state,n,nA,nB,rewardA,rewardB,mn_rewardA,mn_rewardB
"[1, 0, 0, 0, 0, 0, 0, 0, 1, 1, 1, 0, 0, 1, 0]",266,156,110,18,9,0.11538461538461539,0.08181818181818182
"[1, 1, 1, 1, 1, 1, 1, 1, 1, 1, 0, 0, 0, 0, 0]",2673,917,1756,90,172,0.09814612868047982,0.0979498861047836
"[0, 1, 1, 0, 0, 0, 1, 0, 1, 0, 0, 0, 1, 0, 0]",268,190,78,18,5,0.09473684210526316,0.0641025641025641
"[0, 1, 1, 1, 1, 0, 0, 1, 1, 0, 0, 0, 1, 0, 1]",249,170,79,13,8,0.07647058823529412,0.10126582278481013
"[0, 0, 1, 1, 0, 0, 0, 0, 1, 1, 0, 1, 0, 1, 1]",310,156,154,15,13,0.09615384615384616,0.08441558441558442
"[0, 0, 0, 1, 1, 0, 1, 0, 1, 0, 0, 0, 0, 1, 1]",272,166,106,12,9,0.07228915662650602,0.08490566037735849
"[0, 1, 1, 1, 1, 1, 1, 1, 1, 1, 1, 1, 1, 0, 1]",8476,2498,5978,208,590,0.08326661329063251,0.09869521579123453
"[1, 1, 1, 0, 0, 1, 1, 1, 1, 1, 1, 1, 1, 1, 1]",29653,2969,26684,273,2549,0.0919501515661839,0.09552540848448508
"[1, 1, 0, 1, 0, 0, 1, 1, 1, 1, 1, 1, 0, 0, 1]",536,187,349,16,26,0.0855614973262032,0.07449856733524356
"[1, 1, 1, 1, 1, 0, 1, 0, 1, 1, 1, 0, 1, 0, 0]",233,93,140,7,12,0.07526881720430108,0.08571428571428572
"[1, 0, 1, 1, 0, 1, 1, 0, 1, 1, 1, 1, 1, 0, 1]",478,142,336,13,31,0.09154929577464789,0.09226190476190477
"[0, 1, 1, 1, 1, 1, 1, 1, 1, 1, 1, 1, 0, 1, 0]",1882,614,1268,52,124,0.08469055374592833,0.09779179810725552
"[0, 1, 1, 0, 1, 1, 1, 1, 1, 1, 1, 1, 1, 1, 1]",10214,2221,7993,224,777,0.10085547050877983,0.09721005880145127
"[1, 1, 1, 1, 0, 0, 1, 1, 0, 1, 0, 1, 1, 1, 1]",848,233,615,24,58,0.10300429184549356,0.0943089430894309
"[1, 0, 0, 0, 0, 0, 0, 0, 0, 1, 1, 1, 0, 0, 0]",864,507,357,45,32,0.08875739644970414,0.0896358543417367
"[1, 0, 0, 1, 0, 0, 0, 0, 0, 0, 0, 0, 1, 1, 1]",781,447,334,44,29,0.09843400447427293,0.08682634730538923
"[1, 1, 0, 0, 1, 0, 0, 0, 0, 0, 0, 0, 0, 1, 1]",649,390,259,43,30,0.11025641025641025,0.11583011583011583
"[0, 0, 1, 0, 1, 0, 0, 0, 0, 1, 1, 0, 0, 1, 0]",232,157,75,15,11,0.09554140127388536,0.14666666666666667
"[0, 1, 1, 0, 0, 0, 1, 0, 1, 0, 0, 0, 0, 1, 1]",223,148,75,14,9,0.0945945945945946,0.12
"[0, 0, 1, 1, 0, 1, 1, 0, 0, 0, 1, 0, 1, 0, 0]",158,94,64,7,5,0.07446808510638298,0.078125
"[0, 0, 0, 0, 0, 1, 1, 0, 1, 1, 0, 0, 0, 1, 0]",271,173,98,17,10,0.09826589595375723,0.10204081632653061
"[1, 0, 1, 0, 0, 0, 0, 0, 0, 1, 1, 0, 1, 1, 0]",193,112,81,9,10,0.08035714285714286,0.12345679012345678
"[0, 0, 0, 1, 0, 1, 1, 0, 0, 1, 0, 1, 0, 0, 0]",229,159,70,13,5,0.08176100628930817,0.07142857142857142
"[0, 0, 0, 0, 0, 0, 0, 0, 0, 0, 0, 0, 1, 1, 1]",38738,34688,4050,3309,390,0.09539321955719557,0.0962962962962963
"[1, 1, 0, 0, 0, 0, 0, 0, 0, 0, 0, 0, 0, 0, 0]",26107,20813,5294,2013,502,0.09671839715562389,0.09482432942954287
"[0, 1, 0, 0, 0, 0, 0, 0, 0, 0, 0, 0, 1, 1, 0]",3568,2711,857,274,80,0.10106971597196607,0.09334889148191365
"[0, 0, 0, 0, 1, 0, 0, 0, 0, 0, 0, 0, 0, 0, 0]",61803,54252,7551,5148,726,0.0948905109489051,0.09614620580055622
"[0, 0, 0, 0, 0, 0, 0, 1, 0, 0, 0, 0, 0, 0, 0]",57801,51014,6787,4873,664,0.09552279766338652,0.0978340945926035
"[0, 0, 0, 0, 0, 0, 0, 0, 0, 0, 0, 0, 0, 1, 0]",58739,51934,6805,5070,658,0.0976239072669157,0.09669360764144012
"[0, 0, 1, 1, 1, 1, 0, 1, 1, 0, 1, 1, 1, 1, 0]",276,81,195,8,25,0.09876543209876543,0.1282051282051282
"[0, 1, 1, 1, 0, 0, 1, 1, 0, 1, 0, 0, 0, 0, 0]",192,113,79,14,4,0.12389380530973451,0.05063291139240506
"[0, 0, 0, 1, 1, 1, 1, 1, 1, 1, 1, 0, 1, 1, 1]",1167,655,512,61,47,0.09312977099236641,0.091796875
"[1, 1, 1, 1, 0, 1, 1, 1, 1, 1, 0, 1, 0, 0, 0]",265,104,161,7,16,0.0673076923076923,0.09937888198757763
"[1, 1, 0, 1, 1, 0, 1, 1, 1, 1, 0, 1, 1, 1, 1]",1711,390,1321,33,130,0.08461538461538462,0.0984102952308857
"[1, 1, 1, 1, 0, 1, 1, 1, 0, 1, 1, 0, 1, 1, 1]",1710,385,1325,34,123,0.08831168831168831,0.09283018867924528
"[1, 0, 0, 1, 1, 1, 1, 1, 1, 0, 1, 1, 1, 0, 1]",660,158,502,18,44,0.11392405063291139,0.08764940239043825
"[1, 1, 0, 0, 1, 1, 1, 1, 1, 1, 0, 1, 1, 1, 0]",757,199,558,16,47,0.08040201005025126,0.08422939068100359
"[0, 1, 0, 1, 1, 1, 1, 1, 1, 1, 1, 1, 0, 1, 0]",549,173,376,15,40,0.08670520231213873,0.10638297872340426
"[1, 1, 0, 1, 0, 1, 1, 1, 0, 1, 1, 0, 1, 0, 1]",239,90,149,3,12,0.03333333333333333,0.08053691275167785
"[1, 1, 1, 1, 0, 1, 0, 1, 1, 1, 0, 1, 1, 0, 1]",491,146,345,12,35,0.0821917808219178,0.10144927536231885
"[1, 1, 1, 1, 1, 0, 1, 0, 1, 1, 1, 0, 1, 1, 0]",515,137,378,11,41,0.08029197080291971,0.10846560846560846
"[1, 0, 1, 1, 1, 1, 0, 1, 0, 0, 1, 0, 1, 1, 1]",241,87,154,10,10,0.11494252873563218,0.06493506493506493
"[1, 1, 1, 0, 1, 0, 1, 1, 1, 1, 0, 1, 0, 0, 1]",264,88,176,7,17,0.07954545454545454,0.09659090909090909
"[0, 1, 0, 1, 0, 1, 1, 1, 0, 0, 0, 1, 0, 1, 0]",102,53,49,6,2,0.11320754716981132,0.04081632653061224
"[1, 0, 1, 1, 0, 1, 0, 1, 0, 0, 0, 0, 1, 0, 1]",107,53,54,2,9,0.03773584905660377,0.16666666666666666
"[1, 0, 1, 0, 1, 1, 0, 1, 0, 0, 0, 1, 1, 0, 0]",148,79,69,5,8,0.06329113924050633,0.11594202898550725
"[0, 1, 0, 1, 0, 1, 1, 0, 1, 0, 0, 0, 1, 1, 0]",138,75,63,5,5,0.06666666666666667,0.07936507936507936
"[0, 0, 0, 1, 0, 1, 0, 1, 1, 0, 1, 0, 0, 0, 1]",137,87,50,9,5,0.10344827586206896,0.1
"[0, 0, 0, 0, 1, 1, 1, 1, 1, 0, 0, 0, 1, 0, 0]",213,137,76,14,4,0.10218978102189781,0.05263157894736842
"[1, 0, 0, 0, 0, 1, 1, 1, 0, 0, 0, 0, 0, 0, 0]",949,596,353,45,32,0.07550335570469799,0.0906515580736544
"[0, 0, 0, 0, 0, 0, 0, 0, 0, 1, 0, 0, 0, 0, 1]",9090,7630,1460,696,151,0.09121887287024902,0.10342465753424658
"[0, 0, 0, 1, 0, 0, 1, 0, 0, 0, 1, 0, 0, 1, 0]",462,323,139,27,12,0.08359133126934984,0.08633093525179857
"[0, 0, 0, 0, 0, 0, 0, 0, 1, 0, 1, 0, 1, 1, 1]",917,715,202,86,17,0.12027972027972028,0.08415841584158416
"[0, 0, 0, 0, 0, 0, 0, 0, 0, 1, 0, 1, 0, 1, 1]",1220,963,257,103,25,0.10695742471443406,0.09727626459143969
"[1, 1, 0, 0, 1, 1, 0, 1, 0, 1, 1, 0, 0, 0, 0]",157,78,79,10,3,0.1282051282051282,0.0379746835443038
"[1, 1, 1, 1, 1, 0, 0, 0, 1, 0, 1, 1, 1, 1, 1]",859,202,657,22,68,0.10891089108910891,0.1035007610350076
"[0, 0, 0, 0, 1, 1, 0, 0, 0, 0, 0, 0, 0, 0, 1]",7292,5453,1839,532,163,0.0975609756097561,0.08863512778684067
"[1, 0, 0, 1, 1, 1, 0, 1, 0, 0, 0, 0, 1, 1, 0]",163,62,101,4,8,0.06451612903225806,0.07920792079207921
"[0, 0, 0, 0, 0, 1, 0, 0, 1, 1, 1, 0, 1, 0, 0]",251,159,92,16,16,0.10062893081761007,0.17391304347826086
"[0, 0, 0, 0, 0, 0, 0, 0, 0, 1, 0, 0, 1, 1, 1]",3479,2910,569,282,66,0.09690721649484536,0.11599297012302284
"[1, 0, 0, 0, 0, 0, 0, 0, 0, 0, 0, 0, 1, 0, 0]",7991,5950,2041,581,193,0.0976470588235294,0.09456148946594807
"[0, 1, 0, 1, 1, 0, 0, 0, 0, 0, 0, 0, 0, 0, 0]",2954,2185,769,201,77,0.0919908466819222,0.10013003901170352
"[0, 1, 1, 1, 0, 1, 0, 1, 1, 0, 0, 0, 0, 0, 0]",270,156,114,14,11,0.08974358974358974,0.09649122807017543
"[1, 1, 0, 1, 0, 1, 1, 1, 0, 1, 0, 1, 1, 0, 0]",162,59,103,5,14,0.0847457627118644,0.13592233009708737
"[0, 0, 0, 1, 0, 1, 1, 1, 1, 1, 1, 0, 1, 0, 0]",123,70,53,8,1,0.11428571428571428,0.018867924528301886
"[1, 1, 0, 0, 1, 0, 0, 0, 0, 0, 0, 1, 0, 1, 0]",274,175,99,13,13,0.07428571428571429,0.13131313131313133
"[1, 1, 1, 0, 0, 1, 0, 0, 0, 0, 0, 0, 1, 0, 1]",170,86,84,6,8,0.06976744186046512,0.09523809523809523
"[0, 0, 0, 0, 0, 0, 0, 1, 0, 0, 1, 0, 0, 0, 0]",7981,6638,1343,650,130,0.09792106056040976,0.0967982129560685
"[1, 0, 1, 1, 0, 1, 1, 1, 0, 1, 1, 1, 1, 1, 1]",1856,470,1386,42,128,0.08936170212765958,0.09235209235209235
"[1, 1, 0, 1, 1, 0, 1, 1, 1, 0, 1, 1, 1, 1, 1]",1758,394,1364,40,125,0.10152284263959391,0.09164222873900293
"[1, 0, 1, 1, 1, 1, 0, 1, 1, 0, 1, 1, 1, 0, 1]",542,156,386,16,32,0.10256410256410256,0.08290155440414508
"[1, 0, 1, 0, 1, 1, 1, 1, 1, 1, 0, 1, 1, 1, 1]",1725,376,1349,41,127,0.10904255319148937,0.09414381022979985
"[1, 0, 1, 0, 0, 0, 1, 0, 1, 0, 1, 0, 0, 1, 1]",113,56,57,8,2,0.14285714285714285,0.03508771929824561
"[1, 1, 1, 0, 1, 0, 1, 0, 0, 0, 1, 0, 1, 0, 1]",114,52,62,4,12,0.07692307692307693,0.1935483870967742
"[1, 1, 0, 0, 1, 0, 1, 0, 1, 1, 1, 1, 0, 1, 0]",141,78,63,7,9,0.08974358974358974,0.14285714285714285
"[0, 1, 1, 0, 0, 1, 0, 1, 0, 1, 1, 1, 1, 0, 1]",168,72,96,4,9,0.05555555555555555,0.09375
"[0, 1, 0, 0, 1, 1, 0, 0, 1, 0, 1, 0, 1, 1, 1]",143,69,74,7,6,0.10144927536231885,0.08108108108108109
"[0, 0, 0, 0, 1, 0, 1, 0, 0, 1, 1, 0, 0, 1, 0]",240,157,83,19,15,0.12101910828025478,0.18072289156626506
"[1, 1, 1, 0, 1, 0, 1, 0, 0, 0, 1, 1, 1, 0, 0]",132,58,74,8,7,0.13793103448275862,0.0945945945945946
"[0, 1, 1, 1, 0, 1, 0, 1, 0, 0, 0, 1, 1, 1, 0]",119,60,59,4,9,0.06666666666666667,0.15254237288135594
"[0, 0, 1, 1, 1, 0, 1, 0, 1, 0, 0, 0, 1, 1, 1]",187,93,94,7,4,0.07526881720430108,0.0425531914893617
"[0, 0, 0, 1, 0, 0, 0, 0, 1, 1, 1, 0, 1, 0, 1]",142,78,64,6,11,0.07692307692307693,0.171875
"[0, 0, 0, 1, 1, 0, 0, 1, 0, 0, 1, 1, 1, 0, 1]",131,82,49,11,7,0.13414634146341464,0.14285714285714285
"[0, 1, 0, 0, 0, 0, 0, 1, 0, 0, 0, 0, 1, 1, 0]",680,510,170,61,13,0.11960784313725491,0.07647058823529412
"[0, 0, 0, 1, 0, 0, 0, 0, 0, 1, 0, 0, 0, 0, 0]",7310,6050,1260,617,139,0.10198347107438016,0.11031746031746031
"[0, 1, 0, 0, 1, 0, 1, 0, 1, 0, 0, 0, 0, 0, 0]",581,394,187,42,15,0.1065989847715736,0.08021390374331551
"[0, 1, 0, 0, 1, 0, 0, 0, 0, 1, 0, 0, 0, 1, 0]",484,325,159,36,18,0.11076923076923077,0.11320754716981132
"[1, 1, 1, 1, 1, 1, 0, 0, 1, 1, 1, 0, 1, 1, 1]",2834,714,2120,63,187,0.08823529411764706,0.08820754716981132
"[1, 0, 1, 1, 0, 1, 1, 1, 1, 1, 0, 1, 1, 1, 1]",1674,410,1264,34,111,0.08292682926829269,0.08781645569620253
"[1, 1, 1, 0, 1, 1, 0, 0, 1, 0, 1, 1, 1, 1, 0]",237,77,160,5,13,0.06493506493506493,0.08125
"[0, 0, 0, 0, 0, 0, 0, 0, 1, 1, 0, 0, 1, 1, 0]",4891,3531,1360,342,132,0.09685641461342395,0.09705882352941177
"[1, 0, 1, 0, 1, 1, 0, 0, 0, 0, 1, 1, 0, 0, 0]",324,173,151,13,18,0.07514450867052024,0.11920529801324503
"[0, 0, 0, 1, 1, 0, 1, 0, 1, 1, 0, 0, 0, 0, 1]",205,131,74,12,6,0.0916030534351145,0.08108108108108109
"[1, 1, 1, 1, 1, 0, 0, 1, 1, 1, 1, 1, 0, 1, 1]",2657,489,2168,44,212,0.08997955010224949,0.09778597785977859
"[0, 1, 1, 1, 1, 1, 0, 1, 1, 1, 1, 1, 0, 1, 1]",1614,460,1154,45,106,0.09782608695652174,0.09185441941074524
"[1, 0, 1, 1, 1, 1, 1, 1, 0, 1, 1, 1, 1, 1, 1]",7832,1363,6469,127,579,0.09317681584739546,0.08950378729324471
"[1, 1, 1, 1, 1, 0, 1, 1, 1, 1, 1, 1, 0, 1, 1]",7064,1203,5861,126,534,0.10473815461346633,0.09111073195700392
"[1, 1, 1, 0, 1, 0, 0, 0, 0, 0, 0, 0, 0, 0, 1]",397,237,160,34,15,0.14345991561181434,0.09375
"[0, 1, 1, 0, 0, 1, 0, 0, 0, 0, 1, 0, 0, 0, 1]",243,159,84,9,6,0.05660377358490566,0.07142857142857142
"[0, 0, 0, 1, 0, 1, 1, 0, 0, 1, 0, 0, 0, 0, 1]",267,177,90,19,14,0.10734463276836158,0.15555555555555556
"[0, 0, 0, 1, 0, 0, 0, 0, 1, 0, 1, 1, 0, 0, 1]",252,165,87,16,11,0.09696969696969697,0.12643678160919541
"[1, 0, 0, 1, 0, 0, 1, 1, 1, 0, 0, 1, 1, 0, 1]",121,61,60,5,7,0.08196721311475409,0.11666666666666667
"[1, 1, 0, 1, 1, 1, 1, 1, 1, 1, 1, 0, 0, 0, 0]",884,270,614,25,59,0.09259259259259259,0.09609120521172639
"[1, 1, 0, 1, 0, 0, 1, 1, 1, 0, 1, 1, 1, 1, 1]",658,195,463,19,47,0.09743589743589744,0.10151187904967603
"[0, 0, 0, 0, 0, 0, 0, 0, 0, 0, 0, 1, 0, 1, 1]",4772,3980,792,351,66,0.08819095477386935,0.08333333333333333
"[0, 0, 1, 0, 0, 0, 0, 0, 0, 0, 1, 1, 1, 1, 1]",513,307,206,26,21,0.08469055374592833,0.10194174757281553
"[0, 0, 1, 0, 0, 0, 0, 1, 1, 0, 0, 0, 0, 1, 0]",639,459,180,41,20,0.08932461873638345,0.1111111111111111
"[1, 1, 1, 1, 1, 1, 1, 1, 0, 0, 1, 1, 1, 1, 0]",6524,1654,4870,155,454,0.09371221281741234,0.09322381930184805
"[1, 0, 1, 1, 1, 1, 1, 1, 1, 0, 0, 1, 1, 0, 1]",609,178,431,20,38,0.11235955056179775,0.08816705336426914
"[0, 0, 0, 1, 0, 0, 1, 0, 0, 0, 0, 1, 1, 0, 0]",824,575,249,62,22,0.10782608695652174,0.08835341365461848
"[1, 1, 1, 1, 1, 0, 0, 0, 1, 0, 0, 1, 0, 0, 0]",161,72,89,6,7,0.08333333333333333,0.07865168539325842
"[1, 0, 0, 1, 0, 0, 0, 1, 0, 0, 1, 0, 0, 1, 0]",215,135,80,15,9,0.1111111111111111,0.1125
"[1, 0, 1, 1, 0, 0, 0, 1, 1, 1, 0, 1, 1, 1, 0]",159,53,106,4,14,0.07547169811320754,0.1320754716981132
"[0, 0, 0, 0, 1, 1, 0, 1, 1, 1, 1, 1, 0, 0, 0]",182,97,85,11,6,0.1134020618556701,0.07058823529411765
"[1, 1, 1, 1, 0, 1, 0, 0, 1, 0, 0, 1, 1, 1, 1]",366,131,235,10,18,0.07633587786259542,0.07659574468085106
"[1, 1, 1, 0, 1, 1, 1, 1, 1, 1, 1, 0, 1, 0, 0]",574,141,433,19,45,0.1347517730496454,0.10392609699769054
"[0, 1, 1, 0, 0, 1, 1, 1, 0, 0, 0, 1, 0, 1, 1]",174,103,71,13,4,0.1262135922330097,0.056338028169014086
"[1, 1, 0, 0, 1, 0, 0, 0, 0, 0, 1, 1, 0, 0, 1]",230,117,113,8,11,0.06837606837606838,0.09734513274336283
"[0, 1, 0, 0, 0, 0, 0, 1, 1, 0, 0, 0, 0, 0, 1]",681,495,186,62,22,0.12525252525252525,0.11827956989247312
"[0, 0, 0, 0, 0, 1, 1, 1, 1, 0, 0, 0, 1, 0, 0]",482,377,105,40,4,0.10610079575596817,0.0380952380952381
"[0, 1, 0, 1, 1, 1, 0, 1, 1, 1, 1, 1, 1, 1, 1]",2177,563,1614,49,148,0.08703374777975133,0.09169764560099132
"[1, 0, 1, 0, 1, 1, 1, 0, 1, 1, 1, 1, 1, 1, 1]",1971,490,1481,53,135,0.10816326530612246,0.09115462525320729
"[1, 1, 1, 1, 0, 1, 0, 1, 1, 1, 0, 1, 1, 1, 1]",1790,417,1373,38,120,0.09112709832134293,0.08739985433357611
"[0, 1, 0, 0, 1, 0, 0, 0, 1, 1, 0, 0, 0, 0, 0]",750,536,214,54,22,0.10074626865671642,0.102803738317757
"[0, 0, 1, 0, 0, 1, 1, 1, 1, 1, 0, 0, 0, 0, 1]",234,131,103,12,12,0.0916030534351145,0.11650485436893204
"[0, 1, 1, 0, 0, 1, 0, 1, 1, 0, 0, 0, 1, 1, 1]",188,106,82,15,9,0.14150943396226415,0.10975609756097561
"[1, 1, 0, 1, 0, 1, 1, 1, 1, 1, 0, 1, 1, 1, 1]",1755,438,1317,34,129,0.0776255707762557,0.0979498861047836
"[1, 1, 0, 1, 0, 1, 1, 1, 1, 1, 1, 0, 0, 0, 1]",299,112,187,12,18,0.10714285714285714,0.0962566844919786
"[0, 1, 1, 1, 1, 0, 0, 1, 1, 1, 1, 1, 1, 1, 1]",7362,4335,3027,454,292,0.10472895040369089,0.09646514701024116
"[1, 1, 1, 1, 1, 1, 1, 0, 0, 1, 1, 1, 1, 0, 0]",4761,725,4036,64,356,0.08827586206896551,0.08820614469772052
"[0, 1, 1, 0, 1, 1, 1, 0, 1, 1, 1, 0, 1, 1, 1]",495,143,352,14,45,0.0979020979020979,0.1278409090909091
"[1, 0, 1, 1, 1, 0, 1, 1, 0, 1, 1, 1, 1, 1, 1]",1855,450,1405,46,148,0.10222222222222223,0.10533807829181495
"[0, 1, 1, 1, 1, 0, 1, 0, 1, 0, 0, 0, 1, 0, 0]",117,69,48,9,6,0.13043478260869565,0.125
"[1, 0, 0, 1, 1, 1, 0, 0, 1, 0, 1, 1, 1, 1, 1]",334,103,231,14,25,0.13592233009708737,0.10822510822510822
"[1, 1, 0, 1, 1, 1, 0, 0, 1, 1, 1, 0, 0, 1, 0]",177,78,99,8,10,0.10256410256410256,0.10101010101010101
"[1, 1, 1, 0, 0, 1, 1, 0, 1, 0, 1, 1, 1, 0, 1]",239,67,172,7,12,0.1044776119402985,0.06976744186046512
"[0, 0, 0, 0, 0, 0, 1, 0, 0, 0, 0, 0, 0, 0, 1]",8567,7140,1427,680,143,0.09523809523809523,0.10021023125437982
"[0, 1, 0, 0, 0, 0, 0, 1, 1, 0, 1, 1, 0, 1, 1]",116,73,43,7,3,0.0958904109589041,0.06976744186046512
"[1, 0, 0, 0, 0, 1, 0, 0, 0, 0, 0, 1, 1, 0, 1]",264,154,110,11,7,0.07142857142857142,0.06363636363636363
"[0, 1, 0, 0, 0, 0, 1, 0, 0, 0, 0, 0, 1, 1, 0]",670,491,179,51,28,0.10386965376782077,0.1564245810055866
"[0, 0, 0, 0, 1, 0, 1, 1, 0, 1, 0, 0, 0, 0, 1]",247,170,77,15,9,0.08823529411764706,0.11688311688311688
"[0, 0, 0, 0, 1, 1, 0, 0, 0, 0, 1, 0, 0, 0, 1]",840,581,259,41,22,0.07056798623063683,0.08494208494208494
"[0, 0, 0, 1, 1, 0, 0, 1, 1, 0, 0, 0, 0, 1, 1]",2255,1895,360,175,37,0.09234828496042216,0.10277777777777777
"[1, 1, 1, 1, 1, 1, 1, 1, 0, 0, 0, 0, 0, 0, 1]",2380,865,1515,88,146,0.10173410404624278,0.09636963696369637
"[1, 1, 1, 1, 0, 1, 0, 1, 1, 1, 1, 1, 1, 1, 0]",1719,399,1320,40,138,0.10025062656641603,0.10454545454545454
"[1, 1, 1, 1, 1, 1, 0, 1, 0, 0, 0, 0, 1, 1, 1]",501,150,351,11,31,0.07333333333333333,0.08831908831908832
"[0, 0, 1, 1, 1, 1, 1, 1, 0, 1, 1, 1, 1, 1, 1]",2864,717,2147,68,223,0.09483960948396095,0.10386585933861202
"[0, 0, 1, 1, 1, 0, 0, 0, 0, 0, 0, 0, 0, 1, 1]",838,540,298,43,33,0.07962962962962963,0.11073825503355705
"[1, 1, 1, 1, 0, 1, 0, 1, 1, 1, 0, 0, 0, 1, 0]",154,65,89,2,4,0.03076923076923077,0.0449438202247191
"[1, 1, 1, 1, 0, 1, 1, 1, 1, 1, 0, 0, 0, 0, 1]",565,175,390,23,36,0.13142857142857142,0.09230769230769231
"[0, 0, 1, 1, 1, 0, 0, 0, 1, 1, 0, 0, 0, 0, 0]",400,260,140,19,13,0.07307692307692308,0.09285714285714286
"[1, 0, 0, 0, 0, 0, 0, 1, 1, 0, 0, 0, 0, 0, 0]",6669,2981,3688,283,317,0.09493458570949345,0.08595444685466377
"[1, 1, 0, 0, 0, 0, 0, 0, 1, 1, 0, 0, 0, 0, 0]",4315,3022,1293,271,132,0.08967571144937128,0.10208816705336426
"[0, 1, 1, 0, 0, 0, 1, 1, 1, 1, 0, 0, 1, 1, 1]",422,195,227,19,22,0.09743589743589744,0.09691629955947137
"[0, 0, 0, 0, 0, 1, 1, 1, 1, 1, 1, 0, 0, 0, 0]",2286,1903,383,170,41,0.08933263268523384,0.10704960835509138
"[1, 0, 1, 1, 1, 0, 0, 1, 0, 0, 1, 0, 1, 1, 0]",116,50,66,8,5,0.16,0.07575757575757576
"[1, 1, 0, 1, 1, 1, 0, 0, 1, 0, 0, 1, 0, 1, 1]",163,68,95,5,7,0.07352941176470588,0.07368421052631578
"[1, 1, 1, 1, 1, 1, 0, 0, 0, 1, 1, 1, 1, 1, 1]",3468,785,2683,81,276,0.10318471337579618,0.10286992172940738
"[1, 1, 1, 1, 0, 1, 1, 0, 1, 0, 1, 1, 0, 0, 1]",278,84,194,11,19,0.13095238095238096,0.0979381443298969
"[1, 1, 1, 0, 0, 1, 0, 0, 1, 1, 1, 1, 1, 0, 1]",259,86,173,12,18,0.13953488372093023,0.10404624277456648
"[0, 1, 1, 1, 1, 0, 0, 1, 0, 1, 1, 0, 1, 1, 1]",317,152,165,13,14,0.08552631578947369,0.08484848484848485
"[1, 0, 0, 0, 0, 1, 1, 1, 1, 0, 0, 1, 0, 1, 1]",318,82,236,4,18,0.04878048780487805,0.07627118644067797
"[0, 1, 1, 0, 0, 0, 0, 1, 1, 1, 0, 0, 1, 1, 0]",200,127,73,4,7,0.031496062992125984,0.0958904109589041
"[0, 0, 0, 0, 0, 0, 1, 0, 1, 0, 0, 1, 0, 0, 0]",1699,1295,404,121,42,0.09343629343629344,0.10396039603960396
"[0, 1, 1, 0, 1, 0, 0, 0, 0, 0, 0, 0, 1, 0, 1]",227,150,77,17,8,0.11333333333333333,0.1038961038961039
"[1, 0, 1, 0, 1, 1, 0, 1, 0, 0, 0, 0, 0, 0, 0]",335,211,124,14,8,0.06635071090047394,0.06451612903225806
"[0, 1, 1, 0, 0, 0, 0, 0, 0, 1, 1, 0, 1, 0, 1]",287,219,68,25,12,0.1141552511415525,0.17647058823529413
"[0, 0, 1, 1, 0, 0, 1, 0, 0, 0, 0, 0, 1, 1, 1]",404,274,130,26,14,0.0948905109489051,0.1076923076923077
"[1, 0, 1, 0, 0, 0, 0, 0, 0, 0, 0, 0, 0, 0, 1]",2327,1700,627,178,66,0.10470588235294118,0.10526315789473684
"[1, 0, 0, 0, 0, 0, 0, 1, 0, 0, 0, 0, 1, 0, 1]",541,343,198,33,21,0.09620991253644315,0.10606060606060606
"[0, 0, 1, 1, 0, 0, 1, 1, 1, 1, 1, 0, 1, 1, 1]",665,261,404,27,33,0.10344827586206896,0.08168316831683169
"[1, 0, 1, 0, 0, 0, 0, 0, 0, 0, 0, 1, 1, 0, 1]",311,196,115,19,7,0.09693877551020408,0.06086956521739131
"[0, 1, 1, 0, 1, 0, 0, 0, 0, 0, 0, 1, 1, 1, 1]",368,217,151,23,13,0.10599078341013825,0.08609271523178808
"[0, 1, 1, 1, 1, 0, 0, 1, 1, 0, 0, 1, 0, 1, 1]",334,219,115,18,9,0.0821917808219178,0.0782608695652174
"[1, 0, 0, 0, 0, 1, 1, 1, 1, 0, 0, 1, 1, 1, 1]",2178,366,1812,36,181,0.09836065573770492,0.0998896247240618
"[0, 1, 1, 0, 0, 0, 0, 1, 0, 0, 0, 1, 0, 0, 1]",291,203,88,16,15,0.07881773399014778,0.17045454545454544
"[0, 1, 1, 0, 1, 0, 1, 1, 0, 0, 0, 0, 1, 0, 0]",155,85,70,4,7,0.047058823529411764,0.1
"[0, 0, 0, 1, 1, 0, 0, 1, 1, 0, 0, 0, 0, 0, 0]",4856,4199,657,397,54,0.0945463205525125,0.0821917808219178
"[0, 1, 1, 0, 0, 0, 0, 0, 0, 0, 1, 1, 0, 1, 1]",315,237,78,24,12,0.10126582278481013,0.15384615384615385
"[0, 0, 1, 1, 0, 0, 0, 0, 0, 0, 0, 1, 1, 0, 1]",425,266,159,17,20,0.06390977443609022,0.12578616352201258
"[0, 0, 0, 1, 1, 0, 0, 0, 0, 0, 0, 0, 1, 1, 0]",1216,935,281,101,31,0.10802139037433155,0.1103202846975089
"[0, 0, 0, 0, 0, 0, 0, 1, 0, 1, 1, 0, 0, 0, 0]",2221,1762,459,173,42,0.0981838819523269,0.0915032679738562
"[1, 0, 1, 1, 0, 0, 1, 0, 0, 0, 0, 0, 0, 0, 0]",781,504,277,40,17,0.07936507936507936,0.061371841155234655
"[0, 0, 0, 0, 0, 0, 0, 0, 1, 0, 1, 1, 0, 1, 1]",421,285,136,26,6,0.0912280701754386,0.04411764705882353
"[0, 0, 0, 0, 0, 1, 0, 1, 0, 0, 1, 1, 0, 0, 0]",767,544,223,58,20,0.10661764705882353,0.08968609865470852
"[0, 0, 0, 1, 0, 0, 0, 0, 1, 1, 0, 1, 1, 1, 0]",143,82,61,8,8,0.0975609756097561,0.13114754098360656
"[0, 1, 1, 0, 0, 1, 0, 0, 1, 0, 1, 1, 1, 1, 0]",119,64,55,7,8,0.109375,0.14545454545454545
"[1, 1, 1, 0, 1, 1, 0, 0, 1, 0, 0, 1, 0, 1, 1]",153,56,97,8,6,0.14285714285714285,0.061855670103092786
"[0, 0, 0, 0, 0, 0, 1, 1, 1, 1, 1, 0, 1, 0, 1]",228,104,124,13,11,0.125,0.08870967741935484
"[1, 1, 1, 0, 1, 1, 0, 0, 0, 0, 0, 1, 1, 1, 1]",336,132,204,15,23,0.11363636363636363,0.11274509803921569
"[1, 0, 1, 0, 1, 0, 0, 0, 0, 1, 1, 1, 1, 1, 0]",151,68,83,3,3,0.04411764705882353,0.03614457831325301
"[1, 1, 1, 1, 0, 0, 1, 0, 1, 0, 1, 1, 1, 0, 0]",190,73,117,8,9,0.1095890410958904,0.07692307692307693
"[1, 1, 0, 1, 0, 1, 0, 1, 1, 1, 1, 1, 0, 0, 1]",304,110,194,14,15,0.12727272727272726,0.07731958762886598
"[1, 0, 0, 0, 1, 1, 0, 0, 0, 0, 0, 0, 1, 1, 1]",639,373,266,35,29,0.0938337801608579,0.10902255639097744
"[0, 1, 0, 1, 0, 0, 0, 1, 0, 0, 1, 0, 0, 0, 1]",228,158,70,18,7,0.11392405063291139,0.1
"[1, 0, 1, 0, 1, 0, 0, 0, 1, 0, 0, 1, 0, 0, 0]",241,155,86,14,11,0.09032258064516129,0.12790697674418605
"[0, 1, 0, 1, 1, 1, 1, 0, 1, 1, 1, 0, 0, 0, 1]",150,50,100,6,8,0.12,0.08
"[0, 0, 1, 0, 1, 1, 1, 1, 0, 1, 1, 1, 0, 0, 0]",121,55,66,5,6,0.09090909090909091,0.09090909090909091
"[0, 0, 0, 1, 0, 0, 0, 1, 0, 0, 1, 0, 1, 1, 1]",196,124,72,8,4,0.06451612903225806,0.05555555555555555
"[0, 0, 1, 1, 1, 0, 1, 0, 1, 1, 1, 1, 1, 1, 1]",788,241,547,24,55,0.0995850622406639,0.10054844606946983
"[1, 1, 1, 1, 0, 1, 1, 1, 1, 0, 0, 1, 1, 1, 1]",3207,718,2489,64,231,0.08913649025069638,0.09280835676978706
"[1, 1, 0, 0, 1, 1, 0, 0, 1, 1, 0, 0, 0, 0, 1]",1603,811,792,76,74,0.093711467324291,0.09343434343434344
"[1, 0, 0, 0, 0, 0, 1, 1, 1, 0, 0, 1, 1, 0, 0]",262,160,102,9,7,0.05625,0.06862745098039216
"[1, 0, 0, 1, 0, 1, 1, 1, 0, 1, 0, 1, 0, 1, 1]",141,51,90,5,9,0.09803921568627451,0.1
"[0, 1, 1, 1, 0, 0, 0, 1, 1, 0, 0, 1, 0, 1, 1]",141,75,66,7,4,0.09333333333333334,0.06060606060606061
"[0, 0, 0, 1, 1, 0, 0, 0, 0, 1, 0, 0, 1, 0, 1]",327,249,78,25,8,0.10040160642570281,0.10256410256410256
"[1, 1, 0, 0, 1, 0, 0, 1, 0, 1, 0, 1, 0, 0, 1]",113,57,56,6,4,0.10526315789473684,0.07142857142857142
"[1, 1, 1, 0, 0, 1, 0, 0, 1, 0, 1, 0, 1, 0, 0]",113,56,57,9,5,0.16071428571428573,0.08771929824561403
"[0, 0, 0, 0, 0, 0, 0, 1, 1, 0, 1, 1, 0, 0, 1]",407,283,124,20,9,0.0706713780918728,0.07258064516129033
"[0, 0, 0, 1, 0, 1, 0, 1, 1, 1, 0, 0, 1, 1, 1]",181,92,89,9,10,0.09782608695652174,0.11235955056179775
"[0, 1, 0, 0, 0, 0, 1, 1, 0, 0, 1, 1, 1, 0, 0]",226,118,108,7,8,0.059322033898305086,0.07407407407407407
"[1, 0, 0, 0, 1, 1, 0, 0, 1, 0, 0, 0, 0, 1, 0]",235,146,89,15,6,0.10273972602739725,0.06741573033707865
"[0, 1, 0, 0, 1, 1, 1, 1, 0, 0, 0, 1, 1, 0, 0]",169,87,82,7,10,0.08045977011494253,0.12195121951219512
"[1, 0, 1, 0, 0, 1, 1, 1, 1, 0, 0, 0, 1, 1, 0]",145,60,85,4,8,0.06666666666666667,0.09411764705882353
"[1, 0, 0, 0, 0, 0, 0, 1, 0, 1, 0, 0, 1, 1, 1]",289,139,150,13,17,0.09352517985611511,0.11333333333333333
"[0, 1, 0, 1, 0, 0, 1, 1, 1, 1, 0, 0, 1, 1, 0]",292,155,137,18,12,0.11612903225806452,0.08759124087591241
"[0, 0, 0, 1, 0, 1, 1, 0, 0, 1, 0, 0, 1, 1, 1]",157,94,63,8,1,0.0851063829787234,0.015873015873015872
"[1, 1, 1, 0, 1, 0, 0, 1, 1, 0, 1, 0, 1, 0, 0]",114,50,64,3,6,0.06,0.09375
"[0, 1, 0, 0, 0, 1, 1, 1, 0, 1, 0, 0, 1, 1, 0]",108,53,55,6,7,0.11320754716981132,0.12727272727272726
"[1, 1, 1, 0, 1, 0, 1, 0, 0, 0, 1, 0, 1, 1, 0]",121,56,65,4,4,0.07142857142857142,0.06153846153846154
"[0, 1, 0, 0, 0, 1, 1, 1, 1, 1, 1, 1, 1, 1, 1]",1225,415,810,31,80,0.0746987951807229,0.09876543209876543
"[0, 0, 1, 0, 0, 1, 0, 0, 1, 0, 0, 0, 1, 1, 1]",219,135,84,15,9,0.1111111111111111,0.10714285714285714
"[1, 1, 1, 1, 0, 0, 0, 1, 0, 0, 0, 1, 1, 1, 1]",278,102,176,13,14,0.12745098039215685,0.07954545454545454
"[1, 1, 1, 1, 1, 1, 0, 0, 0, 1, 0, 0, 0, 1, 1]",281,129,152,16,16,0.12403100775193798,0.10526315789473684
"[1, 1, 0, 0, 0, 0, 0, 0, 1, 1, 0, 0, 0, 0, 1]",2242,1355,887,129,90,0.0952029520295203,0.10146561443066517
"[0, 1, 0, 1, 0, 0, 1, 0, 0, 1, 1, 1, 0, 1, 1]",124,60,64,7,6,0.11666666666666667,0.09375
"[1, 1, 0, 0, 0, 0, 0, 0, 0, 0, 0, 0, 0, 0, 1]",6878,5050,1828,434,171,0.08594059405940593,0.09354485776805252
"[0, 0, 0, 0, 1, 1, 1, 1, 0, 0, 1, 1, 0, 0, 0]",2026,1270,756,103,80,0.08110236220472442,0.10582010582010581
"[0, 0, 0, 0, 1, 0, 1, 1, 1, 1, 0, 0, 0, 0, 0]",475,323,152,31,8,0.09597523219814241,0.05263157894736842
"[0, 0, 1, 1, 0, 0, 0, 1, 0, 0, 0, 1, 0, 1, 0]",242,153,89,8,9,0.05228758169934641,0.10112359550561797
"[0, 1, 1, 0, 0, 0, 0, 0, 1, 0, 0, 0, 0, 0, 0]",2235,1754,481,164,48,0.09350057012542759,0.0997920997920998
"[1, 0, 1, 1, 0, 0, 0, 0, 0, 1, 0, 0, 0, 0, 0]",618,434,184,50,22,0.1152073732718894,0.11956521739130435
"[1, 1, 1, 1, 1, 1, 0, 0, 0, 1, 0, 1, 1, 0, 0]",211,80,131,6,8,0.075,0.061068702290076333
"[0, 0, 1, 0, 0, 0, 0, 0, 1, 1, 1, 1, 1, 1, 0]",326,178,148,15,13,0.08426966292134831,0.08783783783783784
"[1, 0, 1, 0, 0, 0, 0, 0, 0, 1, 0, 0, 0, 1, 1]",328,215,113,21,10,0.09767441860465116,0.08849557522123894
"[1, 1, 0, 0, 0, 1, 0, 0, 1, 0, 0, 0, 0, 0, 0]",712,502,210,45,14,0.08964143426294821,0.06666666666666667
"[1, 0, 0, 0, 1, 1, 0, 0, 0, 1, 0, 0, 1, 0, 0]",245,160,85,12,9,0.075,0.10588235294117647
"[0, 0, 0, 0, 0, 1, 0, 1, 1, 0, 0, 0, 1, 0, 0]",571,415,156,35,11,0.08433734939759036,0.07051282051282051
"[1, 0, 0, 0, 0, 0, 0, 0, 1, 0, 1, 1, 0, 0, 0]",636,430,206,27,12,0.06279069767441861,0.05825242718446602
"[1, 0, 1, 1, 0, 1, 1, 1, 0, 0, 0, 0, 1, 1, 1]",296,111,185,11,9,0.0990990990990991,0.04864864864864865
"[1, 0, 0, 1, 0, 1, 0, 1, 0, 1, 1, 0, 1, 1, 1]",172,72,100,7,13,0.09722222222222222,0.13
"[1, 1, 1, 0, 1, 1, 0, 0, 0, 0, 1, 0, 0, 1, 1]",145,59,86,5,7,0.0847457627118644,0.08139534883720931
"[0, 0, 0, 0, 0, 0, 1, 0, 1, 0, 1, 1, 0, 0, 0]",732,518,214,47,20,0.09073359073359073,0.09345794392523364
"[0, 1, 0, 0, 1, 0, 0, 1, 1, 0, 0, 0, 1, 0, 0]",258,171,87,13,8,0.07602339181286549,0.09195402298850575
"[1, 1, 0, 1, 0, 0, 1, 0, 1, 1, 0, 1, 1, 0, 1]",120,53,67,6,7,0.11320754716981132,0.1044776119402985
"[0, 1, 1, 1, 0, 1, 0, 1, 1, 1, 0, 1, 0, 0, 1]",133,53,80,3,9,0.05660377358490566,0.1125
"[1, 0, 0, 1, 0, 0, 1, 1, 1, 0, 1, 0, 1, 1, 1]",193,66,127,5,17,0.07575757575757576,0.13385826771653545
"[0, 0, 0, 1, 1, 0, 0, 0, 0, 1, 0, 1, 0, 0, 0]",684,518,166,53,15,0.10231660231660232,0.09036144578313253
"[0, 0, 1, 0, 0, 0, 0, 0, 1, 1, 1, 0, 1, 0, 0]",262,163,99,8,14,0.049079754601226995,0.1414141414141414
"[1, 0, 0, 1, 0, 0, 0, 0, 0, 1, 1, 1, 0, 1, 0]",164,99,65,5,9,0.050505050505050504,0.13846153846153847
"[0, 1, 1, 1, 1, 0, 0, 0, 0, 0, 0, 0, 0, 1, 0]",698,572,126,56,8,0.0979020979020979,0.06349206349206349
"[0, 0, 1, 1, 0, 0, 0, 0, 0, 0, 1, 1, 0, 1, 1]",570,344,226,33,24,0.09593023255813954,0.10619469026548672
"[0, 0, 1, 1, 0, 1, 1, 0, 0, 0, 1, 0, 1, 1, 1]",168,84,84,4,11,0.047619047619047616,0.13095238095238096
"[0, 1, 0, 0, 0, 1, 0, 0, 0, 0, 1, 1, 0, 1, 1]",190,122,68,11,5,0.09016393442622951,0.07352941176470588
"[1, 0, 0, 0, 0, 1, 0, 1, 0, 1, 0, 0, 0, 0, 0]",588,398,190,39,19,0.09798994974874371,0.1
"[1, 0, 0, 0, 0, 1, 0, 0, 0, 1, 1, 1, 0, 1, 1]",106,56,50,3,9,0.05357142857142857,0.18
"[1, 0, 0, 0, 0, 1, 1, 0, 0, 1, 1, 0, 0, 1, 1]",1686,371,1315,41,114,0.1105121293800539,0.08669201520912548
"[1, 1, 0, 1, 0, 0, 0, 1, 1, 1, 0, 0, 0, 0, 1]",170,89,81,5,6,0.056179775280898875,0.07407407407407407
"[1, 1, 0, 0, 0, 0, 1, 1, 0, 0, 0, 1, 1, 1, 1]",494,243,251,22,18,0.09053497942386832,0.07171314741035857
"[0, 1, 1, 1, 1, 0, 1, 0, 0, 1, 0, 0, 1, 0, 0]",111,59,52,2,6,0.03389830508474576,0.11538461538461539
"[1, 0, 0, 1, 1, 1, 1, 0, 1, 0, 0, 1, 0, 0, 1]",137,50,87,6,5,0.12,0.05747126436781609
"[1, 1, 1, 0, 0, 1, 1, 1, 1, 0, 1, 0, 0, 1, 0]",185,67,118,8,12,0.11940298507462686,0.1016949152542373
"[0, 0, 0, 0, 1, 0, 0, 0, 0, 0, 1, 1, 0, 0, 1]",863,643,220,58,24,0.09020217729393468,0.10909090909090909
"[0, 0, 1, 0, 0, 1, 1, 0, 1, 0, 1, 0, 0, 0, 0]",262,162,100,11,9,0.06790123456790123,0.09
"[0, 0, 0, 1, 1, 1, 0, 0, 1, 0, 1, 0, 1, 0, 0]",144,81,63,8,5,0.09876543209876543,0.07936507936507936
"[1, 0, 1, 1, 1, 0, 0, 0, 1, 0, 0, 1, 0, 0, 0]",161,99,62,14,5,0.1414141414141414,0.08064516129032258
"[1, 0, 0, 0, 0, 1, 0, 1, 1, 1, 0, 1, 1, 1, 0]",111,51,60,5,4,0.09803921568627451,0.06666666666666667
"[1, 1, 0, 1, 0, 0, 0, 0, 1, 0, 1, 1, 1, 0, 1]",111,53,58,5,6,0.09433962264150944,0.10344827586206896
"[0, 0, 0, 0, 0, 0, 1, 0, 0, 0, 1, 0, 0, 1, 1]",893,671,222,76,16,0.11326378539493294,0.07207207207207207
"[0, 0, 0, 0, 0, 0, 1, 1, 0, 0, 1, 1, 1, 1, 0]",2018,1230,788,112,71,0.0910569105691057,0.0901015228426396
"[1, 0, 0, 1, 0, 1, 0, 0, 0, 0, 0, 0, 0, 0, 1]",712,454,258,47,19,0.10352422907488987,0.07364341085271318
"[0, 0, 0, 1, 1, 1, 0, 0, 1, 0, 1, 0, 0, 0, 0]",269,172,97,21,10,0.12209302325581395,0.10309278350515463
"[0, 0, 0, 0, 0, 0, 1, 1, 1, 0, 0, 1, 0, 1, 0]",265,186,79,16,10,0.08602150537634409,0.12658227848101267
"[0, 0, 0, 0, 0, 0, 0, 0, 0, 1, 1, 1, 0, 0, 1]",1103,834,269,87,25,0.10431654676258993,0.09293680297397769
"[0, 0, 1, 1, 1, 1, 0, 0, 0, 0, 1, 1, 0, 1, 1]",456,210,246,21,23,0.1,0.09349593495934959
"[1, 0, 0, 0, 0, 0, 1, 1, 1, 1, 0, 0, 0, 0, 1]",525,304,221,28,31,0.09210526315789473,0.14027149321266968
"[0, 1, 0, 1, 0, 0, 0, 0, 0, 0, 0, 1, 0, 1, 1]",311,204,107,15,9,0.07352941176470588,0.08411214953271028
"[1, 1, 0, 1, 1, 0, 1, 0, 0, 1, 0, 1, 0, 0, 0]",112,55,57,3,5,0.05454545454545454,0.08771929824561403
"[0, 0, 0, 0, 0, 0, 0, 0, 0, 1, 0, 1, 1, 1, 0]",729,533,196,51,15,0.09568480300187618,0.07653061224489796
"[0, 0, 1, 0, 0, 0, 0, 0, 0, 0, 1, 1, 0, 0, 0]",3087,2358,729,210,71,0.089058524173028,0.09739368998628258
"[0, 1, 0, 0, 0, 1, 0, 1, 0, 1, 1, 0, 1, 1, 1]",145,67,78,5,6,0.07462686567164178,0.07692307692307693
"[0, 1, 0, 1, 0, 1, 0, 0, 0, 0, 1, 0, 1, 0, 0]",244,157,87,12,9,0.07643312101910828,0.10344827586206896
"[1, 0, 1, 1, 0, 0, 0, 1, 0, 1, 0, 1, 0, 0, 0]",142,81,61,7,3,0.08641975308641975,0.04918032786885246
"[0, 0, 1, 0, 0, 0, 1, 0, 0, 0, 1, 0, 1, 0, 0]",514,363,151,34,12,0.09366391184573003,0.07947019867549669
"[0, 0, 1, 0, 1, 0, 1, 1, 1, 0, 0, 1, 0, 0, 0]",154,91,63,16,8,0.17582417582417584,0.12698412698412698
"[0, 0, 1, 0, 1, 1, 1, 0, 0, 1, 1, 1, 1, 1, 0]",177,63,114,2,8,0.031746031746031744,0.07017543859649122
"[1, 1, 0, 1, 0, 1, 1, 0, 1, 1, 0, 1, 1, 0, 0]",152,53,99,4,6,0.07547169811320754,0.06060606060606061
"[0, 0, 0, 1, 1, 1, 1, 0, 1, 0, 1, 1, 0, 1, 1]",182,102,80,8,6,0.0784313725490196,0.075
"[1, 0, 0, 0, 0, 1, 1, 1, 1, 0, 1, 0, 1, 1, 0]",151,46,105,8,7,0.17391304347826086,0.06666666666666667
"[1, 1, 1, 1, 1, 1, 1, 1, 0, 1, 0, 0, 1, 1, 1]",2495,551,1944,39,183,0.07078039927404718,0.0941358024691358
"[0, 0, 1, 0, 1, 1, 1, 0, 1, 0, 1, 1, 1, 1, 0]",146,53,93,7,10,0.1320754716981132,0.10752688172043011
"[0, 1, 0, 1, 1, 0, 0, 1, 0, 1, 1, 1, 0, 1, 0]",112,51,61,6,8,0.11764705882352941,0.13114754098360656
"[1, 0, 0, 0, 1, 1, 1, 0, 1, 0, 1, 0, 1, 1, 0]",110,45,65,3,4,0.06666666666666667,0.06153846153846154
"[1, 0, 1, 1, 1, 0, 1, 1, 0, 1, 1, 0, 1, 1, 1]",535,169,366,28,28,0.16568047337278108,0.07650273224043716
"[1, 1, 1, 1, 0, 1, 1, 1, 0, 1, 1, 0, 1, 1, 0]",489,141,348,13,32,0.09219858156028368,0.09195402298850575
"[0, 0, 0, 0, 1, 0, 1, 0, 1, 0, 0, 1, 1, 0, 0]",314,196,118,20,10,0.10204081632653061,0.0847457627118644
"[0, 0, 0, 0, 1, 0, 0, 0, 0, 1, 0, 1, 0, 1, 0]",488,335,153,31,16,0.09253731343283582,0.10457516339869281
"[0, 0, 0, 0, 0, 1, 0, 1, 0, 1, 0, 1, 0, 1, 1]",190,121,69,10,2,0.08264462809917356,0.028985507246376812
"[1, 1, 1, 0, 0, 0, 0, 1, 1, 1, 1, 1, 1, 1, 0]",764,149,615,14,56,0.09395973154362416,0.0910569105691057
"[1, 0, 1, 1, 0, 1, 1, 0, 1, 1, 0, 1, 1, 1, 0]",213,69,144,8,10,0.11594202898550725,0.06944444444444445
"[1, 1, 0, 0, 1, 1, 0, 1, 1, 0, 1, 1, 0, 1, 1]",275,95,180,8,20,0.08421052631578947,0.1111111111111111
"[0, 0, 0, 0, 0, 1, 0, 1, 0, 0, 0, 1, 1, 0, 0]",726,537,189,49,16,0.09124767225325885,0.08465608465608465
"[1, 0, 1, 1, 0, 1, 1, 1, 1, 1, 1, 0, 1, 1, 1]",1631,374,1257,36,128,0.0962566844919786,0.10182975338106603
"[1, 1, 0, 1, 1, 1, 1, 1, 0, 0, 1, 1, 1, 1, 1]",3110,704,2406,69,244,0.09801136363636363,0.10141313383208644
"[1, 1, 1, 1, 1, 1, 0, 0, 1, 0, 1, 0, 1, 0, 1]",280,98,182,7,13,0.07142857142857142,0.07142857142857142
"[1, 0, 1, 0, 1, 0, 1, 1, 1, 0, 1, 0, 1, 1, 0]",149,62,87,4,9,0.06451612903225806,0.10344827586206896
"[1, 1, 1, 0, 1, 0, 1, 0, 1, 1, 1, 0, 1, 0, 1]",224,67,157,3,20,0.04477611940298507,0.12738853503184713
"[1, 1, 1, 0, 0, 0, 0, 1, 1, 1, 1, 1, 1, 0, 1]",731,147,584,14,48,0.09523809523809523,0.0821917808219178
"[1, 0, 1, 1, 1, 1, 1, 0, 1, 1, 1, 0, 0, 0, 0]",231,99,132,8,13,0.08080808080808081,0.09848484848484848
"[1, 0, 0, 0, 0, 0, 0, 0, 1, 0, 0, 1, 0, 1, 1]",368,196,172,20,12,0.10204081632653061,0.06976744186046512
"[0, 0, 1, 1, 0, 0, 1, 1, 0, 0, 0, 1, 1, 0, 1]",220,120,100,8,9,0.06666666666666667,0.09
"[1, 1, 0, 1, 0, 0, 1, 0, 1, 0, 0, 0, 1, 0, 0]",126,73,53,13,3,0.1780821917808219,0.05660377358490566
"[1, 1, 1, 0, 1, 0, 1, 1, 1, 0, 1, 0, 1, 1, 1]",533,135,398,15,38,0.1111111111111111,0.09547738693467336
"[0, 1, 1, 0, 1, 1, 1, 1, 1, 1, 1, 0, 1, 0, 1]",515,147,368,15,31,0.10204081632653061,0.08423913043478261
"[1, 1, 0, 0, 0, 0, 0, 0, 0, 0, 0, 1, 0, 1, 0]",787,545,242,45,27,0.08256880733944955,0.1115702479338843
"[0, 1, 1, 0, 0, 0, 0, 0, 0, 0, 0, 0, 1, 0, 1]",983,806,177,77,16,0.09553349875930521,0.0903954802259887
"[1, 1, 1, 0, 1, 0, 0, 1, 1, 1, 1, 0, 1, 1, 1]",627,164,463,15,46,0.09146341463414634,0.09935205183585313
"[1, 1, 1, 1, 0, 1, 0, 0, 1, 1, 1, 1, 0, 1, 1]",610,166,444,17,48,0.10240963855421686,0.10810810810810811
"[0, 1, 1, 1, 1, 0, 1, 0, 0, 1, 1, 1, 1, 0, 1]",227,88,139,6,13,0.06818181818181818,0.09352517985611511
"[0, 1, 1, 1, 0, 0, 0, 0, 0, 1, 1, 0, 0, 1, 0]",153,98,55,7,3,0.07142857142857142,0.05454545454545454
"[0, 1, 1, 0, 0, 1, 1, 1, 1, 1, 1, 0, 1, 1, 0]",389,218,171,20,14,0.09174311926605505,0.08187134502923976
"[1, 1, 1, 0, 1, 1, 1, 1, 1, 1, 1, 1, 0, 0, 1]",3133,694,2439,56,203,0.08069164265129683,0.08323083230832308
"[0, 1, 1, 0, 1, 0, 1, 1, 1, 0, 0, 1, 0, 1, 0]",96,46,50,5,5,0.10869565217391304,0.1
"[0, 1, 0, 1, 1, 0, 1, 1, 0, 0, 0, 1, 0, 1, 0]",103,65,38,10,3,0.15384615384615385,0.07894736842105263
"[0, 0, 0, 0, 0, 1, 1, 0, 0, 1, 0, 0, 1, 1, 0]",356,260,96,23,7,0.08846153846153847,0.07291666666666667
"[0, 1, 1, 1, 0, 1, 0, 1, 0, 0, 0, 1, 0, 0, 1]",107,53,54,5,6,0.09433962264150944,0.1111111111111111
"[0, 1, 1, 1, 1, 0, 1, 0, 0, 0, 1, 1, 1, 1, 1]",386,168,218,11,25,0.06547619047619048,0.11467889908256881
"[1, 1, 1, 0, 1, 1, 0, 1, 0, 1, 0, 0, 0, 0, 0]",145,77,68,10,3,0.12987012987012986,0.04411764705882353
"[0, 1, 1, 0, 0, 1, 1, 1, 0, 0, 1, 0, 1, 0, 1]",115,58,57,6,5,0.10344827586206896,0.08771929824561403
"[1, 0, 1, 0, 1, 1, 0, 0, 1, 1, 1, 0, 0, 1, 0]",129,57,72,6,5,0.10526315789473684,0.06944444444444445
"[0, 1, 1, 1, 0, 1, 1, 0, 1, 0, 1, 1, 0, 0, 1]",159,58,101,8,14,0.13793103448275862,0.13861386138613863
"[1, 0, 1, 1, 1, 0, 1, 1, 0, 1, 0, 1, 1, 0, 0]",161,59,102,6,15,0.1016949152542373,0.14705882352941177
"[0, 0, 1, 1, 1, 1, 0, 0, 1, 0, 1, 1, 1, 1, 1]",510,202,308,13,35,0.06435643564356436,0.11363636363636363
"[0, 1, 0, 1, 1, 0, 0, 0, 0, 0, 0, 1, 1, 1, 0]",190,113,77,10,6,0.08849557522123894,0.07792207792207792
"[1, 1, 0, 0, 1, 1, 0, 0, 0, 0, 1, 0, 0, 0, 0]",507,326,181,31,21,0.0950920245398773,0.11602209944751381
"[0, 1, 1, 1, 1, 1, 1, 0, 0, 1, 1, 1, 1, 0, 0]",2249,1561,688,140,51,0.08968609865470852,0.07412790697674419
"[1, 0, 0, 0, 1, 1, 1, 1, 1, 1, 0, 0, 1, 1, 1]",813,269,544,25,48,0.09293680297397769,0.08823529411764706
"[0, 1, 1, 1, 1, 0, 0, 0, 0, 1, 1, 0, 0, 1, 0]",342,262,80,27,6,0.10305343511450382,0.075
"[1, 0, 1, 0, 0, 1, 1, 1, 1, 1, 0, 1, 0, 0, 0]",127,70,57,8,6,0.11428571428571428,0.10526315789473684
"[1, 1, 0, 1, 0, 1, 0, 0, 0, 0, 0, 0, 1, 1, 0]",243,129,114,17,13,0.13178294573643412,0.11403508771929824
"[0, 1, 1, 1, 1, 0, 1, 0, 0, 0, 1, 0, 1, 0, 1]",100,46,54,5,5,0.10869565217391304,0.09259259259259259
"[0, 1, 1, 0, 1, 0, 0, 0, 1, 0, 0, 0, 1, 1, 1]",168,94,74,10,7,0.10638297872340426,0.0945945945945946
"[0, 0, 0, 1, 0, 0, 0, 0, 1, 1, 0, 1, 0, 0, 0]",549,396,153,44,17,0.1111111111111111,0.1111111111111111
"[0, 1, 1, 0, 1, 0, 0, 0, 0, 0, 0, 0, 0, 0, 1]",746,523,223,46,9,0.08795411089866156,0.04035874439461883
"[1, 0, 0, 1, 0, 0, 0, 1, 0, 0, 0, 1, 1, 0, 0]",271,181,90,21,7,0.11602209944751381,0.07777777777777778
"[0, 0, 0, 0, 0, 0, 1, 1, 0, 0, 0, 1, 1, 0, 0]",1095,784,311,74,26,0.09438775510204081,0.08360128617363344
"[1, 0, 0, 1, 1, 1, 0, 0, 1, 1, 1, 0, 0, 1, 1]",207,78,129,11,9,0.14102564102564102,0.06976744186046512
"[1, 0, 0, 1, 1, 0, 1, 0, 1, 0, 1, 0, 0, 1, 1]",136,57,79,7,4,0.12280701754385964,0.05063291139240506
"[0, 0, 1, 0, 1, 1, 1, 0, 0, 1, 1, 1, 0, 0, 1]",129,57,72,7,7,0.12280701754385964,0.09722222222222222
"[0, 0, 0, 0, 1, 1, 0, 0, 0, 1, 0, 1, 1, 0, 0]",328,229,99,29,2,0.12663755458515283,0.020202020202020204
"[0, 1, 1, 0, 1, 1, 0, 1, 1, 0, 0, 0, 0, 0, 0]",261,161,100,16,11,0.09937888198757763,0.11
"[1, 0, 0, 1, 1, 1, 1, 1, 0, 1, 1, 0, 1, 1, 0]",255,81,174,6,24,0.07407407407407407,0.13793103448275862
"[0, 0, 0, 0, 1, 0, 0, 1, 0, 1, 0, 0, 1, 0, 0]",521,361,160,29,18,0.08033240997229917,0.1125
"[0, 0, 0, 0, 0, 0, 0, 1, 0, 0, 1, 0, 1, 0, 0]",1673,1292,381,120,32,0.09287925696594428,0.08398950131233596
"[0, 0, 1, 1, 0, 0, 1, 1, 1, 0, 1, 1, 1, 1, 1]",559,211,348,14,26,0.06635071090047394,0.07471264367816093
"[1, 0, 0, 1, 1, 0, 0, 0, 0, 1, 1, 1, 1, 1, 1]",2314,391,1923,36,180,0.09207161125319693,0.093603744149766
"[1, 1, 0, 1, 0, 1, 1, 0, 0, 0, 1, 0, 1, 1, 1]",172,86,86,6,16,0.06976744186046512,0.18604651162790697
"[1, 1, 1, 1, 1, 0, 1, 0, 1, 1, 0, 0, 0, 1, 0]",139,63,76,5,6,0.07936507936507936,0.07894736842105263
"[0, 0, 1, 1, 1, 1, 1, 1, 1, 1, 1, 0, 1, 1, 0]",763,224,539,22,40,0.09821428571428571,0.07421150278293136
"[1, 1, 0, 0, 0, 1, 1, 0, 0, 1, 1, 1, 1, 1, 1]",820,298,522,23,44,0.07718120805369127,0.0842911877394636
"[0, 1, 1, 0, 0, 0, 1, 1, 0, 0, 1, 1, 1, 1, 1]",407,199,208,16,17,0.08040201005025126,0.08173076923076923
"[1, 0, 0, 1, 0, 0, 1, 1, 0, 0, 0, 0, 1, 0, 0]",272,180,92,12,7,0.06666666666666667,0.07608695652173914
"[0, 1, 0, 0, 1, 0, 0, 1, 1, 0, 0, 0, 0, 1, 0]",270,169,101,18,10,0.10650887573964497,0.09900990099009901
"[1, 0, 1, 0, 0, 1, 0, 0, 1, 1, 0, 0, 0, 0, 1]",248,135,113,18,8,0.13333333333333333,0.07079646017699115
"[0, 0, 0, 1, 0, 0, 0, 1, 1, 1, 1, 1, 1, 1, 1]",399,220,179,16,18,0.07272727272727272,0.1005586592178771
"[1, 1, 1, 0, 0, 0, 1, 0, 0, 0, 0, 0, 1, 1, 1]",239,101,138,12,10,0.1188118811881188,0.07246376811594203
"[0, 0, 1, 1, 1, 1, 1, 1, 1, 0, 0, 1, 1, 1, 0]",384,148,236,13,29,0.08783783783783784,0.1228813559322034
"[0, 1, 0, 0, 1, 0, 0, 1, 1, 0, 1, 0, 0, 0, 0]",225,140,85,10,8,0.07142857142857142,0.09411764705882353
"[1, 1, 0, 1, 0, 1, 0, 0, 1, 0, 0, 1, 1, 0, 0]",146,72,74,5,8,0.06944444444444445,0.10810810810810811
"[1, 0, 1, 0, 1, 1, 1, 0, 1, 0, 1, 0, 0, 1, 0]",106,43,63,4,6,0.09302325581395349,0.09523809523809523
"[1, 0, 0, 0, 1, 0, 1, 0, 1, 1, 1, 0, 1, 0, 1]",103,46,57,4,8,0.08695652173913043,0.14035087719298245
"[0, 0, 0, 1, 0, 0, 1, 1, 0, 0, 1, 1, 0, 1, 1]",149,85,64,7,9,0.08235294117647059,0.140625
"[1, 0, 1, 0, 0, 0, 1, 0, 0, 1, 1, 0, 0, 1, 1]",197,106,91,6,7,0.05660377358490566,0.07692307692307693
"[1, 1, 0, 0, 0, 1, 0, 1, 1, 1, 0, 1, 0, 1, 0]",110,47,63,5,7,0.10638297872340426,0.1111111111111111
"[1, 1, 0, 0, 0, 1, 1, 0, 0, 0, 1, 0, 1, 1, 1]",163,84,79,3,3,0.03571428571428571,0.0379746835443038
"[1, 0, 0, 1, 1, 0, 1, 1, 1, 0, 1, 0, 0, 0, 1]",127,58,69,0,8,0.0,0.11594202898550725
"[0, 1, 0, 0, 1, 0, 0, 1, 1, 0, 1, 1, 1, 0, 1]",109,54,55,7,6,0.12962962962962962,0.10909090909090909
"[0, 1, 1, 1, 1, 0, 0, 1, 1, 1, 1, 1, 1, 0, 1]",1047,561,486,51,38,0.09090909090909091,0.07818930041152264
"[0, 0, 1, 1, 0, 0, 0, 0, 0, 0, 1, 1, 1, 1, 1]",2082,1094,988,101,66,0.0923217550274223,0.06680161943319839
"[0, 1, 1, 0, 0, 0, 0, 0, 1, 0, 1, 0, 0, 0, 1]",267,181,86,19,10,0.10497237569060773,0.11627906976744186
"[0, 0, 1, 1, 1, 1, 0, 0, 0, 0, 1, 0, 1, 1, 1]",417,220,197,23,15,0.10454545454545454,0.07614213197969544
"[1, 1, 0, 0, 0, 1, 0, 1, 0, 0, 0, 1, 0, 0, 0]",285,184,101,11,7,0.059782608695652176,0.06930693069306931
"[1, 0, 0, 1, 1, 0, 1, 1, 1, 1, 1, 1, 0, 0, 1]",386,124,262,15,31,0.12096774193548387,0.1183206106870229
"[1, 1, 0, 0, 1, 1, 0, 1, 1, 1, 1, 1, 1, 0, 0]",419,156,263,13,28,0.08333333333333333,0.10646387832699619
"[0, 0, 0, 1, 0, 1, 0, 1, 1, 0, 0, 1, 1, 0, 1]",120,68,52,6,7,0.08823529411764706,0.1346153846153846
"[0, 0, 1, 1, 1, 1, 0, 1, 1, 1, 0, 1, 0, 0, 0]",139,71,68,12,5,0.16901408450704225,0.07352941176470588
"[0, 1, 1, 1, 1, 0, 0, 1, 0, 0, 1, 1, 1, 1, 0]",221,118,103,9,12,0.07627118644067797,0.11650485436893204
"[0, 0, 1, 0, 0, 1, 0, 0, 1, 0, 0, 1, 0, 0, 0]",497,332,165,39,19,0.11746987951807229,0.11515151515151516
"[1, 0, 0, 0, 0, 0, 1, 0, 0, 1, 0, 0, 1, 0, 0]",486,349,137,45,18,0.12893982808022922,0.13138686131386862
"[0, 1, 1, 0, 1, 0, 0, 0, 0, 0, 0, 1, 1, 0, 0]",468,303,165,25,19,0.08250825082508251,0.11515151515151516
"[0, 0, 0, 0, 1, 1, 0, 1, 0, 1, 1, 0, 0, 0, 0]",384,270,114,36,11,0.13333333333333333,0.09649122807017543
"[1, 0, 0, 1, 0, 1, 0, 0, 0, 0, 0, 1, 1, 0, 0]",388,233,155,27,12,0.11587982832618025,0.07741935483870968
"[0, 1, 0, 0, 0, 0, 1, 0, 0, 1, 0, 1, 0, 0, 0]",568,406,162,49,10,0.1206896551724138,0.06172839506172839
"[0, 0, 0, 0, 0, 0, 1, 1, 0, 1, 0, 0, 0, 0, 0]",2148,1662,486,152,48,0.0914560770156438,0.09876543209876543
"[0, 0, 1, 0, 0, 0, 0, 0, 0, 1, 1, 0, 1, 0, 0]",538,373,165,40,18,0.10723860589812333,0.10909090909090909
"[0, 0, 1, 1, 0, 0, 1, 0, 0, 0, 0, 0, 0, 1, 1]",515,335,180,36,21,0.10746268656716418,0.11666666666666667
"[0, 1, 0, 0, 0, 1, 1, 1, 1, 0, 1, 1, 1, 0, 0]",139,64,75,7,9,0.109375,0.12
"[1, 0, 1, 0, 0, 0, 1, 1, 1, 1, 0, 1, 1, 1, 0]",153,58,95,2,7,0.034482758620689655,0.07368421052631578
"[1, 1, 0, 1, 1, 1, 0, 0, 0, 0, 1, 0, 0, 0, 0]",171,108,63,5,5,0.046296296296296294,0.07936507936507936
"[0, 1, 0, 0, 1, 0, 1, 0, 1, 0, 1, 1, 0, 0, 0]",166,100,66,7,5,0.07,0.07575757575757576
"[0, 0, 0, 1, 0, 0, 1, 1, 0, 0, 1, 0, 0, 1, 0]",234,156,78,20,10,0.1282051282051282,0.1282051282051282
"[1, 0, 0, 0, 0, 1, 0, 0, 1, 1, 0, 0, 1, 0, 0]",265,163,102,13,10,0.07975460122699386,0.09803921568627451
"[1, 1, 1, 0, 0, 0, 0, 1, 0, 0, 1, 1, 0, 0, 1]",198,86,112,3,11,0.03488372093023256,0.09821428571428571
"[1, 0, 1, 0, 0, 0, 0, 0, 0, 0, 0, 0, 1, 0, 1]",610,400,210,26,24,0.065,0.11428571428571428
"[0, 1, 1, 1, 1, 1, 1, 0, 1, 0, 0, 0, 0, 0, 0]",226,145,81,15,3,0.10344827586206896,0.037037037037037035
"[1, 0, 0, 1, 0, 0, 0, 0, 0, 0, 1, 1, 1, 1, 1]",398,197,201,21,24,0.1065989847715736,0.11940298507462686
"[1, 0, 0, 0, 1, 0, 0, 0, 0, 1, 1, 1, 0, 0, 0]",291,184,107,20,6,0.10869565217391304,0.056074766355140186
"[1, 1, 1, 1, 0, 1, 1, 0, 1, 0, 0, 1, 1, 1, 1]",696,188,508,12,51,0.06382978723404255,0.10039370078740158
"[0, 0, 1, 1, 0, 1, 0, 0, 0, 0, 0, 1, 0, 0, 0]",542,400,142,38,18,0.095,0.1267605633802817
"[0, 0, 0, 1, 1, 0, 1, 0, 0, 0, 0, 0, 1, 0, 0]",562,398,164,38,20,0.09547738693467336,0.12195121951219512
"[0, 1, 1, 1, 0, 0, 1, 1, 1, 1, 0, 0, 1, 1, 1]",871,333,538,34,59,0.1021021021021021,0.10966542750929369
"[1, 1, 1, 0, 0, 1, 1, 0, 0, 1, 0, 0, 0, 0, 1]",194,56,138,6,10,0.10714285714285714,0.07246376811594203
"[1, 1, 0, 0, 1, 1, 1, 0, 0, 1, 1, 0, 0, 1, 0]",145,72,73,5,6,0.06944444444444445,0.0821917808219178
"[1, 0, 1, 0, 0, 1, 1, 1, 0, 1, 1, 1, 1, 0, 0]",169,77,92,5,10,0.06493506493506493,0.10869565217391304
"[0, 1, 1, 1, 0, 0, 1, 0, 0, 0, 0, 0, 1, 1, 0]",179,98,81,9,9,0.09183673469387756,0.1111111111111111
"[0, 1, 1, 1, 1, 1, 0, 1, 1, 1, 0, 0, 1, 1, 1]",771,273,498,26,49,0.09523809523809523,0.09839357429718876
"[1, 0, 1, 1, 1, 1, 1, 0, 1, 1, 1, 0, 0, 1, 1]",687,182,505,21,54,0.11538461538461539,0.10693069306930693
"[0, 1, 0, 1, 1, 1, 0, 1, 0, 0, 1, 0, 1, 0, 0]",103,55,48,7,6,0.12727272727272726,0.125
"[0, 1, 0, 1, 0, 1, 1, 1, 0, 1, 0, 0, 1, 0, 1]",99,48,51,7,5,0.14583333333333334,0.09803921568627451
"[0, 1, 0, 0, 0, 0, 0, 1, 1, 1, 1, 0, 1, 0, 1]",129,70,59,9,3,0.12857142857142856,0.05084745762711865
"[1, 0, 0, 1, 0, 0, 0, 0, 0, 1, 1, 1, 1, 0, 1]",130,70,60,8,9,0.11428571428571428,0.15
"[1, 0, 1, 0, 0, 1, 0, 1, 0, 1, 0, 1, 1, 0, 1]",92,44,48,3,5,0.06818181818181818,0.10416666666666667
"[1, 1, 1, 1, 0, 1, 0, 1, 0, 1, 1, 0, 1, 1, 1]",575,184,391,14,36,0.07608695652173914,0.09207161125319693
"[0, 1, 1, 1, 1, 1, 1, 1, 0, 1, 0, 1, 0, 1, 1]",617,219,398,26,37,0.1187214611872146,0.09296482412060302
"[1, 0, 1, 1, 1, 1, 0, 1, 1, 1, 0, 1, 1, 1, 1]",1729,387,1342,29,133,0.07493540051679587,0.09910581222056632
"[1, 1, 1, 1, 1, 0, 0, 1, 1, 0, 1, 1, 1, 1, 0]",723,185,538,18,59,0.0972972972972973,0.10966542750929369
"[1, 0, 1, 1, 1, 1, 1, 1, 0, 0, 1, 1, 1, 1, 0]",1197,365,832,30,79,0.0821917808219178,0.09495192307692307
"[0, 0, 1, 0, 0, 0, 0, 0, 0, 1, 0, 0, 1, 1, 0]",656,451,205,32,13,0.07095343680709534,0.06341463414634146
"[0, 1, 1, 1, 0, 0, 1, 0, 1, 1, 1, 0, 1, 0, 0]",101,40,61,3,8,0.075,0.13114754098360656
"[0, 0, 1, 0, 1, 1, 1, 0, 1, 1, 1, 0, 1, 1, 1]",266,99,167,7,18,0.0707070707070707,0.10778443113772455
"[0, 1, 0, 0, 0, 0, 0, 0, 0, 0, 1, 1, 0, 0, 0]",3644,2745,899,244,94,0.08888888888888889,0.10456062291434928
"[1, 0, 0, 1, 0, 0, 1, 0, 1, 0, 0, 1, 1, 0, 0]",149,71,78,8,5,0.11267605633802817,0.0641025641025641
"[0, 0, 1, 0, 1, 0, 0, 0, 1, 0, 0, 1, 0, 0, 1]",238,138,100,12,13,0.08695652173913043,0.13
"[0, 0, 1, 0, 1, 0, 0, 1, 1, 1, 1, 0, 0, 0, 0]",344,211,133,25,13,0.11848341232227488,0.09774436090225563
"[1, 1, 0, 1, 0, 1, 1, 0, 0, 0, 1, 0, 1, 0, 0]",83,45,38,4,3,0.08888888888888889,0.07894736842105263
"[1, 1, 1, 1, 1, 0, 0, 1, 0, 1, 1, 0, 1, 1, 1]",706,169,537,18,55,0.10650887573964497,0.10242085661080075
"[1, 1, 1, 0, 0, 0, 1, 0, 0, 1, 1, 1, 1, 1, 0]",183,57,126,2,14,0.03508771929824561,0.1111111111111111
"[0, 0, 1, 1, 1, 1, 1, 0, 0, 0, 0, 1, 1, 0, 0]",458,241,217,14,23,0.058091286307053944,0.10599078341013825
"[1, 0, 1, 0, 0, 1, 1, 1, 1, 1, 0, 0, 0, 0, 1]",211,87,124,9,11,0.10344827586206896,0.08870967741935484
"[0, 1, 0, 0, 1, 1, 0, 0, 1, 0, 0, 0, 0, 1, 0]",238,165,73,15,5,0.09090909090909091,0.0684931506849315
"[1, 1, 1, 1, 1, 0, 0, 0, 0, 0, 0, 0, 1, 0, 0]",313,114,199,10,19,0.08771929824561403,0.09547738693467336
"[1, 1, 0, 0, 1, 1, 1, 1, 0, 0, 1, 0, 0, 1, 1]",342,140,202,11,23,0.07857142857142857,0.11386138613861387
"[0, 0, 1, 1, 1, 1, 1, 0, 1, 1, 0, 1, 1, 1, 1]",731,238,493,24,41,0.10084033613445378,0.08316430020283976
"[1, 1, 1, 0, 1, 0, 0, 1, 1, 1, 1, 1, 0, 1, 1]",581,158,423,11,21,0.06962025316455696,0.04964539007092199
"[0, 0, 1, 1, 1, 1, 1, 1, 0, 0, 1, 1, 0, 1, 1]",720,264,456,21,43,0.07954545454545454,0.09429824561403509
"[1, 1, 0, 0, 0, 1, 1, 1, 1, 1, 0, 1, 1, 1, 1]",747,216,531,22,42,0.10185185185185185,0.07909604519774012
"[0, 0, 1, 1, 1, 0, 0, 0, 1, 1, 1, 1, 1, 0, 1]",164,72,92,4,8,0.05555555555555555,0.08695652173913043
"[0, 0, 0, 0, 1, 1, 1, 0, 0, 0, 1, 1, 1, 1, 1]",314,179,135,14,10,0.0782122905027933,0.07407407407407407
"[1, 1, 1, 1, 0, 1, 0, 0, 0, 0, 0, 0, 0, 1, 1]",264,130,134,13,13,0.1,0.09701492537313433
"[1, 1, 0, 1, 1, 1, 0, 1, 1, 0, 1, 0, 1, 1, 1]",539,144,395,16,43,0.1111111111111111,0.10886075949367088
"[0, 1, 0, 1, 0, 1, 1, 1, 0, 1, 0, 0, 1, 1, 1]",172,82,90,8,11,0.0975609756097561,0.12222222222222222
"[0, 1, 1, 0, 1, 0, 1, 1, 1, 1, 1, 0, 1, 1, 1]",614,170,444,13,38,0.07647058823529412,0.08558558558558559
"[1, 1, 0, 1, 1, 0, 1, 0, 1, 1, 1, 1, 1, 0, 1]",520,148,372,14,27,0.0945945945945946,0.07258064516129033
"[0, 0, 0, 1, 1, 1, 1, 1, 0, 1, 1, 0, 1, 0, 1]",167,86,81,5,6,0.05813953488372093,0.07407407407407407
"[1, 1, 0, 0, 0, 1, 1, 1, 1, 1, 0, 1, 1, 0, 1]",249,85,164,7,19,0.08235294117647059,0.11585365853658537
"[0, 1, 0, 0, 0, 1, 0, 0, 0, 1, 1, 1, 1, 1, 0]",132,74,58,4,7,0.05405405405405406,0.1206896551724138
"[1, 0, 0, 0, 0, 0, 1, 1, 0, 0, 0, 1, 0, 0, 0]",588,390,198,30,13,0.07692307692307693,0.06565656565656566
"[1, 0, 1, 0, 1, 0, 0, 0, 0, 0, 1, 0, 1, 0, 1]",131,76,55,6,5,0.07894736842105263,0.09090909090909091
"[1, 1, 0, 1, 1, 1, 1, 0, 1, 1, 1, 1, 0, 0, 0]",372,122,250,10,23,0.08196721311475409,0.092
"[0, 1, 1, 1, 0, 1, 0, 1, 1, 0, 0, 1, 1, 0, 0]",223,111,112,20,18,0.18018018018018017,0.16071428571428573
"[0, 1, 0, 0, 0, 0, 0, 0, 1, 1, 1, 1, 1, 1, 1]",626,315,311,26,32,0.08253968253968254,0.10289389067524116
"[1, 0, 1, 0, 0, 1, 0, 1, 0, 1, 0, 1, 0, 0, 0]",157,99,58,10,5,0.10101010101010101,0.08620689655172414
"[0, 0, 0, 1, 0, 1, 0, 0, 1, 0, 1, 0, 1, 0, 1]",153,99,54,9,5,0.09090909090909091,0.09259259259259259
"[1, 1, 1, 0, 0, 0, 1, 0, 1, 0, 0, 1, 0, 1, 0]",115,65,50,7,10,0.1076923076923077,0.2
"[0, 1, 0, 0, 0, 1, 1, 0, 0, 1, 1, 1, 1, 1, 0]",166,82,84,10,9,0.12195121951219512,0.10714285714285714
"[0, 0, 1, 0, 0, 0, 0, 0, 0, 1, 0, 0, 0, 1, 1]",755,536,219,55,18,0.10261194029850747,0.0821917808219178
"[0, 1, 1, 0, 1, 1, 1, 0, 1, 0, 0, 1, 1, 0, 1]",137,54,83,7,12,0.12962962962962962,0.14457831325301204
"[0, 1, 1, 1, 1, 1, 1, 1, 0, 1, 0, 1, 0, 0, 0]",173,81,92,9,6,0.1111111111111111,0.06521739130434782
"[0, 0, 0, 0, 1, 1, 1, 1, 0, 1, 1, 1, 0, 1, 1]",241,115,126,10,14,0.08695652173913043,0.1111111111111111
"[1, 1, 1, 1, 1, 0, 0, 0, 0, 1, 1, 1, 1, 0, 1]",748,147,601,20,62,0.1360544217687075,0.10316139767054909
"[1, 1, 1, 0, 0, 0, 1, 1, 1, 0, 0, 0, 0, 0, 0]",367,195,172,19,20,0.09743589743589744,0.11627906976744186
"[0, 1, 0, 0, 1, 1, 1, 0, 0, 0, 1, 1, 1, 0, 0]",130,70,60,9,7,0.12857142857142856,0.11666666666666667
"[1, 0, 0, 0, 1, 0, 1, 0, 1, 1, 0, 0, 0, 1, 0]",132,74,58,3,5,0.04054054054054054,0.08620689655172414
"[0, 1, 0, 0, 1, 1, 0, 1, 0, 1, 0, 1, 0, 0, 0]",148,78,70,4,10,0.05128205128205128,0.14285714285714285
"[1, 0, 1, 1, 0, 1, 1, 1, 1, 1, 0, 0, 1, 1, 1]",840,242,598,18,58,0.0743801652892562,0.09698996655518395
"[0, 1, 1, 0, 1, 1, 1, 0, 0, 0, 1, 1, 1, 1, 1]",361,144,217,6,23,0.041666666666666664,0.10599078341013825
"[1, 0, 0, 1, 1, 0, 1, 1, 1, 0, 0, 0, 1, 1, 1]",216,76,140,12,10,0.15789473684210525,0.07142857142857142
"[1, 0, 0, 0, 0, 1, 0, 0, 0, 0, 0, 0, 1, 1, 0]",861,590,271,61,27,0.10338983050847457,0.0996309963099631
"[0, 1, 1, 1, 1, 1, 1, 0, 0, 1, 0, 1, 0, 1, 1]",338,174,164,15,16,0.08620689655172414,0.0975609756097561
"[1, 0, 0, 1, 1, 1, 1, 1, 1, 0, 0, 1, 0, 1, 0]",224,80,144,3,13,0.0375,0.09027777777777778
"[1, 1, 0, 0, 0, 0, 1, 1, 0, 0, 1, 1, 0, 0, 0]",1822,1063,759,87,75,0.08184383819379115,0.09881422924901186
"[0, 1, 0, 1, 1, 1, 1, 0, 0, 1, 1, 1, 1, 1, 1]",1254,421,833,32,71,0.07600950118764846,0.08523409363745499
"[0, 1, 1, 1, 1, 1, 1, 0, 1, 1, 0, 0, 1, 0, 1]",247,106,141,15,16,0.14150943396226415,0.11347517730496454
"[0, 0, 1, 1, 0, 0, 0, 1, 0, 1, 0, 0, 1, 1, 1]",242,134,108,20,8,0.14925373134328357,0.07407407407407407
"[0, 0, 0, 1, 1, 0, 0, 0, 1, 0, 1, 0, 0, 1, 1]",240,168,72,18,8,0.10714285714285714,0.1111111111111111
"[0, 1, 0, 1, 0, 1, 1, 0, 0, 0, 0, 1, 1, 0, 0]",302,182,120,15,11,0.08241758241758242,0.09166666666666666
"[0, 0, 1, 0, 1, 0, 1, 1, 0, 0, 0, 0, 1, 1, 0]",241,149,92,11,5,0.0738255033557047,0.05434782608695652
"[1, 1, 0, 0, 0, 0, 0, 0, 0, 1, 1, 0, 0, 1, 0]",340,217,123,20,9,0.09216589861751152,0.07317073170731707
"[1, 1, 1, 0, 0, 1, 0, 1, 1, 1, 1, 1, 1, 1, 0]",590,187,403,23,38,0.12299465240641712,0.09429280397022333
"[0, 1, 0, 1, 1, 0, 0, 0, 0, 1, 1, 1, 1, 1, 1]",550,237,313,15,24,0.06329113924050633,0.07667731629392971
"[0, 1, 1, 0, 0, 1, 0, 0, 1, 1, 1, 1, 1, 0, 1]",169,71,98,8,13,0.11267605633802817,0.1326530612244898
"[1, 1, 0, 1, 1, 0, 0, 1, 0, 0, 1, 1, 1, 1, 1]",373,144,229,15,23,0.10416666666666667,0.10043668122270742
"[1, 0, 1, 0, 1, 1, 0, 0, 1, 0, 1, 0, 0, 0, 0]",155,90,65,5,7,0.05555555555555555,0.1076923076923077
"[1, 0, 1, 1, 0, 1, 0, 1, 1, 0, 0, 1, 0, 1, 0]",117,50,67,3,9,0.06,0.13432835820895522
"[0, 1, 1, 1, 1, 0, 1, 1, 0, 1, 0, 1, 1, 0, 0]",168,67,101,4,11,0.05970149253731343,0.10891089108910891
"[1, 1, 0, 1, 1, 1, 1, 0, 1, 1, 0, 1, 0, 1, 1]",534,164,370,24,34,0.14634146341463414,0.0918918918918919
"[1, 1, 1, 0, 1, 1, 1, 1, 0, 1, 1, 0, 1, 0, 1]",492,141,351,17,33,0.12056737588652482,0.09401709401709402
"[0, 1, 0, 0, 1, 0, 1, 1, 0, 0, 0, 1, 0, 1, 1]",104,58,46,8,7,0.13793103448275862,0.15217391304347827
"[0, 1, 0, 1, 1, 1, 0, 0, 0, 0, 0, 1, 0, 0, 0]",240,155,85,18,9,0.11612903225806452,0.10588235294117647
"[0, 0, 1, 1, 1, 0, 0, 1, 0, 1, 1, 1, 0, 0, 0]",127,82,45,14,2,0.17073170731707318,0.044444444444444446
"[0, 1, 1, 0, 0, 0, 1, 1, 1, 0, 0, 1, 0, 1, 1]",140,78,62,6,6,0.07692307692307693,0.0967741935483871
"[0, 1, 0, 1, 0, 0, 0, 0, 0, 0, 0, 1, 1, 0, 0]",961,686,275,62,25,0.09037900874635568,0.09090909090909091
"[0, 1, 1, 0, 0, 0, 0, 0, 0, 0, 1, 0, 1, 0, 0]",682,541,141,48,8,0.08872458410351201,0.05673758865248227
"[1, 1, 0, 0, 1, 1, 1, 0, 1, 1, 0, 1, 0, 0, 1]",188,72,116,7,11,0.09722222222222222,0.09482758620689655
"[0, 1, 1, 0, 1, 1, 1, 0, 1, 1, 1, 1, 1, 0, 1]",498,156,342,15,33,0.09615384615384616,0.09649122807017543
"[0, 0, 0, 1, 1, 1, 1, 1, 1, 1, 0, 0, 0, 0, 0]",389,245,144,25,14,0.10204081632653061,0.09722222222222222
"[1, 1, 0, 0, 1, 0, 0, 1, 0, 0, 1, 1, 0, 0, 0]",204,124,80,11,4,0.08870967741935484,0.05
"[1, 1, 1, 0, 0, 1, 0, 0, 1, 0, 0, 1, 1, 0, 0]",161,75,86,4,12,0.05333333333333334,0.13953488372093023
"[1, 0, 0, 0, 1, 1, 0, 0, 0, 0, 1, 1, 1, 0, 1]",154,70,84,4,11,0.05714285714285714,0.13095238095238096
"[0, 0, 0, 1, 1, 0, 0, 1, 1, 0, 1, 0, 1, 1, 1]",291,212,79,17,6,0.08018867924528301,0.0759493670886076
"[0, 1, 1, 1, 1, 0, 0, 0, 0, 1, 0, 1, 1, 1, 0]",134,81,53,9,4,0.1111111111111111,0.07547169811320754
"[0, 1, 0, 1, 0, 1, 1, 1, 1, 0, 0, 0, 1, 1, 0]",142,74,68,10,6,0.13513513513513514,0.08823529411764706
"[1, 1, 1, 0, 1, 0, 1, 0, 0, 0, 1, 1, 1, 1, 0]",175,64,111,4,5,0.0625,0.04504504504504504
"[0, 0, 0, 1, 1, 1, 1, 0, 1, 1, 0, 1, 1, 1, 0]",175,87,88,9,14,0.10344827586206896,0.1590909090909091
"[1, 0, 1, 0, 0, 0, 1, 1, 1, 0, 0, 0, 0, 1, 1]",206,99,107,15,14,0.15151515151515152,0.1308411214953271
"[1, 0, 0, 0, 0, 1, 0, 0, 0, 1, 0, 1, 1, 0, 0]",261,166,95,12,11,0.07228915662650602,0.11578947368421053
"[0, 0, 1, 0, 0, 0, 0, 1, 0, 0, 0, 1, 0, 1, 1]",269,186,83,15,4,0.08064516129032258,0.04819277108433735
"[0, 1, 0, 0, 0, 1, 1, 1, 1, 1, 0, 0, 1, 0, 0]",161,74,87,6,9,0.08108108108108109,0.10344827586206896
"[1, 1, 0, 1, 1, 0, 0, 1, 1, 1, 0, 1, 0, 1, 1]",245,97,148,15,12,0.15463917525773196,0.08108108108108109
"[0, 0, 0, 1, 0, 1, 1, 0, 0, 1, 0, 1, 1, 1, 1]",152,79,73,7,9,0.08860759493670886,0.1232876712328767
"[0, 0, 1, 1, 1, 1, 1, 1, 1, 1, 1, 1, 0, 1, 0]",970,293,677,36,51,0.12286689419795221,0.07533234859675036
"[1, 0, 0, 0, 0, 1, 1, 1, 1, 1, 0, 0, 0, 0, 0]",356,164,192,7,13,0.042682926829268296,0.06770833333333333
"[1, 1, 0, 0, 0, 0, 0, 1, 0, 0, 0, 0, 1, 0, 0]",589,394,195,40,18,0.10152284263959391,0.09230769230769231
"[1, 1, 1, 1, 1, 1, 0, 1, 0, 0, 1, 0, 1, 1, 1]",649,190,459,21,44,0.11052631578947368,0.09586056644880174
"[0, 0, 1, 1, 0, 0, 0, 0, 0, 1, 0, 1, 1, 1, 1]",312,179,133,17,7,0.09497206703910614,0.05263157894736842
"[1, 1, 1, 0, 1, 1, 1, 0, 0, 0, 1, 1, 0, 1, 0]",138,58,80,4,10,0.06896551724137931,0.125
"[1, 1, 0, 1, 0, 0, 1, 0, 1, 1, 1, 1, 0, 0, 0]",147,73,74,6,9,0.0821917808219178,0.12162162162162163
"[1, 1, 0, 0, 0, 1, 1, 0, 0, 0, 1, 0, 1, 1, 0]",132,62,70,9,5,0.14516129032258066,0.07142857142857142
"[1, 1, 1, 0, 0, 1, 1, 0, 0, 0, 1, 1, 0, 0, 0]",218,91,127,3,17,0.03296703296703297,0.13385826771653545
"[0, 0, 0, 0, 1, 1, 1, 1, 0, 0, 1, 1, 1, 1, 1]",2313,998,1315,89,133,0.08917835671342686,0.10114068441064639
"[1, 1, 0, 0, 1, 1, 0, 0, 0, 0, 0, 0, 1, 1, 1]",2103,1094,1009,95,84,0.08683729433272395,0.08325074331020813
"[1, 1, 1, 0, 1, 1, 1, 1, 0, 0, 1, 1, 0, 0, 0]",373,159,214,15,20,0.09433962264150944,0.09345794392523364
"[1, 0, 1, 1, 0, 1, 1, 1, 0, 1, 1, 1, 0, 1, 0]",200,66,134,7,12,0.10606060606060606,0.08955223880597014
"[1, 1, 0, 1, 1, 1, 1, 0, 0, 1, 1, 1, 1, 0, 0]",750,259,491,25,44,0.09652509652509653,0.08961303462321792
"[0, 0, 0, 1, 0, 1, 0, 1, 1, 1, 1, 1, 1, 1, 1]",398,173,225,20,21,0.11560693641618497,0.09333333333333334
"[1, 0, 1, 1, 1, 1, 1, 0, 0, 0, 1, 1, 0, 0, 0]",161,75,86,4,9,0.05333333333333334,0.10465116279069768
"[0, 1, 1, 0, 0, 1, 0, 0, 1, 1, 0, 0, 1, 1, 0]",202,122,80,8,3,0.06557377049180328,0.0375
"[0, 0, 0, 0, 1, 1, 0, 0, 1, 1, 0, 0, 1, 0, 0]",555,367,188,36,24,0.09809264305177112,0.1276595744680851
"[0, 1, 0, 1, 1, 0, 1, 0, 0, 0, 0, 1, 1, 0, 0]",206,118,88,6,11,0.05084745762711865,0.125
"[0, 0, 0, 1, 0, 1, 0, 0, 0, 1, 0, 1, 1, 0, 0]",286,192,94,14,7,0.07291666666666667,0.07446808510638298
"[1, 0, 0, 0, 1, 0, 1, 0, 0, 0, 1, 0, 1, 1, 0]",147,84,63,9,6,0.10714285714285714,0.09523809523809523
"[0, 1, 0, 0, 0, 1, 0, 0, 0, 0, 0, 0, 0, 0, 0]",8669,7131,1538,651,151,0.09129154396297855,0.09817945383615084
"[0, 1, 1, 1, 0, 0, 0, 1, 0, 0, 0, 0, 0, 1, 0]",239,161,78,16,13,0.09937888198757763,0.16666666666666666
"[1, 0, 0, 0, 0, 0, 0, 0, 1, 1, 0, 0, 0, 0, 1]",1240,795,445,81,38,0.1018867924528302,0.0853932584269663
"[0, 1, 1, 0, 0, 0, 0, 1, 0, 1, 1, 0, 1, 1, 0]",120,77,43,6,4,0.07792207792207792,0.09302325581395349
"[0, 1, 1, 0, 0, 0, 1, 1, 1, 1, 0, 1, 0, 0, 0]",143,90,53,10,5,0.1111111111111111,0.09433962264150944
"[1, 0, 0, 1, 1, 1, 1, 1, 1, 1, 1, 0, 0, 0, 1]",689,152,537,16,48,0.10526315789473684,0.0893854748603352
"[1, 0, 0, 0, 0, 0, 1, 1, 0, 0, 1, 1, 1, 1, 1]",525,245,280,24,28,0.09795918367346938,0.1
"[0, 1, 1, 0, 0, 0, 0, 1, 0, 0, 0, 0, 0, 1, 1]",521,378,143,38,13,0.10052910052910052,0.09090909090909091
"[1, 1, 0, 1, 1, 0, 1, 0, 0, 1, 0, 0, 1, 1, 0]",146,65,81,3,9,0.046153846153846156,0.1111111111111111
"[1, 0, 1, 1, 1, 1, 0, 1, 1, 0, 1, 0, 0, 1, 0]",134,58,76,4,5,0.06896551724137931,0.06578947368421052
"[1, 1, 1, 1, 1, 1, 1, 1, 1, 0, 0, 1, 0, 0, 1]",978,246,732,28,71,0.11382113821138211,0.09699453551912568
"[1, 0, 0, 1, 0, 1, 0, 1, 1, 0, 1, 1, 1, 1, 0]",169,73,96,5,10,0.0684931506849315,0.10416666666666667
"[0, 1, 0, 1, 1, 0, 1, 1, 1, 1, 1, 0, 1, 0, 0]",130,59,71,4,14,0.06779661016949153,0.19718309859154928
"[0, 1, 1, 1, 0, 1, 1, 0, 0, 0, 1, 1, 1, 0, 1]",165,63,102,6,17,0.09523809523809523,0.16666666666666666
"[1, 0, 1, 1, 1, 0, 1, 1, 0, 0, 0, 1, 1, 1, 0]",163,63,100,4,13,0.06349206349206349,0.13
"[1, 1, 0, 0, 0, 0, 0, 0, 1, 0, 1, 1, 0, 1, 0]",179,98,81,5,8,0.05102040816326531,0.09876543209876543
"[1, 1, 1, 1, 0, 1, 0, 1, 0, 0, 1, 0, 1, 0, 0]",124,53,71,4,11,0.07547169811320754,0.15492957746478872
"[1, 0, 0, 1, 0, 1, 1, 0, 0, 1, 0, 1, 1, 0, 1]",81,38,43,4,6,0.10526315789473684,0.13953488372093023
"[0, 1, 1, 1, 1, 0, 0, 0, 1, 1, 1, 1, 0, 1, 0]",170,82,88,7,13,0.08536585365853659,0.14772727272727273
"[1, 1, 1, 0, 1, 1, 1, 1, 0, 0, 0, 1, 1, 1, 1]",800,219,581,19,58,0.0867579908675799,0.09982788296041308
"[0, 1, 0, 0, 0, 1, 1, 0, 1, 0, 0, 0, 0, 1, 0]",229,148,81,21,6,0.14189189189189189,0.07407407407407407
"[0, 1, 1, 0, 1, 0, 0, 0, 0, 0, 1, 0, 0, 0, 1]",256,163,93,18,8,0.11042944785276074,0.08602150537634409
"[1, 1, 0, 0, 0, 0, 0, 0, 1, 1, 1, 0, 0, 0, 1]",326,167,159,15,19,0.08982035928143713,0.11949685534591195
"[0, 1, 0, 1, 0, 0, 1, 0, 0, 0, 0, 0, 0, 0, 0]",2009,1519,490,170,55,0.1119157340355497,0.11224489795918367
"[0, 0, 1, 0, 1, 0, 1, 1, 1, 0, 0, 1, 1, 1, 0]",114,55,59,4,4,0.07272727272727272,0.06779661016949153
"[1, 0, 1, 1, 0, 1, 0, 1, 0, 1, 1, 1, 1, 0, 0]",187,76,111,9,5,0.11842105263157894,0.04504504504504504
"[0, 1, 0, 0, 0, 1, 1, 1, 0, 1, 1, 0, 1, 1, 0]",110,46,64,2,7,0.043478260869565216,0.109375
"[1, 1, 0, 0, 0, 0, 1, 1, 1, 1, 0, 0, 0, 0, 1]",1602,818,784,68,75,0.08312958435207823,0.09566326530612244
"[1, 1, 0, 1, 0, 0, 0, 1, 1, 0, 0, 0, 0, 0, 0]",517,326,191,15,21,0.046012269938650305,0.1099476439790576
"[0, 1, 1, 0, 0, 1, 1, 0, 1, 1, 1, 0, 1, 1, 0]",125,52,73,5,8,0.09615384615384616,0.1095890410958904
"[1, 0, 0, 0, 0, 1, 1, 1, 1, 1, 0, 1, 0, 1, 1]",270,78,192,8,17,0.10256410256410256,0.08854166666666667
"[0, 1, 1, 0, 0, 1, 1, 1, 1, 1, 1, 0, 0, 1, 1]",2275,1664,611,142,62,0.08533653846153846,0.10147299509001637
"[0, 1, 0, 0, 0, 0, 0, 0, 0, 0, 1, 1, 1, 0, 1]",316,201,115,20,3,0.09950248756218906,0.02608695652173913
"[0, 0, 1, 0, 0, 0, 1, 1, 0, 1, 0, 0, 1, 0, 0]",231,149,82,12,9,0.08053691275167785,0.10975609756097561
"[1, 0, 0, 0, 1, 0, 0, 0, 1, 1, 0, 1, 0, 0, 1]",129,70,59,3,6,0.04285714285714286,0.1016949152542373
"[1, 0, 0, 0, 0, 0, 1, 0, 1, 0, 0, 1, 0, 1, 1]",194,101,93,6,9,0.0594059405940594,0.0967741935483871
"[0, 1, 1, 0, 0, 0, 0, 0, 1, 0, 1, 0, 0, 1, 0]",264,181,83,10,14,0.055248618784530384,0.1686746987951807
"[1, 1, 0, 0, 1, 1, 0, 0, 0, 1, 1, 1, 0, 1, 1]",241,102,139,10,10,0.09803921568627451,0.07194244604316546
"[1, 1, 1, 0, 0, 1, 1, 1, 1, 1, 1, 1, 0, 1, 0]",895,166,729,10,66,0.060240963855421686,0.09053497942386832
"[1, 1, 0, 1, 0, 0, 1, 0, 1, 0, 1, 1, 1, 1, 0]",150,55,95,5,11,0.09090909090909091,0.11578947368421053
"[1, 0, 1, 1, 0, 1, 1, 1, 1, 1, 1, 1, 0, 0, 0]",392,137,255,12,22,0.08759124087591241,0.08627450980392157
"[1, 0, 0, 0, 0, 1, 0, 0, 0, 1, 0, 0, 0, 0, 0]",1737,1305,432,130,42,0.09961685823754789,0.09722222222222222
"[0, 0, 1, 1, 0, 0, 1, 0, 1, 1, 0, 0, 0, 0, 1]",205,116,89,7,8,0.0603448275862069,0.0898876404494382
"[0, 1, 1, 1, 0, 1, 0, 1, 1, 0, 1, 0, 0, 0, 1]",99,51,48,3,5,0.058823529411764705,0.10416666666666667
"[1, 1, 1, 1, 0, 1, 0, 0, 0, 1, 1, 0, 0, 0, 1]",133,51,82,4,9,0.0784313725490196,0.10975609756097561
"[1, 1, 0, 1, 1, 0, 0, 1, 1, 1, 1, 1, 1, 0, 0]",781,275,506,27,58,0.09818181818181818,0.11462450592885376
"[0, 1, 1, 0, 0, 0, 1, 1, 1, 1, 1, 1, 1, 0, 1]",286,115,171,10,10,0.08695652173913043,0.05847953216374269
"[0, 0, 0, 1, 0, 1, 1, 1, 0, 1, 1, 0, 0, 0, 1]",140,78,62,9,6,0.11538461538461539,0.0967741935483871
"[0, 1, 1, 0, 0, 1, 1, 1, 0, 1, 1, 0, 1, 1, 1]",288,142,146,16,13,0.11267605633802817,0.08904109589041095
"[1, 1, 1, 1, 0, 1, 0, 1, 1, 1, 0, 1, 1, 1, 0]",545,139,406,11,42,0.07913669064748201,0.10344827586206896
"[1, 1, 1, 1, 0, 1, 1, 0, 0, 0, 0, 0, 0, 1, 1]",352,134,218,11,22,0.08208955223880597,0.10091743119266056
"[1, 1, 1, 1, 0, 1, 1, 0, 0, 1, 1, 1, 1, 0, 0]",625,211,414,22,38,0.10426540284360189,0.09178743961352658
"[1, 0, 1, 0, 0, 0, 1, 0, 1, 1, 1, 1, 0, 1, 1]",156,77,79,7,9,0.09090909090909091,0.11392405063291139
"[0, 1, 0, 1, 0, 0, 0, 1, 0, 1, 1, 1, 1, 0, 1]",119,47,72,2,8,0.0425531914893617,0.1111111111111111
"[0, 0, 0, 1, 0, 0, 0, 0, 0, 1, 0, 1, 1, 0, 0]",600,436,164,36,16,0.08256880733944955,0.0975609756097561
"[1, 0, 1, 0, 0, 0, 1, 0, 0, 1, 0, 0, 0, 0, 1]",220,147,73,14,10,0.09523809523809523,0.136986301369863
"[0, 1, 1, 0, 1, 1, 1, 1, 1, 1, 1, 1, 0, 0, 0]",485,192,293,15,38,0.078125,0.1296928327645051
"[0, 0, 0, 1, 0, 1, 1, 0, 1, 0, 0, 0, 1, 0, 0]",216,140,76,10,11,0.07142857142857142,0.14473684210526316
"[1, 0, 0, 1, 0, 0, 0, 0, 0, 0, 1, 0, 1, 1, 0]",246,152,94,24,12,0.15789473684210525,0.1276595744680851
"[0, 1, 1, 0, 1, 1, 1, 0, 0, 0, 0, 0, 1, 0, 0]",164,101,63,10,9,0.09900990099009901,0.14285714285714285
"[0, 0, 1, 1, 0, 1, 1, 1, 0, 0, 0, 0, 0, 1, 0]",150,79,71,6,4,0.0759493670886076,0.056338028169014086
"[0, 1, 1, 0, 1, 0, 1, 0, 0, 1, 1, 0, 0, 1, 0]",122,75,47,8,2,0.10666666666666667,0.0425531914893617
"[0, 1, 0, 1, 1, 0, 1, 0, 1, 0, 0, 1, 1, 0, 0]",133,74,59,10,4,0.13513513513513514,0.06779661016949153
"[1, 0, 0, 1, 0, 1, 0, 1, 1, 0, 1, 0, 1, 0, 0]",102,57,45,9,3,0.15789473684210525,0.06666666666666667
"[0, 1, 0, 1, 0, 0, 0, 1, 1, 0, 0, 1, 0, 1, 0]",114,62,52,6,4,0.0967741935483871,0.07692307692307693
"[1, 1, 0, 0, 1, 0, 0, 1, 0, 0, 0, 0, 1, 0, 0]",251,162,89,14,3,0.08641975308641975,0.033707865168539325
"[1, 1, 0, 1, 1, 1, 0, 1, 0, 1, 0, 0, 0, 1, 0]",111,59,52,10,7,0.1694915254237288,0.1346153846153846
"[1, 0, 1, 1, 0, 0, 0, 0, 1, 1, 1, 1, 0, 0, 1]",416,192,224,22,25,0.11458333333333333,0.11160714285714286
"[1, 0, 0, 0, 1, 0, 0, 0, 0, 1, 1, 1, 0, 1, 1]",147,78,69,11,8,0.14102564102564102,0.11594202898550725
"[0, 1, 0, 0, 0, 1, 0, 0, 0, 0, 1, 1, 1, 0, 1]",170,94,76,15,14,0.1595744680851064,0.18421052631578946
"[1, 1, 0, 1, 1, 1, 1, 1, 1, 0, 0, 1, 1, 0, 0]",862,292,570,25,54,0.08561643835616438,0.09473684210526316
"[1, 1, 1, 0, 1, 0, 1, 1, 1, 1, 1, 0, 1, 0, 0]",251,86,165,3,19,0.03488372093023256,0.11515151515151516
"[0, 0, 0, 0, 1, 1, 1, 0, 0, 0, 0, 1, 1, 1, 1]",434,271,163,23,14,0.08487084870848709,0.08588957055214724
"[1, 1, 1, 1, 1, 0, 1, 1, 0, 1, 0, 0, 1, 0, 1]",222,73,149,7,18,0.0958904109589041,0.12080536912751678
"[1, 0, 1, 1, 0, 1, 0, 1, 1, 0, 1, 0, 1, 0, 1]",118,46,72,7,3,0.15217391304347827,0.041666666666666664
"[1, 1, 0, 0, 0, 1, 0, 1, 0, 1, 0, 0, 1, 0, 0]",170,110,60,10,8,0.09090909090909091,0.13333333333333333
"[1, 0, 1, 0, 0, 0, 0, 0, 0, 1, 0, 0, 0, 1, 0]",515,376,139,30,11,0.0797872340425532,0.07913669064748201
"[0, 0, 0, 0, 1, 0, 0, 1, 1, 0, 1, 0, 0, 0, 0]",613,435,178,33,20,0.07586206896551724,0.11235955056179775
"[0, 0, 0, 0, 0, 1, 0, 0, 1, 1, 0, 1, 0, 0, 0]",586,419,167,41,20,0.09785202863961814,0.11976047904191617
"[0, 0, 1, 0, 0, 1, 1, 1, 1, 0, 0, 0, 0, 0, 0]",799,532,267,51,32,0.09586466165413533,0.1198501872659176
"[0, 0, 0, 1, 0, 0, 1, 1, 0, 0, 0, 1, 0, 1, 1]",169,110,59,17,6,0.15454545454545454,0.1016949152542373
"[0, 1, 1, 0, 0, 0, 0, 1, 0, 0, 1, 1, 0, 0, 0]",363,254,109,17,14,0.06692913385826772,0.12844036697247707
"[1, 1, 1, 1, 0, 1, 1, 1, 1, 0, 1, 0, 1, 1, 1]",1744,418,1326,43,135,0.10287081339712918,0.10180995475113122
"[0, 1, 1, 0, 0, 0, 0, 1, 1, 0, 1, 0, 0, 0, 0]",395,278,117,23,10,0.08273381294964029,0.08547008547008547
"[1, 1, 0, 1, 0, 0, 0, 0, 1, 0, 1, 0, 1, 1, 1]",117,59,58,4,5,0.06779661016949153,0.08620689655172414
"[0, 0, 0, 1, 0, 0, 0, 1, 1, 0, 1, 0, 0, 1, 1]",158,100,58,9,6,0.09,0.10344827586206896
"[1, 0, 1, 0, 1, 1, 1, 0, 0, 1, 1, 0, 1, 1, 1]",268,100,168,2,15,0.02,0.08928571428571429
"[0, 1, 1, 1, 1, 1, 1, 0, 1, 0, 1, 1, 1, 0, 0]",304,120,184,13,21,0.10833333333333334,0.11413043478260869
"[0, 0, 1, 0, 0, 0, 1, 1, 1, 1, 1, 1, 0, 1, 0]",114,55,59,4,8,0.07272727272727272,0.13559322033898305
"[0, 1, 0, 0, 1, 0, 1, 0, 1, 1, 1, 1, 0, 0, 1]",158,74,84,8,8,0.10810810810810811,0.09523809523809523
"[1, 0, 0, 0, 1, 1, 1, 1, 1, 0, 1, 0, 0, 1, 0]",119,54,65,3,5,0.05555555555555555,0.07692307692307693
"[0, 0, 0, 1, 1, 0, 0, 0, 1, 0, 1, 1, 1, 1, 1]",245,155,90,14,9,0.09032258064516129,0.1
"[1, 1, 1, 0, 1, 1, 0, 0, 1, 1, 1, 1, 0, 0, 1]",587,182,405,10,44,0.054945054945054944,0.10864197530864197
"[1, 1, 0, 1, 1, 1, 0, 0, 1, 0, 0, 1, 1, 1, 1]",331,119,212,13,16,0.1092436974789916,0.07547169811320754
"[1, 1, 1, 1, 0, 1, 1, 1, 0, 1, 1, 1, 0, 0, 1]",669,197,472,25,30,0.12690355329949238,0.0635593220338983
"[0, 1, 0, 1, 1, 1, 0, 1, 1, 1, 1, 1, 0, 1, 1]",539,154,385,17,36,0.11038961038961038,0.09350649350649351
"[1, 1, 0, 1, 1, 1, 0, 1, 1, 1, 0, 1, 1, 1, 0]",469,130,339,5,38,0.038461538461538464,0.11209439528023599
"[1, 1, 0, 1, 1, 1, 0, 0, 1, 0, 1, 1, 0, 1, 1]",272,112,160,10,18,0.08928571428571429,0.1125
"[0, 1, 1, 0, 0, 0, 0, 1, 0, 1, 0, 0, 1, 1, 0]",212,143,69,15,6,0.1048951048951049,0.08695652173913043
"[1, 0, 0, 1, 1, 1, 1, 0, 0, 0, 0, 0, 1, 1, 0]",265,91,174,8,24,0.08791208791208792,0.13793103448275862
"[0, 0, 1, 0, 1, 0, 1, 0, 0, 0, 1, 1, 0, 1, 0]",136,85,51,8,5,0.09411764705882353,0.09803921568627451
"[0, 1, 0, 0, 0, 0, 0, 0, 1, 0, 0, 1, 0, 1, 0]",485,330,155,37,18,0.11212121212121212,0.11612903225806452
"[0, 1, 0, 0, 1, 0, 1, 1, 1, 0, 0, 1, 1, 0, 1]",102,48,54,5,7,0.10416666666666667,0.12962962962962962
"[0, 1, 1, 1, 0, 1, 1, 0, 1, 1, 1, 0, 0, 0, 0]",165,89,76,9,2,0.10112359550561797,0.02631578947368421
"[1, 1, 1, 0, 1, 1, 1, 0, 1, 1, 0, 1, 1, 1, 0]",508,129,379,17,39,0.13178294573643412,0.10290237467018469
"[0, 0, 0, 0, 0, 0, 0, 0, 1, 1, 1, 0, 0, 1, 1]",774,556,218,51,19,0.09172661870503597,0.0871559633027523
"[1, 1, 1, 1, 1, 0, 1, 1, 0, 0, 0, 1, 1, 0, 1]",232,84,148,4,12,0.047619047619047616,0.08108108108108109
"[0, 1, 1, 0, 1, 1, 0, 1, 1, 0, 1, 0, 1, 1, 1]",249,92,157,12,13,0.13043478260869565,0.08280254777070063
"[1, 0, 1, 1, 1, 0, 1, 1, 0, 0, 1, 1, 0, 0, 1]",244,95,149,10,15,0.10526315789473684,0.10067114093959731
"[1, 0, 0, 1, 0, 1, 1, 1, 1, 0, 0, 1, 1, 1, 0]",174,72,102,7,11,0.09722222222222222,0.10784313725490197
"[1, 1, 1, 0, 1, 0, 1, 1, 1, 1, 0, 1, 1, 1, 0]",520,129,391,12,36,0.09302325581395349,0.09207161125319693
"[0, 0, 1, 0, 1, 1, 0, 1, 1, 1, 1, 1, 1, 1, 1]",796,274,522,21,62,0.07664233576642336,0.11877394636015326
"[1, 1, 0, 1, 1, 1, 1, 0, 1, 0, 1, 1, 1, 1, 0]",518,144,374,16,30,0.1111111111111111,0.08021390374331551
"[1, 0, 1, 1, 1, 0, 1, 1, 1, 0, 1, 0, 1, 1, 1]",562,142,420,10,34,0.07042253521126761,0.08095238095238096
"[0, 1, 1, 0, 0, 1, 1, 0, 0, 0, 0, 1, 0, 0, 0]",500,393,107,38,15,0.09669211195928754,0.14018691588785046
"[1, 0, 1, 1, 1, 1, 0, 1, 1, 0, 0, 0, 0, 0, 0]",197,101,96,10,4,0.09900990099009901,0.041666666666666664
"[0, 1, 0, 1, 1, 0, 0, 1, 1, 0, 0, 1, 0, 1, 0]",110,60,50,5,3,0.08333333333333333,0.06
"[1, 0, 1, 0, 1, 0, 1, 0, 0, 1, 0, 1, 0, 0, 1]",102,54,48,7,6,0.12962962962962962,0.125
"[0, 1, 1, 0, 1, 1, 1, 1, 0, 0, 1, 1, 1, 1, 1]",1117,375,742,40,78,0.10666666666666667,0.10512129380053908
"[0, 1, 0, 0, 0, 1, 0, 1, 1, 0, 1, 0, 1, 1, 0]",93,49,44,2,4,0.04081632653061224,0.09090909090909091
"[0, 0, 1, 1, 1, 1, 0, 0, 1, 1, 1, 1, 0, 1, 1]",740,275,465,33,47,0.12,0.1010752688172043
"[1, 0, 1, 0, 1, 0, 1, 1, 1, 1, 1, 1, 0, 1, 0]",219,79,140,8,13,0.10126582278481013,0.09285714285714286
"[0, 1, 1, 0, 0, 0, 0, 0, 0, 0, 1, 0, 0, 1, 0]",622,468,154,43,7,0.09188034188034189,0.045454545454545456
"[0, 1, 1, 1, 1, 0, 0, 0, 1, 0, 1, 0, 0, 0, 0]",214,134,80,7,12,0.05223880597014925,0.15
"[1, 1, 0, 1, 1, 1, 0, 0, 0, 0, 0, 0, 0, 0, 1]",316,158,158,11,9,0.06962025316455696,0.056962025316455694
"[1, 1, 0, 1, 1, 0, 1, 1, 1, 0, 1, 1, 1, 0, 0]",254,110,144,14,10,0.12727272727272726,0.06944444444444445
"[0, 0, 1, 0, 0, 1, 1, 1, 1, 0, 1, 1, 0, 1, 1]",161,68,93,11,8,0.16176470588235295,0.08602150537634409
"[1, 0, 1, 0, 1, 0, 1, 0, 1, 1, 0, 1, 1, 1, 0]",111,48,63,5,8,0.10416666666666667,0.12698412698412698
"[1, 0, 1, 0, 0, 0, 0, 0, 0, 1, 1, 1, 0, 1, 1]",135,70,65,5,4,0.07142857142857142,0.06153846153846154
"[0, 0, 1, 0, 1, 0, 0, 0, 0, 0, 0, 1, 1, 1, 0]",309,194,115,22,13,0.1134020618556701,0.11304347826086956
"[0, 0, 1, 1, 1, 0, 0, 1, 0, 0, 1, 0, 0, 0, 0]",263,186,77,22,6,0.11827956989247312,0.07792207792207792
"[0, 1, 0, 0, 0, 0, 0, 0, 1, 1, 1, 0, 0, 1, 0]",257,162,95,21,14,0.12962962962962962,0.14736842105263157
"[1, 0, 0, 1, 1, 0, 0, 1, 1, 0, 0, 0, 0, 1, 0]",392,124,268,11,22,0.08870967741935484,0.08208955223880597
"[1, 1, 1, 0, 0, 0, 1, 1, 1, 0, 0, 0, 0, 1, 0]",136,69,67,8,6,0.11594202898550725,0.08955223880597014
"[0, 1, 0, 0, 0, 0, 0, 0, 1, 1, 0, 0, 1, 0, 1]",267,175,92,21,8,0.12,0.08695652173913043
"[0, 1, 0, 0, 0, 0, 0, 1, 1, 1, 0, 0, 0, 1, 1]",209,129,80,13,4,0.10077519379844961,0.05
"[1, 1, 1, 1, 1, 0, 1, 0, 0, 0, 1, 1, 0, 0, 1]",223,87,136,8,13,0.09195402298850575,0.09558823529411764
"[1, 1, 1, 1, 0, 1, 1, 1, 0, 1, 0, 1, 0, 0, 1]",253,91,162,5,14,0.054945054945054944,0.08641975308641975
"[0, 0, 0, 0, 1, 1, 1, 1, 1, 1, 0, 1, 1, 0, 1]",291,133,158,11,20,0.08270676691729323,0.12658227848101267
"[1, 1, 0, 1, 0, 0, 1, 1, 0, 0, 0, 1, 1, 1, 1]",227,84,143,9,19,0.10714285714285714,0.13286713286713286
"[1, 0, 1, 1, 0, 1, 0, 1, 1, 1, 0, 0, 0, 1, 0]",104,50,54,2,5,0.04,0.09259259259259259
"[0, 0, 0, 0, 0, 0, 1, 0, 1, 0, 0, 0, 0, 0, 1]",1891,1467,424,127,36,0.08657123381049761,0.08490566037735849
"[1, 0, 0, 0, 0, 0, 0, 0, 0, 0, 1, 0, 0, 1, 1]",1051,611,440,62,51,0.10147299509001637,0.1159090909090909
"[0, 1, 1, 0, 0, 1, 1, 1, 1, 1, 0, 1, 0, 1, 1]",372,191,181,21,17,0.1099476439790576,0.09392265193370165
"[0, 1, 0, 0, 1, 1, 0, 1, 0, 1, 0, 1, 0, 1, 1]",107,53,54,6,5,0.11320754716981132,0.09259259259259259
"[0, 0, 0, 1, 1, 0, 1, 1, 0, 1, 0, 0, 1, 1, 0]",140,82,58,11,5,0.13414634146341464,0.08620689655172414
"[1, 1, 0, 1, 1, 1, 1, 1, 0, 0, 0, 1, 1, 0, 1]",240,81,159,4,15,0.04938271604938271,0.09433962264150944
"[1, 1, 1, 0, 0, 0, 0, 0, 1, 1, 0, 1, 1, 1, 1]",305,94,211,10,26,0.10638297872340426,0.12322274881516587
"[0, 0, 1, 0, 1, 1, 1, 1, 1, 1, 1, 1, 0, 0, 0]",373,182,191,17,20,0.09340659340659341,0.10471204188481675
"[1, 1, 0, 0, 0, 1, 0, 0, 1, 0, 1, 0, 0, 1, 0]",140,80,60,4,4,0.05,0.06666666666666667
"[1, 0, 1, 1, 1, 0, 1, 0, 1, 1, 1, 1, 1, 1, 1]",1991,454,1537,39,151,0.08590308370044053,0.09824333116460637
"[1, 1, 1, 1, 1, 1, 1, 1, 0, 0, 1, 0, 1, 1, 0]",726,215,511,23,48,0.10697674418604651,0.09393346379647749
"[1, 0, 0, 0, 0, 0, 0, 0, 1, 0, 1, 0, 0, 0, 1]",561,357,204,38,26,0.10644257703081232,0.12745098039215685
"[0, 0, 1, 0, 1, 1, 0, 0, 0, 0, 0, 0, 0, 1, 1]",458,290,168,27,17,0.09310344827586207,0.10119047619047619
"[1, 0, 1, 1, 1, 1, 1, 1, 1, 0, 0, 1, 0, 0, 0]",182,79,103,5,12,0.06329113924050633,0.11650485436893204
"[1, 1, 1, 1, 1, 0, 1, 1, 0, 1, 1, 0, 0, 0, 1]",278,87,191,10,16,0.11494252873563218,0.08376963350785341
"[1, 1, 0, 1, 0, 0, 1, 0, 1, 1, 1, 1, 1, 1, 0]",272,92,180,7,22,0.07608695652173914,0.12222222222222222
"[1, 0, 1, 1, 0, 1, 0, 0, 1, 1, 1, 1, 0, 1, 0]",146,65,81,3,5,0.046153846153846156,0.06172839506172839
"[0, 0, 0, 1, 0, 1, 0, 0, 0, 0, 1, 1, 1, 0, 0]",285,176,109,17,13,0.09659090909090909,0.11926605504587157
"[1, 0, 0, 1, 0, 1, 1, 0, 1, 0, 1, 0, 1, 0, 1]",105,45,60,8,6,0.17777777777777778,0.1
"[1, 0, 1, 0, 1, 0, 1, 0, 0, 0, 0, 1, 0, 0, 1]",140,88,52,9,3,0.10227272727272728,0.057692307692307696
"[1, 0, 0, 0, 1, 0, 0, 0, 0, 0, 0, 1, 1, 0, 0]",931,639,292,54,36,0.08450704225352113,0.1232876712328767
"[1, 1, 1, 0, 0, 0, 1, 0, 0, 0, 0, 0, 0, 1, 1]",299,159,140,17,18,0.1069182389937107,0.12857142857142856
"[0, 0, 1, 1, 1, 0, 1, 1, 0, 0, 0, 0, 0, 0, 0]",413,262,151,13,19,0.04961832061068702,0.12582781456953643
"[0, 1, 1, 1, 0, 0, 0, 1, 1, 1, 0, 0, 1, 0, 0]",112,57,55,5,8,0.08771929824561403,0.14545454545454545
"[0, 0, 1, 0, 1, 0, 1, 0, 0, 0, 0, 0, 1, 0, 0]",497,343,154,37,13,0.10787172011661808,0.08441558441558442
"[1, 1, 0, 1, 1, 1, 0, 0, 1, 1, 0, 0, 1, 1, 1]",673,221,452,26,41,0.11764705882352941,0.09070796460176991
"[0, 0, 1, 1, 0, 1, 0, 1, 0, 0, 0, 1, 0, 1, 1]",120,62,58,6,10,0.0967741935483871,0.1724137931034483
"[0, 1, 0, 1, 1, 1, 0, 0, 0, 1, 1, 0, 1, 0, 1]",109,52,57,7,6,0.1346153846153846,0.10526315789473684
"[1, 0, 0, 0, 1, 0, 0, 0, 0, 1, 0, 0, 1, 0, 1]",208,120,88,9,8,0.075,0.09090909090909091
"[1, 1, 0, 0, 1, 0, 0, 1, 0, 1, 0, 0, 1, 1, 0]",123,58,65,3,4,0.05172413793103448,0.06153846153846154
"[0, 1, 0, 1, 1, 1, 0, 0, 1, 0, 1, 0, 0, 1, 1]",125,54,71,5,9,0.09259259259259259,0.1267605633802817
"[1, 0, 1, 1, 0, 1, 1, 1, 1, 1, 1, 0, 1, 0, 0]",238,80,158,11,18,0.1375,0.11392405063291139
"[1, 1, 0, 1, 1, 0, 1, 1, 1, 1, 1, 1, 0, 1, 0]",493,145,348,10,30,0.06896551724137931,0.08620689655172414
"[1, 0, 1, 0, 0, 0, 1, 0, 1, 0, 1, 0, 0, 1, 0]",143,82,61,11,3,0.13414634146341464,0.04918032786885246
"[1, 0, 0, 0, 1, 1, 0, 0, 1, 1, 0, 0, 0, 0, 1]",468,270,198,30,24,0.1111111111111111,0.12121212121212122
"[1, 1, 1, 0, 0, 0, 1, 0, 1, 1, 0, 1, 0, 1, 0]",103,53,50,5,5,0.09433962264150944,0.1
"[1, 1, 0, 1, 1, 1, 0, 0, 1, 1, 1, 1, 0, 0, 0]",378,163,215,21,16,0.12883435582822086,0.07441860465116279
"[1, 0, 1, 0, 1, 0, 0, 1, 1, 1, 1, 1, 1, 0, 1]",258,97,161,7,15,0.07216494845360824,0.09316770186335403
"[0, 1, 1, 1, 1, 1, 1, 0, 0, 1, 0, 1, 0, 1, 0]",174,85,89,8,5,0.09411764705882353,0.056179775280898875
"[1, 0, 1, 1, 1, 0, 1, 0, 0, 1, 0, 1, 1, 1, 0]",128,53,75,3,11,0.05660377358490566,0.14666666666666667
"[0, 0, 0, 1, 0, 1, 1, 1, 0, 1, 0, 0, 1, 0, 1]",95,48,47,6,3,0.125,0.06382978723404255
"[0, 0, 1, 0, 0, 1, 0, 0, 0, 0, 1, 0, 1, 0, 1]",276,173,103,17,11,0.09826589595375723,0.10679611650485436
"[0, 0, 0, 0, 1, 0, 0, 1, 0, 0, 0, 0, 1, 0, 1]",515,370,145,37,16,0.1,0.1103448275862069
"[0, 0, 1, 1, 0, 0, 0, 0, 1, 0, 1, 0, 0, 0, 1]",323,200,123,24,12,0.12,0.0975609756097561
"[1, 0, 1, 0, 0, 0, 0, 0, 1, 1, 1, 1, 0, 0, 1]",295,156,139,23,15,0.14743589743589744,0.1079136690647482
"[1, 1, 1, 1, 1, 1, 0, 1, 1, 1, 1, 0, 1, 0, 0]",612,195,417,26,38,0.13333333333333333,0.09112709832134293
"[0, 0, 0, 0, 0, 1, 1, 0, 0, 0, 1, 0, 1, 0, 0]",692,514,178,42,15,0.08171206225680934,0.08426966292134831
"[1, 0, 0, 1, 1, 1, 1, 1, 1, 1, 0, 0, 1, 0, 0]",231,78,153,5,16,0.0641025641025641,0.10457516339869281
"[1, 0, 1, 0, 1, 0, 1, 0, 0, 1, 1, 1, 1, 1, 0]",162,70,92,8,9,0.11428571428571428,0.09782608695652174
"[1, 0, 1, 1, 1, 0, 1, 1, 0, 1, 0, 1, 0, 1, 0]",139,58,81,5,7,0.08620689655172414,0.08641975308641975
"[1, 1, 0, 0, 0, 0, 1, 1, 1, 1, 0, 0, 1, 1, 1]",2279,900,1379,76,142,0.08444444444444445,0.10297316896301668
"[1, 1, 0, 0, 0, 0, 1, 1, 0, 1, 0, 0, 1, 1, 1]",282,146,136,13,11,0.08904109589041095,0.08088235294117647
"[1, 1, 1, 1, 0, 1, 0, 1, 1, 1, 1, 1, 1, 0, 0]",885,233,652,16,77,0.06866952789699571,0.11809815950920245
"[1, 1, 1, 1, 0, 0, 1, 0, 0, 1, 1, 0, 1, 1, 1]",342,127,215,10,14,0.07874015748031496,0.06511627906976744
"[1, 1, 1, 0, 1, 1, 1, 0, 1, 1, 1, 0, 1, 0, 0]",226,78,148,6,15,0.07692307692307693,0.10135135135135136
"[0, 1, 1, 0, 1, 1, 1, 1, 1, 1, 1, 0, 1, 1, 1]",1669,399,1270,49,123,0.12280701754385964,0.09685039370078741
"[1, 0, 1, 1, 1, 1, 0, 1, 0, 1, 1, 0, 1, 1, 1]",556,176,380,14,45,0.07954545454545454,0.11842105263157894
"[1, 0, 1, 1, 1, 1, 0, 0, 1, 1, 0, 1, 1, 0, 0]",187,84,103,5,9,0.05952380952380952,0.08737864077669903
"[1, 0, 0, 1, 0, 1, 1, 1, 1, 0, 0, 1, 1, 0, 1]",171,62,109,7,13,0.11290322580645161,0.11926605504587157
"[0, 1, 0, 0, 0, 0, 1, 0, 0, 0, 1, 0, 1, 0, 1]",229,139,90,19,5,0.1366906474820144,0.05555555555555555
"[0, 0, 0, 1, 1, 0, 1, 1, 1, 1, 0, 0, 1, 1, 1]",316,144,172,12,18,0.08333333333333333,0.10465116279069768
"[0, 1, 0, 1, 0, 1, 1, 1, 0, 0, 0, 0, 0, 0, 0]",435,291,144,28,19,0.09621993127147767,0.13194444444444445
"[1, 1, 0, 1, 0, 1, 0, 1, 1, 1, 0, 0, 0, 0, 0]",149,76,73,7,5,0.09210526315789473,0.0684931506849315
"[0, 0, 1, 0, 0, 1, 1, 0, 0, 1, 0, 1, 1, 0, 0]",148,85,63,8,7,0.09411764705882353,0.1111111111111111
"[0, 1, 0, 0, 1, 0, 0, 1, 1, 0, 0, 1, 0, 1, 1]",132,74,58,5,4,0.06756756756756757,0.06896551724137931
"[0, 0, 1, 0, 0, 0, 0, 1, 0, 1, 0, 0, 0, 0, 0]",1699,1304,395,116,39,0.08895705521472393,0.09873417721518987
"[0, 1, 1, 0, 1, 0, 1, 1, 0, 1, 0, 1, 1, 1, 0]",132,57,75,3,5,0.05263157894736842,0.06666666666666667
"[1, 0, 1, 0, 1, 1, 0, 1, 0, 1, 1, 0, 1, 0, 1]",132,55,77,4,10,0.07272727272727272,0.12987012987012986
"[0, 1, 0, 1, 0, 0, 1, 1, 0, 1, 0, 1, 1, 0, 1]",102,52,50,2,5,0.038461538461538464,0.1
"[1, 1, 1, 0, 0, 1, 0, 1, 1, 1, 0, 0, 0, 0, 1]",179,82,97,3,9,0.036585365853658534,0.09278350515463918
"[1, 1, 0, 1, 1, 1, 1, 0, 1, 1, 1, 0, 1, 0, 1]",493,160,333,17,32,0.10625,0.0960960960960961
"[0, 1, 1, 0, 1, 1, 1, 1, 0, 1, 1, 1, 0, 1, 0]",247,82,165,10,14,0.12195121951219512,0.08484848484848485
"[1, 0, 0, 0, 1, 0, 0, 1, 1, 0, 1, 1, 1, 1, 0]",120,54,66,7,8,0.12962962962962962,0.12121212121212122
"[1, 1, 1, 1, 1, 0, 1, 0, 0, 0, 1, 0, 0, 1, 1]",178,69,109,3,12,0.043478260869565216,0.11009174311926606
"[1, 1, 1, 1, 0, 0, 1, 0, 1, 0, 0, 1, 0, 0, 0]",136,73,63,3,6,0.0410958904109589,0.09523809523809523
"[1, 1, 1, 0, 1, 0, 1, 1, 0, 0, 0, 0, 1, 0, 1]",126,51,75,7,5,0.13725490196078433,0.06666666666666667
"[0, 0, 0, 0, 0, 1, 1, 1, 0, 1, 0, 1, 1, 0, 0]",195,132,63,12,6,0.09090909090909091,0.09523809523809523
"[0, 1, 1, 1, 0, 0, 0, 0, 1, 1, 1, 0, 0, 1, 1]",184,96,88,8,13,0.08333333333333333,0.14772727272727273
"[1, 1, 1, 1, 1, 0, 0, 0, 0, 1, 1, 1, 0, 0, 0]",281,92,189,11,12,0.11956521739130435,0.06349206349206349
"[0, 0, 0, 0, 1, 0, 1, 0, 0, 1, 0, 0, 1, 0, 0]",549,397,152,31,14,0.07808564231738035,0.09210526315789473
"[0, 0, 1, 0, 1, 0, 1, 0, 0, 1, 0, 1, 0, 0, 0]",242,148,94,17,6,0.11486486486486487,0.06382978723404255
"[0, 1, 0, 0, 0, 1, 0, 0, 0, 1, 0, 1, 0, 1, 0]",220,141,79,12,8,0.0851063829787234,0.10126582278481013
"[1, 0, 1, 1, 1, 0, 1, 0, 0, 0, 0, 1, 1, 0, 0]",184,92,92,8,6,0.08695652173913043,0.06521739130434782
"[0, 0, 1, 1, 1, 0, 0, 0, 1, 0, 1, 1, 1, 0, 1]",108,46,62,3,1,0.06521739130434782,0.016129032258064516
"[0, 1, 0, 0, 0, 0, 0, 1, 0, 1, 1, 1, 0, 1, 1]",140,75,65,7,10,0.09333333333333334,0.15384615384615385
"[0, 0, 0, 0, 0, 1, 1, 0, 0, 0, 0, 0, 1, 1, 0]",1077,854,223,64,23,0.07494145199063232,0.1031390134529148
"[1, 1, 1, 0, 1, 1, 1, 0, 1, 0, 1, 1, 0, 0, 0]",168,78,90,7,10,0.08974358974358974,0.1111111111111111
"[0, 1, 1, 1, 1, 0, 1, 1, 1, 0, 1, 0, 1, 1, 0]",224,69,155,2,18,0.028985507246376812,0.11612903225806452
"[0, 0, 0, 1, 1, 0, 0, 0, 1, 1, 1, 1, 0, 1, 1]",161,96,65,12,6,0.125,0.09230769230769231
"[1, 0, 0, 1, 0, 0, 1, 1, 1, 0, 1, 1, 1, 1, 1]",294,97,197,9,27,0.09278350515463918,0.13705583756345177
"[1, 1, 0, 0, 1, 0, 0, 1, 1, 1, 0, 1, 1, 1, 1]",309,105,204,9,20,0.08571428571428572,0.09803921568627451
"[1, 0, 0, 0, 1, 1, 1, 0, 1, 1, 0, 0, 1, 0, 0]",115,67,48,9,1,0.13432835820895522,0.020833333333333332
"[0, 0, 1, 1, 1, 0, 0, 0, 1, 1, 1, 0, 1, 1, 0]",112,56,56,3,6,0.05357142857142857,0.10714285714285714
"[1, 1, 1, 0, 0, 1, 0, 1, 1, 1, 1, 1, 0, 1, 1]",562,165,397,11,33,0.06666666666666667,0.08312342569269521
"[0, 0, 0, 0, 1, 0, 0, 0, 0, 1, 1, 0, 1, 1, 0]",294,191,103,24,4,0.1256544502617801,0.038834951456310676
"[0, 0, 0, 0, 0, 1, 0, 0, 0, 0, 1, 1, 0, 1, 1]",332,231,101,19,7,0.08225108225108226,0.06930693069306931
"[1, 0, 1, 0, 1, 0, 0, 1, 1, 1, 0, 1, 1, 1, 1]",259,88,171,13,14,0.14772727272727273,0.08187134502923976
"[0, 0, 1, 0, 0, 1, 0, 1, 0, 0, 0, 1, 0, 0, 0]",510,363,147,41,14,0.11294765840220386,0.09523809523809523
"[1, 1, 0, 1, 1, 1, 1, 1, 1, 1, 0, 0, 0, 0, 1]",737,223,514,20,50,0.08968609865470852,0.09727626459143969
"[0, 1, 1, 0, 1, 1, 0, 0, 1, 0, 1, 1, 1, 1, 0]",130,55,75,2,5,0.03636363636363636,0.06666666666666667
"[1, 0, 1, 1, 0, 1, 1, 0, 0, 1, 0, 1, 1, 1, 1]",262,85,177,4,14,0.047058823529411764,0.07909604519774012
"[1, 1, 1, 1, 0, 1, 1, 0, 1, 1, 0, 0, 1, 0, 1]",244,78,166,4,17,0.05128205128205128,0.10240963855421686
"[0, 1, 1, 1, 1, 1, 0, 1, 1, 0, 1, 1, 0, 0, 1]",290,119,171,12,18,0.10084033613445378,0.10526315789473684
"[0, 0, 0, 1, 0, 1, 1, 1, 0, 0, 0, 0, 0, 1, 1]",227,139,88,14,4,0.10071942446043165,0.045454545454545456
"[0, 0, 0, 1, 0, 1, 1, 0, 0, 1, 0, 0, 0, 1, 0]",226,125,101,12,11,0.096,0.10891089108910891
"[0, 0, 1, 0, 1, 0, 0, 1, 1, 0, 0, 1, 1, 0, 0]",357,216,141,24,16,0.1111111111111111,0.11347517730496454
"[1, 1, 1, 0, 0, 0, 1, 0, 1, 0, 0, 1, 1, 0, 0]",146,64,82,11,11,0.171875,0.13414634146341464
"[0, 1, 1, 1, 0, 0, 0, 1, 0, 1, 0, 0, 1, 1, 0]",123,69,54,6,4,0.08695652173913043,0.07407407407407407
"[0, 0, 0, 1, 1, 1, 0, 0, 0, 1, 0, 1, 0, 0, 1]",185,99,86,10,6,0.10101010101010101,0.06976744186046512
"[1, 0, 1, 1, 0, 0, 0, 1, 0, 1, 0, 0, 1, 1, 0]",123,65,58,5,4,0.07692307692307693,0.06896551724137931
"[0, 0, 1, 1, 1, 1, 1, 0, 0, 1, 0, 0, 0, 1, 0]",130,82,48,9,5,0.10975609756097561,0.10416666666666667
"[0, 1, 0, 0, 1, 0, 0, 1, 1, 0, 0, 0, 0, 1, 1]",360,207,153,10,23,0.04830917874396135,0.1503267973856209
"[1, 1, 0, 1, 0, 0, 1, 0, 0, 1, 0, 0, 1, 1, 0]",126,65,61,4,6,0.06153846153846154,0.09836065573770492
"[1, 0, 0, 1, 1, 0, 0, 0, 1, 1, 1, 1, 1, 1, 0]",249,84,165,9,17,0.10714285714285714,0.10303030303030303
"[1, 1, 0, 0, 0, 1, 1, 0, 0, 0, 0, 1, 0, 0, 0]",313,202,111,17,11,0.08415841584158416,0.0990990990990991
"[0, 0, 1, 1, 0, 1, 1, 1, 1, 0, 1, 1, 1, 1, 1]",703,224,479,18,48,0.08035714285714286,0.10020876826722339
"[0, 0, 0, 1, 1, 0, 1, 1, 1, 1, 0, 1, 1, 1, 1]",316,125,191,6,16,0.048,0.08376963350785341
"[1, 0, 1, 0, 1, 0, 1, 1, 0, 0, 0, 1, 1, 0, 1]",100,38,62,5,4,0.13157894736842105,0.06451612903225806
"[1, 0, 0, 0, 0, 1, 0, 1, 1, 0, 0, 1, 1, 0, 1]",116,57,59,3,8,0.05263157894736842,0.13559322033898305
"[1, 1, 1, 0, 0, 0, 0, 1, 0, 1, 1, 0, 0, 1, 1]",214,86,128,10,12,0.11627906976744186,0.09375
"[1, 1, 1, 0, 1, 1, 0, 1, 1, 1, 1, 0, 1, 1, 0]",529,157,372,16,37,0.10191082802547771,0.09946236559139784
"[0, 0, 1, 1, 1, 0, 1, 1, 1, 0, 1, 1, 0, 1, 1]",245,92,153,7,14,0.07608695652173914,0.0915032679738562
"[0, 0, 1, 0, 0, 1, 0, 1, 1, 0, 1, 0, 0, 1, 1]",133,74,59,7,6,0.0945945945945946,0.1016949152542373
"[0, 0, 0, 1, 1, 0, 0, 1, 1, 0, 1, 1, 0, 0, 1]",214,144,70,8,7,0.05555555555555555,0.1
"[1, 1, 1, 1, 1, 0, 0, 1, 1, 1, 1, 1, 0, 0, 0]",551,149,402,9,37,0.06040268456375839,0.09203980099502487
"[0, 0, 0, 1, 1, 0, 1, 1, 1, 1, 1, 1, 1, 1, 1]",1028,403,625,33,63,0.08188585607940446,0.1008
"[1, 0, 0, 1, 1, 1, 1, 1, 1, 1, 0, 1, 1, 1, 0]",670,157,513,11,41,0.07006369426751592,0.07992202729044834
"[0, 1, 1, 0, 0, 1, 0, 1, 1, 0, 1, 0, 1, 0, 1]",107,54,53,5,6,0.09259259259259259,0.11320754716981132
"[0, 0, 1, 1, 0, 0, 1, 1, 0, 1, 1, 0, 1, 1, 1]",306,126,180,11,16,0.0873015873015873,0.08888888888888889
"[0, 0, 0, 1, 0, 1, 1, 1, 1, 0, 1, 1, 0, 1, 1]",173,75,98,2,6,0.02666666666666667,0.061224489795918366
"[0, 1, 1, 1, 0, 1, 1, 0, 1, 0, 1, 1, 0, 1, 1]",264,80,184,8,14,0.1,0.07608695652173914
"[0, 0, 0, 1, 1, 1, 0, 1, 1, 0, 1, 0, 1, 1, 0]",98,45,53,1,7,0.022222222222222223,0.1320754716981132
"[1, 0, 1, 0, 0, 0, 0, 0, 1, 1, 0, 0, 1, 1, 0]",388,219,169,16,17,0.0730593607305936,0.10059171597633136
"[0, 1, 0, 1, 0, 1, 0, 0, 0, 0, 0, 1, 1, 0, 1]",128,76,52,4,6,0.05263157894736842,0.11538461538461539
"[1, 0, 1, 1, 0, 1, 0, 0, 0, 0, 1, 1, 0, 0, 0]",205,114,91,9,8,0.07894736842105263,0.08791208791208792
"[0, 0, 1, 0, 0, 0, 0, 1, 0, 0, 1, 0, 0, 1, 1]",269,175,94,22,10,0.12571428571428572,0.10638297872340426
"[0, 0, 1, 0, 1, 1, 1, 1, 0, 1, 0, 0, 1, 0, 0]",115,57,58,5,5,0.08771929824561403,0.08620689655172414
"[1, 0, 0, 1, 0, 1, 1, 1, 1, 0, 1, 0, 0, 1, 0]",105,50,55,4,9,0.08,0.16363636363636364
"[1, 1, 0, 1, 0, 0, 1, 0, 1, 1, 1, 1, 0, 1, 0]",133,44,89,5,8,0.11363636363636363,0.0898876404494382
"[0, 1, 0, 1, 1, 0, 0, 0, 1, 1, 0, 1, 0, 0, 1]",129,73,56,7,9,0.0958904109589041,0.16071428571428573
"[1, 0, 0, 1, 0, 1, 1, 0, 0, 0, 1, 1, 0, 1, 0]",114,64,50,4,5,0.0625,0.1
"[0, 0, 1, 1, 1, 0, 0, 1, 0, 1, 1, 0, 0, 0, 1]",115,68,47,4,6,0.058823529411764705,0.1276595744680851
"[0, 0, 1, 1, 1, 1, 1, 1, 0, 0, 1, 1, 1, 0, 1]",698,264,434,21,37,0.07954545454545454,0.08525345622119816
"[1, 0, 1, 1, 0, 0, 1, 1, 0, 1, 0, 1, 1, 1, 1]",297,115,182,10,11,0.08695652173913043,0.06043956043956044
"[1, 1, 1, 0, 1, 0, 0, 0, 1, 1, 1, 1, 0, 0, 0]",221,109,112,10,13,0.09174311926605505,0.11607142857142858
"[1, 1, 0, 0, 0, 1, 1, 1, 1, 0, 1, 0, 0, 1, 0]",97,41,56,5,5,0.12195121951219512,0.08928571428571429
"[1, 0, 0, 1, 1, 1, 0, 0, 0, 1, 1, 1, 1, 1, 0]",174,65,109,4,11,0.06153846153846154,0.10091743119266056
"[1, 0, 0, 1, 1, 0, 0, 0, 1, 0, 1, 0, 0, 1, 1]",186,84,102,5,11,0.05952380952380952,0.10784313725490197
"[1, 1, 1, 0, 0, 0, 1, 1, 1, 0, 0, 1, 1, 1, 0]",172,64,108,6,13,0.09375,0.12037037037037036
"[0, 0, 0, 0, 0, 0, 0, 0, 1, 0, 1, 1, 1, 1, 1]",561,385,176,30,17,0.07792207792207792,0.09659090909090909
"[1, 0, 0, 1, 0, 0, 0, 0, 0, 0, 0, 0, 1, 0, 1]",556,372,184,26,14,0.06989247311827956,0.07608695652173914
"[1, 1, 1, 0, 1, 1, 0, 0, 1, 0, 0, 1, 0, 0, 0]",124,73,51,3,5,0.0410958904109589,0.09803921568627451
"[0, 0, 1, 1, 1, 0, 1, 0, 1, 0, 0, 1, 0, 0, 1]",97,47,50,7,2,0.14893617021276595,0.04
"[0, 0, 1, 1, 0, 1, 0, 0, 1, 1, 1, 0, 1, 0, 1]",97,48,49,4,0,0.08333333333333333,0.0
"[0, 0, 1, 0, 1, 0, 1, 1, 1, 1, 1, 1, 1, 1, 1]",874,266,608,37,72,0.13909774436090225,0.11842105263157894
"[0, 0, 1, 0, 0, 1, 0, 1, 1, 0, 0, 0, 1, 0, 0]",247,167,80,13,8,0.07784431137724551,0.1
"[0, 0, 1, 1, 1, 0, 1, 0, 0, 0, 0, 0, 0, 1, 1]",297,182,115,19,12,0.1043956043956044,0.10434782608695652
"[0, 1, 0, 1, 0, 0, 1, 1, 0, 0, 1, 1, 1, 1, 0]",271,138,133,18,15,0.13043478260869565,0.11278195488721804
"[1, 0, 1, 1, 0, 0, 1, 0, 1, 0, 0, 0, 0, 1, 0]",130,65,65,11,3,0.16923076923076924,0.046153846153846156
"[0, 0, 0, 0, 1, 1, 1, 1, 1, 1, 1, 1, 0, 1, 0]",381,173,208,24,21,0.13872832369942195,0.10096153846153846
"[1, 1, 1, 1, 1, 1, 0, 0, 1, 0, 0, 1, 1, 0, 0]",280,116,164,10,19,0.08620689655172414,0.11585365853658537
"[1, 0, 0, 1, 0, 0, 1, 1, 1, 0, 0, 1, 1, 1, 1]",266,99,167,8,17,0.08080808080808081,0.10179640718562874
"[1, 1, 1, 1, 1, 1, 0, 0, 1, 0, 0, 1, 1, 1, 0]",286,94,192,11,19,0.11702127659574468,0.09895833333333333
"[1, 0, 1, 0, 1, 1, 1, 1, 1, 1, 1, 1, 0, 1, 0]",567,157,410,9,39,0.05732484076433121,0.0951219512195122
"[0, 0, 1, 0, 1, 1, 0, 0, 0, 0, 0, 1, 1, 0, 0]",372,254,118,23,14,0.09055118110236221,0.11864406779661017
"[1, 0, 1, 0, 1, 0, 1, 1, 0, 1, 1, 1, 0, 0, 1]",177,72,105,5,9,0.06944444444444445,0.08571428571428572
"[1, 0, 0, 1, 1, 0, 1, 1, 1, 1, 1, 1, 0, 0, 0]",251,91,160,12,16,0.13186813186813187,0.1
"[0, 0, 0, 1, 1, 1, 0, 0, 1, 1, 1, 1, 1, 0, 1]",163,83,80,8,12,0.0963855421686747,0.15
"[1, 0, 1, 1, 1, 1, 1, 0, 1, 0, 1, 1, 0, 0, 1]",238,71,167,6,9,0.08450704225352113,0.05389221556886228
"[0, 0, 0, 0, 0, 0, 0, 1, 1, 0, 1, 0, 0, 0, 1]",778,585,193,51,23,0.08717948717948718,0.11917098445595854
"[1, 0, 1, 0, 1, 1, 0, 0, 1, 0, 0, 1, 1, 0, 1]",113,52,61,3,4,0.057692307692307696,0.06557377049180328
"[0, 0, 1, 0, 1, 0, 0, 1, 0, 0, 1, 1, 0, 0, 1]",166,95,71,12,5,0.12631578947368421,0.07042253521126761
"[0, 0, 0, 0, 0, 1, 0, 1, 0, 0, 1, 0, 0, 1, 1]",344,236,108,23,8,0.09745762711864407,0.07407407407407407
"[0, 0, 1, 0, 0, 1, 0, 0, 0, 1, 1, 0, 1, 1, 0]",119,67,52,11,7,0.16417910447761194,0.1346153846153846
"[1, 0, 0, 0, 1, 0, 1, 0, 0, 0, 1, 1, 1, 1, 0]",150,78,72,5,8,0.0641025641025641,0.1111111111111111
"[0, 0, 1, 1, 0, 0, 0, 1, 0, 1, 0, 0, 0, 1, 1]",206,124,82,13,6,0.10483870967741936,0.07317073170731707
"[0, 0, 0, 0, 0, 1, 1, 1, 0, 1, 0, 0, 0, 0, 0]",741,535,206,54,24,0.10093457943925234,0.11650485436893204
"[1, 1, 0, 0, 1, 1, 1, 1, 0, 0, 1, 1, 0, 1, 1]",788,325,463,28,38,0.08615384615384615,0.08207343412526998
"[1, 0, 0, 0, 0, 1, 1, 1, 0, 0, 1, 1, 1, 1, 0]",242,117,125,13,12,0.1111111111111111,0.096
"[0, 0, 1, 1, 1, 1, 1, 0, 1, 0, 0, 0, 1, 0, 1]",115,49,66,7,4,0.14285714285714285,0.06060606060606061
"[0, 1, 0, 1, 0, 0, 1, 0, 0, 0, 0, 1, 1, 0, 1]",150,86,64,5,9,0.05813953488372093,0.140625
"[0, 1, 0, 0, 0, 1, 0, 1, 1, 0, 1, 0, 1, 0, 0]",156,87,69,10,7,0.11494252873563218,0.10144927536231885
"[1, 1, 0, 1, 0, 0, 1, 0, 0, 0, 0, 1, 0, 0, 1]",153,92,61,7,5,0.07608695652173914,0.08196721311475409
"[0, 0, 1, 1, 0, 1, 1, 1, 0, 1, 1, 0, 1, 1, 0]",155,59,96,5,14,0.0847457627118644,0.14583333333333334
"[1, 1, 0, 1, 1, 0, 0, 1, 1, 0, 0, 0, 0, 1, 1]",478,208,270,16,30,0.07692307692307693,0.1111111111111111
"[1, 1, 1, 0, 1, 1, 0, 1, 0, 0, 1, 1, 0, 0, 0]",152,72,80,5,10,0.06944444444444445,0.125
"[0, 1, 0, 1, 1, 1, 0, 1, 1, 1, 1, 0, 1, 1, 1]",577,165,412,19,40,0.11515151515151516,0.0970873786407767
"[1, 1, 0, 1, 0, 0, 1, 1, 0, 0, 1, 1, 1, 1, 1]",596,209,387,16,31,0.07655502392344497,0.08010335917312661
"[0, 1, 0, 1, 0, 0, 0, 0, 1, 1, 1, 1, 1, 1, 0]",276,134,142,19,18,0.1417910447761194,0.1267605633802817
"[0, 1, 0, 1, 0, 0, 0, 1, 0, 1, 0, 0, 0, 0, 1]",248,170,78,22,4,0.12941176470588237,0.05128205128205128
"[1, 1, 0, 0, 0, 0, 0, 0, 0, 0, 1, 0, 1, 0, 1]",418,257,161,26,17,0.10116731517509728,0.10559006211180125
"[1, 0, 1, 0, 1, 0, 0, 1, 0, 0, 0, 1, 0, 0, 0]",241,145,96,15,12,0.10344827586206896,0.125
"[0, 1, 0, 1, 1, 1, 1, 0, 0, 1, 1, 0, 1, 0, 0]",118,58,60,7,6,0.1206896551724138,0.1
"[0, 0, 0, 1, 0, 1, 0, 1, 0, 1, 0, 0, 0, 0, 1]",251,160,91,21,9,0.13125,0.0989010989010989
"[0, 0, 0, 1, 0, 0, 0, 1, 1, 1, 1, 1, 0, 0, 0]",226,136,90,12,10,0.08823529411764706,0.1111111111111111
"[0, 1, 0, 1, 0, 1, 1, 1, 0, 0, 0, 1, 0, 0, 1]",102,55,47,9,5,0.16363636363636364,0.10638297872340426
"[1, 0, 0, 1, 0, 1, 0, 1, 1, 1, 0, 0, 0, 1, 0]",104,54,50,6,5,0.1111111111111111,0.1
"[0, 0, 1, 1, 1, 0, 1, 0, 0, 1, 0, 0, 0, 0, 0]",298,189,109,18,10,0.09523809523809523,0.09174311926605505
"[0, 1, 0, 0, 0, 0, 1, 1, 1, 0, 1, 0, 0, 1, 0]",154,87,67,11,1,0.12643678160919541,0.014925373134328358
"[0, 0, 0, 0, 1, 0, 0, 1, 0, 1, 0, 1, 1, 0, 0]",286,183,103,22,6,0.12021857923497267,0.05825242718446602
"[0, 0, 1, 1, 1, 0, 0, 1, 0, 0, 0, 0, 0, 0, 0]",821,560,261,69,19,0.12321428571428572,0.07279693486590039
"[1, 0, 0, 1, 1, 1, 0, 0, 0, 0, 0, 0, 1, 1, 0]",381,205,176,13,23,0.06341463414634146,0.13068181818181818
"[0, 0, 0, 1, 1, 1, 0, 0, 0, 0, 0, 1, 0, 0, 0]",657,458,199,45,20,0.0982532751091703,0.10050251256281408
"[1, 0, 0, 1, 0, 1, 1, 1, 1, 0, 0, 0, 0, 0, 1]",136,64,72,9,8,0.140625,0.1111111111111111
"[1, 0, 0, 1, 0, 0, 0, 0, 1, 1, 0, 0, 1, 0, 1]",168,91,77,7,9,0.07692307692307693,0.11688311688311688
"[0, 1, 0, 0, 0, 0, 0, 1, 0, 0, 1, 1, 1, 0, 0]",261,159,102,19,9,0.11949685534591195,0.08823529411764706
"[1, 1, 1, 0, 0, 1, 1, 1, 0, 1, 0, 0, 1, 1, 0]",179,64,115,5,10,0.078125,0.08695652173913043
"[1, 1, 1, 0, 1, 0, 1, 1, 0, 1, 1, 0, 0, 0, 1]",152,53,99,3,9,0.05660377358490566,0.09090909090909091
"[0, 1, 1, 1, 1, 0, 1, 0, 1, 1, 0, 1, 1, 0, 0]",173,75,98,4,7,0.05333333333333334,0.07142857142857142
"[0, 1, 0, 1, 0, 1, 1, 1, 1, 0, 1, 0, 1, 1, 0]",148,60,88,6,6,0.1,0.06818181818181818
"[1, 0, 1, 0, 1, 0, 1, 1, 1, 1, 0, 1, 0, 1, 1]",264,96,168,8,12,0.08333333333333333,0.07142857142857142
"[0, 0, 1, 0, 1, 0, 0, 0, 1, 1, 1, 1, 1, 1, 1]",291,119,172,11,16,0.09243697478991597,0.09302325581395349
"[1, 1, 1, 0, 0, 1, 0, 1, 1, 1, 1, 1, 0, 0, 1]",327,109,218,7,31,0.06422018348623854,0.14220183486238533
"[1, 1, 1, 1, 1, 1, 1, 0, 0, 0, 0, 1, 1, 1, 0]",699,150,549,13,53,0.08666666666666667,0.0965391621129326
"[1, 0, 0, 1, 1, 0, 1, 0, 0, 1, 1, 1, 0, 0, 1]",126,60,66,5,4,0.08333333333333333,0.06060606060606061
"[1, 1, 1, 0, 1, 1, 1, 1, 0, 1, 0, 0, 1, 0, 0]",166,59,107,7,12,0.11864406779661017,0.11214953271028037
"[1, 1, 0, 0, 0, 1, 0, 0, 0, 0, 0, 0, 1, 0, 1]",254,172,82,16,5,0.09302325581395349,0.06097560975609756
"[1, 0, 0, 0, 1, 1, 0, 1, 1, 0, 0, 0, 0, 1, 1]",205,106,99,6,6,0.05660377358490566,0.06060606060606061
"[0, 1, 0, 1, 0, 0, 0, 1, 1, 0, 1, 1, 0, 0, 0]",167,95,72,8,10,0.08421052631578947,0.1388888888888889
"[1, 1, 1, 0, 1, 1, 1, 0, 0, 1, 1, 0, 1, 0, 1]",238,90,148,14,11,0.15555555555555556,0.07432432432432433
"[1, 0, 0, 0, 1, 1, 1, 0, 0, 0, 0, 1, 0, 1, 1]",140,66,74,6,8,0.09090909090909091,0.10810810810810811
"[0, 0, 1, 1, 1, 0, 0, 1, 0, 0, 1, 0, 1, 0, 0]",147,86,61,10,6,0.11627906976744186,0.09836065573770492
"[0, 0, 1, 1, 1, 0, 1, 1, 0, 0, 0, 0, 1, 1, 1]",257,124,133,12,10,0.0967741935483871,0.07518796992481203
"[1, 1, 1, 0, 1, 1, 0, 0, 0, 0, 0, 0, 0, 1, 0]",149,76,73,5,8,0.06578947368421052,0.1095890410958904
"[1, 0, 1, 0, 1, 0, 1, 1, 1, 0, 0, 1, 1, 0, 1]",143,59,84,10,7,0.1694915254237288,0.08333333333333333
"[1, 1, 1, 0, 0, 0, 1, 0, 0, 1, 0, 0, 1, 1, 0]",140,64,76,12,5,0.1875,0.06578947368421052
"[1, 0, 0, 1, 0, 0, 0, 0, 1, 0, 0, 0, 0, 0, 1]",566,380,186,39,12,0.10263157894736842,0.06451612903225806
"[0, 1, 1, 0, 1, 0, 1, 1, 0, 0, 1, 0, 0, 0, 0]",155,87,68,5,5,0.05747126436781609,0.07352941176470588
"[1, 0, 1, 0, 0, 1, 1, 0, 1, 0, 1, 1, 0, 0, 1]",129,55,74,6,8,0.10909090909090909,0.10810810810810811
"[1, 0, 1, 1, 1, 1, 0, 0, 0, 1, 1, 1, 1, 0, 0]",258,119,139,20,17,0.16806722689075632,0.1223021582733813
"[0, 1, 0, 1, 0, 0, 0, 0, 1, 0, 1, 1, 0, 0, 0]",287,188,99,17,9,0.09042553191489362,0.09090909090909091
"[0, 0, 1, 0, 0, 1, 0, 1, 0, 0, 0, 0, 1, 0, 1]",234,149,85,15,7,0.10067114093959731,0.08235294117647059
"[0, 0, 0, 1, 0, 0, 1, 0, 1, 0, 0, 0, 0, 1, 0]",479,340,139,38,17,0.11176470588235295,0.1223021582733813
"[1, 0, 1, 0, 1, 0, 1, 1, 0, 1, 0, 0, 0, 1, 0]",92,49,43,7,3,0.14285714285714285,0.06976744186046512
"[0, 1, 1, 0, 1, 0, 1, 0, 1, 1, 0, 1, 0, 0, 0]",103,55,48,5,3,0.09090909090909091,0.0625
"[0, 0, 1, 0, 1, 0, 0, 1, 0, 1, 1, 1, 0, 0, 0]",163,100,63,8,10,0.08,0.15873015873015872
"[1, 1, 1, 0, 0, 1, 0, 1, 0, 0, 1, 0, 1, 1, 1]",185,69,116,1,14,0.014492753623188406,0.1206896551724138
"[1, 1, 1, 1, 0, 1, 1, 1, 0, 1, 0, 1, 1, 1, 0]",529,142,387,12,44,0.08450704225352113,0.11369509043927649
"[0, 0, 0, 1, 0, 1, 0, 1, 0, 0, 0, 1, 1, 0, 0]",315,206,109,18,8,0.08737864077669903,0.07339449541284404
"[0, 1, 0, 0, 0, 0, 0, 0, 0, 1, 1, 0, 1, 0, 0]",607,420,187,42,15,0.1,0.08021390374331551
"[0, 0, 0, 1, 1, 0, 1, 0, 0, 0, 0, 1, 1, 1, 1]",265,163,102,15,9,0.09202453987730061,0.08823529411764706
"[1, 1, 0, 0, 1, 1, 0, 0, 0, 1, 1, 0, 1, 0, 0]",142,74,68,7,4,0.0945945945945946,0.058823529411764705
"[0, 1, 0, 1, 1, 1, 0, 0, 1, 1, 0, 0, 0, 1, 1]",154,74,80,5,6,0.06756756756756757,0.075
"[0, 0, 0, 0, 0, 1, 0, 1, 0, 0, 1, 1, 1, 0, 1]",146,95,51,13,4,0.1368421052631579,0.0784313725490196
"[0, 0, 0, 0, 0, 0, 0, 1, 0, 1, 0, 0, 1, 1, 1]",792,613,179,52,18,0.08482871125611746,0.1005586592178771
"[0, 0, 1, 0, 1, 1, 0, 1, 0, 0, 1, 0, 0, 0, 0]",262,165,97,14,7,0.08484848484848485,0.07216494845360824
"[1, 0, 1, 1, 0, 0, 0, 1, 1, 0, 1, 1, 0, 0, 0]",146,78,68,9,6,0.11538461538461539,0.08823529411764706
"[1, 1, 0, 1, 1, 0, 0, 0, 1, 1, 0, 1, 1, 0, 0]",131,62,69,6,9,0.0967741935483871,0.13043478260869565
"[0, 1, 1, 1, 0, 0, 1, 1, 1, 0, 1, 1, 0, 0, 0]",125,66,59,6,10,0.09090909090909091,0.1694915254237288
"[1, 1, 0, 1, 0, 0, 0, 1, 1, 1, 1, 0, 0, 0, 1]",132,58,74,4,10,0.06896551724137931,0.13513513513513514
"[0, 1, 1, 0, 1, 0, 0, 0, 1, 0, 0, 0, 0, 1, 0]",205,154,51,16,5,0.1038961038961039,0.09803921568627451
"[1, 0, 1, 1, 0, 1, 0, 0, 0, 0, 0, 1, 0, 0, 1]",145,93,52,10,6,0.10752688172043011,0.11538461538461539
"[1, 0, 0, 1, 0, 0, 0, 0, 1, 0, 1, 0, 0, 1, 0]",220,128,92,13,6,0.1015625,0.06521739130434782
"[0, 0, 1, 1, 1, 1, 0, 1, 0, 1, 0, 1, 0, 0, 0]",157,86,71,7,8,0.08139534883720931,0.11267605633802817
"[1, 0, 1, 1, 1, 0, 1, 0, 1, 1, 0, 1, 0, 1, 1]",243,97,146,6,11,0.061855670103092786,0.07534246575342465
"[1, 0, 0, 0, 0, 0, 0, 1, 0, 0, 1, 0, 0, 1, 0]",533,352,181,35,13,0.09943181818181818,0.0718232044198895
"[1, 0, 0, 0, 1, 1, 1, 1, 1, 0, 1, 1, 0, 1, 1]",275,98,177,10,21,0.10204081632653061,0.11864406779661017
"[0, 1, 0, 1, 1, 1, 1, 1, 0, 1, 1, 0, 0, 0, 1]",119,46,73,8,5,0.17391304347826086,0.0684931506849315
"[1, 1, 0, 1, 1, 1, 1, 0, 1, 0, 0, 1, 0, 0, 0]",116,56,60,5,6,0.08928571428571429,0.1
"[0, 1, 1, 1, 0, 0, 1, 1, 0, 0, 0, 0, 0, 1, 0]",180,104,76,10,8,0.09615384615384616,0.10526315789473684
"[0, 0, 1, 1, 1, 0, 1, 1, 0, 0, 0, 0, 0, 1, 1]",208,103,105,11,11,0.10679611650485436,0.10476190476190476
"[1, 0, 1, 1, 0, 0, 1, 0, 0, 0, 1, 1, 1, 0, 1]",100,56,44,7,3,0.125,0.06818181818181818
"[1, 0, 1, 0, 1, 0, 1, 1, 0, 1, 1, 0, 0, 1, 0]",105,40,65,4,5,0.1,0.07692307692307693
"[0, 1, 1, 0, 1, 0, 1, 0, 1, 0, 1, 0, 1, 1, 0]",106,45,61,4,5,0.08888888888888889,0.08196721311475409
"[1, 1, 0, 1, 1, 0, 0, 1, 0, 1, 1, 1, 0, 0, 0]",116,63,53,7,4,0.1111111111111111,0.07547169811320754
"[0, 1, 1, 1, 0, 1, 1, 0, 0, 1, 0, 1, 1, 1, 0]",132,41,91,2,6,0.04878048780487805,0.06593406593406594
"[1, 0, 0, 0, 1, 1, 0, 0, 0, 1, 0, 0, 1, 1, 0]",166,87,79,10,6,0.11494252873563218,0.0759493670886076
"[1, 1, 0, 0, 0, 1, 1, 0, 0, 0, 1, 0, 0, 1, 1]",175,92,83,9,6,0.09782608695652174,0.07228915662650602
"[1, 0, 1, 0, 0, 1, 1, 1, 0, 0, 0, 0, 1, 0, 1]",101,56,45,9,3,0.16071428571428573,0.06666666666666667
"[1, 1, 0, 1, 0, 0, 1, 0, 0, 1, 0, 0, 0, 1, 0]",122,65,57,8,4,0.12307692307692308,0.07017543859649122
"[1, 0, 0, 1, 0, 1, 1, 1, 0, 0, 1, 1, 0, 0, 1]",210,92,118,9,13,0.09782608695652174,0.11016949152542373
"[1, 0, 0, 0, 0, 1, 0, 0, 1, 1, 0, 0, 0, 0, 1]",384,223,161,26,15,0.11659192825112108,0.09316770186335403
"[1, 1, 0, 1, 0, 0, 1, 0, 1, 0, 1, 1, 0, 1, 0]",98,51,47,7,4,0.13725490196078433,0.0851063829787234
"[0, 1, 0, 0, 1, 1, 1, 0, 0, 1, 1, 1, 0, 0, 0]",124,69,55,3,6,0.043478260869565216,0.10909090909090909
"[0, 1, 0, 0, 1, 1, 0, 0, 1, 0, 0, 1, 0, 0, 0]",245,158,87,13,8,0.08227848101265822,0.09195402298850575
"[1, 1, 1, 1, 1, 1, 0, 0, 1, 0, 1, 1, 0, 0, 1]",370,119,251,17,20,0.14285714285714285,0.0796812749003984
"[0, 1, 1, 0, 1, 0, 1, 1, 1, 0, 1, 0, 1, 1, 1]",257,107,150,12,11,0.11214953271028037,0.07333333333333333
"[1, 1, 1, 1, 0, 0, 1, 1, 0, 1, 0, 0, 1, 1, 1]",423,152,271,11,33,0.07236842105263158,0.12177121771217712
"[1, 1, 1, 0, 1, 1, 1, 1, 0, 0, 1, 1, 0, 1, 0]",265,89,176,6,15,0.06741573033707865,0.08522727272727272
"[1, 0, 0, 0, 1, 1, 0, 0, 1, 1, 0, 1, 1, 0, 1]",120,64,56,9,9,0.140625,0.16071428571428573
"[0, 1, 0, 1, 0, 1, 0, 0, 0, 1, 0, 0, 0, 0, 0]",579,410,169,38,15,0.09268292682926829,0.08875739644970414
"[0, 0, 1, 1, 0, 1, 1, 1, 0, 1, 1, 1, 1, 1, 1]",711,233,478,22,38,0.0944206008583691,0.0794979079497908
"[1, 1, 0, 0, 0, 1, 1, 1, 0, 0, 1, 0, 0, 1, 1]",133,58,75,7,6,0.1206896551724138,0.08
"[1, 0, 1, 0, 0, 1, 1, 0, 0, 0, 1, 1, 1, 0, 0]",144,71,73,8,14,0.11267605633802817,0.1917808219178082
"[0, 1, 1, 0, 0, 0, 0, 1, 0, 0, 0, 1, 1, 0, 1]",155,103,52,12,9,0.11650485436893204,0.17307692307692307
"[1, 1, 0, 1, 0, 0, 1, 1, 1, 1, 0, 0, 1, 1, 1]",570,193,377,12,39,0.06217616580310881,0.10344827586206896
"[1, 1, 0, 0, 1, 1, 0, 0, 0, 1, 0, 0, 0, 1, 0]",188,114,74,16,6,0.14035087719298245,0.08108108108108109
"[1, 1, 0, 0, 0, 1, 0, 1, 1, 0, 0, 1, 0, 0, 1]",115,56,59,7,5,0.125,0.0847457627118644
"[0, 0, 1, 0, 0, 1, 0, 0, 0, 0, 1, 0, 0, 1, 1]",287,188,99,16,13,0.0851063829787234,0.13131313131313133
"[0, 1, 1, 0, 0, 1, 0, 0, 1, 1, 1, 1, 1, 1, 1]",517,242,275,19,21,0.07851239669421488,0.07636363636363637
"[0, 0, 0, 0, 0, 0, 1, 1, 1, 1, 1, 0, 0, 0, 0]",721,478,243,46,15,0.09623430962343096,0.06172839506172839
"[1, 0, 1, 0, 0, 0, 0, 1, 0, 0, 1, 1, 0, 0, 0]",323,225,98,18,13,0.08,0.1326530612244898
"[1, 0, 0, 1, 1, 0, 1, 0, 1, 1, 1, 1, 0, 1, 0]",131,48,83,5,11,0.10416666666666667,0.13253012048192772
"[1, 1, 1, 0, 1, 1, 1, 1, 0, 0, 0, 0, 1, 1, 1]",724,252,472,24,38,0.09523809523809523,0.08050847457627118
"[1, 1, 1, 0, 0, 1, 0, 1, 0, 1, 1, 0, 1, 0, 0]",113,50,63,3,0,0.06,0.0
"[1, 1, 1, 1, 0, 0, 0, 1, 1, 1, 0, 0, 1, 0, 1]",145,56,89,7,11,0.125,0.12359550561797752
"[0, 1, 0, 0, 1, 0, 0, 0, 0, 0, 1, 0, 1, 0, 0]",550,378,172,27,15,0.07142857142857142,0.0872093023255814
"[0, 1, 0, 1, 1, 0, 0, 1, 0, 1, 0, 1, 0, 0, 1]",115,59,56,8,6,0.13559322033898305,0.10714285714285714
"[1, 1, 1, 0, 0, 0, 1, 1, 1, 0, 0, 1, 1, 1, 1]",446,156,290,20,29,0.1282051282051282,0.1
"[0, 0, 0, 0, 1, 1, 1, 1, 0, 0, 1, 1, 1, 0, 0]",372,195,177,18,23,0.09230769230769231,0.12994350282485875
"[1, 0, 0, 1, 0, 0, 1, 0, 1, 0, 0, 1, 0, 0, 0]",236,158,78,9,5,0.056962025316455694,0.0641025641025641
"[1, 1, 0, 0, 1, 0, 0, 1, 0, 1, 0, 0, 1, 0, 0]",124,77,47,2,3,0.025974025974025976,0.06382978723404255
"[1, 0, 1, 1, 1, 0, 0, 1, 0, 1, 0, 0, 0, 0, 1]",126,65,61,6,9,0.09230769230769231,0.14754098360655737
"[0, 0, 0, 0, 0, 1, 1, 1, 0, 0, 1, 0, 1, 0, 1]",161,92,69,6,7,0.06521739130434782,0.10144927536231885
"[1, 0, 0, 1, 1, 1, 1, 1, 0, 0, 0, 0, 0, 1, 1]",235,87,148,8,22,0.09195402298850575,0.14864864864864866
"[0, 0, 0, 1, 0, 1, 0, 1, 1, 0, 1, 1, 0, 0, 1]",133,80,53,7,8,0.0875,0.1509433962264151
"[1, 0, 1, 0, 1, 0, 1, 0, 1, 0, 0, 1, 1, 1, 0]",100,41,59,5,4,0.12195121951219512,0.06779661016949153
"[1, 1, 1, 0, 0, 1, 0, 0, 1, 0, 1, 0, 1, 0, 1]",95,43,52,1,4,0.023255813953488372,0.07692307692307693
"[0, 1, 0, 1, 1, 1, 0, 1, 0, 1, 0, 0, 0, 1, 0]",96,56,40,5,4,0.08928571428571429,0.1
"[0, 1, 0, 1, 1, 1, 1, 1, 1, 1, 0, 1, 0, 0, 0]",176,62,114,3,8,0.04838709677419355,0.07017543859649122
"[0, 1, 0, 1, 0, 0, 1, 0, 1, 1, 1, 0, 1, 1, 0]",113,50,63,2,5,0.04,0.07936507936507936
"[0, 0, 1, 0, 1, 0, 1, 0, 1, 1, 1, 1, 1, 1, 1]",359,136,223,14,16,0.10294117647058823,0.07174887892376682
"[1, 1, 0, 1, 1, 0, 1, 0, 1, 1, 0, 1, 1, 1, 0]",234,87,147,10,17,0.11494252873563218,0.11564625850340136
"[1, 1, 1, 1, 0, 0, 1, 0, 0, 0, 0, 1, 1, 0, 0]",219,115,104,12,9,0.10434782608695652,0.08653846153846154
"[1, 1, 0, 1, 0, 0, 1, 0, 0, 1, 0, 0, 1, 1, 1]",152,77,75,11,4,0.14285714285714285,0.05333333333333334
"[0, 1, 0, 0, 1, 1, 0, 1, 0, 0, 1, 0, 0, 1, 0]",123,73,50,9,6,0.1232876712328767,0.12
"[1, 1, 0, 1, 0, 0, 0, 0, 0, 0, 1, 1, 0, 1, 0]",168,107,61,7,3,0.06542056074766354,0.04918032786885246
"[0, 1, 1, 0, 1, 0, 0, 0, 0, 0, 0, 1, 1, 0, 1]",182,108,74,9,7,0.08333333333333333,0.0945945945945946
"[1, 1, 0, 1, 0, 0, 0, 0, 0, 1, 1, 0, 1, 0, 0]",170,109,61,11,4,0.10091743119266056,0.06557377049180328
"[1, 0, 1, 0, 1, 0, 0, 1, 1, 0, 1, 1, 1, 1, 1]",260,87,173,7,14,0.08045977011494253,0.08092485549132948
"[1, 1, 1, 0, 1, 1, 0, 1, 0, 1, 0, 1, 0, 1, 0]",143,62,81,7,6,0.11290322580645161,0.07407407407407407
"[0, 0, 0, 1, 0, 0, 0, 1, 1, 1, 0, 1, 1, 0, 1]",100,46,54,6,1,0.13043478260869565,0.018518518518518517
"[0, 0, 0, 1, 0, 1, 0, 1, 1, 1, 0, 1, 0, 1, 1]",124,66,58,10,6,0.15151515151515152,0.10344827586206896
"[0, 1, 0, 0, 0, 0, 0, 0, 1, 1, 1, 0, 1, 0, 0]",283,181,102,20,12,0.11049723756906077,0.11764705882352941
"[0, 1, 1, 1, 1, 1, 0, 0, 0, 0, 1, 1, 0, 0, 1]",447,221,226,22,21,0.09954751131221719,0.09292035398230089
"[1, 0, 1, 0, 1, 1, 0, 0, 0, 0, 1, 0, 1, 1, 1]",129,57,72,7,11,0.12280701754385964,0.1527777777777778
"[0, 1, 1, 0, 0, 0, 0, 1, 0, 1, 0, 0, 1, 0, 0]",261,183,78,18,10,0.09836065573770492,0.1282051282051282
"[1, 0, 0, 0, 0, 0, 0, 1, 1, 1, 0, 1, 1, 0, 1]",163,58,105,5,11,0.08620689655172414,0.10476190476190476
"[0, 0, 1, 1, 1, 1, 0, 0, 1, 1, 0, 1, 0, 0, 0]",233,131,102,18,11,0.13740458015267176,0.10784313725490197
"[1, 0, 0, 0, 1, 1, 1, 1, 1, 1, 0, 1, 0, 1, 0]",154,66,88,8,10,0.12121212121212122,0.11363636363636363
"[0, 0, 0, 1, 0, 1, 1, 1, 1, 0, 0, 0, 1, 1, 1]",182,100,82,12,7,0.12,0.08536585365853659
"[0, 1, 1, 1, 1, 0, 1, 1, 1, 0, 1, 1, 0, 1, 0]",226,89,137,9,13,0.10112359550561797,0.0948905109489051
"[0, 1, 1, 0, 0, 0, 1, 1, 1, 0, 1, 0, 0, 1, 1]",126,58,68,4,6,0.06896551724137931,0.08823529411764706
"[1, 1, 1, 0, 0, 1, 1, 0, 0, 1, 0, 0, 1, 0, 0]",163,63,100,4,8,0.06349206349206349,0.08
"[0, 1, 1, 0, 0, 0, 0, 1, 0, 1, 0, 1, 1, 0, 1]",138,86,52,11,4,0.12790697674418605,0.07692307692307693
"[0, 1, 1, 1, 0, 0, 0, 1, 1, 1, 1, 1, 0, 0, 1]",193,82,111,9,8,0.10975609756097561,0.07207207207207207
"[1, 0, 1, 1, 1, 0, 0, 0, 0, 0, 1, 1, 0, 0, 1]",190,97,93,9,3,0.09278350515463918,0.03225806451612903
"[1, 1, 0, 0, 1, 1, 1, 0, 1, 0, 1, 1, 1, 0, 0]",178,74,104,8,17,0.10810810810810811,0.16346153846153846
"[1, 1, 1, 0, 1, 0, 1, 1, 0, 0, 0, 0, 0, 1, 0]",128,65,63,9,9,0.13846153846153847,0.14285714285714285
"[0, 1, 1, 0, 0, 0, 0, 0, 1, 0, 0, 0, 1, 0, 0]",584,441,143,46,14,0.10430839002267574,0.0979020979020979
"[0, 0, 1, 1, 0, 0, 0, 0, 0, 1, 0, 0, 0, 1, 0]",612,447,165,57,9,0.12751677852348994,0.05454545454545454
"[1, 0, 0, 0, 1, 0, 1, 1, 1, 0, 1, 0, 1, 0, 0]",110,52,58,5,7,0.09615384615384616,0.1206896551724138
"[0, 0, 1, 0, 0, 0, 0, 1, 0, 0, 1, 1, 0, 1, 0]",229,143,86,10,8,0.06993006993006994,0.09302325581395349
"[1, 1, 1, 0, 0, 1, 0, 0, 0, 0, 1, 0, 0, 1, 1]",163,85,78,12,4,0.1411764705882353,0.05128205128205128
"[0, 0, 1, 1, 0, 1, 0, 0, 1, 0, 1, 0, 0, 0, 0]",265,170,95,15,4,0.08823529411764706,0.042105263157894736
"[1, 0, 0, 0, 0, 0, 1, 0, 0, 1, 1, 0, 1, 0, 0]",246,143,103,16,12,0.11188811188811189,0.11650485436893204
"[1, 1, 0, 1, 1, 1, 1, 0, 1, 1, 0, 0, 0, 1, 1]",290,104,186,14,22,0.1346153846153846,0.11827956989247312
"[0, 0, 0, 1, 1, 0, 1, 1, 1, 1, 0, 1, 1, 0, 0]",146,65,81,10,7,0.15384615384615385,0.08641975308641975
"[0, 1, 1, 1, 0, 1, 0, 0, 1, 1, 0, 0, 0, 1, 1]",137,67,70,5,9,0.07462686567164178,0.12857142857142856
"[1, 1, 0, 0, 1, 0, 1, 0, 0, 1, 0, 1, 0, 0, 1]",122,53,69,3,7,0.05660377358490566,0.10144927536231885
"[0, 1, 1, 0, 1, 1, 0, 0, 0, 0, 1, 0, 0, 1, 1]",124,68,56,7,6,0.10294117647058823,0.10714285714285714
"[0, 0, 1, 1, 0, 1, 1, 0, 1, 1, 0, 1, 1, 0, 0]",114,52,62,8,9,0.15384615384615385,0.14516129032258066
"[0, 0, 0, 0, 0, 0, 0, 1, 1, 1, 1, 0, 0, 1, 0]",687,551,136,65,12,0.11796733212341198,0.08823529411764706
"[1, 0, 0, 1, 1, 1, 0, 1, 0, 1, 1, 1, 1, 0, 1]",240,81,159,8,13,0.09876543209876543,0.08176100628930817
"[1, 1, 1, 1, 0, 1, 0, 1, 1, 1, 1, 0, 1, 0, 0]",276,91,185,8,22,0.08791208791208792,0.11891891891891893
"[1, 1, 1, 1, 0, 1, 0, 1, 0, 1, 1, 0, 1, 0, 0]",136,51,85,3,9,0.058823529411764705,0.10588235294117647
"[0, 0, 0, 1, 0, 1, 1, 1, 0, 0, 0, 1, 0, 1, 0]",132,79,53,8,7,0.10126582278481013,0.1320754716981132
"[1, 0, 1, 1, 0, 0, 0, 0, 0, 0, 0, 0, 1, 0, 0]",620,418,202,39,23,0.09330143540669857,0.11386138613861387
"[0, 1, 1, 1, 0, 0, 1, 0, 0, 0, 0, 0, 1, 0, 1]",152,86,66,9,7,0.10465116279069768,0.10606060606060606
"[0, 0, 1, 0, 0, 1, 1, 0, 0, 1, 0, 1, 0, 0, 1]",141,78,63,9,6,0.11538461538461539,0.09523809523809523
"[1, 0, 1, 0, 0, 0, 1, 0, 0, 1, 1, 1, 0, 1, 1]",114,63,51,4,7,0.06349206349206349,0.13725490196078433
"[0, 0, 1, 0, 1, 0, 0, 0, 1, 0, 0, 1, 1, 1, 0]",144,79,65,10,7,0.12658227848101267,0.1076923076923077
"[0, 0, 0, 1, 0, 1, 0, 0, 0, 1, 0, 0, 1, 1, 1]",217,137,80,14,9,0.10218978102189781,0.1125
"[1, 1, 0, 1, 1, 0, 0, 1, 0, 1, 0, 0, 1, 1, 1]",178,65,113,8,9,0.12307692307692308,0.07964601769911504
"[0, 0, 0, 1, 1, 0, 0, 0, 0, 1, 0, 0, 1, 1, 1]",549,433,116,35,6,0.08083140877598152,0.05172413793103448
"[1, 0, 0, 0, 0, 0, 0, 0, 1, 1, 0, 1, 0, 1, 0]",247,157,90,12,11,0.07643312101910828,0.12222222222222222
"[1, 0, 1, 0, 0, 1, 0, 1, 0, 1, 0, 0, 0, 0, 0]",261,170,91,15,14,0.08823529411764706,0.15384615384615385
"[1, 1, 1, 0, 1, 0, 0, 1, 0, 1, 0, 1, 0, 0, 0]",119,48,71,4,11,0.08333333333333333,0.15492957746478872
"[0, 1, 0, 0, 1, 1, 0, 0, 1, 0, 0, 0, 0, 0, 1]",272,173,99,24,11,0.13872832369942195,0.1111111111111111
"[1, 0, 0, 0, 0, 0, 1, 0, 0, 1, 1, 0, 0, 1, 0]",269,162,107,9,13,0.05555555555555555,0.12149532710280374
"[1, 0, 0, 0, 0, 1, 0, 1, 1, 0, 0, 0, 0, 0, 1]",305,196,109,21,10,0.10714285714285714,0.09174311926605505
"[1, 1, 0, 0, 0, 1, 1, 0, 0, 0, 0, 1, 0, 1, 1]",137,67,70,8,7,0.11940298507462686,0.1
"[0, 0, 0, 0, 1, 1, 1, 1, 0, 0, 1, 0, 0, 0, 0]",500,332,168,30,19,0.09036144578313253,0.1130952380952381
"[0, 1, 1, 0, 0, 0, 0, 0, 1, 0, 1, 0, 0, 0, 0]",700,510,190,46,20,0.09019607843137255,0.10526315789473684
"[1, 1, 1, 0, 1, 0, 1, 1, 1, 1, 0, 0, 0, 0, 1]",298,118,180,14,22,0.11864406779661017,0.12222222222222222
"[1, 0, 1, 1, 1, 1, 0, 1, 1, 0, 1, 1, 0, 0, 1]",265,88,177,9,17,0.10227272727272728,0.096045197740113
"[0, 1, 0, 1, 1, 0, 0, 0, 1, 0, 0, 0, 1, 1, 1]",162,86,76,11,11,0.12790697674418605,0.14473684210526316
"[1, 1, 0, 0, 1, 0, 0, 1, 1, 0, 0, 0, 1, 1, 1]",181,93,88,9,5,0.0967741935483871,0.056818181818181816
"[1, 0, 1, 1, 0, 1, 1, 0, 0, 1, 1, 1, 0, 0, 1]",151,60,91,7,5,0.11666666666666667,0.054945054945054944
"[0, 0, 1, 1, 0, 1, 0, 1, 1, 0, 1, 0, 0, 1, 0]",123,61,62,4,4,0.06557377049180328,0.06451612903225806
"[1, 1, 0, 0, 1, 1, 1, 0, 1, 0, 1, 0, 0, 1, 0]",92,47,45,3,2,0.06382978723404255,0.044444444444444446
"[1, 1, 1, 1, 1, 0, 0, 1, 1, 1, 0, 1, 0, 1, 0]",296,74,222,8,21,0.10810810810810811,0.0945945945945946
"[0, 1, 1, 0, 1, 1, 0, 0, 1, 1, 0, 0, 0, 1, 1]",153,70,83,8,9,0.11428571428571428,0.10843373493975904
"[1, 1, 0, 0, 0, 1, 1, 0, 1, 1, 1, 1, 1, 1, 0]",335,123,212,18,19,0.14634146341463414,0.08962264150943396
"[0, 1, 1, 1, 1, 0, 0, 1, 0, 1, 0, 1, 0, 1, 1]",171,92,79,13,9,0.14130434782608695,0.11392405063291139
"[1, 1, 1, 0, 1, 1, 1, 0, 0, 0, 1, 1, 0, 0, 0]",171,61,110,5,7,0.08196721311475409,0.06363636363636363
"[0, 1, 1, 1, 1, 0, 0, 1, 1, 0, 1, 0, 1, 1, 0]",194,108,86,10,5,0.09259259259259259,0.05813953488372093
"[1, 1, 1, 0, 0, 1, 1, 0, 1, 1, 0, 1, 1, 0, 1]",254,84,170,6,15,0.07142857142857142,0.08823529411764706
"[0, 1, 0, 1, 1, 0, 0, 1, 1, 0, 0, 0, 1, 1, 1]",217,107,110,19,10,0.17757009345794392,0.09090909090909091
"[0, 1, 0, 0, 1, 0, 0, 1, 1, 1, 1, 1, 1, 0, 1]",163,60,103,4,7,0.06666666666666667,0.06796116504854369
"[0, 0, 0, 1, 1, 1, 1, 0, 0, 1, 1, 1, 0, 0, 0]",249,174,75,16,4,0.09195402298850575,0.05333333333333334
"[0, 0, 0, 0, 1, 1, 1, 1, 0, 0, 1, 0, 1, 0, 0]",271,156,115,12,12,0.07692307692307693,0.10434782608695652
"[0, 1, 0, 0, 0, 1, 1, 0, 1, 0, 0, 1, 0, 0, 1]",138,79,59,4,8,0.05063291139240506,0.13559322033898305
"[0, 0, 0, 0, 1, 0, 0, 0, 1, 0, 0, 1, 1, 0, 0]",679,505,174,51,21,0.100990099009901,0.1206896551724138
"[1, 1, 1, 0, 0, 0, 0, 0, 1, 0, 0, 0, 1, 0, 0]",289,169,120,13,17,0.07692307692307693,0.14166666666666666
"[0, 1, 0, 1, 1, 0, 0, 1, 1, 0, 0, 0, 0, 1, 1]",411,222,189,22,22,0.0990990990990991,0.1164021164021164
"[1, 1, 0, 0, 1, 0, 1, 0, 0, 0, 0, 0, 1, 0, 0]",239,158,81,16,5,0.10126582278481013,0.06172839506172839
"[0, 1, 0, 0, 0, 0, 0, 0, 0, 1, 1, 0, 1, 0, 1]",260,156,104,17,10,0.10897435897435898,0.09615384615384616
"[0, 1, 1, 0, 0, 0, 0, 1, 0, 1, 1, 0, 0, 1, 1]",170,106,64,14,7,0.1320754716981132,0.109375
"[0, 1, 0, 0, 0, 1, 1, 0, 0, 0, 1, 0, 0, 0, 1]",257,167,90,10,13,0.059880239520958084,0.14444444444444443
"[1, 0, 1, 0, 0, 1, 0, 0, 1, 1, 1, 0, 0, 1, 0]",127,71,56,8,1,0.11267605633802817,0.017857142857142856
"[0, 1, 1, 1, 0, 0, 1, 0, 0, 0, 1, 1, 1, 1, 1]",219,103,116,7,14,0.06796116504854369,0.1206896551724138
"[0, 1, 1, 1, 1, 0, 0, 1, 1, 1, 0, 0, 1, 0, 0]",163,95,68,11,10,0.11578947368421053,0.14705882352941177
"[1, 1, 0, 1, 0, 1, 0, 1, 1, 0, 1, 1, 1, 1, 0]",237,81,156,9,11,0.1111111111111111,0.07051282051282051
"[1, 0, 1, 1, 1, 1, 1, 0, 1, 0, 1, 0, 1, 0, 1]",208,61,147,8,15,0.13114754098360656,0.10204081632653061
"[1, 0, 1, 1, 0, 1, 1, 1, 1, 1, 0, 1, 0, 1, 0]",210,69,141,7,21,0.10144927536231885,0.14893617021276595
"[1, 0, 1, 0, 1, 1, 1, 0, 1, 1, 0, 1, 1, 0, 1]",239,90,149,10,23,0.1111111111111111,0.15436241610738255
"[0, 0, 0, 1, 0, 0, 1, 1, 1, 1, 1, 1, 1, 0, 0]",243,133,110,13,8,0.09774436090225563,0.07272727272727272
"[0, 0, 0, 1, 0, 1, 0, 0, 0, 0, 0, 0, 1, 0, 1]",552,382,170,39,14,0.10209424083769633,0.08235294117647059
"[0, 0, 0, 1, 0, 0, 0, 1, 0, 1, 1, 1, 0, 0, 0]",273,179,94,15,6,0.08379888268156424,0.06382978723404255
"[1, 1, 1, 1, 0, 1, 0, 0, 1, 0, 1, 0, 0, 1, 1]",168,59,109,6,11,0.1016949152542373,0.10091743119266056
"[0, 0, 1, 1, 0, 1, 0, 1, 1, 1, 1, 1, 1, 0, 0]",242,101,141,10,13,0.09900990099009901,0.09219858156028368
"[0, 1, 1, 1, 1, 1, 0, 0, 1, 1, 0, 1, 0, 1, 1]",267,115,152,3,8,0.02608695652173913,0.05263157894736842
"[0, 0, 0, 0, 1, 1, 0, 1, 1, 0, 0, 1, 0, 1, 0]",171,109,62,12,7,0.11009174311926606,0.11290322580645161
"[1, 0, 0, 0, 0, 0, 0, 1, 1, 0, 1, 1, 1, 0, 1]",173,66,107,2,12,0.030303030303030304,0.11214953271028037
"[1, 1, 0, 1, 0, 0, 1, 0, 1, 1, 1, 0, 1, 1, 1]",238,73,165,5,17,0.0684931506849315,0.10303030303030303
"[1, 1, 1, 0, 0, 0, 1, 1, 0, 0, 1, 1, 1, 0, 0]",161,62,99,2,10,0.03225806451612903,0.10101010101010101
"[1, 0, 1, 0, 0, 1, 1, 1, 0, 0, 1, 1, 0, 1, 0]",119,42,77,6,9,0.14285714285714285,0.11688311688311688
"[0, 1, 1, 1, 0, 1, 0, 1, 0, 0, 0, 0, 0, 0, 0]",324,197,127,17,10,0.08629441624365482,0.07874015748031496
"[0, 0, 0, 1, 1, 1, 0, 1, 0, 0, 0, 1, 1, 0, 0]",201,125,76,11,6,0.088,0.07894736842105263
"[0, 0, 0, 0, 1, 0, 1, 1, 1, 1, 1, 1, 1, 1, 1]",596,229,367,22,32,0.09606986899563319,0.08719346049046321
"[1, 1, 0, 1, 1, 0, 0, 1, 1, 1, 1, 0, 0, 0, 0]",417,187,230,18,17,0.0962566844919786,0.07391304347826087
"[0, 0, 1, 1, 0, 0, 0, 1, 0, 0, 0, 1, 0, 1, 1]",211,128,83,9,11,0.0703125,0.13253012048192772
"[1, 0, 1, 1, 0, 0, 1, 0, 1, 1, 0, 0, 1, 0, 0]",115,66,49,6,3,0.09090909090909091,0.061224489795918366
"[0, 1, 1, 0, 0, 0, 0, 0, 1, 0, 1, 1, 0, 0, 1]",186,117,69,8,7,0.06837606837606838,0.10144927536231885
"[1, 1, 0, 0, 1, 0, 1, 1, 1, 0, 1, 1, 1, 0, 1]",233,86,147,12,14,0.13953488372093023,0.09523809523809523
"[0, 0, 0, 0, 1, 1, 1, 0, 0, 1, 0, 1, 1, 1, 0]",142,81,61,8,4,0.09876543209876543,0.06557377049180328
"[1, 0, 1, 1, 0, 1, 1, 1, 0, 1, 0, 0, 0, 0, 1]",134,63,71,4,9,0.06349206349206349,0.1267605633802817
"[1, 0, 0, 0, 1, 0, 1, 0, 1, 1, 1, 1, 1, 0, 1]",135,61,74,6,3,0.09836065573770492,0.04054054054054054
"[1, 1, 0, 0, 1, 0, 1, 0, 1, 1, 1, 1, 1, 1, 1]",798,253,545,23,63,0.09090909090909091,0.11559633027522936
"[0, 0, 1, 1, 1, 1, 1, 0, 1, 1, 1, 1, 0, 1, 0]",248,67,181,12,11,0.1791044776119403,0.06077348066298342
"[1, 0, 1, 1, 0, 1, 0, 1, 0, 0, 1, 0, 0, 0, 0]",167,91,76,9,8,0.0989010989010989,0.10526315789473684
"[1, 1, 0, 1, 1, 0, 1, 0, 1, 0, 0, 1, 0, 0, 0]",127,65,62,5,7,0.07692307692307693,0.11290322580645161
"[0, 0, 1, 0, 1, 0, 0, 1, 1, 1, 1, 1, 0, 1, 1]",158,59,99,4,8,0.06779661016949153,0.08080808080808081
"[1, 0, 0, 1, 1, 0, 0, 1, 1, 0, 0, 1, 0, 0, 0]",305,129,176,14,15,0.10852713178294573,0.08522727272727272
"[0, 0, 1, 1, 0, 0, 1, 0, 1, 0, 1, 0, 0, 1, 1]",178,91,87,8,6,0.08791208791208792,0.06896551724137931
"[1, 1, 0, 1, 0, 1, 0, 1, 0, 0, 0, 0, 0, 1, 0]",122,74,48,8,4,0.10810810810810811,0.08333333333333333
"[0, 1, 0, 0, 1, 0, 0, 0, 1, 1, 0, 1, 0, 1, 0]",135,91,44,7,6,0.07692307692307693,0.13636363636363635
"[1, 0, 0, 1, 0, 0, 1, 0, 0, 0, 1, 1, 0, 1, 0]",130,67,63,5,3,0.07462686567164178,0.047619047619047616
"[0, 1, 0, 0, 1, 1, 0, 1, 0, 1, 1, 0, 0, 0, 0]",183,109,74,5,9,0.045871559633027525,0.12162162162162163
"[1, 1, 1, 1, 0, 1, 0, 0, 0, 0, 0, 0, 1, 1, 1]",325,146,179,18,13,0.1232876712328767,0.07262569832402235
"[0, 0, 0, 0, 1, 1, 0, 1, 0, 1, 1, 1, 0, 1, 0]",110,50,60,4,6,0.08,0.1
"[0, 0, 0, 1, 0, 1, 1, 1, 0, 0, 0, 1, 0, 0, 0]",256,163,93,18,8,0.11042944785276074,0.08602150537634409
"[1, 1, 0, 0, 0, 0, 1, 0, 0, 0, 0, 1, 0, 1, 1]",202,120,82,17,9,0.14166666666666666,0.10975609756097561
"[1, 1, 0, 0, 1, 0, 0, 1, 1, 0, 1, 1, 0, 1, 1]",186,73,113,7,13,0.0958904109589041,0.11504424778761062
"[0, 1, 0, 0, 1, 1, 0, 1, 0, 0, 1, 1, 1, 1, 1]",205,87,118,9,13,0.10344827586206896,0.11016949152542373
"[0, 0, 0, 1, 1, 0, 1, 1, 0, 1, 0, 1, 1, 0, 0]",136,62,74,7,7,0.11290322580645161,0.0945945945945946
"[0, 0, 0, 0, 0, 0, 0, 1, 1, 0, 1, 1, 0, 1, 0]",290,199,91,18,8,0.09045226130653267,0.08791208791208792
"[0, 1, 1, 1, 1, 1, 0, 0, 0, 0, 0, 0, 0, 0, 1]",519,288,231,19,20,0.06597222222222222,0.08658008658008658
"[0, 0, 0, 1, 1, 1, 0, 1, 0, 0, 0, 0, 0, 1, 1]",265,182,83,23,12,0.12637362637362637,0.14457831325301204
"[0, 1, 0, 0, 0, 1, 0, 1, 0, 0, 1, 0, 0, 1, 1]",181,112,69,10,2,0.08928571428571429,0.028985507246376812
"[1, 1, 1, 0, 1, 0, 0, 0, 1, 0, 0, 0, 1, 0, 1]",118,64,54,7,3,0.109375,0.05555555555555555
"[1, 1, 0, 1, 0, 1, 1, 1, 0, 0, 0, 0, 0, 1, 0]",103,50,53,4,3,0.08,0.05660377358490566
"[1, 1, 1, 1, 1, 1, 0, 0, 1, 1, 0, 1, 0, 1, 0]",322,131,191,16,20,0.12213740458015267,0.10471204188481675
"[1, 1, 1, 1, 1, 1, 0, 0, 0, 0, 1, 0, 1, 1, 1]",680,259,421,25,32,0.09652509652509653,0.07600950118764846
"[1, 1, 0, 1, 0, 0, 1, 0, 1, 1, 1, 0, 1, 1, 0]",130,49,81,7,7,0.14285714285714285,0.08641975308641975
"[1, 1, 1, 1, 1, 1, 1, 1, 1, 0, 0, 1, 0, 0, 0]",457,128,329,18,36,0.140625,0.1094224924012158
"[0, 1, 1, 1, 0, 1, 0, 1, 1, 0, 0, 0, 0, 1, 1]",211,102,109,6,11,0.058823529411764705,0.10091743119266056
"[1, 1, 1, 1, 0, 0, 0, 0, 1, 0, 1, 0, 0, 0, 1]",176,80,96,4,14,0.05,0.14583333333333334
"[0, 0, 0, 0, 0, 1, 1, 1, 1, 1, 0, 0, 0, 0, 1]",375,248,127,24,5,0.0967741935483871,0.03937007874015748
"[1, 0, 0, 1, 1, 1, 1, 1, 0, 1, 0, 0, 1, 1, 0]",161,66,95,6,7,0.09090909090909091,0.07368421052631578
"[0, 1, 0, 0, 1, 0, 0, 0, 0, 1, 0, 0, 1, 1, 1]",215,122,93,15,9,0.12295081967213115,0.0967741935483871
"[0, 0, 1, 1, 1, 1, 1, 0, 0, 1, 0, 0, 1, 0, 1]",122,58,64,6,5,0.10344827586206896,0.078125
"[1, 1, 0, 0, 0, 0, 0, 1, 0, 0, 1, 0, 1, 0, 0]",246,149,97,13,8,0.087248322147651,0.08247422680412371
"[0, 0, 0, 1, 1, 1, 0, 0, 0, 0, 0, 0, 0, 1, 1]",534,362,172,29,20,0.08011049723756906,0.11627906976744186
"[1, 1, 1, 0, 0, 0, 1, 0, 1, 1, 1, 0, 1, 0, 1]",142,52,90,3,11,0.057692307692307696,0.12222222222222222
"[1, 1, 0, 1, 1, 1, 1, 1, 1, 1, 0, 0, 0, 1, 0]",275,99,176,10,15,0.10101010101010101,0.08522727272727272
"[1, 1, 0, 0, 0, 1, 0, 1, 1, 0, 1, 1, 1, 0, 0]",152,55,97,3,9,0.05454545454545454,0.09278350515463918
"[0, 0, 1, 1, 0, 1, 1, 0, 0, 0, 1, 0, 1, 1, 0]",105,55,50,6,4,0.10909090909090909,0.08
"[0, 0, 0, 1, 0, 1, 0, 0, 1, 1, 0, 1, 1, 0, 1]",97,50,47,5,2,0.1,0.0425531914893617
"[0, 0, 0, 0, 0, 1, 0, 1, 0, 0, 1, 1, 0, 1, 1]",191,125,66,11,6,0.088,0.09090909090909091
"[0, 0, 0, 0, 0, 1, 0, 0, 0, 1, 0, 1, 0, 1, 1]",298,207,91,14,15,0.06763285024154589,0.16483516483516483
"[0, 1, 0, 1, 0, 1, 0, 1, 1, 1, 0, 0, 0, 0, 1]",159,79,80,6,8,0.0759493670886076,0.1
"[0, 0, 1, 1, 1, 1, 1, 0, 0, 1, 0, 0, 1, 1, 1]",275,127,148,10,11,0.07874015748031496,0.07432432432432433
"[0, 1, 1, 0, 0, 0, 0, 1, 0, 1, 1, 0, 1, 0, 1]",112,65,47,6,3,0.09230769230769231,0.06382978723404255
"[1, 1, 0, 1, 1, 1, 1, 1, 0, 1, 1, 0, 0, 0, 0]",236,90,146,12,14,0.13333333333333333,0.0958904109589041
"[0, 0, 1, 1, 1, 0, 0, 0, 0, 0, 1, 1, 1, 1, 1]",300,158,142,18,16,0.11392405063291139,0.11267605633802817
"[0, 0, 0, 1, 1, 0, 1, 0, 1, 0, 0, 1, 0, 1, 1]",136,84,52,8,1,0.09523809523809523,0.019230769230769232
"[1, 0, 0, 0, 0, 0, 1, 0, 1, 0, 1, 1, 1, 0, 1]",115,52,63,5,8,0.09615384615384616,0.12698412698412698
"[1, 1, 0, 1, 0, 0, 1, 0, 0, 0, 0, 1, 0, 1, 1]",133,67,66,5,4,0.07462686567164178,0.06060606060606061
"[1, 0, 1, 0, 1, 1, 0, 1, 1, 0, 0, 0, 0, 1, 0]",107,57,50,6,3,0.10526315789473684,0.06
"[0, 1, 0, 1, 1, 0, 0, 1, 1, 1, 1, 1, 1, 1, 0]",327,129,198,13,23,0.10077519379844961,0.11616161616161616
"[0, 0, 1, 1, 1, 0, 1, 1, 0, 1, 1, 0, 1, 1, 1]",294,107,187,8,17,0.07476635514018691,0.09090909090909091
"[0, 1, 1, 0, 1, 0, 0, 1, 0, 1, 0, 0, 0, 1, 1]",134,72,62,6,3,0.08333333333333333,0.04838709677419355
"[0, 1, 0, 1, 1, 0, 1, 1, 1, 0, 0, 1, 1, 0, 1]",133,49,84,5,8,0.10204081632653061,0.09523809523809523
"[0, 0, 1, 0, 1, 1, 0, 1, 1, 1, 0, 0, 1, 1, 0]",130,68,62,3,9,0.04411764705882353,0.14516129032258066
"[1, 1, 1, 1, 0, 1, 0, 0, 1, 0, 1, 1, 0, 1, 1]",234,82,152,11,17,0.13414634146341464,0.1118421052631579
"[0, 0, 1, 0, 1, 0, 0, 1, 0, 1, 0, 1, 0, 0, 1]",165,100,65,12,6,0.12,0.09230769230769231
"[1, 0, 0, 1, 0, 1, 1, 1, 0, 0, 0, 0, 0, 0, 1]",245,128,117,14,8,0.109375,0.06837606837606838
"[1, 1, 0, 0, 1, 1, 0, 0, 1, 1, 1, 0, 1, 0, 0]",252,126,126,20,11,0.15873015873015872,0.0873015873015873
"[1, 0, 1, 0, 1, 0, 0, 0, 1, 1, 1, 0, 1, 0, 1]",98,52,46,6,6,0.11538461538461539,0.13043478260869565
"[1, 0, 1, 1, 1, 0, 0, 1, 0, 0, 1, 1, 1, 0, 0]",113,64,49,6,7,0.09375,0.14285714285714285
"[0, 1, 1, 1, 1, 0, 1, 0, 0, 0, 0, 0, 0, 1, 0]",153,98,55,10,8,0.10204081632653061,0.14545454545454545
"[0, 0, 1, 0, 1, 0, 0, 0, 0, 0, 0, 1, 0, 0, 1]",504,355,149,31,14,0.08732394366197183,0.09395973154362416
"[1, 1, 1, 0, 1, 1, 1, 0, 1, 0, 0, 0, 0, 1, 0]",121,55,66,6,5,0.10909090909090909,0.07575757575757576
"[0, 1, 0, 0, 1, 0, 1, 1, 0, 0, 1, 1, 1, 1, 0]",173,86,87,10,4,0.11627906976744186,0.04597701149425287
"[1, 0, 0, 1, 0, 0, 0, 1, 0, 0, 1, 1, 1, 0, 0]",168,103,65,10,6,0.0970873786407767,0.09230769230769231
"[0, 0, 1, 1, 1, 0, 1, 1, 1, 1, 0, 1, 1, 1, 1]",636,211,425,15,54,0.07109004739336493,0.12705882352941175
"[1, 0, 0, 1, 0, 1, 1, 1, 0, 1, 1, 0, 0, 1, 0]",112,57,55,9,5,0.15789473684210525,0.09090909090909091
"[1, 1, 0, 0, 1, 0, 1, 1, 1, 0, 1, 1, 0, 0, 1]",166,65,101,5,11,0.07692307692307693,0.10891089108910891
"[1, 0, 1, 1, 1, 1, 0, 0, 0, 0, 0, 1, 1, 0, 0]",222,107,115,17,12,0.1588785046728972,0.10434782608695652
"[1, 0, 0, 1, 0, 1, 1, 1, 1, 0, 1, 1, 1, 1, 0]",248,80,168,4,21,0.05,0.125
"[0, 0, 0, 1, 1, 0, 0, 1, 0, 1, 0, 1, 0, 1, 1]",168,108,60,10,6,0.09259259259259259,0.1
"[0, 0, 0, 0, 0, 1, 0, 0, 1, 0, 1, 1, 0, 0, 1]",276,181,95,26,12,0.143646408839779,0.12631578947368421
"[1, 1, 0, 1, 0, 0, 1, 0, 0, 1, 0, 1, 0, 0, 0]",164,100,64,6,4,0.06,0.0625
"[0, 0, 1, 0, 0, 0, 0, 1, 1, 1, 1, 0, 1, 1, 0]",112,66,46,6,3,0.09090909090909091,0.06521739130434782
"[0, 0, 0, 1, 1, 0, 0, 1, 0, 1, 1, 0, 1, 1, 1]",178,109,69,12,5,0.11009174311926606,0.07246376811594203
"[1, 1, 1, 1, 1, 0, 0, 0, 0, 0, 1, 0, 0, 1, 1]",252,92,160,4,14,0.043478260869565216,0.0875
"[1, 1, 1, 1, 0, 0, 0, 1, 1, 1, 1, 0, 1, 0, 1]",282,100,182,15,22,0.15,0.12087912087912088
"[0, 0, 0, 1, 1, 1, 1, 1, 1, 1, 0, 0, 0, 1, 1]",317,186,131,18,11,0.0967741935483871,0.08396946564885496
"[1, 1, 1, 0, 1, 1, 1, 1, 0, 0, 0, 1, 0, 0, 1]",162,63,99,6,11,0.09523809523809523,0.1111111111111111
"[1, 0, 1, 1, 1, 0, 1, 1, 0, 1, 1, 1, 0, 1, 1]",535,179,356,22,36,0.12290502793296089,0.10112359550561797
"[1, 1, 0, 0, 1, 1, 1, 1, 0, 1, 1, 0, 0, 1, 1]",424,146,278,16,23,0.1095890410958904,0.08273381294964029
"[1, 1, 1, 1, 1, 0, 0, 1, 1, 0, 0, 0, 1, 0, 1]",291,79,212,9,26,0.11392405063291139,0.12264150943396226
"[0, 1, 0, 1, 0, 1, 1, 1, 1, 1, 0, 0, 1, 1, 0]",208,92,116,5,13,0.05434782608695652,0.11206896551724138
"[0, 1, 0, 1, 0, 0, 0, 1, 1, 1, 1, 0, 0, 1, 1]",253,121,132,6,10,0.049586776859504134,0.07575757575757576
"[0, 0, 0, 1, 0, 0, 1, 0, 1, 0, 0, 0, 1, 1, 1]",244,149,95,17,7,0.11409395973154363,0.07368421052631578
"[1, 0, 0, 0, 1, 1, 0, 1, 0, 1, 1, 0, 0, 1, 0]",95,49,46,5,3,0.10204081632653061,0.06521739130434782
"[0, 1, 1, 0, 1, 0, 1, 1, 1, 0, 1, 0, 0, 0, 1]",97,44,53,2,5,0.045454545454545456,0.09433962264150944
"[0, 1, 1, 1, 1, 1, 1, 1, 0, 0, 1, 0, 1, 0, 0]",203,105,98,9,7,0.08571428571428572,0.07142857142857142
"[1, 0, 1, 0, 1, 1, 0, 0, 0, 1, 0, 1, 1, 0, 1]",129,57,72,7,9,0.12280701754385964,0.125
"[1, 0, 0, 0, 1, 1, 1, 0, 0, 0, 1, 1, 0, 1, 1]",158,77,81,8,11,0.1038961038961039,0.13580246913580246
"[1, 1, 0, 0, 0, 0, 0, 0, 1, 0, 1, 0, 1, 0, 0]",264,168,96,21,8,0.125,0.08333333333333333
"[1, 0, 0, 0, 1, 0, 0, 1, 1, 0, 0, 1, 0, 1, 0]",138,83,55,6,5,0.07228915662650602,0.09090909090909091
"[1, 1, 0, 1, 1, 1, 1, 1, 0, 0, 1, 1, 1, 0, 1]",546,175,371,17,35,0.09714285714285714,0.09433962264150944
"[1, 0, 1, 0, 0, 0, 1, 1, 1, 1, 0, 1, 1, 0, 1]",158,67,91,2,6,0.029850746268656716,0.06593406593406594
"[1, 1, 1, 0, 1, 0, 1, 0, 1, 0, 1, 1, 0, 1, 0]",156,61,95,4,10,0.06557377049180328,0.10526315789473684
"[0, 0, 1, 1, 0, 1, 0, 1, 0, 0, 1, 1, 0, 0, 0]",237,140,97,10,10,0.07142857142857142,0.10309278350515463
"[1, 1, 1, 1, 0, 1, 0, 0, 0, 1, 1, 0, 1, 0, 1]",175,79,96,12,7,0.1518987341772152,0.07291666666666667
"[1, 1, 0, 1, 1, 0, 1, 1, 1, 1, 1, 0, 0, 0, 1]",246,93,153,6,15,0.06451612903225806,0.09803921568627451
"[0, 0, 0, 1, 1, 0, 1, 0, 0, 1, 1, 1, 1, 1, 0]",121,61,60,4,5,0.06557377049180328,0.08333333333333333
"[0, 1, 1, 1, 1, 0, 0, 1, 1, 1, 1, 1, 0, 0, 0]",334,190,144,12,13,0.06315789473684211,0.09027777777777778
"[1, 1, 0, 0, 1, 0, 1, 1, 0, 0, 0, 0, 0, 1, 1]",177,81,96,10,13,0.12345679012345678,0.13541666666666666
"[1, 0, 0, 1, 0, 0, 0, 0, 0, 1, 0, 0, 1, 0, 1]",219,137,82,11,9,0.08029197080291971,0.10975609756097561
"[0, 1, 0, 0, 1, 0, 0, 1, 1, 0, 1, 1, 0, 0, 1]",119,70,49,8,5,0.11428571428571428,0.10204081632653061
"[0, 0, 1, 1, 1, 1, 0, 1, 1, 1, 1, 1, 1, 0, 0]",401,135,266,9,18,0.06666666666666667,0.06766917293233082
"[0, 0, 1, 0, 1, 0, 0, 1, 1, 1, 1, 0, 1, 0, 1]",109,47,62,4,7,0.0851063829787234,0.11290322580645161
"[1, 1, 0, 1, 1, 1, 1, 0, 1, 0, 0, 1, 0, 1, 0]",161,63,98,10,6,0.15873015873015872,0.061224489795918366
"[1, 1, 1, 0, 1, 1, 1, 1, 0, 1, 0, 0, 1, 0, 1]",223,71,152,4,14,0.056338028169014086,0.09210526315789473
"[1, 0, 0, 1, 1, 1, 0, 1, 1, 0, 1, 0, 1, 1, 0]",144,53,91,3,8,0.05660377358490566,0.08791208791208792
"[1, 1, 0, 1, 0, 0, 1, 1, 1, 0, 1, 1, 0, 1, 0]",160,63,97,6,8,0.09523809523809523,0.08247422680412371
"[1, 0, 1, 0, 0, 1, 1, 1, 1, 0, 1, 0, 1, 1, 1]",271,93,178,10,18,0.10752688172043011,0.10112359550561797
"[1, 0, 1, 0, 0, 1, 0, 1, 0, 0, 1, 1, 1, 1, 0]",138,70,68,3,8,0.04285714285714286,0.11764705882352941
"[1, 0, 0, 1, 1, 1, 0, 1, 0, 0, 1, 0, 1, 0, 0]",127,71,56,15,4,0.2112676056338028,0.07142857142857142
"[0, 0, 0, 1, 0, 0, 1, 1, 1, 0, 1, 0, 0, 1, 0]",163,115,48,9,4,0.0782608695652174,0.08333333333333333
"[0, 1, 1, 0, 0, 1, 0, 0, 1, 1, 0, 1, 1, 0, 0]",125,76,49,8,6,0.10526315789473684,0.12244897959183673
"[1, 0, 1, 1, 0, 1, 1, 0, 0, 1, 0, 0, 1, 1, 0]",108,39,69,2,5,0.05128205128205128,0.07246376811594203
"[1, 0, 1, 0, 0, 1, 1, 0, 1, 1, 0, 1, 1, 0, 0]",123,51,72,7,2,0.13725490196078433,0.027777777777777776
"[0, 1, 1, 0, 0, 1, 0, 1, 1, 0, 1, 0, 1, 0, 0]",109,63,46,5,5,0.07936507936507936,0.10869565217391304
"[1, 1, 1, 0, 1, 1, 0, 0, 1, 0, 1, 1, 0, 1, 0]",130,55,75,7,6,0.12727272727272726,0.08
"[0, 0, 0, 0, 1, 0, 0, 1, 1, 1, 1, 0, 1, 0, 0]",145,93,52,10,6,0.10752688172043011,0.11538461538461539
"[1, 1, 1, 0, 1, 0, 0, 0, 0, 0, 1, 1, 1, 1, 1]",363,149,214,12,22,0.08053691275167785,0.102803738317757
"[0, 1, 1, 1, 0, 0, 1, 1, 1, 0, 1, 1, 0, 0, 1]",195,88,107,8,5,0.09090909090909091,0.04672897196261682
"[1, 0, 1, 1, 0, 1, 1, 1, 0, 0, 1, 1, 1, 0, 1]",256,92,164,7,13,0.07608695652173914,0.07926829268292683
"[0, 0, 1, 0, 1, 1, 1, 1, 1, 1, 0, 0, 0, 1, 1]",224,107,117,9,12,0.08411214953271028,0.10256410256410256
"[1, 0, 0, 0, 1, 1, 1, 0, 0, 1, 1, 0, 0, 0, 0]",307,163,144,12,11,0.0736196319018405,0.0763888888888889
"[1, 0, 0, 0, 1, 0, 0, 0, 0, 1, 1, 0, 0, 0, 1]",282,176,106,22,13,0.125,0.12264150943396226
"[1, 0, 1, 0, 0, 0, 1, 0, 1, 1, 1, 0, 0, 0, 1]",116,59,57,11,7,0.1864406779661017,0.12280701754385964
"[0, 0, 1, 0, 1, 0, 0, 0, 1, 0, 1, 1, 1, 0, 0]",154,92,62,6,5,0.06521739130434782,0.08064516129032258
"[0, 0, 0, 0, 1, 0, 1, 0, 0, 0, 1, 0, 1, 1, 1]",224,145,79,11,4,0.07586206896551724,0.05063291139240506
"[1, 0, 1, 0, 0, 1, 0, 1, 1, 0, 1, 1, 1, 1, 1]",276,102,174,7,12,0.06862745098039216,0.06896551724137931
"[0, 0, 0, 1, 1, 1, 0, 0, 0, 0, 1, 0, 1, 0, 1]",160,95,65,9,7,0.09473684210526316,0.1076923076923077
"[1, 0, 0, 1, 0, 0, 1, 0, 1, 1, 0, 0, 0, 0, 1]",194,109,85,12,8,0.11009174311926606,0.09411764705882353
"[0, 0, 0, 1, 0, 0, 0, 0, 0, 1, 0, 0, 1, 1, 0]",666,501,165,58,19,0.1157684630738523,0.11515151515151516
"[1, 0, 0, 0, 1, 0, 0, 0, 0, 0, 1, 0, 0, 1, 1]",287,188,99,15,9,0.0797872340425532,0.09090909090909091
"[1, 1, 0, 1, 1, 1, 0, 0, 0, 0, 1, 1, 0, 0, 1]",340,143,197,19,10,0.13286713286713286,0.050761421319796954
"[1, 1, 1, 0, 0, 0, 0, 0, 1, 1, 0, 1, 0, 1, 0]",124,55,69,4,6,0.07272727272727272,0.08695652173913043
"[1, 0, 0, 0, 0, 0, 1, 0, 0, 1, 1, 1, 0, 0, 1]",147,75,72,5,5,0.06666666666666667,0.06944444444444445
"[1, 1, 0, 1, 1, 1, 0, 0, 0, 1, 0, 1, 1, 0, 1]",138,55,83,7,7,0.12727272727272726,0.08433734939759036
"[0, 1, 0, 1, 1, 0, 0, 0, 0, 0, 0, 1, 0, 0, 0]",596,410,186,31,20,0.07560975609756097,0.10752688172043011
"[1, 1, 1, 0, 1, 0, 1, 0, 0, 0, 0, 0, 0, 1, 0]",158,80,78,11,7,0.1375,0.08974358974358974
"[1, 1, 1, 1, 0, 1, 0, 1, 0, 0, 0, 0, 0, 0, 1]",212,110,102,7,5,0.06363636363636363,0.049019607843137254
"[0, 0, 1, 1, 0, 0, 1, 1, 1, 0, 0, 0, 0, 1, 0]",185,114,71,11,3,0.09649122807017543,0.04225352112676056
"[1, 0, 0, 1, 1, 0, 0, 1, 1, 1, 0, 0, 0, 0, 1]",202,76,126,5,8,0.06578947368421052,0.06349206349206349
"[0, 1, 0, 1, 0, 1, 0, 1, 0, 0, 0, 1, 1, 0, 1]",101,58,43,5,9,0.08620689655172414,0.20930232558139536
"[1, 1, 1, 1, 0, 1, 1, 1, 0, 0, 0, 0, 1, 0, 1]",166,73,93,4,6,0.0547945205479452,0.06451612903225806
"[1, 1, 1, 0, 1, 0, 1, 1, 0, 0, 1, 1, 0, 1, 0]",150,52,98,5,5,0.09615384615384616,0.05102040816326531
"[0, 1, 0, 1, 0, 1, 1, 0, 0, 0, 1, 1, 1, 1, 0]",158,74,84,9,7,0.12162162162162163,0.08333333333333333
"[0, 1, 1, 1, 1, 0, 0, 0, 1, 1, 1, 0, 1, 1, 1]",315,152,163,18,24,0.11842105263157894,0.147239263803681
"[0, 0, 1, 0, 1, 1, 0, 0, 1, 1, 1, 0, 1, 1, 1]",178,64,114,2,7,0.03125,0.06140350877192982
"[1, 0, 1, 1, 0, 1, 1, 0, 1, 1, 0, 1, 0, 1, 1]",229,84,145,12,10,0.14285714285714285,0.06896551724137931
"[0, 0, 0, 1, 1, 1, 1, 0, 1, 1, 1, 1, 1, 0, 1]",294,142,152,12,15,0.08450704225352113,0.09868421052631579
"[0, 0, 1, 1, 0, 1, 0, 0, 0, 0, 1, 0, 0, 1, 0]",219,138,81,11,7,0.07971014492753623,0.08641975308641975
"[1, 0, 0, 1, 0, 1, 1, 1, 1, 1, 0, 0, 0, 1, 0]",116,57,59,7,5,0.12280701754385964,0.0847457627118644
"[1, 1, 1, 0, 1, 1, 1, 1, 0, 0, 1, 0, 0, 0, 1]",169,65,104,10,7,0.15384615384615385,0.0673076923076923
"[1, 0, 0, 0, 0, 1, 0, 1, 1, 0, 1, 0, 0, 0, 0]",254,157,97,10,7,0.06369426751592357,0.07216494845360824
"[0, 0, 1, 0, 0, 0, 0, 0, 1, 0, 1, 0, 1, 1, 0]",256,163,93,13,4,0.07975460122699386,0.043010752688172046
"[0, 0, 0, 1, 1, 1, 0, 0, 0, 1, 0, 1, 1, 0, 1]",123,66,57,4,7,0.06060606060606061,0.12280701754385964
"[1, 1, 0, 0, 1, 1, 0, 0, 0, 1, 1, 1, 0, 0, 0]",182,95,87,8,7,0.08421052631578947,0.08045977011494253
"[1, 1, 1, 0, 1, 1, 0, 1, 0, 0, 1, 1, 0, 1, 1]",272,106,166,7,19,0.0660377358490566,0.1144578313253012
"[0, 1, 0, 1, 0, 1, 1, 1, 1, 0, 1, 1, 0, 1, 0]",145,54,91,2,6,0.037037037037037035,0.06593406593406594
"[0, 0, 0, 0, 1, 0, 1, 1, 1, 1, 0, 1, 1, 1, 0]",100,44,56,4,7,0.09090909090909091,0.125
"[1, 0, 0, 0, 0, 0, 0, 1, 0, 1, 1, 1, 1, 0, 1]",127,54,73,8,6,0.14814814814814814,0.0821917808219178
"[0, 1, 1, 1, 1, 0, 0, 0, 0, 1, 1, 1, 0, 0, 1]",264,193,71,21,7,0.10880829015544041,0.09859154929577464
"[1, 0, 1, 1, 0, 1, 1, 1, 1, 0, 1, 1, 1, 0, 0]",282,97,185,9,27,0.09278350515463918,0.14594594594594595
"[0, 1, 1, 0, 1, 1, 0, 1, 0, 1, 0, 0, 1, 0, 1]",108,44,64,2,8,0.045454545454545456,0.125
"[0, 1, 0, 1, 0, 0, 1, 0, 1, 0, 1, 1, 0, 1, 1]",117,59,58,6,2,0.1016949152542373,0.034482758620689655
"[1, 1, 1, 0, 0, 1, 1, 0, 1, 1, 1, 0, 0, 0, 0]",185,72,113,8,9,0.1111111111111111,0.07964601769911504
"[0, 0, 1, 1, 1, 0, 1, 0, 1, 1, 1, 1, 1, 0, 0]",162,81,81,9,5,0.1111111111111111,0.06172839506172839
"[1, 1, 0, 0, 1, 0, 0, 1, 0, 0, 1, 0, 1, 0, 1]",97,42,55,6,8,0.14285714285714285,0.14545454545454545
"[0, 0, 1, 0, 0, 0, 1, 0, 1, 1, 1, 0, 1, 1, 1]",133,67,66,4,2,0.05970149253731343,0.030303030303030304
"[1, 0, 0, 1, 1, 0, 0, 0, 1, 1, 1, 0, 0, 0, 0]",221,121,100,11,7,0.09090909090909091,0.07
"[0, 1, 1, 0, 1, 1, 1, 1, 1, 0, 1, 0, 0, 0, 0]",147,74,73,9,7,0.12162162162162163,0.0958904109589041
"[1, 0, 1, 0, 0, 1, 1, 0, 1, 1, 1, 1, 1, 0, 1]",228,80,148,6,18,0.075,0.12162162162162163
"[0, 1, 0, 0, 0, 0, 0, 1, 0, 1, 0, 0, 1, 1, 0]",266,154,112,20,7,0.12987012987012986,0.0625
"[1, 0, 1, 0, 0, 0, 0, 0, 1, 0, 1, 0, 0, 1, 1]",173,101,72,11,8,0.10891089108910891,0.1111111111111111
"[1, 0, 0, 0, 1, 0, 1, 0, 0, 0, 0, 0, 1, 0, 1]",238,157,81,15,5,0.09554140127388536,0.06172839506172839
"[0, 0, 0, 0, 1, 1, 1, 0, 0, 0, 1, 0, 1, 0, 0]",276,186,90,13,12,0.06989247311827956,0.13333333333333333
"[1, 1, 0, 0, 1, 0, 1, 0, 1, 1, 1, 1, 0, 0, 0]",172,83,89,8,8,0.0963855421686747,0.0898876404494382
"[0, 1, 0, 0, 1, 1, 0, 1, 0, 1, 0, 0, 1, 0, 1]",92,56,36,3,3,0.05357142857142857,0.08333333333333333
"[0, 0, 0, 0, 0, 1, 0, 0, 1, 1, 0, 1, 0, 1, 0]",219,157,62,15,5,0.09554140127388536,0.08064516129032258
"[0, 1, 0, 0, 0, 0, 1, 0, 1, 1, 1, 1, 1, 1, 1]",263,115,148,8,15,0.06956521739130435,0.10135135135135136
"[1, 1, 0, 1, 0, 0, 0, 1, 1, 0, 0, 1, 0, 0, 1]",123,58,65,4,11,0.06896551724137931,0.16923076923076924
"[0, 1, 1, 0, 0, 1, 0, 0, 0, 1, 0, 1, 1, 0, 0]",175,110,65,12,5,0.10909090909090909,0.07692307692307693
"[0, 0, 0, 1, 1, 0, 0, 1, 1, 1, 1, 0, 0, 0, 1]",433,335,98,36,8,0.10746268656716418,0.08163265306122448
"[0, 1, 1, 1, 0, 1, 0, 1, 1, 0, 1, 1, 0, 0, 0]",122,69,53,4,7,0.057971014492753624,0.1320754716981132
"[1, 1, 0, 0, 0, 1, 1, 0, 1, 0, 0, 0, 1, 0, 0]",150,87,63,9,3,0.10344827586206896,0.047619047619047616
"[0, 1, 1, 0, 1, 1, 0, 1, 1, 0, 0, 0, 1, 1, 1]",205,90,115,10,11,0.1111111111111111,0.09565217391304348
"[1, 0, 1, 0, 1, 1, 1, 0, 0, 0, 0, 0, 1, 1, 0]",132,67,65,5,6,0.07462686567164178,0.09230769230769231
"[1, 0, 1, 0, 1, 0, 1, 1, 1, 0, 0, 0, 0, 0, 1]",123,67,56,6,8,0.08955223880597014,0.14285714285714285
"[0, 0, 0, 0, 1, 0, 1, 0, 1, 1, 0, 0, 1, 0, 0]",231,151,80,11,9,0.0728476821192053,0.1125
"[0, 1, 0, 1, 0, 0, 0, 0, 1, 0, 1, 1, 0, 1, 0]",132,68,64,9,6,0.1323529411764706,0.09375
"[0, 1, 0, 0, 1, 0, 1, 1, 1, 0, 1, 0, 1, 0, 1]",89,45,44,3,2,0.06666666666666667,0.045454545454545456
"[1, 1, 1, 0, 0, 1, 0, 0, 0, 0, 0, 0, 0, 1, 1]",308,162,146,20,12,0.12345679012345678,0.0821917808219178
"[1, 0, 0, 1, 0, 1, 0, 1, 0, 0, 1, 0, 1, 0, 0]",146,81,65,8,1,0.09876543209876543,0.015384615384615385
"[1, 1, 1, 0, 0, 1, 0, 1, 0, 1, 0, 0, 1, 0, 1]",107,50,57,11,1,0.22,0.017543859649122806
"[0, 1, 0, 0, 0, 0, 1, 0, 0, 1, 1, 0, 0, 1, 1]",257,161,96,14,11,0.08695652173913043,0.11458333333333333
"[0, 0, 1, 0, 0, 0, 0, 1, 0, 0, 1, 1, 0, 0, 1]",314,208,106,17,8,0.08173076923076923,0.07547169811320754
"[0, 1, 1, 1, 1, 1, 0, 1, 0, 0, 1, 0, 0, 0, 0]",142,77,65,4,3,0.05194805194805195,0.046153846153846156
"[1, 1, 0, 0, 1, 0, 0, 0, 0, 0, 1, 1, 0, 1, 1]",145,83,62,9,7,0.10843373493975904,0.11290322580645161
"[1, 0, 0, 1, 0, 0, 0, 0, 1, 1, 1, 0, 1, 1, 0]",109,52,57,4,10,0.07692307692307693,0.17543859649122806
"[0, 1, 0, 0, 0, 1, 0, 0, 1, 1, 1, 0, 0, 1, 1]",174,99,75,18,3,0.18181818181818182,0.04
"[0, 1, 0, 1, 1, 1, 0, 1, 1, 0, 0, 0, 1, 0, 1]",92,41,51,5,2,0.12195121951219512,0.0392156862745098
"[1, 0, 1, 0, 1, 1, 1, 1, 1, 0, 1, 0, 0, 0, 1]",159,56,103,7,6,0.125,0.05825242718446602
"[0, 0, 0, 0, 0, 0, 0, 1, 0, 1, 0, 1, 1, 1, 1]",446,301,145,37,16,0.12292358803986711,0.1103448275862069
"[0, 1, 1, 0, 1, 1, 1, 0, 1, 0, 1, 1, 1, 1, 0]",221,91,130,9,12,0.0989010989010989,0.09230769230769231
"[1, 1, 1, 0, 0, 0, 0, 0, 1, 1, 1, 1, 0, 0, 1]",356,152,204,13,24,0.08552631578947369,0.11764705882352941
"[1, 0, 0, 0, 0, 1, 0, 1, 1, 0, 0, 0, 1, 0, 0]",241,149,92,23,13,0.15436241610738255,0.14130434782608695
"[1, 0, 1, 0, 0, 1, 1, 0, 0, 1, 1, 1, 0, 1, 1]",149,62,87,5,4,0.08064516129032258,0.04597701149425287
"[1, 0, 1, 0, 1, 1, 0, 1, 0, 1, 0, 0, 0, 0, 0]",158,96,62,6,5,0.0625,0.08064516129032258
"[0, 1, 1, 0, 0, 0, 0, 0, 0, 1, 0, 1, 1, 1, 0]",213,135,78,14,4,0.1037037037037037,0.05128205128205128
"[0, 1, 0, 0, 0, 0, 0, 1, 0, 1, 1, 1, 0, 1, 0]",125,84,41,4,4,0.047619047619047616,0.0975609756097561
"[0, 0, 0, 0, 1, 0, 1, 0, 1, 0, 1, 0, 1, 0, 1]",161,93,68,8,3,0.08602150537634409,0.04411764705882353
"[0, 0, 1, 0, 1, 0, 1, 0, 1, 1, 0, 1, 0, 0, 1]",119,62,57,6,9,0.0967741935483871,0.15789473684210525
"[0, 0, 0, 1, 0, 1, 1, 0, 1, 0, 1, 0, 1, 0, 0]",132,85,47,9,3,0.10588235294117647,0.06382978723404255
"[0, 0, 0, 0, 0, 1, 0, 0, 1, 1, 1, 0, 0, 0, 1]",282,192,90,23,7,0.11979166666666667,0.07777777777777778
"[0, 1, 1, 0, 0, 1, 0, 1, 0, 0, 0, 1, 1, 1, 1]",197,126,71,10,6,0.07936507936507936,0.08450704225352113
"[1, 0, 0, 0, 1, 0, 0, 1, 1, 1, 1, 0, 0, 0, 0]",324,187,137,19,13,0.10160427807486631,0.0948905109489051
"[0, 0, 0, 0, 0, 1, 1, 1, 0, 0, 1, 1, 1, 0, 0]",224,151,73,17,10,0.11258278145695365,0.136986301369863
"[0, 0, 0, 0, 0, 1, 0, 0, 0, 1, 1, 1, 0, 1, 0]",228,148,80,12,7,0.08108108108108109,0.0875
"[1, 0, 1, 1, 1, 0, 0, 0, 0, 1, 1, 0, 1, 0, 0]",129,62,67,6,11,0.0967741935483871,0.16417910447761194
"[0, 1, 1, 1, 1, 0, 1, 1, 0, 1, 1, 1, 0, 0, 0]",189,83,106,5,17,0.060240963855421686,0.16037735849056603
"[0, 1, 1, 1, 1, 0, 1, 1, 0, 0, 1, 1, 0, 0, 0]",203,100,103,10,8,0.1,0.07766990291262135
"[0, 1, 0, 1, 0, 1, 0, 1, 0, 0, 0, 1, 0, 1, 1]",123,70,53,6,4,0.08571428571428572,0.07547169811320754
"[0, 0, 1, 0, 1, 1, 1, 1, 0, 0, 0, 1, 0, 1, 0]",93,57,36,7,0,0.12280701754385964,0.0
"[1, 1, 0, 0, 1, 0, 1, 1, 1, 1, 0, 0, 0, 1, 0]",104,42,62,5,9,0.11904761904761904,0.14516129032258066
"[1, 1, 1, 1, 0, 0, 0, 1, 1, 1, 0, 1, 1, 1, 0]",276,86,190,7,21,0.08139534883720931,0.11052631578947368
"[0, 1, 0, 1, 1, 0, 0, 0, 1, 1, 0, 0, 1, 0, 0]",150,85,65,11,7,0.12941176470588237,0.1076923076923077
"[1, 0, 0, 1, 0, 0, 1, 0, 1, 1, 0, 0, 0, 1, 1]",126,67,59,7,4,0.1044776119402985,0.06779661016949153
"[0, 1, 1, 1, 1, 0, 1, 1, 0, 0, 1, 0, 0, 0, 1]",103,50,53,5,4,0.1,0.07547169811320754
"[0, 1, 1, 1, 0, 0, 0, 1, 1, 0, 1, 1, 0, 0, 0]",131,73,58,10,5,0.136986301369863,0.08620689655172414
"[1, 1, 0, 1, 0, 1, 0, 0, 0, 0, 1, 0, 0, 0, 0]",241,152,89,22,13,0.14473684210526316,0.14606741573033707
"[0, 0, 1, 1, 0, 0, 0, 0, 1, 1, 0, 1, 1, 1, 1]",447,223,224,24,28,0.10762331838565023,0.125
"[1, 1, 0, 0, 1, 0, 0, 0, 0, 1, 1, 0, 1, 1, 1]",175,82,93,11,13,0.13414634146341464,0.13978494623655913
"[1, 0, 1, 0, 1, 0, 0, 0, 0, 0, 0, 1, 1, 1, 0]",154,86,68,5,6,0.05813953488372093,0.08823529411764706
"[1, 0, 1, 1, 1, 0, 1, 1, 0, 1, 0, 1, 1, 1, 0]",204,76,128,8,12,0.10526315789473684,0.09375
"[0, 0, 1, 0, 0, 1, 0, 1, 1, 1, 0, 1, 1, 0, 1]",109,51,58,4,6,0.0784313725490196,0.10344827586206896
"[1, 0, 0, 1, 1, 1, 0, 1, 0, 1, 1, 1, 0, 1, 1]",234,84,150,8,20,0.09523809523809523,0.13333333333333333
"[0, 0, 1, 1, 1, 1, 1, 0, 0, 1, 0, 1, 1, 1, 0]",195,72,123,5,10,0.06944444444444445,0.08130081300813008
"[1, 0, 1, 0, 1, 0, 1, 1, 1, 1, 1, 1, 1, 0, 1]",546,161,385,23,38,0.14285714285714285,0.0987012987012987
"[1, 1, 0, 0, 0, 1, 0, 0, 0, 1, 1, 1, 0, 0, 1]",135,73,62,7,5,0.0958904109589041,0.08064516129032258
"[1, 0, 1, 1, 1, 0, 1, 0, 0, 0, 1, 1, 0, 1, 1]",129,45,84,2,11,0.044444444444444446,0.13095238095238096
"[1, 1, 1, 0, 1, 0, 1, 1, 1, 0, 1, 0, 0, 0, 1]",136,56,80,11,10,0.19642857142857142,0.125
"[0, 1, 1, 1, 0, 1, 0, 1, 1, 1, 0, 1, 0, 0, 0]",99,45,54,9,2,0.2,0.037037037037037035
"[0, 0, 0, 1, 1, 1, 1, 1, 0, 0, 1, 1, 0, 0, 1]",349,182,167,12,22,0.06593406593406594,0.1317365269461078
"[1, 1, 0, 0, 1, 0, 0, 0, 1, 1, 0, 1, 1, 1, 0]",105,48,57,6,5,0.125,0.08771929824561403
"[0, 1, 1, 0, 0, 1, 0, 0, 0, 1, 1, 0, 1, 1, 1]",136,70,66,6,6,0.08571428571428572,0.09090909090909091
"[0, 0, 0, 0, 1, 0, 0, 0, 1, 0, 1, 0, 0, 0, 1]",568,403,165,40,16,0.09925558312655088,0.09696969696969697
"[1, 0, 1, 0, 0, 0, 1, 1, 0, 0, 0, 0, 1, 0, 1]",161,82,79,9,7,0.10975609756097561,0.08860759493670886
"[0, 1, 1, 1, 0, 0, 0, 0, 0, 0, 0, 1, 0, 0, 1]",312,202,110,25,12,0.12376237623762376,0.10909090909090909
"[0, 1, 1, 0, 0, 0, 1, 1, 1, 1, 0, 0, 1, 1, 0]",315,161,154,21,18,0.13043478260869565,0.11688311688311688
"[0, 1, 0, 1, 1, 1, 1, 0, 0, 0, 1, 1, 1, 0, 1]",158,60,98,6,9,0.1,0.09183673469387756
"[0, 0, 0, 0, 0, 0, 1, 0, 0, 0, 1, 1, 1, 1, 1]",467,330,137,32,9,0.09696969696969697,0.06569343065693431
"[0, 1, 1, 1, 1, 0, 1, 0, 0, 1, 1, 1, 0, 1, 1]",268,114,154,9,12,0.07894736842105263,0.07792207792207792
"[0, 0, 0, 1, 1, 0, 1, 1, 0, 1, 0, 0, 0, 1, 0]",137,84,53,9,3,0.10714285714285714,0.05660377358490566
"[0, 1, 1, 0, 0, 0, 1, 0, 0, 1, 0, 0, 0, 0, 1]",282,195,87,16,7,0.08205128205128205,0.08045977011494253
"[0, 0, 1, 0, 1, 0, 1, 1, 0, 0, 0, 1, 0, 1, 1]",145,77,68,8,7,0.1038961038961039,0.10294117647058823
"[1, 0, 0, 1, 0, 0, 0, 0, 1, 0, 1, 0, 1, 1, 0]",178,101,77,8,5,0.07920792079207921,0.06493506493506493
"[0, 0, 0, 1, 0, 1, 1, 1, 1, 0, 0, 0, 1, 0, 0]",176,105,71,6,4,0.05714285714285714,0.056338028169014086
"[1, 1, 0, 0, 0, 0, 1, 0, 1, 1, 1, 1, 0, 0, 0]",194,101,93,13,5,0.12871287128712872,0.053763440860215055
"[1, 0, 1, 1, 0, 0, 0, 0, 1, 0, 1, 1, 1, 1, 0]",117,58,59,4,4,0.06896551724137931,0.06779661016949153
"[0, 0, 0, 1, 1, 0, 1, 1, 1, 1, 1, 0, 1, 0, 1]",141,67,74,7,5,0.1044776119402985,0.06756756756756757
"[0, 0, 1, 1, 0, 0, 1, 0, 1, 0, 1, 0, 1, 0, 0]",149,86,63,8,9,0.09302325581395349,0.14285714285714285
"[0, 1, 0, 1, 1, 0, 1, 1, 0, 1, 1, 0, 0, 1, 1]",171,76,95,7,8,0.09210526315789473,0.08421052631578947
"[1, 1, 0, 1, 1, 0, 0, 1, 0, 1, 1, 0, 1, 1, 0]",135,49,86,8,8,0.16326530612244897,0.09302325581395349
"[1, 1, 1, 0, 0, 0, 1, 1, 1, 0, 1, 0, 1, 1, 1]",306,98,208,3,17,0.030612244897959183,0.08173076923076923
"[1, 0, 0, 1, 1, 1, 0, 0, 1, 1, 1, 1, 0, 0, 0]",262,118,144,8,15,0.06779661016949153,0.10416666666666667
"[0, 0, 1, 0, 1, 1, 1, 0, 0, 0, 1, 1, 0, 0, 1]",138,82,56,8,3,0.0975609756097561,0.05357142857142857
"[0, 0, 0, 0, 1, 0, 1, 1, 1, 0, 0, 0, 1, 1, 0]",161,103,58,12,6,0.11650485436893204,0.10344827586206896
"[1, 0, 0, 0, 0, 0, 1, 0, 1, 1, 1, 0, 0, 0, 1]",172,96,76,9,9,0.09375,0.11842105263157894
"[0, 1, 0, 0, 1, 0, 1, 0, 1, 1, 1, 0, 0, 0, 0]",195,114,81,14,9,0.12280701754385964,0.1111111111111111
"[0, 0, 0, 1, 0, 0, 0, 0, 1, 0, 1, 0, 0, 1, 1]",296,196,100,28,8,0.14285714285714285,0.08
"[1, 0, 0, 0, 0, 1, 0, 1, 1, 1, 1, 1, 1, 0, 0]",201,90,111,9,15,0.1,0.13513513513513514
"[1, 0, 1, 0, 1, 0, 0, 1, 1, 1, 1, 0, 1, 0, 1]",119,45,74,2,9,0.044444444444444446,0.12162162162162163
"[0, 1, 1, 0, 1, 0, 1, 1, 1, 1, 1, 0, 0, 0, 1]",170,74,96,12,9,0.16216216216216217,0.09375
"[0, 0, 1, 0, 1, 1, 1, 1, 1, 0, 0, 0, 1, 0, 0]",123,59,64,5,7,0.0847457627118644,0.109375
"[1, 0, 1, 1, 0, 0, 0, 0, 0, 0, 1, 0, 1, 1, 1]",195,111,84,11,10,0.0990990990990991,0.11904761904761904
"[0, 1, 0, 1, 0, 0, 0, 1, 1, 1, 1, 0, 1, 1, 1]",191,85,106,5,10,0.058823529411764705,0.09433962264150944
"[1, 0, 1, 1, 1, 1, 1, 0, 0, 1, 0, 0, 0, 0, 1]",146,78,68,12,8,0.15384615384615385,0.11764705882352941
"[1, 1, 0, 0, 0, 0, 1, 1, 0, 0, 1, 1, 0, 1, 0]",301,159,142,17,16,0.1069182389937107,0.11267605633802817
"[0, 1, 1, 1, 0, 1, 1, 1, 0, 1, 1, 1, 0, 0, 0]",164,71,93,9,7,0.1267605633802817,0.07526881720430108
"[0, 0, 1, 0, 0, 1, 0, 0, 1, 1, 1, 1, 1, 1, 0]",190,90,100,13,11,0.14444444444444443,0.11
"[1, 1, 0, 0, 0, 0, 0, 1, 1, 0, 1, 0, 0, 0, 0]",296,187,109,15,9,0.08021390374331551,0.08256880733944955
"[0, 1, 0, 0, 1, 1, 0, 1, 1, 1, 0, 0, 0, 1, 0]",97,46,51,5,7,0.10869565217391304,0.13725490196078433
"[0, 0, 1, 0, 0, 1, 0, 0, 0, 0, 1, 1, 1, 1, 0]",274,170,104,17,10,0.1,0.09615384615384616
"[0, 0, 0, 0, 1, 1, 1, 0, 1, 1, 1, 1, 0, 1, 1]",193,89,104,4,13,0.0449438202247191,0.125
"[0, 1, 0, 1, 1, 0, 0, 0, 1, 0, 1, 1, 0, 1, 1]",114,51,63,5,5,0.09803921568627451,0.07936507936507936
"[0, 0, 0, 0, 1, 0, 1, 0, 1, 0, 1, 1, 0, 0, 0]",279,166,113,15,18,0.09036144578313253,0.1592920353982301
"[1, 0, 1, 0, 1, 0, 1, 0, 1, 1, 1, 0, 1, 1, 1]",270,95,175,6,19,0.06315789473684211,0.10857142857142857
"[0, 0, 1, 1, 1, 0, 1, 1, 0, 0, 1, 0, 1, 1, 0]",108,50,58,5,6,0.1,0.10344827586206896
"[1, 1, 1, 0, 1, 1, 1, 1, 1, 0, 1, 0, 1, 1, 0]",488,119,369,14,36,0.11764705882352941,0.0975609756097561
"[0, 1, 0, 0, 0, 0, 0, 1, 1, 1, 0, 0, 1, 1, 0]",224,138,86,12,5,0.08695652173913043,0.05813953488372093
"[1, 1, 1, 0, 0, 1, 0, 1, 1, 0, 0, 1, 1, 1, 0]",169,70,99,8,9,0.11428571428571428,0.09090909090909091
"[1, 0, 1, 1, 1, 0, 0, 1, 1, 1, 0, 0, 0, 0, 1]",154,70,84,2,12,0.02857142857142857,0.14285714285714285
"[1, 0, 0, 0, 1, 0, 1, 1, 1, 0, 0, 1, 1, 1, 0]",122,60,62,6,2,0.1,0.03225806451612903
"[0, 0, 1, 1, 0, 1, 0, 0, 1, 1, 1, 0, 0, 0, 1]",110,56,54,6,4,0.10714285714285714,0.07407407407407407
"[0, 1, 0, 1, 1, 0, 1, 0, 0, 0, 1, 1, 0, 1, 0]",119,66,53,3,7,0.045454545454545456,0.1320754716981132
"[1, 0, 0, 1, 1, 0, 1, 1, 1, 1, 0, 0, 1, 1, 0]",232,85,147,4,16,0.047058823529411764,0.10884353741496598
"[0, 0, 1, 0, 0, 1, 1, 0, 1, 1, 1, 1, 0, 0, 1]",163,73,90,6,6,0.0821917808219178,0.06666666666666667
"[0, 0, 0, 0, 1, 0, 1, 1, 1, 0, 1, 0, 0, 1, 0]",128,75,53,7,3,0.09333333333333334,0.05660377358490566
"[0, 0, 0, 1, 0, 1, 0, 1, 0, 1, 1, 1, 1, 1, 1]",230,109,121,6,11,0.05504587155963303,0.09090909090909091
"[0, 1, 0, 1, 0, 0, 1, 1, 1, 0, 1, 0, 1, 0, 0]",112,65,47,5,2,0.07692307692307693,0.0425531914893617
"[0, 0, 0, 1, 0, 1, 0, 0, 1, 1, 1, 1, 1, 1, 0]",205,99,106,15,8,0.15151515151515152,0.07547169811320754
"[1, 0, 0, 0, 0, 1, 0, 1, 0, 1, 0, 0, 0, 0, 1]",250,149,101,14,12,0.09395973154362416,0.1188118811881188
"[0, 0, 0, 1, 0, 0, 0, 1, 0, 0, 0, 1, 1, 1, 0]",268,189,79,16,6,0.08465608465608465,0.0759493670886076
"[1, 1, 0, 0, 1, 0, 0, 1, 1, 0, 1, 0, 0, 0, 0]",175,95,80,6,4,0.06315789473684211,0.05
"[0, 1, 0, 1, 0, 1, 1, 1, 1, 1, 1, 1, 0, 0, 0]",253,107,146,13,17,0.12149532710280374,0.11643835616438356
"[1, 1, 1, 0, 1, 1, 1, 1, 0, 0, 0, 1, 1, 0, 0]",232,92,140,6,17,0.06521739130434782,0.12142857142857143
"[0, 1, 1, 1, 1, 1, 0, 0, 1, 0, 0, 0, 1, 0, 0]",117,71,46,9,4,0.1267605633802817,0.08695652173913043
"[0, 1, 1, 1, 1, 0, 1, 1, 1, 0, 0, 1, 0, 0, 0]",141,70,71,4,7,0.05714285714285714,0.09859154929577464
"[0, 1, 0, 0, 1, 0, 1, 1, 1, 1, 1, 0, 1, 0, 0]",124,54,70,7,1,0.12962962962962962,0.014285714285714285
"[1, 1, 0, 1, 1, 1, 0, 0, 1, 0, 1, 0, 1, 0, 1]",140,63,77,3,8,0.047619047619047616,0.1038961038961039
"[0, 0, 1, 0, 0, 1, 0, 1, 0, 1, 1, 0, 1, 0, 1]",108,53,55,4,6,0.07547169811320754,0.10909090909090909
"[1, 1, 0, 0, 1, 0, 0, 1, 0, 1, 0, 1, 1, 0, 1]",106,51,55,4,3,0.0784313725490196,0.05454545454545454
"[0, 1, 1, 0, 1, 1, 0, 1, 0, 1, 1, 0, 1, 0, 1]",127,49,78,6,6,0.12244897959183673,0.07692307692307693
"[0, 1, 1, 0, 1, 0, 1, 0, 0, 0, 0, 0, 1, 0, 1]",141,89,52,13,6,0.14606741573033707,0.11538461538461539
"[0, 1, 1, 0, 0, 1, 1, 0, 0, 1, 0, 0, 0, 1, 0]",198,149,49,12,8,0.08053691275167785,0.16326530612244897
"[0, 1, 1, 1, 0, 0, 0, 0, 1, 0, 0, 1, 0, 0, 1]",152,86,66,10,9,0.11627906976744186,0.13636363636363635
"[1, 1, 0, 1, 0, 1, 1, 1, 0, 0, 0, 0, 1, 0, 0]",120,67,53,2,1,0.029850746268656716,0.018867924528301886
"[0, 0, 0, 0, 0, 0, 1, 1, 1, 1, 1, 0, 1, 0, 0]",268,164,104,15,11,0.09146341463414634,0.10576923076923077
"[1, 1, 0, 1, 0, 1, 0, 0, 0, 1, 0, 0, 0, 0, 0]",284,178,106,19,6,0.10674157303370786,0.05660377358490566
"[1, 0, 1, 1, 0, 1, 1, 1, 1, 0, 1, 0, 0, 1, 0]",131,56,75,7,6,0.125,0.08
"[1, 1, 0, 0, 0, 1, 1, 0, 0, 0, 1, 1, 0, 1, 0]",91,50,41,2,7,0.04,0.17073170731707318
"[1, 1, 1, 0, 0, 0, 0, 1, 1, 1, 1, 0, 1, 0, 0]",222,56,166,7,8,0.125,0.04819277108433735
"[1, 0, 0, 0, 0, 0, 0, 1, 1, 1, 1, 1, 0, 1, 1]",337,94,243,7,17,0.07446808510638298,0.06995884773662552
"[1, 1, 0, 1, 0, 0, 0, 1, 1, 0, 0, 0, 0, 0, 1]",196,119,77,12,14,0.10084033613445378,0.18181818181818182
"[1, 0, 0, 0, 1, 0, 1, 0, 0, 0, 0, 0, 0, 1, 1]",390,227,163,24,20,0.10572687224669604,0.12269938650306748
"[1, 0, 1, 1, 0, 0, 0, 1, 0, 1, 0, 1, 1, 1, 0]",119,51,68,3,6,0.058823529411764705,0.08823529411764706
"[0, 0, 0, 0, 1, 1, 0, 1, 0, 1, 1, 0, 0, 0, 1]",171,107,64,8,5,0.07476635514018691,0.078125
"[1, 0, 1, 1, 0, 1, 1, 0, 1, 0, 1, 0, 0, 1, 1]",141,67,74,9,9,0.13432835820895522,0.12162162162162163
"[1, 0, 1, 0, 1, 0, 1, 1, 0, 1, 1, 0, 1, 0, 1]",137,65,72,7,4,0.1076923076923077,0.05555555555555555
"[0, 0, 1, 1, 1, 1, 0, 1, 1, 1, 0, 0, 0, 0, 1]",201,92,109,10,11,0.10869565217391304,0.10091743119266056
"[0, 0, 0, 0, 0, 1, 1, 0, 1, 1, 1, 1, 1, 1, 1]",376,209,167,19,8,0.09090909090909091,0.04790419161676647
"[1, 1, 1, 1, 0, 1, 0, 0, 0, 1, 0, 0, 1, 1, 1]",197,84,113,7,13,0.08333333333333333,0.11504424778761062
"[1, 1, 0, 0, 1, 0, 1, 0, 0, 1, 1, 1, 0, 0, 1]",128,71,57,11,3,0.15492957746478872,0.05263157894736842
"[1, 1, 0, 1, 1, 0, 1, 0, 1, 1, 1, 0, 0, 1, 1]",311,111,200,11,14,0.0990990990990991,0.07
"[0, 1, 0, 1, 0, 1, 1, 1, 1, 1, 1, 1, 0, 1, 1]",557,165,392,15,36,0.09090909090909091,0.09183673469387756
"[1, 1, 1, 1, 1, 1, 0, 1, 0, 1, 1, 0, 0, 1, 0]",273,83,190,5,23,0.060240963855421686,0.12105263157894737
"[1, 0, 0, 0, 0, 0, 1, 1, 0, 0, 1, 1, 0, 1, 1]",195,100,95,8,12,0.08,0.12631578947368421
"[1, 0, 1, 0, 0, 1, 0, 0, 0, 1, 0, 0, 1, 0, 1]",139,85,54,10,7,0.11764705882352941,0.12962962962962962
"[0, 1, 1, 1, 1, 0, 1, 1, 1, 0, 1, 0, 0, 1, 0]",140,54,86,3,12,0.05555555555555555,0.13953488372093023
"[0, 1, 0, 1, 1, 1, 1, 0, 1, 1, 1, 0, 1, 0, 0]",144,59,85,3,9,0.05084745762711865,0.10588235294117647
"[1, 1, 0, 0, 1, 0, 1, 1, 1, 1, 0, 0, 0, 0, 1]",235,91,144,11,11,0.12087912087912088,0.0763888888888889
"[0, 0, 1, 0, 0, 1, 1, 1, 1, 1, 0, 1, 1, 0, 0]",143,70,73,12,10,0.17142857142857143,0.136986301369863
"[1, 1, 1, 0, 0, 1, 0, 1, 1, 0, 0, 1, 1, 0, 0]",228,98,130,7,15,0.07142857142857142,0.11538461538461539
"[0, 0, 0, 1, 1, 1, 1, 0, 1, 0, 0, 1, 0, 1, 1]",140,85,55,10,5,0.11764705882352941,0.09090909090909091
"[1, 1, 1, 0, 1, 0, 1, 0, 1, 0, 0, 1, 1, 1, 1]",331,119,212,18,19,0.15126050420168066,0.08962264150943396
"[0, 1, 1, 1, 0, 1, 0, 0, 0, 1, 0, 0, 1, 0, 0]",121,75,46,9,6,0.12,0.13043478260869565
"[1, 0, 0, 0, 0, 1, 0, 0, 1, 1, 0, 0, 0, 1, 1]",186,96,90,10,9,0.10416666666666667,0.1
"[0, 1, 1, 0, 1, 1, 1, 0, 0, 0, 0, 0, 0, 0, 1]",217,127,90,10,7,0.07874015748031496,0.07777777777777778
"[1, 1, 0, 0, 0, 0, 1, 1, 0, 1, 1, 1, 0, 0, 0]",176,94,82,10,12,0.10638297872340426,0.14634146341463414
"[1, 0, 0, 1, 1, 0, 1, 0, 1, 0, 1, 1, 1, 0, 0]",126,50,76,7,6,0.14,0.07894736842105263
"[1, 1, 1, 0, 1, 1, 1, 1, 0, 0, 1, 0, 1, 1, 0]",230,79,151,8,12,0.10126582278481013,0.07947019867549669
"[0, 0, 0, 1, 0, 1, 1, 0, 1, 1, 0, 1, 0, 1, 0]",97,40,57,0,8,0.0,0.14035087719298245
"[1, 0, 0, 0, 1, 0, 1, 1, 0, 1, 1, 0, 1, 0, 1]",109,54,55,4,2,0.07407407407407407,0.03636363636363636
"[1, 0, 1, 0, 0, 0, 1, 0, 1, 1, 0, 1, 1, 0, 1]",110,50,60,6,3,0.12,0.05
"[0, 1, 1, 1, 0, 0, 1, 1, 0, 1, 0, 0, 0, 0, 1]",121,67,54,10,3,0.14925373134328357,0.05555555555555555
"[1, 1, 0, 1, 1, 0, 1, 1, 1, 1, 1, 0, 1, 0, 0]",261,90,171,11,13,0.12222222222222222,0.07602339181286549
"[0, 1, 0, 0, 1, 1, 1, 0, 1, 0, 1, 0, 0, 0, 1]",102,55,47,4,4,0.07272727272727272,0.0851063829787234
"[0, 1, 1, 1, 1, 0, 1, 1, 0, 1, 0, 0, 1, 1, 1]",288,120,168,7,12,0.058333333333333334,0.07142857142857142
"[1, 0, 1, 0, 1, 1, 0, 1, 1, 1, 0, 0, 1, 1, 0]",178,82,96,11,10,0.13414634146341464,0.10416666666666667
"[1, 0, 0, 1, 0, 0, 1, 0, 0, 1, 0, 0, 1, 1, 1]",158,88,70,7,6,0.07954545454545454,0.08571428571428572
"[1, 1, 0, 1, 1, 0, 1, 1, 1, 0, 1, 0, 0, 1, 0]",140,63,77,4,4,0.06349206349206349,0.05194805194805195
"[1, 1, 1, 0, 0, 0, 1, 0, 1, 0, 1, 0, 1, 0, 0]",120,60,60,9,6,0.15,0.1
"[0, 1, 1, 1, 0, 0, 0, 1, 0, 1, 0, 1, 0, 1, 0]",113,63,50,5,5,0.07936507936507936,0.1
"[0, 0, 0, 0, 1, 1, 1, 0, 0, 0, 1, 0, 1, 0, 1]",170,91,79,10,7,0.10989010989010989,0.08860759493670886
"[0, 1, 0, 0, 1, 1, 1, 0, 1, 0, 0, 1, 0, 0, 0]",161,109,52,12,7,0.11009174311926606,0.1346153846153846
"[0, 1, 0, 1, 1, 1, 0, 0, 0, 1, 1, 0, 1, 1, 1]",153,74,79,6,7,0.08108108108108109,0.08860759493670886
"[1, 1, 0, 1, 0, 0, 1, 0, 0, 1, 1, 1, 1, 0, 1]",140,60,80,4,9,0.06666666666666667,0.1125
"[0, 1, 0, 1, 1, 0, 1, 0, 0, 1, 0, 0, 1, 1, 1]",131,59,72,4,6,0.06779661016949153,0.08333333333333333
"[1, 1, 0, 0, 0, 0, 0, 0, 0, 1, 0, 1, 1, 0, 1]",183,103,80,8,8,0.07766990291262135,0.1
"[1, 0, 1, 1, 1, 0, 1, 0, 0, 0, 1, 1, 1, 0, 0]",126,65,61,6,3,0.09230769230769231,0.04918032786885246
"[0, 0, 1, 1, 0, 1, 0, 1, 1, 1, 0, 1, 0, 0, 0]",114,63,51,9,4,0.14285714285714285,0.0784313725490196
"[0, 1, 0, 1, 0, 0, 1, 1, 0, 1, 0, 1, 1, 1, 0]",118,56,62,4,4,0.07142857142857142,0.06451612903225806
"[0, 1, 1, 1, 1, 1, 0, 0, 1, 1, 1, 0, 0, 1, 1]",385,180,205,21,22,0.11666666666666667,0.1073170731707317
"[1, 0, 1, 1, 1, 0, 1, 0, 1, 1, 1, 0, 0, 1, 0]",134,46,88,3,11,0.06521739130434782,0.125
"[0, 1, 0, 1, 0, 1, 1, 0, 0, 1, 1, 1, 0, 1, 0]",114,47,67,2,10,0.0425531914893617,0.14925373134328357
"[1, 1, 1, 0, 1, 0, 0, 1, 1, 0, 0, 1, 1, 0, 0]",290,126,164,12,18,0.09523809523809523,0.10975609756097561
"[0, 1, 0, 1, 0, 0, 1, 0, 1, 1, 0, 1, 1, 0, 1]",112,60,52,3,6,0.05,0.11538461538461539
"[1, 0, 1, 1, 0, 0, 1, 1, 0, 1, 0, 1, 0, 0, 1]",112,53,59,5,7,0.09433962264150944,0.11864406779661017
"[0, 0, 0, 1, 1, 0, 0, 1, 0, 0, 1, 0, 0, 1, 1]",243,185,58,15,10,0.08108108108108109,0.1724137931034483
"[0, 0, 0, 0, 1, 1, 0, 0, 1, 0, 0, 1, 0, 0, 1]",337,219,118,24,12,0.1095890410958904,0.1016949152542373
"[0, 0, 1, 1, 0, 0, 1, 0, 1, 0, 0, 1, 1, 0, 1]",108,51,57,4,4,0.0784313725490196,0.07017543859649122
"[0, 1, 0, 1, 0, 1, 1, 1, 1, 1, 0, 0, 0, 1, 1]",189,77,112,7,7,0.09090909090909091,0.0625
"[1, 0, 1, 0, 1, 0, 1, 1, 1, 1, 1, 0, 0, 0, 1]",163,78,85,10,14,0.1282051282051282,0.16470588235294117
"[0, 0, 1, 1, 0, 1, 0, 1, 0, 1, 1, 1, 1, 1, 0]",167,68,99,8,9,0.11764705882352941,0.09090909090909091
"[0, 0, 0, 1, 1, 0, 1, 0, 1, 0, 0, 1, 0, 0, 0]",258,174,84,15,6,0.08620689655172414,0.07142857142857142
"[0, 0, 0, 1, 0, 1, 1, 1, 0, 0, 1, 0, 0, 0, 0]",295,181,114,17,5,0.09392265193370165,0.043859649122807015
"[1, 1, 0, 0, 0, 1, 1, 0, 0, 0, 1, 1, 1, 1, 0]",164,71,93,7,9,0.09859154929577464,0.0967741935483871
"[0, 0, 0, 1, 1, 0, 1, 0, 0, 0, 1, 0, 1, 1, 0]",150,98,52,11,8,0.11224489795918367,0.15384615384615385
"[1, 1, 0, 1, 0, 1, 1, 1, 1, 0, 1, 0, 1, 1, 0]",227,101,126,12,11,0.1188118811881188,0.0873015873015873
"[0, 1, 1, 1, 0, 0, 0, 0, 0, 0, 1, 0, 1, 1, 0]",168,105,63,7,5,0.06666666666666667,0.07936507936507936
"[1, 1, 1, 1, 0, 1, 0, 0, 1, 1, 0, 1, 1, 0, 1]",238,97,141,7,18,0.07216494845360824,0.1276595744680851
"[1, 1, 1, 0, 1, 1, 0, 1, 1, 1, 0, 0, 1, 0, 1]",249,88,161,5,11,0.056818181818181816,0.06832298136645963
"[0, 1, 1, 0, 1, 1, 1, 1, 0, 1, 0, 1, 0, 1, 0]",138,69,69,4,6,0.057971014492753624,0.08695652173913043
"[1, 0, 0, 1, 1, 0, 1, 0, 0, 1, 1, 1, 0, 1, 0]",97,48,49,5,4,0.10416666666666667,0.08163265306122448
"[0, 0, 0, 0, 1, 0, 0, 1, 0, 0, 0, 1, 1, 1, 1]",303,206,97,22,10,0.10679611650485436,0.10309278350515463
"[1, 0, 1, 0, 0, 0, 0, 0, 0, 1, 0, 1, 0, 1, 0]",245,167,78,16,11,0.09580838323353294,0.14102564102564102
"[0, 0, 1, 1, 1, 1, 0, 0, 1, 1, 1, 0, 1, 1, 0]",239,114,125,11,16,0.09649122807017543,0.128
"[0, 0, 0, 0, 0, 0, 1, 0, 1, 1, 1, 1, 0, 1, 0]",154,93,61,9,3,0.0967741935483871,0.04918032786885246
"[1, 0, 0, 0, 0, 1, 1, 0, 1, 1, 0, 1, 1, 0, 0]",163,74,89,3,12,0.04054054054054054,0.1348314606741573
"[0, 0, 0, 1, 0, 1, 0, 0, 1, 0, 1, 1, 1, 0, 0]",156,90,66,4,9,0.044444444444444446,0.13636363636363635
"[1, 1, 0, 0, 1, 1, 0, 1, 1, 1, 1, 1, 0, 1, 0]",248,102,146,9,12,0.08823529411764706,0.0821917808219178
"[1, 1, 0, 1, 1, 0, 0, 1, 0, 1, 0, 1, 1, 0, 0]",131,51,80,3,6,0.058823529411764705,0.075
"[1, 1, 1, 0, 1, 1, 0, 0, 1, 0, 1, 0, 1, 1, 0]",152,63,89,5,7,0.07936507936507936,0.07865168539325842
"[1, 0, 0, 1, 0, 1, 0, 0, 1, 1, 0, 1, 1, 0, 0]",120,66,54,5,5,0.07575757575757576,0.09259259259259259
"[0, 0, 1, 1, 1, 0, 0, 1, 0, 1, 1, 0, 0, 0, 0]",187,116,71,10,8,0.08620689655172414,0.11267605633802817
"[1, 0, 0, 0, 0, 0, 0, 1, 1, 1, 0, 0, 1, 0, 1]",184,84,100,12,8,0.14285714285714285,0.08
"[1, 0, 1, 1, 0, 1, 1, 1, 1, 1, 0, 0, 0, 0, 0]",198,79,119,5,12,0.06329113924050633,0.10084033613445378
"[1, 0, 1, 1, 0, 0, 1, 1, 0, 0, 1, 0, 1, 1, 1]",197,77,120,3,18,0.03896103896103896,0.15
"[0, 0, 1, 0, 1, 1, 1, 0, 1, 1, 0, 0, 1, 1, 0]",147,70,77,9,10,0.12857142857142856,0.12987012987012986
"[0, 0, 1, 0, 1, 0, 1, 0, 0, 1, 0, 0, 1, 0, 1]",118,65,53,5,4,0.07692307692307693,0.07547169811320754
"[1, 1, 0, 0, 1, 0, 0, 0, 0, 1, 0, 1, 0, 1, 0]",133,85,48,8,3,0.09411764705882353,0.0625
"[1, 1, 1, 1, 1, 0, 1, 0, 1, 0, 0, 0, 1, 1, 0]",168,63,105,3,12,0.047619047619047616,0.11428571428571428
"[0, 1, 0, 0, 0, 1, 1, 0, 0, 0, 0, 0, 1, 0, 1]",240,147,93,12,9,0.08163265306122448,0.0967741935483871
"[1, 0, 0, 0, 0, 1, 0, 1, 0, 1, 0, 1, 0, 1, 0]",139,79,60,11,6,0.13924050632911392,0.1
"[1, 1, 1, 1, 0, 0, 0, 1, 1, 0, 1, 1, 1, 1, 0]",281,85,196,4,21,0.047058823529411764,0.10714285714285714
"[0, 0, 1, 0, 1, 1, 1, 1, 1, 0, 0, 0, 1, 1, 0]",130,65,65,9,11,0.13846153846153847,0.16923076923076924
"[1, 0, 0, 0, 0, 1, 0, 1, 1, 1, 1, 1, 0, 0, 0]",178,83,95,6,5,0.07228915662650602,0.05263157894736842
"[1, 0, 0, 1, 1, 1, 0, 0, 0, 0, 1, 0, 1, 1, 1]",139,61,78,7,5,0.11475409836065574,0.0641025641025641
"[0, 0, 1, 1, 1, 1, 1, 0, 0, 0, 0, 0, 1, 0, 0]",204,121,83,13,7,0.10743801652892562,0.08433734939759036
"[0, 0, 0, 1, 1, 1, 0, 1, 0, 1, 0, 1, 0, 1, 1]",126,63,63,3,5,0.047619047619047616,0.07936507936507936
"[0, 1, 0, 0, 0, 0, 0, 1, 1, 1, 0, 1, 0, 1, 0]",135,76,59,6,12,0.07894736842105263,0.2033898305084746
"[1, 0, 1, 1, 0, 0, 0, 0, 0, 0, 1, 0, 1, 0, 1]",139,76,63,5,6,0.06578947368421052,0.09523809523809523
"[1, 0, 1, 1, 1, 0, 0, 0, 0, 1, 0, 0, 1, 1, 0]",131,71,60,9,5,0.1267605633802817,0.08333333333333333
"[1, 0, 0, 0, 0, 1, 0, 1, 1, 1, 1, 0, 0, 0, 0]",247,127,120,10,14,0.07874015748031496,0.11666666666666667
"[1, 1, 0, 0, 0, 0, 0, 1, 0, 0, 1, 1, 1, 1, 0]",162,88,74,6,8,0.06818181818181818,0.10810810810810811
"[0, 1, 1, 0, 1, 0, 1, 1, 1, 1, 0, 1, 1, 0, 1]",235,92,143,7,12,0.07608695652173914,0.08391608391608392
"[1, 1, 0, 1, 0, 0, 1, 0, 1, 1, 0, 1, 0, 0, 1]",129,69,60,6,6,0.08695652173913043,0.1
"[0, 0, 0, 1, 1, 1, 1, 1, 0, 1, 0, 1, 1, 0, 1]",156,80,76,4,6,0.05,0.07894736842105263
"[0, 1, 0, 0, 0, 0, 1, 1, 1, 0, 0, 1, 1, 1, 1]",242,117,125,14,13,0.11965811965811966,0.104
"[0, 0, 0, 1, 1, 1, 1, 1, 0, 1, 1, 1, 0, 1, 1]",323,151,172,18,10,0.11920529801324503,0.05813953488372093
"[0, 1, 1, 0, 0, 0, 1, 1, 1, 1, 1, 0, 1, 1, 1]",342,146,196,14,28,0.0958904109589041,0.14285714285714285
"[1, 0, 0, 0, 1, 1, 0, 1, 1, 1, 0, 1, 1, 1, 1]",309,104,205,9,21,0.08653846153846154,0.1024390243902439
"[0, 0, 1, 0, 1, 1, 1, 0, 0, 0, 0, 1, 1, 0, 0]",325,204,121,21,10,0.10294117647058823,0.08264462809917356
"[0, 1, 1, 1, 1, 0, 1, 1, 1, 0, 0, 1, 1, 1, 0]",265,96,169,11,12,0.11458333333333333,0.07100591715976332
"[1, 0, 0, 0, 0, 0, 1, 1, 0, 1, 0, 1, 1, 0, 0]",195,108,87,8,8,0.07407407407407407,0.09195402298850575
"[0, 0, 1, 0, 1, 1, 0, 0, 0, 0, 0, 1, 1, 0, 1]",147,89,58,7,6,0.07865168539325842,0.10344827586206896
"[0, 0, 0, 0, 0, 1, 1, 1, 0, 1, 0, 1, 0, 1, 1]",162,98,64,12,6,0.12244897959183673,0.09375
"[0, 1, 1, 1, 0, 1, 1, 1, 1, 1, 1, 0, 1, 0, 0]",229,88,141,7,14,0.07954545454545454,0.09929078014184398
"[1, 0, 1, 1, 0, 1, 0, 0, 0, 0, 1, 0, 1, 0, 0]",148,89,59,4,7,0.0449438202247191,0.11864406779661017
"[1, 1, 1, 0, 0, 1, 0, 1, 1, 0, 0, 1, 1, 1, 1]",423,136,287,16,17,0.11764705882352941,0.059233449477351915
"[1, 1, 1, 1, 1, 1, 0, 0, 1, 1, 1, 0, 0, 1, 0]",379,137,242,5,31,0.0364963503649635,0.128099173553719
"[0, 1, 0, 1, 0, 0, 0, 1, 1, 1, 1, 1, 1, 0, 1]",170,74,96,12,5,0.16216216216216217,0.052083333333333336
"[0, 1, 1, 0, 0, 1, 0, 1, 1, 0, 1, 1, 0, 0, 0]",144,81,63,9,1,0.1111111111111111,0.015873015873015872
"[1, 1, 1, 1, 1, 0, 0, 1, 1, 1, 0, 0, 1, 0, 1]",311,86,225,12,23,0.13953488372093023,0.10222222222222223
"[0, 0, 1, 1, 1, 1, 1, 0, 0, 1, 1, 1, 0, 0, 1]",252,91,161,8,25,0.08791208791208792,0.15527950310559005
"[0, 1, 0, 0, 0, 0, 0, 0, 1, 1, 1, 0, 0, 1, 1]",256,154,102,11,9,0.07142857142857142,0.08823529411764706
"[1, 1, 1, 0, 0, 0, 1, 0, 1, 1, 0, 1, 0, 1, 1]",166,60,106,11,12,0.18333333333333332,0.11320754716981132
"[0, 1, 1, 1, 0, 0, 0, 1, 0, 1, 1, 0, 1, 0, 1]",108,47,61,7,7,0.14893617021276595,0.11475409836065574
"[1, 0, 1, 0, 1, 1, 0, 0, 0, 1, 0, 0, 1, 1, 0]",114,54,60,6,3,0.1111111111111111,0.05
"[1, 1, 0, 1, 0, 1, 1, 0, 0, 0, 1, 0, 0, 1, 1]",151,68,83,4,7,0.058823529411764705,0.08433734939759036
"[0, 1, 1, 1, 0, 0, 1, 0, 0, 1, 1, 0, 0, 1, 0]",108,62,46,5,3,0.08064516129032258,0.06521739130434782
"[0, 0, 1, 1, 1, 0, 0, 1, 0, 0, 1, 1, 0, 0, 1]",163,84,79,9,7,0.10714285714285714,0.08860759493670886
"[1, 0, 1, 0, 0, 0, 1, 1, 1, 0, 0, 1, 1, 1, 0]",126,50,76,2,6,0.04,0.07894736842105263
"[0, 1, 1, 0, 0, 1, 1, 1, 0, 1, 1, 0, 0, 1, 1]",226,105,121,8,11,0.0761904761904762,0.09090909090909091
"[0, 0, 1, 1, 1, 0, 0, 1, 1, 0, 1, 0, 1, 0, 0]",115,59,56,11,6,0.1864406779661017,0.10714285714285714
"[0, 1, 0, 0, 1, 0, 1, 0, 0, 1, 1, 1, 0, 0, 1]",127,65,62,7,7,0.1076923076923077,0.11290322580645161
"[1, 0, 1, 0, 1, 0, 1, 0, 0, 0, 0, 0, 1, 1, 1]",164,86,78,11,3,0.12790697674418605,0.038461538461538464
"[1, 1, 0, 1, 1, 1, 0, 1, 1, 0, 1, 0, 1, 0, 1]",207,70,137,8,9,0.11428571428571428,0.06569343065693431
"[0, 0, 1, 0, 0, 1, 0, 1, 0, 1, 1, 0, 0, 0, 1]",152,86,66,16,4,0.18604651162790697,0.06060606060606061
"[1, 1, 1, 1, 0, 0, 0, 0, 0, 0, 1, 1, 0, 1, 0]",302,151,151,18,10,0.11920529801324503,0.06622516556291391
"[0, 1, 0, 1, 0, 1, 0, 1, 0, 1, 1, 1, 0, 0, 1]",122,52,70,3,3,0.057692307692307696,0.04285714285714286
"[1, 0, 1, 1, 0, 1, 0, 0, 0, 1, 0, 1, 0, 1, 1]",90,38,52,4,2,0.10526315789473684,0.038461538461538464
"[0, 1, 1, 1, 0, 1, 0, 0, 1, 1, 0, 0, 0, 1, 0]",108,54,54,5,4,0.09259259259259259,0.07407407407407407
"[0, 0, 1, 1, 1, 0, 1, 0, 0, 1, 1, 0, 0, 0, 1]",119,54,65,5,1,0.09259259259259259,0.015384615384615385
"[1, 1, 0, 0, 1, 1, 1, 0, 0, 0, 0, 0, 1, 0, 1]",135,66,69,4,10,0.06060606060606061,0.14492753623188406
"[1, 0, 0, 1, 0, 0, 1, 1, 1, 1, 0, 0, 1, 0, 1]",130,50,80,6,14,0.12,0.175
"[1, 0, 0, 0, 1, 1, 0, 1, 1, 0, 1, 1, 1, 0, 0]",131,60,71,5,12,0.08333333333333333,0.16901408450704225
"[1, 0, 0, 1, 1, 0, 1, 1, 0, 1, 0, 1, 1, 0, 0]",99,49,50,3,5,0.061224489795918366,0.1
"[0, 1, 0, 0, 1, 1, 1, 0, 1, 1, 0, 0, 1, 1, 0]",121,56,65,8,5,0.14285714285714285,0.07692307692307693
"[1, 1, 0, 0, 0, 0, 1, 0, 1, 1, 0, 1, 0, 0, 1]",116,57,59,9,7,0.15789473684210525,0.11864406779661017
"[0, 1, 0, 1, 0, 1, 1, 0, 0, 0, 0, 1, 0, 1, 1]",104,46,58,5,4,0.10869565217391304,0.06896551724137931
"[0, 1, 0, 0, 1, 1, 1, 1, 0, 0, 0, 1, 0, 1, 1]",137,63,74,5,9,0.07936507936507936,0.12162162162162163
"[0, 1, 1, 0, 0, 1, 0, 0, 0, 1, 0, 0, 0, 0, 1]",272,182,90,9,3,0.04945054945054945,0.03333333333333333
"[1, 1, 1, 0, 1, 1, 1, 1, 0, 1, 1, 0, 0, 1, 0]",243,75,168,8,16,0.10666666666666667,0.09523809523809523
"[0, 0, 1, 0, 1, 1, 0, 1, 0, 0, 1, 1, 1, 0, 1]",118,56,62,5,4,0.08928571428571429,0.06451612903225806
"[1, 1, 0, 1, 1, 1, 0, 0, 0, 0, 1, 0, 0, 1, 0]",117,56,61,5,8,0.08928571428571429,0.13114754098360656
"[0, 1, 1, 0, 0, 0, 0, 1, 1, 1, 0, 0, 1, 0, 0]",207,139,68,9,7,0.06474820143884892,0.10294117647058823
"[0, 0, 0, 0, 0, 1, 1, 0, 1, 1, 1, 1, 0, 0, 0]",262,158,104,22,9,0.13924050632911392,0.08653846153846154
"[0, 0, 1, 0, 1, 1, 1, 0, 1, 1, 1, 1, 0, 1, 1]",234,78,156,5,12,0.0641025641025641,0.07692307692307693
"[0, 1, 0, 0, 0, 0, 0, 0, 1, 0, 1, 1, 1, 0, 1]",125,80,45,6,5,0.075,0.1111111111111111
"[0, 1, 1, 0, 0, 1, 0, 1, 1, 0, 0, 0, 1, 1, 0]",139,79,60,8,7,0.10126582278481013,0.11666666666666667
"[0, 0, 1, 1, 1, 0, 0, 1, 0, 1, 0, 1, 0, 1, 1]",125,57,68,6,5,0.10526315789473684,0.07352941176470588
"[1, 0, 0, 0, 0, 0, 1, 1, 1, 1, 0, 0, 1, 0, 1]",157,75,82,5,3,0.06666666666666667,0.036585365853658534
"[1, 1, 0, 1, 0, 0, 1, 0, 1, 0, 1, 1, 1, 0, 0]",119,63,56,5,5,0.07936507936507936,0.08928571428571429
"[1, 1, 0, 1, 0, 0, 1, 0, 0, 1, 0, 0, 0, 0, 1]",146,93,53,11,2,0.11827956989247312,0.03773584905660377
"[0, 1, 1, 0, 0, 1, 1, 1, 0, 1, 1, 1, 1, 1, 0]",279,105,174,9,19,0.08571428571428572,0.10919540229885058
"[1, 1, 0, 1, 0, 0, 1, 1, 1, 0, 0, 1, 1, 1, 0]",154,60,94,4,9,0.06666666666666667,0.09574468085106383
"[0, 1, 1, 0, 1, 1, 1, 0, 0, 0, 1, 0, 0, 1, 1]",118,60,58,5,5,0.08333333333333333,0.08620689655172414
"[0, 0, 1, 0, 0, 0, 1, 1, 1, 1, 0, 1, 0, 1, 1]",108,54,54,5,4,0.09259259259259259,0.07407407407407407
"[1, 0, 1, 1, 1, 0, 1, 0, 0, 0, 1, 1, 1, 1, 1]",320,114,206,12,19,0.10526315789473684,0.09223300970873786
"[1, 1, 1, 0, 1, 1, 1, 1, 0, 1, 1, 1, 0, 0, 0]",348,108,240,10,25,0.09259259259259259,0.10416666666666667
"[1, 1, 0, 1, 1, 0, 0, 0, 1, 1, 1, 1, 0, 0, 0]",212,100,112,11,17,0.11,0.15178571428571427
"[1, 0, 1, 0, 1, 0, 1, 1, 0, 1, 0, 1, 0, 1, 1]",135,54,81,7,6,0.12962962962962962,0.07407407407407407
"[1, 0, 1, 0, 0, 1, 1, 1, 0, 0, 1, 1, 1, 0, 1]",154,62,92,7,7,0.11290322580645161,0.07608695652173914
"[1, 0, 1, 1, 0, 0, 1, 0, 0, 0, 1, 0, 1, 1, 0]",98,54,44,7,6,0.12962962962962962,0.13636363636363635
"[1, 0, 1, 0, 1, 1, 1, 1, 0, 0, 0, 0, 1, 0, 0]",131,74,57,8,6,0.10810810810810811,0.10526315789473684
"[0, 1, 0, 1, 1, 0, 0, 1, 0, 1, 1, 1, 1, 0, 0]",148,79,69,8,5,0.10126582278481013,0.07246376811594203
"[1, 1, 1, 0, 0, 1, 0, 0, 0, 0, 1, 0, 1, 1, 0]",139,67,72,4,6,0.05970149253731343,0.08333333333333333
"[1, 1, 0, 1, 1, 0, 0, 0, 1, 0, 0, 0, 1, 0, 1]",109,60,49,5,1,0.08333333333333333,0.02040816326530612
"[0, 1, 0, 0, 0, 0, 0, 1, 0, 1, 1, 0, 1, 0, 0]",238,152,86,22,5,0.14473684210526316,0.05813953488372093
"[0, 0, 0, 0, 0, 1, 0, 1, 1, 1, 0, 0, 1, 0, 0]",253,155,98,16,7,0.1032258064516129,0.07142857142857142
"[0, 1, 1, 0, 1, 0, 0, 1, 1, 0, 1, 1, 0, 1, 1]",141,54,87,5,9,0.09259259259259259,0.10344827586206896
"[1, 1, 1, 0, 1, 1, 0, 1, 0, 0, 0, 1, 1, 0, 1]",137,46,91,5,10,0.10869565217391304,0.10989010989010989
"[1, 1, 1, 0, 1, 0, 1, 1, 0, 0, 1, 0, 0, 1, 1]",183,66,117,7,7,0.10606060606060606,0.05982905982905983
"[0, 1, 1, 1, 0, 1, 0, 1, 1, 0, 0, 1, 0, 0, 1]",121,56,65,5,8,0.08928571428571429,0.12307692307692308
"[0, 0, 1, 0, 0, 1, 0, 1, 1, 0, 0, 0, 1, 1, 1]",142,79,63,10,9,0.12658227848101267,0.14285714285714285
"[1, 0, 0, 1, 0, 1, 1, 0, 1, 1, 0, 0, 1, 0, 0]",97,59,38,6,2,0.1016949152542373,0.05263157894736842
"[0, 0, 1, 0, 1, 1, 1, 0, 1, 1, 0, 1, 0, 0, 0]",105,50,55,1,9,0.02,0.16363636363636364
"[0, 0, 0, 1, 0, 1, 1, 1, 0, 1, 1, 0, 1, 0, 0]",101,47,54,4,4,0.0851063829787234,0.07407407407407407
"[0, 1, 0, 1, 0, 1, 0, 1, 1, 1, 1, 0, 1, 1, 1]",259,86,173,4,17,0.046511627906976744,0.09826589595375723
"[1, 0, 1, 0, 0, 1, 0, 1, 0, 1, 0, 0, 1, 0, 0]",140,91,49,7,5,0.07692307692307693,0.10204081632653061
"[0, 1, 0, 0, 1, 1, 0, 1, 1, 0, 0, 1, 0, 0, 1]",126,65,61,1,5,0.015384615384615385,0.08196721311475409
"[0, 0, 0, 0, 1, 0, 0, 1, 1, 0, 1, 1, 1, 0, 1]",110,61,49,3,6,0.04918032786885246,0.12244897959183673
"[0, 1, 0, 0, 0, 0, 1, 0, 0, 1, 1, 0, 1, 1, 1]",125,62,63,4,9,0.06451612903225806,0.14285714285714285
"[1, 1, 0, 1, 0, 0, 0, 1, 1, 0, 1, 1, 1, 1, 0]",146,63,83,7,8,0.1111111111111111,0.0963855421686747
"[1, 0, 0, 1, 1, 0, 0, 0, 1, 0, 0, 0, 1, 1, 1]",219,89,130,7,10,0.07865168539325842,0.07692307692307693
"[0, 0, 1, 0, 1, 1, 0, 0, 1, 1, 0, 0, 0, 1, 0]",150,88,62,10,3,0.11363636363636363,0.04838709677419355
"[1, 1, 1, 0, 0, 0, 1, 0, 1, 0, 0, 1, 0, 0, 1]",122,59,63,2,7,0.03389830508474576,0.1111111111111111
"[0, 1, 1, 0, 1, 1, 0, 0, 1, 1, 0, 1, 0, 1, 0]",113,52,61,3,6,0.057692307692307696,0.09836065573770492
"[0, 0, 1, 1, 0, 1, 1, 0, 0, 1, 1, 0, 1, 0, 1]",127,61,66,5,9,0.08196721311475409,0.13636363636363635
"[1, 1, 1, 1, 0, 0, 0, 1, 1, 0, 1, 1, 0, 0, 1]",209,78,131,8,15,0.10256410256410256,0.11450381679389313
"[1, 0, 1, 1, 1, 0, 1, 0, 1, 1, 0, 1, 0, 0, 1]",133,59,74,11,11,0.1864406779661017,0.14864864864864866
"[1, 1, 0, 1, 1, 1, 0, 1, 0, 1, 1, 0, 1, 0, 0]",131,49,82,2,13,0.04081632653061224,0.15853658536585366
"[1, 0, 0, 1, 1, 0, 1, 1, 1, 1, 0, 1, 0, 0, 1]",140,50,90,3,6,0.06,0.06666666666666667
"[1, 0, 0, 0, 0, 0, 1, 0, 0, 0, 1, 0, 1, 0, 0]",542,346,196,29,19,0.0838150289017341,0.09693877551020408
"[0, 0, 1, 0, 1, 0, 0, 1, 0, 1, 0, 0, 0, 1, 0]",215,137,78,16,7,0.11678832116788321,0.08974358974358974
"[0, 1, 0, 0, 0, 1, 0, 1, 1, 1, 1, 0, 0, 0, 1]",128,65,63,8,7,0.12307692307692308,0.1111111111111111
"[0, 1, 1, 1, 1, 0, 0, 1, 1, 1, 0, 0, 1, 1, 0]",226,123,103,12,7,0.0975609756097561,0.06796116504854369
"[0, 1, 1, 0, 1, 1, 1, 1, 0, 0, 1, 1, 1, 0, 0]",187,79,108,7,10,0.08860759493670886,0.09259259259259259
"[1, 1, 1, 1, 1, 1, 0, 0, 1, 0, 0, 0, 1, 0, 1]",172,74,98,12,12,0.16216216216216217,0.12244897959183673
"[1, 0, 0, 0, 0, 1, 1, 1, 0, 0, 1, 0, 0, 0, 1]",153,75,78,6,7,0.08,0.08974358974358974
"[0, 0, 1, 1, 1, 0, 0, 0, 1, 1, 0, 1, 0, 0, 1]",116,63,53,6,3,0.09523809523809523,0.05660377358490566
"[1, 0, 0, 0, 0, 1, 1, 0, 0, 1, 1, 1, 1, 1, 0]",394,95,299,8,28,0.08421052631578947,0.09364548494983277
"[0, 1, 0, 0, 1, 1, 1, 0, 1, 0, 0, 1, 1, 1, 0]",98,53,45,5,5,0.09433962264150944,0.1111111111111111
"[1, 0, 1, 0, 0, 1, 1, 1, 1, 0, 1, 0, 1, 0, 1]",111,50,61,4,3,0.08,0.04918032786885246
"[0, 1, 1, 1, 0, 1, 1, 0, 1, 0, 0, 0, 0, 0, 1]",107,57,50,3,3,0.05263157894736842,0.06
"[1, 0, 0, 1, 0, 0, 1, 0, 0, 1, 0, 1, 1, 1, 1]",140,58,82,4,13,0.06896551724137931,0.15853658536585366
"[1, 1, 0, 1, 1, 0, 0, 0, 0, 1, 0, 0, 0, 0, 1]",144,87,57,7,7,0.08045977011494253,0.12280701754385964
"[0, 0, 1, 1, 0, 1, 0, 1, 1, 1, 0, 0, 1, 1, 0]",148,65,83,3,7,0.046153846153846156,0.08433734939759036
"[0, 1, 1, 0, 0, 0, 1, 1, 0, 0, 1, 1, 0, 1, 0]",146,84,62,7,6,0.08333333333333333,0.0967741935483871
"[1, 1, 1, 1, 1, 1, 1, 1, 0, 1, 0, 1, 0, 0, 0]",371,116,255,18,21,0.15517241379310345,0.08235294117647059
"[0, 1, 0, 0, 1, 0, 1, 1, 0, 1, 1, 1, 1, 1, 0]",136,50,86,9,7,0.18,0.08139534883720931
"[0, 0, 1, 1, 1, 1, 0, 1, 0, 1, 1, 0, 1, 0, 1]",152,54,98,7,11,0.12962962962962962,0.11224489795918367
"[0, 0, 1, 0, 1, 1, 0, 0, 1, 1, 1, 1, 1, 1, 0]",276,113,163,10,8,0.08849557522123894,0.049079754601226995
"[1, 0, 1, 1, 0, 0, 0, 1, 0, 0, 1, 1, 0, 1, 1]",103,56,47,6,5,0.10714285714285714,0.10638297872340426
"[0, 0, 1, 1, 0, 1, 0, 0, 1, 0, 0, 0, 1, 1, 0]",147,88,59,10,5,0.11363636363636363,0.0847457627118644
"[0, 0, 0, 1, 1, 0, 1, 0, 0, 1, 0, 0, 0, 1, 1]",204,120,84,14,5,0.11666666666666667,0.05952380952380952
"[1, 0, 1, 0, 0, 0, 1, 0, 0, 1, 1, 0, 0, 1, 0]",129,83,46,9,3,0.10843373493975904,0.06521739130434782
"[1, 1, 0, 0, 0, 0, 0, 1, 0, 1, 1, 0, 1, 0, 0]",165,92,73,8,6,0.08695652173913043,0.0821917808219178
"[0, 0, 1, 1, 0, 1, 1, 0, 0, 1, 0, 1, 0, 1, 0]",122,72,50,4,3,0.05555555555555555,0.06
"[0, 1, 0, 1, 1, 1, 0, 1, 0, 0, 0, 0, 0, 1, 1]",143,77,66,11,4,0.14285714285714285,0.06060606060606061
"[1, 1, 0, 0, 0, 1, 0, 1, 1, 1, 1, 0, 1, 1, 0]",159,68,91,5,4,0.07352941176470588,0.04395604395604396
"[0, 0, 1, 1, 1, 1, 1, 0, 0, 0, 1, 1, 1, 0, 1]",175,83,92,8,8,0.0963855421686747,0.08695652173913043
"[0, 1, 1, 1, 0, 0, 0, 1, 0, 1, 0, 1, 1, 1, 1]",175,89,86,4,7,0.0449438202247191,0.08139534883720931
"[0, 0, 1, 0, 0, 0, 0, 1, 0, 1, 1, 0, 1, 1, 1]",147,81,66,6,8,0.07407407407407407,0.12121212121212122
"[1, 1, 1, 0, 0, 1, 0, 1, 1, 0, 1, 1, 0, 0, 1]",164,60,104,7,6,0.11666666666666667,0.057692307692307696
"[0, 1, 1, 1, 0, 0, 1, 0, 1, 1, 0, 1, 1, 0, 0]",123,53,70,5,5,0.09433962264150944,0.07142857142857142
"[1, 0, 1, 1, 1, 0, 0, 0, 1, 0, 0, 1, 1, 0, 0]",141,72,69,9,8,0.125,0.11594202898550725
"[1, 0, 1, 1, 0, 1, 1, 1, 0, 0, 0, 1, 0, 0, 1]",109,63,46,6,5,0.09523809523809523,0.10869565217391304
"[0, 0, 0, 1, 0, 1, 1, 1, 0, 0, 1, 0, 1, 0, 1]",127,75,52,3,1,0.04,0.019230769230769232
"[0, 0, 1, 0, 1, 1, 0, 1, 0, 1, 0, 0, 0, 1, 0]",138,94,44,8,6,0.0851063829787234,0.13636363636363635
"[0, 0, 0, 1, 0, 1, 1, 0, 1, 0, 1, 0, 0, 0, 1]",165,99,66,12,4,0.12121212121212122,0.06060606060606061
"[0, 1, 1, 0, 0, 1, 1, 1, 0, 1, 0, 0, 0, 0, 0]",227,133,94,12,9,0.09022556390977443,0.09574468085106383
"[1, 0, 1, 0, 0, 0, 1, 1, 1, 1, 1, 0, 1, 1, 1]",248,85,163,8,12,0.09411764705882353,0.0736196319018405
"[0, 1, 0, 0, 1, 0, 1, 1, 1, 0, 1, 0, 0, 1, 0]",104,59,45,10,7,0.1694915254237288,0.15555555555555556
"[1, 0, 1, 1, 0, 0, 1, 0, 0, 0, 1, 0, 0, 1, 0]",123,68,55,5,9,0.07352941176470588,0.16363636363636364
"[1, 0, 0, 0, 0, 1, 1, 1, 0, 0, 1, 1, 0, 1, 0]",108,40,68,2,7,0.05,0.10294117647058823
"[0, 1, 1, 0, 1, 0, 1, 1, 1, 0, 1, 1, 1, 0, 1]",223,80,143,6,15,0.075,0.1048951048951049
"[0, 0, 1, 1, 1, 1, 0, 1, 1, 1, 0, 0, 0, 0, 0]",188,91,97,14,7,0.15384615384615385,0.07216494845360824
"[0, 1, 0, 1, 0, 0, 0, 0, 1, 1, 0, 1, 1, 0, 1]",109,54,55,4,8,0.07407407407407407,0.14545454545454545
"[1, 0, 1, 1, 1, 1, 0, 0, 0, 0, 1, 1, 0, 1, 0]",130,66,64,3,8,0.045454545454545456,0.125
"[0, 0, 0, 0, 1, 0, 0, 0, 1, 1, 1, 0, 1, 1, 1]",149,90,59,5,5,0.05555555555555555,0.0847457627118644
"[0, 0, 1, 0, 0, 1, 0, 0, 1, 1, 1, 1, 1, 0, 0]",160,78,82,13,8,0.16666666666666666,0.0975609756097561
"[0, 0, 1, 0, 1, 1, 0, 0, 0, 0, 1, 0, 0, 1, 1]",184,114,70,11,3,0.09649122807017543,0.04285714285714286
"[0, 1, 0, 0, 0, 1, 0, 1, 0, 1, 0, 0, 1, 0, 0]",237,141,96,7,7,0.04964539007092199,0.07291666666666667
"[0, 0, 0, 0, 1, 0, 0, 0, 0, 1, 1, 1, 1, 1, 0]",198,120,78,10,6,0.08333333333333333,0.07692307692307693
"[0, 1, 0, 1, 1, 0, 0, 0, 1, 0, 1, 1, 0, 0, 1]",133,68,65,6,4,0.08823529411764706,0.06153846153846154
"[1, 1, 0, 0, 1, 1, 0, 0, 1, 0, 0, 1, 1, 0, 1]",138,69,69,4,6,0.057971014492753624,0.08695652173913043
"[0, 0, 1, 1, 1, 0, 0, 0, 1, 0, 1, 1, 1, 1, 0]",146,70,76,7,10,0.1,0.13157894736842105
"[0, 0, 1, 0, 0, 1, 0, 0, 0, 1, 0, 1, 1, 1, 0]",143,90,53,7,6,0.07777777777777778,0.11320754716981132
"[1, 1, 0, 1, 0, 0, 1, 0, 1, 0, 0, 0, 0, 1, 1]",151,80,71,7,4,0.0875,0.056338028169014086
"[1, 1, 0, 0, 0, 1, 0, 0, 1, 0, 1, 1, 1, 1, 0]",135,66,69,5,10,0.07575757575757576,0.14492753623188406
"[0, 0, 1, 0, 0, 0, 1, 1, 0, 0, 0, 1, 0, 1, 0]",259,180,79,14,3,0.07777777777777778,0.0379746835443038
"[1, 1, 1, 0, 0, 1, 1, 1, 0, 1, 0, 0, 0, 0, 1]",187,78,109,7,11,0.08974358974358974,0.10091743119266056
"[1, 0, 0, 0, 0, 1, 1, 1, 0, 1, 1, 1, 1, 1, 0]",205,75,130,5,9,0.06666666666666667,0.06923076923076923
"[1, 1, 0, 0, 0, 1, 0, 1, 1, 0, 0, 1, 1, 0, 0]",196,106,90,6,7,0.05660377358490566,0.07777777777777778
"[0, 0, 1, 0, 1, 0, 1, 1, 1, 0, 0, 0, 1, 1, 0]",100,59,41,6,3,0.1016949152542373,0.07317073170731707
"[0, 0, 0, 0, 1, 0, 1, 1, 1, 0, 0, 1, 0, 0, 1]",155,94,61,9,7,0.09574468085106383,0.11475409836065574
"[0, 1, 0, 0, 0, 1, 1, 1, 0, 0, 1, 1, 0, 1, 0]",111,56,55,8,4,0.14285714285714285,0.07272727272727272
"[1, 1, 1, 0, 1, 1, 0, 0, 1, 1, 1, 1, 1, 0, 1]",564,159,405,16,28,0.10062893081761007,0.0691358024691358
"[1, 0, 1, 1, 0, 1, 1, 0, 1, 0, 0, 0, 0, 0, 1]",138,75,63,4,7,0.05333333333333334,0.1111111111111111
"[1, 0, 0, 0, 1, 0, 1, 0, 0, 0, 0, 1, 1, 0, 1]",139,87,52,11,11,0.12643678160919541,0.21153846153846154
"[1, 0, 1, 1, 0, 1, 0, 1, 1, 0, 1, 0, 0, 0, 1]",125,59,66,1,9,0.01694915254237288,0.13636363636363635
"[0, 1, 0, 0, 1, 1, 1, 1, 0, 0, 0, 0, 1, 1, 0]",385,206,179,25,21,0.12135922330097088,0.11731843575418995
"[0, 0, 1, 1, 1, 0, 1, 1, 0, 0, 1, 0, 1, 0, 0]",122,55,67,5,5,0.09090909090909091,0.07462686567164178
"[1, 0, 0, 0, 1, 0, 0, 1, 0, 1, 0, 0, 1, 1, 1]",149,77,72,10,6,0.12987012987012986,0.08333333333333333
"[1, 0, 1, 0, 0, 1, 0, 1, 1, 1, 1, 0, 1, 0, 1]",129,56,73,7,8,0.125,0.1095890410958904
"[0, 0, 1, 1, 1, 1, 0, 1, 1, 1, 1, 1, 0, 0, 1]",377,144,233,8,23,0.05555555555555555,0.09871244635193133
"[1, 0, 0, 0, 0, 1, 1, 0, 1, 1, 0, 1, 0, 0, 1]",144,76,68,7,8,0.09210526315789473,0.11764705882352941
"[0, 1, 0, 0, 1, 1, 1, 1, 1, 0, 0, 1, 1, 0, 1]",158,69,89,7,7,0.10144927536231885,0.07865168539325842
"[1, 1, 1, 0, 1, 0, 0, 1, 1, 1, 1, 1, 0, 0, 1]",332,132,200,17,18,0.12878787878787878,0.09
"[1, 1, 0, 1, 0, 0, 0, 0, 1, 1, 0, 0, 1, 0, 0]",165,100,65,8,9,0.08,0.13846153846153847
"[1, 0, 0, 0, 0, 0, 1, 0, 0, 1, 0, 0, 0, 1, 1]",314,197,117,27,12,0.13705583756345177,0.10256410256410256
"[0, 1, 0, 0, 0, 0, 1, 1, 0, 1, 0, 1, 1, 0, 1]",101,51,50,9,7,0.17647058823529413,0.14
"[1, 1, 1, 1, 1, 1, 0, 1, 0, 0, 0, 1, 0, 1, 1]",263,74,189,9,12,0.12162162162162163,0.06349206349206349
"[1, 1, 1, 0, 0, 0, 1, 0, 0, 1, 0, 1, 0, 0, 0]",159,90,69,10,7,0.1111111111111111,0.10144927536231885
"[1, 1, 1, 0, 1, 1, 1, 1, 0, 1, 0, 0, 0, 0, 0]",161,78,83,8,9,0.10256410256410256,0.10843373493975904
"[1, 0, 0, 1, 1, 0, 1, 0, 0, 1, 0, 0, 0, 0, 0]",269,167,102,15,11,0.08982035928143713,0.10784313725490197
"[1, 0, 0, 1, 1, 1, 0, 1, 1, 0, 1, 1, 0, 0, 0]",131,48,83,4,14,0.08333333333333333,0.1686746987951807
"[1, 1, 1, 1, 1, 0, 0, 0, 1, 0, 0, 1, 0, 0, 1]",147,69,78,6,8,0.08695652173913043,0.10256410256410256
"[0, 0, 0, 0, 0, 1, 0, 1, 1, 0, 0, 0, 1, 1, 1]",317,210,107,14,9,0.06666666666666667,0.08411214953271028
"[1, 1, 0, 1, 1, 1, 0, 0, 1, 0, 1, 0, 0, 0, 1]",127,61,66,1,2,0.01639344262295082,0.030303030303030304
"[1, 1, 0, 1, 1, 0, 0, 0, 1, 1, 1, 0, 0, 0, 1]",116,47,69,5,11,0.10638297872340426,0.15942028985507245
"[1, 0, 1, 0, 1, 1, 1, 1, 0, 0, 1, 0, 1, 0, 1]",154,66,88,7,7,0.10606060606060606,0.07954545454545454
"[0, 1, 1, 0, 1, 1, 0, 0, 1, 1, 0, 0, 1, 1, 0]",280,139,141,10,17,0.07194244604316546,0.12056737588652482
"[1, 1, 1, 1, 0, 0, 1, 0, 0, 1, 1, 0, 0, 1, 0]",100,36,64,2,5,0.05555555555555555,0.078125
"[1, 1, 0, 1, 0, 1, 1, 0, 0, 0, 1, 1, 1, 1, 0]",191,81,110,7,11,0.08641975308641975,0.1
"[0, 1, 0, 0, 1, 0, 1, 1, 0, 1, 1, 1, 1, 0, 0]",143,67,76,3,7,0.04477611940298507,0.09210526315789473
"[1, 1, 1, 1, 1, 1, 0, 0, 1, 1, 1, 0, 1, 0, 1]",801,249,552,23,42,0.09236947791164658,0.07608695652173914
"[1, 0, 0, 1, 0, 1, 0, 1, 1, 1, 1, 0, 0, 0, 1]",132,58,74,4,5,0.06896551724137931,0.06756756756756757
"[1, 0, 0, 0, 0, 1, 0, 1, 1, 0, 1, 1, 0, 0, 0]",171,90,81,10,10,0.1111111111111111,0.12345679012345678
"[0, 0, 1, 0, 1, 1, 0, 0, 0, 1, 0, 0, 0, 0, 1]",305,205,100,20,10,0.0975609756097561,0.1
"[0, 1, 0, 1, 1, 0, 0, 0, 0, 0, 1, 1, 0, 1, 1]",136,77,59,11,5,0.14285714285714285,0.0847457627118644
"[1, 0, 0, 1, 1, 1, 0, 1, 0, 0, 1, 1, 1, 0, 1]",136,53,83,4,7,0.07547169811320754,0.08433734939759036
"[0, 1, 0, 1, 0, 0, 1, 0, 1, 0, 1, 0, 1, 1, 1]",120,62,58,9,5,0.14516129032258066,0.08620689655172414
"[1, 1, 0, 1, 0, 1, 0, 1, 0, 0, 0, 0, 1, 1, 1]",177,75,102,5,10,0.06666666666666667,0.09803921568627451
"[1, 1, 1, 1, 0, 1, 0, 1, 0, 1, 0, 0, 0, 0, 1]",152,83,69,10,5,0.12048192771084337,0.07246376811594203
"[1, 1, 1, 0, 0, 0, 0, 1, 1, 0, 1, 0, 1, 0, 0]",165,72,93,3,6,0.041666666666666664,0.06451612903225806
"[1, 1, 1, 1, 0, 0, 0, 0, 1, 1, 0, 1, 0, 1, 0]",209,103,106,7,12,0.06796116504854369,0.11320754716981132
"[1, 0, 1, 1, 0, 0, 1, 0, 0, 1, 1, 0, 0, 1, 1]",181,93,88,8,7,0.08602150537634409,0.07954545454545454
"[0, 1, 0, 1, 1, 0, 1, 0, 0, 1, 1, 0, 1, 1, 0]",89,48,41,5,5,0.10416666666666667,0.12195121951219512
"[1, 1, 0, 1, 0, 1, 0, 1, 1, 0, 1, 0, 0, 1, 1]",144,61,83,3,2,0.04918032786885246,0.024096385542168676
"[1, 1, 1, 0, 1, 0, 0, 0, 0, 1, 0, 1, 0, 0, 0]",174,97,77,13,7,0.13402061855670103,0.09090909090909091
"[1, 1, 1, 0, 0, 0, 1, 1, 0, 1, 1, 1, 0, 1, 0]",150,51,99,6,10,0.11764705882352941,0.10101010101010101
"[0, 1, 0, 1, 0, 0, 0, 1, 0, 0, 0, 1, 1, 1, 0]",155,98,57,7,3,0.07142857142857142,0.05263157894736842
"[0, 1, 0, 1, 1, 1, 0, 1, 1, 1, 0, 1, 0, 1, 1]",227,85,142,8,16,0.09411764705882353,0.11267605633802817
"[0, 0, 1, 0, 1, 1, 1, 0, 1, 1, 1, 0, 1, 0, 1]",135,56,79,9,6,0.16071428571428573,0.0759493670886076
"[0, 1, 1, 1, 1, 0, 0, 0, 1, 1, 1, 0, 0, 1, 1]",222,121,101,11,9,0.09090909090909091,0.0891089108910891
"[0, 1, 0, 1, 1, 0, 1, 0, 0, 0, 1, 0, 1, 0, 0]",147,88,59,11,5,0.125,0.0847457627118644
"[0, 1, 0, 0, 0, 1, 1, 1, 1, 0, 0, 1, 0, 0, 0]",174,111,63,9,5,0.08108108108108109,0.07936507936507936
"[0, 1, 1, 0, 0, 1, 0, 1, 0, 0, 1, 0, 1, 0, 1]",96,55,41,6,7,0.10909090909090909,0.17073170731707318
"[0, 1, 1, 0, 1, 0, 0, 1, 1, 0, 0, 1, 0, 1, 0]",117,63,54,11,1,0.1746031746031746,0.018518518518518517
"[1, 0, 0, 1, 0, 0, 0, 1, 1, 1, 0, 1, 1, 0, 0]",110,59,51,3,8,0.05084745762711865,0.1568627450980392
"[1, 0, 1, 1, 0, 1, 0, 1, 1, 1, 1, 1, 0, 0, 0]",192,67,125,4,14,0.05970149253731343,0.112
"[0, 0, 1, 1, 1, 1, 0, 1, 1, 1, 1, 0, 0, 0, 0]",219,96,123,11,14,0.11458333333333333,0.11382113821138211
"[1, 1, 1, 1, 1, 0, 0, 0, 0, 1, 1, 0, 1, 0, 1]",322,78,244,6,23,0.07692307692307693,0.0942622950819672
"[0, 1, 1, 0, 1, 1, 0, 0, 1, 1, 1, 0, 0, 0, 1]",124,55,69,3,4,0.05454545454545454,0.057971014492753624
"[0, 1, 0, 0, 1, 1, 1, 1, 0, 1, 0, 1, 1, 1, 0]",134,59,75,11,6,0.1864406779661017,0.08
"[0, 0, 0, 0, 0, 1, 0, 0, 1, 0, 0, 1, 1, 1, 0]",279,189,90,23,11,0.12169312169312169,0.12222222222222222
"[1, 1, 0, 0, 0, 1, 1, 0, 1, 0, 1, 0, 1, 1, 0]",101,43,58,2,4,0.046511627906976744,0.06896551724137931
"[1, 0, 1, 0, 0, 0, 1, 1, 0, 0, 1, 0, 0, 0, 1]",137,80,57,8,3,0.1,0.05263157894736842
"[1, 0, 1, 0, 1, 0, 1, 0, 0, 0, 1, 1, 0, 0, 0]",172,104,68,8,1,0.07692307692307693,0.014705882352941176
"[0, 0, 0, 1, 1, 0, 1, 0, 0, 0, 1, 1, 0, 1, 0]",145,93,52,7,3,0.07526881720430108,0.057692307692307696
"[0, 1, 1, 1, 0, 1, 0, 1, 1, 0, 0, 0, 1, 1, 0]",128,59,69,6,9,0.1016949152542373,0.13043478260869565
"[0, 0, 1, 0, 0, 0, 1, 0, 0, 0, 1, 1, 1, 1, 0]",202,135,67,15,4,0.1111111111111111,0.05970149253731343
"[1, 1, 1, 1, 0, 0, 1, 1, 1, 0, 0, 0, 0, 1, 1]",371,160,211,15,19,0.09375,0.09004739336492891
"[1, 0, 1, 0, 0, 0, 0, 0, 1, 1, 0, 1, 1, 1, 0]",125,63,62,4,5,0.06349206349206349,0.08064516129032258
"[0, 0, 1, 0, 1, 1, 0, 0, 0, 1, 0, 0, 1, 1, 1]",153,75,78,6,11,0.08,0.14102564102564102
"[0, 1, 1, 0, 0, 1, 0, 0, 1, 1, 1, 0, 0, 0, 1]",137,81,56,8,6,0.09876543209876543,0.10714285714285714
"[1, 1, 1, 0, 0, 1, 1, 1, 0, 0, 1, 0, 0, 1, 1]",246,87,159,9,13,0.10344827586206896,0.08176100628930817
"[1, 1, 1, 1, 1, 1, 1, 0, 0, 1, 0, 1, 0, 0, 0]",248,83,165,8,19,0.0963855421686747,0.11515151515151516
"[1, 1, 1, 1, 0, 0, 0, 0, 0, 1, 1, 1, 0, 1, 1]",246,113,133,8,12,0.07079646017699115,0.09022556390977443
"[1, 1, 0, 0, 0, 1, 0, 1, 1, 0, 1, 0, 0, 0, 1]",148,79,69,3,8,0.0379746835443038,0.11594202898550725
"[0, 0, 1, 1, 1, 0, 1, 1, 1, 0, 0, 1, 0, 1, 1]",161,58,103,5,9,0.08620689655172414,0.08737864077669903
"[0, 1, 0, 1, 0, 0, 1, 1, 0, 1, 1, 0, 0, 0, 1]",110,53,57,2,7,0.03773584905660377,0.12280701754385964
"[1, 1, 0, 0, 0, 1, 1, 0, 0, 1, 0, 0, 0, 1, 1]",143,79,64,7,8,0.08860759493670886,0.125
"[0, 1, 1, 0, 0, 0, 1, 0, 1, 0, 1, 1, 1, 1, 0]",128,72,56,3,5,0.041666666666666664,0.08928571428571429
"[1, 0, 1, 1, 0, 0, 0, 0, 1, 0, 1, 1, 1, 0, 0]",130,65,65,10,6,0.15384615384615385,0.09230769230769231
"[0, 0, 0, 1, 1, 1, 0, 1, 1, 0, 0, 0, 0, 1, 0]",139,85,54,11,3,0.12941176470588237,0.05555555555555555
"[0, 1, 1, 0, 0, 1, 1, 0, 1, 1, 1, 0, 0, 1, 1]",221,114,107,9,6,0.07894736842105263,0.056074766355140186
"[0, 1, 1, 0, 0, 1, 0, 0, 1, 1, 1, 1, 0, 0, 1]",206,113,93,11,6,0.09734513274336283,0.06451612903225806
"[1, 0, 0, 1, 1, 1, 0, 1, 0, 0, 0, 1, 1, 1, 0]",116,50,66,6,8,0.12,0.12121212121212122
"[0, 1, 0, 0, 0, 1, 0, 0, 1, 0, 1, 1, 1, 0, 0]",139,70,69,6,9,0.08571428571428572,0.13043478260869565
"[1, 0, 1, 0, 1, 0, 1, 0, 0, 1, 0, 1, 1, 1, 1]",171,70,101,7,8,0.1,0.07920792079207921
"[1, 1, 0, 0, 1, 0, 0, 1, 0, 1, 1, 0, 1, 0, 1]",107,62,45,7,4,0.11290322580645161,0.08888888888888889
"[1, 1, 0, 0, 1, 0, 1, 0, 1, 0, 0, 0, 1, 1, 1]",166,78,88,11,12,0.14102564102564102,0.13636363636363635
"[1, 1, 0, 1, 0, 0, 0, 0, 0, 1, 1, 0, 0, 1, 0]",150,98,52,5,5,0.05102040816326531,0.09615384615384616
"[0, 0, 1, 1, 1, 1, 1, 0, 1, 0, 0, 1, 0, 0, 0]",132,71,61,7,3,0.09859154929577464,0.04918032786885246
"[1, 1, 0, 1, 0, 0, 1, 1, 0, 0, 1, 1, 1, 1, 0]",319,135,184,7,18,0.05185185185185185,0.09782608695652174
"[0, 1, 0, 1, 0, 1, 1, 1, 0, 0, 0, 1, 0, 0, 0]",147,88,59,5,9,0.056818181818181816,0.15254237288135594
"[1, 0, 1, 1, 1, 1, 0, 1, 0, 1, 0, 1, 1, 0, 1]",240,89,151,8,17,0.0898876404494382,0.11258278145695365
"[0, 0, 0, 1, 0, 1, 1, 1, 1, 0, 1, 0, 1, 0, 1]",101,49,52,3,2,0.061224489795918366,0.038461538461538464
"[0, 1, 1, 0, 0, 0, 0, 1, 0, 1, 1, 1, 1, 0, 1]",131,74,57,7,6,0.0945945945945946,0.10526315789473684
"[0, 0, 1, 0, 1, 1, 0, 0, 0, 0, 1, 0, 1, 1, 1]",147,70,77,14,5,0.2,0.06493506493506493
"[0, 1, 0, 1, 1, 1, 0, 0, 0, 0, 1, 1, 0, 1, 0]",123,65,58,6,2,0.09230769230769231,0.034482758620689655
"[0, 0, 0, 1, 0, 1, 1, 0, 0, 0, 1, 1, 0, 1, 1]",120,72,48,9,3,0.125,0.0625
"[0, 0, 1, 0, 1, 1, 1, 1, 0, 1, 1, 0, 0, 1, 0]",94,42,52,2,0,0.047619047619047616,0.0
"[0, 1, 0, 1, 0, 0, 0, 0, 1, 0, 0, 1, 0, 0, 1]",214,139,75,12,12,0.08633093525179857,0.16
"[1, 0, 0, 1, 0, 0, 0, 1, 1, 1, 0, 0, 1, 1, 0]",133,67,66,7,11,0.1044776119402985,0.16666666666666666
"[1, 0, 0, 1, 0, 0, 0, 1, 0, 1, 1, 0, 0, 0, 0]",282,175,107,15,12,0.08571428571428572,0.11214953271028037
"[0, 1, 0, 1, 1, 0, 0, 0, 1, 0, 0, 0, 0, 1, 0]",258,167,91,20,15,0.11976047904191617,0.16483516483516483
"[0, 1, 0, 1, 0, 1, 1, 0, 0, 0, 1, 1, 1, 0, 1]",111,49,62,4,4,0.08163265306122448,0.06451612903225806
"[0, 1, 0, 0, 1, 0, 1, 0, 1, 1, 1, 1, 0, 1, 0]",102,46,56,5,7,0.10869565217391304,0.125
"[0, 1, 1, 1, 0, 0, 1, 1, 1, 1, 0, 0, 1, 0, 1]",187,79,108,4,13,0.05063291139240506,0.12037037037037036
"[1, 0, 1, 1, 1, 0, 0, 1, 1, 1, 1, 0, 0, 1, 0]",188,79,109,7,9,0.08860759493670886,0.08256880733944955
"[1, 0, 0, 1, 1, 0, 1, 1, 0, 0, 0, 0, 0, 0, 0]",417,252,165,26,21,0.10317460317460317,0.12727272727272726
"[0, 0, 0, 0, 0, 1, 0, 0, 1, 1, 0, 0, 1, 1, 0]",532,353,179,33,17,0.09348441926345609,0.09497206703910614
"[0, 0, 0, 0, 1, 0, 0, 1, 0, 1, 0, 1, 1, 1, 1]",167,103,64,12,4,0.11650485436893204,0.0625
"[0, 1, 1, 0, 1, 0, 0, 0, 1, 0, 0, 1, 1, 1, 0]",101,54,47,7,3,0.12962962962962962,0.06382978723404255
"[1, 1, 1, 1, 1, 1, 0, 0, 1, 0, 1, 1, 0, 1, 0]",286,100,186,16,27,0.16,0.14516129032258066
"[1, 0, 0, 1, 0, 1, 0, 1, 1, 1, 0, 1, 1, 0, 1]",152,65,87,6,8,0.09230769230769231,0.09195402298850575
"[1, 1, 0, 0, 0, 1, 1, 1, 0, 1, 0, 1, 1, 1, 0]",158,71,87,5,9,0.07042253521126761,0.10344827586206896
"[0, 0, 0, 1, 1, 0, 1, 0, 1, 0, 0, 1, 1, 1, 1]",221,118,103,14,14,0.11864406779661017,0.13592233009708737
"[0, 1, 0, 1, 1, 0, 0, 1, 0, 0, 1, 0, 0, 1, 1]",134,77,57,7,7,0.09090909090909091,0.12280701754385964
"[0, 0, 1, 0, 1, 1, 1, 1, 1, 0, 1, 1, 0, 1, 1]",245,97,148,12,17,0.12371134020618557,0.11486486486486487
"[1, 0, 1, 0, 1, 1, 0, 1, 0, 0, 0, 0, 0, 1, 0]",129,80,49,10,5,0.125,0.10204081632653061
"[0, 1, 1, 1, 0, 0, 0, 0, 0, 1, 1, 0, 1, 0, 0]",153,98,55,10,3,0.10204081632653061,0.05454545454545454
"[0, 0, 0, 0, 1, 1, 1, 1, 1, 0, 1, 1, 1, 0, 0]",188,96,92,10,10,0.10416666666666667,0.10869565217391304
"[0, 1, 0, 1, 0, 1, 1, 0, 1, 1, 0, 0, 1, 0, 1]",99,47,52,6,4,0.1276595744680851,0.07692307692307693
"[1, 1, 1, 0, 0, 1, 0, 1, 0, 0, 1, 1, 1, 0, 1]",157,58,99,4,13,0.06896551724137931,0.13131313131313133
"[1, 0, 1, 0, 0, 1, 1, 0, 1, 1, 1, 0, 0, 0, 0]",174,93,81,11,6,0.11827956989247312,0.07407407407407407
"[1, 0, 1, 1, 0, 0, 0, 1, 0, 1, 1, 1, 1, 1, 0]",145,66,79,4,12,0.06060606060606061,0.1518987341772152
"[0, 1, 1, 0, 0, 0, 0, 1, 1, 0, 1, 0, 1, 0, 1]",154,110,44,7,6,0.06363636363636363,0.13636363636363635
"[1, 1, 0, 0, 0, 1, 1, 0, 0, 1, 1, 1, 0, 0, 0]",170,86,84,12,3,0.13953488372093023,0.03571428571428571
"[1, 1, 0, 0, 0, 1, 1, 0, 1, 1, 0, 1, 1, 1, 0]",143,67,76,8,5,0.11940298507462686,0.06578947368421052
"[0, 0, 1, 1, 1, 0, 0, 1, 0, 1, 1, 1, 1, 0, 1]",142,58,84,12,12,0.20689655172413793,0.14285714285714285
"[1, 1, 1, 0, 1, 1, 1, 0, 0, 0, 0, 0, 1, 0, 0]",144,64,80,2,7,0.03125,0.0875
"[1, 0, 0, 0, 1, 1, 0, 1, 0, 1, 0, 0, 1, 1, 1]",173,87,86,5,6,0.05747126436781609,0.06976744186046512
"[1, 1, 1, 0, 1, 0, 1, 0, 0, 0, 1, 1, 0, 1, 0]",93,37,56,3,5,0.08108108108108109,0.08928571428571429
"[0, 1, 1, 1, 0, 1, 0, 0, 1, 1, 0, 1, 0, 0, 1]",109,43,66,7,10,0.16279069767441862,0.15151515151515152
"[1, 1, 1, 1, 0, 0, 1, 1, 1, 0, 0, 0, 1, 1, 0]",183,80,103,10,8,0.125,0.07766990291262135
"[1, 1, 1, 0, 0, 1, 0, 1, 1, 0, 0, 1, 0, 0, 0]",131,61,70,9,4,0.14754098360655737,0.05714285714285714
"[1, 1, 1, 1, 1, 0, 1, 1, 0, 0, 0, 1, 0, 0, 0]",129,53,76,7,5,0.1320754716981132,0.06578947368421052
"[0, 0, 0, 1, 1, 1, 1, 0, 0, 1, 0, 1, 0, 1, 0]",154,96,58,7,10,0.07291666666666667,0.1724137931034483
"[0, 0, 1, 1, 1, 0, 0, 1, 1, 1, 0, 1, 1, 0, 0]",151,73,78,6,3,0.0821917808219178,0.038461538461538464
"[1, 1, 1, 0, 0, 1, 1, 0, 1, 0, 1, 0, 0, 1, 1]",226,76,150,8,18,0.10526315789473684,0.12
"[1, 0, 1, 1, 1, 1, 1, 0, 1, 0, 0, 1, 1, 0, 0]",210,98,112,8,12,0.08163265306122448,0.10714285714285714
"[1, 0, 0, 1, 0, 1, 0, 1, 0, 0, 0, 1, 0, 0, 0]",250,161,89,17,8,0.10559006211180125,0.0898876404494382
"[0, 0, 1, 0, 1, 0, 0, 1, 1, 1, 0, 0, 1, 0, 1]",92,45,47,4,8,0.08888888888888889,0.1702127659574468
"[1, 0, 0, 0, 0, 1, 0, 1, 0, 0, 1, 1, 1, 0, 0]",162,85,77,10,10,0.11764705882352941,0.12987012987012986
"[0, 0, 1, 0, 1, 1, 0, 1, 1, 0, 1, 1, 1, 1, 0]",151,66,85,9,12,0.13636363636363635,0.1411764705882353
"[0, 1, 0, 0, 0, 1, 0, 0, 1, 1, 0, 1, 1, 0, 1]",92,48,44,5,10,0.10416666666666667,0.22727272727272727
"[1, 0, 1, 1, 0, 0, 0, 0, 0, 1, 0, 1, 0, 1, 0]",124,71,53,8,6,0.11267605633802817,0.11320754716981132
"[0, 0, 1, 0, 0, 1, 1, 0, 1, 0, 1, 1, 1, 1, 0]",144,64,80,5,11,0.078125,0.1375
"[0, 1, 1, 0, 0, 0, 1, 0, 0, 1, 0, 1, 1, 0, 0]",179,119,60,7,5,0.058823529411764705,0.08333333333333333
"[0, 1, 1, 1, 0, 1, 1, 0, 0, 0, 1, 0, 1, 0, 0]",107,61,46,7,4,0.11475409836065574,0.08695652173913043
"[0, 1, 0, 1, 0, 0, 0, 1, 1, 1, 0, 0, 0, 1, 1]",144,72,72,6,2,0.08333333333333333,0.027777777777777776
"[0, 0, 1, 1, 1, 0, 1, 0, 1, 0, 0, 1, 0, 1, 0]",81,35,46,5,4,0.14285714285714285,0.08695652173913043
"[0, 0, 0, 1, 1, 0, 0, 1, 1, 1, 0, 1, 0, 1, 0]",167,105,62,9,9,0.08571428571428572,0.14516129032258066
"[0, 1, 0, 1, 0, 1, 0, 1, 0, 1, 0, 1, 0, 0, 1]",113,60,53,6,4,0.1,0.07547169811320754
"[1, 1, 0, 1, 0, 1, 0, 1, 0, 1, 0, 1, 0, 1, 0]",84,49,35,4,5,0.08163265306122448,0.14285714285714285
"[1, 0, 1, 1, 1, 0, 0, 0, 1, 0, 1, 0, 0, 1, 1]",138,62,76,7,10,0.11290322580645161,0.13157894736842105
"[0, 0, 1, 1, 0, 0, 0, 1, 1, 0, 1, 0, 1, 0, 0]",163,89,74,9,13,0.10112359550561797,0.17567567567567569
"[0, 1, 1, 0, 0, 0, 1, 1, 1, 1, 0, 0, 1, 0, 0]",125,73,52,11,7,0.1506849315068493,0.1346153846153846
"[0, 1, 0, 1, 0, 0, 0, 1, 0, 1, 1, 1, 1, 0, 0]",132,65,67,9,3,0.13846153846153847,0.04477611940298507
"[1, 1, 0, 1, 1, 0, 0, 0, 1, 0, 0, 0, 0, 1, 0]",129,81,48,8,3,0.09876543209876543,0.0625
"[0, 1, 1, 1, 0, 1, 1, 1, 1, 0, 1, 0, 1, 0, 1]",214,70,144,5,10,0.07142857142857142,0.06944444444444445
"[1, 0, 1, 1, 1, 0, 1, 1, 1, 1, 0, 1, 0, 1, 0]",232,93,139,9,18,0.0967741935483871,0.12949640287769784
"[1, 1, 0, 1, 0, 1, 1, 0, 1, 0, 0, 1, 0, 0, 0]",128,69,59,3,5,0.043478260869565216,0.0847457627118644
"[0, 1, 0, 1, 1, 1, 0, 1, 0, 1, 0, 1, 0, 0, 1]",104,49,55,4,3,0.08163265306122448,0.05454545454545454
"[0, 1, 0, 1, 0, 0, 1, 1, 1, 0, 1, 1, 1, 1, 0]",134,55,79,9,5,0.16363636363636364,0.06329113924050633
"[0, 0, 0, 1, 1, 1, 0, 0, 1, 1, 1, 0, 1, 0, 0]",111,69,42,8,7,0.11594202898550725,0.16666666666666666
"[1, 1, 0, 1, 1, 1, 0, 0, 1, 0, 0, 0, 0, 0, 0]",204,112,92,7,14,0.0625,0.15217391304347827
"[1, 0, 1, 1, 1, 1, 0, 0, 1, 0, 0, 0, 0, 1, 0]",108,56,52,6,2,0.10714285714285714,0.038461538461538464
"[0, 0, 0, 0, 0, 1, 0, 1, 1, 1, 1, 1, 1, 0, 0]",230,128,102,7,10,0.0546875,0.09803921568627451
"[0, 0, 0, 1, 1, 1, 1, 1, 0, 1, 1, 0, 0, 1, 0]",119,60,59,2,5,0.03333333333333333,0.0847457627118644
"[1, 0, 0, 0, 1, 1, 1, 1, 1, 0, 1, 1, 0, 0, 1]",165,62,103,4,7,0.06451612903225806,0.06796116504854369
"[1, 1, 0, 1, 1, 1, 1, 1, 1, 0, 1, 0, 1, 0, 0]",268,82,186,10,13,0.12195121951219512,0.06989247311827956
"[1, 1, 1, 1, 1, 0, 0, 0, 1, 0, 0, 0, 1, 0, 0]",135,76,59,8,5,0.10526315789473684,0.0847457627118644
"[1, 1, 0, 0, 1, 1, 1, 0, 1, 1, 0, 1, 1, 0, 0]",197,88,109,8,12,0.09090909090909091,0.11009174311926606
"[0, 1, 0, 0, 0, 1, 1, 1, 0, 0, 0, 1, 0, 0, 1]",160,102,58,13,6,0.12745098039215685,0.10344827586206896
"[1, 0, 1, 0, 1, 1, 1, 0, 0, 1, 1, 1, 1, 1, 0]",271,84,187,10,15,0.11904761904761904,0.08021390374331551
"[0, 0, 1, 0, 1, 0, 1, 0, 0, 1, 0, 0, 1, 0, 0]",226,146,80,11,9,0.07534246575342465,0.1125
"[1, 1, 0, 0, 1, 0, 1, 0, 1, 0, 1, 0, 1, 0, 1]",122,55,67,3,5,0.05454545454545454,0.07462686567164178
"[1, 1, 0, 1, 1, 1, 0, 1, 1, 0, 0, 0, 1, 0, 0]",103,39,64,2,11,0.05128205128205128,0.171875
"[0, 0, 0, 1, 0, 1, 1, 0, 1, 1, 1, 0, 1, 1, 0]",114,53,61,7,6,0.1320754716981132,0.09836065573770492
"[0, 0, 0, 0, 1, 1, 0, 0, 0, 1, 1, 0, 1, 0, 1]",190,120,70,12,4,0.1,0.05714285714285714
"[1, 0, 1, 1, 0, 1, 1, 0, 0, 1, 1, 1, 1, 0, 1]",256,107,149,8,16,0.07476635514018691,0.10738255033557047
"[1, 0, 1, 0, 0, 1, 0, 1, 0, 1, 0, 0, 1, 1, 1]",131,68,63,2,4,0.029411764705882353,0.06349206349206349
"[1, 0, 0, 0, 1, 0, 1, 0, 0, 1, 1, 1, 1, 0, 1]",106,59,47,3,3,0.05084745762711865,0.06382978723404255
"[0, 1, 1, 1, 0, 1, 0, 1, 0, 1, 1, 0, 1, 1, 0]",129,58,71,6,4,0.10344827586206896,0.056338028169014086
"[0, 0, 0, 0, 1, 1, 1, 0, 1, 0, 1, 0, 1, 1, 0]",126,56,70,7,2,0.125,0.02857142857142857
"[1, 0, 1, 1, 0, 0, 0, 1, 0, 0, 1, 0, 0, 1, 1]",120,65,55,9,2,0.13846153846153847,0.03636363636363636
"[1, 0, 1, 0, 1, 1, 0, 1, 0, 1, 1, 1, 0, 1, 1]",220,95,125,8,6,0.08421052631578947,0.048
"[1, 0, 1, 0, 0, 1, 0, 1, 0, 1, 1, 0, 0, 1, 0]",128,70,58,8,7,0.11428571428571428,0.1206896551724138
"[0, 0, 1, 0, 1, 0, 1, 0, 1, 1, 0, 0, 1, 1, 0]",132,63,69,7,5,0.1111111111111111,0.07246376811594203
"[1, 0, 0, 0, 0, 0, 0, 1, 0, 1, 0, 1, 0, 1, 1]",193,94,99,9,8,0.09574468085106383,0.08080808080808081
"[1, 0, 1, 0, 1, 0, 1, 1, 1, 1, 1, 0, 0, 0, 0]",209,88,121,10,13,0.11363636363636363,0.10743801652892562
"[1, 0, 1, 0, 0, 1, 1, 1, 0, 0, 0, 1, 0, 0, 0]",137,76,61,9,6,0.11842105263157894,0.09836065573770492
"[0, 0, 1, 0, 0, 1, 1, 1, 1, 1, 0, 0, 0, 0, 0]",295,169,126,16,11,0.09467455621301775,0.0873015873015873
"[1, 1, 0, 1, 0, 0, 1, 0, 1, 0, 0, 1, 0, 1, 1]",128,54,74,6,7,0.1111111111111111,0.0945945945945946
"[1, 1, 1, 1, 0, 1, 1, 0, 0, 0, 1, 1, 1, 0, 0]",168,69,99,6,4,0.08695652173913043,0.04040404040404041
"[1, 1, 1, 0, 0, 1, 0, 0, 1, 0, 1, 0, 1, 1, 1]",212,86,126,7,10,0.08139534883720931,0.07936507936507936
"[1, 0, 0, 1, 1, 1, 0, 0, 1, 0, 1, 0, 1, 1, 1]",177,62,115,9,8,0.14516129032258066,0.06956521739130435
"[1, 1, 0, 1, 0, 1, 0, 1, 1, 0, 0, 0, 1, 1, 0]",133,58,75,5,2,0.08620689655172414,0.02666666666666667
"[0, 1, 1, 0, 0, 1, 0, 0, 0, 0, 0, 1, 1, 1, 1]",275,169,106,16,14,0.09467455621301775,0.1320754716981132
"[0, 0, 1, 1, 0, 1, 0, 0, 1, 0, 0, 1, 1, 0, 1]",101,52,49,7,4,0.1346153846153846,0.08163265306122448
"[0, 1, 0, 0, 1, 1, 1, 1, 1, 0, 0, 0, 1, 1, 1]",179,74,105,7,13,0.0945945945945946,0.12380952380952381
"[0, 1, 0, 1, 1, 1, 0, 1, 1, 1, 0, 0, 0, 1, 1]",149,58,91,6,9,0.10344827586206896,0.0989010989010989
"[0, 1, 0, 0, 1, 1, 0, 1, 0, 0, 1, 1, 0, 0, 1]",152,76,76,4,7,0.05263157894736842,0.09210526315789473
"[0, 0, 0, 0, 0, 1, 1, 0, 1, 0, 0, 1, 1, 0, 1]",140,101,39,7,2,0.06930693069306931,0.05128205128205128
"[1, 1, 0, 1, 0, 1, 0, 0, 0, 1, 1, 1, 1, 1, 0]",162,58,104,4,8,0.06896551724137931,0.07692307692307693
"[1, 1, 0, 1, 0, 0, 0, 1, 0, 1, 0, 0, 0, 0, 1]",158,93,65,7,3,0.07526881720430108,0.046153846153846156
"[0, 1, 0, 0, 0, 1, 1, 0, 0, 0, 0, 0, 1, 1, 1]",286,179,107,18,6,0.1005586592178771,0.056074766355140186
"[0, 0, 0, 0, 1, 1, 0, 1, 1, 1, 0, 1, 0, 1, 0]",120,68,52,9,3,0.1323529411764706,0.057692307692307696
"[0, 1, 1, 0, 0, 1, 1, 1, 0, 0, 0, 1, 0, 0, 1]",136,74,62,7,2,0.0945945945945946,0.03225806451612903
"[1, 0, 0, 1, 1, 1, 1, 0, 0, 0, 1, 0, 0, 0, 1]",174,63,111,6,12,0.09523809523809523,0.10810810810810811
"[1, 0, 1, 1, 1, 0, 1, 1, 0, 0, 0, 1, 1, 0, 1]",141,66,75,4,6,0.06060606060606061,0.08
"[1, 1, 1, 1, 0, 0, 1, 1, 0, 0, 1, 0, 1, 0, 0]",206,115,91,6,2,0.05217391304347826,0.02197802197802198
"[0, 0, 0, 0, 1, 0, 0, 1, 1, 1, 1, 1, 0, 0, 1]",166,99,67,15,8,0.15151515151515152,0.11940298507462686
"[1, 0, 1, 1, 0, 1, 0, 0, 0, 1, 0, 0, 0, 0, 1]",136,75,61,8,8,0.10666666666666667,0.13114754098360656
"[1, 1, 0, 1, 0, 1, 0, 0, 1, 1, 0, 1, 1, 1, 0]",141,58,83,7,7,0.1206896551724138,0.08433734939759036
"[0, 1, 0, 0, 1, 1, 0, 1, 1, 0, 0, 0, 1, 1, 1]",161,90,71,7,8,0.07777777777777778,0.11267605633802817
"[1, 0, 0, 0, 1, 1, 1, 0, 1, 0, 0, 1, 0, 1, 0]",103,56,47,6,4,0.10714285714285714,0.0851063829787234
"[1, 1, 0, 0, 1, 0, 0, 0, 1, 1, 0, 0, 1, 1, 1]",229,98,131,10,17,0.10204081632653061,0.1297709923664122
"[0, 0, 1, 0, 0, 1, 0, 0, 1, 1, 1, 0, 1, 1, 0]",103,51,52,4,8,0.0784313725490196,0.15384615384615385
"[0, 0, 1, 0, 0, 1, 0, 1, 1, 1, 0, 0, 1, 1, 1]",189,95,94,4,9,0.042105263157894736,0.09574468085106383
"[1, 1, 1, 0, 1, 1, 1, 1, 0, 0, 0, 0, 1, 0, 0]",143,64,79,5,5,0.078125,0.06329113924050633
"[0, 0, 0, 0, 1, 1, 1, 0, 0, 0, 1, 1, 1, 1, 0]",184,120,64,14,8,0.11666666666666667,0.125
"[0, 1, 1, 0, 0, 0, 1, 0, 1, 0, 0, 1, 0, 0, 1]",136,79,57,8,4,0.10126582278481013,0.07017543859649122
"[0, 1, 0, 0, 1, 0, 0, 0, 1, 0, 1, 1, 1, 1, 0]",140,78,62,6,5,0.07692307692307693,0.08064516129032258
"[1, 1, 0, 0, 0, 1, 0, 0, 1, 0, 0, 0, 1, 0, 1]",141,82,59,7,11,0.08536585365853659,0.1864406779661017
"[1, 0, 0, 0, 0, 0, 1, 1, 1, 1, 1, 0, 1, 1, 1]",237,79,158,6,20,0.0759493670886076,0.12658227848101267
"[0, 0, 0, 0, 0, 1, 0, 1, 1, 0, 1, 0, 1, 1, 0]",150,78,72,5,7,0.0641025641025641,0.09722222222222222
"[1, 1, 0, 0, 0, 0, 1, 1, 0, 1, 0, 0, 0, 1, 0]",168,96,72,10,9,0.10416666666666667,0.125
"[0, 0, 1, 1, 0, 0, 1, 0, 0, 1, 1, 1, 0, 1, 1]",139,65,74,7,6,0.1076923076923077,0.08108108108108109
"[1, 0, 1, 1, 1, 1, 0, 1, 1, 0, 1, 0, 0, 0, 1]",144,57,87,8,5,0.14035087719298245,0.05747126436781609
"[0, 0, 0, 0, 1, 1, 1, 1, 1, 0, 0, 0, 1, 1, 0]",183,104,79,9,9,0.08653846153846154,0.11392405063291139
"[0, 0, 0, 1, 0, 0, 1, 0, 0, 1, 0, 1, 0, 1, 1]",161,100,61,7,9,0.07,0.14754098360655737
"[1, 0, 1, 0, 1, 0, 0, 1, 1, 1, 0, 0, 0, 1, 0]",100,60,40,6,3,0.1,0.075
"[1, 0, 0, 0, 1, 0, 0, 1, 1, 0, 1, 0, 0, 0, 1]",123,74,49,11,2,0.14864864864864866,0.04081632653061224
"[0, 1, 1, 0, 1, 0, 0, 1, 1, 1, 1, 1, 0, 0, 0]",158,79,79,6,7,0.0759493670886076,0.08860759493670886
"[1, 0, 1, 1, 1, 1, 0, 0, 0, 0, 0, 0, 0, 1, 0]",204,129,75,9,7,0.06976744186046512,0.09333333333333334
"[0, 0, 1, 1, 0, 0, 1, 1, 0, 1, 0, 1, 0, 0, 0]",213,129,84,18,9,0.13953488372093023,0.10714285714285714
"[0, 0, 0, 1, 1, 0, 0, 1, 1, 0, 1, 0, 1, 0, 0]",209,140,69,15,8,0.10714285714285714,0.11594202898550725
"[1, 0, 1, 0, 1, 1, 0, 1, 0, 0, 1, 0, 0, 1, 1]",118,50,68,5,6,0.1,0.08823529411764706
"[0, 1, 1, 1, 1, 0, 1, 0, 0, 1, 0, 1, 1, 0, 0]",124,58,66,6,6,0.10344827586206896,0.09090909090909091
"[0, 1, 1, 1, 1, 0, 1, 0, 0, 0, 0, 0, 1, 1, 0]",150,81,69,11,7,0.13580246913580246,0.10144927536231885
"[1, 1, 0, 1, 1, 0, 1, 0, 1, 0, 1, 1, 0, 0, 0]",126,62,64,6,5,0.0967741935483871,0.078125
"[1, 1, 0, 1, 1, 1, 1, 0, 0, 0, 0, 1, 0, 0, 0]",127,64,63,6,9,0.09375,0.14285714285714285
"[0, 0, 0, 0, 1, 1, 0, 1, 1, 1, 1, 0, 1, 1, 1]",221,93,128,11,10,0.11827956989247312,0.078125
"[1, 0, 1, 0, 1, 1, 0, 1, 1, 1, 1, 0, 1, 0, 0]",133,59,74,2,10,0.03389830508474576,0.13513513513513514
"[0, 1, 0, 0, 1, 1, 0, 1, 0, 1, 1, 1, 1, 1, 0]",149,59,90,5,15,0.0847457627118644,0.16666666666666666
"[1, 0, 1, 1, 0, 1, 1, 1, 1, 0, 0, 0, 0, 0, 1]",163,72,91,6,12,0.08333333333333333,0.13186813186813187
"[1, 1, 0, 1, 0, 1, 1, 0, 1, 1, 1, 0, 1, 0, 1]",209,75,134,7,6,0.09333333333333334,0.04477611940298507
"[1, 1, 1, 0, 1, 0, 1, 1, 0, 0, 0, 1, 0, 0, 0]",120,66,54,6,10,0.09090909090909091,0.18518518518518517
"[1, 0, 0, 1, 0, 0, 1, 0, 1, 0, 0, 0, 0, 0, 0]",609,412,197,41,17,0.09951456310679611,0.08629441624365482
"[1, 0, 1, 1, 0, 0, 0, 1, 1, 0, 0, 1, 1, 0, 0]",292,154,138,7,17,0.045454545454545456,0.12318840579710146
"[1, 1, 0, 0, 1, 1, 0, 0, 0, 1, 0, 1, 1, 0, 0]",141,84,57,8,9,0.09523809523809523,0.15789473684210525
"[1, 1, 0, 1, 1, 0, 0, 1, 0, 1, 1, 0, 1, 0, 0]",101,44,57,2,4,0.045454545454545456,0.07017543859649122
"[1, 0, 0, 1, 1, 0, 1, 1, 0, 0, 1, 0, 1, 1, 0]",107,38,69,1,4,0.02631578947368421,0.057971014492753624
"[1, 0, 1, 1, 0, 0, 0, 1, 1, 0, 0, 0, 1, 1, 0]",119,62,57,5,8,0.08064516129032258,0.14035087719298245
"[0, 0, 1, 0, 1, 0, 0, 1, 1, 0, 1, 0, 0, 1, 0]",116,66,50,3,5,0.045454545454545456,0.1
"[0, 1, 0, 0, 1, 1, 1, 1, 1, 0, 0, 1, 0, 0, 1]",112,51,61,4,2,0.0784313725490196,0.03278688524590164
"[1, 1, 0, 1, 1, 1, 0, 0, 1, 1, 0, 0, 1, 1, 0]",316,126,190,12,19,0.09523809523809523,0.1
"[1, 1, 1, 0, 0, 1, 0, 1, 0, 0, 0, 0, 1, 1, 0]",139,69,70,6,7,0.08695652173913043,0.1
"[1, 0, 0, 0, 0, 0, 1, 0, 1, 1, 1, 1, 1, 0, 0]",182,82,100,8,17,0.0975609756097561,0.17
"[0, 0, 1, 1, 0, 1, 1, 1, 1, 1, 0, 0, 0, 1, 0]",107,36,71,5,4,0.1388888888888889,0.056338028169014086
"[1, 0, 0, 0, 0, 0, 1, 0, 0, 1, 0, 1, 0, 1, 1]",171,91,80,11,6,0.12087912087912088,0.075
"[0, 1, 0, 1, 0, 1, 0, 1, 1, 1, 0, 1, 0, 0, 1]",102,52,50,4,3,0.07692307692307693,0.06
"[1, 0, 1, 0, 0, 1, 0, 1, 1, 1, 0, 1, 1, 0, 0]",120,58,62,5,6,0.08620689655172414,0.0967741935483871
"[0, 1, 0, 0, 1, 1, 1, 0, 0, 1, 0, 0, 0, 1, 1]",134,69,65,3,7,0.043478260869565216,0.1076923076923077
"[1, 0, 1, 0, 0, 1, 0, 0, 0, 1, 0, 1, 1, 1, 1]",138,68,70,5,5,0.07352941176470588,0.07142857142857142
"[0, 1, 1, 1, 0, 1, 1, 1, 0, 0, 1, 0, 0, 0, 1]",121,55,66,5,3,0.09090909090909091,0.045454545454545456
"[1, 0, 1, 0, 0, 0, 0, 0, 1, 0, 1, 1, 0, 1, 1]",129,70,59,6,7,0.08571428571428572,0.11864406779661017
"[1, 1, 0, 1, 0, 1, 0, 0, 1, 1, 1, 0, 0, 0, 0]",141,75,66,7,5,0.09333333333333334,0.07575757575757576
"[0, 1, 0, 0, 1, 0, 1, 0, 1, 1, 1, 1, 1, 0, 0]",132,64,68,3,12,0.046875,0.17647058823529413
"[0, 1, 1, 0, 0, 1, 0, 0, 0, 1, 0, 1, 0, 0, 1]",166,97,69,8,5,0.08247422680412371,0.07246376811594203
"[1, 1, 1, 1, 1, 0, 0, 0, 0, 0, 1, 0, 0, 1, 0]",151,67,84,2,2,0.029850746268656716,0.023809523809523808
"[0, 1, 0, 0, 0, 0, 0, 1, 0, 0, 1, 1, 0, 1, 1]",157,101,56,6,4,0.0594059405940594,0.07142857142857142
"[1, 1, 1, 1, 0, 0, 0, 1, 0, 0, 1, 1, 1, 1, 0]",202,79,123,7,12,0.08860759493670886,0.0975609756097561
"[1, 0, 1, 1, 0, 0, 1, 1, 1, 0, 1, 1, 1, 0, 0]",172,81,91,7,6,0.08641975308641975,0.06593406593406594
"[0, 0, 1, 0, 0, 0, 1, 1, 1, 0, 1, 1, 0, 1, 1]",123,53,70,6,9,0.11320754716981132,0.12857142857142856
"[1, 1, 1, 1, 0, 1, 0, 1, 0, 1, 0, 1, 0, 1, 1]",259,101,158,7,13,0.06930693069306931,0.08227848101265822
"[1, 1, 0, 0, 1, 0, 0, 0, 1, 0, 0, 0, 1, 0, 1]",131,72,59,9,8,0.125,0.13559322033898305
"[1, 0, 0, 1, 0, 1, 0, 1, 1, 0, 1, 1, 0, 1, 1]",131,55,76,3,4,0.05454545454545454,0.05263157894736842
"[0, 1, 1, 0, 0, 0, 1, 0, 1, 1, 0, 0, 1, 0, 1]",107,56,51,2,3,0.03571428571428571,0.058823529411764705
"[1, 0, 1, 0, 1, 0, 1, 0, 0, 0, 0, 1, 1, 0, 1]",113,66,47,6,4,0.09090909090909091,0.0851063829787234
"[0, 1, 1, 0, 0, 0, 0, 0, 1, 1, 1, 0, 1, 1, 0]",135,79,56,9,5,0.11392405063291139,0.08928571428571429
"[1, 0, 0, 1, 0, 1, 1, 0, 1, 0, 0, 0, 0, 1, 1]",159,79,80,1,7,0.012658227848101266,0.0875
"[1, 1, 0, 0, 0, 0, 1, 0, 0, 0, 1, 1, 0, 1, 1]",149,73,76,12,7,0.1643835616438356,0.09210526315789473
"[1, 0, 0, 1, 0, 1, 1, 0, 0, 1, 1, 0, 1, 1, 1]",190,71,119,1,15,0.014084507042253521,0.12605042016806722
"[1, 0, 1, 1, 0, 1, 0, 0, 0, 1, 0, 1, 1, 1, 0]",95,46,49,3,9,0.06521739130434782,0.1836734693877551
"[1, 0, 1, 0, 0, 1, 1, 1, 1, 0, 0, 1, 0, 0, 0]",133,65,68,6,7,0.09230769230769231,0.10294117647058823
"[0, 1, 0, 0, 1, 0, 1, 1, 0, 1, 0, 0, 0, 1, 0]",127,67,60,10,4,0.14925373134328357,0.06666666666666667
"[0, 0, 1, 1, 0, 1, 0, 1, 0, 0, 1, 1, 0, 1, 1]",118,56,62,7,5,0.125,0.08064516129032258
"[1, 1, 0, 1, 0, 1, 1, 0, 1, 0, 1, 0, 0, 1, 1]",134,63,71,7,4,0.1111111111111111,0.056338028169014086
"[1, 1, 1, 1, 0, 0, 0, 1, 0, 1, 1, 0, 1, 0, 0]",142,64,78,5,10,0.078125,0.1282051282051282
"[1, 1, 0, 0, 0, 1, 0, 0, 1, 0, 1, 0, 1, 1, 0]",110,54,56,4,5,0.07407407407407407,0.08928571428571429
"[0, 0, 0, 1, 0, 0, 0, 0, 1, 1, 1, 0, 1, 1, 1]",169,87,82,5,3,0.05747126436781609,0.036585365853658534
"[1, 1, 0, 1, 1, 0, 0, 0, 1, 1, 0, 1, 0, 0, 1]",111,63,48,9,4,0.14285714285714285,0.08333333333333333
"[0, 1, 1, 1, 1, 0, 1, 0, 0, 1, 1, 1, 0, 0, 0]",141,71,70,4,7,0.056338028169014086,0.1
"[0, 0, 0, 0, 1, 1, 1, 0, 0, 1, 0, 1, 0, 0, 1]",159,109,50,12,4,0.11009174311926606,0.08
"[1, 0, 1, 0, 1, 0, 1, 0, 1, 1, 0, 0, 0, 0, 0]",199,117,82,8,9,0.06837606837606838,0.10975609756097561
"[1, 0, 0, 1, 0, 0, 0, 1, 0, 1, 0, 0, 1, 0, 1]",156,83,73,11,8,0.13253012048192772,0.1095890410958904
"[1, 0, 1, 1, 0, 1, 0, 0, 1, 1, 0, 0, 0, 0, 1]",167,87,80,6,8,0.06896551724137931,0.1
"[0, 0, 1, 1, 0, 1, 1, 0, 1, 0, 1, 1, 1, 0, 0]",122,57,65,6,6,0.10526315789473684,0.09230769230769231
"[1, 0, 0, 0, 0, 0, 0, 0, 1, 1, 0, 1, 1, 0, 1]",160,79,81,12,9,0.1518987341772152,0.1111111111111111
"[0, 1, 0, 0, 1, 0, 0, 1, 0, 1, 0, 1, 1, 0, 0]",162,96,66,7,6,0.07291666666666667,0.09090909090909091
"[0, 0, 1, 0, 1, 1, 1, 0, 1, 0, 1, 1, 0, 0, 1]",119,52,67,2,8,0.038461538461538464,0.11940298507462686
"[1, 0, 1, 1, 1, 0, 1, 0, 1, 1, 1, 0, 0, 1, 1]",297,105,192,9,15,0.08571428571428572,0.078125
"[1, 0, 0, 1, 0, 1, 1, 1, 1, 1, 1, 1, 0, 1, 0]",210,63,147,8,16,0.12698412698412698,0.10884353741496598
"[1, 0, 1, 1, 1, 1, 0, 1, 1, 1, 0, 0, 0, 0, 0]",194,79,115,9,11,0.11392405063291139,0.09565217391304348
"[0, 1, 1, 1, 0, 1, 0, 0, 1, 0, 1, 0, 1, 1, 0]",103,51,52,5,8,0.09803921568627451,0.15384615384615385
"[1, 0, 1, 1, 0, 1, 1, 1, 0, 1, 0, 1, 1, 0, 0]",146,58,88,6,2,0.10344827586206896,0.022727272727272728
"[0, 0, 1, 1, 1, 1, 0, 1, 0, 1, 0, 0, 0, 1, 1]",160,90,70,18,6,0.2,0.08571428571428572
"[1, 1, 1, 0, 1, 0, 0, 0, 0, 0, 0, 0, 1, 0, 1]",164,107,57,8,5,0.07476635514018691,0.08771929824561403
"[1, 1, 1, 1, 1, 0, 0, 1, 0, 0, 0, 0, 0, 1, 1]",230,94,136,12,17,0.1276595744680851,0.125
"[1, 1, 0, 1, 1, 1, 0, 1, 1, 0, 1, 0, 0, 1, 0]",125,46,79,3,13,0.06521739130434782,0.16455696202531644
"[0, 1, 0, 0, 1, 0, 0, 1, 1, 1, 0, 1, 0, 0, 1]",111,62,49,6,6,0.0967741935483871,0.12244897959183673
"[1, 1, 1, 0, 1, 0, 1, 1, 1, 1, 1, 0, 0, 1, 0]",222,68,154,6,4,0.08823529411764706,0.025974025974025976
"[0, 0, 1, 0, 0, 1, 0, 0, 1, 0, 1, 1, 1, 0, 0]",167,98,69,6,5,0.061224489795918366,0.07246376811594203
"[1, 1, 1, 1, 0, 1, 0, 1, 0, 1, 1, 0, 0, 0, 1]",144,77,67,10,5,0.12987012987012986,0.07462686567164178
"[1, 0, 1, 1, 1, 1, 0, 1, 0, 1, 0, 0, 1, 0, 1]",137,55,82,5,7,0.09090909090909091,0.08536585365853659
"[0, 1, 1, 1, 1, 0, 0, 0, 0, 1, 0, 0, 1, 0, 1]",153,111,42,9,5,0.08108108108108109,0.11904761904761904
"[0, 1, 0, 1, 1, 0, 1, 0, 0, 1, 1, 0, 1, 1, 1]",164,68,96,8,12,0.11764705882352941,0.125
"[0, 1, 0, 0, 1, 0, 1, 1, 1, 0, 0, 0, 1, 0, 0]",128,75,53,3,5,0.04,0.09433962264150944
"[1, 0, 1, 1, 1, 0, 1, 0, 0, 1, 0, 0, 1, 0, 0]",102,54,48,3,4,0.05555555555555555,0.08333333333333333
"[0, 1, 0, 0, 0, 1, 0, 0, 1, 0, 1, 0, 0, 1, 0]",233,149,84,19,8,0.12751677852348994,0.09523809523809523
"[0, 1, 0, 1, 0, 0, 1, 0, 1, 0, 1, 0, 0, 1, 1]",135,66,69,10,6,0.15151515151515152,0.08695652173913043
"[1, 0, 0, 1, 0, 0, 1, 0, 0, 0, 1, 1, 1, 1, 0]",153,81,72,9,6,0.1111111111111111,0.08333333333333333
"[1, 1, 0, 1, 0, 1, 1, 0, 0, 1, 0, 0, 1, 0, 1]",118,46,72,4,8,0.08695652173913043,0.1111111111111111
"[1, 1, 0, 1, 0, 1, 1, 0, 0, 0, 1, 1, 0, 1, 0]",112,60,52,8,5,0.13333333333333333,0.09615384615384616
"[0, 1, 1, 0, 1, 0, 1, 0, 1, 0, 0, 0, 0, 1, 1]",136,70,66,7,3,0.1,0.045454545454545456
"[0, 1, 1, 1, 1, 0, 0, 1, 0, 1, 0, 0, 0, 0, 1]",117,73,44,8,7,0.1095890410958904,0.1590909090909091
"[1, 0, 1, 0, 0, 0, 0, 0, 1, 1, 1, 0, 1, 1, 1]",131,70,61,5,5,0.07142857142857142,0.08196721311475409
"[1, 0, 0, 0, 1, 0, 1, 1, 0, 1, 1, 0, 0, 0, 1]",118,60,58,4,5,0.06666666666666667,0.08620689655172414
"[0, 1, 0, 1, 0, 1, 1, 1, 1, 1, 1, 0, 0, 0, 0]",251,128,123,16,10,0.125,0.08130081300813008
"[1, 0, 1, 0, 1, 0, 1, 0, 1, 1, 1, 1, 1, 0, 0]",191,68,123,9,11,0.1323529411764706,0.08943089430894309
"[0, 1, 1, 1, 0, 1, 0, 0, 0, 1, 0, 1, 1, 0, 0]",115,62,53,8,3,0.12903225806451613,0.05660377358490566
"[1, 0, 0, 1, 0, 1, 1, 0, 1, 0, 1, 1, 0, 0, 1]",111,54,57,10,3,0.18518518518518517,0.05263157894736842
"[1, 1, 1, 0, 1, 0, 0, 0, 0, 1, 1, 0, 1, 0, 0]",121,60,61,4,1,0.06666666666666667,0.01639344262295082
"[1, 1, 0, 1, 0, 0, 1, 0, 0, 1, 1, 1, 0, 1, 0]",82,45,37,3,3,0.06666666666666667,0.08108108108108109
"[0, 0, 1, 0, 0, 1, 1, 1, 0, 1, 0, 1, 1, 0, 0]",108,60,48,6,4,0.1,0.08333333333333333
"[1, 0, 1, 0, 1, 0, 0, 0, 1, 1, 1, 0, 1, 0, 0]",111,66,45,10,2,0.15151515151515152,0.044444444444444446
"[0, 1, 0, 0, 1, 0, 1, 0, 1, 0, 0, 1, 0, 0, 1]",144,92,52,9,3,0.09782608695652174,0.057692307692307696
"[1, 0, 0, 0, 1, 1, 1, 0, 0, 0, 1, 1, 1, 0, 0]",156,76,80,11,9,0.14473684210526316,0.1125
"[0, 1, 0, 0, 1, 1, 1, 1, 0, 0, 0, 1, 0, 1, 0]",113,60,53,6,5,0.1,0.09433962264150944
"[0, 1, 0, 1, 0, 1, 1, 0, 1, 0, 1, 1, 0, 1, 0]",95,46,49,3,5,0.06521739130434782,0.10204081632653061
"[0, 1, 1, 1, 1, 0, 0, 0, 1, 0, 1, 0, 1, 0, 1]",107,59,48,9,7,0.15254237288135594,0.14583333333333334
"[0, 0, 1, 1, 1, 1, 1, 0, 0, 1, 1, 0, 1, 0, 0]",136,55,81,4,8,0.07272727272727272,0.09876543209876543
"[0, 1, 0, 1, 1, 0, 0, 0, 1, 1, 1, 1, 1, 1, 0]",218,83,135,6,10,0.07228915662650602,0.07407407407407407
"[1, 1, 0, 1, 0, 1, 1, 0, 0, 1, 0, 1, 1, 0, 0]",129,60,69,9,8,0.15,0.11594202898550725
"[1, 1, 0, 1, 0, 0, 1, 0, 1, 1, 0, 0, 0, 1, 0]",124,69,55,7,6,0.10144927536231885,0.10909090909090909
"[1, 0, 0, 1, 0, 1, 0, 0, 1, 1, 0, 1, 0, 1, 0]",114,57,57,4,4,0.07017543859649122,0.07017543859649122
"[0, 0, 1, 0, 0, 1, 1, 1, 1, 1, 0, 1, 0, 1, 0]",81,43,38,3,2,0.06976744186046512,0.05263157894736842
"[1, 0, 1, 1, 1, 1, 0, 0, 1, 0, 0, 1, 0, 0, 1]",120,60,60,6,1,0.1,0.016666666666666666
"[0, 1, 0, 1, 0, 1, 0, 1, 1, 0, 0, 1, 1, 0, 1]",118,58,60,8,6,0.13793103448275862,0.1
"[0, 0, 1, 0, 1, 1, 1, 0, 1, 0, 1, 0, 0, 1, 1]",125,61,64,8,4,0.13114754098360656,0.0625
"[1, 0, 1, 1, 0, 1, 1, 1, 1, 1, 1, 0, 0, 1, 0]",245,85,160,9,10,0.10588235294117647,0.0625
"[0, 1, 1, 1, 0, 1, 0, 1, 0, 0, 1, 1, 0, 1, 0]",94,41,53,1,4,0.024390243902439025,0.07547169811320754
"[1, 0, 0, 1, 1, 0, 1, 0, 1, 1, 1, 0, 0, 0, 1]",141,60,81,6,9,0.1,0.1111111111111111
"[1, 1, 1, 0, 0, 0, 0, 1, 1, 0, 1, 0, 0, 1, 0]",149,77,72,7,6,0.09090909090909091,0.08333333333333333
"[0, 1, 1, 1, 1, 0, 1, 0, 0, 0, 0, 1, 0, 1, 1]",138,71,67,5,6,0.07042253521126761,0.08955223880597014
"[1, 0, 0, 1, 0, 1, 1, 0, 1, 1, 0, 0, 0, 1, 0]",100,61,39,5,4,0.08196721311475409,0.10256410256410256
"[0, 1, 0, 1, 0, 1, 1, 1, 0, 1, 1, 1, 0, 1, 0]",128,54,74,8,9,0.14814814814814814,0.12162162162162163
"[0, 0, 0, 0, 1, 0, 1, 1, 1, 1, 1, 0, 1, 0, 1]",125,63,62,7,4,0.1111111111111111,0.06451612903225806
"[1, 0, 0, 0, 0, 1, 0, 1, 0, 1, 1, 1, 0, 1, 1]",114,50,64,6,8,0.12,0.125
"[0, 1, 1, 0, 0, 1, 0, 0, 1, 1, 0, 1, 0, 1, 0]",101,59,42,8,4,0.13559322033898305,0.09523809523809523
"[0, 0, 0, 1, 0, 0, 1, 1, 0, 1, 0, 1, 1, 0, 1]",98,52,46,5,5,0.09615384615384616,0.10869565217391304
"[0, 0, 0, 0, 1, 0, 1, 1, 1, 0, 1, 0, 1, 0, 0]",139,79,60,11,4,0.13924050632911392,0.06666666666666667
"[1, 1, 0, 0, 1, 0, 1, 0, 0, 0, 1, 0, 0, 0, 1]",140,78,62,6,6,0.07692307692307693,0.0967741935483871
"[1, 0, 1, 0, 1, 1, 1, 1, 1, 0, 0, 1, 0, 0, 0]",145,83,62,9,5,0.10843373493975904,0.08064516129032258
"[1, 0, 1, 0, 0, 0, 0, 1, 0, 0, 1, 0, 1, 1, 0]",110,57,53,1,4,0.017543859649122806,0.07547169811320754
"[0, 1, 1, 1, 0, 1, 0, 0, 1, 0, 0, 1, 0, 0, 1]",123,78,45,8,6,0.10256410256410256,0.13333333333333333
"[1, 0, 0, 0, 1, 0, 0, 0, 0, 1, 0, 1, 1, 0, 1]",131,75,56,8,5,0.10666666666666667,0.08928571428571429
"[0, 1, 0, 0, 1, 1, 1, 0, 1, 0, 0, 1, 1, 0, 1]",96,42,54,7,1,0.16666666666666666,0.018518518518518517
"[0, 0, 1, 0, 1, 1, 1, 1, 1, 0, 1, 0, 1, 1, 0]",115,49,66,8,12,0.16326530612244897,0.18181818181818182
"[1, 0, 1, 0, 0, 1, 0, 0, 1, 0, 1, 0, 0, 1, 1]",107,55,52,6,6,0.10909090909090909,0.11538461538461539
"[0, 0, 1, 1, 0, 1, 1, 0, 1, 1, 0, 0, 0, 1, 0]",114,63,51,3,3,0.047619047619047616,0.058823529411764705
"[1, 0, 0, 1, 0, 1, 0, 0, 0, 1, 0, 1, 0, 1, 0]",126,75,51,6,7,0.08,0.13725490196078433
"[0, 0, 0, 1, 0, 0, 1, 0, 0, 1, 1, 1, 0, 1, 0]",137,82,55,11,5,0.13414634146341464,0.09090909090909091
"[1, 1, 0, 1, 0, 0, 1, 1, 0, 0, 1, 0, 0, 1, 0]",98,50,48,5,5,0.1,0.10416666666666667
"[1, 0, 1, 0, 0, 0, 0, 0, 0, 1, 0, 1, 1, 1, 1]",187,94,93,10,7,0.10638297872340426,0.07526881720430108
"[1, 0, 1, 1, 0, 1, 1, 0, 1, 0, 0, 1, 1, 0, 0]",141,62,79,5,7,0.08064516129032258,0.08860759493670886
"[1, 0, 1, 0, 1, 1, 1, 1, 0, 0, 0, 1, 0, 0, 0]",136,75,61,7,5,0.09333333333333334,0.08196721311475409
"[0, 1, 0, 1, 1, 0, 0, 0, 1, 0, 0, 1, 0, 1, 1]",123,62,61,4,6,0.06451612903225806,0.09836065573770492
"[1, 0, 0, 0, 1, 0, 1, 1, 0, 0, 1, 0, 1, 1, 0]",114,62,52,2,2,0.03225806451612903,0.038461538461538464
"[1, 1, 1, 1, 0, 0, 0, 1, 0, 0, 1, 0, 1, 0, 0]",117,61,56,12,8,0.19672131147540983,0.14285714285714285
"[1, 1, 1, 0, 1, 0, 1, 1, 0, 0, 1, 0, 1, 0, 0]",109,58,51,4,4,0.06896551724137931,0.0784313725490196
"[0, 0, 0, 0, 1, 1, 1, 0, 1, 0, 0, 1, 1, 0, 1]",122,75,47,6,4,0.08,0.0851063829787234
"[0, 1, 0, 0, 0, 1, 1, 1, 0, 1, 1, 0, 1, 0, 0]",87,44,43,6,6,0.13636363636363635,0.13953488372093023
"[1, 0, 0, 1, 1, 1, 0, 0, 0, 0, 0, 1, 1, 0, 1]",127,63,64,10,6,0.15873015873015872,0.09375
"[1, 1, 1, 1, 1, 0, 1, 1, 0, 1, 0, 0, 0, 1, 0]",95,43,52,7,5,0.16279069767441862,0.09615384615384616
"[1, 1, 0, 0, 0, 1, 1, 1, 0, 1, 1, 0, 0, 0, 1]",129,67,62,4,13,0.05970149253731343,0.20967741935483872
"[0, 1, 1, 0, 1, 1, 1, 0, 1, 0, 0, 1, 0, 0, 0]",109,53,56,4,6,0.07547169811320754,0.10714285714285714
"[1, 0, 0, 1, 1, 0, 0, 1, 0, 0, 1, 1, 0, 1, 0]",118,57,61,7,4,0.12280701754385964,0.06557377049180328
"[0, 1, 1, 1, 0, 0, 1, 0, 1, 0, 0, 0, 1, 0, 1]",110,66,44,10,4,0.15151515151515152,0.09090909090909091
"[1, 1, 0, 1, 0, 0, 0, 1, 1, 1, 0, 1, 0, 0, 0]",112,60,52,2,3,0.03333333333333333,0.057692307692307696
"[1, 0, 0, 1, 0, 1, 0, 1, 1, 0, 0, 0, 1, 0, 1]",127,79,48,3,1,0.0379746835443038,0.020833333333333332
"[1, 0, 1, 0, 1, 0, 0, 0, 1, 0, 0, 1, 1, 0, 0]",171,113,58,11,12,0.09734513274336283,0.20689655172413793
"[1, 0, 0, 0, 0, 1, 0, 0, 1, 0, 0, 1, 1, 0, 1]",145,70,75,5,10,0.07142857142857142,0.13333333333333333
"[1, 1, 0, 0, 0, 1, 0, 1, 0, 0, 0, 1, 1, 0, 1]",107,57,50,4,3,0.07017543859649122,0.06
"[1, 0, 0, 0, 1, 1, 1, 0, 1, 1, 1, 0, 1, 0, 0]",99,53,46,7,4,0.1320754716981132,0.08695652173913043
"[1, 1, 1, 1, 1, 0, 0, 0, 0, 0, 0, 0, 1, 1, 1]",642,173,469,19,44,0.10982658959537572,0.09381663113006397
"[1, 1, 0, 0, 0, 0, 1, 1, 0, 1, 0, 1, 0, 0, 0]",194,114,80,13,7,0.11403508771929824,0.0875
"[0, 0, 0, 1, 1, 0, 0, 1, 0, 0, 0, 0, 1, 1, 0]",349,231,118,31,18,0.1341991341991342,0.15254237288135594
"[0, 1, 1, 0, 1, 0, 0, 0, 1, 1, 0, 0, 1, 0, 0]",146,100,46,9,4,0.09,0.08695652173913043
"[0, 0, 1, 1, 0, 1, 1, 1, 0, 0, 0, 1, 1, 0, 1]",129,62,67,5,9,0.08064516129032258,0.13432835820895522
"[0, 0, 0, 1, 1, 0, 1, 1, 1, 0, 0, 0, 1, 1, 0]",127,64,63,5,5,0.078125,0.07936507936507936
"[0, 1, 1, 1, 1, 1, 0, 1, 0, 1, 1, 1, 0, 1, 0]",210,79,131,10,7,0.12658227848101267,0.05343511450381679
"[1, 1, 0, 1, 1, 0, 1, 1, 0, 1, 1, 1, 1, 1, 0]",520,147,373,14,40,0.09523809523809523,0.10723860589812333
"[0, 1, 0, 0, 0, 0, 0, 0, 1, 1, 0, 1, 1, 0, 0]",326,190,136,20,14,0.10526315789473684,0.10294117647058823
"[0, 0, 0, 0, 0, 0, 0, 0, 0, 0, 0, 0, 0, 1, 1]",57735,52307,5428,5066,508,0.09685128185520102,0.09358879882092852
"[1, 0, 0, 0, 0, 0, 0, 0, 0, 0, 0, 0, 0, 0, 0]",83611,61129,22482,5815,2209,0.09512669927530305,0.09825638288408504
"[0, 0, 0, 0, 0, 0, 0, 0, 1, 1, 0, 0, 0, 0, 0]",28006,23167,4839,2182,461,0.09418569516985367,0.09526761727629676
"[0, 0, 0, 0, 0, 0, 0, 0, 0, 0, 1, 1, 0, 0, 0]",28201,23403,4798,2231,443,0.09532965859077897,0.09233013755731555
"[0, 0, 0, 0, 0, 0, 0, 0, 1, 0, 0, 0, 0, 0, 0]",56999,50254,6745,4813,662,0.09577347076849604,0.09814677538917717
"[0, 1, 1, 1, 1, 1, 1, 1, 1, 1, 1, 1, 1, 1, 1]",88411,25550,62861,2439,6098,0.09545988258317026,0.09700768361941427
"[1, 1, 1, 1, 1, 1, 1, 1, 1, 0, 0, 1, 1, 1, 1]",30992,3539,27453,325,2621,0.09183385137044363,0.0954722616836047
"[1, 1, 1, 0, 0, 0, 1, 1, 1, 1, 0, 0, 1, 1, 1]",627,179,448,12,39,0.0670391061452514,0.08705357142857142
"[0, 0, 0, 1, 1, 1, 1, 0, 1, 1, 0, 1, 1, 1, 1]",395,179,216,14,20,0.0782122905027933,0.09259259259259259
"[0, 1, 0, 0, 0, 1, 1, 1, 1, 1, 1, 1, 1, 0, 1]",271,95,176,5,23,0.05263157894736842,0.13068181818181818
"[1, 0, 1, 1, 1, 1, 1, 0, 1, 0, 0, 0, 1, 1, 1]",297,104,193,13,10,0.125,0.05181347150259067
"[1, 1, 0, 1, 1, 1, 1, 1, 0, 1, 0, 0, 0, 1, 1]",277,101,176,10,17,0.09900990099009901,0.09659090909090909
"[1, 1, 1, 0, 1, 1, 1, 1, 1, 0, 1, 0, 0, 0, 1]",249,80,169,5,23,0.0625,0.13609467455621302
"[0, 1, 1, 0, 0, 1, 1, 1, 1, 1, 1, 0, 1, 1, 1]",1034,577,457,50,53,0.08665511265164645,0.11597374179431072
"[1, 1, 0, 1, 1, 1, 0, 1, 1, 1, 1, 0, 1, 1, 1]",1617,408,1209,30,99,0.07352941176470588,0.08188585607940446
"[1, 0, 1, 0, 0, 0, 1, 1, 1, 0, 1, 0, 1, 1, 1]",157,66,91,4,9,0.06060606060606061,0.0989010989010989
"[0, 0, 1, 0, 1, 0, 0, 0, 1, 1, 1, 0, 1, 0, 1]",115,63,52,3,1,0.047619047619047616,0.019230769230769232
"[1, 0, 1, 1, 1, 0, 0, 0, 1, 0, 1, 0, 0, 0, 1]",125,62,63,4,6,0.06451612903225806,0.09523809523809523
"[1, 1, 1, 0, 1, 1, 0, 0, 1, 0, 0, 0, 1, 0, 1]",99,45,54,4,7,0.08888888888888889,0.12962962962962962
"[0, 0, 1, 1, 1, 0, 1, 1, 0, 0, 1, 0, 0, 0, 1]",132,71,61,8,7,0.11267605633802817,0.11475409836065574
"[0, 1, 1, 0, 1, 0, 0, 1, 1, 1, 0, 1, 1, 0, 0]",132,64,68,4,4,0.0625,0.058823529411764705
"[0, 1, 1, 0, 0, 0, 0, 0, 1, 1, 0, 1, 0, 0, 1]",179,128,51,6,5,0.046875,0.09803921568627451
"[0, 0, 1, 1, 0, 0, 0, 0, 0, 1, 1, 0, 1, 0, 0]",332,202,130,24,6,0.1188118811881188,0.046153846153846156
"[0, 1, 0, 1, 1, 0, 1, 0, 0, 0, 1, 1, 0, 0, 1]",160,87,73,11,10,0.12643678160919541,0.136986301369863
"[0, 0, 0, 0, 1, 0, 1, 0, 1, 1, 0, 1, 0, 0, 0]",260,168,92,23,11,0.13690476190476192,0.11956521739130435
"[0, 1, 1, 1, 0, 1, 1, 1, 1, 1, 1, 1, 1, 1, 1]",9691,2122,7569,221,699,0.10414703110273327,0.09235037653587
"[1, 0, 0, 0, 0, 0, 1, 1, 1, 1, 1, 0, 0, 0, 1]",171,97,74,1,7,0.010309278350515464,0.0945945945945946
"[1, 0, 0, 0, 0, 0, 0, 0, 0, 1, 0, 0, 0, 1, 0]",1611,1131,480,99,50,0.08753315649867374,0.10416666666666667
"[0, 0, 0, 1, 0, 0, 1, 0, 0, 0, 0, 0, 0, 0, 0]",8596,7081,1515,704,147,0.0994209857364779,0.09702970297029703
"[0, 0, 1, 0, 0, 0, 1, 0, 0, 1, 0, 0, 0, 0, 0]",1658,1287,371,114,32,0.08857808857808858,0.0862533692722372
"[1, 1, 1, 1, 1, 1, 1, 1, 0, 1, 1, 0, 1, 0, 0]",642,177,465,12,41,0.06779661016949153,0.08817204301075268
"[0, 1, 1, 0, 0, 1, 1, 0, 1, 0, 1, 1, 0, 0, 0]",130,78,52,10,5,0.1282051282051282,0.09615384615384616
"[1, 1, 1, 1, 1, 1, 1, 1, 1, 1, 1, 0, 0, 0, 1]",3482,630,2852,53,265,0.08412698412698413,0.09291725105189341
"[0, 1, 1, 1, 1, 1, 1, 0, 0, 0, 1, 0, 1, 1, 1]",458,254,204,23,19,0.09055118110236221,0.09313725490196079
"[1, 0, 0, 1, 0, 1, 0, 1, 1, 1, 1, 1, 1, 0, 0]",223,78,145,9,16,0.11538461538461539,0.1103448275862069
"[1, 1, 0, 1, 0, 0, 0, 0, 1, 1, 0, 0, 0, 0, 0]",475,283,192,35,21,0.12367491166077739,0.109375
"[0, 0, 0, 1, 0, 0, 1, 1, 1, 0, 1, 0, 0, 0, 0]",276,160,116,13,9,0.08125,0.07758620689655173
"[1, 0, 1, 1, 1, 1, 1, 1, 0, 1, 0, 0, 0, 1, 1]",279,109,170,15,25,0.13761467889908258,0.14705882352941177
"[0, 0, 1, 0, 1, 1, 0, 0, 1, 1, 1, 1, 0, 0, 1]",291,142,149,18,19,0.1267605633802817,0.12751677852348994
"[0, 1, 1, 1, 1, 1, 1, 0, 0, 1, 0, 0, 0, 0, 0]",251,158,93,13,7,0.08227848101265822,0.07526881720430108
"[0, 0, 0, 0, 0, 1, 1, 1, 1, 1, 1, 0, 0, 1, 0]",372,282,90,24,10,0.0851063829787234,0.1111111111111111
"[0, 0, 0, 1, 0, 1, 1, 1, 0, 0, 1, 1, 0, 0, 1]",201,112,89,9,4,0.08035714285714286,0.0449438202247191
"[1, 0, 0, 1, 1, 0, 1, 1, 1, 1, 1, 1, 1, 1, 1]",2598,600,1998,59,192,0.09833333333333333,0.0960960960960961
"[1, 1, 0, 0, 1, 1, 1, 1, 1, 1, 1, 0, 1, 1, 1]",3059,748,2311,63,188,0.08422459893048129,0.08135006490696668
"[1, 1, 1, 0, 0, 1, 1, 1, 1, 1, 1, 1, 0, 1, 1]",2754,470,2284,47,192,0.1,0.0840630472854641
"[0, 1, 1, 1, 1, 0, 1, 1, 0, 1, 1, 1, 0, 1, 1]",586,190,396,18,34,0.09473684210526316,0.08585858585858586
"[0, 1, 1, 1, 1, 0, 0, 1, 1, 1, 1, 0, 1, 1, 1]",1037,544,493,47,38,0.08639705882352941,0.07707910750507099
"[1, 1, 1, 1, 1, 0, 1, 1, 0, 1, 1, 1, 1, 0, 0]",769,216,553,18,51,0.08333333333333333,0.0922242314647378
"[1, 1, 1, 1, 1, 1, 1, 1, 0, 1, 0, 1, 1, 1, 1]",9021,1558,7463,142,770,0.09114249037227215,0.10317566662200188
"[0, 1, 1, 1, 1, 0, 1, 0, 1, 0, 0, 0, 1, 0, 1]",114,48,66,6,4,0.125,0.06060606060606061
"[1, 0, 0, 1, 0, 0, 0, 0, 0, 1, 0, 0, 1, 0, 0]",516,350,166,31,20,0.08857142857142856,0.12048192771084337
"[0, 0, 0, 0, 0, 1, 1, 1, 1, 1, 1, 1, 0, 1, 0]",248,167,81,20,7,0.11976047904191617,0.08641975308641975
"[0, 1, 0, 0, 0, 0, 1, 1, 1, 0, 1, 0, 1, 0, 0]",122,77,45,5,2,0.06493506493506493,0.044444444444444446
"[0, 0, 0, 0, 1, 0, 0, 0, 0, 1, 1, 1, 0, 1, 0]",233,148,85,18,7,0.12162162162162163,0.08235294117647059
"[0, 0, 0, 0, 1, 1, 0, 0, 0, 0, 0, 1, 0, 0, 0]",2300,1771,529,183,40,0.10333145115753811,0.07561436672967864
"[0, 0, 1, 0, 0, 0, 0, 1, 1, 0, 0, 0, 0, 0, 1]",675,476,199,52,19,0.1092436974789916,0.09547738693467336
"[1, 0, 0, 1, 0, 0, 0, 0, 1, 1, 0, 0, 0, 0, 0]",974,667,307,55,35,0.08245877061469266,0.11400651465798045
"[0, 0, 1, 0, 1, 0, 0, 0, 0, 1, 1, 0, 0, 0, 0]",999,710,289,72,30,0.10140845070422536,0.10380622837370242
"[0, 0, 0, 0, 1, 0, 0, 0, 0, 1, 1, 0, 0, 1, 0]",568,402,166,33,20,0.08208955223880597,0.12048192771084337
"[1, 0, 0, 0, 0, 0, 1, 0, 0, 0, 0, 0, 0, 0, 0]",8601,6740,1861,618,168,0.09169139465875371,0.09027404621171413
"[0, 0, 1, 0, 0, 0, 0, 1, 0, 0, 0, 0, 0, 1, 0]",1509,1156,353,110,35,0.09515570934256055,0.09915014164305949
"[0, 0, 1, 1, 1, 0, 0, 0, 0, 0, 0, 1, 0, 0, 0]",607,414,193,39,22,0.09420289855072464,0.11398963730569948
"[0, 1, 0, 1, 0, 1, 0, 0, 0, 0, 0, 0, 0, 1, 1]",383,243,140,29,15,0.11934156378600823,0.10714285714285714
"[0, 0, 0, 1, 0, 0, 1, 0, 0, 0, 0, 1, 0, 0, 0]",1551,1176,375,113,45,0.09608843537414966,0.12
"[1, 1, 1, 1, 0, 0, 1, 1, 1, 0, 1, 1, 1, 1, 1]",2572,609,1963,74,177,0.12151067323481117,0.09016811003565971
"[1, 0, 0, 0, 0, 0, 0, 0, 0, 1, 1, 1, 1, 1, 1]",2030,451,1579,44,142,0.0975609756097561,0.08993033565547814
"[1, 1, 1, 1, 1, 0, 0, 1, 1, 1, 1, 1, 1, 0, 0]",4571,691,3880,68,346,0.09840810419681621,0.08917525773195877
"[1, 1, 0, 0, 1, 1, 1, 1, 1, 1, 1, 1, 0, 0, 1]",4143,1210,2933,102,272,0.08429752066115702,0.09273781111489943
"[1, 1, 1, 1, 1, 1, 0, 1, 1, 0, 0, 1, 1, 1, 1]",2878,632,2246,65,217,0.10284810126582279,0.09661620658949244
"[1, 1, 1, 1, 1, 1, 1, 1, 1, 0, 1, 1, 0, 0, 1]",2527,542,1985,54,195,0.0996309963099631,0.0982367758186398
"[1, 1, 1, 1, 1, 1, 1, 1, 1, 0, 1, 1, 1, 0, 0]",2357,528,1829,33,159,0.0625,0.08693275013668672
"[0, 1, 1, 0, 1, 1, 1, 1, 1, 0, 1, 1, 1, 1, 1]",1803,490,1313,45,132,0.09183673469387756,0.10053313023610053
"[1, 0, 0, 1, 0, 1, 1, 1, 1, 0, 1, 1, 0, 1, 1]",235,99,136,4,12,0.04040404040404041,0.08823529411764706
"[1, 0, 1, 1, 0, 0, 1, 0, 1, 1, 1, 1, 0, 1, 1]",210,81,129,10,16,0.12345679012345678,0.12403100775193798
"[0, 0, 0, 1, 1, 0, 0, 1, 1, 0, 1, 0, 0, 1, 1]",231,155,76,13,6,0.08387096774193549,0.07894736842105263
"[0, 0, 1, 1, 0, 1, 0, 1, 1, 0, 0, 0, 0, 1, 1]",210,126,84,12,9,0.09523809523809523,0.10714285714285714
"[0, 0, 1, 0, 0, 0, 1, 1, 0, 1, 0, 1, 1, 0, 0]",161,88,73,6,7,0.06818181818181818,0.0958904109589041
"[1, 1, 1, 1, 0, 1, 1, 1, 1, 1, 1, 1, 1, 0, 1]",7026,1238,5788,104,525,0.0840064620355412,0.09070490670352453
"[0, 1, 1, 1, 1, 1, 1, 1, 1, 0, 0, 0, 0, 1, 0]",375,277,98,22,9,0.07942238267148015,0.09183673469387756
"[1, 0, 0, 0, 1, 0, 0, 1, 1, 0, 1, 1, 1, 0, 1]",98,37,61,2,4,0.05405405405405406,0.06557377049180328
"[0, 0, 0, 0, 1, 0, 0, 0, 0, 0, 0, 1, 1, 0, 0]",3090,2376,714,205,65,0.08627946127946128,0.09103641456582633
"[1, 0, 0, 1, 1, 0, 1, 1, 0, 0, 1, 1, 1, 1, 1]",459,145,314,12,31,0.08275862068965517,0.09872611464968153
"[0, 0, 0, 0, 0, 0, 1, 0, 0, 1, 1, 0, 1, 1, 0]",271,173,98,12,4,0.06936416184971098,0.04081632653061224
"[1, 1, 1, 0, 0, 0, 1, 1, 0, 0, 0, 0, 0, 0, 0]",564,335,229,35,24,0.1044776119402985,0.10480349344978165
"[0, 1, 1, 1, 1, 0, 1, 1, 0, 1, 0, 1, 0, 1, 1]",233,96,137,12,10,0.125,0.072992700729927
"[1, 1, 1, 0, 1, 1, 1, 1, 1, 0, 0, 0, 1, 0, 0]",152,60,92,8,7,0.13333333333333333,0.07608695652173914
"[0, 0, 1, 0, 0, 1, 0, 0, 1, 1, 0, 1, 1, 1, 1]",145,74,71,9,9,0.12162162162162163,0.1267605633802817
"[0, 1, 0, 0, 1, 0, 0, 1, 0, 0, 1, 1, 0, 1, 1]",115,65,50,6,9,0.09230769230769231,0.18
"[1, 0, 0, 0, 1, 0, 0, 1, 0, 0, 1, 0, 0, 1, 1]",148,79,69,6,6,0.0759493670886076,0.08695652173913043
"[1, 1, 1, 1, 0, 1, 1, 0, 0, 0, 1, 1, 1, 0, 1]",257,99,158,15,18,0.15151515151515152,0.11392405063291139
"[1, 1, 1, 1, 1, 1, 1, 1, 0, 1, 1, 1, 0, 0, 0]",867,223,644,21,49,0.09417040358744394,0.07608695652173914
"[1, 1, 1, 0, 1, 0, 0, 1, 0, 0, 1, 1, 1, 1, 1]",365,132,233,10,17,0.07575757575757576,0.07296137339055794
"[1, 1, 1, 1, 1, 0, 1, 0, 0, 1, 0, 0, 1, 1, 1]",345,118,227,10,24,0.0847457627118644,0.10572687224669604
"[1, 1, 0, 1, 1, 1, 1, 1, 1, 1, 0, 1, 0, 0, 1]",567,155,412,18,36,0.11612903225806452,0.08737864077669903
"[0, 0, 1, 1, 0, 0, 1, 1, 1, 0, 0, 0, 1, 0, 1]",171,92,79,10,7,0.10869565217391304,0.08860759493670886
"[0, 0, 0, 1, 1, 0, 0, 1, 1, 1, 0, 0, 0, 1, 0]",194,141,53,10,4,0.07092198581560284,0.07547169811320754
"[1, 0, 1, 0, 0, 1, 0, 0, 1, 0, 0, 0, 0, 0, 1]",243,151,92,13,9,0.08609271523178808,0.09782608695652174
"[1, 1, 1, 0, 1, 1, 1, 1, 1, 1, 1, 1, 0, 1, 0]",1610,379,1231,36,118,0.09498680738786279,0.0958570268074736
"[0, 1, 0, 0, 0, 1, 1, 0, 0, 0, 0, 0, 0, 0, 1]",712,496,216,45,29,0.0907258064516129,0.13425925925925927
"[1, 0, 0, 0, 0, 1, 0, 0, 1, 0, 0, 0, 1, 1, 0]",252,152,100,15,10,0.09868421052631579,0.1
"[0, 1, 0, 1, 0, 1, 1, 1, 1, 0, 0, 1, 1, 1, 0]",159,63,96,6,13,0.09523809523809523,0.13541666666666666
"[0, 1, 1, 1, 1, 1, 0, 1, 0, 1, 0, 1, 1, 1, 1]",554,176,378,14,58,0.07954545454545454,0.15343915343915343
"[1, 1, 0, 0, 0, 1, 1, 1, 1, 1, 0, 1, 0, 1, 0]",148,64,84,14,7,0.21875,0.08333333333333333
"[1, 1, 1, 0, 0, 0, 1, 1, 1, 1, 1, 0, 1, 0, 1]",245,75,170,5,15,0.06666666666666667,0.08823529411764706
"[1, 1, 1, 1, 1, 1, 1, 1, 0, 1, 1, 0, 1, 1, 1]",8355,1444,6911,135,622,0.09349030470914127,0.09000144696860078
"[1, 0, 1, 0, 1, 0, 1, 1, 1, 0, 1, 1, 0, 1, 1]",228,76,152,9,12,0.11842105263157894,0.07894736842105263
"[1, 0, 1, 1, 1, 0, 1, 0, 1, 0, 1, 1, 1, 0, 1]",198,62,136,5,15,0.08064516129032258,0.11029411764705882
"[0, 1, 1, 0, 1, 1, 1, 1, 1, 0, 1, 1, 1, 0, 1]",492,161,331,14,34,0.08695652173913043,0.1027190332326284
"[0, 0, 1, 0, 0, 0, 0, 1, 1, 1, 1, 0, 1, 0, 1]",103,53,50,4,4,0.07547169811320754,0.08
"[0, 0, 0, 1, 0, 1, 0, 0, 0, 0, 0, 0, 0, 1, 0]",1551,1198,353,120,36,0.1001669449081803,0.10198300283286119
"[1, 0, 1, 0, 0, 1, 0, 1, 1, 0, 1, 0, 0, 0, 0]",174,95,79,14,5,0.14736842105263157,0.06329113924050633
"[1, 1, 1, 1, 0, 0, 1, 1, 1, 1, 1, 1, 1, 1, 0]",6099,1600,4499,168,435,0.105,0.09668815292287175
"[0, 1, 1, 0, 1, 1, 1, 0, 1, 1, 1, 1, 1, 1, 1]",2033,547,1486,45,139,0.08226691042047532,0.09353970390309556
"[1, 0, 1, 0, 1, 1, 1, 1, 1, 0, 1, 1, 0, 1, 1]",512,136,376,14,35,0.10294117647058823,0.09308510638297872
"[1, 0, 0, 0, 0, 1, 0, 0, 0, 1, 0, 1, 1, 1, 1]",160,73,87,9,9,0.1232876712328767,0.10344827586206896
"[0, 1, 1, 0, 0, 0, 0, 1, 0, 0, 0, 1, 0, 1, 1]",214,152,62,21,5,0.13815789473684212,0.08064516129032258
"[0, 0, 1, 1, 0, 0, 0, 0, 1, 0, 0, 0, 1, 0, 1]",304,188,116,15,13,0.0797872340425532,0.11206896551724138
"[0, 0, 1, 1, 0, 0, 0, 0, 1, 1, 0, 0, 0, 0, 1]",2282,1434,848,162,88,0.11297071129707113,0.10377358490566038
"[1, 0, 0, 1, 1, 1, 0, 1, 0, 0, 0, 0, 0, 0, 0]",341,206,135,16,16,0.07766990291262135,0.11851851851851852
"[0, 0, 0, 0, 0, 1, 1, 1, 0, 0, 0, 1, 0, 0, 0]",671,486,185,40,19,0.0823045267489712,0.10270270270270271
"[0, 0, 1, 0, 1, 0, 0, 0, 0, 0, 0, 0, 0, 0, 1]",2026,1567,459,159,39,0.10146777281429484,0.08496732026143791
"[0, 0, 0, 0, 1, 0, 0, 0, 0, 1, 0, 1, 0, 0, 0]",1611,1260,351,137,28,0.10873015873015873,0.07977207977207977
"[0, 0, 0, 0, 0, 0, 0, 0, 1, 0, 0, 0, 0, 1, 0]",7028,5819,1209,559,116,0.09606461591338718,0.09594706368899918
"[0, 0, 0, 0, 0, 1, 1, 1, 1, 1, 1, 1, 0, 1, 1]",402,269,133,29,16,0.10780669144981413,0.12030075187969924
"[0, 0, 1, 1, 0, 0, 0, 0, 1, 1, 0, 0, 1, 1, 1]",2028,1107,921,112,87,0.1011743450767841,0.09446254071661238
"[1, 1, 0, 1, 0, 0, 1, 1, 0, 0, 1, 1, 0, 0, 0]",283,141,142,10,13,0.07092198581560284,0.09154929577464789
"[1, 0, 1, 0, 1, 1, 1, 1, 1, 1, 1, 0, 0, 1, 1]",977,303,674,29,61,0.09570957095709572,0.09050445103857567
"[1, 1, 0, 0, 1, 1, 1, 1, 1, 1, 0, 1, 0, 1, 1]",865,261,604,18,66,0.06896551724137931,0.10927152317880795
"[0, 1, 1, 1, 0, 0, 1, 1, 1, 1, 1, 1, 0, 1, 0]",250,90,160,12,16,0.13333333333333333,0.1
"[1, 1, 1, 0, 0, 1, 1, 1, 0, 1, 1, 1, 0, 0, 1]",318,103,215,10,18,0.0970873786407767,0.08372093023255814
"[0, 1, 1, 1, 0, 0, 1, 1, 1, 0, 1, 1, 1, 0, 0]",179,65,114,7,9,0.1076923076923077,0.07894736842105263
"[0, 0, 1, 1, 1, 1, 0, 1, 0, 0, 1, 1, 1, 1, 0]",204,89,115,6,5,0.06741573033707865,0.043478260869565216
"[1, 1, 0, 1, 0, 0, 0, 0, 1, 1, 1, 1, 0, 1, 0]",117,54,63,2,4,0.037037037037037035,0.06349206349206349
"[0, 1, 1, 1, 1, 1, 1, 1, 1, 0, 1, 0, 0, 0, 0]",247,121,126,17,14,0.14049586776859505,0.1111111111111111
"[0, 0, 0, 0, 1, 1, 1, 1, 1, 1, 0, 1, 1, 1, 1]",767,298,469,32,48,0.10738255033557047,0.1023454157782516
"[1, 1, 1, 1, 1, 0, 1, 1, 1, 1, 1, 0, 0, 0, 0]",599,177,422,18,34,0.1016949152542373,0.08056872037914692
"[1, 1, 1, 1, 1, 1, 1, 0, 1, 1, 1, 1, 1, 0, 0]",2525,584,1941,50,177,0.08561643835616438,0.09119010819165378
"[0, 0, 1, 1, 0, 0, 0, 0, 0, 1, 0, 0, 1, 0, 0]",611,416,195,40,13,0.09615384615384616,0.06666666666666667
"[1, 0, 1, 0, 0, 1, 1, 0, 0, 0, 0, 0, 0, 1, 1]",550,313,237,28,25,0.08945686900958466,0.10548523206751055
"[1, 0, 0, 0, 1, 0, 0, 0, 0, 0, 0, 0, 0, 0, 0]",9393,7404,1989,681,183,0.0919773095623987,0.09200603318250378
"[1, 1, 1, 1, 1, 1, 1, 0, 1, 0, 1, 1, 1, 0, 0]",726,199,527,20,44,0.10050251256281408,0.08349146110056926
"[0, 1, 1, 0, 0, 0, 0, 0, 0, 1, 1, 1, 1, 1, 1]",1947,1533,414,136,43,0.08871493803000652,0.10386473429951691
"[1, 1, 1, 1, 1, 0, 0, 0, 1, 1, 1, 1, 1, 1, 1]",3317,634,2683,70,257,0.11041009463722397,0.09578829668281774
"[1, 1, 0, 0, 0, 0, 0, 1, 1, 1, 0, 1, 1, 1, 1]",277,126,151,16,10,0.12698412698412698,0.06622516556291391
"[1, 1, 0, 0, 1, 1, 1, 0, 0, 1, 1, 0, 0, 0, 0]",292,144,148,17,16,0.11805555555555555,0.10810810810810811
"[0, 1, 1, 0, 1, 1, 0, 0, 1, 1, 1, 0, 0, 1, 1]",199,93,106,13,10,0.13978494623655913,0.09433962264150944
"[1, 0, 0, 1, 1, 1, 1, 1, 0, 1, 1, 0, 1, 0, 1]",263,81,182,10,19,0.12345679012345678,0.1043956043956044
"[1, 1, 0, 0, 1, 0, 0, 1, 0, 0, 1, 1, 1, 1, 1]",271,114,157,12,19,0.10526315789473684,0.12101910828025478
"[0, 0, 1, 0, 1, 1, 0, 1, 1, 1, 0, 1, 1, 0, 0]",118,63,55,9,8,0.14285714285714285,0.14545454545454545
"[0, 1, 0, 0, 0, 1, 1, 1, 1, 0, 0, 1, 0, 1, 1]",134,60,74,2,10,0.03333333333333333,0.13513513513513514
"[1, 0, 0, 1, 0, 0, 0, 1, 1, 1, 1, 0, 0, 1, 0]",124,73,51,2,4,0.0273972602739726,0.0784313725490196
"[1, 0, 0, 1, 0, 1, 1, 1, 0, 0, 1, 0, 0, 0, 1]",108,61,47,7,4,0.11475409836065574,0.0851063829787234
"[0, 0, 1, 1, 0, 0, 0, 0, 1, 1, 1, 1, 0, 0, 1]",1490,756,734,74,74,0.09788359788359788,0.1008174386920981
"[1, 1, 0, 0, 1, 1, 0, 0, 0, 0, 1, 1, 1, 1, 0]",1487,736,751,60,74,0.08152173913043478,0.0985352862849534
"[0, 0, 0, 0, 0, 1, 0, 0, 0, 0, 1, 0, 0, 0, 1]",1697,1333,364,142,24,0.10652663165791448,0.06593406593406594
"[0, 0, 1, 0, 1, 0, 0, 1, 0, 0, 0, 0, 0, 0, 0]",1857,1419,438,138,37,0.09725158562367865,0.08447488584474885
"[1, 0, 0, 0, 0, 0, 0, 1, 1, 0, 1, 0, 1, 1, 0]",200,102,98,16,6,0.1568627450980392,0.061224489795918366
"[0, 0, 0, 1, 1, 1, 1, 0, 0, 0, 0, 0, 1, 0, 1]",313,243,70,26,9,0.10699588477366255,0.12857142857142856
"[0, 0, 0, 0, 0, 0, 1, 1, 1, 1, 0, 0, 0, 0, 0]",5312,3861,1451,357,116,0.09246309246309246,0.07994486560992418
"[0, 1, 0, 1, 1, 1, 0, 0, 0, 0, 0, 0, 0, 0, 0]",1040,673,367,61,41,0.09063893016344725,0.11171662125340599
"[0, 0, 1, 0, 0, 0, 0, 1, 0, 1, 1, 0, 1, 0, 1]",138,77,61,2,4,0.025974025974025976,0.06557377049180328
"[0, 0, 1, 0, 0, 0, 1, 1, 0, 0, 1, 0, 0, 0, 0]",562,392,170,30,17,0.07653061224489796,0.1
"[1, 0, 0, 0, 0, 0, 0, 1, 0, 0, 0, 1, 0, 0, 0]",1648,1166,482,130,43,0.11149228130360206,0.08921161825726141
"[0, 0, 0, 1, 0, 0, 0, 0, 1, 1, 1, 0, 0, 1, 0]",245,153,92,14,6,0.0915032679738562,0.06521739130434782
"[0, 0, 1, 0, 1, 0, 0, 0, 1, 0, 0, 0, 0, 1, 1]",366,233,133,29,12,0.12446351931330472,0.09022556390977443
"[0, 1, 0, 0, 0, 1, 0, 0, 0, 0, 0, 0, 1, 0, 1]",495,343,152,34,15,0.09912536443148688,0.09868421052631579
"[1, 0, 0, 0, 0, 1, 1, 0, 1, 1, 0, 0, 1, 0, 1]",132,65,67,9,6,0.13846153846153847,0.08955223880597014
"[1, 0, 0, 1, 0, 1, 0, 0, 0, 0, 0, 0, 0, 0, 0]",2229,1602,627,156,58,0.09737827715355805,0.09250398724082935
"[1, 1, 1, 1, 1, 0, 0, 0, 0, 0, 0, 1, 0, 0, 0]",339,131,208,13,14,0.09923664122137404,0.0673076923076923
"[1, 1, 1, 1, 1, 1, 0, 0, 0, 0, 0, 0, 1, 0, 0]",398,220,178,21,14,0.09545454545454546,0.07865168539325842
"[1, 1, 1, 1, 1, 1, 1, 0, 0, 0, 0, 0, 0, 1, 0]",393,106,287,10,28,0.09433962264150944,0.0975609756097561
"[0, 1, 1, 0, 0, 1, 1, 1, 1, 1, 0, 1, 1, 1, 1]",919,447,472,46,50,0.1029082774049217,0.1059322033898305
"[0, 0, 0, 0, 0, 1, 1, 0, 1, 1, 1, 0, 1, 0, 0]",171,105,66,8,6,0.0761904761904762,0.09090909090909091
"[0, 0, 0, 0, 0, 0, 0, 1, 1, 0, 1, 1, 1, 0, 1]",193,121,72,13,5,0.10743801652892562,0.06944444444444445
"[0, 0, 0, 0, 0, 1, 1, 0, 1, 0, 0, 0, 0, 0, 0]",2153,1680,473,140,36,0.08333333333333333,0.07610993657505286
"[1, 0, 0, 1, 1, 1, 1, 0, 0, 1, 1, 0, 0, 1, 0]",323,84,239,10,25,0.11904761904761904,0.10460251046025104
"[1, 1, 1, 1, 0, 0, 1, 1, 1, 1, 0, 0, 1, 1, 0]",2171,793,1378,65,126,0.08196721311475409,0.09143686502177069
"[0, 1, 1, 0, 0, 1, 1, 1, 0, 1, 0, 0, 0, 0, 1]",161,89,72,8,4,0.0898876404494382,0.05555555555555555
"[1, 0, 1, 1, 0, 0, 1, 1, 1, 0, 1, 0, 0, 0, 0]",158,83,75,6,8,0.07228915662650602,0.10666666666666667
"[1, 1, 0, 0, 0, 0, 0, 0, 0, 1, 1, 0, 1, 1, 1]",331,191,140,16,11,0.08376963350785341,0.07857142857142857
"[0, 1, 0, 1, 1, 0, 1, 1, 0, 0, 1, 0, 0, 0, 0]",139,87,52,7,4,0.08045977011494253,0.07692307692307693
"[0, 0, 0, 1, 0, 1, 0, 0, 1, 1, 0, 0, 0, 0, 0]",887,618,269,51,21,0.0825242718446602,0.07806691449814127
"[0, 0, 1, 0, 0, 0, 0, 1, 1, 0, 1, 1, 1, 0, 0]",175,104,71,8,8,0.07692307692307693,0.11267605633802817
"[1, 0, 0, 1, 0, 1, 1, 1, 1, 0, 0, 0, 1, 0, 0]",121,57,64,4,8,0.07017543859649122,0.125
"[1, 0, 0, 1, 0, 0, 1, 0, 1, 1, 1, 1, 0, 0, 0]",155,83,72,7,7,0.08433734939759036,0.09722222222222222
"[0, 0, 0, 1, 1, 1, 1, 0, 1, 1, 0, 0, 1, 0, 0]",115,68,47,7,1,0.10294117647058823,0.02127659574468085
"[0, 0, 0, 0, 0, 1, 1, 1, 1, 1, 0, 1, 0, 1, 0]",151,97,54,7,4,0.07216494845360824,0.07407407407407407
"[0, 0, 0, 0, 0, 0, 0, 1, 1, 1, 1, 1, 0, 1, 0]",263,192,71,16,2,0.08333333333333333,0.028169014084507043
"[0, 0, 0, 1, 1, 1, 1, 0, 0, 0, 0, 0, 0, 0, 0]",5179,4518,661,393,60,0.08698539176626827,0.0907715582450832
"[0, 1, 0, 0, 0, 0, 1, 1, 1, 1, 1, 0, 1, 1, 0]",131,71,60,4,6,0.056338028169014086,0.1
"[0, 1, 0, 1, 0, 1, 0, 0, 0, 0, 1, 1, 1, 1, 1]",220,118,102,12,9,0.1016949152542373,0.08823529411764706
"[0, 0, 1, 0, 0, 0, 1, 0, 0, 1, 0, 1, 0, 1, 0]",228,157,71,16,12,0.10191082802547771,0.16901408450704225
"[1, 0, 1, 1, 1, 1, 1, 0, 1, 0, 0, 0, 1, 0, 1]",143,58,85,7,5,0.1206896551724138,0.058823529411764705
"[1, 1, 0, 0, 0, 1, 1, 1, 0, 1, 0, 1, 1, 1, 1]",307,108,199,7,17,0.06481481481481481,0.08542713567839195
"[0, 1, 1, 1, 1, 0, 1, 0, 0, 1, 1, 0, 0, 0, 1]",148,82,66,15,8,0.18292682926829268,0.12121212121212122
"[0, 0, 1, 1, 1, 1, 0, 1, 0, 0, 1, 1, 0, 0, 0]",200,120,80,16,11,0.13333333333333333,0.1375
"[0, 0, 0, 0, 0, 0, 1, 1, 0, 1, 0, 1, 0, 0, 0]",677,475,202,52,25,0.10947368421052632,0.12376237623762376
"[0, 0, 1, 0, 0, 0, 0, 0, 0, 0, 0, 0, 1, 1, 0]",3067,2365,702,231,75,0.09767441860465116,0.10683760683760683
"[0, 0, 1, 1, 0, 0, 0, 0, 0, 0, 1, 0, 0, 0, 1]",909,645,264,64,25,0.09922480620155039,0.0946969696969697
"[1, 1, 0, 0, 0, 1, 0, 0, 1, 1, 1, 1, 1, 1, 1]",502,182,320,13,35,0.07142857142857142,0.109375
"[0, 1, 1, 1, 1, 0, 1, 1, 1, 0, 0, 0, 1, 0, 0]",139,71,68,8,6,0.11267605633802817,0.08823529411764706
"[0, 1, 0, 1, 1, 1, 1, 1, 1, 0, 0, 1, 1, 1, 1]",1220,395,825,35,89,0.08860759493670886,0.10787878787878788
"[1, 0, 1, 0, 1, 1, 1, 1, 1, 1, 1, 1, 1, 0, 0]",1035,264,771,27,86,0.10227272727272728,0.11154345006485085
"[1, 0, 1, 1, 1, 1, 0, 1, 1, 1, 1, 0, 0, 1, 1]",826,242,584,30,61,0.12396694214876033,0.10445205479452055
"[0, 0, 1, 0, 0, 1, 0, 1, 1, 1, 0, 1, 1, 1, 1]",181,73,108,11,7,0.1506849315068493,0.06481481481481481
"[1, 0, 0, 1, 0, 0, 1, 0, 1, 1, 1, 0, 1, 1, 1]",183,60,123,2,13,0.03333333333333333,0.10569105691056911
"[1, 1, 0, 1, 1, 1, 1, 1, 0, 0, 1, 0, 0, 1, 0]",158,53,105,5,8,0.09433962264150944,0.0761904761904762
"[1, 1, 1, 0, 0, 1, 1, 0, 0, 1, 1, 0, 0, 0, 0]",1537,317,1220,22,111,0.0694006309148265,0.09098360655737706
"[1, 0, 0, 1, 1, 0, 0, 0, 0, 0, 1, 1, 1, 0, 0]",226,95,131,11,14,0.11578947368421053,0.10687022900763359
"[0, 1, 0, 0, 0, 0, 0, 1, 0, 0, 0, 1, 1, 0, 0]",680,466,214,47,24,0.10085836909871244,0.11214953271028037
"[0, 1, 0, 1, 0, 1, 1, 1, 0, 0, 1, 0, 1, 1, 1]",175,72,103,7,7,0.09722222222222222,0.06796116504854369
"[1, 0, 1, 1, 1, 0, 1, 0, 1, 0, 1, 1, 1, 0, 0]",164,69,95,2,8,0.028985507246376812,0.08421052631578947
"[1, 0, 0, 0, 0, 1, 1, 0, 0, 0, 0, 1, 0, 0, 1]",434,204,230,29,22,0.14215686274509803,0.09565217391304348
"[1, 0, 0, 1, 0, 1, 0, 0, 0, 0, 1, 1, 0, 0, 0]",381,247,134,21,14,0.08502024291497975,0.1044776119402985
"[0, 0, 0, 1, 1, 0, 0, 0, 0, 0, 0, 1, 1, 1, 1]",2509,2114,395,199,28,0.09413434247871334,0.07088607594936709
"[1, 1, 0, 0, 0, 0, 1, 1, 0, 0, 0, 0, 0, 0, 1]",2269,1372,897,124,98,0.09037900874635568,0.10925306577480491
"[1, 1, 1, 0, 0, 1, 1, 0, 0, 0, 0, 1, 1, 0, 0]",1515,311,1204,34,105,0.10932475884244373,0.0872093023255814
"[1, 1, 1, 1, 0, 0, 1, 1, 0, 0, 0, 0, 1, 1, 0]",1495,700,795,62,65,0.08857142857142856,0.08176100628930817
"[0, 0, 1, 1, 1, 1, 1, 1, 1, 1, 1, 1, 0, 0, 1]",4014,1238,2776,106,222,0.08562197092084006,0.07997118155619597
"[0, 0, 0, 0, 0, 1, 0, 1, 0, 1, 1, 1, 0, 0, 1]",175,109,66,15,2,0.13761467889908258,0.030303030303030304
"[0, 0, 0, 1, 1, 0, 0, 1, 1, 1, 0, 0, 1, 0, 1]",164,107,57,14,4,0.1308411214953271,0.07017543859649122
"[1, 1, 1, 1, 0, 1, 0, 0, 0, 0, 0, 0, 1, 1, 0]",228,117,111,15,10,0.1282051282051282,0.09009009009009009
"[0, 0, 1, 1, 1, 1, 0, 0, 1, 1, 0, 0, 0, 1, 0]",344,178,166,19,17,0.10674157303370786,0.10240963855421686
"[0, 0, 0, 0, 0, 0, 0, 1, 0, 1, 1, 0, 0, 1, 0]",550,414,136,35,13,0.08454106280193237,0.09558823529411764
"[0, 1, 1, 1, 1, 1, 1, 0, 1, 1, 0, 1, 1, 0, 0]",335,135,200,17,15,0.1259259259259259,0.075
"[1, 0, 1, 0, 0, 0, 1, 1, 1, 0, 1, 0, 0, 1, 1]",126,74,52,5,10,0.06756756756756757,0.19230769230769232
"[0, 0, 0, 1, 0, 1, 1, 0, 0, 1, 1, 0, 0, 0, 0]",533,325,208,42,7,0.12923076923076923,0.03365384615384615
"[1, 0, 0, 0, 0, 1, 0, 0, 0, 0, 1, 1, 1, 0, 1]",149,91,58,6,7,0.06593406593406594,0.1206896551724138
"[1, 0, 1, 1, 1, 0, 0, 1, 1, 0, 1, 0, 0, 1, 0]",106,46,60,1,6,0.021739130434782608,0.1
"[0, 0, 0, 0, 0, 0, 1, 1, 0, 1, 1, 1, 0, 0, 1]",211,125,86,10,4,0.08,0.046511627906976744
"[1, 1, 1, 0, 0, 0, 0, 0, 0, 0, 0, 1, 1, 0, 1]",433,137,296,11,30,0.08029197080291971,0.10135135135135136
"[1, 1, 1, 1, 0, 0, 0, 0, 0, 0, 0, 0, 1, 1, 0]",1858,1096,762,95,72,0.08667883211678833,0.09448818897637795
"[1, 1, 1, 1, 1, 0, 0, 0, 1, 0, 0, 0, 1, 1, 1]",279,90,189,6,17,0.06666666666666667,0.08994708994708994
"[0, 1, 1, 0, 1, 1, 1, 0, 0, 0, 1, 1, 1, 1, 0]",169,74,95,12,6,0.16216216216216217,0.06315789473684211
"[0, 1, 1, 1, 1, 1, 0, 1, 1, 0, 1, 1, 1, 0, 0]",285,115,170,12,12,0.10434782608695652,0.07058823529411765
"[1, 0, 0, 1, 1, 0, 1, 1, 1, 1, 1, 0, 1, 1, 0]",237,71,166,5,17,0.07042253521126761,0.10240963855421686
"[1, 1, 0, 1, 1, 1, 0, 0, 1, 1, 0, 1, 1, 1, 1]",640,182,458,14,45,0.07692307692307693,0.0982532751091703
"[0, 0, 0, 1, 1, 1, 1, 0, 0, 1, 1, 0, 0, 0, 0]",2023,1680,343,152,32,0.09047619047619047,0.09329446064139942
"[0, 0, 0, 1, 0, 1, 0, 0, 1, 0, 0, 0, 0, 0, 1]",576,403,173,40,21,0.09925558312655088,0.12138728323699421
"[1, 0, 0, 1, 0, 0, 1, 1, 1, 0, 0, 0, 0, 0, 1]",181,115,66,11,6,0.09565217391304348,0.09090909090909091
"[0, 0, 0, 0, 0, 0, 1, 1, 0, 0, 0, 1, 0, 0, 1]",888,611,277,54,30,0.088379705400982,0.10830324909747292
"[0, 0, 1, 0, 1, 1, 0, 0, 0, 0, 0, 1, 0, 0, 0]",592,413,179,42,19,0.1016949152542373,0.10614525139664804
"[0, 0, 0, 0, 1, 0, 1, 0, 0, 0, 0, 0, 0, 1, 0]",1574,1188,386,111,36,0.09343434343434344,0.09326424870466321
"[0, 1, 0, 0, 0, 1, 1, 0, 0, 0, 1, 0, 0, 1, 0]",270,180,90,14,8,0.07777777777777778,0.08888888888888889
"[0, 0, 0, 1, 0, 1, 1, 0, 0, 0, 1, 0, 0, 0, 1]",249,153,96,17,10,0.1111111111111111,0.10416666666666667
"[0, 0, 0, 1, 0, 0, 1, 0, 0, 0, 0, 1, 1, 1, 1]",382,267,115,33,8,0.12359550561797752,0.06956521739130435
"[1, 1, 1, 1, 1, 1, 0, 0, 0, 0, 0, 0, 1, 1, 0]",1583,721,862,58,71,0.08044382801664356,0.08236658932714618
"[1, 0, 0, 0, 0, 1, 1, 1, 0, 1, 1, 1, 1, 1, 1]",527,126,401,10,44,0.07936507936507936,0.10972568578553615
"[1, 1, 0, 0, 0, 0, 1, 1, 1, 0, 1, 1, 1, 1, 1]",615,186,429,25,32,0.13440860215053763,0.07459207459207459
"[0, 1, 0, 1, 0, 1, 1, 0, 0, 0, 0, 0, 0, 0, 0]",897,630,267,74,24,0.11746031746031746,0.0898876404494382
"[0, 0, 1, 0, 0, 1, 1, 0, 0, 0, 1, 0, 0, 0, 1]",240,144,96,21,10,0.14583333333333334,0.10416666666666667
"[1, 1, 1, 0, 0, 0, 0, 1, 1, 0, 0, 0, 1, 1, 0]",244,76,168,5,19,0.06578947368421052,0.1130952380952381
"[1, 1, 0, 1, 1, 1, 0, 0, 0, 0, 1, 1, 0, 0, 0]",257,125,132,10,9,0.08,0.06818181818181818
"[1, 0, 1, 0, 0, 1, 0, 1, 1, 0, 1, 1, 0, 1, 0]",112,66,46,8,3,0.12121212121212122,0.06521739130434782
"[0, 0, 0, 0, 0, 1, 1, 0, 0, 0, 0, 1, 0, 1, 0]",793,609,184,53,13,0.08702791461412152,0.07065217391304347
"[1, 0, 0, 1, 0, 0, 0, 0, 0, 0, 1, 1, 0, 0, 0]",985,661,324,70,44,0.1059001512859304,0.13580246913580246
"[1, 0, 0, 0, 0, 0, 1, 0, 1, 0, 0, 1, 0, 0, 0]",529,347,182,29,17,0.08357348703170028,0.09340659340659341
"[1, 0, 1, 0, 0, 0, 0, 0, 1, 0, 1, 0, 0, 1, 0]",224,132,92,14,10,0.10606060606060606,0.10869565217391304
"[1, 1, 0, 1, 0, 0, 1, 0, 1, 0, 0, 0, 0, 0, 1]",188,106,82,10,7,0.09433962264150944,0.08536585365853659
"[0, 0, 1, 1, 1, 0, 1, 0, 0, 1, 0, 1, 0, 0, 0]",176,99,77,6,10,0.06060606060606061,0.12987012987012986
"[0, 0, 0, 0, 0, 0, 1, 1, 0, 0, 0, 0, 0, 0, 1]",7571,5719,1852,542,173,0.09477181325406539,0.09341252699784017
"[0, 1, 1, 0, 0, 0, 0, 0, 0, 1, 1, 0, 1, 1, 1]",457,359,98,36,7,0.10027855153203342,0.07142857142857142
"[1, 0, 0, 0, 0, 1, 1, 1, 1, 0, 0, 0, 0, 0, 1]",515,151,364,12,31,0.07947019867549669,0.08516483516483517
"[0, 1, 1, 1, 1, 0, 0, 0, 0, 1, 1, 1, 1, 0, 0]",1522,1183,339,112,29,0.09467455621301775,0.0855457227138643
"[0, 0, 0, 1, 0, 1, 1, 1, 1, 0, 0, 0, 0, 1, 1]",322,184,138,16,13,0.08695652173913043,0.09420289855072464
"[1, 0, 1, 1, 1, 1, 1, 1, 1, 0, 0, 1, 1, 0, 0]",809,299,510,27,47,0.0903010033444816,0.09215686274509804
"[1, 0, 1, 1, 0, 0, 0, 1, 0, 1, 1, 1, 1, 1, 1]",333,115,218,14,25,0.12173913043478261,0.11467889908256881
"[0, 0, 0, 1, 1, 0, 1, 1, 0, 0, 0, 1, 0, 1, 1]",136,84,52,7,2,0.08333333333333333,0.038461538461538464
"[0, 0, 1, 1, 1, 0, 1, 1, 0, 0, 0, 0, 0, 1, 0]",143,85,58,6,8,0.07058823529411765,0.13793103448275862
"[0, 0, 0, 0, 1, 0, 0, 0, 1, 1, 1, 0, 1, 1, 0]",140,90,50,6,6,0.06666666666666667,0.12
"[0, 0, 1, 1, 0, 1, 1, 0, 0, 0, 0, 1, 0, 0, 0]",249,167,82,16,7,0.09580838323353294,0.08536585365853659
"[0, 0, 0, 0, 1, 1, 0, 1, 1, 0, 0, 0, 0, 1, 0]",231,153,78,16,9,0.10457516339869281,0.11538461538461539
"[1, 1, 1, 0, 1, 0, 0, 0, 1, 1, 1, 0, 0, 0, 0]",170,82,88,11,10,0.13414634146341464,0.11363636363636363
"[1, 0, 0, 1, 1, 1, 1, 1, 1, 0, 1, 1, 1, 0, 0]",373,107,266,6,32,0.056074766355140186,0.12030075187969924
"[0, 1, 0, 0, 1, 1, 1, 0, 1, 0, 0, 1, 1, 1, 1]",200,88,112,8,11,0.09090909090909091,0.09821428571428571
"[1, 0, 0, 1, 0, 1, 1, 1, 0, 0, 0, 1, 0, 1, 1]",131,64,67,8,4,0.125,0.05970149253731343
"[1, 1, 1, 0, 0, 0, 0, 1, 1, 0, 0, 0, 1, 1, 1]",445,101,344,8,30,0.07920792079207921,0.0872093023255814
"[1, 0, 1, 0, 0, 0, 1, 1, 1, 1, 0, 0, 1, 1, 1]",371,144,227,10,23,0.06944444444444445,0.1013215859030837
"[0, 0, 1, 0, 1, 0, 0, 0, 0, 0, 1, 1, 1, 0, 1]",159,94,65,13,10,0.13829787234042554,0.15384615384615385
"[0, 1, 1, 1, 0, 0, 1, 0, 1, 0, 0, 0, 0, 0, 1]",174,100,74,9,10,0.09,0.13513513513513514
"[0, 1, 0, 1, 1, 1, 0, 0, 1, 0, 1, 0, 0, 0, 0]",179,104,75,12,5,0.11538461538461539,0.06666666666666667
"[1, 1, 0, 0, 1, 0, 0, 0, 0, 1, 0, 0, 1, 0, 1]",144,76,68,11,6,0.14473684210526316,0.08823529411764706
"[0, 1, 1, 0, 1, 0, 0, 0, 1, 0, 0, 1, 0, 0, 0]",225,150,75,14,5,0.09333333333333334,0.06666666666666667
"[1, 1, 0, 0, 1, 0, 1, 1, 0, 1, 0, 0, 0, 1, 0]",105,57,48,9,8,0.15789473684210525,0.16666666666666666
"[0, 0, 0, 0, 0, 1, 1, 0, 0, 1, 0, 1, 1, 0, 1]",189,118,71,11,6,0.09322033898305085,0.08450704225352113
"[1, 0, 0, 1, 1, 0, 1, 0, 1, 0, 0, 0, 0, 0, 1]",156,84,72,10,9,0.11904761904761904,0.125
"[0, 1, 0, 0, 1, 1, 0, 1, 0, 1, 0, 0, 0, 0, 0]",286,169,117,16,17,0.09467455621301775,0.1452991452991453
"[0, 0, 1, 0, 1, 0, 1, 0, 0, 0, 1, 0, 0, 1, 0]",221,148,73,13,4,0.08783783783783784,0.0547945205479452
"[1, 1, 1, 0, 0, 0, 0, 0, 0, 0, 1, 1, 0, 0, 1]",383,145,238,11,16,0.07586206896551724,0.06722689075630252
"[1, 1, 1, 1, 0, 0, 0, 0, 0, 0, 0, 1, 1, 0, 0]",542,288,254,28,21,0.09722222222222222,0.08267716535433071
"[0, 0, 1, 0, 0, 0, 1, 0, 1, 1, 0, 1, 0, 0, 0]",228,157,71,13,10,0.08280254777070063,0.14084507042253522
"[1, 0, 0, 0, 1, 0, 0, 1, 0, 0, 1, 0, 0, 0, 1]",209,126,83,7,6,0.05555555555555555,0.07228915662650602
"[0, 1, 1, 0, 1, 1, 0, 0, 1, 1, 1, 0, 0, 0, 0]",150,86,64,8,5,0.09302325581395349,0.078125
"[0, 0, 0, 1, 1, 0, 1, 1, 0, 0, 1, 1, 1, 0, 0]",134,74,60,5,7,0.06756756756756757,0.11666666666666667
"[0, 1, 0, 0, 0, 0, 0, 0, 1, 0, 0, 1, 0, 0, 0]",1564,1221,343,112,31,0.09172809172809172,0.09037900874635568
"[0, 0, 1, 0, 1, 0, 0, 0, 0, 0, 0, 0, 1, 0, 1]",542,386,156,25,14,0.06476683937823834,0.08974358974358974
"[1, 0, 0, 1, 0, 1, 0, 0, 0, 0, 0, 0, 0, 1, 0]",566,392,174,37,24,0.09438775510204081,0.13793103448275862
"[0, 0, 1, 0, 1, 1, 0, 1, 1, 0, 1, 0, 0, 1, 0]",111,54,57,3,7,0.05555555555555555,0.12280701754385964
"[0, 0, 0, 0, 0, 0, 0, 0, 1, 0, 1, 1, 1, 0, 0]",778,546,232,52,11,0.09523809523809523,0.04741379310344827
"[0, 0, 0, 0, 1, 0, 1, 0, 0, 0, 1, 0, 1, 0, 1]",263,163,100,9,10,0.05521472392638037,0.1
"[1, 0, 0, 0, 0, 1, 0, 1, 1, 0, 0, 0, 1, 0, 1]",138,79,59,4,7,0.05063291139240506,0.11864406779661017
"[0, 0, 1, 0, 1, 0, 0, 0, 0, 1, 0, 0, 0, 0, 1]",532,393,139,37,16,0.09414758269720101,0.11510791366906475
"[0, 1, 1, 0, 0, 1, 0, 1, 0, 0, 0, 0, 1, 0, 0]",277,189,88,24,7,0.12698412698412698,0.07954545454545454
"[0, 0, 1, 1, 0, 0, 1, 0, 1, 0, 0, 0, 0, 1, 0]",282,188,94,21,8,0.11170212765957446,0.0851063829787234
"[1, 1, 0, 0, 0, 1, 1, 0, 0, 1, 0, 1, 0, 0, 0]",162,103,59,12,7,0.11650485436893204,0.11864406779661017
"[0, 1, 1, 0, 0, 0, 1, 1, 0, 0, 1, 0, 1, 0, 0]",164,103,61,7,2,0.06796116504854369,0.03278688524590164
"[0, 0, 1, 0, 0, 0, 1, 0, 1, 0, 0, 0, 1, 0, 1]",253,172,81,21,5,0.12209302325581395,0.06172839506172839
"[1, 0, 0, 0, 0, 0, 1, 0, 0, 0, 1, 0, 0, 0, 1]",563,354,209,32,24,0.0903954802259887,0.11483253588516747
"[0, 1, 0, 1, 0, 1, 1, 1, 1, 1, 1, 1, 1, 1, 1]",2342,644,1698,75,167,0.11645962732919254,0.0983510011778563
"[1, 1, 0, 1, 1, 0, 1, 1, 0, 1, 0, 1, 0, 1, 1]",219,84,135,7,9,0.08333333333333333,0.06666666666666667
"[1, 1, 0, 0, 0, 1, 1, 1, 1, 1, 1, 1, 1, 0, 1]",652,207,445,25,52,0.12077294685990338,0.11685393258426967
"[1, 1, 0, 0, 0, 1, 0, 1, 1, 0, 0, 0, 1, 1, 1]",149,83,66,12,5,0.14457831325301204,0.07575757575757576
"[1, 1, 1, 0, 0, 0, 1, 0, 1, 1, 0, 0, 0, 1, 1]",121,52,69,5,7,0.09615384615384616,0.10144927536231885
"[0, 1, 0, 1, 0, 1, 1, 0, 1, 0, 1, 1, 0, 0, 1]",122,47,75,5,1,0.10638297872340426,0.013333333333333334
"[1, 0, 0, 0, 0, 0, 1, 0, 0, 0, 0, 1, 0, 1, 0]",504,349,155,36,11,0.10315186246418338,0.07096774193548387
"[0, 0, 0, 0, 1, 1, 0, 0, 0, 1, 0, 0, 0, 1, 0]",585,414,171,32,12,0.07729468599033816,0.07017543859649122
"[0, 0, 1, 0, 1, 0, 1, 0, 1, 0, 1, 1, 0, 0, 0]",173,110,63,7,4,0.06363636363636363,0.06349206349206349
"[1, 0, 0, 0, 0, 1, 1, 0, 0, 0, 1, 1, 1, 1, 1]",374,106,268,16,21,0.1509433962264151,0.07835820895522388
"[0, 1, 1, 0, 0, 0, 0, 0, 0, 0, 1, 1, 0, 0, 1]",595,424,171,50,15,0.1179245283018868,0.08771929824561403
"[1, 1, 1, 0, 0, 0, 0, 0, 0, 0, 0, 0, 1, 0, 0]",963,536,427,49,38,0.0914179104477612,0.08899297423887588
"[0, 1, 0, 0, 0, 1, 0, 0, 0, 1, 0, 0, 1, 0, 0]",487,338,149,19,11,0.05621301775147929,0.0738255033557047
"[0, 0, 1, 0, 0, 1, 0, 0, 0, 1, 0, 0, 0, 1, 0]",497,357,140,29,7,0.08123249299719888,0.05
"[1, 1, 0, 0, 1, 1, 1, 1, 0, 0, 0, 0, 1, 1, 1]",2328,926,1402,89,150,0.09611231101511879,0.10699001426533523
"[0, 0, 1, 0, 0, 1, 1, 1, 1, 1, 0, 0, 1, 1, 0]",201,96,105,9,5,0.09375,0.047619047619047616
"[1, 1, 0, 1, 1, 1, 1, 1, 1, 0, 1, 1, 1, 1, 0]",1639,398,1241,35,127,0.08793969849246232,0.10233682514101532
"[1, 1, 0, 1, 0, 1, 1, 0, 1, 1, 1, 1, 1, 1, 0]",604,192,412,14,32,0.07291666666666667,0.07766990291262135
"[0, 1, 1, 1, 1, 1, 1, 0, 1, 0, 1, 1, 0, 1, 1]",579,205,374,25,41,0.12195121951219512,0.10962566844919786
"[1, 0, 0, 1, 1, 0, 0, 1, 1, 1, 1, 1, 1, 1, 1]",5099,602,4497,60,441,0.09966777408637874,0.0980653769179453
"[1, 0, 1, 1, 1, 1, 1, 1, 1, 1, 1, 1, 0, 0, 0]",1334,393,941,25,101,0.06361323155216285,0.1073326248671626
"[0, 1, 1, 1, 1, 1, 1, 1, 1, 0, 1, 1, 1, 1, 0]",1751,539,1212,37,110,0.0686456400742115,0.09075907590759076
"[1, 1, 1, 0, 1, 0, 0, 1, 1, 1, 1, 1, 1, 1, 1]",2814,650,2164,61,208,0.09384615384615384,0.09611829944547134
"[0, 0, 0, 1, 1, 0, 0, 0, 1, 0, 1, 1, 1, 0, 0]",206,138,68,16,5,0.11594202898550725,0.07352941176470588
"[1, 1, 1, 1, 0, 0, 0, 0, 1, 1, 1, 1, 1, 1, 0]",2204,800,1404,74,152,0.0925,0.10826210826210826
"[0, 1, 0, 1, 1, 1, 1, 1, 0, 1, 1, 1, 0, 0, 0]",182,65,117,6,8,0.09230769230769231,0.06837606837606838
"[0, 1, 1, 1, 1, 1, 1, 1, 0, 0, 1, 1, 0, 0, 1]",841,330,511,31,46,0.09393939393939393,0.09001956947162426
"[0, 1, 1, 1, 1, 0, 1, 0, 0, 1, 0, 1, 0, 0, 0]",105,55,50,5,8,0.09090909090909091,0.16
"[0, 1, 1, 0, 0, 1, 0, 0, 1, 1, 1, 1, 0, 1, 0]",124,58,66,4,5,0.06896551724137931,0.07575757575757576
"[0, 1, 1, 1, 0, 0, 1, 1, 0, 0, 1, 0, 0, 1, 1]",150,78,72,6,6,0.07692307692307693,0.08333333333333333
"[0, 1, 0, 1, 0, 1, 1, 0, 1, 1, 1, 1, 1, 1, 1]",642,179,463,18,37,0.1005586592178771,0.07991360691144708
"[1, 0, 1, 0, 1, 0, 1, 1, 0, 1, 1, 1, 1, 1, 1]",634,209,425,24,33,0.11483253588516747,0.07764705882352942
"[1, 0, 1, 1, 0, 0, 1, 1, 1, 1, 1, 1, 1, 1, 1]",3593,890,2703,90,267,0.10112359550561797,0.09877913429522753
"[0, 0, 1, 1, 0, 0, 1, 0, 0, 1, 0, 1, 0, 0, 0]",278,178,100,22,12,0.12359550561797752,0.12
"[1, 1, 1, 0, 0, 0, 0, 0, 1, 1, 0, 0, 1, 0, 0]",193,95,98,8,8,0.08421052631578947,0.08163265306122448
"[0, 1, 1, 1, 1, 1, 1, 0, 1, 1, 0, 1, 1, 1, 0]",495,159,336,9,30,0.05660377358490566,0.08928571428571429
"[0, 0, 0, 0, 0, 0, 1, 1, 0, 1, 1, 1, 1, 0, 0]",278,169,109,13,8,0.07692307692307693,0.07339449541284404
"[0, 0, 0, 1, 1, 0, 0, 0, 0, 1, 1, 0, 0, 0, 1]",736,594,142,45,10,0.07575757575757576,0.07042253521126761
"[0, 1, 0, 1, 1, 0, 1, 0, 1, 0, 0, 1, 0, 0, 0]",153,90,63,11,10,0.12222222222222222,0.15873015873015872
"[0, 0, 1, 0, 1, 1, 0, 1, 0, 1, 0, 0, 1, 0, 0]",151,99,52,16,2,0.16161616161616163,0.038461538461538464
"[0, 0, 0, 0, 0, 1, 0, 1, 1, 0, 1, 0, 1, 0, 0]",250,179,71,19,6,0.10614525139664804,0.08450704225352113
"[0, 0, 1, 1, 0, 0, 1, 1, 1, 1, 0, 0, 1, 1, 1]",2347,990,1357,103,130,0.10404040404040404,0.09579955784819455
"[0, 1, 1, 0, 1, 0, 1, 1, 0, 0, 1, 1, 1, 0, 0]",165,82,83,4,5,0.04878048780487805,0.060240963855421686
"[1, 1, 0, 0, 1, 1, 1, 1, 0, 0, 1, 0, 1, 1, 1]",581,209,372,21,33,0.10047846889952153,0.08870967741935484
"[1, 1, 1, 1, 0, 0, 1, 1, 0, 0, 1, 1, 1, 1, 0]",2189,810,1379,76,137,0.09382716049382717,0.09934735315445975
"[1, 0, 1, 0, 0, 0, 0, 1, 1, 1, 1, 1, 1, 1, 1]",758,279,479,28,32,0.1003584229390681,0.06680584551148225
"[1, 1, 1, 0, 1, 1, 0, 1, 1, 1, 1, 1, 1, 0, 1]",1513,346,1167,30,105,0.08670520231213873,0.08997429305912596
"[1, 1, 1, 1, 0, 1, 1, 0, 1, 1, 1, 1, 1, 1, 0]",1768,429,1339,40,116,0.09324009324009325,0.08663181478715459
"[0, 1, 0, 0, 0, 0, 1, 0, 0, 0, 0, 1, 1, 1, 1]",313,194,119,19,10,0.0979381443298969,0.08403361344537816
"[0, 0, 1, 1, 0, 0, 1, 1, 1, 1, 0, 0, 1, 1, 0]",1492,765,727,66,64,0.08627450980392157,0.08803301237964237
"[1, 1, 1, 0, 0, 1, 0, 1, 1, 1, 0, 0, 1, 1, 0]",209,79,130,3,14,0.0379746835443038,0.1076923076923077
"[1, 1, 1, 0, 1, 1, 1, 1, 1, 0, 0, 1, 0, 1, 1]",549,162,387,12,45,0.07407407407407407,0.11627906976744186
"[0, 1, 0, 1, 1, 1, 1, 0, 1, 1, 1, 1, 1, 0, 0]",290,107,183,10,17,0.09345794392523364,0.09289617486338798
"[1, 0, 1, 1, 0, 1, 0, 1, 1, 1, 1, 0, 1, 1, 1]",544,154,390,17,40,0.11038961038961038,0.10256410256410256
"[1, 0, 1, 0, 1, 1, 0, 1, 0, 1, 1, 1, 1, 0, 1]",221,74,147,9,14,0.12162162162162163,0.09523809523809523
"[1, 1, 1, 1, 1, 0, 0, 1, 1, 1, 1, 0, 0, 0, 0]",2030,358,1672,31,171,0.08659217877094973,0.10227272727272728
"[0, 0, 0, 0, 1, 1, 0, 0, 0, 1, 1, 1, 1, 1, 1]",462,233,229,17,18,0.07296137339055794,0.07860262008733625
"[1, 0, 1, 0, 0, 0, 0, 1, 1, 0, 0, 0, 1, 1, 1]",200,110,90,12,7,0.10909090909090909,0.07777777777777778
"[0, 0, 1, 0, 1, 1, 1, 1, 0, 0, 0, 0, 1, 1, 0]",275,154,121,10,9,0.06493506493506493,0.0743801652892562
"[1, 0, 1, 0, 1, 0, 0, 0, 0, 1, 0, 1, 0, 0, 1]",155,93,62,9,5,0.0967741935483871,0.08064516129032258
"[0, 1, 1, 1, 0, 0, 1, 0, 1, 0, 1, 0, 0, 0, 0]",146,78,68,8,3,0.10256410256410256,0.04411764705882353
"[1, 1, 0, 1, 1, 1, 0, 0, 1, 0, 1, 0, 1, 0, 0]",115,64,51,7,4,0.109375,0.0784313725490196
"[1, 1, 1, 1, 0, 0, 1, 1, 1, 0, 1, 1, 1, 1, 0]",676,202,474,22,45,0.10891089108910891,0.0949367088607595
"[0, 1, 1, 0, 0, 0, 0, 0, 0, 0, 1, 0, 1, 0, 1]",343,246,97,21,6,0.08536585365853659,0.061855670103092786
"[0, 0, 1, 1, 0, 0, 0, 0, 0, 0, 0, 1, 0, 1, 0]",773,534,239,47,25,0.08801498127340825,0.10460251046025104
"[0, 1, 1, 0, 0, 0, 1, 1, 0, 0, 1, 0, 0, 0, 1]",167,104,63,13,10,0.125,0.15873015873015872
"[0, 0, 0, 0, 1, 0, 1, 1, 1, 0, 0, 1, 1, 1, 0]",103,58,45,7,5,0.1206896551724138,0.1111111111111111
"[1, 1, 0, 1, 1, 1, 1, 0, 0, 0, 1, 1, 0, 1, 0]",136,59,77,3,11,0.05084745762711865,0.14285714285714285
"[1, 1, 0, 0, 1, 1, 0, 0, 0, 0, 0, 0, 0, 1, 0]",649,398,251,25,28,0.06281407035175879,0.11155378486055777
"[1, 1, 0, 0, 0, 0, 0, 1, 1, 0, 0, 1, 1, 0, 0]",533,300,233,31,25,0.10333333333333333,0.1072961373390558
"[0, 0, 0, 1, 1, 0, 0, 0, 0, 0, 1, 1, 0, 0, 1]",524,366,158,31,10,0.08469945355191257,0.06329113924050633
"[0, 1, 0, 0, 0, 0, 1, 1, 0, 0, 0, 0, 0, 1, 1]",453,309,144,29,14,0.09385113268608414,0.09722222222222222
"[1, 1, 1, 0, 0, 1, 1, 0, 0, 1, 1, 1, 0, 1, 1]",562,112,450,11,44,0.09821428571428571,0.09777777777777778
"[0, 0, 0, 1, 1, 1, 1, 1, 0, 1, 0, 1, 1, 0, 0]",156,81,75,7,7,0.08641975308641975,0.09333333333333334
"[1, 0, 0, 0, 1, 1, 1, 1, 1, 1, 1, 1, 1, 0, 1]",630,201,429,17,48,0.0845771144278607,0.11188811188811189
"[1, 0, 0, 0, 0, 1, 0, 0, 1, 1, 1, 1, 1, 1, 1]",354,134,220,16,26,0.11940298507462686,0.11818181818181818
"[1, 0, 1, 0, 1, 0, 1, 1, 1, 0, 0, 0, 0, 1, 0]",124,69,55,2,4,0.028985507246376812,0.07272727272727272
"[1, 1, 0, 0, 1, 1, 1, 1, 1, 1, 0, 1, 0, 1, 0]",323,117,206,15,24,0.1282051282051282,0.11650485436893204
"[0, 0, 1, 1, 0, 0, 1, 1, 1, 1, 1, 1, 0, 1, 0]",371,156,215,19,23,0.12179487179487179,0.10697674418604651
"[1, 0, 0, 0, 1, 1, 0, 0, 1, 1, 1, 1, 1, 1, 0]",434,188,246,26,28,0.13829787234042554,0.11382113821138211
"[0, 0, 0, 0, 1, 0, 0, 0, 1, 1, 1, 1, 1, 1, 1]",337,184,153,11,10,0.059782608695652176,0.06535947712418301
"[0, 1, 1, 0, 0, 0, 0, 0, 1, 0, 0, 0, 1, 1, 1]",392,294,98,28,12,0.09523809523809523,0.12244897959183673
"[0, 0, 0, 0, 0, 1, 0, 0, 1, 0, 1, 1, 0, 1, 1]",187,115,72,9,8,0.0782608695652174,0.1111111111111111
"[1, 1, 1, 1, 1, 0, 0, 1, 1, 1, 1, 1, 1, 0, 1]",3056,470,2586,49,251,0.10425531914893617,0.09706109822119102
"[1, 0, 0, 1, 0, 0, 0, 1, 0, 0, 0, 1, 0, 0, 0]",568,379,189,42,21,0.11081794195250659,0.1111111111111111
"[1, 0, 0, 1, 1, 0, 1, 0, 0, 0, 0, 0, 0, 0, 1]",315,193,122,16,11,0.08290155440414508,0.09016393442622951
"[0, 0, 0, 0, 1, 0, 0, 1, 0, 0, 1, 1, 0, 1, 0]",213,137,76,12,7,0.08759124087591241,0.09210526315789473
"[1, 0, 0, 1, 1, 0, 0, 1, 0, 0, 0, 0, 0, 1, 0]",264,159,105,17,9,0.1069182389937107,0.08571428571428572
"[0, 1, 1, 0, 1, 1, 1, 0, 0, 0, 1, 0, 1, 0, 1]",102,48,54,1,6,0.020833333333333332,0.1111111111111111
"[0, 0, 1, 1, 0, 0, 0, 1, 0, 1, 1, 1, 0, 1, 0]",122,69,53,6,8,0.08695652173913043,0.1509433962264151
"[1, 1, 1, 0, 1, 0, 1, 0, 0, 1, 1, 1, 1, 0, 0]",261,99,162,9,20,0.09090909090909091,0.12345679012345678
"[0, 0, 1, 0, 0, 0, 0, 1, 1, 1, 1, 0, 1, 1, 1]",183,93,90,12,6,0.12903225806451613,0.06666666666666667
"[1, 0, 1, 0, 1, 1, 0, 0, 1, 1, 1, 0, 0, 1, 1]",204,96,108,9,15,0.09375,0.1388888888888889
"[1, 1, 1, 1, 1, 1, 1, 0, 1, 0, 1, 0, 1, 1, 0]",575,166,409,11,35,0.06626506024096386,0.08557457212713937
"[0, 0, 0, 1, 1, 1, 1, 0, 0, 0, 0, 1, 0, 1, 1]",335,255,80,19,14,0.07450980392156863,0.175
"[1, 0, 0, 0, 1, 0, 1, 0, 0, 0, 1, 0, 0, 0, 0]",554,364,190,40,25,0.10989010989010989,0.13157894736842105
"[1, 0, 0, 0, 0, 0, 1, 0, 0, 0, 1, 0, 0, 0, 0]",1649,1217,432,132,49,0.10846343467543139,0.11342592592592593
"[0, 1, 1, 1, 0, 1, 0, 0, 0, 0, 0, 0, 0, 1, 0]",272,183,89,16,7,0.08743169398907104,0.07865168539325842
"[0, 0, 0, 0, 0, 0, 1, 0, 0, 0, 0, 1, 0, 0, 1]",1750,1326,424,128,45,0.09653092006033183,0.10613207547169812
"[1, 0, 0, 1, 1, 0, 1, 0, 0, 0, 1, 1, 1, 1, 0]",139,69,70,6,8,0.08695652173913043,0.11428571428571428
"[1, 1, 0, 0, 1, 0, 0, 1, 1, 0, 1, 0, 0, 0, 1]",124,61,63,7,4,0.11475409836065574,0.06349206349206349
"[0, 1, 1, 1, 0, 0, 0, 0, 1, 0, 0, 0, 0, 0, 1]",296,197,99,9,12,0.04568527918781726,0.12121212121212122
"[0, 1, 1, 0, 1, 1, 1, 0, 0, 0, 0, 1, 0, 0, 0]",159,89,70,7,8,0.07865168539325842,0.11428571428571428
"[0, 0, 1, 0, 1, 0, 0, 1, 0, 0, 1, 1, 0, 1, 1]",97,51,46,3,1,0.058823529411764705,0.021739130434782608
"[1, 1, 0, 1, 0, 0, 1, 0, 1, 0, 0, 1, 0, 0, 1]",105,53,52,4,5,0.07547169811320754,0.09615384615384616
"[1, 1, 0, 0, 0, 1, 0, 0, 0, 0, 1, 1, 1, 0, 0]",187,110,77,15,3,0.13636363636363635,0.03896103896103896
"[1, 0, 1, 1, 0, 1, 0, 0, 1, 1, 1, 1, 1, 1, 1]",844,259,585,33,45,0.1274131274131274,0.07692307692307693
"[1, 1, 1, 1, 0, 0, 0, 1, 1, 1, 1, 0, 0, 1, 0]",206,79,127,14,16,0.17721518987341772,0.12598425196850394
"[1, 1, 0, 1, 0, 0, 0, 1, 0, 1, 1, 1, 1, 0, 1]",138,55,83,3,9,0.05454545454545454,0.10843373493975904
"[1, 1, 1, 0, 1, 0, 0, 0, 1, 0, 1, 1, 1, 1, 0]",160,67,93,6,11,0.08955223880597014,0.11827956989247312
"[1, 1, 0, 0, 1, 0, 1, 0, 1, 1, 1, 0, 1, 0, 0]",103,43,60,6,8,0.13953488372093023,0.13333333333333333
"[1, 1, 0, 1, 1, 1, 1, 1, 0, 0, 1, 1, 0, 1, 0]",266,86,180,5,13,0.05813953488372093,0.07222222222222222
"[1, 1, 1, 1, 1, 0, 0, 0, 0, 0, 1, 0, 1, 0, 1]",143,53,90,3,7,0.05660377358490566,0.07777777777777778
"[0, 1, 1, 1, 0, 0, 1, 1, 1, 1, 1, 0, 0, 0, 0]",244,131,113,13,10,0.09923664122137404,0.08849557522123894
"[0, 1, 0, 0, 1, 1, 1, 0, 1, 1, 1, 1, 0, 0, 1]",179,83,96,5,11,0.060240963855421686,0.11458333333333333
"[0, 0, 0, 0, 0, 0, 1, 1, 0, 1, 0, 0, 1, 1, 1]",426,272,154,28,13,0.10294117647058823,0.08441558441558442
"[1, 0, 0, 0, 0, 0, 0, 1, 1, 0, 1, 0, 0, 1, 1]",272,118,154,9,16,0.07627118644067797,0.1038961038961039
"[1, 1, 0, 0, 0, 0, 0, 0, 1, 1, 0, 1, 0, 0, 1]",284,174,110,17,7,0.09770114942528736,0.06363636363636363
"[1, 1, 1, 0, 1, 1, 0, 0, 1, 1, 1, 0, 0, 1, 1]",317,82,235,9,23,0.10975609756097561,0.09787234042553192
"[1, 1, 1, 0, 1, 1, 1, 1, 1, 0, 1, 1, 1, 0, 1]",1550,353,1197,32,120,0.0906515580736544,0.10025062656641603
"[0, 0, 1, 1, 1, 0, 1, 1, 1, 1, 1, 1, 1, 0, 1]",530,152,378,16,32,0.10526315789473684,0.08465608465608465
"[1, 1, 1, 0, 1, 0, 0, 1, 0, 1, 0, 1, 0, 1, 1]",147,51,96,4,9,0.0784313725490196,0.09375
"[0, 1, 1, 1, 0, 1, 1, 1, 1, 1, 0, 1, 1, 1, 1]",1796,437,1359,43,115,0.09839816933638444,0.08462104488594555
"[1, 1, 1, 0, 1, 1, 1, 0, 1, 1, 1, 1, 1, 0, 1]",1527,328,1199,35,102,0.10670731707317073,0.08507089241034195
"[1, 1, 1, 0, 1, 1, 1, 0, 1, 1, 1, 0, 1, 1, 1]",1632,361,1271,37,121,0.10249307479224377,0.0952006294256491
"[1, 1, 1, 0, 0, 1, 1, 1, 1, 0, 0, 0, 1, 1, 1]",729,159,570,23,69,0.14465408805031446,0.12105263157894737
"[0, 1, 1, 1, 1, 1, 0, 1, 1, 1, 0, 0, 0, 0, 1]",237,110,127,8,10,0.07272727272727272,0.07874015748031496
"[1, 0, 1, 0, 1, 1, 1, 1, 1, 0, 1, 1, 1, 0, 0]",279,103,176,7,26,0.06796116504854369,0.14772727272727273
"[0, 0, 0, 0, 1, 0, 0, 1, 1, 0, 0, 0, 0, 1, 1]",754,530,224,51,23,0.09622641509433963,0.10267857142857142
"[0, 0, 1, 0, 1, 0, 0, 0, 0, 0, 0, 1, 1, 0, 0]",1017,734,283,71,21,0.09673024523160763,0.07420494699646643
"[0, 1, 0, 1, 0, 1, 1, 0, 0, 1, 1, 1, 1, 0, 0]",284,141,143,19,15,0.1347517730496454,0.1048951048951049
"[1, 0, 0, 1, 0, 1, 0, 1, 0, 1, 1, 0, 0, 1, 1]",157,67,90,9,10,0.13432835820895522,0.1111111111111111
"[1, 0, 1, 0, 0, 0, 1, 0, 0, 1, 0, 1, 1, 1, 0]",112,67,45,12,6,0.1791044776119403,0.13333333333333333
"[1, 0, 1, 1, 0, 0, 0, 1, 1, 1, 0, 1, 0, 0, 0]",110,52,58,3,5,0.057692307692307696,0.08620689655172414
"[0, 0, 0, 0, 0, 1, 1, 0, 1, 1, 0, 0, 1, 1, 0]",248,156,92,8,10,0.05128205128205128,0.10869565217391304
"[0, 0, 0, 1, 1, 1, 0, 0, 1, 0, 0, 1, 0, 1, 1]",160,94,66,10,7,0.10638297872340426,0.10606060606060606
"[0, 1, 1, 1, 0, 0, 0, 1, 1, 0, 0, 1, 0, 0, 1]",121,64,57,8,3,0.125,0.05263157894736842
"[0, 0, 0, 0, 1, 1, 1, 0, 0, 0, 1, 1, 0, 0, 1]",225,139,86,15,9,0.1079136690647482,0.10465116279069768
"[0, 1, 1, 0, 1, 1, 0, 1, 0, 0, 0, 0, 0, 0, 1]",186,126,60,17,7,0.1349206349206349,0.11666666666666667
"[0, 1, 0, 0, 1, 1, 0, 1, 1, 0, 1, 0, 0, 0, 0]",168,98,70,10,5,0.10204081632653061,0.07142857142857142
"[1, 1, 1, 1, 0, 0, 1, 0, 0, 1, 1, 0, 1, 1, 0]",180,83,97,9,11,0.10843373493975904,0.1134020618556701
"[0, 0, 1, 0, 0, 1, 0, 0, 1, 0, 1, 0, 0, 1, 1]",166,108,58,11,5,0.10185185185185185,0.08620689655172414
"[0, 1, 1, 0, 0, 1, 0, 0, 0, 1, 0, 1, 0, 0, 0]",254,170,84,22,10,0.12941176470588237,0.11904761904761904
"[0, 0, 1, 1, 0, 0, 1, 0, 0, 0, 1, 0, 1, 0, 0]",258,171,87,16,8,0.0935672514619883,0.09195402298850575
"[0, 0, 0, 0, 0, 0, 1, 0, 0, 0, 0, 0, 1, 1, 0]",2561,2018,543,189,47,0.09365708622398414,0.0865561694290976
"[0, 1, 1, 0, 0, 0, 1, 0, 1, 0, 0, 1, 1, 1, 1]",189,123,66,15,10,0.12195121951219512,0.15151515151515152
"[0, 1, 0, 1, 0, 0, 1, 1, 1, 1, 1, 0, 0, 0, 0]",199,101,98,10,7,0.09900990099009901,0.07142857142857142
"[1, 0, 1, 1, 1, 1, 0, 1, 0, 1, 0, 0, 1, 1, 1]",262,86,176,11,13,0.12790697674418605,0.07386363636363637
"[0, 1, 1, 0, 1, 1, 1, 1, 0, 1, 0, 1, 0, 0, 1]",148,64,84,5,4,0.078125,0.047619047619047616
"[0, 1, 0, 0, 1, 1, 1, 0, 0, 0, 0, 0, 0, 0, 1]",277,194,83,18,9,0.09278350515463918,0.10843373493975904
"[0, 1, 1, 0, 0, 1, 1, 0, 0, 1, 1, 1, 1, 1, 1]",2432,1766,666,155,71,0.08776896942242356,0.1066066066066066
"[0, 1, 0, 0, 0, 1, 1, 0, 0, 1, 1, 0, 0, 1, 1]",439,241,198,17,17,0.07053941908713693,0.08585858585858586
"[1, 1, 1, 0, 0, 1, 1, 1, 1, 0, 0, 1, 0, 0, 1]",319,88,231,6,22,0.06818181818181818,0.09523809523809523
"[0, 1, 0, 0, 1, 0, 0, 0, 1, 0, 0, 0, 0, 0, 1]",566,424,142,36,16,0.08490566037735849,0.11267605633802817
"[0, 0, 0, 1, 0, 0, 1, 0, 0, 0, 1, 0, 0, 0, 0]",1642,1267,375,119,42,0.09392265193370165,0.112
"[0, 0, 0, 0, 1, 0, 0, 1, 1, 1, 1, 1, 1, 1, 1]",492,245,247,21,27,0.08571428571428572,0.10931174089068826
"[1, 0, 0, 1, 1, 0, 1, 1, 1, 1, 0, 1, 0, 0, 0]",119,52,67,8,3,0.15384615384615385,0.04477611940298507
"[1, 0, 1, 0, 1, 1, 1, 1, 1, 1, 0, 1, 1, 1, 0]",524,160,364,11,26,0.06875,0.07142857142857142
"[0, 0, 1, 0, 1, 0, 1, 1, 1, 0, 1, 0, 0, 1, 1]",128,67,61,7,7,0.1044776119402985,0.11475409836065574
"[1, 0, 0, 0, 1, 1, 1, 1, 1, 0, 1, 1, 0, 1, 0]",145,62,83,2,9,0.03225806451612903,0.10843373493975904
"[1, 0, 0, 0, 1, 1, 1, 1, 1, 0, 1, 0, 1, 1, 1]",290,109,181,10,17,0.09174311926605505,0.09392265193370165
"[0, 0, 1, 0, 0, 1, 0, 0, 0, 1, 0, 1, 0, 0, 0]",530,375,155,33,14,0.088,0.09032258064516129
"[1, 0, 0, 0, 0, 1, 0, 0, 1, 0, 0, 0, 1, 0, 1]",215,127,88,14,6,0.11023622047244094,0.06818181818181818
"[1, 1, 0, 0, 0, 1, 0, 0, 0, 1, 0, 0, 0, 0, 1]",283,174,109,15,8,0.08620689655172414,0.07339449541284404
"[1, 1, 0, 1, 0, 0, 0, 1, 0, 0, 0, 1, 0, 0, 0]",234,147,87,19,6,0.1292517006802721,0.06896551724137931
"[0, 1, 0, 1, 1, 0, 1, 0, 0, 0, 1, 0, 0, 0, 1]",171,100,71,7,9,0.07,0.1267605633802817
"[1, 1, 1, 0, 1, 1, 1, 0, 1, 1, 1, 1, 0, 0, 1]",685,183,502,17,49,0.09289617486338798,0.09760956175298804
"[1, 1, 0, 0, 1, 1, 1, 1, 1, 1, 1, 1, 1, 0, 1]",2857,714,2143,60,203,0.08403361344537816,0.09472701819878675
"[1, 0, 1, 1, 1, 1, 1, 1, 0, 1, 1, 1, 0, 1, 0]",476,134,342,16,32,0.11940298507462686,0.0935672514619883
"[1, 1, 0, 0, 1, 1, 1, 1, 1, 0, 1, 0, 1, 0, 1]",250,76,174,5,20,0.06578947368421052,0.11494252873563218
"[0, 0, 0, 1, 1, 0, 0, 1, 1, 1, 1, 1, 0, 1, 0]",202,133,69,17,10,0.12781954887218044,0.14492753623188406
"[0, 1, 1, 0, 0, 1, 1, 1, 1, 1, 0, 0, 1, 0, 0]",162,93,69,8,9,0.08602150537634409,0.13043478260869565
"[0, 0, 1, 1, 0, 0, 0, 1, 0, 0, 0, 0, 1, 0, 0]",632,443,189,48,20,0.10835214446952596,0.10582010582010581
"[1, 1, 0, 1, 0, 0, 1, 1, 0, 0, 0, 1, 0, 0, 0]",158,87,71,6,7,0.06896551724137931,0.09859154929577464
"[0, 1, 1, 0, 1, 0, 0, 1, 1, 0, 0, 0, 1, 0, 0]",156,91,65,11,8,0.12087912087912088,0.12307692307692308
"[0, 0, 0, 1, 1, 0, 1, 0, 0, 1, 1, 0, 0, 0, 1]",155,93,62,15,3,0.16129032258064516,0.04838709677419355
"[0, 0, 1, 1, 1, 1, 0, 0, 1, 1, 1, 1, 0, 0, 0]",1553,788,765,82,77,0.10406091370558376,0.10065359477124183
"[1, 0, 1, 1, 1, 1, 0, 1, 1, 1, 1, 1, 0, 0, 0]",317,113,204,6,19,0.05309734513274336,0.09313725490196079
"[0, 1, 1, 1, 1, 0, 0, 1, 0, 1, 0, 0, 0, 1, 1]",176,108,68,12,6,0.1111111111111111,0.08823529411764706
"[0, 1, 0, 1, 1, 1, 1, 0, 0, 1, 0, 1, 0, 0, 0]",107,52,55,11,9,0.21153846153846154,0.16363636363636364
"[0, 0, 1, 0, 1, 1, 1, 1, 0, 0, 1, 0, 1, 0, 0]",106,51,55,2,7,0.0392156862745098,0.12727272727272726
"[0, 1, 1, 1, 0, 0, 0, 1, 1, 1, 0, 0, 0, 0, 0]",275,189,86,15,7,0.07936507936507936,0.08139534883720931
"[1, 1, 0, 0, 0, 1, 0, 0, 0, 1, 1, 1, 1, 0, 1]",124,64,60,2,8,0.03125,0.13333333333333333
"[1, 0, 1, 0, 1, 1, 1, 0, 0, 0, 0, 0, 0, 1, 1]",304,145,159,12,16,0.08275862068965517,0.10062893081761007
"[1, 1, 0, 0, 1, 0, 1, 0, 1, 1, 1, 0, 0, 1, 1]",204,87,117,5,12,0.05747126436781609,0.10256410256410256
"[1, 0, 0, 0, 1, 1, 1, 1, 1, 0, 1, 1, 1, 1, 0]",234,76,158,10,13,0.13157894736842105,0.08227848101265822
"[0, 1, 0, 0, 0, 1, 0, 0, 1, 0, 0, 0, 1, 1, 1]",190,118,72,11,3,0.09322033898305085,0.041666666666666664
"[0, 0, 0, 1, 0, 0, 0, 1, 0, 0, 1, 0, 0, 0, 1]",530,380,150,39,15,0.10263157894736842,0.1
"[0, 0, 0, 0, 0, 0, 1, 1, 0, 0, 1, 1, 0, 1, 1]",576,369,207,38,23,0.10298102981029811,0.1111111111111111
"[0, 0, 1, 0, 1, 1, 1, 1, 1, 1, 1, 1, 1, 0, 1]",576,173,403,24,41,0.13872832369942195,0.10173697270471464
"[0, 0, 1, 1, 0, 0, 0, 0, 1, 1, 0, 0, 1, 1, 0]",1888,1112,776,99,76,0.08902877697841727,0.0979381443298969
"[1, 0, 0, 0, 0, 1, 0, 1, 0, 0, 0, 1, 1, 0, 0]",313,181,132,6,17,0.03314917127071823,0.12878787878787878
"[1, 0, 1, 1, 0, 0, 1, 0, 1, 1, 1, 1, 0, 0, 1]",193,84,109,9,12,0.10714285714285714,0.11009174311926606
"[1, 0, 0, 0, 0, 0, 0, 0, 1, 1, 0, 0, 1, 0, 1]",320,198,122,14,11,0.0707070707070707,0.09016393442622951
"[0, 1, 0, 0, 0, 0, 0, 1, 0, 0, 0, 0, 1, 0, 0]",1508,1144,364,116,35,0.10139860139860139,0.09615384615384616
"[0, 1, 1, 0, 1, 1, 1, 0, 1, 1, 0, 0, 1, 0, 1]",133,56,77,8,8,0.14285714285714285,0.1038961038961039
"[1, 1, 0, 1, 1, 0, 1, 1, 1, 0, 1, 1, 0, 0, 1]",276,100,176,10,10,0.1,0.056818181818181816
"[1, 1, 1, 1, 0, 1, 1, 0, 0, 1, 0, 0, 1, 1, 1]",338,116,222,10,15,0.08620689655172414,0.06756756756756757
"[1, 1, 0, 0, 1, 0, 1, 0, 0, 0, 0, 1, 1, 1, 0]",122,69,53,4,8,0.057971014492753624,0.1509433962264151
"[0, 1, 0, 1, 1, 0, 0, 1, 0, 1, 0, 0, 0, 0, 1]",132,71,61,5,2,0.07042253521126761,0.03278688524590164
"[0, 1, 1, 0, 1, 0, 1, 1, 0, 0, 1, 0, 1, 0, 0]",116,63,53,8,7,0.12698412698412698,0.1320754716981132
"[0, 1, 1, 1, 0, 1, 1, 1, 1, 0, 1, 1, 0, 1, 0]",214,80,134,7,10,0.0875,0.07462686567164178
"[0, 1, 1, 0, 1, 1, 0, 1, 1, 1, 0, 1, 1, 1, 1]",553,178,375,15,44,0.08426966292134831,0.11733333333333333
"[0, 0, 0, 0, 0, 0, 0, 1, 0, 1, 0, 1, 0, 0, 0]",1739,1358,381,127,44,0.093519882179676,0.11548556430446194
"[1, 1, 1, 0, 0, 0, 0, 0, 0, 0, 0, 0, 1, 0, 1]",466,196,270,18,23,0.09183673469387756,0.08518518518518518
"[1, 1, 1, 0, 0, 1, 0, 1, 1, 1, 0, 0, 0, 0, 0]",187,88,99,10,9,0.11363636363636363,0.09090909090909091
"[0, 1, 0, 1, 0, 0, 0, 1, 1, 0, 0, 1, 1, 0, 0]",326,206,120,20,12,0.0970873786407767,0.1
"[1, 1, 0, 0, 0, 0, 0, 0, 0, 0, 0, 1, 0, 1, 1]",676,449,227,46,17,0.10244988864142539,0.07488986784140969
"[1, 1, 0, 1, 1, 1, 1, 1, 0, 1, 1, 1, 0, 0, 1]",653,176,477,12,41,0.06818181818181818,0.0859538784067086
"[0, 0, 0, 0, 1, 1, 1, 1, 1, 1, 1, 0, 0, 0, 0]",456,261,195,24,17,0.09195402298850575,0.08717948717948718
"[1, 0, 0, 1, 0, 0, 1, 0, 0, 1, 1, 0, 0, 0, 0]",356,214,142,20,12,0.09345794392523364,0.08450704225352113
"[0, 1, 0, 0, 1, 1, 0, 1, 1, 1, 0, 1, 0, 1, 0]",104,44,60,3,3,0.06818181818181818,0.05
"[1, 1, 0, 0, 1, 0, 1, 1, 1, 0, 0, 1, 0, 1, 0]",132,70,62,5,3,0.07142857142857142,0.04838709677419355
"[0, 1, 1, 1, 0, 1, 1, 1, 0, 0, 0, 0, 0, 1, 1]",168,90,78,12,7,0.13333333333333333,0.08974358974358974
"[1, 0, 1, 1, 1, 0, 0, 1, 1, 0, 0, 0, 0, 0, 0]",460,260,200,28,13,0.1076923076923077,0.065
"[1, 0, 1, 1, 0, 1, 1, 1, 1, 1, 0, 0, 1, 0, 0]",149,50,99,7,12,0.14,0.12121212121212122
"[0, 1, 0, 1, 1, 0, 1, 1, 1, 1, 1, 0, 0, 1, 0]",122,49,73,7,7,0.14285714285714285,0.0958904109589041
"[1, 0, 0, 0, 1, 1, 1, 1, 0, 1, 0, 1, 1, 1, 1]",297,116,181,12,14,0.10344827586206896,0.07734806629834254
"[1, 1, 1, 0, 0, 0, 1, 1, 1, 0, 1, 0, 0, 0, 1]",138,65,73,5,11,0.07692307692307693,0.1506849315068493
"[0, 0, 0, 1, 0, 0, 0, 1, 0, 1, 1, 0, 0, 0, 0]",644,461,183,43,15,0.09327548806941431,0.08196721311475409
"[0, 0, 1, 1, 0, 1, 1, 0, 0, 1, 1, 1, 0, 1, 0]",118,54,64,7,7,0.12962962962962962,0.109375
"[0, 0, 1, 1, 1, 1, 0, 1, 0, 0, 0, 0, 1, 1, 1]",264,129,135,16,14,0.12403100775193798,0.1037037037037037
"[1, 0, 0, 0, 0, 1, 1, 1, 1, 0, 1, 0, 0, 0, 0]",236,118,118,11,20,0.09322033898305085,0.1694915254237288
"[0, 0, 0, 1, 0, 0, 0, 0, 0, 1, 1, 0, 0, 0, 0]",2928,2298,630,224,57,0.09747606614447346,0.09047619047619047
"[0, 0, 0, 0, 0, 1, 0, 1, 1, 1, 1, 1, 1, 0, 1]",139,82,57,8,3,0.0975609756097561,0.05263157894736842
"[0, 0, 1, 1, 0, 0, 0, 1, 1, 0, 0, 0, 1, 0, 1]",167,105,62,8,6,0.0761904761904762,0.0967741935483871
"[1, 0, 0, 0, 0, 0, 1, 1, 1, 1, 0, 1, 1, 1, 1]",260,89,171,9,11,0.10112359550561797,0.06432748538011696
"[1, 1, 1, 0, 1, 1, 1, 0, 1, 0, 0, 1, 1, 1, 0]",234,80,154,9,13,0.1125,0.08441558441558442
"[1, 1, 1, 1, 0, 1, 1, 1, 1, 1, 0, 0, 0, 1, 1]",701,201,500,19,40,0.0945273631840796,0.08
"[0, 1, 1, 1, 0, 0, 0, 0, 0, 0, 1, 1, 1, 0, 0]",275,187,88,11,5,0.058823529411764705,0.056818181818181816
"[0, 0, 1, 1, 0, 0, 1, 0, 0, 1, 1, 0, 0, 1, 1]",256,144,112,11,11,0.0763888888888889,0.09821428571428571
"[1, 1, 0, 0, 1, 1, 0, 0, 1, 0, 0, 1, 1, 0, 0]",182,98,84,7,10,0.07142857142857142,0.11904761904761904
"[0, 1, 0, 0, 0, 1, 0, 1, 0, 0, 0, 1, 0, 1, 1]",172,105,67,11,6,0.10476190476190476,0.08955223880597014
"[0, 0, 1, 0, 0, 0, 0, 0, 1, 0, 1, 0, 0, 0, 1]",548,394,154,38,14,0.09644670050761421,0.09090909090909091
"[0, 1, 1, 0, 0, 1, 0, 0, 0, 0, 0, 1, 0, 1, 0]",234,149,85,14,2,0.09395973154362416,0.023529411764705882
"[0, 0, 0, 1, 0, 1, 1, 0, 1, 1, 0, 0, 1, 1, 1]",159,66,93,4,11,0.06060606060606061,0.11827956989247312
"[0, 1, 1, 0, 0, 1, 1, 1, 1, 1, 0, 0, 0, 0, 1]",278,161,117,12,12,0.07453416149068323,0.10256410256410256
"[1, 1, 0, 1, 1, 0, 0, 1, 1, 1, 1, 1, 0, 0, 0]",238,87,151,12,20,0.13793103448275862,0.13245033112582782
"[1, 0, 1, 0, 1, 1, 1, 0, 0, 0, 1, 1, 0, 0, 1]",130,59,71,4,5,0.06779661016949153,0.07042253521126761
"[1, 1, 1, 1, 1, 1, 1, 0, 0, 0, 1, 0, 0, 1, 0]",186,68,118,5,15,0.07352941176470588,0.1271186440677966
"[1, 1, 0, 1, 1, 1, 0, 0, 1, 1, 0, 1, 1, 1, 0]",242,84,158,6,16,0.07142857142857142,0.10126582278481013
"[1, 1, 1, 1, 1, 1, 1, 1, 1, 1, 0, 0, 1, 0, 0]",1050,290,760,24,76,0.08275862068965517,0.1
"[0, 0, 1, 1, 1, 0, 1, 1, 1, 0, 1, 0, 1, 1, 0]",150,83,67,9,6,0.10843373493975904,0.08955223880597014
"[0, 0, 0, 0, 0, 0, 1, 0, 1, 1, 0, 1, 0, 1, 1]",196,117,79,12,9,0.10256410256410256,0.11392405063291139
"[1, 1, 1, 1, 1, 1, 1, 0, 0, 0, 0, 0, 1, 0, 1]",337,96,241,10,21,0.10416666666666667,0.08713692946058091
"[0, 1, 1, 1, 1, 0, 0, 0, 0, 0, 0, 0, 1, 1, 0]",403,297,106,25,12,0.08417508417508418,0.11320754716981132
"[1, 0, 0, 1, 0, 1, 0, 0, 0, 1, 0, 0, 1, 1, 0]",156,87,69,9,5,0.10344827586206896,0.07246376811594203
"[1, 1, 1, 1, 1, 1, 0, 1, 1, 0, 0, 0, 1, 1, 0]",303,117,186,9,19,0.07692307692307693,0.10215053763440861
"[1, 1, 0, 0, 1, 0, 0, 0, 0, 1, 1, 1, 1, 1, 1]",464,193,271,15,20,0.07772020725388601,0.07380073800738007
"[1, 0, 1, 0, 1, 0, 0, 0, 0, 1, 1, 0, 0, 1, 0]",153,94,59,9,8,0.09574468085106383,0.13559322033898305
"[0, 0, 0, 1, 0, 1, 1, 1, 0, 1, 1, 0, 1, 0, 1]",109,55,54,7,8,0.12727272727272726,0.14814814814814814
"[0, 1, 1, 1, 0, 0, 0, 0, 1, 0, 1, 1, 1, 0, 1]",124,60,64,9,7,0.15,0.109375
"[1, 1, 1, 0, 1, 1, 1, 0, 0, 0, 0, 1, 0, 1, 1]",160,63,97,8,9,0.12698412698412698,0.09278350515463918
"[0, 0, 1, 1, 1, 1, 0, 1, 0, 0, 1, 1, 1, 1, 1]",445,171,274,14,23,0.08187134502923976,0.08394160583941605
"[1, 1, 1, 1, 0, 0, 0, 1, 1, 1, 1, 0, 1, 0, 0]",185,70,115,6,6,0.08571428571428572,0.05217391304347826
"[1, 0, 1, 0, 0, 1, 0, 0, 0, 0, 0, 0, 0, 0, 0]",2174,1584,590,142,59,0.08964646464646464,0.1
"[1, 0, 1, 1, 1, 1, 0, 0, 0, 0, 0, 0, 1, 1, 0]",395,213,182,12,25,0.056338028169014086,0.13736263736263737
"[0, 1, 0, 1, 1, 1, 1, 0, 0, 0, 0, 0, 0, 1, 1]",442,213,229,21,20,0.09859154929577464,0.08733624454148471
"[0, 1, 0, 1, 0, 1, 0, 1, 1, 1, 1, 0, 0, 0, 0]",192,100,92,9,8,0.09,0.08695652173913043
"[0, 1, 0, 1, 1, 0, 1, 0, 1, 0, 1, 0, 1, 1, 1]",156,59,97,4,11,0.06779661016949153,0.1134020618556701
"[1, 1, 1, 0, 0, 0, 1, 0, 1, 0, 1, 1, 0, 1, 0]",99,46,53,4,5,0.08695652173913043,0.09433962264150944
"[0, 1, 0, 1, 1, 1, 0, 0, 1, 1, 1, 0, 0, 0, 1]",122,54,68,5,6,0.09259259259259259,0.08823529411764706
"[1, 1, 1, 0, 1, 0, 0, 0, 1, 0, 1, 0, 1, 1, 1]",142,65,77,6,9,0.09230769230769231,0.11688311688311688
"[0, 1, 0, 1, 0, 1, 1, 1, 1, 0, 0, 1, 0, 1, 0]",116,60,56,5,5,0.08333333333333333,0.08928571428571429
"[1, 1, 0, 1, 1, 0, 0, 0, 0, 1, 1, 1, 1, 0, 0]",436,218,218,22,21,0.10091743119266056,0.0963302752293578
"[1, 0, 1, 0, 0, 0, 1, 1, 0, 0, 0, 0, 0, 0, 1]",489,272,217,29,20,0.10661764705882353,0.09216589861751152
"[0, 1, 1, 0, 1, 0, 0, 0, 1, 1, 0, 0, 0, 0, 0]",436,287,149,19,9,0.06620209059233449,0.06040268456375839
"[0, 0, 1, 1, 0, 1, 0, 0, 0, 1, 1, 0, 0, 0, 0]",439,261,178,22,25,0.0842911877394636,0.1404494382022472
"[1, 1, 0, 1, 1, 0, 1, 1, 0, 0, 1, 1, 0, 1, 1]",273,106,167,13,12,0.12264150943396226,0.0718562874251497
"[0, 0, 0, 0, 1, 1, 1, 1, 1, 0, 1, 0, 1, 1, 0]",159,81,78,11,6,0.13580246913580246,0.07692307692307693
"[1, 1, 0, 0, 1, 0, 1, 1, 1, 1, 0, 1, 0, 0, 0]",152,59,93,3,11,0.05084745762711865,0.11827956989247312
"[1, 1, 1, 0, 1, 1, 0, 0, 0, 1, 1, 0, 0, 1, 0]",117,57,60,6,5,0.10526315789473684,0.08333333333333333
"[0, 0, 0, 0, 1, 1, 1, 0, 1, 1, 1, 1, 0, 0, 1]",211,100,111,9,13,0.09,0.11711711711711711
"[1, 1, 0, 1, 1, 0, 0, 0, 0, 0, 1, 0, 0, 1, 1]",141,77,64,9,5,0.11688311688311688,0.078125
"[0, 1, 1, 0, 1, 1, 0, 0, 0, 0, 0, 1, 0, 0, 1]",151,94,57,6,5,0.06382978723404255,0.08771929824561403
"[0, 0, 1, 0, 1, 0, 1, 1, 1, 1, 0, 1, 1, 1, 1]",314,116,198,11,17,0.09482758620689655,0.08585858585858586
"[0, 0, 0, 0, 0, 1, 1, 1, 0, 1, 1, 0, 0, 1, 1]",234,151,83,18,5,0.11920529801324503,0.060240963855421686
"[1, 1, 0, 1, 0, 0, 0, 1, 1, 0, 0, 0, 1, 1, 1]",138,61,77,9,7,0.14754098360655737,0.09090909090909091
"[1, 1, 1, 0, 1, 0, 0, 0, 1, 1, 0, 0, 0, 1, 1]",138,60,78,4,8,0.06666666666666667,0.10256410256410256
"[1, 1, 1, 1, 1, 1, 1, 1, 1, 0, 1, 0, 0, 0, 1]",817,194,623,16,57,0.08247422680412371,0.09149277688603531
"[1, 1, 0, 0, 0, 1, 1, 1, 1, 1, 1, 1, 0, 1, 1]",725,209,516,17,42,0.08133971291866028,0.08139534883720931
"[1, 0, 0, 0, 0, 1, 1, 0, 0, 1, 1, 1, 0, 1, 1]",326,86,240,5,15,0.05813953488372093,0.0625
"[0, 1, 1, 1, 1, 0, 1, 1, 0, 0, 1, 1, 1, 1, 0]",384,157,227,19,26,0.12101910828025478,0.1145374449339207
"[0, 1, 0, 1, 1, 1, 1, 0, 1, 1, 0, 0, 1, 1, 1]",345,130,215,3,26,0.023076923076923078,0.12093023255813953
"[0, 0, 1, 1, 1, 0, 0, 1, 1, 1, 0, 0, 0, 1, 0]",132,65,67,6,2,0.09230769230769231,0.029850746268656716
"[0, 0, 0, 0, 1, 1, 0, 1, 0, 0, 0, 1, 0, 0, 1]",264,166,98,24,13,0.14457831325301204,0.1326530612244898
"[0, 0, 0, 0, 0, 1, 1, 1, 1, 1, 0, 0, 1, 1, 1]",445,303,142,26,17,0.0858085808580858,0.11971830985915492
"[1, 0, 0, 0, 0, 0, 0, 1, 1, 1, 1, 1, 0, 0, 1]",309,100,209,6,15,0.06,0.07177033492822966
"[1, 1, 1, 0, 0, 1, 1, 0, 0, 0, 0, 0, 0, 0, 1]",582,178,404,17,41,0.09550561797752809,0.10148514851485149
"[0, 0, 0, 0, 1, 1, 0, 0, 1, 1, 1, 1, 1, 1, 0]",1541,782,759,78,80,0.09974424552429667,0.10540184453227931
"[1, 0, 0, 1, 1, 0, 0, 0, 0, 1, 1, 0, 1, 1, 0]",229,60,169,6,12,0.1,0.07100591715976332
"[1, 0, 1, 0, 0, 1, 1, 0, 0, 0, 0, 1, 1, 0, 1]",134,73,61,8,9,0.1095890410958904,0.14754098360655737
"[1, 0, 0, 0, 0, 1, 1, 1, 0, 0, 0, 0, 1, 1, 1]",283,124,159,15,15,0.12096774193548387,0.09433962264150944
"[0, 0, 1, 1, 0, 0, 0, 0, 1, 1, 1, 0, 0, 0, 0]",497,330,167,33,19,0.1,0.11377245508982035
"[0, 0, 1, 0, 0, 0, 0, 0, 0, 1, 0, 1, 0, 1, 1]",304,211,93,21,10,0.0995260663507109,0.10752688172043011
"[1, 1, 1, 0, 0, 0, 1, 0, 0, 1, 1, 0, 0, 0, 1]",124,64,60,5,7,0.078125,0.11666666666666667
"[0, 0, 0, 0, 1, 1, 1, 0, 0, 0, 1, 0, 0, 1, 1]",204,130,74,10,6,0.07692307692307693,0.08108108108108109
"[1, 0, 0, 0, 1, 0, 0, 0, 0, 0, 1, 1, 1, 0, 0]",282,188,94,16,9,0.0851063829787234,0.09574468085106383
"[1, 0, 0, 1, 1, 0, 0, 0, 1, 0, 0, 0, 0, 0, 1]",280,150,130,14,15,0.09333333333333334,0.11538461538461539
"[0, 1, 0, 1, 0, 1, 0, 1, 1, 1, 1, 1, 1, 1, 0]",285,101,184,11,20,0.10891089108910891,0.10869565217391304
"[0, 1, 1, 0, 0, 1, 0, 1, 0, 1, 0, 1, 1, 1, 1]",193,95,98,10,7,0.10526315789473684,0.07142857142857142
"[1, 0, 0, 1, 1, 1, 1, 0, 1, 1, 1, 0, 1, 0, 1]",250,65,185,3,22,0.046153846153846156,0.11891891891891893
"[0, 0, 0, 0, 0, 0, 0, 1, 1, 0, 0, 0, 0, 1, 0]",2768,2316,452,221,31,0.09542314335060449,0.06858407079646017
"[1, 1, 0, 0, 1, 1, 1, 1, 1, 0, 1, 0, 1, 1, 1]",924,282,642,29,65,0.10283687943262411,0.10124610591900311
"[1, 1, 0, 1, 1, 0, 1, 0, 1, 1, 1, 1, 1, 0, 0]",349,111,238,17,17,0.15315315315315314,0.07142857142857142
"[1, 1, 1, 1, 0, 1, 1, 0, 1, 1, 0, 1, 0, 1, 1]",506,134,372,9,42,0.06716417910447761,0.11290322580645161
"[0, 1, 1, 1, 1, 1, 1, 0, 1, 1, 0, 1, 1, 0, 1]",498,160,338,16,34,0.1,0.10059171597633136
"[0, 0, 0, 1, 1, 1, 0, 0, 0, 0, 1, 1, 1, 1, 0]",319,177,142,17,10,0.096045197740113,0.07042253521126761
"[1, 1, 1, 1, 1, 0, 0, 0, 0, 1, 0, 0, 0, 0, 1]",169,70,99,5,7,0.07142857142857142,0.0707070707070707
"[0, 0, 0, 1, 1, 1, 0, 0, 1, 1, 1, 1, 1, 1, 1]",636,286,350,19,39,0.06643356643356643,0.11142857142857143
"[1, 0, 1, 0, 0, 1, 0, 1, 1, 0, 0, 0, 0, 0, 0]",371,246,125,25,12,0.1016260162601626,0.096
"[1, 1, 1, 1, 0, 1, 1, 0, 1, 0, 0, 1, 0, 1, 1]",267,96,171,7,17,0.07291666666666667,0.09941520467836257
"[0, 1, 1, 1, 0, 1, 1, 0, 1, 0, 1, 1, 0, 1, 0]",141,52,89,2,4,0.038461538461538464,0.0449438202247191
"[1, 0, 0, 1, 0, 0, 0, 0, 0, 0, 1, 1, 1, 0, 0]",329,220,109,15,7,0.06818181818181818,0.06422018348623854
"[0, 1, 0, 1, 0, 1, 0, 0, 1, 0, 0, 0, 0, 0, 0]",600,428,172,39,14,0.0911214953271028,0.08139534883720931
"[1, 1, 0, 0, 0, 0, 1, 0, 0, 1, 1, 0, 0, 0, 1]",183,102,81,10,4,0.09803921568627451,0.04938271604938271
"[1, 1, 0, 1, 1, 0, 1, 1, 0, 0, 1, 0, 0, 0, 0]",140,60,80,6,10,0.1,0.125
"[1, 1, 1, 1, 1, 1, 0, 1, 1, 0, 1, 1, 0, 0, 1]",728,230,498,22,49,0.09565217391304348,0.09839357429718876
"[0, 0, 0, 0, 0, 1, 1, 0, 0, 0, 0, 1, 0, 1, 1]",614,478,136,43,11,0.0899581589958159,0.08088235294117647
"[0, 0, 0, 0, 1, 0, 1, 1, 1, 0, 0, 1, 0, 1, 1]",124,67,57,7,5,0.1044776119402985,0.08771929824561403
"[1, 0, 0, 0, 1, 1, 0, 0, 0, 0, 1, 1, 1, 1, 1]",539,274,265,37,31,0.13503649635036497,0.1169811320754717
"[1, 0, 1, 1, 1, 1, 0, 0, 0, 1, 1, 0, 0, 0, 0]",226,122,104,11,9,0.09016393442622951,0.08653846153846154
"[1, 1, 0, 0, 1, 0, 1, 1, 1, 1, 0, 0, 0, 1, 1]",192,71,121,5,10,0.07042253521126761,0.08264462809917356
"[0, 1, 0, 1, 1, 1, 1, 0, 0, 1, 0, 1, 1, 1, 1]",271,109,162,6,21,0.05504587155963303,0.12962962962962962
"[1, 0, 1, 0, 0, 1, 0, 1, 0, 1, 1, 1, 1, 0, 0]",143,75,68,9,5,0.12,0.07352941176470588
"[0, 1, 0, 0, 0, 1, 1, 1, 1, 1, 0, 1, 0, 0, 1]",127,66,61,5,7,0.07575757575757576,0.11475409836065574
"[1, 0, 1, 0, 0, 0, 1, 1, 1, 1, 1, 0, 1, 0, 0]",112,58,54,5,6,0.08620689655172414,0.1111111111111111
"[0, 0, 0, 1, 1, 0, 0, 0, 0, 0, 1, 0, 0, 0, 1]",776,595,181,73,9,0.1226890756302521,0.049723756906077346
"[0, 1, 1, 1, 1, 1, 0, 0, 0, 0, 1, 0, 0, 0, 1]",143,72,71,8,7,0.1111111111111111,0.09859154929577464
"[0, 0, 0, 1, 0, 1, 1, 1, 1, 1, 0, 0, 0, 0, 1]",221,115,106,10,16,0.08695652173913043,0.1509433962264151
"[0, 0, 1, 0, 1, 1, 0, 1, 1, 0, 1, 1, 1, 0, 0]",115,45,70,3,7,0.06666666666666667,0.1
"[0, 0, 0, 1, 1, 0, 1, 1, 0, 1, 1, 1, 1, 1, 1]",366,166,200,19,23,0.1144578313253012,0.115
"[0, 0, 0, 0, 1, 1, 1, 1, 1, 0, 1, 0, 1, 0, 1]",156,76,80,7,9,0.09210526315789473,0.1125
"[0, 1, 0, 0, 1, 1, 0, 0, 0, 0, 0, 1, 1, 0, 0]",363,230,133,22,8,0.09565217391304348,0.06015037593984962
"[0, 1, 1, 0, 0, 0, 0, 1, 0, 1, 0, 1, 0, 1, 0]",151,107,44,10,1,0.09345794392523364,0.022727272727272728
"[0, 1, 0, 0, 1, 0, 0, 1, 0, 1, 1, 1, 0, 1, 1]",106,48,58,4,3,0.08333333333333333,0.05172413793103448
"[1, 1, 0, 1, 1, 0, 0, 0, 0, 1, 1, 1, 1, 0, 1]",216,75,141,7,14,0.09333333333333334,0.09929078014184398
"[1, 0, 1, 1, 0, 1, 1, 0, 1, 0, 1, 1, 1, 0, 1]",208,81,127,9,12,0.1111111111111111,0.09448818897637795
"[1, 1, 0, 1, 1, 0, 0, 1, 1, 0, 0, 1, 1, 1, 1]",809,292,517,24,44,0.0821917808219178,0.0851063829787234
"[0, 1, 1, 0, 0, 1, 1, 1, 0, 0, 1, 0, 0, 0, 0]",223,141,82,13,6,0.09219858156028368,0.07317073170731707
"[0, 1, 0, 0, 1, 1, 0, 0, 1, 1, 1, 0, 0, 1, 0]",105,53,52,6,2,0.11320754716981132,0.038461538461538464
"[0, 1, 1, 1, 0, 0, 1, 1, 1, 1, 1, 0, 0, 1, 0]",152,75,77,9,10,0.12,0.12987012987012986
"[0, 1, 0, 1, 1, 0, 0, 1, 1, 1, 0, 0, 1, 1, 1]",234,100,134,7,17,0.07,0.12686567164179105
"[1, 0, 1, 0, 0, 0, 1, 0, 1, 1, 0, 0, 1, 1, 1]",182,97,85,9,9,0.09278350515463918,0.10588235294117647
"[0, 1, 1, 1, 0, 1, 1, 1, 0, 1, 1, 1, 0, 1, 0]",238,96,142,9,11,0.09375,0.07746478873239436
"[1, 0, 1, 1, 1, 1, 0, 1, 1, 1, 0, 1, 1, 1, 0]",490,129,361,14,34,0.10852713178294573,0.09418282548476455
"[0, 1, 0, 1, 1, 1, 0, 1, 1, 1, 1, 0, 1, 0, 1]",230,77,153,8,10,0.1038961038961039,0.06535947712418301
"[1, 1, 0, 1, 1, 1, 0, 1, 1, 1, 0, 1, 0, 1, 1]",549,159,390,12,36,0.07547169811320754,0.09230769230769231
"[1, 0, 0, 1, 1, 0, 0, 0, 0, 1, 0, 0, 0, 1, 0]",281,151,130,13,16,0.08609271523178808,0.12307692307692308
"[0, 0, 1, 0, 1, 1, 0, 0, 1, 1, 0, 0, 1, 0, 1]",126,64,62,4,11,0.0625,0.1774193548387097
"[0, 0, 0, 1, 0, 1, 1, 0, 0, 1, 1, 0, 0, 1, 0]",146,71,75,6,6,0.08450704225352113,0.08
"[0, 0, 0, 1, 1, 0, 1, 0, 1, 0, 1, 0, 0, 0, 1]",153,97,56,7,6,0.07216494845360824,0.10714285714285714
"[1, 1, 0, 1, 0, 0, 1, 1, 1, 0, 0, 0, 0, 0, 0]",251,130,121,15,8,0.11538461538461539,0.06611570247933884
"[0, 0, 1, 1, 0, 1, 0, 0, 1, 1, 1, 0, 0, 0, 0]",199,119,80,15,8,0.12605042016806722,0.1
"[1, 0, 0, 1, 0, 0, 0, 0, 1, 1, 0, 1, 0, 0, 1]",173,94,79,8,4,0.0851063829787234,0.05063291139240506
"[1, 0, 1, 1, 0, 0, 1, 1, 1, 1, 0, 0, 1, 0, 0]",126,64,62,4,2,0.0625,0.03225806451612903
"[0, 1, 0, 1, 0, 1, 0, 0, 1, 0, 1, 0, 0, 1, 0]",106,59,47,8,4,0.13559322033898305,0.0851063829787234
"[1, 1, 1, 1, 1, 1, 0, 0, 1, 1, 1, 0, 1, 0, 0]",396,142,254,15,23,0.1056338028169014,0.09055118110236221
"[1, 1, 1, 1, 0, 1, 1, 1, 0, 1, 0, 1, 1, 0, 1]",519,145,374,12,49,0.08275862068965517,0.13101604278074866
"[1, 0, 1, 1, 0, 0, 0, 0, 0, 0, 0, 1, 0, 0, 1]",267,178,89,15,6,0.08426966292134831,0.06741573033707865
"[0, 1, 1, 1, 1, 1, 0, 0, 0, 0, 0, 0, 0, 0, 0]",943,631,312,62,41,0.098256735340729,0.13141025641025642
"[1, 0, 0, 1, 0, 0, 0, 0, 0, 0, 1, 1, 1, 1, 0]",372,223,149,29,14,0.13004484304932734,0.09395973154362416
"[0, 1, 1, 0, 0, 1, 1, 1, 1, 0, 0, 0, 1, 1, 1]",489,324,165,35,24,0.10802469135802469,0.14545454545454545
"[0, 0, 1, 0, 1, 1, 0, 0, 1, 1, 1, 1, 0, 0, 0]",265,162,103,18,7,0.1111111111111111,0.06796116504854369
"[0, 1, 1, 1, 1, 0, 1, 0, 1, 0, 1, 0, 1, 1, 0]",139,55,84,4,9,0.07272727272727272,0.10714285714285714
"[1, 0, 1, 0, 1, 0, 1, 0, 1, 0, 1, 1, 0, 0, 1]",113,52,61,3,3,0.057692307692307696,0.04918032786885246
"[1, 1, 1, 0, 1, 0, 1, 0, 1, 0, 1, 0, 1, 1, 0]",127,44,83,4,5,0.09090909090909091,0.060240963855421686
"[1, 1, 0, 0, 1, 0, 1, 1, 1, 1, 0, 1, 1, 1, 0]",203,74,129,7,8,0.0945945945945946,0.06201550387596899
"[0, 1, 1, 0, 0, 0, 1, 1, 0, 0, 0, 0, 0, 1, 1]",274,179,95,17,11,0.09497206703910614,0.11578947368421053
"[0, 0, 1, 1, 0, 0, 0, 1, 1, 0, 0, 0, 0, 0, 1]",342,212,130,21,16,0.09905660377358491,0.12307692307692308
"[0, 1, 0, 0, 0, 1, 1, 1, 0, 0, 0, 0, 0, 0, 0]",847,586,261,73,20,0.12457337883959044,0.07662835249042145
"[0, 1, 1, 0, 0, 0, 0, 1, 0, 1, 0, 0, 1, 1, 1]",216,156,60,19,6,0.12179487179487179,0.1
"[1, 0, 0, 1, 1, 0, 0, 0, 0, 1, 0, 1, 0, 0, 1]",204,94,110,6,8,0.06382978723404255,0.07272727272727272
"[1, 1, 0, 0, 1, 0, 1, 0, 0, 0, 0, 1, 0, 0, 1]",164,101,63,12,4,0.1188118811881188,0.06349206349206349
"[1, 1, 1, 0, 0, 0, 1, 1, 1, 1, 1, 1, 0, 0, 1]",612,221,391,22,37,0.09954751131221719,0.09462915601023018
"[1, 0, 1, 1, 0, 0, 1, 1, 1, 0, 1, 1, 1, 1, 1]",654,186,468,16,53,0.08602150537634409,0.11324786324786325
"[0, 1, 1, 1, 1, 1, 1, 1, 1, 0, 0, 0, 1, 1, 1]",1173,574,599,65,48,0.1132404181184669,0.08013355592654424
"[1, 1, 0, 0, 1, 1, 1, 0, 1, 0, 1, 0, 1, 1, 1]",335,113,222,5,22,0.04424778761061947,0.0990990990990991
"[1, 0, 1, 0, 0, 1, 1, 0, 0, 1, 1, 1, 0, 1, 0]",110,46,64,6,8,0.13043478260869565,0.125
"[1, 1, 1, 0, 1, 1, 1, 0, 1, 0, 1, 0, 0, 1, 1]",272,89,183,7,14,0.07865168539325842,0.07650273224043716
"[0, 0, 0, 0, 1, 1, 1, 1, 0, 1, 1, 1, 0, 1, 0]",135,65,70,8,3,0.12307692307692308,0.04285714285714286
"[0, 1, 1, 0, 1, 0, 0, 0, 0, 1, 0, 0, 0, 0, 1]",252,173,79,19,4,0.10982658959537572,0.05063291139240506
"[1, 1, 1, 0, 1, 1, 0, 1, 0, 0, 0, 0, 1, 0, 0]",126,67,59,4,6,0.05970149253731343,0.1016949152542373
"[0, 0, 1, 1, 1, 1, 1, 1, 0, 1, 1, 0, 1, 0, 0]",201,93,108,9,9,0.0967741935483871,0.08333333333333333
"[1, 1, 0, 0, 0, 0, 0, 0, 0, 0, 0, 1, 0, 0, 1]",941,627,314,65,39,0.10366826156299841,0.12420382165605096
"[1, 0, 1, 0, 1, 1, 0, 1, 1, 0, 1, 0, 0, 1, 1]",174,73,101,5,14,0.0684931506849315,0.13861386138613863
"[1, 0, 1, 1, 1, 0, 1, 1, 1, 1, 0, 1, 1, 1, 0]",527,156,371,20,28,0.1282051282051282,0.07547169811320754
"[1, 1, 0, 1, 0, 0, 0, 0, 1, 0, 1, 1, 1, 1, 1]",207,80,127,12,19,0.15,0.14960629921259844
"[0, 1, 1, 1, 0, 0, 0, 0, 1, 1, 0, 0, 0, 0, 1]",470,280,190,28,22,0.1,0.11578947368421053
"[1, 0, 0, 1, 1, 0, 1, 0, 1, 0, 1, 0, 1, 1, 1]",191,71,120,9,7,0.1267605633802817,0.058333333333333334
"[1, 0, 0, 1, 0, 0, 0, 0, 1, 1, 1, 1, 1, 0, 1]",131,44,87,6,10,0.13636363636363635,0.11494252873563218
"[1, 0, 1, 1, 0, 1, 0, 0, 1, 1, 0, 1, 1, 0, 0]",117,50,67,5,7,0.1,0.1044776119402985
"[0, 1, 0, 0, 1, 0, 1, 0, 0, 1, 0, 1, 1, 1, 1]",140,75,65,8,3,0.10666666666666667,0.046153846153846156
"[0, 0, 1, 0, 0, 1, 0, 1, 0, 0, 1, 0, 1, 1, 1]",136,78,58,5,7,0.0641025641025641,0.1206896551724138
"[1, 0, 0, 0, 1, 0, 0, 1, 0, 1, 0, 0, 1, 0, 1]",161,93,68,12,7,0.12903225806451613,0.10294117647058823
"[0, 1, 0, 1, 0, 0, 0, 0, 1, 1, 0, 1, 1, 1, 0]",104,55,49,3,6,0.05454545454545454,0.12244897959183673
"[0, 0, 1, 0, 1, 1, 1, 1, 1, 0, 1, 0, 1, 0, 0]",119,54,65,4,6,0.07407407407407407,0.09230769230769231
"[0, 1, 1, 0, 0, 1, 0, 0, 0, 1, 0, 1, 1, 1, 1]",171,98,73,4,6,0.04081632653061224,0.0821917808219178
"[0, 0, 1, 1, 0, 0, 1, 0, 0, 0, 1, 0, 1, 1, 1]",195,115,80,13,9,0.11304347826086956,0.1125
"[1, 0, 1, 1, 1, 1, 1, 0, 1, 0, 1, 0, 0, 1, 0]",138,66,72,5,6,0.07575757575757576,0.08333333333333333
"[0, 0, 1, 1, 1, 1, 1, 1, 1, 1, 0, 0, 1, 0, 1]",575,226,349,25,29,0.11061946902654868,0.0830945558739255
"[1, 1, 1, 0, 1, 0, 1, 0, 1, 1, 0, 0, 1, 0, 0]",117,55,62,2,3,0.03636363636363636,0.04838709677419355
"[0, 0, 0, 0, 0, 0, 1, 1, 0, 1, 0, 1, 0, 1, 0]",273,174,99,16,6,0.09195402298850575,0.06060606060606061
"[1, 1, 0, 1, 1, 1, 1, 1, 1, 1, 0, 0, 1, 0, 0]",272,86,186,10,18,0.11627906976744186,0.0967741935483871
"[0, 1, 1, 0, 1, 1, 0, 0, 0, 1, 1, 1, 0, 1, 1]",161,71,90,7,12,0.09859154929577464,0.13333333333333333
"[1, 1, 1, 1, 1, 1, 1, 0, 1, 1, 0, 1, 1, 0, 0]",742,207,535,20,50,0.0966183574879227,0.09345794392523364
"[0, 0, 0, 0, 1, 1, 1, 0, 0, 0, 0, 0, 1, 1, 1]",462,300,162,24,14,0.08,0.08641975308641975
"[1, 0, 0, 1, 0, 0, 1, 0, 0, 0, 0, 0, 1, 1, 1]",268,151,117,14,16,0.09271523178807947,0.13675213675213677
"[0, 1, 0, 0, 1, 1, 1, 0, 1, 1, 0, 0, 0, 1, 1]",115,49,66,6,8,0.12244897959183673,0.12121212121212122
"[1, 1, 0, 0, 1, 0, 1, 1, 0, 0, 1, 1, 1, 1, 1]",432,150,282,20,32,0.13333333333333333,0.11347517730496454
"[0, 1, 0, 0, 0, 1, 0, 1, 0, 0, 0, 0, 1, 1, 1]",250,149,101,16,13,0.10738255033557047,0.12871287128712872
"[1, 1, 0, 0, 1, 0, 1, 0, 0, 1, 0, 0, 1, 0, 1]",127,69,58,9,8,0.13043478260869565,0.13793103448275862
"[1, 1, 0, 0, 0, 1, 0, 1, 0, 1, 0, 0, 1, 0, 1]",87,50,37,4,1,0.08,0.02702702702702703
"[0, 0, 0, 0, 1, 0, 0, 1, 1, 1, 0, 0, 0, 1, 0]",234,157,77,16,11,0.10191082802547771,0.14285714285714285
"[0, 0, 0, 0, 0, 1, 1, 1, 0, 1, 1, 0, 0, 0, 0]",347,244,103,19,5,0.0778688524590164,0.04854368932038835
"[1, 0, 0, 1, 0, 0, 0, 0, 0, 1, 1, 1, 1, 0, 0]",353,193,160,12,16,0.06217616580310881,0.1
"[0, 1, 0, 1, 1, 0, 1, 0, 1, 0, 0, 0, 0, 0, 0]",282,189,93,19,11,0.10052910052910052,0.11827956989247312
"[1, 0, 0, 1, 0, 1, 0, 1, 0, 0, 0, 0, 0, 1, 0]",218,146,72,12,8,0.0821917808219178,0.1111111111111111
"[1, 1, 0, 0, 1, 0, 0, 1, 0, 1, 0, 1, 0, 0, 0]",138,78,60,4,6,0.05128205128205128,0.1
"[0, 0, 1, 1, 0, 0, 1, 0, 0, 1, 0, 1, 0, 1, 0]",131,73,58,4,4,0.0547945205479452,0.06896551724137931
"[0, 1, 0, 0, 1, 1, 0, 1, 1, 1, 0, 0, 1, 1, 0]",128,59,69,4,5,0.06779661016949153,0.07246376811594203
"[1, 0, 1, 0, 0, 1, 1, 0, 1, 1, 1, 0, 0, 1, 1]",181,77,104,12,10,0.15584415584415584,0.09615384615384616
"[0, 1, 1, 0, 1, 0, 1, 0, 0, 0, 1, 0, 1, 1, 1]",117,57,60,5,6,0.08771929824561403,0.1
"[1, 1, 0, 0, 0, 1, 1, 0, 1, 0, 1, 0, 0, 0, 1]",111,56,55,3,4,0.05357142857142857,0.07272727272727272
"[0, 1, 1, 1, 0, 0, 0, 1, 1, 0, 1, 0, 1, 0, 0]",120,61,59,8,7,0.13114754098360656,0.11864406779661017
"[1, 0, 1, 0, 0, 1, 1, 0, 0, 0, 0, 0, 1, 1, 1]",219,119,100,15,17,0.12605042016806722,0.17
"[1, 0, 1, 0, 1, 1, 1, 0, 0, 1, 0, 1, 0, 0, 1]",120,65,55,3,7,0.046153846153846156,0.12727272727272726
"[1, 0, 1, 1, 0, 1, 0, 1, 0, 1, 0, 1, 1, 1, 0]",156,65,91,5,8,0.07692307692307693,0.08791208791208792
"[1, 1, 0, 1, 1, 0, 1, 0, 1, 1, 1, 1, 1, 1, 0]",576,176,400,12,32,0.06818181818181818,0.08
"[0, 1, 1, 0, 1, 0, 0, 1, 0, 0, 1, 1, 0, 0, 1]",178,98,80,10,9,0.10204081632653061,0.1125
"[0, 1, 1, 1, 0, 1, 1, 1, 1, 1, 1, 0, 1, 1, 0]",498,141,357,13,38,0.09219858156028368,0.10644257703081232
"[0, 1, 1, 0, 1, 1, 1, 1, 1, 1, 0, 1, 0, 0, 1]",267,101,166,14,19,0.13861386138613863,0.1144578313253012
"[1, 1, 0, 1, 1, 1, 1, 1, 0, 1, 1, 0, 1, 1, 0]",491,135,356,13,32,0.0962962962962963,0.0898876404494382
"[1, 1, 1, 0, 0, 1, 0, 0, 1, 1, 1, 1, 1, 0, 0]",215,69,146,9,7,0.13043478260869565,0.04794520547945205
"[1, 0, 1, 0, 0, 1, 0, 1, 0, 0, 1, 1, 0, 0, 0]",174,104,70,7,9,0.0673076923076923,0.12857142857142856
"[0, 1, 0, 1, 0, 0, 1, 0, 1, 0, 0, 1, 1, 0, 0]",183,111,72,10,10,0.09009009009009009,0.1388888888888889
"[1, 0, 1, 1, 0, 0, 1, 1, 0, 1, 0, 0, 0, 1, 0]",104,53,51,5,9,0.09433962264150944,0.17647058823529413
"[0, 1, 1, 0, 1, 1, 0, 0, 1, 1, 0, 1, 0, 0, 0]",98,59,39,7,3,0.11864406779661017,0.07692307692307693
"[1, 0, 0, 0, 0, 1, 0, 1, 1, 1, 0, 0, 1, 1, 1]",171,72,99,3,12,0.041666666666666664,0.12121212121212122
"[0, 1, 0, 1, 1, 0, 1, 0, 1, 0, 0, 1, 1, 1, 1]",172,58,114,5,8,0.08620689655172414,0.07017543859649122
"[1, 0, 1, 0, 0, 1, 0, 1, 1, 1, 0, 0, 0, 0, 0]",192,103,89,9,7,0.08737864077669903,0.07865168539325842
"[0, 1, 0, 0, 1, 0, 1, 0, 0, 0, 1, 0, 1, 1, 1]",118,76,42,9,6,0.11842105263157894,0.14285714285714285
"[0, 0, 0, 1, 0, 0, 1, 0, 0, 0, 0, 1, 0, 1, 0]",498,355,143,28,10,0.07887323943661972,0.06993006993006994
"[0, 1, 0, 1, 1, 0, 1, 1, 0, 1, 0, 1, 0, 1, 1]",130,54,76,7,5,0.12962962962962962,0.06578947368421052
"[0, 0, 1, 0, 1, 1, 0, 1, 1, 0, 1, 0, 1, 0, 1]",102,51,51,3,6,0.058823529411764705,0.11764705882352941
"[0, 1, 1, 0, 1, 1, 0, 0, 0, 0, 0, 1, 1, 0, 0]",258,168,90,17,8,0.10119047619047619,0.08888888888888889
"[1, 1, 1, 0, 1, 1, 0, 1, 0, 0, 1, 0, 0, 0, 0]",123,59,64,4,7,0.06779661016949153,0.109375
"[0, 1, 0, 0, 1, 0, 1, 0, 1, 0, 0, 0, 0, 1, 0]",242,144,98,18,8,0.125,0.08163265306122448
"[1, 0, 1, 0, 1, 0, 0, 1, 0, 1, 0, 1, 0, 0, 0]",164,87,77,5,5,0.05747126436781609,0.06493506493506493
"[0, 1, 1, 0, 1, 0, 1, 0, 0, 1, 0, 1, 0, 1, 0]",113,61,52,8,5,0.13114754098360656,0.09615384615384616
"[1, 0, 1, 1, 0, 0, 0, 1, 1, 0, 1, 0, 1, 0, 0]",118,63,55,6,11,0.09523809523809523,0.2
"[1, 0, 0, 1, 0, 1, 1, 1, 1, 1, 0, 0, 1, 0, 0]",92,42,50,3,6,0.07142857142857142,0.12
"[1, 1, 0, 1, 0, 1, 0, 1, 0, 0, 1, 1, 1, 1, 1]",366,136,230,6,27,0.04411764705882353,0.11739130434782609
"[1, 1, 1, 1, 0, 0, 1, 1, 1, 0, 0, 1, 1, 0, 0]",357,126,231,10,23,0.07936507936507936,0.09956709956709957
"[0, 1, 1, 1, 0, 1, 1, 1, 0, 1, 0, 1, 1, 1, 1]",617,188,429,20,39,0.10638297872340426,0.09090909090909091
"[1, 0, 1, 1, 1, 1, 1, 0, 1, 1, 1, 0, 1, 1, 0]",533,162,371,10,33,0.06172839506172839,0.0889487870619946
"[1, 1, 1, 1, 1, 0, 0, 0, 0, 1, 1, 0, 1, 0, 0]",206,67,139,4,9,0.05970149253731343,0.06474820143884892
"[1, 0, 0, 0, 0, 1, 0, 0, 0, 1, 1, 1, 1, 1, 1]",277,115,162,9,18,0.0782608695652174,0.1111111111111111
"[1, 0, 1, 1, 1, 1, 0, 1, 1, 0, 1, 0, 1, 1, 1]",562,183,379,22,43,0.12021857923497267,0.11345646437994723
"[1, 0, 0, 1, 1, 0, 1, 1, 1, 1, 0, 1, 0, 1, 1]",255,90,165,9,19,0.1,0.11515151515151516
"[0, 1, 0, 0, 1, 1, 0, 1, 1, 1, 1, 0, 1, 0, 1]",145,63,82,9,4,0.14285714285714285,0.04878048780487805
"[1, 1, 1, 0, 0, 1, 0, 1, 1, 1, 1, 0, 0, 1, 0]",140,47,93,4,11,0.0851063829787234,0.11827956989247312
"[1, 1, 1, 0, 1, 1, 1, 0, 1, 0, 1, 1, 1, 1, 0]",539,163,376,15,47,0.09202453987730061,0.125
"[1, 1, 1, 0, 0, 1, 0, 1, 1, 1, 1, 0, 0, 1, 1]",432,134,298,11,27,0.08208955223880597,0.09060402684563758
"[1, 0, 1, 1, 1, 0, 1, 0, 1, 0, 0, 0, 0, 1, 0]",107,50,57,5,4,0.1,0.07017543859649122
"[1, 1, 1, 1, 0, 1, 0, 1, 1, 0, 0, 0, 1, 1, 1]",338,120,218,17,20,0.14166666666666666,0.09174311926605505
"[1, 0, 0, 1, 1, 1, 1, 0, 1, 1, 0, 0, 0, 1, 0]",102,49,53,7,6,0.14285714285714285,0.11320754716981132
"[1, 1, 1, 0, 0, 0, 0, 0, 0, 0, 0, 0, 1, 1, 0]",714,350,364,42,22,0.12,0.06043956043956044
"[0, 1, 1, 0, 1, 0, 1, 0, 1, 1, 1, 0, 0, 0, 0]",144,73,71,5,7,0.0684931506849315,0.09859154929577464
"[0, 0, 0, 1, 0, 0, 1, 0, 0, 0, 0, 1, 1, 0, 1]",234,161,73,12,10,0.07453416149068323,0.136986301369863
"[1, 1, 0, 0, 0, 0, 0, 0, 1, 0, 0, 1, 0, 0, 0]",734,478,256,48,18,0.100418410041841,0.0703125
"[1, 0, 1, 1, 0, 0, 0, 0, 0, 0, 1, 0, 0, 1, 0]",244,166,78,14,4,0.08433734939759036,0.05128205128205128
"[0, 1, 1, 0, 0, 1, 0, 1, 1, 0, 0, 0, 0, 0, 0]",389,240,149,23,17,0.09583333333333334,0.11409395973154363
"[1, 1, 0, 1, 1, 0, 0, 1, 1, 0, 0, 0, 1, 0, 1]",119,53,66,2,7,0.03773584905660377,0.10606060606060606
"[0, 0, 0, 0, 0, 0, 0, 0, 1, 1, 0, 0, 1, 0, 1]",1066,746,320,87,28,0.11662198391420911,0.0875
"[0, 0, 1, 1, 1, 1, 1, 1, 0, 0, 0, 0, 1, 0, 1]",396,205,191,18,14,0.08780487804878048,0.07329842931937172
"[1, 0, 1, 0, 1, 1, 0, 1, 0, 1, 1, 1, 0, 1, 0]",122,47,75,2,9,0.0425531914893617,0.12
"[0, 0, 1, 1, 0, 1, 0, 1, 1, 0, 1, 0, 1, 1, 0]",109,46,63,5,2,0.10869565217391304,0.031746031746031744
"[1, 0, 1, 1, 1, 1, 0, 1, 1, 1, 0, 1, 0, 1, 1]",537,165,372,17,36,0.10303030303030303,0.0967741935483871
"[1, 1, 1, 1, 0, 1, 0, 0, 0, 1, 0, 0, 1, 1, 0]",120,53,67,3,4,0.05660377358490566,0.05970149253731343
"[1, 0, 1, 1, 1, 1, 0, 0, 1, 1, 1, 0, 1, 0, 1]",258,100,158,11,16,0.11,0.10126582278481013
"[1, 1, 0, 1, 0, 0, 0, 0, 1, 0, 1, 1, 1, 0, 0]",113,55,58,2,6,0.03636363636363636,0.10344827586206896
"[1, 1, 1, 1, 0, 1, 0, 1, 1, 0, 1, 0, 0, 0, 0]",121,50,71,7,7,0.14,0.09859154929577464
"[1, 1, 1, 1, 1, 0, 1, 0, 1, 1, 0, 1, 0, 0, 0]",156,61,95,3,9,0.04918032786885246,0.09473684210526316
"[0, 0, 1, 0, 0, 0, 0, 0, 0, 1, 1, 0, 1, 1, 1]",264,172,92,16,8,0.09302325581395349,0.08695652173913043
"[1, 1, 0, 0, 1, 0, 1, 0, 0, 1, 0, 0, 0, 0, 0]",291,178,113,19,14,0.10674157303370786,0.12389380530973451
"[1, 0, 1, 1, 0, 0, 0, 0, 1, 0, 1, 0, 1, 0, 0]",155,85,70,7,7,0.08235294117647059,0.1
"[1, 1, 1, 1, 1, 0, 0, 0, 1, 1, 0, 0, 0, 0, 1]",289,111,178,12,15,0.10810810810810811,0.08426966292134831
"[1, 0, 1, 0, 1, 0, 0, 1, 0, 1, 0, 0, 0, 0, 0]",278,173,105,19,9,0.10982658959537572,0.08571428571428572
"[0, 1, 0, 1, 0, 1, 0, 0, 1, 0, 1, 0, 0, 0, 0]",249,163,86,14,4,0.08588957055214724,0.046511627906976744
"[0, 0, 1, 0, 0, 0, 1, 0, 0, 0, 1, 0, 1, 0, 1]",222,148,74,8,10,0.05405405405405406,0.13513513513513514
"[0, 0, 0, 1, 0, 1, 1, 1, 0, 1, 0, 0, 0, 0, 1]",172,91,81,8,4,0.08791208791208792,0.04938271604938271
"[0, 1, 1, 1, 0, 0, 0, 1, 0, 1, 1, 1, 0, 1, 0]",110,47,63,2,2,0.0425531914893617,0.031746031746031744
"[0, 0, 0, 0, 0, 1, 0, 1, 1, 1, 0, 1, 1, 1, 0]",138,67,71,4,10,0.05970149253731343,0.14084507042253522
"[0, 0, 1, 1, 0, 0, 0, 1, 1, 0, 0, 1, 1, 1, 1]",393,209,184,21,15,0.10047846889952153,0.08152173913043478
"[0, 0, 0, 1, 1, 0, 0, 0, 1, 1, 0, 0, 1, 1, 1]",362,238,124,17,11,0.07142857142857142,0.08870967741935484
"[1, 0, 0, 1, 1, 1, 1, 1, 0, 1, 1, 0, 1, 0, 0]",160,54,106,3,10,0.05555555555555555,0.09433962264150944
"[1, 1, 0, 0, 0, 1, 0, 0, 1, 1, 1, 1, 1, 0, 1]",158,56,102,6,9,0.10714285714285714,0.08823529411764706
"[1, 0, 0, 1, 1, 1, 0, 0, 0, 1, 1, 1, 0, 1, 1]",153,65,88,3,5,0.046153846153846156,0.056818181818181816
"[1, 0, 1, 1, 0, 0, 0, 1, 0, 0, 0, 0, 0, 1, 1]",178,101,77,4,9,0.039603960396039604,0.11688311688311688
"[1, 0, 0, 1, 1, 1, 0, 0, 1, 0, 0, 0, 1, 0, 1]",124,51,73,3,5,0.058823529411764705,0.0684931506849315
"[0, 1, 0, 0, 1, 1, 1, 0, 0, 1, 0, 0, 0, 1, 0]",126,69,57,8,5,0.11594202898550725,0.08771929824561403
"[1, 1, 0, 0, 0, 1, 1, 0, 0, 0, 0, 0, 0, 0, 0]",1313,907,406,83,40,0.09151047409040794,0.09852216748768473
"[1, 0, 0, 1, 0, 0, 1, 0, 1, 0, 0, 0, 1, 0, 0]",228,146,82,10,8,0.0684931506849315,0.0975609756097561
"[0, 0, 1, 0, 0, 1, 0, 0, 1, 1, 0, 0, 0, 0, 1]",374,241,133,18,10,0.07468879668049792,0.07518796992481203
"[0, 0, 1, 0, 0, 0, 1, 0, 0, 1, 0, 0, 1, 1, 0]",240,159,81,11,5,0.06918238993710692,0.06172839506172839
"[1, 1, 0, 0, 0, 1, 0, 0, 0, 0, 0, 1, 0, 0, 1]",241,156,85,12,7,0.07692307692307693,0.08235294117647059
"[1, 1, 0, 1, 1, 1, 1, 1, 0, 1, 1, 1, 1, 0, 0]",758,217,541,12,43,0.055299539170506916,0.07948243992606285
"[1, 0, 1, 1, 1, 1, 1, 0, 1, 1, 0, 1, 1, 0, 0]",270,88,182,7,15,0.07954545454545454,0.08241758241758242
"[0, 1, 1, 1, 1, 0, 1, 1, 1, 0, 0, 1, 0, 0, 1]",142,57,85,6,9,0.10526315789473684,0.10588235294117647
"[0, 1, 0, 0, 0, 1, 0, 1, 1, 1, 0, 0, 0, 0, 0]",305,205,100,20,9,0.0975609756097561,0.09
"[1, 1, 0, 0, 1, 0, 0, 0, 1, 0, 1, 1, 1, 0, 0]",131,64,67,4,12,0.0625,0.1791044776119403
"[1, 1, 0, 0, 0, 1, 0, 1, 0, 0, 1, 1, 0, 0, 1]",149,76,73,6,6,0.07894736842105263,0.0821917808219178
"[1, 0, 0, 1, 1, 0, 0, 0, 1, 1, 1, 0, 1, 0, 0]",122,59,63,3,6,0.05084745762711865,0.09523809523809523
"[0, 0, 1, 0, 1, 1, 0, 0, 0, 1, 0, 1, 0, 0, 1]",158,100,58,15,4,0.15,0.06896551724137931
"[0, 1, 1, 1, 1, 1, 0, 0, 1, 0, 0, 0, 1, 0, 1]",112,63,49,6,11,0.09523809523809523,0.22448979591836735
"[0, 1, 0, 0, 1, 0, 1, 0, 0, 0, 1, 1, 0, 1, 0]",148,90,58,6,3,0.06666666666666667,0.05172413793103448
"[1, 0, 1, 0, 1, 0, 1, 0, 0, 0, 1, 0, 0, 1, 0]",141,87,54,10,3,0.11494252873563218,0.05555555555555555
"[1, 0, 0, 0, 0, 1, 1, 1, 0, 1, 1, 0, 0, 1, 1]",204,66,138,9,10,0.13636363636363635,0.07246376811594203
"[1, 1, 0, 1, 1, 1, 0, 1, 1, 1, 0, 1, 1, 0, 0]",257,100,157,5,23,0.05,0.1464968152866242
"[1, 1, 1, 1, 1, 1, 0, 1, 0, 1, 0, 1, 0, 1, 1]",579,175,404,13,46,0.07428571428571429,0.11386138613861387
"[0, 0, 1, 1, 0, 1, 1, 0, 1, 0, 1, 0, 1, 0, 1]",105,46,59,4,6,0.08695652173913043,0.1016949152542373
"[0, 1, 1, 1, 1, 0, 1, 1, 0, 0, 0, 0, 0, 0, 1]",208,127,81,18,8,0.14173228346456693,0.09876543209876543
"[0, 1, 1, 0, 1, 1, 1, 1, 0, 1, 1, 0, 0, 0, 0]",164,68,96,8,9,0.11764705882352941,0.09375
"[0, 1, 1, 1, 0, 1, 1, 1, 0, 1, 1, 0, 1, 1, 1]",580,169,411,11,52,0.0650887573964497,0.12652068126520682
"[1, 0, 1, 0, 0, 0, 0, 1, 1, 1, 0, 1, 1, 1, 0]",109,51,58,7,5,0.13725490196078433,0.08620689655172414
"[0, 1, 1, 0, 1, 0, 0, 1, 1, 1, 1, 0, 1, 0, 1]",153,71,82,5,7,0.07042253521126761,0.08536585365853659
"[1, 1, 1, 0, 1, 1, 0, 0, 1, 1, 0, 0, 0, 0, 1]",322,137,185,13,11,0.0948905109489051,0.05945945945945946
"[0, 1, 1, 0, 1, 1, 1, 0, 1, 1, 0, 0, 1, 1, 0]",160,69,91,4,12,0.057971014492753624,0.13186813186813187
"[1, 1, 1, 1, 0, 0, 1, 1, 0, 0, 0, 1, 1, 0, 1]",294,117,177,13,18,0.1111111111111111,0.1016949152542373
"[1, 1, 0, 0, 1, 1, 0, 1, 1, 0, 0, 1, 1, 0, 0]",217,115,102,10,9,0.08695652173913043,0.08823529411764706
"[1, 0, 1, 1, 1, 1, 1, 0, 0, 0, 1, 1, 0, 1, 0]",146,59,87,5,11,0.0847457627118644,0.12643678160919541
"[1, 1, 1, 0, 0, 1, 1, 1, 1, 1, 0, 0, 0, 0, 1]",367,116,251,10,24,0.08620689655172414,0.09561752988047809
"[1, 0, 0, 0, 1, 0, 0, 1, 1, 0, 1, 1, 1, 1, 1]",171,65,106,9,7,0.13846153846153847,0.0660377358490566
"[1, 1, 0, 0, 0, 0, 1, 1, 0, 0, 0, 1, 0, 0, 1]",298,162,136,15,16,0.09259259259259259,0.11764705882352941
"[1, 0, 0, 0, 0, 0, 1, 0, 1, 0, 0, 0, 0, 1, 1]",389,231,158,16,12,0.06926406926406926,0.0759493670886076
"[0, 0, 0, 1, 1, 0, 1, 1, 1, 1, 1, 1, 0, 0, 1]",281,142,139,15,16,0.1056338028169014,0.11510791366906475
"[1, 0, 0, 1, 0, 1, 1, 0, 1, 0, 1, 0, 1, 1, 1]",171,73,98,10,11,0.136986301369863,0.11224489795918367
"[0, 0, 1, 0, 1, 0, 0, 1, 0, 0, 1, 0, 0, 0, 1]",236,163,73,8,5,0.049079754601226995,0.0684931506849315
"[0, 1, 0, 0, 0, 0, 0, 1, 1, 0, 0, 1, 1, 0, 0]",760,457,303,43,27,0.09409190371991247,0.0891089108910891
"[0, 1, 1, 1, 0, 0, 1, 0, 0, 1, 1, 0, 0, 0, 1]",119,66,53,6,3,0.09090909090909091,0.05660377358490566
"[0, 0, 0, 0, 1, 1, 1, 0, 0, 1, 0, 0, 1, 1, 0]",195,117,78,6,8,0.05128205128205128,0.10256410256410256
"[0, 0, 0, 0, 0, 0, 0, 1, 0, 1, 0, 0, 0, 1, 1]",962,732,230,65,20,0.08879781420765027,0.08695652173913043
"[1, 1, 0, 1, 0, 0, 1, 1, 1, 0, 1, 0, 0, 1, 0]",98,49,49,7,8,0.14285714285714285,0.16326530612244897
"[1, 1, 0, 0, 0, 1, 1, 0, 1, 0, 0, 1, 1, 1, 0]",118,55,63,6,5,0.10909090909090909,0.07936507936507936
"[0, 0, 0, 1, 1, 1, 0, 0, 1, 0, 1, 1, 0, 0, 0]",178,105,73,10,5,0.09523809523809523,0.0684931506849315
"[1, 0, 0, 0, 0, 0, 0, 1, 1, 0, 1, 0, 0, 0, 1]",315,154,161,11,10,0.07142857142857142,0.062111801242236024
"[1, 0, 0, 1, 1, 1, 1, 0, 0, 1, 0, 0, 0, 0, 0]",256,114,142,15,10,0.13157894736842105,0.07042253521126761
"[1, 1, 1, 0, 0, 1, 1, 0, 1, 1, 1, 0, 1, 1, 1]",706,154,552,10,48,0.06493506493506493,0.08695652173913043
"[1, 1, 0, 1, 0, 0, 0, 1, 1, 1, 1, 0, 0, 0, 0]",269,119,150,15,14,0.12605042016806722,0.09333333333333334
"[1, 1, 0, 0, 1, 1, 1, 0, 0, 1, 0, 1, 0, 1, 1]",179,67,112,12,12,0.1791044776119403,0.10714285714285714
"[1, 1, 0, 0, 0, 1, 1, 0, 1, 0, 1, 1, 1, 0, 1]",138,60,78,8,7,0.13333333333333333,0.08974358974358974
"[1, 1, 1, 1, 1, 0, 0, 0, 0, 1, 0, 0, 1, 1, 1]",382,95,287,3,29,0.031578947368421054,0.10104529616724739
"[0, 1, 0, 1, 0, 0, 0, 0, 1, 0, 0, 0, 1, 0, 0]",536,371,165,28,15,0.07547169811320754,0.09090909090909091
"[0, 1, 0, 0, 1, 0, 0, 1, 1, 0, 1, 1, 1, 1, 0]",147,70,77,7,9,0.1,0.11688311688311688
"[1, 0, 1, 0, 0, 1, 1, 1, 0, 1, 0, 1, 0, 0, 1]",110,53,57,4,9,0.07547169811320754,0.15789473684210525
"[1, 1, 0, 0, 0, 0, 0, 0, 1, 1, 1, 0, 0, 1, 0]",234,132,102,19,6,0.14393939393939395,0.058823529411764705
"[1, 0, 0, 0, 0, 0, 0, 1, 0, 1, 0, 1, 1, 0, 0]",321,199,122,16,11,0.08040201005025126,0.09016393442622951
"[0, 0, 0, 1, 0, 1, 0, 0, 1, 1, 0, 0, 1, 1, 1]",261,150,111,14,16,0.09333333333333334,0.14414414414414414
"[1, 0, 0, 1, 1, 0, 1, 0, 1, 1, 0, 0, 0, 0, 1]",149,74,75,5,6,0.06756756756756757,0.08
"[1, 1, 1, 1, 1, 1, 1, 0, 1, 0, 1, 1, 0, 1, 0]",565,157,408,13,46,0.08280254777070063,0.11274509803921569
"[1, 0, 1, 1, 1, 1, 1, 0, 0, 1, 0, 1, 1, 1, 1]",634,179,455,17,43,0.09497206703910614,0.0945054945054945
"[0, 0, 0, 0, 0, 1, 0, 1, 1, 0, 0, 0, 0, 0, 1]",690,491,199,48,20,0.09775967413441955,0.10050251256281408
"[1, 0, 1, 0, 1, 1, 1, 1, 0, 0, 1, 1, 1, 1, 1]",1033,305,728,27,68,0.08852459016393442,0.09340659340659341
"[0, 0, 1, 1, 0, 1, 1, 0, 1, 1, 1, 1, 1, 0, 1]",247,83,164,9,12,0.10843373493975904,0.07317073170731707
"[0, 0, 1, 1, 1, 1, 1, 0, 1, 0, 0, 0, 0, 1, 1]",217,101,116,6,4,0.0594059405940594,0.034482758620689655
"[0, 1, 0, 0, 0, 1, 1, 1, 0, 0, 1, 1, 1, 1, 1]",248,111,137,11,14,0.0990990990990991,0.10218978102189781
"[0, 0, 1, 0, 0, 0, 1, 1, 1, 0, 0, 1, 1, 1, 1]",209,104,105,3,11,0.028846153846153848,0.10476190476190476
"[0, 0, 1, 0, 1, 0, 0, 1, 0, 0, 1, 0, 1, 0, 0]",229,150,79,13,8,0.08666666666666667,0.10126582278481013
"[1, 1, 1, 1, 1, 0, 1, 1, 0, 0, 1, 1, 1, 0, 1]",555,161,394,17,34,0.10559006211180125,0.08629441624365482
"[0, 1, 0, 0, 1, 0, 0, 1, 1, 0, 0, 1, 0, 0, 1]",143,88,55,8,4,0.09090909090909091,0.07272727272727272
"[0, 1, 0, 0, 1, 1, 0, 0, 0, 1, 1, 0, 0, 1, 1]",215,114,101,15,12,0.13157894736842105,0.1188118811881188
"[0, 1, 0, 0, 0, 1, 0, 1, 0, 0, 1, 0, 1, 0, 0]",203,143,60,12,5,0.08391608391608392,0.08333333333333333
"[0, 0, 1, 1, 1, 0, 0, 0, 1, 0, 0, 0, 1, 0, 1]",161,94,67,12,3,0.1276595744680851,0.04477611940298507
"[1, 0, 0, 1, 1, 1, 0, 0, 0, 1, 0, 0, 0, 1, 0]",134,80,54,8,8,0.1,0.14814814814814814
"[0, 0, 0, 1, 1, 1, 0, 0, 1, 1, 1, 1, 0, 0, 0]",358,216,142,24,15,0.1111111111111111,0.1056338028169014
"[0, 1, 0, 0, 0, 1, 1, 0, 1, 1, 0, 1, 1, 0, 0]",122,52,70,2,4,0.038461538461538464,0.05714285714285714
"[1, 1, 1, 0, 1, 1, 1, 1, 1, 0, 0, 0, 0, 1, 0]",190,83,107,6,12,0.07228915662650602,0.11214953271028037
"[0, 0, 0, 1, 0, 1, 0, 1, 0, 0, 1, 0, 0, 0, 1]",233,148,85,20,10,0.13513513513513514,0.11764705882352941
"[0, 1, 1, 1, 0, 0, 1, 1, 1, 1, 0, 0, 1, 1, 0]",442,192,250,16,30,0.08333333333333333,0.12
"[1, 1, 1, 0, 1, 1, 0, 1, 1, 0, 0, 0, 0, 1, 1]",289,92,197,9,20,0.09782608695652174,0.10152284263959391
"[1, 1, 1, 1, 0, 1, 1, 0, 1, 1, 0, 0, 0, 0, 1]",260,95,165,12,15,0.12631578947368421,0.09090909090909091
"[1, 1, 1, 0, 1, 0, 0, 0, 1, 0, 1, 1, 1, 1, 1]",305,106,199,12,21,0.11320754716981132,0.10552763819095477
"[0, 0, 0, 0, 1, 0, 1, 0, 0, 1, 0, 0, 0, 0, 1]",578,409,169,41,15,0.10024449877750612,0.08875739644970414
"[0, 0, 0, 1, 1, 0, 1, 1, 0, 1, 0, 1, 1, 1, 0]",105,53,52,7,5,0.1320754716981132,0.09615384615384616
"[0, 0, 1, 0, 0, 0, 0, 1, 0, 0, 0, 1, 1, 0, 1]",221,152,69,21,7,0.13815789473684212,0.10144927536231885
"[1, 0, 0, 1, 1, 0, 1, 1, 1, 0, 1, 1, 0, 1, 1]",257,75,182,10,21,0.13333333333333333,0.11538461538461539
"[1, 1, 1, 1, 0, 0, 1, 1, 0, 1, 1, 1, 1, 1, 0]",626,188,438,17,44,0.09042553191489362,0.1004566210045662
"[1, 1, 1, 1, 1, 1, 0, 0, 1, 1, 0, 1, 1, 0, 1]",775,227,548,20,46,0.0881057268722467,0.08394160583941605
"[0, 1, 1, 0, 0, 0, 1, 1, 1, 1, 0, 1, 0, 1, 1]",172,72,100,4,7,0.05555555555555555,0.07
"[0, 0, 0, 1, 1, 1, 0, 1, 0, 1, 0, 1, 1, 1, 1]",217,119,98,11,9,0.09243697478991597,0.09183673469387756
"[1, 1, 1, 1, 0, 0, 0, 0, 1, 1, 1, 0, 1, 0, 1]",279,128,151,19,15,0.1484375,0.09933774834437085
"[0, 1, 1, 1, 1, 1, 1, 0, 1, 0, 0, 1, 1, 0, 0]",194,101,93,12,9,0.1188118811881188,0.0967741935483871
"[1, 0, 0, 0, 0, 0, 1, 0, 1, 0, 1, 0, 0, 0, 1]",242,162,80,11,7,0.06790123456790123,0.0875
"[1, 0, 0, 1, 1, 0, 1, 1, 0, 0, 1, 1, 1, 1, 0]",222,93,129,10,9,0.10752688172043011,0.06976744186046512
"[0, 0, 1, 1, 0, 1, 0, 0, 1, 1, 0, 1, 1, 0, 0]",121,60,61,3,5,0.05,0.08196721311475409
"[0, 1, 0, 0, 0, 0, 1, 1, 0, 1, 0, 0, 1, 1, 0]",159,104,55,9,2,0.08653846153846154,0.03636363636363636
"[1, 0, 0, 1, 0, 0, 0, 1, 0, 0, 0, 0, 1, 1, 0]",318,205,113,16,5,0.07804878048780488,0.04424778761061947
"[1, 0, 0, 1, 1, 0, 1, 1, 0, 1, 0, 1, 1, 1, 1]",312,97,215,20,29,0.20618556701030927,0.13488372093023257
"[0, 1, 0, 0, 1, 1, 0, 1, 1, 0, 1, 0, 1, 1, 1]",165,66,99,5,18,0.07575757575757576,0.18181818181818182
"[1, 0, 0, 1, 1, 0, 1, 0, 0, 1, 1, 0, 1, 1, 0]",103,44,59,4,9,0.09090909090909091,0.15254237288135594
"[0, 0, 0, 0, 0, 0, 1, 0, 0, 1, 0, 0, 1, 1, 1]",688,503,185,42,17,0.08349900596421471,0.0918918918918919
"[0, 1, 0, 1, 0, 1, 0, 1, 0, 0, 0, 0, 1, 1, 1]",154,89,65,10,8,0.11235955056179775,0.12307692307692308
"[0, 1, 0, 1, 0, 0, 1, 1, 0, 0, 1, 1, 0, 1, 0]",120,62,58,4,4,0.06451612903225806,0.06896551724137931
"[0, 0, 1, 1, 0, 0, 0, 0, 0, 1, 1, 1, 1, 0, 1]",186,109,77,6,12,0.05504587155963303,0.15584415584415584
"[0, 0, 0, 0, 0, 0, 1, 0, 0, 1, 0, 1, 0, 1, 1]",318,202,116,20,4,0.09900990099009901,0.034482758620689655
"[0, 0, 0, 0, 1, 1, 1, 0, 0, 0, 0, 0, 1, 0, 0]",638,452,186,39,22,0.08628318584070796,0.11827956989247312
"[0, 0, 0, 0, 0, 1, 1, 1, 0, 0, 0, 0, 0, 1, 0]",618,446,172,42,10,0.09417040358744394,0.05813953488372093
"[0, 1, 0, 0, 0, 1, 1, 0, 0, 1, 1, 0, 0, 1, 0]",180,111,69,11,5,0.0990990990990991,0.07246376811594203
"[1, 1, 1, 0, 1, 0, 0, 1, 1, 0, 0, 0, 0, 1, 1]",277,122,155,15,12,0.12295081967213115,0.07741935483870968
"[1, 1, 0, 1, 0, 0, 1, 1, 1, 0, 0, 1, 1, 1, 1]",377,131,246,15,25,0.11450381679389313,0.1016260162601626
"[1, 1, 0, 1, 1, 1, 1, 0, 1, 0, 0, 1, 0, 0, 1]",173,61,112,5,10,0.08196721311475409,0.08928571428571429
"[0, 1, 0, 1, 1, 0, 1, 1, 1, 0, 1, 1, 1, 0, 1]",190,70,120,5,11,0.07142857142857142,0.09166666666666666
"[0, 0, 1, 1, 1, 0, 1, 0, 1, 1, 0, 1, 1, 1, 0]",131,61,70,8,6,0.13114754098360656,0.08571428571428572
"[1, 0, 0, 0, 0, 0, 0, 0, 0, 1, 1, 0, 0, 0, 1]",1173,563,610,61,54,0.108348134991119,0.08852459016393442
"[1, 0, 0, 1, 1, 1, 0, 0, 0, 1, 0, 1, 1, 1, 1]",234,89,145,11,11,0.12359550561797752,0.07586206896551724
"[0, 1, 1, 1, 1, 1, 1, 0, 0, 0, 1, 1, 0, 1, 0]",206,111,95,13,7,0.11711711711711711,0.07368421052631578
"[1, 0, 1, 1, 1, 1, 1, 1, 1, 0, 1, 0, 0, 0, 0]",205,84,121,6,15,0.07142857142857142,0.12396694214876033
"[0, 0, 0, 1, 0, 1, 0, 0, 0, 1, 1, 0, 1, 1, 0]",135,80,55,6,8,0.075,0.14545454545454545
"[0, 1, 1, 0, 1, 0, 1, 1, 1, 1, 0, 1, 0, 0, 1]",167,68,99,7,7,0.10294117647058823,0.0707070707070707
"[0, 0, 1, 0, 1, 1, 0, 1, 1, 1, 1, 0, 0, 0, 1]",155,71,84,5,12,0.07042253521126761,0.14285714285714285
"[1, 0, 0, 0, 0, 1, 0, 1, 1, 0, 1, 1, 1, 1, 0]",129,61,68,9,4,0.14754098360655737,0.058823529411764705
"[0, 0, 0, 1, 1, 0, 0, 0, 0, 1, 0, 1, 1, 0, 1]",193,126,67,14,8,0.1111111111111111,0.11940298507462686
"[1, 1, 1, 1, 0, 1, 0, 0, 0, 0, 0, 1, 1, 0, 0]",214,97,117,12,9,0.12371134020618557,0.07692307692307693
"[0, 1, 0, 1, 0, 0, 0, 1, 1, 1, 1, 1, 1, 1, 0]",198,81,117,9,11,0.1111111111111111,0.09401709401709402
"[1, 0, 0, 0, 0, 1, 1, 1, 1, 0, 1, 1, 0, 0, 0]",187,67,120,9,21,0.13432835820895522,0.175
"[1, 1, 0, 0, 0, 0, 1, 1, 1, 1, 0, 1, 1, 0, 0]",252,103,149,7,13,0.06796116504854369,0.087248322147651
"[0, 1, 0, 0, 0, 1, 1, 0, 0, 1, 0, 1, 1, 1, 0]",97,55,42,4,2,0.07272727272727272,0.047619047619047616
"[0, 1, 1, 1, 1, 1, 1, 0, 0, 0, 1, 0, 0, 0, 0]",203,127,76,7,4,0.05511811023622047,0.05263157894736842
"[1, 0, 0, 1, 0, 1, 0, 0, 0, 0, 0, 1, 1, 1, 1]",256,127,129,13,11,0.10236220472440945,0.08527131782945736
"[0, 0, 1, 1, 0, 0, 1, 0, 1, 0, 0, 0, 0, 0, 1]",322,210,112,16,11,0.0761904761904762,0.09821428571428571
"[1, 0, 1, 0, 1, 1, 1, 0, 0, 1, 1, 0, 1, 1, 0]",158,64,94,3,4,0.046875,0.0425531914893617
"[1, 1, 1, 0, 1, 0, 0, 0, 1, 0, 0, 0, 0, 0, 1]",152,84,68,3,5,0.03571428571428571,0.07352941176470588
"[1, 1, 1, 1, 0, 0, 0, 1, 1, 1, 1, 1, 1, 1, 0]",823,233,590,20,51,0.08583690987124463,0.08644067796610169
"[0, 1, 0, 1, 1, 1, 1, 1, 0, 1, 0, 0, 1, 1, 0]",174,65,109,5,12,0.07692307692307693,0.11009174311926606
"[1, 1, 1, 0, 1, 0, 0, 0, 1, 1, 0, 1, 1, 1, 0]",136,51,85,4,9,0.0784313725490196,0.10588235294117647
"[1, 0, 0, 1, 0, 1, 0, 1, 0, 1, 1, 1, 1, 0, 1]",144,60,84,2,7,0.03333333333333333,0.08333333333333333
"[1, 1, 0, 1, 1, 0, 1, 0, 0, 1, 0, 1, 0, 1, 0]",113,58,55,7,6,0.1206896551724138,0.10909090909090909
"[1, 1, 0, 1, 0, 1, 0, 1, 1, 0, 1, 0, 0, 0, 1]",93,46,47,3,5,0.06521739130434782,0.10638297872340426
"[0, 0, 1, 1, 1, 1, 1, 0, 1, 1, 0, 1, 0, 1, 0]",172,64,108,10,9,0.15625,0.08333333333333333
"[1, 1, 0, 0, 1, 0, 1, 0, 0, 1, 0, 1, 1, 1, 0]",105,43,62,4,3,0.09302325581395349,0.04838709677419355
"[0, 1, 1, 1, 1, 1, 0, 1, 0, 1, 1, 1, 1, 0, 1]",520,182,338,18,36,0.0989010989010989,0.10650887573964497
"[0, 1, 1, 0, 1, 0, 0, 1, 0, 0, 0, 1, 0, 0, 0]",258,171,87,19,9,0.1111111111111111,0.10344827586206896
"[0, 1, 0, 1, 0, 0, 0, 1, 1, 1, 1, 0, 0, 0, 1]",124,62,62,6,7,0.0967741935483871,0.11290322580645161
"[1, 1, 0, 0, 1, 1, 1, 0, 1, 0, 1, 0, 0, 1, 1]",214,89,125,10,16,0.11235955056179775,0.128
"[1, 0, 1, 1, 1, 0, 0, 1, 1, 0, 0, 0, 1, 1, 0]",128,60,68,8,5,0.13333333333333333,0.07352941176470588
"[0, 0, 0, 0, 1, 0, 1, 0, 0, 1, 1, 1, 0, 1, 1]",137,76,61,4,4,0.05263157894736842,0.06557377049180328
"[0, 1, 0, 0, 1, 1, 0, 0, 1, 0, 0, 1, 0, 1, 1]",111,61,50,7,5,0.11475409836065574,0.1
"[1, 0, 0, 1, 1, 0, 1, 1, 0, 0, 0, 0, 0, 1, 0]",148,88,60,11,5,0.125,0.08333333333333333
"[1, 1, 0, 0, 1, 1, 1, 0, 1, 1, 0, 0, 0, 1, 1]",202,75,127,13,10,0.17333333333333334,0.07874015748031496
"[1, 1, 1, 0, 0, 1, 1, 1, 0, 1, 1, 0, 0, 0, 1]",187,59,128,8,9,0.13559322033898305,0.0703125
"[1, 0, 0, 0, 1, 0, 0, 0, 0, 1, 0, 1, 1, 1, 1]",181,82,99,6,14,0.07317073170731707,0.1414141414141414
"[0, 0, 1, 1, 0, 0, 0, 1, 1, 0, 0, 0, 1, 1, 0]",229,131,98,13,10,0.09923664122137404,0.10204081632653061
"[1, 0, 1, 0, 1, 1, 1, 0, 1, 1, 0, 0, 0, 0, 1]",137,59,78,6,4,0.1016949152542373,0.05128205128205128
"[0, 0, 0, 1, 1, 0, 1, 0, 1, 1, 1, 0, 1, 1, 0]",99,52,47,7,5,0.1346153846153846,0.10638297872340426
"[1, 0, 0, 0, 0, 1, 0, 1, 0, 0, 1, 0, 0, 0, 0]",521,330,191,39,17,0.11818181818181818,0.08900523560209424
"[0, 1, 1, 0, 1, 0, 1, 1, 0, 1, 0, 1, 0, 1, 0]",105,50,55,5,8,0.1,0.14545454545454545
"[0, 1, 0, 1, 1, 0, 1, 0, 1, 1, 0, 1, 0, 1, 0]",91,44,47,4,8,0.09090909090909091,0.1702127659574468
"[1, 1, 1, 0, 1, 0, 1, 1, 0, 1, 0, 1, 1, 0, 1]",230,75,155,3,18,0.04,0.11612903225806452
"[0, 1, 0, 0, 1, 0, 1, 1, 1, 0, 1, 0, 1, 1, 0]",104,48,56,5,3,0.10416666666666667,0.05357142857142857
"[0, 0, 1, 1, 1, 1, 1, 0, 0, 0, 1, 0, 0, 1, 0]",136,73,63,6,4,0.0821917808219178,0.06349206349206349
"[1, 0, 1, 1, 0, 0, 1, 0, 1, 0, 1, 1, 0, 1, 0]",88,42,46,7,5,0.16666666666666666,0.10869565217391304
"[0, 1, 0, 0, 1, 1, 0, 1, 1, 0, 0, 1, 0, 1, 0]",110,54,56,3,3,0.05555555555555555,0.05357142857142857
"[1, 0, 1, 0, 0, 1, 1, 1, 1, 0, 1, 1, 0, 1, 0]",140,50,90,3,11,0.06,0.12222222222222222
"[1, 1, 0, 0, 1, 1, 1, 1, 0, 1, 0, 0, 1, 1, 1]",465,169,296,13,34,0.07692307692307693,0.11486486486486487
"[1, 1, 1, 1, 1, 0, 0, 1, 1, 1, 1, 0, 1, 0, 0]",403,109,294,9,39,0.08256880733944955,0.1326530612244898
"[0, 1, 1, 1, 0, 1, 1, 1, 1, 1, 0, 0, 1, 1, 0]",355,125,230,12,16,0.096,0.06956521739130435
"[0, 1, 0, 1, 1, 0, 1, 1, 0, 0, 1, 1, 0, 1, 1]",151,63,88,7,7,0.1111111111111111,0.07954545454545454
"[0, 0, 0, 0, 0, 1, 0, 0, 1, 1, 1, 0, 1, 1, 1]",167,110,57,12,3,0.10909090909090909,0.05263157894736842
"[0, 0, 0, 0, 0, 0, 1, 0, 0, 1, 1, 1, 0, 1, 1]",201,127,74,10,6,0.07874015748031496,0.08108108108108109
"[0, 1, 1, 0, 0, 1, 0, 1, 1, 1, 1, 1, 0, 1, 1]",279,115,164,9,15,0.0782608695652174,0.09146341463414634
"[1, 1, 1, 1, 1, 0, 1, 0, 0, 0, 0, 1, 1, 1, 0]",170,75,95,9,15,0.12,0.15789473684210525
"[1, 0, 0, 1, 1, 0, 1, 0, 1, 1, 1, 1, 1, 1, 0]",331,98,233,10,13,0.10204081632653061,0.055793991416309016
"[1, 0, 0, 0, 0, 0, 0, 1, 0, 1, 0, 1, 0, 1, 0]",231,149,82,14,3,0.09395973154362416,0.036585365853658534
"[1, 1, 0, 1, 1, 0, 1, 0, 1, 1, 0, 1, 1, 0, 1]",200,65,135,4,15,0.06153846153846154,0.1111111111111111
"[0, 1, 1, 0, 1, 1, 0, 1, 0, 1, 1, 0, 1, 1, 0]",123,57,66,9,2,0.15789473684210525,0.030303030303030304
"[0, 1, 1, 0, 0, 1, 0, 1, 1, 1, 0, 0, 0, 1, 1]",150,78,72,6,5,0.07692307692307693,0.06944444444444445
"[0, 0, 0, 0, 1, 1, 0, 1, 0, 0, 0, 1, 0, 1, 0]",228,156,72,16,9,0.10256410256410256,0.125
"[0, 1, 0, 1, 1, 1, 0, 1, 0, 1, 0, 0, 1, 1, 1]",163,71,92,10,7,0.14084507042253522,0.07608695652173914
"[1, 1, 1, 1, 0, 0, 1, 0, 1, 1, 1, 0, 1, 0, 0]",143,59,84,11,6,0.1864406779661017,0.07142857142857142
"[1, 1, 1, 1, 1, 1, 0, 0, 1, 0, 1, 1, 1, 0, 1]",600,160,440,14,44,0.0875,0.1
"[1, 0, 1, 1, 0, 0, 0, 1, 1, 0, 0, 0, 1, 0, 0]",154,84,70,8,3,0.09523809523809523,0.04285714285714286
"[1, 0, 0, 0, 1, 1, 1, 0, 1, 0, 0, 1, 1, 1, 0]",102,46,56,6,5,0.13043478260869565,0.08928571428571429
"[0, 1, 0, 0, 0, 1, 0, 0, 0, 1, 1, 1, 0, 1, 0]",137,82,55,6,6,0.07317073170731707,0.10909090909090909
"[0, 1, 0, 0, 1, 1, 0, 0, 0, 0, 1, 1, 1, 0, 1]",135,72,63,14,5,0.19444444444444445,0.07936507936507936
"[0, 1, 0, 0, 1, 0, 0, 0, 1, 1, 0, 0, 0, 0, 1]",341,216,125,16,9,0.07407407407407407,0.072
"[0, 0, 0, 0, 1, 1, 1, 1, 0, 1, 0, 1, 1, 1, 1]",339,152,187,15,21,0.09868421052631579,0.11229946524064172
"[0, 1, 1, 0, 0, 1, 0, 0, 1, 0, 1, 1, 1, 0, 1]",90,46,44,1,5,0.021739130434782608,0.11363636363636363
"[0, 0, 1, 1, 0, 1, 0, 0, 1, 1, 1, 1, 1, 1, 1]",474,179,295,24,25,0.1340782122905028,0.0847457627118644
"[1, 0, 1, 1, 0, 1, 1, 0, 1, 0, 1, 1, 0, 1, 1]",209,83,126,9,12,0.10843373493975904,0.09523809523809523
"[0, 1, 1, 0, 0, 0, 1, 1, 1, 0, 0, 1, 0, 0, 1]",118,73,45,9,6,0.1232876712328767,0.13333333333333333
"[1, 0, 0, 0, 1, 1, 0, 0, 1, 0, 1, 0, 0, 1, 1]",117,48,69,5,7,0.10416666666666667,0.10144927536231885
"[0, 1, 1, 1, 1, 1, 1, 0, 0, 0, 1, 1, 0, 0, 1]",286,135,151,13,12,0.0962962962962963,0.07947019867549669
"[0, 1, 1, 1, 0, 1, 1, 0, 0, 1, 0, 0, 0, 0, 0]",189,114,75,12,12,0.10526315789473684,0.16
"[0, 0, 1, 1, 1, 0, 1, 1, 0, 0, 1, 0, 0, 0, 0]",187,94,93,8,9,0.0851063829787234,0.0967741935483871
"[0, 0, 1, 0, 0, 1, 1, 1, 0, 1, 1, 0, 0, 1, 0]",125,72,53,11,3,0.1527777777777778,0.05660377358490566
"[0, 1, 0, 1, 0, 1, 1, 0, 1, 0, 1, 0, 0, 1, 0]",92,57,35,4,6,0.07017543859649122,0.17142857142857143
"[1, 1, 1, 1, 1, 1, 1, 0, 1, 0, 1, 0, 0, 1, 1]",739,197,542,23,50,0.116751269035533,0.09225092250922509
"[1, 1, 1, 1, 1, 1, 1, 1, 1, 0, 1, 0, 1, 0, 0]",743,198,545,18,52,0.09090909090909091,0.09541284403669725
"[1, 0, 0, 0, 1, 0, 0, 0, 1, 0, 0, 0, 1, 0, 0]",462,328,134,34,17,0.10365853658536585,0.12686567164179105
"[1, 0, 0, 0, 0, 1, 0, 0, 0, 0, 1, 1, 1, 1, 1]",274,129,145,22,17,0.17054263565891473,0.11724137931034483
"[0, 1, 1, 0, 0, 1, 0, 0, 1, 0, 1, 1, 1, 0, 0]",125,74,51,8,3,0.10810810810810811,0.058823529411764705
"[1, 1, 1, 1, 1, 0, 0, 0, 0, 1, 0, 0, 1, 0, 1]",157,49,108,6,5,0.12244897959183673,0.046296296296296294
"[1, 1, 1, 1, 1, 1, 1, 1, 1, 0, 0, 0, 0, 1, 0]",631,139,492,16,51,0.11510791366906475,0.10365853658536585
"[0, 0, 1, 1, 0, 1, 1, 1, 1, 1, 0, 1, 1, 0, 0]",179,77,102,3,9,0.03896103896103896,0.08823529411764706
"[0, 0, 1, 0, 1, 0, 0, 0, 1, 0, 0, 1, 0, 1, 0]",226,142,84,13,8,0.09154929577464789,0.09523809523809523
"[0, 0, 0, 0, 1, 1, 0, 1, 1, 1, 0, 1, 0, 0, 0]",162,102,60,11,4,0.10784313725490197,0.06666666666666667
"[0, 1, 0, 0, 0, 0, 1, 1, 0, 1, 1, 1, 0, 1, 0]",100,48,52,7,6,0.14583333333333334,0.11538461538461539
"[1, 1, 1, 1, 1, 1, 0, 1, 0, 1, 0, 0, 0, 0, 0]",194,89,105,7,13,0.07865168539325842,0.12380952380952381
"[0, 1, 0, 0, 1, 1, 1, 1, 0, 1, 1, 0, 1, 1, 1]",274,101,173,11,26,0.10891089108910891,0.15028901734104047
"[0, 0, 1, 1, 0, 1, 0, 1, 1, 1, 1, 0, 1, 0, 1]",157,71,86,8,9,0.11267605633802817,0.10465116279069768
"[1, 1, 0, 0, 1, 0, 1, 1, 0, 1, 0, 1, 0, 0, 1]",95,44,51,4,5,0.09090909090909091,0.09803921568627451
"[0, 1, 1, 1, 0, 0, 1, 0, 1, 1, 0, 1, 0, 1, 0]",92,50,42,6,2,0.12,0.047619047619047616
"[0, 1, 0, 1, 1, 0, 0, 1, 0, 0, 0, 0, 1, 0, 1]",129,76,53,10,4,0.13157894736842105,0.07547169811320754
"[0, 1, 1, 0, 1, 0, 1, 1, 0, 0, 1, 0, 1, 0, 1]",110,44,66,6,11,0.13636363636363635,0.16666666666666666
"[0, 0, 1, 1, 1, 0, 1, 0, 1, 1, 1, 0, 0, 1, 0]",141,68,73,1,7,0.014705882352941176,0.0958904109589041
"[0, 0, 0, 1, 1, 1, 0, 1, 0, 1, 1, 1, 0, 0, 1]",166,74,92,11,11,0.14864864864864866,0.11956521739130435
"[0, 1, 1, 0, 0, 0, 1, 1, 1, 1, 0, 1, 1, 1, 1]",327,138,189,17,21,0.12318840579710146,0.1111111111111111
"[1, 0, 0, 0, 0, 0, 0, 1, 0, 0, 0, 0, 1, 1, 1]",676,338,338,18,36,0.05325443786982249,0.10650887573964497
"[1, 0, 1, 1, 1, 0, 1, 0, 0, 0, 0, 0, 0, 1, 1]",186,91,95,6,8,0.06593406593406594,0.08421052631578947
"[0, 1, 0, 1, 1, 1, 0, 1, 0, 0, 0, 0, 0, 0, 1]",158,100,58,8,4,0.08,0.06896551724137931
"[0, 1, 0, 1, 0, 1, 1, 0, 1, 0, 0, 1, 1, 0, 0]",124,66,58,9,7,0.13636363636363635,0.1206896551724138
"[0, 0, 1, 0, 0, 1, 0, 1, 1, 0, 0, 1, 0, 1, 0]",129,77,52,9,4,0.11688311688311688,0.07692307692307693
"[1, 1, 0, 1, 0, 0, 0, 1, 0, 0, 1, 0, 1, 1, 0]",103,45,58,4,6,0.08888888888888889,0.10344827586206896
"[0, 1, 1, 0, 0, 0, 1, 1, 0, 0, 1, 0, 0, 1, 0]",169,108,61,15,5,0.1388888888888889,0.08196721311475409
"[0, 0, 0, 0, 1, 0, 1, 1, 1, 0, 0, 1, 0, 1, 0]",150,84,66,7,5,0.08333333333333333,0.07575757575757576
"[0, 1, 1, 1, 0, 1, 1, 0, 0, 1, 1, 1, 0, 1, 1]",254,104,150,13,21,0.125,0.14
"[1, 1, 0, 1, 1, 1, 1, 0, 0, 0, 0, 0, 0, 0, 0]",520,282,238,31,29,0.1099290780141844,0.12184873949579832
"[0, 1, 0, 0, 0, 0, 0, 0, 0, 1, 1, 0, 1, 1, 0]",266,174,92,19,6,0.10919540229885058,0.06521739130434782
"[1, 0, 0, 0, 1, 1, 1, 1, 0, 1, 1, 1, 0, 0, 0]",149,65,84,13,6,0.2,0.07142857142857142
"[0, 0, 1, 0, 0, 0, 1, 1, 1, 1, 0, 1, 1, 1, 0]",113,62,51,7,5,0.11290322580645161,0.09803921568627451
"[0, 0, 1, 0, 0, 0, 0, 1, 0, 0, 0, 1, 1, 1, 1]",273,171,102,21,5,0.12280701754385964,0.049019607843137254
"[0, 1, 1, 1, 0, 1, 1, 0, 1, 0, 1, 0, 1, 1, 0]",143,72,71,5,4,0.06944444444444445,0.056338028169014086
"[1, 0, 0, 1, 0, 1, 0, 1, 1, 0, 1, 0, 1, 0, 1]",121,57,64,3,4,0.05263157894736842,0.0625
"[1, 1, 0, 0, 0, 0, 1, 1, 1, 1, 0, 0, 1, 0, 0]",306,160,146,13,13,0.08125,0.08904109589041095
"[1, 0, 0, 0, 0, 1, 1, 0, 1, 1, 1, 1, 1, 1, 1]",546,144,402,18,38,0.125,0.0945273631840796
"[0, 1, 1, 0, 0, 1, 1, 0, 1, 1, 1, 1, 1, 1, 1]",882,381,501,34,40,0.08923884514435695,0.07984031936127745
"[0, 1, 0, 1, 1, 0, 1, 1, 0, 1, 1, 1, 1, 0, 0]",176,75,101,12,4,0.16,0.039603960396039604
"[1, 1, 1, 0, 1, 0, 1, 0, 1, 1, 0, 1, 1, 0, 1]",209,62,147,6,21,0.0967741935483871,0.14285714285714285
"[1, 0, 1, 1, 1, 0, 1, 0, 0, 0, 1, 1, 1, 1, 0]",191,79,112,13,14,0.16455696202531644,0.125
"[0, 0, 0, 1, 1, 1, 1, 1, 0, 1, 1, 0, 1, 1, 1]",379,177,202,12,20,0.06779661016949153,0.09900990099009901
"[0, 0, 0, 1, 1, 0, 0, 1, 1, 1, 0, 1, 0, 1, 1]",202,127,75,17,4,0.13385826771653545,0.05333333333333334
"[1, 0, 1, 1, 0, 0, 0, 0, 0, 0, 0, 1, 0, 0, 0]",590,407,183,34,12,0.08353808353808354,0.06557377049180328
"[0, 1, 1, 0, 0, 0, 0, 0, 1, 1, 0, 1, 1, 0, 0]",217,141,76,14,11,0.09929078014184398,0.14473684210526316
"[0, 1, 0, 1, 0, 1, 0, 1, 1, 1, 1, 1, 1, 1, 1]",755,251,504,24,42,0.09561752988047809,0.08333333333333333
"[0, 1, 1, 0, 0, 1, 1, 0, 0, 1, 1, 1, 1, 1, 0]",418,285,133,35,16,0.12280701754385964,0.12030075187969924
"[0, 1, 0, 1, 0, 0, 1, 1, 0, 1, 1, 1, 1, 1, 1]",310,121,189,15,15,0.12396694214876033,0.07936507936507936
"[1, 0, 1, 1, 0, 1, 0, 1, 0, 1, 0, 1, 0, 0, 1]",118,57,61,2,4,0.03508771929824561,0.06557377049180328
"[1, 0, 0, 0, 1, 1, 1, 0, 1, 1, 0, 1, 0, 1, 0]",119,55,64,3,4,0.05454545454545454,0.0625
"[1, 1, 0, 1, 0, 0, 0, 1, 0, 0, 0, 1, 1, 1, 0]",115,60,55,7,2,0.11666666666666667,0.03636363636363636
"[1, 0, 0, 1, 1, 0, 0, 0, 0, 1, 0, 1, 0, 1, 1]",211,71,140,7,20,0.09859154929577464,0.14285714285714285
"[0, 0, 0, 1, 0, 0, 0, 0, 0, 1, 1, 1, 0, 1, 0]",231,151,80,13,12,0.08609271523178808,0.15
"[1, 0, 1, 1, 0, 0, 0, 1, 1, 0, 0, 0, 0, 0, 0]",475,291,184,31,20,0.10652920962199312,0.10869565217391304
"[0, 1, 1, 0, 0, 1, 0, 0, 1, 0, 1, 0, 0, 0, 0]",271,176,95,17,6,0.09659090909090909,0.06315789473684211
"[0, 0, 0, 0, 0, 0, 1, 0, 1, 1, 1, 1, 1, 0, 0]",278,173,105,10,5,0.057803468208092484,0.047619047619047616
"[0, 0, 0, 0, 0, 0, 0, 1, 0, 1, 1, 1, 1, 1, 0]",247,148,99,12,10,0.08108108108108109,0.10101010101010101
"[1, 0, 0, 0, 0, 1, 0, 0, 0, 0, 1, 0, 0, 1, 0]",516,357,159,41,11,0.11484593837535013,0.06918238993710692
"[1, 1, 1, 0, 0, 1, 0, 0, 1, 0, 0, 0, 0, 1, 0]",133,73,60,9,3,0.1232876712328767,0.05
"[1, 0, 0, 1, 1, 1, 0, 1, 0, 1, 1, 0, 1, 0, 1]",161,57,104,5,13,0.08771929824561403,0.125
"[1, 0, 0, 0, 1, 1, 0, 0, 1, 1, 0, 1, 1, 1, 1]",203,72,131,6,12,0.08333333333333333,0.0916030534351145
"[1, 1, 1, 1, 0, 0, 1, 1, 0, 1, 0, 0, 0, 0, 0]",237,110,127,5,11,0.045454545454545456,0.08661417322834646
"[0, 0, 1, 1, 1, 1, 1, 0, 1, 0, 1, 1, 1, 1, 0]",321,126,195,16,21,0.12698412698412698,0.1076923076923077
"[1, 1, 0, 1, 0, 1, 1, 1, 1, 1, 1, 1, 0, 0, 0]",425,134,291,13,16,0.09701492537313433,0.054982817869415807
"[1, 0, 1, 1, 1, 1, 1, 1, 1, 1, 0, 0, 0, 1, 0]",279,106,173,7,17,0.0660377358490566,0.09826589595375723
"[1, 1, 0, 0, 1, 0, 1, 0, 1, 0, 0, 1, 0, 1, 1]",134,64,70,6,6,0.09375,0.08571428571428572
"[1, 1, 1, 1, 1, 0, 1, 0, 1, 1, 0, 0, 1, 0, 1]",260,91,169,11,14,0.12087912087912088,0.08284023668639054
"[1, 0, 0, 0, 0, 1, 0, 1, 0, 1, 1, 1, 0, 0, 1]",134,64,70,5,6,0.078125,0.08571428571428572
"[0, 1, 1, 0, 0, 1, 0, 0, 1, 1, 0, 0, 0, 1, 1]",173,97,76,10,7,0.10309278350515463,0.09210526315789473
"[0, 0, 1, 0, 1, 0, 1, 1, 1, 0, 1, 1, 1, 1, 0]",148,60,88,3,3,0.05,0.03409090909090909
"[0, 1, 1, 0, 1, 1, 0, 0, 0, 0, 0, 1, 0, 1, 0]",144,75,69,9,10,0.12,0.14492753623188406
"[0, 1, 0, 1, 1, 1, 0, 0, 1, 0, 0, 0, 0, 0, 0]",309,203,106,20,5,0.09852216748768473,0.04716981132075472
"[0, 1, 1, 0, 0, 0, 0, 0, 1, 0, 0, 0, 1, 1, 0]",291,202,89,23,9,0.11386138613861387,0.10112359550561797
"[1, 0, 1, 0, 1, 0, 1, 0, 1, 0, 0, 1, 1, 0, 0]",167,92,75,6,3,0.06521739130434782,0.04
"[0, 1, 0, 0, 1, 1, 0, 1, 0, 1, 0, 1, 0, 1, 0]",85,54,31,3,5,0.05555555555555555,0.16129032258064516
"[0, 1, 0, 0, 0, 0, 1, 0, 0, 1, 1, 0, 1, 0, 1]",141,85,56,4,5,0.047058823529411764,0.08928571428571429
"[1, 0, 0, 1, 1, 0, 1, 0, 0, 1, 1, 0, 0, 0, 0]",245,126,119,11,8,0.0873015873015873,0.06722689075630252
"[1, 0, 1, 0, 1, 0, 0, 1, 0, 0, 1, 1, 1, 0, 0]",130,71,59,5,6,0.07042253521126761,0.1016949152542373
"[0, 1, 0, 0, 1, 1, 0, 1, 0, 0, 0, 0, 1, 0, 0]",227,148,79,13,8,0.08783783783783784,0.10126582278481013
"[0, 1, 0, 0, 0, 0, 1, 0, 0, 1, 1, 0, 1, 0, 0]",247,150,97,16,3,0.10666666666666667,0.030927835051546393
"[1, 0, 1, 1, 0, 0, 0, 1, 1, 1, 1, 1, 1, 0, 0]",321,135,186,12,25,0.08888888888888889,0.13440860215053763
"[0, 0, 1, 1, 0, 1, 0, 0, 0, 0, 0, 1, 0, 0, 1]",256,176,80,18,6,0.10227272727272728,0.075
"[0, 1, 1, 1, 1, 0, 1, 1, 0, 0, 0, 1, 1, 1, 1]",391,177,214,20,20,0.11299435028248588,0.09345794392523364
"[1, 1, 1, 0, 0, 1, 0, 1, 0, 0, 1, 0, 1, 0, 0]",118,65,53,9,7,0.13846153846153847,0.1320754716981132
"[0, 0, 0, 1, 0, 0, 0, 0, 0, 1, 1, 1, 1, 0, 1]",180,99,81,7,7,0.0707070707070707,0.08641975308641975
"[0, 1, 1, 0, 1, 1, 0, 1, 1, 0, 1, 1, 0, 0, 0]",111,42,69,7,9,0.16666666666666666,0.13043478260869565
"[0, 1, 0, 0, 1, 1, 0, 1, 1, 0, 1, 1, 0, 1, 1]",140,69,71,5,10,0.07246376811594203,0.14084507042253522
"[1, 1, 0, 0, 0, 0, 1, 0, 0, 0, 1, 0, 1, 0, 0]",270,176,94,18,13,0.10227272727272728,0.13829787234042554
"[0, 1, 1, 1, 0, 0, 0, 1, 0, 1, 0, 0, 1, 0, 1]",112,58,54,3,2,0.05172413793103448,0.037037037037037035
"[0, 1, 0, 1, 1, 0, 0, 0, 1, 1, 1, 1, 0, 0, 1]",193,87,106,4,10,0.04597701149425287,0.09433962264150944
"[0, 1, 0, 1, 0, 0, 1, 0, 1, 1, 0, 0, 0, 1, 1]",133,71,62,6,11,0.08450704225352113,0.1774193548387097
"[0, 0, 1, 1, 0, 0, 0, 1, 0, 1, 0, 1, 0, 0, 1]",188,100,88,8,2,0.08,0.022727272727272728
"[0, 0, 0, 0, 0, 1, 0, 0, 1, 1, 0, 0, 0, 1, 0]",578,440,138,48,18,0.10909090909090909,0.13043478260869565
"[0, 0, 1, 1, 1, 1, 1, 0, 1, 1, 0, 0, 1, 0, 1]",153,48,105,6,13,0.125,0.12380952380952381
"[1, 1, 0, 0, 0, 1, 0, 1, 0, 1, 1, 0, 0, 0, 1]",126,69,57,9,9,0.13043478260869565,0.15789473684210525
"[1, 0, 1, 1, 0, 1, 0, 0, 0, 1, 1, 1, 1, 1, 1]",375,130,245,9,24,0.06923076923076923,0.09795918367346938
"[1, 0, 0, 1, 1, 1, 0, 0, 1, 1, 0, 0, 0, 1, 0]",129,63,66,6,9,0.09523809523809523,0.13636363636363635
"[0, 1, 1, 0, 1, 0, 1, 0, 1, 1, 0, 0, 1, 1, 1]",238,106,132,6,13,0.05660377358490566,0.09848484848484848
"[0, 1, 0, 0, 0, 1, 0, 0, 1, 1, 0, 1, 0, 1, 0]",117,60,57,7,4,0.11666666666666667,0.07017543859649122
"[1, 0, 1, 1, 1, 0, 0, 1, 0, 0, 1, 0, 1, 1, 1]",165,65,100,12,3,0.18461538461538463,0.03
"[0, 1, 1, 0, 0, 0, 0, 1, 0, 1, 1, 0, 0, 1, 0]",159,95,64,10,2,0.10526315789473684,0.03125
"[1, 0, 1, 1, 0, 0, 0, 0, 1, 0, 1, 1, 0, 0, 1]",126,62,64,5,6,0.08064516129032258,0.09375
"[0, 0, 0, 0, 1, 1, 0, 1, 0, 1, 0, 0, 1, 1, 1]",229,138,91,17,12,0.12318840579710146,0.13186813186813187
"[0, 1, 0, 1, 1, 0, 0, 1, 1, 1, 0, 0, 0, 0, 0]",225,135,90,13,9,0.0962962962962963,0.1
"[0, 0, 1, 0, 1, 1, 0, 0, 1, 1, 1, 0, 0, 0, 0]",206,125,81,11,10,0.088,0.12345679012345678
"[0, 0, 0, 1, 0, 1, 1, 0, 0, 1, 1, 1, 0, 0, 0]",189,113,76,14,7,0.12389380530973451,0.09210526315789473
"[0, 1, 0, 1, 1, 1, 0, 0, 1, 1, 1, 1, 0, 1, 1]",262,104,158,10,11,0.09615384615384616,0.06962025316455696
"[0, 1, 0, 0, 0, 0, 0, 1, 1, 1, 1, 0, 0, 1, 0]",198,111,87,6,8,0.05405405405405406,0.09195402298850575
"[1, 0, 0, 0, 1, 0, 1, 1, 1, 1, 1, 0, 0, 1, 1]",245,82,163,5,15,0.06097560975609756,0.09202453987730061
"[1, 1, 1, 1, 0, 0, 0, 1, 0, 1, 1, 1, 1, 1, 0]",306,115,191,18,14,0.1565217391304348,0.07329842931937172
"[0, 1, 0, 0, 1, 1, 1, 1, 1, 1, 0, 0, 0, 0, 1]",455,221,234,23,20,0.10407239819004525,0.08547008547008547
"[1, 0, 0, 0, 1, 1, 1, 0, 1, 1, 1, 1, 0, 1, 1]",239,69,170,5,13,0.07246376811594203,0.07647058823529412
"[1, 1, 0, 1, 1, 0, 1, 1, 0, 0, 1, 1, 0, 0, 1]",282,88,194,5,21,0.056818181818181816,0.10824742268041238
"[0, 0, 1, 1, 1, 0, 1, 0, 1, 0, 0, 1, 0, 1, 1]",111,55,56,7,8,0.12727272727272726,0.14285714285714285
"[1, 1, 1, 1, 1, 0, 1, 1, 1, 1, 0, 0, 1, 0, 1]",539,153,386,16,35,0.10457516339869281,0.09067357512953368
"[0, 0, 1, 1, 1, 1, 0, 1, 1, 1, 0, 0, 0, 1, 1]",212,90,122,13,6,0.14444444444444443,0.04918032786885246
"[1, 1, 0, 1, 0, 0, 0, 0, 0, 0, 1, 0, 1, 0, 0]",252,170,82,14,14,0.08235294117647059,0.17073170731707318
"[1, 1, 0, 0, 1, 0, 0, 0, 0, 0, 1, 1, 1, 1, 1]",287,134,153,12,13,0.08955223880597014,0.08496732026143791
"[0, 1, 0, 1, 0, 0, 1, 1, 1, 1, 1, 1, 1, 0, 0]",265,112,153,13,15,0.11607142857142858,0.09803921568627451
"[0, 1, 1, 1, 0, 1, 1, 1, 0, 0, 1, 1, 1, 1, 0]",352,132,220,18,24,0.13636363636363635,0.10909090909090909
"[0, 0, 1, 0, 0, 1, 1, 1, 1, 1, 1, 0, 1, 0, 1]",158,59,99,6,6,0.1016949152542373,0.06060606060606061
"[1, 0, 0, 1, 0, 0, 1, 1, 1, 1, 1, 1, 0, 1, 0]",180,80,100,7,7,0.0875,0.07
"[0, 0, 1, 1, 0, 1, 0, 0, 1, 0, 0, 1, 1, 1, 1]",195,100,95,7,3,0.07,0.031578947368421054
"[1, 0, 1, 0, 1, 1, 0, 1, 0, 0, 0, 0, 1, 0, 0]",117,68,49,5,3,0.07352941176470588,0.061224489795918366
"[1, 1, 0, 0, 0, 1, 1, 1, 1, 0, 0, 1, 1, 1, 0]",182,93,89,9,6,0.0967741935483871,0.06741573033707865
"[1, 0, 0, 1, 0, 1, 0, 0, 0, 1, 0, 1, 1, 0, 1]",98,57,41,4,2,0.07017543859649122,0.04878048780487805
"[0, 1, 0, 0, 1, 1, 1, 1, 1, 1, 1, 0, 0, 0, 0]",329,167,162,17,13,0.10179640718562874,0.08024691358024691
"[0, 1, 0, 0, 1, 0, 0, 1, 1, 1, 1, 1, 1, 1, 0]",202,85,117,9,11,0.10588235294117647,0.09401709401709402
"[0, 0, 1, 1, 1, 1, 0, 1, 0, 0, 0, 0, 1, 0, 0]",171,97,74,9,6,0.09278350515463918,0.08108108108108109
"[0, 0, 0, 0, 1, 0, 1, 1, 0, 0, 1, 1, 0, 0, 0]",428,290,138,27,18,0.09310344827586207,0.13043478260869565
"[0, 1, 0, 0, 1, 0, 0, 1, 1, 0, 0, 0, 1, 1, 1]",184,88,96,5,10,0.056818181818181816,0.10416666666666667
"[0, 1, 1, 0, 1, 0, 1, 1, 0, 0, 1, 1, 1, 1, 0]",220,93,127,6,7,0.06451612903225806,0.05511811023622047
"[0, 1, 1, 0, 0, 1, 0, 0, 1, 0, 0, 0, 0, 0, 1]",263,167,96,17,17,0.10179640718562874,0.17708333333333334
"[0, 0, 0, 0, 1, 0, 1, 1, 0, 0, 1, 0, 0, 1, 0]",222,145,77,19,6,0.1310344827586207,0.07792207792207792
"[0, 1, 0, 0, 1, 1, 1, 0, 1, 1, 0, 0, 0, 0, 1]",144,68,76,7,10,0.10294117647058823,0.13157894736842105
"[0, 1, 0, 1, 0, 0, 1, 1, 1, 0, 1, 1, 0, 0, 0]",131,66,65,7,10,0.10606060606060606,0.15384615384615385
"[1, 1, 1, 0, 0, 1, 0, 0, 1, 1, 0, 1, 0, 0, 0]",141,76,65,4,3,0.05263157894736842,0.046153846153846156
"[0, 0, 1, 1, 1, 1, 1, 1, 0, 1, 1, 0, 1, 1, 0]",291,110,181,9,18,0.08181818181818182,0.09944751381215469
"[1, 1, 1, 0, 1, 1, 1, 0, 1, 0, 0, 1, 1, 1, 1]",660,189,471,22,36,0.1164021164021164,0.07643312101910828
"[0, 1, 0, 0, 0, 1, 0, 1, 1, 1, 0, 0, 0, 1, 0]",132,82,50,11,7,0.13414634146341464,0.14
"[0, 0, 0, 0, 1, 0, 0, 0, 1, 0, 1, 1, 1, 0, 0]",271,174,97,24,9,0.13793103448275862,0.09278350515463918
"[1, 1, 1, 0, 0, 1, 1, 1, 1, 0, 0, 1, 0, 1, 1]",503,118,385,16,28,0.13559322033898305,0.07272727272727272
"[1, 1, 1, 1, 0, 0, 1, 1, 1, 1, 0, 0, 1, 0, 1]",562,214,348,17,29,0.0794392523364486,0.08333333333333333
"[1, 1, 1, 0, 0, 1, 1, 0, 1, 0, 0, 0, 1, 1, 0]",130,48,82,9,9,0.1875,0.10975609756097561
"[0, 0, 1, 1, 1, 1, 0, 1, 1, 0, 0, 0, 0, 0, 1]",171,87,84,14,8,0.16091954022988506,0.09523809523809523
"[0, 0, 0, 0, 1, 0, 1, 1, 1, 1, 0, 1, 0, 0, 0]",152,89,63,9,6,0.10112359550561797,0.09523809523809523
"[1, 0, 0, 1, 1, 0, 0, 0, 0, 1, 0, 0, 1, 1, 1]",308,82,226,10,18,0.12195121951219512,0.07964601769911504
"[1, 1, 1, 0, 0, 1, 1, 0, 1, 0, 1, 1, 1, 1, 1]",766,187,579,15,52,0.08021390374331551,0.08981001727115717
"[1, 0, 0, 1, 0, 0, 1, 1, 0, 0, 0, 0, 1, 1, 0]",347,195,152,21,11,0.1076923076923077,0.07236842105263158
"[0, 0, 1, 1, 1, 0, 0, 1, 0, 1, 0, 0, 0, 1, 1]",132,65,67,10,13,0.15384615384615385,0.19402985074626866
"[1, 1, 1, 0, 0, 1, 0, 0, 1, 1, 1, 0, 0, 1, 0]",97,49,48,6,5,0.12244897959183673,0.10416666666666667
"[1, 0, 0, 0, 0, 0, 1, 0, 0, 0, 1, 0, 1, 1, 1]",215,102,113,8,7,0.0784313725490196,0.061946902654867256
"[1, 1, 1, 0, 0, 0, 0, 1, 0, 0, 0, 0, 0, 1, 0]",275,156,119,15,12,0.09615384615384616,0.10084033613445378
"[0, 1, 1, 1, 1, 1, 1, 0, 0, 0, 0, 1, 0, 0, 0]",242,178,64,12,9,0.06741573033707865,0.140625
"[0, 1, 0, 0, 1, 0, 1, 1, 1, 0, 1, 1, 1, 0, 0]",120,71,49,12,5,0.16901408450704225,0.10204081632653061
"[0, 1, 1, 0, 0, 1, 1, 1, 1, 0, 1, 0, 0, 1, 0]",157,85,72,12,6,0.1411764705882353,0.08333333333333333
"[1, 1, 0, 0, 1, 1, 1, 0, 0, 1, 1, 0, 1, 1, 0]",161,76,85,7,7,0.09210526315789473,0.08235294117647059
"[0, 0, 1, 1, 0, 0, 1, 1, 1, 0, 0, 1, 1, 0, 1]",160,80,80,13,7,0.1625,0.0875
"[1, 1, 0, 0, 0, 1, 1, 0, 0, 1, 1, 1, 0, 0, 1]",163,84,79,9,6,0.10714285714285714,0.0759493670886076
"[0, 0, 0, 1, 1, 0, 1, 1, 0, 1, 1, 1, 1, 0, 1]",153,62,91,11,11,0.1774193548387097,0.12087912087912088
"[0, 1, 1, 1, 0, 0, 0, 0, 1, 1, 1, 0, 0, 0, 1]",120,62,58,3,4,0.04838709677419355,0.06896551724137931
"[0, 0, 0, 0, 1, 1, 1, 0, 1, 0, 0, 0, 1, 1, 0]",184,117,67,17,6,0.1452991452991453,0.08955223880597014
"[0, 0, 0, 0, 1, 1, 0, 0, 1, 0, 0, 1, 0, 0, 0]",632,457,175,40,17,0.087527352297593,0.09714285714285714
"[0, 0, 0, 1, 0, 1, 0, 0, 0, 1, 1, 0, 0, 0, 1]",250,162,88,10,9,0.06172839506172839,0.10227272727272728
"[1, 0, 0, 0, 0, 1, 0, 0, 1, 0, 0, 1, 0, 1, 1]",187,104,83,9,9,0.08653846153846154,0.10843373493975904
"[0, 1, 1, 1, 0, 1, 0, 0, 0, 0, 1, 0, 0, 1, 0]",134,85,49,4,3,0.047058823529411764,0.061224489795918366
"[1, 0, 1, 0, 1, 0, 1, 0, 0, 1, 0, 1, 1, 0, 1]",104,40,64,3,3,0.075,0.046875
"[0, 1, 1, 1, 0, 0, 1, 1, 1, 1, 1, 0, 1, 0, 1]",270,104,166,17,12,0.16346153846153846,0.07228915662650602
"[1, 0, 1, 1, 1, 0, 1, 0, 0, 1, 1, 1, 1, 0, 0]",242,83,159,2,15,0.024096385542168676,0.09433962264150944
"[0, 1, 1, 1, 1, 0, 1, 1, 0, 0, 1, 0, 0, 0, 0]",131,68,63,6,9,0.08823529411764706,0.14285714285714285
"[1, 0, 1, 0, 1, 1, 1, 1, 0, 1, 1, 0, 0, 1, 0]",150,60,90,4,13,0.06666666666666667,0.14444444444444443
"[1, 0, 1, 0, 1, 0, 1, 1, 1, 1, 0, 1, 1, 0, 0]",173,72,101,7,9,0.09722222222222222,0.0891089108910891
"[1, 1, 1, 1, 1, 0, 1, 1, 1, 1, 0, 0, 0, 0, 1]",540,175,365,12,36,0.06857142857142857,0.09863013698630137
"[1, 0, 0, 1, 0, 0, 0, 1, 1, 0, 1, 1, 0, 0, 1]",118,57,61,9,5,0.15789473684210525,0.08196721311475409
"[0, 0, 0, 0, 1, 0, 0, 1, 1, 0, 1, 0, 1, 1, 0]",136,75,61,11,5,0.14666666666666667,0.08196721311475409
"[1, 1, 0, 1, 0, 1, 1, 1, 1, 0, 1, 0, 0, 0, 0]",135,56,79,4,10,0.07142857142857142,0.12658227848101267
"[0, 1, 1, 0, 1, 0, 1, 0, 1, 1, 1, 1, 1, 1, 0]",246,84,162,13,24,0.15476190476190477,0.14814814814814814
"[1, 0, 0, 1, 0, 1, 1, 1, 1, 1, 0, 0, 0, 0, 1]",208,112,96,7,9,0.0625,0.09375
"[1, 1, 1, 0, 1, 1, 0, 0, 1, 1, 1, 0, 1, 1, 0]",231,82,149,5,13,0.06097560975609756,0.087248322147651
"[0, 0, 0, 1, 1, 0, 1, 1, 0, 1, 1, 1, 1, 0, 0]",178,95,83,9,5,0.09473684210526316,0.060240963855421686
"[0, 1, 0, 0, 0, 0, 1, 1, 0, 1, 1, 0, 1, 1, 1]",137,69,68,5,4,0.07246376811594203,0.058823529411764705
"[1, 0, 0, 1, 0, 0, 0, 1, 1, 0, 1, 0, 0, 0, 0]",256,155,101,23,14,0.14838709677419354,0.13861386138613863
"[0, 1, 0, 1, 1, 1, 0, 0, 0, 1, 0, 0, 0, 0, 1]",161,100,61,10,4,0.1,0.06557377049180328
"[0, 1, 1, 1, 0, 0, 0, 0, 0, 1, 0, 1, 0, 0, 0]",248,177,71,17,6,0.096045197740113,0.08450704225352113
"[1, 1, 0, 0, 1, 1, 0, 1, 0, 0, 0, 1, 1, 1, 0]",122,56,66,8,6,0.14285714285714285,0.09090909090909091
"[0, 0, 1, 0, 1, 0, 0, 0, 1, 0, 0, 0, 1, 0, 0]",500,370,130,27,16,0.07297297297297298,0.12307692307692308
"[0, 0, 1, 1, 0, 1, 1, 1, 1, 0, 0, 1, 0, 1, 1]",173,69,104,2,10,0.028985507246376812,0.09615384615384616
"[0, 0, 1, 1, 1, 1, 1, 0, 1, 0, 0, 0, 0, 0, 1]",159,79,80,9,11,0.11392405063291139,0.1375
"[1, 1, 0, 1, 0, 1, 1, 0, 0, 1, 0, 1, 1, 1, 1]",269,87,182,14,17,0.16091954022988506,0.09340659340659341
"[0, 0, 0, 1, 0, 0, 1, 1, 1, 1, 1, 1, 1, 0, 1]",188,74,114,8,17,0.10810810810810811,0.14912280701754385
"[1, 1, 0, 0, 0, 0, 0, 1, 1, 1, 1, 0, 0, 0, 1]",182,96,86,8,11,0.08333333333333333,0.12790697674418605
"[1, 1, 1, 0, 0, 0, 1, 1, 1, 1, 0, 0, 0, 1, 0]",143,63,80,8,9,0.12698412698412698,0.1125
"[0, 0, 0, 1, 1, 0, 0, 1, 1, 1, 0, 0, 0, 1, 1]",230,156,74,15,10,0.09615384615384616,0.13513513513513514
"[0, 0, 1, 1, 1, 1, 1, 0, 0, 0, 0, 1, 0, 1, 0]",140,77,63,12,6,0.15584415584415584,0.09523809523809523
"[1, 1, 0, 0, 1, 1, 1, 0, 1, 1, 0, 1, 1, 1, 0]",265,86,179,8,16,0.09302325581395349,0.0893854748603352
"[0, 0, 1, 1, 1, 0, 0, 1, 1, 1, 0, 1, 1, 0, 1]",174,85,89,12,11,0.1411764705882353,0.12359550561797752
"[1, 0, 0, 1, 0, 1, 1, 0, 0, 0, 0, 0, 1, 0, 0]",254,161,93,19,14,0.11801242236024845,0.15053763440860216
"[0, 1, 0, 1, 1, 1, 0, 0, 1, 1, 1, 1, 0, 0, 0]",258,124,134,9,16,0.07258064516129033,0.11940298507462686
"[0, 0, 1, 0, 0, 0, 0, 1, 0, 1, 0, 1, 0, 1, 1]",187,117,70,11,8,0.09401709401709402,0.11428571428571428
"[1, 0, 0, 0, 1, 0, 0, 1, 0, 0, 0, 1, 0, 1, 0]",219,137,82,23,8,0.1678832116788321,0.0975609756097561
"[1, 0, 0, 0, 1, 0, 1, 1, 1, 0, 1, 0, 1, 1, 1]",160,70,90,8,6,0.11428571428571428,0.06666666666666667
"[1, 1, 1, 1, 1, 0, 0, 1, 1, 1, 0, 0, 0, 1, 1]",401,113,288,6,31,0.05309734513274336,0.1076388888888889
"[0, 0, 1, 0, 1, 1, 0, 1, 1, 1, 0, 0, 0, 0, 0]",206,112,94,11,16,0.09821428571428571,0.1702127659574468
"[1, 0, 1, 1, 0, 0, 0, 1, 0, 1, 1, 0, 1, 1, 1]",148,73,75,8,6,0.1095890410958904,0.08
"[1, 0, 1, 1, 0, 1, 0, 0, 0, 1, 1, 0, 1, 1, 0]",116,60,56,7,3,0.11666666666666667,0.05357142857142857
"[1, 1, 1, 1, 0, 0, 0, 0, 0, 0, 1, 0, 1, 0, 0]",252,132,120,11,12,0.08333333333333333,0.1
"[1, 1, 0, 0, 0, 0, 0, 1, 1, 0, 0, 1, 0, 1, 0]",163,93,70,6,4,0.06451612903225806,0.05714285714285714
"[0, 1, 1, 0, 0, 0, 0, 0, 1, 1, 0, 0, 1, 0, 1]",183,115,68,8,4,0.06956521739130435,0.058823529411764705
"[1, 1, 1, 0, 1, 0, 1, 0, 1, 0, 1, 1, 1, 0, 0]",163,72,91,2,9,0.027777777777777776,0.0989010989010989
"[0, 1, 1, 1, 0, 1, 0, 1, 0, 1, 0, 1, 1, 1, 0]",132,48,84,4,7,0.08333333333333333,0.08333333333333333
"[1, 0, 1, 1, 0, 1, 1, 1, 0, 1, 0, 1, 0, 1, 0]",130,51,79,5,4,0.09803921568627451,0.05063291139240506
"[0, 0, 1, 0, 1, 0, 1, 1, 0, 1, 1, 1, 0, 1, 0]",92,45,47,2,4,0.044444444444444446,0.0851063829787234
"[1, 0, 1, 1, 1, 0, 1, 1, 0, 0, 0, 0, 1, 1, 0]",184,77,107,7,13,0.09090909090909091,0.12149532710280374
"[1, 0, 0, 1, 1, 0, 1, 1, 0, 0, 1, 0, 1, 0, 0]",130,60,70,6,8,0.1,0.11428571428571428
"[1, 1, 1, 0, 0, 0, 0, 0, 1, 0, 0, 1, 1, 0, 1]",126,56,70,5,3,0.08928571428571429,0.04285714285714286
"[1, 1, 1, 0, 1, 1, 0, 1, 1, 1, 1, 0, 1, 0, 1]",516,164,352,18,29,0.10975609756097561,0.08238636363636363
"[0, 1, 0, 0, 1, 1, 0, 1, 0, 1, 1, 0, 0, 1, 1]",170,79,91,4,7,0.05063291139240506,0.07692307692307693
"[0, 1, 1, 1, 1, 1, 1, 0, 1, 1, 0, 1, 0, 1, 0]",243,94,149,7,13,0.07446808510638298,0.087248322147651
"[1, 0, 0, 1, 0, 0, 1, 1, 1, 0, 1, 1, 0, 1, 1]",144,61,83,5,4,0.08196721311475409,0.04819277108433735
"[1, 1, 1, 1, 0, 1, 1, 0, 0, 0, 0, 1, 0, 1, 1]",182,76,106,7,10,0.09210526315789473,0.09433962264150944
"[1, 0, 1, 1, 1, 1, 1, 0, 1, 1, 0, 0, 0, 0, 1]",196,70,126,5,9,0.07142857142857142,0.07142857142857142
"[0, 1, 1, 0, 0, 0, 1, 1, 1, 0, 0, 1, 0, 0, 0]",168,101,67,9,11,0.0891089108910891,0.16417910447761194
"[1, 1, 1, 0, 1, 1, 0, 0, 0, 1, 1, 1, 0, 0, 1]",153,56,97,3,8,0.05357142857142857,0.08247422680412371
"[1, 1, 0, 1, 0, 1, 1, 0, 0, 0, 0, 0, 1, 0, 1]",127,67,60,5,4,0.07462686567164178,0.06666666666666667
"[0, 0, 0, 1, 0, 1, 1, 1, 0, 1, 0, 1, 1, 0, 0]",133,66,67,4,8,0.06060606060606061,0.11940298507462686
"[0, 1, 1, 0, 1, 1, 0, 0, 0, 0, 1, 0, 0, 0, 0]",274,178,96,21,7,0.11797752808988764,0.07291666666666667
"[1, 0, 1, 1, 0, 1, 1, 0, 0, 0, 0, 1, 0, 0, 0]",153,92,61,5,8,0.05434782608695652,0.13114754098360656
"[1, 1, 0, 1, 0, 0, 1, 0, 1, 0, 0, 0, 1, 1, 0]",137,71,66,6,6,0.08450704225352113,0.09090909090909091
"[1, 0, 0, 0, 1, 1, 0, 1, 1, 1, 1, 1, 1, 0, 0]",255,93,162,8,15,0.08602150537634409,0.09259259259259259
"[1, 0, 1, 0, 0, 0, 1, 1, 0, 0, 1, 1, 1, 1, 0]",276,129,147,16,15,0.12403100775193798,0.10204081632653061
"[0, 1, 1, 1, 0, 0, 0, 1, 1, 0, 1, 1, 1, 0, 0]",156,81,75,4,11,0.04938271604938271,0.14666666666666667
"[1, 0, 0, 0, 0, 1, 0, 0, 0, 1, 1, 0, 0, 1, 0]",205,125,80,11,15,0.088,0.1875
"[1, 0, 1, 0, 0, 0, 1, 1, 1, 0, 1, 0, 1, 1, 0]",131,62,69,6,6,0.0967741935483871,0.08695652173913043
"[0, 0, 1, 0, 0, 1, 1, 1, 1, 1, 1, 0, 0, 1, 0]",163,86,77,10,7,0.11627906976744186,0.09090909090909091
"[0, 1, 1, 0, 0, 0, 1, 0, 0, 1, 0, 0, 1, 1, 0]",180,117,63,9,4,0.07692307692307693,0.06349206349206349
"[0, 0, 1, 0, 0, 1, 1, 1, 0, 0, 0, 0, 0, 0, 1]",392,230,162,16,18,0.06956521739130435,0.1111111111111111
"[0, 0, 1, 0, 0, 1, 0, 1, 1, 0, 1, 1, 1, 0, 1]",80,41,39,3,5,0.07317073170731707,0.1282051282051282
"[1, 1, 0, 1, 1, 1, 1, 0, 1, 0, 0, 0, 0, 0, 0]",175,86,89,13,13,0.1511627906976744,0.14606741573033707
"[0, 0, 1, 0, 1, 0, 0, 0, 0, 0, 0, 1, 1, 1, 1]",454,263,191,29,13,0.11026615969581749,0.06806282722513089
"[1, 0, 0, 0, 0, 0, 0, 1, 0, 0, 1, 1, 0, 0, 1]",345,200,145,17,11,0.085,0.07586206896551724
"[0, 1, 1, 0, 1, 0, 1, 0, 0, 1, 0, 0, 0, 0, 0]",288,183,105,18,10,0.09836065573770492,0.09523809523809523
"[0, 0, 1, 1, 0, 0, 1, 1, 0, 1, 0, 1, 0, 0, 1]",150,81,69,9,2,0.1111111111111111,0.028985507246376812
"[1, 1, 0, 1, 0, 0, 0, 1, 1, 0, 0, 0, 0, 1, 0]",169,95,74,8,9,0.08421052631578947,0.12162162162162163
"[1, 0, 0, 1, 1, 1, 0, 0, 0, 1, 0, 0, 0, 0, 1]",161,80,81,14,6,0.175,0.07407407407407407
"[0, 1, 1, 1, 0, 1, 1, 1, 1, 0, 0, 0, 0, 0, 1]",170,90,80,6,5,0.06666666666666667,0.0625
"[0, 0, 1, 0, 1, 0, 1, 0, 1, 1, 1, 1, 0, 0, 1]",132,57,75,3,7,0.05263157894736842,0.09333333333333334
"[1, 0, 1, 1, 0, 0, 1, 0, 0, 0, 1, 1, 0, 0, 1]",132,72,60,4,4,0.05555555555555555,0.06666666666666667
"[0, 0, 1, 0, 1, 1, 1, 1, 0, 0, 1, 0, 0, 0, 1]",122,59,63,4,5,0.06779661016949153,0.07936507936507936
"[0, 1, 1, 0, 0, 1, 0, 0, 0, 1, 1, 0, 1, 0, 0]",173,97,76,10,11,0.10309278350515463,0.14473684210526316
"[0, 1, 1, 1, 1, 0, 1, 1, 0, 1, 1, 0, 0, 0, 0]",166,88,78,13,7,0.14772727272727273,0.08974358974358974
"[0, 0, 1, 0, 1, 1, 0, 0, 1, 0, 0, 1, 1, 0, 1]",103,53,50,9,4,0.16981132075471697,0.08
"[0, 1, 1, 1, 0, 1, 0, 1, 0, 0, 1, 0, 1, 1, 0]",102,43,59,4,7,0.09302325581395349,0.11864406779661017
"[1, 0, 0, 1, 0, 1, 1, 1, 0, 1, 0, 1, 0, 0, 1]",119,55,64,6,4,0.10909090909090909,0.0625
"[1, 0, 1, 1, 0, 0, 0, 0, 1, 1, 0, 1, 0, 0, 1]",112,60,52,6,2,0.1,0.038461538461538464
"[0, 1, 0, 0, 1, 1, 0, 0, 1, 1, 1, 0, 0, 0, 0]",217,134,83,13,12,0.09701492537313433,0.14457831325301204
"[1, 1, 1, 0, 0, 1, 0, 1, 1, 1, 1, 1, 0, 0, 0]",214,92,122,10,21,0.10869565217391304,0.1721311475409836
"[0, 0, 0, 0, 1, 1, 1, 1, 1, 1, 1, 0, 0, 0, 1]",279,149,130,12,13,0.08053691275167785,0.1
"[1, 1, 1, 0, 0, 0, 1, 0, 0, 1, 0, 0, 1, 1, 1]",187,74,113,5,12,0.06756756756756757,0.10619469026548672
"[1, 1, 1, 1, 0, 0, 0, 1, 0, 0, 1, 0, 0, 1, 1]",186,86,100,6,6,0.06976744186046512,0.06
"[0, 1, 0, 1, 1, 1, 0, 1, 1, 0, 1, 1, 1, 0, 1]",246,96,150,8,15,0.08333333333333333,0.1
"[0, 1, 1, 1, 0, 1, 0, 0, 0, 1, 1, 0, 1, 0, 1]",120,48,72,4,4,0.08333333333333333,0.05555555555555555
"[1, 1, 0, 1, 0, 1, 1, 1, 0, 1, 0, 0, 0, 1, 1]",155,62,93,6,11,0.0967741935483871,0.11827956989247312
"[0, 0, 1, 0, 1, 1, 1, 1, 0, 1, 1, 1, 0, 1, 1]",232,79,153,8,16,0.10126582278481013,0.10457516339869281
"[0, 0, 1, 0, 0, 0, 0, 0, 1, 1, 0, 0, 0, 1, 1]",386,256,130,23,17,0.08984375,0.13076923076923078
"[1, 1, 0, 1, 1, 1, 1, 1, 0, 1, 0, 1, 0, 0, 0]",166,69,97,6,8,0.08695652173913043,0.08247422680412371
"[1, 1, 1, 1, 1, 1, 0, 0, 0, 1, 0, 0, 1, 0, 0]",164,90,74,4,2,0.044444444444444446,0.02702702702702703
"[0, 0, 0, 1, 1, 1, 0, 1, 1, 1, 0, 1, 1, 0, 0]",114,48,66,5,8,0.10416666666666667,0.12121212121212122
"[1, 1, 1, 1, 0, 0, 0, 0, 0, 0, 1, 0, 1, 0, 1]",202,101,101,11,10,0.10891089108910891,0.09900990099009901
"[1, 1, 0, 1, 1, 0, 1, 1, 1, 1, 0, 0, 0, 0, 0]",231,93,138,5,16,0.053763440860215055,0.11594202898550725
"[0, 0, 1, 1, 0, 0, 1, 0, 1, 1, 0, 0, 1, 1, 0]",168,91,77,8,7,0.08791208791208792,0.09090909090909091
"[0, 0, 0, 1, 1, 0, 1, 0, 0, 0, 0, 1, 0, 1, 0]",235,166,69,17,6,0.10240963855421686,0.08695652173913043
"[1, 0, 1, 0, 0, 1, 1, 1, 0, 1, 0, 0, 0, 1, 0]",104,52,52,3,3,0.057692307692307696,0.057692307692307696
"[0, 0, 0, 0, 0, 1, 1, 0, 0, 1, 0, 1, 0, 0, 1]",329,233,96,17,8,0.07296137339055794,0.08333333333333333
"[1, 1, 1, 1, 1, 0, 1, 0, 1, 1, 0, 0, 1, 1, 0]",326,106,220,9,22,0.08490566037735849,0.1
"[1, 1, 1, 1, 0, 0, 1, 1, 1, 0, 1, 1, 1, 0, 0]",355,118,237,8,26,0.06779661016949153,0.10970464135021098
"[1, 1, 1, 1, 1, 1, 0, 1, 0, 0, 0, 1, 1, 0, 1]",279,105,174,4,16,0.0380952380952381,0.09195402298850575
"[0, 1, 1, 1, 1, 1, 0, 0, 1, 0, 1, 0, 1, 1, 0]",145,60,85,7,9,0.11666666666666667,0.10588235294117647
"[0, 1, 1, 0, 0, 0, 1, 0, 1, 1, 1, 0, 0, 1, 0]",125,68,57,9,7,0.1323529411764706,0.12280701754385964
"[0, 0, 0, 0, 1, 0, 1, 0, 0, 1, 1, 1, 1, 1, 1]",250,141,109,20,13,0.14184397163120568,0.11926605504587157
"[1, 0, 0, 0, 1, 0, 1, 1, 1, 0, 1, 1, 1, 0, 1]",132,59,73,3,6,0.05084745762711865,0.0821917808219178
"[0, 1, 0, 0, 1, 1, 0, 1, 1, 0, 0, 1, 0, 0, 0]",139,75,64,9,4,0.12,0.0625
"[0, 1, 1, 1, 1, 1, 0, 0, 0, 1, 1, 1, 0, 0, 1]",195,84,111,7,13,0.08333333333333333,0.11711711711711711
"[0, 1, 1, 0, 0, 1, 1, 1, 0, 0, 1, 1, 1, 0, 0]",161,83,78,9,4,0.10843373493975904,0.05128205128205128
"[0, 0, 1, 1, 1, 1, 0, 1, 0, 1, 1, 0, 0, 1, 1]",235,100,135,15,12,0.15,0.08888888888888889
"[1, 1, 1, 1, 1, 1, 0, 1, 1, 1, 0, 0, 0, 0, 1]",477,150,327,14,23,0.09333333333333334,0.07033639143730887
"[1, 1, 1, 1, 0, 1, 0, 0, 0, 0, 1, 1, 0, 1, 1]",162,59,103,11,9,0.1864406779661017,0.08737864077669903
"[0, 1, 1, 1, 0, 1, 1, 1, 0, 0, 0, 1, 0, 1, 0]",106,49,57,1,5,0.02040816326530612,0.08771929824561403
"[1, 0, 0, 1, 1, 0, 1, 0, 0, 0, 0, 0, 0, 1, 0]",214,124,90,14,4,0.11290322580645161,0.044444444444444446
"[1, 1, 0, 0, 1, 0, 0, 1, 1, 0, 1, 1, 0, 0, 1]",125,57,68,7,3,0.12280701754385964,0.04411764705882353
"[1, 0, 1, 1, 1, 1, 0, 1, 0, 1, 0, 0, 0, 0, 1]",118,55,63,10,6,0.18181818181818182,0.09523809523809523
"[0, 1, 0, 0, 1, 1, 1, 1, 0, 1, 0, 0, 1, 1, 1]",187,80,107,6,7,0.075,0.06542056074766354
"[0, 1, 0, 1, 0, 0, 0, 0, 0, 1, 0, 0, 1, 1, 1]",237,157,80,15,9,0.09554140127388536,0.1125
"[0, 0, 1, 0, 1, 0, 1, 0, 0, 1, 0, 1, 0, 1, 1]",122,63,59,4,6,0.06349206349206349,0.1016949152542373
"[1, 1, 1, 1, 0, 1, 1, 1, 0, 1, 0, 0, 0, 1, 0]",149,58,91,6,12,0.10344827586206896,0.13186813186813187
"[1, 1, 0, 0, 0, 1, 1, 1, 0, 1, 1, 0, 1, 1, 1]",308,112,196,11,18,0.09821428571428571,0.09183673469387756
"[1, 1, 0, 0, 0, 1, 1, 1, 0, 0, 1, 1, 0, 0, 0]",215,112,103,11,9,0.09821428571428571,0.08737864077669903
"[0, 1, 0, 0, 0, 0, 1, 1, 0, 0, 0, 1, 1, 1, 0]",180,109,71,11,8,0.10091743119266056,0.11267605633802817
"[0, 1, 0, 1, 0, 0, 0, 1, 0, 1, 1, 1, 0, 0, 0]",149,88,61,10,9,0.11363636363636363,0.14754098360655737
"[1, 1, 0, 1, 1, 0, 1, 0, 0, 1, 0, 1, 1, 1, 0]",122,42,80,0,9,0.0,0.1125
"[1, 1, 1, 0, 1, 0, 1, 0, 1, 0, 1, 1, 1, 1, 1]",622,187,435,20,48,0.10695187165775401,0.1103448275862069
"[0, 1, 1, 1, 0, 0, 0, 0, 1, 0, 1, 0, 1, 0, 1]",120,67,53,6,5,0.08955223880597014,0.09433962264150944
"[0, 1, 1, 0, 0, 1, 0, 0, 1, 1, 1, 0, 1, 1, 0]",111,51,60,5,9,0.09803921568627451,0.15
"[0, 0, 0, 1, 0, 1, 0, 0, 1, 0, 0, 0, 1, 0, 0]",522,385,137,38,11,0.0987012987012987,0.08029197080291971
"[1, 1, 0, 0, 0, 0, 1, 0, 1, 0, 0, 1, 0, 0, 0]",289,178,111,18,15,0.10112359550561797,0.13513513513513514
"[0, 0, 1, 0, 0, 1, 0, 1, 1, 0, 0, 0, 0, 1, 0]",236,147,89,9,7,0.061224489795918366,0.07865168539325842
"[0, 1, 0, 1, 1, 1, 0, 1, 0, 0, 0, 1, 1, 0, 0]",134,75,59,8,12,0.10666666666666667,0.2033898305084746
"[1, 0, 1, 1, 0, 1, 1, 1, 0, 0, 0, 1, 0, 1, 1]",157,63,94,8,10,0.12698412698412698,0.10638297872340426
"[0, 0, 0, 1, 1, 1, 1, 0, 0, 0, 1, 0, 0, 1, 0]",215,156,59,14,8,0.08974358974358974,0.13559322033898305
"[1, 1, 0, 0, 1, 0, 1, 0, 1, 0, 1, 1, 0, 0, 0]",133,71,62,6,7,0.08450704225352113,0.11290322580645161
"[0, 1, 1, 0, 0, 1, 1, 0, 0, 1, 0, 1, 0, 1, 0]",134,86,48,8,4,0.09302325581395349,0.08333333333333333
"[0, 1, 0, 1, 1, 0, 0, 1, 1, 0, 0, 1, 1, 1, 0]",147,76,71,10,6,0.13157894736842105,0.08450704225352113
"[0, 1, 0, 0, 1, 0, 1, 1, 0, 0, 1, 1, 0, 0, 1]",213,125,88,10,6,0.08,0.06818181818181818
"[0, 1, 0, 0, 1, 0, 0, 1, 0, 1, 1, 0, 0, 1, 1]",160,76,84,12,6,0.15789473684210525,0.07142857142857142
"[0, 1, 1, 1, 1, 0, 1, 0, 1, 0, 1, 0, 1, 0, 0]",136,63,73,7,9,0.1111111111111111,0.1232876712328767
"[0, 1, 0, 0, 1, 1, 0, 0, 1, 1, 1, 1, 1, 0, 0]",169,82,87,6,8,0.07317073170731707,0.09195402298850575
"[1, 0, 0, 0, 0, 1, 0, 0, 1, 1, 0, 0, 1, 1, 1]",258,122,136,12,7,0.09836065573770492,0.051470588235294115
"[0, 0, 1, 0, 0, 0, 1, 1, 0, 1, 1, 0, 1, 1, 1]",142,73,69,7,7,0.0958904109589041,0.10144927536231885
"[0, 0, 0, 1, 0, 0, 0, 0, 0, 1, 0, 1, 0, 1, 0]",515,381,134,45,13,0.11811023622047244,0.09701492537313433
"[0, 1, 1, 0, 1, 1, 0, 1, 0, 0, 0, 0, 1, 1, 1]",191,89,102,11,8,0.12359550561797752,0.0784313725490196
"[0, 1, 1, 0, 0, 0, 0, 0, 1, 1, 1, 1, 0, 1, 0]",155,86,69,12,7,0.13953488372093023,0.10144927536231885
"[0, 0, 1, 1, 0, 1, 1, 1, 1, 1, 0, 1, 1, 1, 0]",246,85,161,6,13,0.07058823529411765,0.08074534161490683
"[1, 0, 1, 0, 1, 1, 0, 0, 0, 0, 1, 0, 1, 1, 0]",99,53,46,7,6,0.1320754716981132,0.13043478260869565
"[1, 1, 1, 0, 1, 1, 0, 0, 1, 1, 1, 0, 0, 1, 0]",159,65,94,8,8,0.12307692307692308,0.0851063829787234
"[1, 1, 0, 1, 1, 0, 1, 0, 0, 1, 0, 1, 0, 0, 1]",105,48,57,9,4,0.1875,0.07017543859649122
"[0, 1, 0, 0, 1, 1, 0, 1, 1, 1, 1, 0, 0, 1, 1]",233,102,131,12,7,0.11764705882352941,0.05343511450381679
"[1, 0, 1, 0, 0, 1, 1, 0, 1, 1, 1, 1, 0, 0, 1]",187,73,114,6,5,0.0821917808219178,0.043859649122807015
"[0, 0, 1, 0, 1, 0, 1, 1, 1, 1, 0, 1, 1, 0, 1]",147,56,91,5,11,0.08928571428571429,0.12087912087912088
"[1, 1, 1, 0, 0, 1, 0, 0, 1, 0, 0, 0, 0, 0, 1]",177,104,73,13,7,0.125,0.0958904109589041
"[0, 1, 0, 0, 0, 1, 1, 0, 0, 0, 0, 1, 1, 0, 1]",203,120,83,18,7,0.15,0.08433734939759036
"[0, 1, 1, 1, 0, 0, 1, 1, 1, 0, 0, 1, 1, 1, 1]",447,169,278,20,23,0.11834319526627218,0.08273381294964029
"[1, 1, 0, 0, 0, 1, 1, 0, 0, 0, 1, 0, 0, 0, 1]",153,96,57,14,2,0.14583333333333334,0.03508771929824561
"[0, 1, 1, 1, 0, 0, 0, 0, 0, 0, 1, 0, 0, 1, 1]",247,168,79,15,6,0.08928571428571429,0.0759493670886076
"[0, 0, 1, 1, 0, 1, 1, 1, 0, 0, 0, 0, 0, 0, 1]",248,144,104,18,7,0.125,0.0673076923076923
"[0, 1, 0, 1, 0, 1, 0, 0, 0, 1, 0, 0, 0, 1, 0]",223,152,71,9,6,0.05921052631578947,0.08450704225352113
"[1, 1, 1, 0, 0, 0, 0, 1, 1, 0, 1, 1, 0, 1, 0]",154,55,99,7,18,0.12727272727272726,0.18181818181818182
"[1, 0, 0, 0, 0, 0, 0, 1, 0, 0, 1, 1, 1, 1, 0]",259,131,128,10,9,0.07633587786259542,0.0703125
"[1, 1, 0, 0, 1, 0, 1, 0, 0, 1, 0, 1, 0, 1, 1]",115,50,65,4,8,0.08,0.12307692307692308
"[0, 0, 0, 1, 0, 1, 1, 1, 0, 1, 1, 0, 0, 1, 1]",143,68,75,10,9,0.14705882352941177,0.12
"[1, 0, 0, 0, 1, 1, 1, 0, 0, 1, 1, 0, 1, 1, 1]",198,81,117,8,11,0.09876543209876543,0.09401709401709402
"[0, 0, 0, 0, 1, 0, 0, 0, 1, 0, 0, 1, 1, 1, 0]",276,165,111,23,8,0.1393939393939394,0.07207207207207207
"[1, 1, 1, 0, 1, 1, 0, 0, 1, 1, 0, 1, 1, 1, 1]",663,184,479,17,54,0.09239130434782608,0.1127348643006263
"[1, 0, 1, 0, 1, 0, 0, 1, 0, 0, 0, 1, 0, 1, 1]",124,63,61,3,8,0.047619047619047616,0.13114754098360656
"[0, 1, 0, 0, 1, 1, 0, 0, 0, 1, 1, 1, 0, 0, 0]",190,106,84,14,6,0.1320754716981132,0.07142857142857142
"[0, 0, 1, 0, 0, 1, 1, 0, 1, 0, 1, 0, 0, 1, 0]",135,67,68,8,6,0.11940298507462686,0.08823529411764706
"[0, 0, 1, 1, 0, 1, 1, 0, 0, 1, 0, 1, 1, 1, 0]",106,52,54,7,3,0.1346153846153846,0.05555555555555555
"[0, 1, 0, 0, 0, 0, 1, 1, 0, 1, 1, 0, 0, 1, 0]",158,97,61,8,6,0.08247422680412371,0.09836065573770492
"[0, 0, 0, 1, 1, 1, 0, 0, 0, 0, 0, 1, 1, 0, 1]",177,119,58,14,4,0.11764705882352941,0.06896551724137931
"[1, 1, 0, 1, 0, 1, 1, 1, 0, 1, 1, 0, 1, 0, 0]",155,70,85,4,10,0.05714285714285714,0.11764705882352941
"[0, 0, 1, 0, 0, 1, 0, 0, 1, 1, 0, 0, 1, 1, 0]",242,138,104,15,10,0.10869565217391304,0.09615384615384616
"[0, 1, 1, 0, 0, 1, 0, 0, 1, 0, 0, 1, 0, 0, 1]",144,88,56,10,6,0.11363636363636363,0.10714285714285714
"[0, 0, 1, 0, 1, 1, 0, 0, 0, 1, 0, 0, 1, 1, 0]",174,100,74,14,8,0.14,0.10810810810810811
"[0, 0, 0, 1, 1, 1, 0, 1, 0, 1, 1, 0, 1, 1, 0]",123,71,52,9,4,0.1267605633802817,0.07692307692307693
"[1, 0, 0, 1, 1, 1, 0, 0, 1, 0, 0, 1, 1, 1, 1]",235,71,164,10,21,0.14084507042253522,0.12804878048780488
"[0, 0, 0, 1, 0, 1, 1, 1, 0, 0, 1, 0, 0, 1, 1]",160,92,68,12,3,0.13043478260869565,0.04411764705882353
"[1, 0, 1, 0, 0, 0, 1, 0, 1, 1, 1, 0, 0, 1, 0]",110,53,57,5,4,0.09433962264150944,0.07017543859649122
"[0, 1, 1, 1, 1, 0, 1, 0, 0, 0, 1, 0, 1, 1, 1]",179,85,94,7,6,0.08235294117647059,0.06382978723404255
"[1, 1, 0, 1, 0, 1, 0, 1, 0, 1, 0, 1, 0, 1, 1]",147,64,83,4,6,0.0625,0.07228915662650602
"[1, 1, 0, 0, 1, 0, 1, 1, 1, 1, 0, 1, 0, 1, 0]",147,61,86,6,10,0.09836065573770492,0.11627906976744186
"[0, 0, 0, 0, 1, 0, 0, 1, 1, 0, 0, 1, 1, 0, 1]",171,113,58,14,2,0.12389380530973451,0.034482758620689655
"[0, 0, 1, 0, 1, 0, 0, 1, 1, 1, 0, 1, 0, 1, 1]",116,54,62,5,7,0.09259259259259259,0.11290322580645161
"[0, 0, 1, 0, 0, 1, 1, 1, 0, 0, 1, 1, 1, 0, 0]",130,82,48,4,6,0.04878048780487805,0.125
"[0, 1, 1, 1, 0, 0, 1, 0, 1, 0, 0, 0, 1, 0, 0]",157,105,52,15,3,0.14285714285714285,0.057692307692307696
"[1, 0, 0, 0, 1, 0, 1, 1, 0, 1, 1, 1, 0, 1, 0]",89,36,53,3,5,0.08333333333333333,0.09433962264150944
"[1, 1, 1, 0, 1, 0, 0, 0, 1, 0, 1, 1, 1, 0, 1]",142,64,78,7,7,0.109375,0.08974358974358974
"[1, 0, 1, 0, 0, 0, 1, 0, 1, 1, 0, 0, 0, 0, 0]",333,218,115,19,11,0.0871559633027523,0.09565217391304348
"[0, 1, 1, 0, 1, 1, 1, 1, 0, 0, 1, 1, 0, 0, 1]",364,162,202,14,20,0.08641975308641975,0.09900990099009901
"[1, 0, 0, 0, 0, 1, 0, 1, 0, 1, 0, 1, 1, 0, 1]",118,60,58,5,3,0.08333333333333333,0.05172413793103448
"[1, 1, 0, 0, 0, 0, 1, 0, 1, 0, 1, 0, 1, 1, 0]",141,77,64,13,1,0.16883116883116883,0.015625
"[0, 1, 0, 1, 0, 0, 0, 0, 0, 0, 1, 0, 1, 0, 0]",506,374,132,31,12,0.08288770053475936,0.09090909090909091
"[1, 1, 0, 1, 0, 0, 0, 1, 0, 1, 1, 1, 0, 1, 0]",87,40,47,5,7,0.125,0.14893617021276595
"[0, 0, 0, 1, 1, 1, 1, 1, 0, 0, 1, 0, 0, 0, 1]",168,98,70,8,8,0.08163265306122448,0.11428571428571428
"[0, 1, 1, 0, 1, 0, 1, 0, 0, 0, 0, 0, 1, 1, 1]",187,110,77,18,3,0.16363636363636364,0.03896103896103896
"[1, 1, 1, 0, 1, 0, 0, 0, 0, 1, 1, 0, 1, 1, 0]",119,56,63,6,5,0.10714285714285714,0.07936507936507936
"[0, 0, 1, 1, 1, 0, 1, 0, 1, 1, 0, 0, 1, 1, 1]",260,110,150,10,15,0.09090909090909091,0.1
"[1, 0, 1, 0, 1, 1, 1, 0, 1, 1, 0, 0, 0, 0, 0]",162,70,92,5,6,0.07142857142857142,0.06521739130434782
"[1, 1, 0, 0, 1, 0, 0, 1, 0, 0, 0, 0, 1, 1, 1]",230,134,96,16,11,0.11940298507462686,0.11458333333333333
"[0, 1, 1, 0, 0, 1, 0, 0, 1, 0, 0, 0, 0, 1, 1]",251,156,95,14,4,0.08974358974358974,0.042105263157894736
"[1, 1, 1, 0, 0, 0, 0, 1, 1, 0, 0, 1, 0, 0, 1]",239,78,161,6,17,0.07692307692307693,0.10559006211180125
"[1, 1, 0, 1, 1, 0, 0, 0, 1, 1, 0, 0, 0, 0, 1]",217,101,116,14,15,0.13861386138613863,0.12931034482758622
"[1, 0, 1, 0, 1, 1, 0, 1, 0, 0, 1, 0, 0, 0, 1]",122,63,59,6,3,0.09523809523809523,0.05084745762711865
"[1, 1, 1, 0, 0, 0, 1, 0, 0, 1, 1, 0, 0, 1, 1]",210,90,120,7,5,0.07777777777777778,0.041666666666666664
"[0, 1, 0, 1, 1, 0, 0, 0, 0, 1, 0, 0, 0, 1, 1]",180,95,85,6,9,0.06315789473684211,0.10588235294117647
"[1, 1, 1, 0, 0, 0, 0, 0, 0, 0, 1, 1, 1, 1, 1]",579,202,377,31,38,0.15346534653465346,0.10079575596816977
"[0, 1, 1, 0, 0, 1, 0, 0, 1, 0, 0, 1, 0, 1, 0]",113,70,43,7,6,0.1,0.13953488372093023
"[0, 0, 0, 1, 0, 0, 0, 1, 1, 1, 0, 1, 0, 0, 0]",228,157,71,15,7,0.09554140127388536,0.09859154929577464
"[0, 0, 0, 0, 0, 0, 1, 0, 0, 0, 1, 1, 1, 0, 1]",249,167,82,13,5,0.07784431137724551,0.06097560975609756
"[0, 1, 0, 0, 0, 1, 0, 1, 1, 1, 0, 1, 0, 0, 0]",140,86,54,7,3,0.08139534883720931,0.05555555555555555
"[0, 1, 1, 0, 0, 0, 1, 1, 1, 1, 1, 1, 0, 0, 0]",306,171,135,20,14,0.11695906432748537,0.1037037037037037
"[1, 1, 0, 0, 0, 1, 1, 0, 1, 1, 0, 0, 0, 0, 0]",245,150,95,16,9,0.10666666666666667,0.09473684210526316
"[0, 0, 1, 0, 1, 1, 1, 0, 0, 1, 1, 1, 0, 0, 0]",122,65,57,7,5,0.1076923076923077,0.08771929824561403
"[0, 0, 1, 1, 1, 0, 0, 1, 0, 1, 1, 1, 0, 0, 1]",152,77,75,6,5,0.07792207792207792,0.06666666666666667
"[1, 0, 0, 0, 0, 1, 0, 1, 1, 1, 0, 0, 0, 1, 1]",122,59,63,5,3,0.0847457627118644,0.047619047619047616
"[0, 1, 1, 0, 1, 0, 1, 0, 0, 0, 0, 1, 0, 0, 0]",231,141,90,10,9,0.07092198581560284,0.1
"[1, 0, 1, 0, 0, 0, 1, 0, 1, 0, 0, 0, 0, 1, 0]",220,142,78,11,8,0.07746478873239436,0.10256410256410256
"[0, 0, 0, 0, 1, 0, 1, 0, 1, 0, 0, 1, 1, 0, 1]",137,74,63,7,5,0.0945945945945946,0.07936507936507936
"[1, 0, 0, 0, 0, 1, 0, 1, 0, 0, 0, 0, 0, 1, 0]",505,335,170,33,15,0.09850746268656717,0.08823529411764706
"[1, 1, 0, 0, 1, 1, 0, 1, 0, 0, 0, 0, 1, 1, 1]",214,101,113,4,15,0.039603960396039604,0.13274336283185842
"[0, 1, 1, 0, 0, 1, 1, 0, 1, 0, 0, 0, 0, 1, 1]",193,113,80,12,8,0.10619469026548672,0.1
"[0, 1, 0, 0, 1, 1, 0, 0, 0, 1, 0, 1, 1, 1, 0]",118,60,58,8,8,0.13333333333333333,0.13793103448275862
"[0, 0, 1, 0, 0, 0, 1, 1, 0, 1, 0, 0, 1, 1, 1]",146,75,71,10,4,0.13333333333333333,0.056338028169014086
"[0, 1, 1, 0, 0, 0, 0, 0, 1, 1, 1, 1, 1, 0, 0]",204,119,85,11,4,0.09243697478991597,0.047058823529411764
"[1, 1, 1, 1, 1, 0, 0, 1, 0, 0, 1, 0, 1, 1, 0]",150,50,100,2,9,0.04,0.09
"[0, 1, 0, 0, 0, 1, 0, 0, 0, 1, 0, 0, 1, 1, 1]",194,109,85,10,9,0.09174311926605505,0.10588235294117647
"[1, 1, 1, 1, 0, 0, 0, 1, 0, 1, 0, 0, 0, 0, 0]",223,126,97,13,10,0.10317460317460317,0.10309278350515463
"[0, 1, 0, 1, 0, 0, 1, 1, 0, 0, 1, 0, 0, 0, 1]",135,79,56,5,10,0.06329113924050633,0.17857142857142858
"[0, 1, 0, 0, 0, 1, 1, 0, 1, 1, 1, 1, 1, 1, 1]",390,136,254,15,24,0.11029411764705882,0.09448818897637795
"[1, 1, 1, 1, 0, 0, 1, 0, 0, 1, 0, 1, 0, 0, 0]",133,76,57,3,6,0.039473684210526314,0.10526315789473684
"[0, 0, 1, 1, 1, 0, 1, 0, 0, 1, 0, 0, 1, 1, 1]",140,61,79,7,12,0.11475409836065574,0.1518987341772152
"[1, 0, 0, 0, 1, 1, 1, 0, 1, 0, 0, 1, 0, 0, 1]",100,53,47,2,2,0.03773584905660377,0.0425531914893617
"[0, 1, 0, 1, 0, 1, 0, 1, 1, 1, 0, 0, 1, 0, 0]",128,63,65,5,7,0.07936507936507936,0.1076923076923077
"[0, 1, 0, 0, 0, 0, 1, 1, 0, 1, 1, 0, 1, 0, 0]",164,100,64,10,7,0.1,0.109375
"[0, 0, 1, 0, 0, 0, 0, 1, 1, 0, 1, 1, 0, 1, 0]",142,81,61,5,5,0.06172839506172839,0.08196721311475409
"[0, 1, 1, 1, 1, 0, 1, 0, 1, 1, 1, 0, 0, 0, 0]",188,99,89,18,5,0.18181818181818182,0.056179775280898875
"[1, 1, 0, 1, 0, 1, 1, 0, 1, 1, 0, 0, 1, 0, 1]",137,56,81,2,3,0.03571428571428571,0.037037037037037035
"[1, 1, 0, 1, 1, 0, 0, 0, 0, 1, 0, 1, 1, 1, 1]",201,84,117,7,12,0.08333333333333333,0.10256410256410256
"[1, 1, 1, 1, 1, 1, 1, 0, 0, 1, 0, 0, 1, 1, 0]",357,103,254,6,26,0.05825242718446602,0.10236220472440945
"[0, 0, 1, 0, 1, 1, 1, 1, 1, 1, 1, 1, 0, 0, 1]",476,186,290,13,25,0.06989247311827956,0.08620689655172414
"[0, 1, 1, 1, 1, 0, 0, 1, 0, 1, 1, 0, 0, 1, 0]",119,63,56,6,7,0.09523809523809523,0.125
"[0, 0, 1, 1, 0, 1, 1, 1, 0, 0, 1, 1, 0, 1, 1]",168,72,96,10,10,0.1388888888888889,0.10416666666666667
"[0, 1, 0, 0, 1, 1, 1, 0, 0, 1, 1, 1, 1, 0, 0]",249,120,129,9,9,0.075,0.06976744186046512
"[0, 0, 0, 1, 1, 1, 0, 1, 0, 0, 0, 0, 1, 1, 1]",213,136,77,9,10,0.0661764705882353,0.12987012987012986
"[1, 1, 1, 1, 1, 1, 0, 0, 0, 0, 0, 1, 1, 1, 0]",258,114,144,11,11,0.09649122807017543,0.0763888888888889
"[1, 1, 0, 1, 1, 0, 0, 0, 0, 0, 1, 0, 1, 1, 1]",166,79,87,8,13,0.10126582278481013,0.14942528735632185
"[1, 1, 1, 1, 0, 1, 1, 1, 0, 1, 1, 0, 0, 1, 0]",259,79,180,9,16,0.11392405063291139,0.08888888888888889
"[0, 1, 0, 0, 0, 0, 1, 0, 1, 0, 1, 0, 0, 1, 0]",183,123,60,16,7,0.13008130081300814,0.11666666666666667
"[1, 1, 1, 1, 1, 0, 0, 0, 0, 0, 1, 1, 0, 0, 1]",340,117,223,7,19,0.05982905982905983,0.08520179372197309
"[1, 1, 0, 0, 1, 0, 0, 1, 0, 1, 1, 1, 1, 0, 1]",132,49,83,7,3,0.14285714285714285,0.03614457831325301
"[1, 0, 1, 1, 1, 0, 0, 1, 1, 1, 0, 1, 1, 1, 0]",237,87,150,10,18,0.11494252873563218,0.12
"[0, 0, 1, 0, 1, 0, 0, 1, 1, 1, 1, 0, 1, 1, 0]",108,48,60,4,4,0.08333333333333333,0.06666666666666667
"[0, 0, 0, 1, 0, 1, 0, 0, 1, 1, 1, 1, 0, 1, 1]",127,71,56,8,6,0.11267605633802817,0.10714285714285714
"[0, 1, 0, 1, 1, 1, 1, 1, 1, 0, 0, 0, 0, 1, 0]",125,61,64,7,4,0.11475409836065574,0.0625
"[1, 1, 0, 1, 0, 1, 0, 0, 0, 1, 1, 0, 1, 0, 1]",89,47,42,6,4,0.1276595744680851,0.09523809523809523
"[0, 0, 0, 1, 0, 1, 1, 1, 1, 1, 1, 0, 0, 1, 1]",327,137,190,16,18,0.11678832116788321,0.09473684210526316
"[0, 0, 0, 0, 1, 0, 1, 1, 1, 1, 1, 1, 0, 0, 1]",186,86,100,14,13,0.16279069767441862,0.13
"[0, 0, 1, 1, 0, 1, 1, 1, 1, 0, 0, 1, 1, 1, 0]",171,78,93,7,12,0.08974358974358974,0.12903225806451613
"[1, 1, 1, 0, 1, 0, 1, 0, 1, 1, 0, 0, 1, 1, 1]",352,121,231,14,18,0.11570247933884298,0.07792207792207792
"[1, 1, 0, 0, 1, 1, 0, 1, 0, 1, 0, 1, 1, 1, 0]",153,57,96,4,8,0.07017543859649122,0.08333333333333333
"[1, 0, 0, 0, 0, 0, 0, 0, 1, 1, 1, 0, 1, 1, 1]",247,107,140,11,15,0.102803738317757,0.10714285714285714
"[0, 1, 1, 0, 1, 1, 1, 0, 0, 1, 0, 0, 1, 1, 0]",102,46,56,9,5,0.1956521739130435,0.08928571428571429
"[0, 1, 1, 1, 1, 1, 1, 0, 0, 1, 0, 0, 1, 1, 1]",448,262,186,24,19,0.0916030534351145,0.10215053763440861
"[0, 1, 0, 1, 0, 1, 1, 1, 0, 0, 0, 0, 0, 1, 0]",148,94,54,9,4,0.09574468085106383,0.07407407407407407
"[1, 0, 0, 0, 0, 0, 0, 1, 0, 1, 0, 1, 1, 1, 0]",144,89,55,5,2,0.056179775280898875,0.03636363636363636
"[0, 0, 1, 1, 0, 0, 1, 0, 0, 1, 1, 1, 1, 0, 0]",234,134,100,15,7,0.11194029850746269,0.07
"[1, 1, 0, 1, 1, 0, 0, 1, 1, 0, 0, 1, 0, 0, 1]",143,76,67,5,5,0.06578947368421052,0.07462686567164178
"[0, 1, 0, 1, 0, 1, 0, 1, 1, 1, 0, 1, 1, 1, 1]",298,103,195,12,16,0.11650485436893204,0.08205128205128205
"[0, 1, 0, 1, 1, 0, 1, 0, 1, 0, 1, 0, 1, 0, 1]",112,57,55,4,9,0.07017543859649122,0.16363636363636364
"[0, 0, 1, 0, 1, 1, 1, 1, 0, 1, 1, 1, 0, 0, 1]",143,68,75,2,6,0.029411764705882353,0.08
"[1, 1, 0, 1, 1, 1, 1, 1, 0, 1, 0, 1, 1, 0, 1]",492,165,327,15,39,0.09090909090909091,0.11926605504587157
"[1, 1, 1, 0, 0, 1, 1, 1, 1, 0, 0, 0, 1, 0, 1]",310,84,226,6,18,0.07142857142857142,0.07964601769911504
"[1, 1, 1, 0, 1, 1, 1, 1, 1, 1, 0, 0, 0, 0, 0]",414,144,270,10,13,0.06944444444444445,0.04814814814814815
"[0, 0, 1, 1, 1, 0, 0, 0, 0, 1, 1, 1, 1, 0, 1]",170,84,86,7,10,0.08333333333333333,0.11627906976744186
"[1, 1, 1, 1, 1, 0, 0, 0, 1, 1, 1, 0, 0, 0, 1]",258,78,180,10,8,0.1282051282051282,0.044444444444444446
"[1, 0, 0, 1, 0, 0, 1, 1, 0, 0, 0, 1, 1, 0, 1]",122,65,57,5,4,0.07692307692307693,0.07017543859649122
"[0, 1, 1, 0, 0, 0, 1, 1, 1, 1, 0, 0, 0, 1, 1]",169,86,83,6,10,0.06976744186046512,0.12048192771084337
"[0, 0, 1, 1, 1, 0, 0, 1, 0, 1, 1, 0, 1, 0, 0]",116,56,60,5,3,0.08928571428571429,0.05
"[0, 1, 0, 1, 0, 0, 1, 0, 0, 0, 1, 0, 1, 0, 0]",224,143,81,9,10,0.06293706293706294,0.12345679012345678
"[0, 1, 0, 1, 0, 0, 1, 0, 0, 0, 1, 1, 1, 1, 1]",156,76,80,8,5,0.10526315789473684,0.0625
"[1, 1, 1, 0, 0, 0, 0, 0, 1, 0, 1, 1, 0, 0, 1]",169,62,107,3,8,0.04838709677419355,0.07476635514018691
"[0, 1, 1, 0, 1, 1, 1, 0, 0, 0, 0, 0, 1, 0, 1]",98,53,45,3,7,0.05660377358490566,0.15555555555555556
"[1, 0, 1, 0, 0, 0, 1, 0, 0, 1, 1, 1, 1, 1, 0]",113,53,60,6,6,0.11320754716981132,0.1
"[0, 1, 0, 0, 1, 1, 1, 0, 1, 0, 0, 1, 0, 0, 1]",97,53,44,5,6,0.09433962264150944,0.13636363636363635
"[0, 1, 0, 1, 0, 1, 0, 0, 0, 0, 0, 0, 0, 1, 0]",524,365,159,38,12,0.10410958904109589,0.07547169811320754
"[0, 1, 0, 1, 0, 0, 1, 0, 0, 1, 1, 0, 0, 0, 0]",373,239,134,24,18,0.100418410041841,0.13432835820895522
"[1, 0, 0, 1, 0, 1, 0, 0, 1, 0, 0, 1, 1, 0, 0]",187,115,72,11,6,0.09565217391304348,0.08333333333333333
"[0, 0, 0, 1, 1, 1, 1, 0, 0, 0, 1, 0, 1, 1, 1]",305,217,88,15,8,0.06912442396313365,0.09090909090909091
"[1, 0, 1, 0, 1, 0, 1, 1, 0, 0, 0, 0, 1, 0, 1]",124,59,65,10,7,0.1694915254237288,0.1076923076923077
"[1, 1, 1, 0, 1, 0, 1, 0, 1, 1, 0, 0, 0, 0, 1]",155,71,84,5,2,0.07042253521126761,0.023809523809523808
"[0, 0, 0, 1, 1, 0, 0, 0, 1, 1, 0, 1, 1, 1, 1]",230,142,88,19,14,0.13380281690140844,0.1590909090909091
"[0, 1, 1, 1, 0, 0, 1, 1, 0, 0, 1, 1, 1, 1, 0]",485,210,275,27,21,0.12857142857142856,0.07636363636363637
"[0, 0, 1, 0, 0, 0, 0, 0, 0, 1, 0, 0, 1, 1, 1]",499,342,157,23,18,0.06725146198830409,0.11464968152866242
"[0, 0, 1, 1, 0, 1, 1, 1, 1, 1, 0, 1, 0, 1, 0]",131,54,77,9,8,0.16666666666666666,0.1038961038961039
"[1, 0, 0, 1, 1, 0, 0, 1, 1, 0, 1, 1, 1, 1, 1]",582,121,461,10,43,0.08264462809917356,0.09327548806941431
"[1, 0, 0, 1, 0, 0, 1, 0, 1, 0, 1, 1, 0, 1, 0]",113,59,54,4,5,0.06779661016949153,0.09259259259259259
"[1, 1, 1, 0, 1, 1, 0, 1, 1, 0, 1, 0, 1, 1, 0]",226,89,137,15,11,0.16853932584269662,0.08029197080291971
"[1, 0, 1, 0, 0, 1, 0, 0, 1, 0, 0, 0, 0, 0, 0]",604,417,187,37,11,0.08872901678657075,0.058823529411764705
"[0, 1, 1, 1, 1, 1, 1, 0, 0, 0, 0, 1, 0, 1, 1]",361,254,107,17,5,0.06692913385826772,0.04672897196261682
"[0, 0, 0, 0, 1, 1, 0, 0, 1, 0, 0, 0, 1, 1, 1]",473,303,170,23,10,0.07590759075907591,0.058823529411764705
"[1, 1, 1, 0, 0, 1, 0, 0, 0, 0, 1, 1, 1, 0, 1]",125,45,80,2,15,0.044444444444444446,0.1875
"[0, 0, 1, 1, 1, 1, 1, 1, 1, 1, 0, 0, 1, 0, 0]",422,187,235,20,16,0.10695187165775401,0.06808510638297872
"[0, 1, 0, 0, 1, 0, 1, 1, 1, 0, 0, 0, 0, 0, 0]",377,259,118,29,12,0.11196911196911197,0.1016949152542373
"[1, 1, 0, 0, 1, 1, 0, 0, 1, 0, 0, 0, 1, 0, 0]",211,129,82,12,6,0.09302325581395349,0.07317073170731707
"[0, 0, 1, 1, 0, 0, 1, 1, 1, 0, 1, 0, 0, 0, 1]",186,93,93,8,8,0.08602150537634409,0.08602150537634409
"[1, 1, 0, 1, 0, 0, 0, 1, 1, 0, 0, 1, 1, 1, 0]",131,64,67,4,5,0.0625,0.07462686567164178
"[0, 1, 0, 0, 0, 1, 0, 0, 0, 1, 1, 1, 0, 0, 0]",283,185,98,14,10,0.07567567567567568,0.10204081632653061
"[0, 0, 1, 0, 0, 0, 1, 0, 0, 0, 1, 1, 1, 0, 0]",272,184,88,11,8,0.059782608695652176,0.09090909090909091
"[1, 0, 0, 0, 1, 1, 0, 0, 0, 1, 1, 0, 1, 0, 0]",139,92,47,12,2,0.13043478260869565,0.0425531914893617
"[1, 0, 0, 1, 1, 1, 0, 0, 0, 1, 1, 0, 0, 0, 1]",139,63,76,8,9,0.12698412698412698,0.11842105263157894
"[0, 1, 1, 1, 1, 1, 0, 1, 0, 0, 0, 1, 1, 0, 0]",177,90,87,8,7,0.08888888888888889,0.08045977011494253
"[0, 1, 0, 0, 0, 1, 1, 1, 1, 1, 0, 1, 0, 0, 0]",112,59,53,5,5,0.0847457627118644,0.09433962264150944
"[1, 1, 1, 1, 0, 1, 1, 1, 1, 0, 1, 1, 1, 0, 0]",692,188,504,19,45,0.10106382978723404,0.08928571428571429
"[1, 1, 1, 1, 1, 0, 0, 0, 1, 0, 1, 1, 1, 1, 0]",324,104,220,12,19,0.11538461538461539,0.08636363636363636
"[1, 1, 0, 1, 0, 1, 0, 1, 1, 0, 1, 0, 0, 1, 0]",102,45,57,3,1,0.06666666666666667,0.017543859649122806
"[0, 0, 1, 1, 1, 0, 0, 1, 1, 1, 0, 1, 0, 1, 0]",132,59,73,7,7,0.11864406779661017,0.0958904109589041
"[0, 1, 0, 0, 0, 1, 0, 0, 1, 1, 1, 1, 0, 0, 0]",247,150,97,10,11,0.06666666666666667,0.1134020618556701
"[1, 1, 1, 0, 0, 1, 0, 0, 0, 1, 1, 1, 0, 1, 0]",96,41,55,2,8,0.04878048780487805,0.14545454545454545
"[1, 1, 1, 0, 0, 1, 0, 1, 0, 0, 1, 1, 1, 0, 0]",103,40,63,0,7,0.0,0.1111111111111111
"[1, 1, 1, 0, 1, 1, 0, 1, 0, 1, 1, 1, 0, 0, 1]",286,79,207,10,20,0.12658227848101267,0.0966183574879227
"[1, 1, 0, 0, 1, 0, 0, 0, 1, 1, 0, 0, 0, 0, 0]",403,245,158,22,12,0.08979591836734693,0.0759493670886076
"[1, 0, 1, 0, 0, 0, 1, 1, 0, 0, 1, 1, 0, 1, 0]",137,71,66,5,6,0.07042253521126761,0.09090909090909091
"[1, 0, 1, 0, 0, 1, 0, 0, 1, 0, 0, 1, 0, 1, 0]",129,74,55,4,2,0.05405405405405406,0.03636363636363636
"[0, 1, 0, 1, 0, 0, 1, 0, 0, 1, 0, 0, 1, 0, 1]",115,64,51,8,5,0.125,0.09803921568627451
"[1, 0, 0, 1, 0, 0, 1, 1, 0, 1, 0, 0, 0, 1, 0]",130,79,51,5,4,0.06329113924050633,0.0784313725490196
"[0, 1, 0, 0, 0, 1, 1, 0, 0, 1, 0, 1, 0, 0, 1]",124,79,45,6,0,0.0759493670886076,0.0
"[1, 0, 1, 1, 1, 0, 1, 1, 0, 1, 0, 1, 1, 0, 1]",262,84,178,6,15,0.07142857142857142,0.08426966292134831
"[0, 0, 1, 0, 1, 1, 1, 1, 0, 0, 0, 1, 0, 1, 1]",104,57,47,5,5,0.08771929824561403,0.10638297872340426
"[0, 0, 1, 0, 1, 1, 0, 0, 1, 0, 0, 1, 1, 1, 1]",183,83,100,6,11,0.07228915662650602,0.11
"[0, 0, 0, 0, 0, 1, 1, 1, 1, 0, 1, 0, 0, 1, 0]",200,130,70,15,6,0.11538461538461539,0.08571428571428572
"[1, 1, 0, 0, 1, 1, 1, 0, 0, 1, 1, 0, 1, 1, 1]",315,104,211,14,21,0.1346153846153846,0.0995260663507109
"[1, 0, 0, 0, 0, 0, 1, 1, 1, 1, 1, 0, 0, 0, 0]",312,180,132,16,5,0.08888888888888889,0.03787878787878788
"[1, 1, 0, 1, 0, 0, 0, 1, 0, 0, 1, 0, 0, 0, 1]",129,73,56,5,4,0.0684931506849315,0.07142857142857142
"[1, 1, 0, 0, 1, 0, 1, 1, 1, 0, 1, 1, 1, 1, 0]",236,81,155,12,20,0.14814814814814814,0.12903225806451613
"[0, 0, 1, 0, 0, 1, 1, 0, 0, 0, 1, 1, 1, 0, 1]",112,57,55,5,2,0.08771929824561403,0.03636363636363636
"[0, 0, 1, 1, 0, 1, 0, 0, 0, 1, 0, 1, 0, 1, 1]",117,55,62,6,6,0.10909090909090909,0.0967741935483871
"[0, 1, 1, 0, 0, 0, 1, 0, 1, 0, 0, 1, 0, 1, 0]",132,71,61,10,3,0.14084507042253522,0.04918032786885246
"[0, 0, 0, 0, 1, 1, 1, 1, 0, 0, 0, 1, 1, 0, 1]",215,114,101,10,11,0.08771929824561403,0.10891089108910891
"[0, 0, 0, 0, 1, 1, 1, 1, 0, 1, 1, 0, 1, 0, 1]",161,86,75,7,5,0.08139534883720931,0.06666666666666667
"[0, 1, 0, 1, 1, 1, 1, 0, 0, 1, 0, 1, 1, 1, 0]",158,51,107,5,13,0.09803921568627451,0.12149532710280374
"[1, 1, 0, 0, 1, 1, 0, 1, 0, 0, 0, 0, 1, 0, 1]",129,69,60,6,6,0.08695652173913043,0.1
"[1, 0, 1, 0, 0, 1, 0, 0, 1, 1, 0, 0, 1, 0, 1]",120,54,66,5,2,0.09259259259259259,0.030303030303030304
"[1, 1, 0, 1, 0, 0, 1, 0, 0, 1, 1, 0, 0, 1, 0]",133,66,67,4,2,0.06060606060606061,0.029850746268656716
"[1, 1, 1, 1, 1, 0, 1, 1, 0, 1, 1, 0, 1, 0, 0]",243,80,163,2,15,0.025,0.09202453987730061
"[1, 0, 1, 0, 1, 1, 1, 1, 1, 1, 1, 0, 1, 1, 0]",477,151,326,10,26,0.06622516556291391,0.07975460122699386
"[1, 0, 0, 1, 1, 0, 1, 0, 0, 1, 0, 0, 0, 1, 0]",148,92,56,7,6,0.07608695652173914,0.10714285714285714
"[0, 1, 0, 1, 1, 1, 0, 1, 0, 1, 1, 0, 1, 1, 0]",118,48,70,3,5,0.0625,0.07142857142857142
"[1, 0, 1, 0, 0, 0, 1, 1, 1, 0, 0, 0, 1, 0, 0]",154,89,65,8,6,0.0898876404494382,0.09230769230769231
"[1, 1, 0, 1, 1, 0, 1, 0, 1, 0, 0, 1, 0, 1, 1]",142,67,75,9,6,0.13432835820895522,0.08
"[0, 1, 1, 1, 0, 1, 1, 0, 1, 0, 1, 0, 0, 1, 0]",100,50,50,4,2,0.08,0.04
"[1, 0, 1, 1, 1, 1, 1, 0, 1, 1, 1, 0, 1, 0, 0]",228,75,153,10,16,0.13333333333333333,0.10457516339869281
"[1, 1, 1, 1, 1, 1, 0, 0, 1, 1, 1, 0, 0, 0, 0]",348,136,212,9,16,0.0661764705882353,0.07547169811320754
"[0, 1, 1, 0, 0, 1, 1, 0, 1, 0, 1, 1, 1, 0, 1]",170,95,75,12,3,0.12631578947368421,0.04
"[1, 0, 1, 1, 0, 0, 1, 1, 0, 1, 0, 1, 1, 1, 0]",158,55,103,5,11,0.09090909090909091,0.10679611650485436
"[0, 1, 1, 0, 1, 0, 0, 1, 1, 0, 0, 0, 1, 0, 1]",100,52,48,4,2,0.07692307692307693,0.041666666666666664
"[1, 1, 0, 0, 1, 0, 0, 0, 0, 0, 0, 1, 1, 1, 0]",175,101,74,9,5,0.0891089108910891,0.06756756756756757
"[0, 0, 0, 1, 1, 1, 0, 0, 1, 1, 1, 0, 1, 1, 1]",215,113,102,12,9,0.10619469026548672,0.08823529411764706
"[1, 0, 1, 0, 1, 1, 1, 1, 0, 1, 1, 0, 0, 0, 1]",172,70,102,4,9,0.05714285714285714,0.08823529411764706
"[0, 0, 0, 0, 1, 1, 0, 0, 0, 1, 1, 0, 1, 1, 0]",199,128,71,13,9,0.1015625,0.1267605633802817
"[1, 0, 1, 1, 0, 1, 1, 1, 0, 1, 0, 0, 1, 0, 0]",101,45,56,6,3,0.13333333333333333,0.05357142857142857
"[1, 0, 1, 1, 0, 1, 0, 0, 0, 1, 1, 0, 0, 0, 0]",240,127,113,6,14,0.047244094488188976,0.12389380530973451
"[1, 0, 0, 1, 1, 1, 0, 1, 1, 0, 1, 1, 0, 0, 1]",178,60,118,7,9,0.11666666666666667,0.07627118644067797
"[0, 1, 1, 1, 1, 0, 1, 1, 0, 1, 0, 0, 1, 0, 1]",151,67,84,6,5,0.08955223880597014,0.05952380952380952
"[0, 0, 1, 1, 1, 0, 1, 1, 0, 0, 0, 1, 0, 0, 1]",106,61,45,5,2,0.08196721311475409,0.044444444444444446
"[0, 0, 1, 0, 0, 1, 1, 1, 1, 0, 1, 1, 0, 1, 0]",119,59,60,5,6,0.0847457627118644,0.1
"[1, 0, 1, 1, 0, 1, 0, 0, 1, 0, 0, 1, 1, 1, 1]",187,72,115,6,14,0.08333333333333333,0.12173913043478261
"[0, 0, 0, 0, 0, 1, 0, 1, 1, 0, 1, 0, 0, 1, 0]",266,162,104,20,11,0.12345679012345678,0.10576923076923077
"[1, 0, 1, 0, 1, 0, 0, 0, 1, 1, 0, 1, 1, 0, 0]",130,75,55,7,8,0.09333333333333334,0.14545454545454545
"[0, 1, 1, 1, 1, 0, 1, 0, 1, 0, 1, 0, 0, 1, 1]",177,82,95,8,9,0.0975609756097561,0.09473684210526316
"[0, 1, 1, 1, 0, 0, 0, 1, 0, 1, 0, 0, 1, 0, 0]",150,97,53,9,5,0.09278350515463918,0.09433962264150944
"[0, 1, 0, 0, 1, 0, 1, 0, 1, 0, 0, 1, 0, 1, 0]",135,86,49,6,3,0.06976744186046512,0.061224489795918366
"[0, 0, 1, 1, 1, 0, 1, 1, 0, 1, 0, 0, 0, 1, 0]",96,57,39,5,7,0.08771929824561403,0.1794871794871795
"[0, 0, 1, 1, 1, 1, 1, 1, 0, 1, 1, 0, 0, 0, 1]",195,84,111,9,6,0.10714285714285714,0.05405405405405406
"[0, 1, 0, 1, 0, 0, 1, 0, 1, 1, 1, 1, 0, 1, 1]",151,74,77,6,5,0.08108108108108109,0.06493506493506493
"[0, 0, 1, 1, 0, 0, 1, 0, 0, 1, 1, 1, 0, 0, 1]",164,83,81,7,6,0.08433734939759036,0.07407407407407407
"[1, 1, 0, 0, 1, 1, 0, 0, 1, 0, 0, 1, 1, 1, 0]",159,86,73,5,6,0.05813953488372093,0.0821917808219178
"[1, 0, 1, 0, 1, 1, 1, 1, 0, 1, 1, 0, 1, 0, 1]",222,91,131,7,7,0.07692307692307693,0.05343511450381679
"[0, 1, 1, 1, 0, 0, 0, 1, 1, 1, 0, 0, 0, 1, 1]",173,100,73,10,5,0.1,0.0684931506849315
"[0, 1, 0, 1, 1, 0, 1, 0, 0, 1, 1, 1, 0, 1, 0]",113,63,50,5,8,0.07936507936507936,0.16
"[0, 0, 1, 0, 0, 1, 0, 1, 0, 1, 1, 0, 1, 0, 0]",124,63,61,8,5,0.12698412698412698,0.08196721311475409
"[0, 0, 0, 1, 0, 1, 1, 0, 1, 1, 1, 0, 1, 1, 1]",168,78,90,7,7,0.08974358974358974,0.07777777777777778
"[1, 1, 1, 0, 0, 0, 0, 1, 1, 0, 0, 1, 0, 0, 0]",299,119,180,13,18,0.1092436974789916,0.1
"[1, 1, 1, 0, 1, 0, 1, 1, 0, 0, 1, 1, 0, 1, 1]",253,88,165,6,13,0.06818181818181818,0.07878787878787878
"[1, 1, 0, 0, 0, 0, 1, 0, 0, 1, 1, 0, 1, 1, 0]",121,64,57,8,4,0.125,0.07017543859649122
"[0, 0, 1, 1, 0, 1, 0, 0, 0, 1, 0, 1, 1, 0, 1]",102,64,38,7,4,0.109375,0.10526315789473684
"[0, 1, 1, 0, 1, 1, 0, 1, 0, 1, 1, 1, 1, 0, 1]",224,86,138,8,13,0.09302325581395349,0.09420289855072464
"[1, 1, 1, 0, 0, 1, 0, 0, 0, 1, 0, 0, 1, 1, 0]",121,66,55,12,6,0.18181818181818182,0.10909090909090909
"[0, 1, 0, 0, 1, 0, 0, 0, 0, 1, 1, 1, 0, 0, 0]",305,207,98,22,8,0.10628019323671498,0.08163265306122448
"[0, 1, 1, 1, 1, 1, 1, 1, 1, 0, 0, 1, 0, 0, 0]",275,163,112,12,11,0.0736196319018405,0.09821428571428571
"[0, 0, 1, 0, 1, 0, 0, 1, 0, 1, 1, 0, 0, 1, 0]",124,74,50,11,6,0.14864864864864866,0.12
"[0, 1, 1, 0, 1, 1, 0, 1, 1, 1, 1, 1, 0, 0, 0]",189,86,103,7,8,0.08139534883720931,0.07766990291262135
"[1, 0, 1, 0, 0, 0, 1, 1, 1, 1, 1, 1, 0, 0, 0]",287,144,143,14,14,0.09722222222222222,0.0979020979020979
"[1, 0, 0, 1, 1, 1, 0, 1, 0, 0, 0, 1, 0, 0, 1]",114,49,65,3,6,0.061224489795918366,0.09230769230769231
"[1, 1, 0, 1, 1, 0, 1, 1, 1, 1, 0, 1, 0, 1, 0]",231,87,144,9,12,0.10344827586206896,0.08333333333333333
"[0, 1, 1, 0, 1, 0, 0, 1, 1, 1, 0, 1, 0, 1, 1]",139,54,85,4,11,0.07407407407407407,0.12941176470588237
"[1, 1, 1, 1, 1, 0, 0, 1, 0, 1, 0, 0, 0, 0, 0]",206,87,119,6,14,0.06896551724137931,0.11764705882352941
"[1, 0, 1, 0, 0, 0, 1, 1, 1, 0, 1, 0, 1, 0, 0]",98,49,49,1,5,0.02040816326530612,0.10204081632653061
"[0, 0, 0, 0, 1, 0, 1, 0, 0, 0, 1, 1, 1, 0, 1]",152,89,63,7,5,0.07865168539325842,0.07936507936507936
"[0, 1, 1, 1, 0, 1, 0, 0, 0, 0, 0, 0, 1, 0, 1]",142,97,45,11,3,0.1134020618556701,0.06666666666666667
"[0, 0, 0, 0, 0, 1, 0, 1, 1, 1, 1, 0, 1, 0, 1]",130,67,63,7,7,0.1044776119402985,0.1111111111111111
"[1, 0, 0, 1, 0, 1, 0, 0, 1, 0, 1, 0, 0, 0, 1]",144,92,52,9,7,0.09782608695652174,0.1346153846153846
"[1, 0, 0, 0, 0, 0, 0, 0, 1, 1, 1, 1, 1, 1, 1]",668,271,397,37,34,0.13653136531365315,0.08564231738035265
"[1, 0, 1, 1, 0, 0, 0, 1, 0, 1, 0, 0, 1, 0, 1]",109,64,45,6,3,0.09375,0.06666666666666667
"[0, 0, 1, 1, 0, 1, 1, 1, 1, 1, 0, 1, 0, 0, 1]",156,68,88,8,8,0.11764705882352941,0.09090909090909091
"[1, 0, 0, 1, 1, 0, 0, 1, 0, 1, 0, 0, 1, 1, 0]",149,69,80,6,9,0.08695652173913043,0.1125
"[1, 0, 1, 1, 0, 0, 1, 1, 0, 0, 1, 0, 1, 0, 0]",106,61,45,6,3,0.09836065573770492,0.06666666666666667
"[0, 1, 0, 1, 0, 0, 0, 0, 1, 1, 0, 0, 1, 1, 0]",342,211,131,16,15,0.07582938388625593,0.11450381679389313
"[0, 1, 1, 1, 0, 0, 1, 0, 0, 1, 0, 0, 1, 1, 1]",141,74,67,3,12,0.04054054054054054,0.1791044776119403
"[0, 1, 0, 0, 0, 1, 0, 1, 1, 0, 1, 1, 1, 1, 1]",194,91,103,8,8,0.08791208791208792,0.07766990291262135
"[0, 0, 1, 1, 0, 0, 1, 0, 1, 1, 1, 0, 1, 0, 0]",130,58,72,16,11,0.27586206896551724,0.1527777777777778
"[0, 1, 1, 0, 1, 0, 1, 0, 1, 0, 1, 0, 1, 1, 1]",127,57,70,5,6,0.08771929824561403,0.08571428571428572
"[1, 0, 0, 0, 1, 0, 1, 0, 1, 1, 0, 1, 0, 1, 1]",100,54,46,4,5,0.07407407407407407,0.10869565217391304
"[1, 0, 1, 1, 0, 0, 0, 1, 0, 1, 0, 1, 1, 0, 1]",112,50,62,4,5,0.08,0.08064516129032258
"[0, 1, 1, 0, 1, 1, 0, 0, 0, 1, 0, 1, 0, 1, 1]",129,61,68,11,10,0.18032786885245902,0.14705882352941177
"[1, 0, 0, 1, 0, 0, 1, 0, 1, 1, 1, 0, 1, 1, 0]",95,46,49,3,2,0.06521739130434782,0.04081632653061224
"[1, 0, 0, 1, 0, 0, 1, 1, 1, 0, 0, 0, 1, 1, 1]",175,72,103,7,11,0.09722222222222222,0.10679611650485436
"[1, 1, 1, 0, 1, 1, 1, 0, 0, 1, 0, 1, 0, 0, 1]",151,64,87,7,8,0.109375,0.09195402298850575
"[1, 1, 1, 1, 0, 0, 1, 0, 1, 0, 0, 1, 1, 0, 0]",162,66,96,5,13,0.07575757575757576,0.13541666666666666
"[1, 0, 0, 0, 1, 1, 1, 1, 1, 0, 0, 0, 0, 0, 1]",141,76,65,5,7,0.06578947368421052,0.1076923076923077
"[0, 1, 0, 0, 0, 1, 0, 1, 1, 1, 1, 1, 0, 1, 1]",145,59,86,5,4,0.0847457627118644,0.046511627906976744
"[1, 1, 0, 1, 0, 0, 0, 1, 1, 1, 0, 1, 1, 0, 1]",131,57,74,9,10,0.15789473684210525,0.13513513513513514
"[0, 1, 0, 1, 0, 0, 1, 0, 1, 0, 1, 0, 0, 0, 1]",145,92,53,7,3,0.07608695652173914,0.05660377358490566
"[1, 1, 0, 1, 0, 0, 1, 1, 0, 1, 0, 0, 0, 1, 0]",111,59,52,10,8,0.1694915254237288,0.15384615384615385
"[0, 0, 1, 1, 0, 1, 0, 0, 1, 1, 0, 1, 0, 0, 0]",149,81,68,7,7,0.08641975308641975,0.10294117647058823
"[1, 1, 0, 1, 1, 0, 0, 1, 0, 1, 1, 0, 0, 0, 0]",171,99,72,9,7,0.09090909090909091,0.09722222222222222
"[0, 0, 0, 0, 1, 1, 1, 0, 1, 0, 0, 0, 1, 0, 0]",247,162,85,15,7,0.09259259259259259,0.08235294117647059
"[0, 1, 1, 1, 1, 0, 1, 1, 1, 1, 0, 1, 1, 1, 0]",537,179,358,16,34,0.0893854748603352,0.09497206703910614
"[0, 0, 1, 0, 1, 0, 1, 1, 0, 0, 0, 0, 1, 1, 1]",237,126,111,14,6,0.1111111111111111,0.05405405405405406
"[1, 0, 0, 0, 0, 0, 0, 1, 1, 1, 0, 0, 1, 1, 1]",369,122,247,13,16,0.10655737704918032,0.06477732793522267
"[1, 1, 0, 0, 0, 1, 0, 1, 0, 0, 0, 0, 0, 1, 1]",244,142,102,11,14,0.07746478873239436,0.13725490196078433
"[1, 1, 0, 1, 0, 1, 0, 0, 1, 1, 0, 0, 0, 1, 0]",98,45,53,7,4,0.15555555555555556,0.07547169811320754
"[1, 0, 1, 0, 0, 1, 1, 1, 1, 1, 1, 0, 1, 0, 1]",250,90,160,7,14,0.07777777777777778,0.0875
"[0, 0, 1, 0, 1, 1, 0, 1, 0, 1, 1, 0, 1, 0, 1]",111,49,62,2,11,0.04081632653061224,0.1774193548387097
"[1, 0, 1, 1, 1, 1, 0, 0, 0, 0, 0, 0, 1, 1, 1]",532,232,300,24,26,0.10344827586206896,0.08666666666666667
"[1, 0, 0, 1, 1, 0, 1, 0, 1, 0, 0, 0, 0, 0, 0]",352,204,148,14,16,0.06862745098039216,0.10810810810810811
"[1, 1, 0, 0, 1, 1, 0, 1, 0, 1, 0, 0, 0, 0, 0]",217,130,87,12,14,0.09230769230769231,0.16091954022988506
"[1, 0, 1, 0, 0, 1, 0, 1, 0, 0, 1, 1, 1, 0, 0]",121,75,46,7,5,0.09333333333333334,0.10869565217391304
"[1, 1, 0, 1, 0, 1, 0, 1, 0, 1, 1, 0, 0, 1, 1]",182,74,108,5,10,0.06756756756756757,0.09259259259259259
"[1, 1, 1, 0, 1, 0, 0, 0, 0, 0, 0, 1, 1, 0, 1]",149,71,78,7,5,0.09859154929577464,0.0641025641025641
"[0, 1, 0, 1, 1, 0, 1, 0, 0, 0, 1, 0, 1, 0, 1]",92,53,39,7,2,0.1320754716981132,0.05128205128205128
"[0, 0, 1, 1, 1, 1, 1, 0, 0, 0, 0, 0, 1, 1, 0]",187,87,100,4,6,0.04597701149425287,0.06
"[0, 1, 1, 0, 1, 0, 0, 0, 0, 1, 0, 0, 0, 1, 1]",169,108,61,12,5,0.1111111111111111,0.08196721311475409
"[0, 1, 1, 0, 0, 0, 0, 1, 1, 1, 0, 1, 1, 0, 1]",157,98,59,13,4,0.1326530612244898,0.06779661016949153
"[0, 0, 0, 1, 0, 0, 1, 1, 1, 1, 0, 1, 1, 1, 1]",194,82,112,10,10,0.12195121951219512,0.08928571428571429
"[1, 1, 1, 0, 0, 0, 1, 1, 0, 1, 0, 0, 1, 0, 0]",117,61,56,7,7,0.11475409836065574,0.125
"[1, 0, 1, 1, 0, 0, 0, 1, 1, 0, 1, 1, 1, 0, 0]",114,49,65,5,10,0.10204081632653061,0.15384615384615385
"[0, 1, 0, 0, 0, 0, 1, 1, 0, 0, 1, 1, 1, 1, 1]",444,213,231,18,12,0.08450704225352113,0.05194805194805195
"[1, 0, 1, 0, 1, 1, 0, 1, 0, 1, 0, 0, 0, 1, 1]",111,49,62,2,8,0.04081632653061224,0.12903225806451613
"[0, 0, 1, 1, 0, 1, 0, 1, 1, 0, 0, 1, 1, 1, 0]",129,56,73,3,3,0.05357142857142857,0.0410958904109589
"[1, 1, 0, 1, 1, 0, 1, 1, 0, 1, 1, 1, 0, 0, 0]",173,80,93,8,13,0.1,0.13978494623655913
"[0, 0, 0, 1, 0, 0, 1, 1, 1, 1, 0, 0, 0, 1, 0]",178,115,63,7,8,0.06086956521739131,0.12698412698412698
"[0, 1, 0, 0, 0, 0, 1, 1, 1, 1, 1, 1, 0, 0, 0]",486,264,222,20,22,0.07575757575757576,0.0990990990990991
"[1, 1, 0, 0, 1, 0, 0, 0, 1, 1, 1, 0, 1, 1, 1]",161,78,83,7,9,0.08974358974358974,0.10843373493975904
"[0, 1, 1, 1, 1, 1, 0, 1, 0, 0, 0, 0, 1, 1, 1]",247,133,114,7,7,0.05263157894736842,0.06140350877192982
"[1, 1, 0, 1, 0, 0, 0, 1, 0, 1, 0, 0, 0, 0, 0]",266,182,84,19,10,0.1043956043956044,0.11904761904761904
"[0, 0, 0, 1, 0, 1, 0, 1, 0, 1, 1, 0, 0, 0, 0]",298,188,110,21,8,0.11170212765957446,0.07272727272727272
"[1, 1, 0, 1, 1, 0, 0, 1, 0, 1, 1, 0, 0, 0, 1]",121,51,70,4,11,0.0784313725490196,0.15714285714285714
"[0, 1, 1, 1, 0, 0, 0, 0, 0, 1, 0, 0, 1, 1, 1]",177,109,68,12,8,0.11009174311926606,0.11764705882352941
"[0, 0, 0, 1, 1, 0, 0, 1, 1, 0, 1, 1, 1, 0, 0]",173,103,70,13,7,0.1262135922330097,0.1
"[1, 1, 1, 1, 1, 0, 0, 0, 1, 0, 0, 1, 1, 1, 1]",492,151,341,8,41,0.052980132450331126,0.12023460410557185
"[0, 1, 0, 1, 1, 1, 1, 1, 0, 1, 1, 0, 0, 1, 0]",143,56,87,8,5,0.14285714285714285,0.05747126436781609
"[0, 0, 1, 0, 0, 0, 1, 1, 1, 1, 1, 0, 0, 0, 1]",125,69,56,7,6,0.10144927536231885,0.10714285714285714
"[1, 0, 1, 1, 1, 0, 0, 1, 1, 0, 1, 0, 1, 0, 0]",113,56,57,7,5,0.125,0.08771929824561403
"[0, 0, 0, 1, 0, 0, 0, 1, 0, 1, 1, 0, 1, 1, 0]",175,107,68,8,9,0.07476635514018691,0.1323529411764706
"[0, 1, 1, 1, 0, 1, 0, 0, 1, 1, 1, 0, 0, 1, 1]",195,77,118,8,14,0.1038961038961039,0.11864406779661017
"[0, 1, 0, 1, 1, 0, 0, 0, 1, 1, 0, 0, 0, 0, 1]",213,134,79,9,6,0.06716417910447761,0.0759493670886076
"[0, 1, 0, 0, 1, 0, 0, 0, 1, 0, 1, 1, 0, 0, 0]",255,160,95,14,10,0.0875,0.10526315789473684
"[1, 0, 1, 1, 1, 0, 0, 0, 1, 0, 0, 1, 1, 1, 0]",113,56,57,7,9,0.125,0.15789473684210525
"[0, 0, 1, 0, 0, 0, 1, 1, 1, 0, 0, 0, 1, 1, 1]",178,81,97,8,8,0.09876543209876543,0.08247422680412371
"[0, 0, 0, 1, 1, 1, 1, 0, 1, 1, 1, 0, 1, 0, 0]",128,71,57,4,5,0.056338028169014086,0.08771929824561403
"[0, 0, 0, 0, 0, 1, 0, 0, 0, 1, 1, 1, 1, 0, 1]",176,110,66,15,8,0.13636363636363635,0.12121212121212122
"[0, 0, 0, 0, 0, 0, 1, 0, 1, 1, 1, 0, 1, 0, 1]",160,102,58,8,5,0.0784313725490196,0.08620689655172414
"[1, 0, 1, 1, 1, 1, 0, 1, 1, 1, 0, 0, 0, 0, 1]",238,90,148,10,17,0.1111111111111111,0.11486486486486487
"[1, 0, 1, 1, 0, 0, 0, 1, 1, 1, 1, 0, 0, 0, 1]",139,62,77,5,7,0.08064516129032258,0.09090909090909091
"[1, 0, 0, 1, 1, 0, 1, 1, 0, 0, 0, 1, 1, 1, 1]",257,99,158,10,19,0.10101010101010101,0.12025316455696203
"[1, 0, 1, 1, 0, 1, 1, 1, 1, 0, 0, 0, 0, 1, 1]",379,139,240,16,19,0.11510791366906475,0.07916666666666666
"[0, 1, 1, 0, 1, 0, 0, 1, 0, 1, 0, 0, 1, 1, 1]",130,63,67,8,5,0.12698412698412698,0.07462686567164178
"[0, 0, 1, 1, 0, 0, 1, 1, 0, 1, 1, 1, 0, 1, 0]",122,62,60,9,3,0.14516129032258066,0.05
"[0, 0, 1, 1, 1, 0, 0, 1, 1, 1, 0, 1, 0, 0, 1]",122,58,64,9,7,0.15517241379310345,0.109375
"[1, 0, 1, 0, 0, 0, 0, 1, 0, 1, 0, 1, 1, 1, 1]",135,77,58,7,3,0.09090909090909091,0.05172413793103448
"[1, 1, 1, 1, 0, 0, 0, 0, 1, 0, 0, 0, 1, 1, 1]",328,180,148,17,12,0.09444444444444444,0.08108108108108109
"[0, 1, 1, 1, 1, 0, 0, 0, 0, 1, 0, 0, 0, 1, 1]",257,178,79,16,4,0.0898876404494382,0.05063291139240506
"[0, 0, 1, 1, 1, 0, 1, 0, 1, 0, 1, 1, 1, 1, 0]",163,68,95,6,12,0.08823529411764706,0.12631578947368421
"[1, 1, 0, 1, 1, 0, 0, 1, 1, 1, 0, 0, 0, 1, 1]",196,90,106,8,9,0.08888888888888889,0.08490566037735849
"[0, 1, 1, 1, 0, 1, 1, 0, 0, 1, 1, 1, 0, 0, 0]",147,73,74,7,9,0.0958904109589041,0.12162162162162163
"[0, 0, 1, 0, 1, 1, 0, 1, 0, 0, 1, 0, 0, 0, 1]",171,92,79,7,6,0.07608695652173914,0.0759493670886076
"[0, 0, 1, 1, 1, 0, 1, 0, 0, 0, 0, 0, 1, 0, 0]",239,151,88,13,7,0.08609271523178808,0.07954545454545454
"[0, 0, 1, 0, 0, 1, 1, 1, 1, 0, 1, 0, 1, 1, 0]",122,67,55,7,9,0.1044776119402985,0.16363636363636364
"[0, 1, 1, 1, 0, 1, 1, 1, 0, 1, 0, 1, 0, 0, 1]",141,54,87,4,10,0.07407407407407407,0.11494252873563218
"[0, 0, 1, 0, 1, 0, 0, 0, 1, 1, 1, 0, 1, 1, 1]",145,68,77,11,7,0.16176470588235295,0.09090909090909091
"[1, 0, 0, 0, 1, 0, 0, 0, 1, 0, 1, 1, 0, 0, 1]",178,107,71,9,6,0.08411214953271028,0.08450704225352113
"[1, 1, 0, 0, 0, 1, 0, 0, 0, 1, 0, 1, 1, 0, 0]",162,91,71,10,9,0.10989010989010989,0.1267605633802817
"[0, 1, 1, 0, 0, 0, 1, 0, 1, 1, 1, 1, 0, 1, 1]",185,89,96,10,11,0.11235955056179775,0.11458333333333333
"[1, 1, 1, 0, 1, 1, 0, 0, 0, 1, 0, 1, 1, 1, 1]",278,92,186,8,11,0.08695652173913043,0.05913978494623656
"[0, 0, 1, 0, 0, 1, 1, 1, 0, 0, 0, 1, 1, 0, 0]",193,107,86,10,10,0.09345794392523364,0.11627906976744186
"[0, 0, 0, 1, 1, 1, 0, 1, 0, 0, 1, 0, 0, 0, 1]",144,91,53,7,6,0.07692307692307693,0.11320754716981132
"[0, 1, 1, 0, 0, 1, 0, 1, 0, 1, 0, 1, 0, 0, 0]",126,77,49,9,3,0.11688311688311688,0.061224489795918366
"[1, 0, 1, 1, 0, 1, 1, 0, 0, 1, 0, 0, 1, 0, 1]",108,50,58,6,7,0.12,0.1206896551724138
"[1, 0, 1, 1, 0, 0, 0, 0, 1, 0, 0, 0, 0, 1, 1]",185,121,64,7,6,0.05785123966942149,0.09375
"[0, 0, 0, 1, 1, 1, 0, 0, 0, 0, 1, 1, 0, 1, 0]",187,122,65,12,7,0.09836065573770492,0.1076923076923077
"[1, 0, 1, 1, 0, 1, 0, 0, 0, 1, 1, 1, 1, 0, 0]",165,91,74,7,10,0.07692307692307693,0.13513513513513514
"[1, 1, 0, 0, 0, 0, 0, 1, 1, 1, 0, 1, 1, 1, 0]",151,75,76,5,5,0.06666666666666667,0.06578947368421052
"[1, 0, 1, 1, 1, 0, 0, 0, 0, 0, 1, 1, 1, 0, 1]",125,50,75,6,11,0.12,0.14666666666666667
"[0, 1, 0, 0, 0, 1, 1, 0, 1, 1, 1, 1, 0, 0, 0]",147,89,58,8,4,0.0898876404494382,0.06896551724137931
"[1, 1, 1, 0, 1, 0, 0, 0, 1, 0, 1, 0, 1, 0, 1]",111,46,65,2,6,0.043478260869565216,0.09230769230769231
"[1, 1, 1, 0, 0, 1, 0, 1, 0, 1, 1, 0, 0, 1, 1]",234,90,144,3,14,0.03333333333333333,0.09722222222222222
"[0, 1, 1, 0, 0, 1, 1, 1, 1, 0, 0, 1, 0, 1, 0]",214,138,76,12,6,0.08695652173913043,0.07894736842105263
"[1, 0, 1, 0, 0, 1, 1, 1, 1, 0, 0, 0, 1, 1, 1]",231,101,130,9,15,0.0891089108910891,0.11538461538461539
"[0, 0, 1, 1, 1, 0, 0, 0, 1, 0, 1, 1, 0, 0, 1]",139,69,70,7,7,0.10144927536231885,0.1
"[1, 1, 1, 1, 0, 0, 0, 0, 0, 1, 1, 1, 0, 0, 0]",207,109,98,10,9,0.09174311926605505,0.09183673469387756
"[1, 0, 1, 1, 0, 0, 1, 1, 0, 0, 0, 1, 0, 0, 0]",158,93,65,16,5,0.17204301075268819,0.07692307692307693
"[0, 0, 1, 1, 0, 1, 1, 0, 1, 1, 0, 0, 1, 1, 0]",153,69,84,5,8,0.07246376811594203,0.09523809523809523
"[0, 1, 0, 1, 0, 1, 0, 0, 0, 0, 1, 1, 1, 1, 0]",179,95,84,9,4,0.09473684210526316,0.047619047619047616
"[1, 0, 1, 0, 1, 1, 0, 1, 0, 1, 0, 1, 0, 1, 0]",95,39,56,5,7,0.1282051282051282,0.125
"[0, 1, 1, 1, 0, 1, 0, 0, 0, 0, 1, 0, 0, 0, 0]",281,188,93,25,13,0.13297872340425532,0.13978494623655913
"[1, 0, 0, 1, 1, 0, 1, 0, 1, 1, 0, 1, 0, 0, 1]",123,54,69,5,6,0.09259259259259259,0.08695652173913043
"[1, 1, 1, 1, 1, 0, 0, 1, 1, 0, 1, 0, 1, 1, 0]",280,95,185,11,18,0.11578947368421053,0.0972972972972973
"[1, 1, 0, 1, 0, 1, 1, 1, 1, 1, 0, 1, 1, 0, 0]",292,106,186,10,19,0.09433962264150944,0.10215053763440861
"[0, 0, 0, 1, 1, 0, 1, 1, 0, 1, 0, 0, 1, 0, 0]",143,91,52,6,3,0.06593406593406594,0.057692307692307696
"[1, 1, 1, 0, 1, 0, 0, 1, 1, 0, 1, 1, 0, 0, 1]",152,60,92,3,10,0.05,0.10869565217391304
"[0, 0, 1, 0, 1, 1, 1, 0, 1, 0, 0, 1, 1, 0, 1]",108,59,49,6,3,0.1016949152542373,0.061224489795918366
"[0, 1, 0, 1, 0, 0, 0, 0, 0, 0, 1, 0, 1, 1, 1]",209,126,83,14,12,0.1111111111111111,0.14457831325301204
"[1, 1, 1, 0, 1, 1, 0, 1, 0, 0, 1, 0, 0, 0, 1]",103,39,64,7,4,0.1794871794871795,0.0625
"[1, 1, 1, 0, 1, 0, 1, 0, 0, 1, 0, 0, 1, 0, 0]",92,50,42,4,6,0.08,0.14285714285714285
"[0, 0, 1, 1, 1, 0, 0, 1, 1, 0, 0, 0, 1, 1, 0]",164,86,78,7,8,0.08139534883720931,0.10256410256410256
"[1, 0, 0, 1, 0, 0, 1, 0, 1, 1, 1, 1, 0, 1, 0]",94,43,51,8,4,0.18604651162790697,0.0784313725490196
"[0, 0, 0, 1, 0, 1, 0, 0, 1, 1, 0, 0, 0, 0, 1]",385,254,131,20,10,0.07874015748031496,0.07633587786259542
"[1, 0, 0, 1, 1, 0, 1, 1, 1, 0, 1, 0, 0, 0, 0]",129,70,59,5,5,0.07142857142857142,0.0847457627118644
"[0, 0, 1, 1, 1, 1, 1, 0, 1, 1, 1, 0, 0, 0, 0]",196,88,108,12,9,0.13636363636363635,0.08333333333333333
"[0, 1, 1, 1, 1, 1, 1, 0, 0, 1, 0, 1, 0, 0, 1]",199,94,105,7,8,0.07446808510638298,0.0761904761904762
"[1, 1, 0, 1, 1, 1, 1, 0, 0, 1, 0, 0, 1, 0, 0]",110,51,59,5,5,0.09803921568627451,0.0847457627118644
"[0, 1, 0, 0, 1, 1, 0, 0, 1, 1, 0, 1, 1, 0, 1]",122,56,66,7,3,0.125,0.045454545454545456
"[1, 1, 0, 1, 0, 0, 1, 0, 0, 1, 1, 1, 0, 0, 1]",127,62,65,7,4,0.11290322580645161,0.06153846153846154
"[0, 0, 1, 1, 1, 1, 0, 0, 1, 1, 1, 0, 0, 1, 0]",205,86,119,8,17,0.09302325581395349,0.14285714285714285
"[0, 1, 0, 1, 1, 0, 0, 1, 1, 1, 1, 1, 0, 1, 0]",143,51,92,6,8,0.11764705882352941,0.08695652173913043
"[1, 0, 1, 0, 0, 0, 0, 1, 1, 0, 0, 0, 1, 0, 1]",160,94,66,7,6,0.07446808510638298,0.09090909090909091
"[1, 1, 0, 1, 1, 0, 1, 1, 1, 0, 0, 0, 1, 0, 1]",150,65,85,7,9,0.1076923076923077,0.10588235294117647
"[0, 1, 1, 0, 1, 1, 0, 1, 1, 1, 0, 0, 0, 1, 0]",110,49,61,4,5,0.08163265306122448,0.08196721311475409
"[0, 0, 0, 1, 0, 1, 1, 0, 1, 0, 0, 1, 1, 1, 1]",193,98,95,4,9,0.04081632653061224,0.09473684210526316
"[0, 0, 1, 1, 0, 1, 0, 1, 0, 0, 0, 0, 1, 1, 1]",243,132,111,10,14,0.07575757575757576,0.12612612612612611
"[0, 1, 0, 1, 0, 1, 1, 1, 1, 0, 0, 1, 1, 0, 1]",142,47,95,6,7,0.1276595744680851,0.07368421052631578
"[0, 0, 0, 0, 0, 1, 1, 1, 1, 0, 1, 1, 0, 0, 0]",263,181,82,31,10,0.1712707182320442,0.12195121951219512
"[0, 1, 0, 1, 1, 1, 1, 1, 1, 1, 0, 0, 0, 0, 1]",397,168,229,17,22,0.10119047619047619,0.09606986899563319
"[0, 1, 0, 0, 1, 0, 1, 0, 1, 1, 1, 1, 1, 1, 1]",314,133,181,13,17,0.09774436090225563,0.09392265193370165
"[1, 1, 0, 0, 1, 1, 0, 0, 1, 0, 0, 1, 0, 1, 0]",125,64,61,6,3,0.09375,0.04918032786885246
"[1, 0, 0, 1, 1, 0, 1, 0, 1, 0, 1, 0, 1, 0, 1]",91,40,51,2,2,0.05,0.0392156862745098
"[0, 1, 0, 1, 1, 1, 1, 0, 1, 1, 0, 0, 0, 1, 0]",110,48,62,2,6,0.041666666666666664,0.0967741935483871
"[0, 1, 1, 0, 1, 1, 0, 1, 0, 1, 0, 1, 0, 0, 1]",118,56,62,5,5,0.08928571428571429,0.08064516129032258
"[1, 0, 0, 1, 0, 1, 0, 0, 0, 0, 0, 1, 1, 0, 1]",132,77,55,6,8,0.07792207792207792,0.14545454545454545
"[1, 0, 1, 1, 1, 0, 1, 1, 1, 0, 0, 1, 0, 1, 0]",131,59,72,5,11,0.0847457627118644,0.1527777777777778
"[0, 1, 0, 0, 1, 1, 0, 0, 1, 0, 0, 0, 1, 1, 0]",166,105,61,15,4,0.14285714285714285,0.06557377049180328
"[1, 0, 0, 1, 1, 0, 1, 0, 0, 1, 1, 0, 0, 1, 0]",129,65,64,6,4,0.09230769230769231,0.0625
"[1, 0, 1, 1, 0, 0, 1, 1, 0, 1, 0, 0, 1, 1, 0]",124,61,63,2,9,0.03278688524590164,0.14285714285714285
"[0, 0, 0, 0, 1, 1, 1, 1, 1, 0, 0, 1, 1, 0, 1]",190,103,87,11,7,0.10679611650485436,0.08045977011494253
"[0, 1, 1, 0, 1, 1, 0, 1, 0, 1, 0, 1, 1, 1, 0]",154,71,83,5,6,0.07042253521126761,0.07228915662650602
"[1, 0, 0, 1, 1, 0, 1, 0, 1, 0, 1, 1, 0, 1, 1]",157,53,104,5,16,0.09433962264150944,0.15384615384615385
"[1, 1, 0, 0, 1, 1, 0, 1, 0, 1, 0, 1, 1, 0, 1]",149,79,70,8,8,0.10126582278481013,0.11428571428571428
"[0, 1, 0, 1, 1, 0, 0, 1, 0, 0, 1, 1, 1, 1, 0]",135,67,68,6,5,0.08955223880597014,0.07352941176470588
"[0, 0, 0, 1, 0, 1, 0, 0, 1, 0, 0, 1, 0, 1, 1]",126,78,48,7,8,0.08974358974358974,0.16666666666666666
"[1, 0, 0, 0, 1, 0, 0, 1, 1, 0, 1, 1, 1, 0, 0]",115,64,51,4,7,0.0625,0.13725490196078433
"[0, 1, 0, 1, 1, 0, 0, 0, 1, 0, 0, 1, 1, 0, 1]",120,68,52,7,10,0.10294117647058823,0.19230769230769232
"[0, 0, 1, 1, 1, 0, 1, 1, 0, 1, 0, 1, 1, 1, 0]",126,46,80,4,3,0.08695652173913043,0.0375
"[1, 0, 0, 1, 0, 1, 0, 1, 0, 0, 1, 0, 0, 1, 1]",133,74,59,20,9,0.2702702702702703,0.15254237288135594
"[1, 1, 0, 0, 1, 0, 1, 0, 1, 1, 0, 1, 1, 0, 1]",126,43,83,2,8,0.046511627906976744,0.0963855421686747
"[1, 0, 0, 0, 1, 0, 1, 0, 0, 1, 0, 0, 0, 0, 1]",272,169,103,21,20,0.1242603550295858,0.1941747572815534
"[1, 1, 0, 0, 0, 0, 1, 0, 0, 0, 0, 0, 1, 0, 1]",287,177,110,14,11,0.07909604519774012,0.1
"[1, 0, 1, 1, 0, 1, 0, 1, 0, 0, 0, 1, 0, 1, 1]",113,41,72,0,8,0.0,0.1111111111111111
"[1, 0, 1, 0, 1, 0, 0, 0, 0, 0, 0, 1, 0, 1, 1]",165,98,67,11,9,0.11224489795918367,0.13432835820895522
"[1, 1, 1, 0, 1, 1, 0, 0, 1, 0, 0, 0, 1, 0, 0]",113,66,47,7,4,0.10606060606060606,0.0851063829787234
"[1, 1, 1, 1, 1, 0, 1, 0, 0, 0, 1, 0, 0, 0, 0]",151,80,71,8,5,0.1,0.07042253521126761
"[0, 0, 1, 0, 1, 0, 0, 0, 0, 1, 1, 0, 1, 1, 0]",146,85,61,6,3,0.07058823529411765,0.04918032786885246
"[1, 0, 0, 0, 0, 0, 1, 0, 0, 0, 1, 1, 1, 0, 1]",144,88,56,9,9,0.10227272727272728,0.16071428571428573
"[1, 0, 0, 0, 0, 1, 0, 0, 1, 1, 1, 0, 1, 1, 0]",114,62,52,5,5,0.08064516129032258,0.09615384615384616
"[1, 1, 1, 1, 0, 1, 0, 0, 0, 0, 0, 1, 1, 1, 0]",140,71,69,6,10,0.08450704225352113,0.14492753623188406
"[1, 0, 0, 1, 0, 0, 1, 1, 0, 1, 0, 0, 1, 1, 0]",105,55,50,6,3,0.10909090909090909,0.06
"[1, 1, 0, 0, 1, 0, 0, 1, 1, 0, 1, 0, 0, 1, 1]",119,63,56,6,3,0.09523809523809523,0.05357142857142857
"[1, 0, 1, 0, 0, 0, 1, 1, 0, 1, 1, 0, 0, 1, 1]",164,81,83,8,2,0.09876543209876543,0.024096385542168676
"[1, 1, 0, 0, 0, 1, 0, 1, 0, 1, 1, 1, 0, 1, 1]",160,68,92,8,7,0.11764705882352941,0.07608695652173914
"[0, 0, 1, 0, 0, 0, 0, 1, 1, 1, 1, 1, 0, 0, 0]",231,138,93,6,8,0.043478260869565216,0.08602150537634409
"[0, 0, 0, 1, 0, 0, 0, 0, 1, 1, 1, 1, 1, 0, 0]",238,136,102,13,9,0.09558823529411764,0.08823529411764706
"[0, 0, 1, 0, 0, 1, 0, 0, 1, 1, 1, 0, 0, 0, 1]",153,101,52,8,3,0.07920792079207921,0.057692307692307696
"[0, 1, 1, 0, 1, 0, 1, 1, 1, 1, 0, 0, 1, 1, 1]",415,166,249,18,18,0.10843373493975904,0.07228915662650602
"[0, 1, 1, 1, 0, 1, 1, 0, 0, 0, 0, 1, 0, 1, 0]",123,71,52,9,5,0.1267605633802817,0.09615384615384616
"[1, 1, 0, 1, 1, 1, 0, 0, 1, 1, 0, 0, 0, 0, 0]",281,134,147,11,14,0.08208955223880597,0.09523809523809523
"[0, 0, 1, 0, 0, 1, 1, 0, 0, 0, 1, 0, 0, 1, 0]",240,162,78,18,10,0.1111111111111111,0.1282051282051282
"[0, 1, 1, 0, 1, 1, 0, 0, 0, 1, 0, 0, 1, 1, 0]",122,61,61,6,2,0.09836065573770492,0.03278688524590164
"[1, 1, 1, 0, 1, 1, 1, 0, 0, 1, 0, 0, 0, 1, 1]",183,78,105,8,14,0.10256410256410256,0.13333333333333333
"[0, 0, 0, 1, 1, 1, 1, 0, 1, 1, 1, 0, 0, 1, 0]",125,69,56,4,6,0.057971014492753624,0.10714285714285714
"[0, 1, 0, 0, 1, 0, 1, 0, 1, 0, 0, 0, 1, 1, 1]",149,75,74,13,2,0.17333333333333334,0.02702702702702703
"[0, 0, 0, 1, 1, 0, 0, 0, 1, 0, 1, 0, 1, 1, 0]",154,100,54,4,6,0.04,0.1111111111111111
"[0, 1, 0, 1, 1, 0, 0, 0, 1, 0, 0, 1, 1, 1, 1]",162,64,98,4,6,0.0625,0.061224489795918366
"[0, 1, 0, 1, 0, 1, 0, 1, 1, 0, 0, 0, 1, 0, 0]",131,83,48,7,5,0.08433734939759036,0.10416666666666667
"[1, 1, 1, 0, 1, 0, 0, 0, 0, 0, 1, 1, 1, 0, 1]",106,45,61,9,4,0.2,0.06557377049180328
"[1, 0, 0, 1, 0, 0, 1, 1, 1, 1, 0, 0, 0, 0, 1]",272,128,144,9,15,0.0703125,0.10416666666666667
"[1, 0, 1, 1, 0, 1, 0, 0, 0, 0, 1, 0, 1, 1, 0]",116,55,61,4,5,0.07272727272727272,0.08196721311475409
"[0, 0, 1, 1, 1, 1, 1, 1, 0, 0, 0, 1, 0, 1, 0]",190,103,87,15,7,0.14563106796116504,0.08045977011494253
"[1, 0, 0, 1, 0, 1, 1, 0, 0, 1, 0, 0, 0, 0, 1]",166,85,81,9,8,0.10588235294117647,0.09876543209876543
"[1, 1, 0, 0, 0, 1, 0, 0, 0, 1, 0, 0, 1, 0, 1]",126,69,57,3,6,0.043478260869565216,0.10526315789473684
"[0, 1, 1, 0, 0, 0, 1, 0, 0, 0, 1, 0, 0, 1, 0]",217,143,74,17,6,0.11888111888111888,0.08108108108108109
"[1, 0, 0, 1, 0, 1, 0, 0, 1, 1, 1, 0, 0, 0, 1]",111,63,48,4,7,0.06349206349206349,0.14583333333333334
"[1, 0, 1, 0, 0, 1, 1, 1, 1, 1, 0, 0, 1, 1, 0]",208,81,127,6,10,0.07407407407407407,0.07874015748031496
"[0, 0, 1, 1, 1, 1, 1, 0, 1, 1, 1, 0, 1, 0, 1]",266,91,175,7,21,0.07692307692307693,0.12
"[0, 0, 0, 1, 0, 1, 0, 1, 0, 0, 0, 1, 0, 0, 1]",245,159,86,18,7,0.11320754716981132,0.08139534883720931
"[1, 0, 1, 1, 0, 1, 1, 0, 1, 0, 1, 1, 0, 0, 0]",131,58,73,4,6,0.06896551724137931,0.0821917808219178
"[0, 0, 0, 1, 0, 0, 0, 0, 1, 1, 0, 1, 0, 1, 1]",172,108,64,10,4,0.09259259259259259,0.0625
"[1, 0, 1, 1, 1, 1, 1, 1, 0, 0, 1, 0, 1, 1, 0]",234,95,139,14,16,0.14736842105263157,0.11510791366906475
"[1, 1, 0, 0, 1, 1, 0, 0, 1, 0, 1, 1, 1, 1, 0]",199,82,117,5,16,0.06097560975609756,0.13675213675213677
"[1, 1, 0, 1, 0, 1, 0, 0, 1, 0, 1, 0, 1, 0, 1]",103,48,55,2,6,0.041666666666666664,0.10909090909090909
"[1, 0, 0, 0, 1, 1, 1, 0, 0, 1, 1, 1, 0, 0, 0]",130,67,63,4,2,0.05970149253731343,0.031746031746031744
"[1, 1, 1, 1, 0, 1, 0, 1, 1, 0, 0, 0, 0, 0, 1]",158,70,88,7,7,0.1,0.07954545454545454
"[0, 1, 1, 1, 0, 0, 0, 1, 0, 1, 1, 1, 0, 1, 1]",150,61,89,4,8,0.06557377049180328,0.0898876404494382
"[1, 1, 1, 1, 1, 1, 1, 0, 1, 0, 0, 0, 1, 0, 1]",275,77,198,8,19,0.1038961038961039,0.09595959595959595
"[0, 1, 0, 0, 0, 1, 0, 1, 0, 1, 1, 1, 0, 1, 0]",113,60,53,9,2,0.15,0.03773584905660377
"[0, 1, 0, 0, 1, 1, 1, 1, 0, 1, 1, 0, 1, 0, 0]",126,59,67,5,7,0.0847457627118644,0.1044776119402985
"[0, 1, 1, 0, 1, 1, 1, 1, 1, 1, 0, 0, 0, 0, 1]",356,160,196,17,20,0.10625,0.10204081632653061
"[1, 1, 1, 0, 0, 0, 1, 1, 1, 1, 0, 0, 0, 0, 1]",324,129,195,18,12,0.13953488372093023,0.06153846153846154
"[0, 0, 0, 1, 1, 1, 0, 0, 0, 1, 1, 0, 1, 0, 1]",110,54,56,4,2,0.07407407407407407,0.03571428571428571
"[0, 1, 0, 0, 1, 1, 1, 0, 0, 1, 1, 0, 0, 1, 1]",282,156,126,14,7,0.08974358974358974,0.05555555555555555
"[0, 1, 0, 0, 1, 0, 0, 1, 0, 0, 1, 1, 1, 0, 1]",108,59,49,2,6,0.03389830508474576,0.12244897959183673
"[1, 1, 1, 0, 0, 0, 1, 0, 0, 1, 1, 0, 1, 0, 0]",120,67,53,6,2,0.08955223880597014,0.03773584905660377
"[0, 1, 1, 0, 0, 1, 0, 1, 1, 1, 1, 1, 1, 0, 0]",240,118,122,14,8,0.11864406779661017,0.06557377049180328
"[1, 0, 1, 0, 1, 0, 1, 1, 1, 1, 1, 0, 1, 0, 0]",150,56,94,5,14,0.08928571428571429,0.14893617021276595
"[0, 1, 0, 0, 1, 1, 1, 0, 0, 1, 1, 0, 0, 0, 1]",137,74,63,9,5,0.12162162162162163,0.07936507936507936
"[1, 1, 1, 0, 0, 0, 1, 1, 0, 0, 1, 1, 1, 0, 1]",171,63,108,5,18,0.07936507936507936,0.16666666666666666
"[1, 1, 0, 1, 1, 1, 1, 0, 0, 0, 1, 1, 0, 0, 1]",215,82,133,8,12,0.0975609756097561,0.09022556390977443
"[0, 1, 1, 0, 1, 1, 1, 1, 0, 0, 0, 1, 1, 0, 0]",161,87,74,9,6,0.10344827586206896,0.08108108108108109
"[0, 0, 1, 1, 0, 1, 1, 1, 1, 0, 0, 0, 1, 1, 0]",153,72,81,4,3,0.05555555555555555,0.037037037037037035
"[0, 1, 1, 1, 1, 0, 0, 0, 1, 0, 1, 0, 0, 1, 1]",164,92,72,9,7,0.09782608695652174,0.09722222222222222
"[1, 1, 1, 0, 0, 1, 0, 1, 1, 1, 0, 0, 1, 0, 1]",163,77,86,8,5,0.1038961038961039,0.05813953488372093
"[0, 1, 0, 1, 1, 1, 0, 1, 1, 1, 1, 0, 0, 1, 0]",130,55,75,8,6,0.14545454545454545,0.08
"[0, 1, 0, 1, 1, 0, 1, 1, 0, 1, 0, 0, 0, 0, 0]",174,102,72,11,8,0.10784313725490197,0.1111111111111111
"[0, 0, 1, 0, 0, 0, 0, 0, 1, 1, 0, 1, 0, 0, 1]",249,169,80,18,10,0.10650887573964497,0.125
"[0, 0, 1, 1, 1, 0, 1, 0, 1, 0, 1, 1, 0, 1, 1]",159,78,81,10,8,0.1282051282051282,0.09876543209876543
"[0, 1, 1, 0, 1, 0, 1, 0, 0, 0, 1, 1, 1, 0, 0]",126,67,59,6,8,0.08955223880597014,0.13559322033898305
"[1, 0, 1, 0, 1, 1, 1, 0, 1, 1, 1, 0, 0, 0, 0]",141,56,85,6,7,0.10714285714285714,0.08235294117647059
"[1, 0, 1, 1, 0, 1, 0, 0, 1, 1, 0, 0, 0, 1, 0]",111,56,55,5,8,0.08928571428571429,0.14545454545454545
"[0, 1, 0, 1, 1, 0, 0, 1, 0, 0, 1, 1, 0, 0, 1]",144,64,80,5,7,0.078125,0.0875
"[0, 0, 1, 0, 1, 0, 1, 1, 0, 0, 1, 0, 0, 1, 1]",125,65,60,6,5,0.09230769230769231,0.08333333333333333
"[0, 1, 1, 1, 0, 0, 0, 1, 0, 1, 0, 1, 1, 0, 0]",127,67,60,10,6,0.14925373134328357,0.1
"[1, 0, 0, 0, 1, 0, 0, 1, 0, 1, 0, 0, 1, 1, 0]",166,96,70,6,6,0.0625,0.08571428571428572
"[1, 0, 1, 0, 1, 0, 0, 0, 1, 0, 0, 0, 1, 1, 1]",145,71,74,5,6,0.07042253521126761,0.08108108108108109
"[1, 1, 0, 1, 0, 1, 0, 0, 0, 1, 0, 0, 0, 1, 1]",133,68,65,4,4,0.058823529411764705,0.06153846153846154
"[0, 1, 0, 0, 1, 1, 0, 0, 1, 1, 0, 0, 1, 0, 1]",147,71,76,8,9,0.11267605633802817,0.11842105263157894
"[1, 0, 1, 0, 1, 1, 1, 0, 1, 1, 0, 1, 0, 0, 1]",155,62,93,9,8,0.14516129032258066,0.08602150537634409
"[0, 1, 0, 0, 1, 0, 1, 0, 1, 0, 1, 0, 0, 0, 1]",125,71,54,8,1,0.11267605633802817,0.018518518518518517
"[1, 1, 0, 1, 0, 0, 1, 1, 0, 1, 1, 1, 0, 1, 1]",243,84,159,9,14,0.10714285714285714,0.0880503144654088
"[1, 1, 0, 0, 1, 0, 1, 0, 0, 0, 1, 1, 1, 1, 0]",145,77,68,10,10,0.12987012987012986,0.14705882352941177
"[1, 1, 0, 1, 0, 0, 1, 0, 0, 1, 0, 1, 0, 1, 0]",97,49,48,5,2,0.10204081632653061,0.041666666666666664
"[0, 1, 1, 1, 1, 1, 1, 0, 1, 1, 0, 0, 0, 0, 1]",261,121,140,15,22,0.12396694214876033,0.15714285714285714
"[1, 0, 1, 0, 1, 0, 1, 0, 0, 0, 1, 1, 1, 1, 0]",146,71,75,7,7,0.09859154929577464,0.09333333333333334
"[0, 1, 1, 1, 0, 1, 1, 0, 1, 1, 0, 0, 1, 0, 0]",130,65,65,7,6,0.1076923076923077,0.09230769230769231
"[1, 1, 0, 0, 1, 0, 0, 0, 1, 1, 1, 0, 1, 1, 0]",112,51,61,6,6,0.11764705882352941,0.09836065573770492
"[0, 1, 0, 0, 1, 0, 1, 1, 0, 1, 0, 0, 1, 0, 1]",83,37,46,2,5,0.05405405405405406,0.10869565217391304
"[1, 1, 0, 0, 0, 0, 1, 1, 1, 0, 1, 1, 0, 0, 0]",186,98,88,11,5,0.11224489795918367,0.056818181818181816
"[1, 1, 0, 1, 1, 1, 0, 1, 0, 0, 0, 1, 1, 1, 0]",135,46,89,1,7,0.021739130434782608,0.07865168539325842
"[0, 1, 0, 0, 1, 0, 0, 1, 0, 1, 1, 0, 1, 1, 1]",113,52,61,3,9,0.057692307692307696,0.14754098360655737
"[0, 1, 1, 1, 0, 1, 1, 0, 1, 0, 1, 0, 1, 1, 1]",220,88,132,11,16,0.125,0.12121212121212122
"[0, 1, 0, 1, 1, 0, 1, 0, 0, 1, 1, 0, 1, 0, 1]",106,54,52,3,4,0.05555555555555555,0.07692307692307693
"[1, 0, 1, 1, 1, 0, 1, 0, 1, 0, 1, 0, 1, 0, 0]",127,56,71,8,7,0.14285714285714285,0.09859154929577464
"[0, 0, 1, 1, 1, 1, 1, 1, 1, 0, 1, 0, 1, 0, 0]",202,89,113,9,13,0.10112359550561797,0.11504424778761062
"[1, 0, 0, 0, 1, 1, 0, 1, 0, 1, 0, 1, 1, 0, 0]",131,75,56,7,7,0.09333333333333334,0.125
"[0, 0, 1, 0, 1, 1, 0, 0, 1, 1, 0, 1, 0, 1, 0]",107,64,43,8,3,0.125,0.06976744186046512
"[0, 1, 1, 0, 0, 1, 0, 1, 0, 0, 1, 1, 1, 0, 0]",140,82,58,13,7,0.15853658536585366,0.1206896551724138
"[1, 1, 1, 0, 0, 1, 0, 0, 0, 1, 0, 0, 0, 1, 1]",121,57,64,9,8,0.15789473684210525,0.125
"[0, 1, 1, 0, 0, 0, 1, 0, 0, 1, 1, 1, 0, 0, 1]",141,76,65,9,6,0.11842105263157894,0.09230769230769231
"[1, 1, 0, 0, 0, 1, 0, 1, 0, 1, 0, 0, 1, 1, 0]",142,71,71,8,7,0.11267605633802817,0.09859154929577464
"[1, 0, 1, 1, 0, 1, 0, 1, 0, 1, 0, 0, 1, 0, 1]",115,41,74,7,6,0.17073170731707318,0.08108108108108109
"[0, 0, 0, 1, 1, 0, 0, 1, 0, 0, 1, 1, 0, 0, 1]",217,143,74,14,9,0.0979020979020979,0.12162162162162163
"[1, 0, 0, 1, 0, 1, 1, 0, 0, 0, 0, 1, 1, 1, 1]",295,142,153,17,11,0.11971830985915492,0.0718954248366013
"[1, 1, 1, 0, 1, 1, 1, 0, 0, 1, 0, 1, 1, 0, 0]",137,50,87,6,11,0.12,0.12643678160919541
"[1, 0, 1, 1, 1, 1, 1, 0, 1, 0, 0, 1, 0, 0, 1]",165,60,105,7,9,0.11666666666666667,0.08571428571428572
"[0, 0, 1, 0, 0, 1, 0, 1, 0, 0, 1, 1, 0, 1, 1]",124,66,58,9,5,0.13636363636363635,0.08620689655172414
"[0, 0, 0, 1, 0, 0, 1, 0, 1, 0, 0, 1, 1, 0, 1]",134,83,51,7,4,0.08433734939759036,0.0784313725490196
"[1, 0, 0, 0, 1, 1, 0, 0, 1, 0, 0, 0, 1, 1, 1]",146,78,68,6,5,0.07692307692307693,0.07352941176470588
"[1, 0, 1, 0, 1, 1, 1, 1, 0, 0, 1, 0, 0, 0, 0]",138,73,65,4,11,0.0547945205479452,0.16923076923076924
"[1, 1, 1, 0, 1, 1, 0, 0, 0, 0, 1, 0, 1, 1, 1]",194,85,109,9,11,0.10588235294117647,0.10091743119266056
"[1, 0, 0, 0, 1, 0, 1, 0, 1, 0, 1, 0, 0, 0, 1]",142,84,58,9,4,0.10714285714285714,0.06896551724137931
"[1, 1, 0, 0, 0, 0, 1, 0, 0, 1, 0, 1, 0, 1, 0]",131,74,57,9,4,0.12162162162162163,0.07017543859649122
"[1, 1, 1, 0, 0, 1, 0, 1, 1, 1, 0, 1, 0, 1, 0]",146,52,94,4,8,0.07692307692307693,0.0851063829787234
"[1, 1, 1, 0, 1, 1, 1, 1, 0, 0, 0, 0, 0, 0, 0]",332,153,179,15,20,0.09803921568627451,0.11173184357541899
"[1, 0, 1, 1, 1, 0, 1, 0, 1, 0, 0, 1, 1, 1, 0]",150,58,92,5,7,0.08620689655172414,0.07608695652173914
"[1, 1, 1, 1, 1, 1, 0, 1, 1, 0, 0, 0, 1, 0, 1]",265,68,197,7,17,0.10294117647058823,0.08629441624365482
"[0, 1, 1, 0, 1, 0, 0, 0, 0, 1, 1, 0, 0, 1, 0]",158,96,62,8,4,0.08333333333333333,0.06451612903225806
"[1, 0, 0, 1, 0, 1, 0, 0, 0, 0, 1, 1, 0, 1, 1]",133,70,63,4,3,0.05714285714285714,0.047619047619047616
"[1, 0, 1, 0, 0, 0, 1, 0, 1, 0, 0, 1, 0, 0, 1]",128,76,52,6,2,0.07894736842105263,0.038461538461538464
"[0, 1, 0, 1, 0, 0, 1, 1, 0, 0, 0, 1, 0, 1, 1]",116,71,45,8,7,0.11267605633802817,0.15555555555555556
"[0, 0, 1, 0, 0, 1, 1, 1, 1, 1, 1, 0, 1, 0, 0]",140,58,82,8,8,0.13793103448275862,0.0975609756097561
"[0, 0, 0, 1, 1, 1, 1, 0, 1, 0, 0, 0, 0, 0, 1]",215,135,80,11,10,0.08148148148148149,0.125
"[0, 0, 1, 1, 0, 1, 0, 0, 1, 0, 0, 1, 1, 0, 0]",218,125,93,11,12,0.088,0.12903225806451613
"[0, 0, 0, 1, 1, 0, 1, 0, 0, 1, 0, 0, 1, 1, 0]",172,103,69,4,6,0.038834951456310676,0.08695652173913043
"[1, 0, 0, 0, 1, 1, 0, 1, 0, 0, 0, 1, 1, 1, 1]",169,60,109,4,13,0.06666666666666667,0.11926605504587157
"[0, 0, 0, 1, 1, 0, 1, 0, 1, 1, 1, 1, 0, 0, 0]",175,95,80,6,10,0.06315789473684211,0.125
"[1, 0, 0, 0, 1, 0, 0, 0, 1, 0, 1, 0, 0, 0, 0]",536,374,162,37,16,0.09893048128342247,0.09876543209876543
"[0, 0, 1, 1, 1, 0, 0, 0, 1, 0, 0, 1, 1, 1, 0]",115,58,57,4,1,0.06896551724137931,0.017543859649122806
"[1, 0, 0, 1, 1, 0, 1, 0, 1, 1, 0, 1, 0, 1, 0]",89,42,47,0,6,0.0,0.1276595744680851
"[1, 1, 0, 0, 0, 0, 1, 1, 0, 1, 0, 0, 1, 0, 1]",146,79,67,13,6,0.16455696202531644,0.08955223880597014
"[0, 1, 0, 0, 1, 0, 1, 1, 0, 0, 1, 0, 1, 1, 0]",98,47,51,5,5,0.10638297872340426,0.09803921568627451
"[0, 1, 0, 1, 0, 0, 0, 0, 1, 0, 0, 1, 0, 1, 0]",223,155,68,17,5,0.10967741935483871,0.07352941176470588
"[1, 1, 1, 1, 0, 0, 0, 0, 0, 1, 0, 1, 0, 0, 1]",186,102,84,14,7,0.13725490196078433,0.08333333333333333
"[0, 0, 1, 0, 1, 0, 1, 1, 1, 1, 0, 1, 0, 0, 1]",106,55,51,9,6,0.16363636363636364,0.11764705882352941
"[1, 0, 0, 1, 0, 0, 1, 0, 1, 0, 1, 1, 1, 1, 0]",121,52,69,3,3,0.057692307692307696,0.043478260869565216
"[1, 0, 0, 0, 1, 1, 1, 0, 1, 0, 1, 0, 0, 1, 1]",131,51,80,6,13,0.11764705882352941,0.1625
"[0, 1, 1, 1, 1, 0, 1, 0, 0, 0, 1, 1, 0, 1, 0]",132,72,60,5,7,0.06944444444444445,0.11666666666666667
"[0, 1, 1, 0, 1, 1, 0, 1, 0, 0, 0, 1, 0, 1, 1]",91,41,50,7,8,0.17073170731707318,0.16
"[0, 0, 0, 0, 0, 1, 0, 1, 0, 1, 0, 1, 1, 1, 0]",144,77,67,9,6,0.11688311688311688,0.08955223880597014
"[0, 1, 1, 1, 0, 1, 0, 1, 1, 1, 1, 1, 0, 0, 1]",268,94,174,4,21,0.0425531914893617,0.1206896551724138
"[1, 0, 0, 1, 0, 0, 0, 0, 0, 1, 0, 1, 1, 0, 1]",133,77,56,7,4,0.09090909090909091,0.07142857142857142
"[1, 1, 1, 0, 1, 0, 1, 0, 0, 0, 1, 1, 1, 1, 1]",358,136,222,11,27,0.08088235294117647,0.12162162162162163
"[1, 1, 0, 1, 0, 1, 0, 0, 0, 1, 0, 1, 1, 0, 1]",107,48,59,2,7,0.041666666666666664,0.11864406779661017
"[0, 0, 1, 0, 1, 0, 1, 1, 1, 0, 1, 1, 0, 1, 1]",159,58,101,6,10,0.10344827586206896,0.09900990099009901
"[0, 0, 1, 0, 1, 0, 1, 0, 0, 0, 1, 0, 0, 1, 1]",168,104,64,7,1,0.0673076923076923,0.015625
"[1, 1, 0, 1, 1, 0, 1, 1, 1, 1, 1, 1, 0, 0, 0]",413,150,263,20,17,0.13333333333333333,0.06463878326996197
"[1, 1, 0, 1, 1, 1, 1, 0, 1, 0, 1, 0, 1, 1, 0]",232,78,154,9,12,0.11538461538461539,0.07792207792207792
"[0, 1, 1, 1, 0, 0, 0, 0, 0, 1, 1, 1, 1, 1, 0]",154,85,69,5,6,0.058823529411764705,0.08695652173913043
"[1, 0, 0, 1, 1, 0, 1, 1, 1, 0, 0, 0, 0, 0, 1]",145,66,79,4,10,0.06060606060606061,0.12658227848101267
"[0, 0, 1, 0, 0, 0, 1, 1, 1, 0, 1, 0, 0, 0, 1]",153,87,66,7,5,0.08045977011494253,0.07575757575757576
"[1, 0, 0, 1, 0, 0, 0, 1, 1, 1, 0, 1, 0, 0, 0]",147,88,59,11,10,0.125,0.1694915254237288
"[0, 0, 0, 1, 1, 1, 0, 0, 1, 0, 0, 1, 0, 1, 0]",137,79,58,4,6,0.05063291139240506,0.10344827586206896
"[0, 1, 1, 1, 1, 0, 1, 0, 1, 1, 0, 0, 1, 0, 1]",112,47,65,5,7,0.10638297872340426,0.1076923076923077
"[0, 0, 1, 0, 0, 0, 1, 1, 1, 0, 0, 0, 0, 0, 1]",278,186,92,19,10,0.10215053763440861,0.10869565217391304
"[1, 1, 1, 0, 1, 0, 1, 1, 1, 0, 0, 1, 0, 0, 1]",172,77,95,9,5,0.11688311688311688,0.05263157894736842
"[0, 1, 1, 1, 0, 0, 0, 0, 1, 0, 1, 0, 1, 0, 0]",140,88,52,6,6,0.06818181818181818,0.11538461538461539
"[1, 1, 0, 1, 1, 1, 0, 1, 0, 0, 0, 0, 0, 0, 1]",138,66,72,3,5,0.045454545454545456,0.06944444444444445
"[0, 0, 1, 1, 1, 0, 1, 0, 1, 1, 1, 0, 0, 1, 1]",231,101,130,18,17,0.1782178217821782,0.13076923076923078
"[1, 0, 0, 0, 1, 0, 0, 0, 1, 1, 0, 0, 0, 1, 1]",206,105,101,12,9,0.11428571428571428,0.0891089108910891
"[1, 0, 0, 0, 1, 1, 1, 0, 0, 0, 1, 1, 0, 0, 1]",136,65,71,4,3,0.06153846153846154,0.04225352112676056
"[0, 1, 1, 0, 0, 1, 1, 1, 1, 0, 0, 0, 0, 1, 0]",326,242,84,17,8,0.07024793388429752,0.09523809523809523
"[1, 1, 0, 1, 1, 0, 0, 1, 1, 0, 0, 1, 0, 0, 0]",112,53,59,7,10,0.1320754716981132,0.1694915254237288
"[1, 1, 1, 1, 0, 1, 1, 0, 0, 1, 1, 0, 0, 1, 0]",159,64,95,5,11,0.078125,0.11578947368421053
"[1, 0, 0, 1, 1, 1, 1, 0, 1, 0, 0, 1, 1, 0, 0]",170,54,116,7,10,0.12962962962962962,0.08620689655172414
"[0, 0, 0, 0, 1, 1, 1, 0, 1, 1, 1, 1, 0, 0, 0]",186,95,91,12,2,0.12631578947368421,0.02197802197802198
"[0, 0, 1, 0, 0, 0, 1, 1, 1, 0, 1, 0, 1, 0, 1]",111,57,54,4,4,0.07017543859649122,0.07407407407407407
"[0, 1, 0, 1, 1, 0, 1, 0, 1, 0, 1, 1, 0, 0, 0]",99,57,42,5,4,0.08771929824561403,0.09523809523809523
"[0, 0, 0, 1, 1, 1, 0, 1, 1, 0, 1, 1, 1, 1, 1]",357,150,207,9,17,0.06,0.0821256038647343
"[1, 1, 1, 0, 1, 1, 0, 0, 0, 1, 0, 0, 0, 1, 0]",112,60,52,7,4,0.11666666666666667,0.07692307692307693
"[1, 1, 1, 0, 1, 0, 0, 0, 1, 1, 1, 1, 1, 0, 0]",195,79,116,4,18,0.05063291139240506,0.15517241379310345
"[0, 1, 1, 1, 0, 0, 0, 0, 1, 0, 1, 1, 0, 1, 0]",105,57,48,4,6,0.07017543859649122,0.125
"[0, 0, 0, 1, 0, 1, 0, 1, 1, 0, 0, 0, 0, 1, 0]",203,136,67,17,9,0.125,0.13432835820895522
"[1, 0, 0, 0, 1, 0, 0, 0, 0, 0, 1, 0, 1, 0, 1]",216,142,74,14,12,0.09859154929577464,0.16216216216216217
"[1, 1, 1, 0, 0, 1, 0, 0, 1, 1, 1, 1, 0, 1, 0]",151,56,95,9,10,0.16071428571428573,0.10526315789473684
"[0, 1, 1, 0, 1, 1, 1, 1, 1, 1, 0, 0, 1, 0, 0]",168,75,93,12,13,0.16,0.13978494623655913
"[0, 0, 0, 0, 1, 0, 0, 0, 1, 1, 0, 1, 1, 1, 1]",203,126,77,11,8,0.0873015873015873,0.1038961038961039
"[1, 0, 0, 1, 1, 0, 1, 0, 1, 0, 1, 1, 0, 1, 0]",96,48,48,3,8,0.0625,0.16666666666666666
"[1, 0, 1, 0, 1, 0, 0, 1, 0, 1, 0, 1, 0, 0, 1]",115,68,47,8,8,0.11764705882352941,0.1702127659574468
"[1, 1, 1, 0, 1, 0, 1, 0, 1, 0, 1, 0, 1, 0, 1]",115,46,69,1,5,0.021739130434782608,0.07246376811594203
"[0, 1, 1, 0, 1, 0, 0, 1, 0, 0, 0, 0, 0, 1, 1]",199,113,86,9,10,0.07964601769911504,0.11627906976744186
"[0, 1, 1, 1, 1, 0, 0, 0, 0, 1, 0, 0, 1, 1, 0]",196,126,70,9,6,0.07142857142857142,0.08571428571428572
"[1, 1, 1, 0, 0, 0, 0, 0, 1, 1, 1, 0, 1, 1, 0]",136,59,77,2,12,0.03389830508474576,0.15584415584415584
"[0, 1, 1, 0, 1, 1, 0, 1, 0, 0, 1, 0, 1, 0, 1]",108,44,64,3,9,0.06818181818181818,0.140625
"[1, 1, 0, 0, 1, 1, 1, 0, 1, 1, 1, 0, 1, 1, 0]",229,83,146,5,4,0.060240963855421686,0.0273972602739726
"[0, 1, 1, 0, 0, 0, 0, 0, 1, 1, 1, 0, 1, 0, 1]",125,81,44,7,7,0.08641975308641975,0.1590909090909091
"[0, 1, 1, 0, 1, 0, 0, 0, 0, 0, 0, 1, 0, 1, 1]",173,99,74,8,5,0.08080808080808081,0.06756756756756757
"[1, 0, 0, 0, 1, 0, 0, 1, 0, 1, 0, 0, 1, 0, 0]",218,144,74,12,3,0.08333333333333333,0.04054054054054054
"[0, 0, 0, 1, 1, 1, 1, 0, 0, 1, 0, 0, 0, 1, 1]",224,157,67,14,9,0.08917197452229299,0.13432835820895522
"[0, 1, 1, 1, 1, 1, 0, 0, 0, 1, 0, 0, 0, 1, 0]",128,71,57,11,6,0.15492957746478872,0.10526315789473684
"[1, 0, 1, 1, 0, 0, 1, 0, 1, 0, 0, 0, 1, 1, 1]",134,64,70,10,5,0.15625,0.07142857142857142
"[1, 0, 1, 0, 1, 0, 0, 0, 0, 1, 0, 0, 0, 0, 1]",248,162,86,17,9,0.10493827160493827,0.10465116279069768
"[1, 0, 0, 1, 1, 0, 1, 0, 1, 0, 1, 0, 0, 0, 0]",168,99,69,10,3,0.10101010101010101,0.043478260869565216
"[1, 0, 0, 0, 0, 1, 0, 1, 1, 0, 1, 1, 1, 0, 1]",114,57,57,4,5,0.07017543859649122,0.08771929824561403
"[1, 0, 0, 1, 0, 0, 1, 0, 0, 0, 0, 1, 0, 1, 1]",150,97,53,10,3,0.10309278350515463,0.05660377358490566
"[1, 0, 0, 1, 0, 1, 1, 1, 0, 0, 0, 0, 1, 1, 0]",173,88,85,8,8,0.09090909090909091,0.09411764705882353
"[1, 1, 0, 1, 1, 0, 0, 0, 1, 0, 0, 1, 0, 0, 0]",150,84,66,9,5,0.10714285714285714,0.07575757575757576
"[0, 0, 1, 0, 1, 0, 0, 1, 1, 1, 1, 0, 1, 1, 1]",186,81,105,5,12,0.06172839506172839,0.11428571428571428
"[0, 1, 0, 0, 0, 1, 0, 1, 0, 0, 1, 1, 1, 1, 0]",156,84,72,11,6,0.13095238095238096,0.08333333333333333
"[1, 0, 1, 0, 0, 1, 0, 0, 0, 0, 0, 1, 1, 0, 1]",146,77,69,9,6,0.11688311688311688,0.08695652173913043
"[0, 0, 1, 0, 1, 1, 1, 1, 0, 1, 0, 1, 1, 0, 1]",142,66,76,8,6,0.12121212121212122,0.07894736842105263
"[0, 1, 0, 0, 1, 1, 0, 1, 0, 0, 0, 1, 1, 0, 1]",99,55,44,6,5,0.10909090909090909,0.11363636363636363
"[0, 1, 1, 0, 1, 0, 0, 0, 1, 1, 0, 1, 0, 0, 0]",145,87,58,10,7,0.11494252873563218,0.1206896551724138
"[0, 1, 1, 1, 0, 0, 0, 0, 1, 1, 1, 0, 1, 1, 0]",137,62,75,9,5,0.14516129032258066,0.06666666666666667
"[0, 1, 0, 0, 1, 0, 1, 1, 0, 0, 0, 1, 0, 1, 0]",135,82,53,6,6,0.07317073170731707,0.11320754716981132
"[1, 1, 0, 0, 0, 0, 1, 0, 1, 0, 1, 1, 1, 1, 0]",144,59,85,5,10,0.0847457627118644,0.11764705882352941
"[0, 1, 0, 1, 0, 1, 1, 0, 1, 1, 1, 0, 1, 0, 0]",112,51,61,3,5,0.058823529411764705,0.08196721311475409
"[0, 0, 1, 0, 0, 1, 0, 1, 1, 0, 1, 0, 0, 0, 0]",235,149,86,16,5,0.10738255033557047,0.05813953488372093
"[1, 1, 0, 1, 0, 0, 1, 0, 0, 1, 1, 0, 1, 1, 0]",110,50,60,4,6,0.08,0.1
"[0, 1, 0, 1, 1, 0, 0, 1, 1, 0, 1, 0, 0, 0, 1]",119,58,61,7,7,0.1206896551724138,0.11475409836065574
"[0, 0, 0, 1, 1, 1, 1, 1, 1, 1, 0, 0, 1, 0, 1]",250,126,124,6,11,0.047619047619047616,0.08870967741935484
"[0, 1, 0, 0, 1, 1, 0, 1, 1, 0, 0, 0, 0, 1, 0]",128,74,54,9,9,0.12162162162162163,0.16666666666666666
"[1, 1, 0, 0, 0, 0, 1, 0, 1, 0, 1, 1, 0, 1, 0]",116,64,52,7,3,0.109375,0.057692307692307696
"[0, 0, 0, 0, 1, 0, 1, 1, 0, 1, 1, 1, 0, 0, 0]",164,89,75,11,10,0.12359550561797752,0.13333333333333333
"[0, 0, 0, 1, 0, 0, 1, 0, 1, 1, 0, 1, 1, 0, 1]",123,69,54,6,2,0.08695652173913043,0.037037037037037035
"[0, 0, 0, 1, 1, 0, 1, 1, 0, 0, 1, 0, 0, 1, 0]",134,83,51,5,6,0.060240963855421686,0.11764705882352941
"[0, 1, 0, 1, 1, 0, 0, 1, 1, 1, 0, 0, 0, 0, 1]",147,76,71,4,10,0.05263157894736842,0.14084507042253522
"[0, 0, 1, 0, 0, 0, 1, 1, 0, 0, 0, 0, 0, 1, 1]",386,271,115,29,8,0.1070110701107011,0.06956521739130435
"[1, 1, 0, 1, 0, 1, 0, 0, 1, 0, 0, 0, 0, 0, 1]",163,95,68,7,3,0.07368421052631578,0.04411764705882353
"[0, 1, 0, 1, 0, 1, 1, 0, 1, 1, 1, 1, 0, 1, 0]",131,58,73,5,4,0.08620689655172414,0.0547945205479452
"[1, 1, 1, 0, 0, 1, 0, 1, 1, 0, 1, 0, 0, 0, 0]",127,62,65,2,8,0.03225806451612903,0.12307692307692308
"[1, 1, 1, 0, 0, 0, 1, 1, 0, 0, 0, 1, 0, 0, 1]",142,65,77,4,4,0.06153846153846154,0.05194805194805195
"[0, 1, 1, 1, 0, 0, 0, 1, 1, 1, 0, 1, 0, 0, 1]",137,66,71,8,3,0.12121212121212122,0.04225352112676056
"[0, 0, 1, 1, 0, 1, 0, 1, 1, 0, 0, 1, 0, 0, 1]",109,57,52,6,5,0.10526315789473684,0.09615384615384616
"[1, 0, 1, 0, 1, 1, 0, 1, 0, 0, 1, 1, 1, 1, 0]",167,68,99,3,9,0.04411764705882353,0.09090909090909091
"[0, 0, 0, 1, 1, 1, 0, 0, 0, 1, 0, 0, 0, 1, 0]",263,170,93,20,12,0.11764705882352941,0.12903225806451613
"[1, 1, 0, 0, 1, 1, 0, 1, 1, 0, 1, 0, 0, 1, 1]",196,85,111,11,5,0.12941176470588237,0.04504504504504504
"[1, 1, 1, 0, 0, 0, 0, 1, 0, 0, 1, 0, 0, 1, 1]",181,88,93,4,7,0.045454545454545456,0.07526881720430108
"[0, 0, 0, 0, 1, 0, 1, 0, 1, 0, 1, 1, 1, 1, 1]",201,93,108,8,14,0.08602150537634409,0.12962962962962962
"[1, 0, 0, 0, 1, 1, 1, 0, 1, 0, 1, 0, 0, 1, 0]",92,56,36,5,3,0.08928571428571429,0.08333333333333333
"[1, 1, 1, 0, 1, 1, 1, 0, 0, 0, 1, 0, 1, 1, 0]",136,56,80,3,7,0.05357142857142857,0.0875
"[0, 1, 1, 0, 1, 1, 0, 1, 0, 0, 1, 0, 0, 0, 0]",157,94,63,10,2,0.10638297872340426,0.031746031746031744
"[1, 1, 0, 0, 0, 0, 1, 0, 0, 1, 1, 0, 1, 1, 1]",182,91,91,10,5,0.10989010989010989,0.054945054945054944
"[0, 1, 1, 1, 0, 0, 1, 0, 0, 0, 1, 0, 1, 1, 1]",153,77,76,9,11,0.11688311688311688,0.14473684210526316
"[1, 0, 1, 1, 0, 0, 0, 1, 0, 0, 1, 1, 0, 1, 0]",106,66,40,6,9,0.09090909090909091,0.225
"[0, 1, 1, 1, 1, 1, 0, 1, 0, 1, 1, 0, 1, 0, 0]",131,63,68,5,9,0.07936507936507936,0.1323529411764706
"[1, 0, 0, 1, 0, 1, 1, 1, 0, 0, 1, 0, 1, 1, 0]",105,31,74,2,6,0.06451612903225806,0.08108108108108109
"[0, 1, 0, 1, 0, 1, 0, 1, 0, 1, 0, 0, 0, 0, 1]",133,77,56,6,5,0.07792207792207792,0.08928571428571429
"[0, 0, 0, 0, 1, 0, 1, 1, 0, 0, 0, 1, 1, 1, 1]",216,129,87,19,9,0.14728682170542637,0.10344827586206896
"[1, 0, 1, 1, 0, 0, 0, 0, 0, 1, 0, 1, 1, 1, 1]",180,85,95,10,9,0.11764705882352941,0.09473684210526316
"[1, 1, 0, 1, 0, 0, 0, 0, 0, 1, 0, 0, 1, 0, 0]",223,151,72,16,6,0.10596026490066225,0.08333333333333333
"[1, 0, 0, 1, 1, 0, 1, 0, 1, 0, 0, 0, 0, 1, 1]",190,82,108,8,11,0.0975609756097561,0.10185185185185185
"[1, 0, 0, 0, 1, 1, 1, 1, 0, 0, 0, 0, 1, 0, 1]",146,71,75,7,12,0.09859154929577464,0.16
"[1, 0, 0, 0, 1, 1, 0, 1, 0, 1, 1, 1, 0, 1, 0]",105,53,52,6,5,0.11320754716981132,0.09615384615384616
"[1, 1, 0, 0, 1, 0, 1, 0, 1, 0, 0, 1, 1, 1, 1]",213,85,128,13,14,0.15294117647058825,0.109375
"[0, 1, 1, 1, 0, 1, 1, 1, 0, 1, 1, 0, 0, 1, 0]",120,45,75,4,5,0.08888888888888889,0.06666666666666667
"[0, 0, 1, 0, 1, 0, 1, 1, 1, 1, 0, 1, 0, 0, 0]",125,68,57,11,6,0.16176470588235295,0.10526315789473684
"[1, 0, 1, 1, 0, 0, 0, 1, 0, 0, 0, 1, 1, 1, 0]",115,60,55,7,10,0.11666666666666667,0.18181818181818182
"[0, 1, 0, 1, 1, 1, 0, 1, 0, 1, 1, 0, 1, 0, 0]",99,42,57,4,4,0.09523809523809523,0.07017543859649122
"[1, 1, 0, 1, 1, 1, 1, 0, 0, 0, 0, 0, 0, 0, 1]",199,102,97,10,6,0.09803921568627451,0.061855670103092786
"[0, 0, 1, 1, 1, 1, 1, 0, 0, 1, 0, 1, 1, 1, 1]",361,131,230,11,29,0.08396946564885496,0.12608695652173912
"[1, 0, 1, 0, 0, 0, 1, 0, 0, 0, 1, 1, 0, 1, 0]",129,81,48,7,5,0.08641975308641975,0.10416666666666667
"[1, 0, 1, 0, 1, 0, 0, 1, 0, 0, 1, 1, 1, 1, 1]",217,105,112,12,7,0.11428571428571428,0.0625
"[0, 1, 0, 1, 0, 1, 0, 0, 1, 0, 0, 1, 1, 1, 1]",172,85,87,8,8,0.09411764705882353,0.09195402298850575
"[0, 0, 0, 1, 0, 1, 1, 0, 0, 1, 1, 0, 0, 0, 1]",189,106,83,16,6,0.1509433962264151,0.07228915662650602
"[0, 0, 1, 0, 0, 0, 1, 1, 0, 1, 1, 1, 1, 0, 1]",108,43,65,6,7,0.13953488372093023,0.1076923076923077
"[0, 0, 0, 1, 0, 1, 1, 0, 1, 1, 1, 0, 1, 0, 1]",97,57,40,5,4,0.08771929824561403,0.1
"[0, 1, 1, 0, 1, 1, 0, 0, 0, 1, 0, 1, 1, 0, 0]",131,65,66,6,9,0.09230769230769231,0.13636363636363635
"[0, 1, 0, 1, 0, 1, 0, 1, 1, 0, 0, 0, 1, 1, 1]",160,73,87,12,7,0.1643835616438356,0.08045977011494253
"[1, 0, 0, 0, 0, 0, 1, 0, 1, 1, 0, 1, 1, 1, 0]",108,60,48,4,3,0.06666666666666667,0.0625
"[1, 1, 0, 1, 0, 1, 0, 0, 1, 1, 0, 0, 0, 1, 1]",144,58,86,8,14,0.13793103448275862,0.16279069767441862
"[1, 0, 1, 1, 0, 0, 0, 0, 0, 1, 0, 1, 0, 0, 0]",274,190,84,26,8,0.1368421052631579,0.09523809523809523
"[0, 1, 0, 0, 0, 1, 1, 0, 1, 1, 0, 0, 1, 1, 1]",169,78,91,13,10,0.16666666666666666,0.10989010989010989
"[0, 1, 1, 1, 0, 0, 1, 0, 0, 0, 0, 1, 1, 1, 0]",114,60,54,5,2,0.08333333333333333,0.037037037037037035
"[0, 1, 0, 1, 0, 1, 0, 0, 1, 1, 0, 0, 1, 1, 0]",176,108,68,9,6,0.08333333333333333,0.08823529411764706
"[0, 1, 0, 1, 0, 1, 0, 1, 0, 0, 1, 1, 0, 0, 1]",120,51,69,3,8,0.058823529411764705,0.11594202898550725
"[1, 0, 1, 1, 1, 0, 1, 1, 0, 0, 0, 0, 0, 0, 0]",237,115,122,8,6,0.06956521739130435,0.04918032786885246
"[1, 0, 1, 1, 1, 1, 0, 0, 1, 0, 0, 0, 1, 1, 0]",143,60,83,6,8,0.1,0.0963855421686747
"[0, 0, 0, 1, 0, 1, 1, 1, 1, 0, 0, 1, 1, 0, 1]",151,84,67,6,5,0.07142857142857142,0.07462686567164178
"[1, 1, 1, 1, 0, 0, 0, 1, 0, 0, 1, 1, 0, 0, 1]",179,80,99,7,10,0.0875,0.10101010101010101
"[1, 1, 0, 1, 1, 0, 1, 1, 0, 0, 0, 0, 0, 1, 1]",177,85,92,10,7,0.11764705882352941,0.07608695652173914
"[1, 1, 0, 0, 0, 1, 1, 0, 0, 0, 0, 1, 1, 0, 1]",141,83,58,10,3,0.12048192771084337,0.05172413793103448
"[1, 0, 1, 0, 0, 1, 1, 1, 0, 1, 0, 0, 1, 1, 0]",117,61,56,5,6,0.08196721311475409,0.10714285714285714
"[0, 0, 1, 1, 1, 1, 1, 0, 0, 0, 1, 0, 1, 1, 1]",214,81,133,13,11,0.16049382716049382,0.08270676691729323
"[1, 1, 1, 0, 0, 1, 1, 1, 0, 1, 0, 1, 1, 0, 1]",257,81,176,5,11,0.06172839506172839,0.0625
"[1, 1, 1, 1, 1, 0, 1, 1, 0, 0, 1, 0, 0, 0, 0]",156,70,86,5,12,0.07142857142857142,0.13953488372093023
"[1, 1, 0, 0, 1, 1, 0, 0, 1, 0, 1, 1, 1, 0, 0]",156,69,87,4,9,0.057971014492753624,0.10344827586206896
"[0, 0, 0, 0, 1, 0, 0, 1, 1, 1, 0, 0, 0, 1, 1]",201,129,72,16,11,0.12403100775193798,0.1527777777777778
"[0, 0, 0, 0, 0, 0, 1, 1, 1, 0, 1, 1, 1, 0, 1]",168,91,77,9,7,0.0989010989010989,0.09090909090909091
"[0, 1, 0, 1, 0, 0, 1, 0, 0, 0, 1, 1, 0, 1, 0]",123,67,56,7,9,0.1044776119402985,0.16071428571428573
"[1, 0, 0, 0, 0, 1, 1, 1, 0, 1, 1, 1, 0, 1, 0]",129,63,66,9,7,0.14285714285714285,0.10606060606060606
"[1, 1, 1, 0, 0, 1, 0, 0, 1, 1, 0, 1, 0, 1, 1]",186,93,93,12,9,0.12903225806451613,0.0967741935483871
"[0, 0, 0, 0, 1, 1, 0, 1, 0, 0, 0, 1, 1, 1, 0]",176,102,74,7,8,0.06862745098039216,0.10810810810810811
"[1, 1, 0, 0, 1, 0, 0, 1, 0, 0, 0, 0, 1, 1, 0]",200,121,79,14,8,0.11570247933884298,0.10126582278481013
"[0, 1, 1, 0, 1, 0, 0, 0, 1, 1, 1, 1, 0, 1, 0]",106,49,57,4,4,0.08163265306122448,0.07017543859649122
"[1, 0, 1, 0, 1, 1, 1, 1, 0, 0, 1, 1, 1, 0, 1]",268,80,188,3,18,0.0375,0.09574468085106383
"[0, 1, 1, 1, 0, 1, 1, 1, 1, 0, 0, 0, 1, 0, 1]",139,62,77,5,13,0.08064516129032258,0.16883116883116883
"[0, 0, 0, 1, 1, 1, 0, 1, 1, 1, 1, 0, 0, 0, 1]",141,68,73,8,7,0.11764705882352941,0.0958904109589041
"[0, 1, 1, 0, 0, 0, 0, 1, 1, 1, 1, 0, 1, 0, 0]",230,166,64,14,7,0.08433734939759036,0.109375
"[0, 1, 0, 0, 1, 0, 1, 1, 1, 0, 1, 1, 1, 1, 0]",141,59,82,7,6,0.11864406779661017,0.07317073170731707
"[0, 0, 0, 0, 1, 1, 1, 0, 1, 1, 1, 1, 0, 1, 0]",130,64,66,4,5,0.0625,0.07575757575757576
"[0, 1, 0, 0, 0, 1, 0, 1, 1, 1, 0, 0, 0, 0, 1]",160,96,64,7,6,0.07291666666666667,0.09375
"[1, 1, 1, 1, 0, 1, 0, 1, 0, 0, 0, 0, 0, 1, 1]",162,67,95,5,11,0.07462686567164178,0.11578947368421053
"[1, 0, 1, 1, 0, 1, 1, 1, 0, 0, 0, 1, 1, 1, 0]",160,50,110,4,9,0.08,0.08181818181818182
"[1, 1, 0, 0, 1, 0, 0, 0, 0, 0, 1, 0, 0, 0, 1]",236,144,92,12,7,0.08333333333333333,0.07608695652173914
"[1, 1, 0, 0, 1, 1, 0, 1, 1, 0, 0, 0, 0, 1, 0]",109,55,54,4,9,0.07272727272727272,0.16666666666666666
"[0, 0, 1, 0, 1, 0, 1, 1, 0, 1, 1, 0, 1, 0, 0]",110,59,51,7,4,0.11864406779661017,0.0784313725490196
"[0, 0, 0, 1, 1, 1, 1, 0, 1, 0, 0, 1, 0, 0, 0]",195,126,69,10,6,0.07936507936507936,0.08695652173913043
"[1, 1, 1, 0, 1, 1, 0, 1, 0, 0, 1, 0, 0, 1, 0]",99,52,47,4,7,0.07692307692307693,0.14893617021276595
"[1, 0, 1, 0, 0, 0, 1, 1, 0, 0, 0, 1, 1, 0, 0]",192,111,81,8,3,0.07207207207207207,0.037037037037037035
"[1, 0, 1, 1, 1, 0, 0, 1, 0, 0, 1, 1, 0, 1, 0]",126,61,65,2,10,0.03278688524590164,0.15384615384615385
"[1, 0, 0, 0, 0, 0, 1, 1, 1, 0, 1, 1, 1, 1, 0]",144,57,87,3,10,0.05263157894736842,0.11494252873563218
"[1, 1, 1, 0, 1, 0, 1, 0, 1, 1, 0, 0, 0, 1, 0]",97,51,46,6,3,0.11764705882352941,0.06521739130434782
"[0, 0, 0, 0, 1, 0, 1, 1, 0, 0, 1, 1, 0, 1, 0]",147,86,61,7,7,0.08139534883720931,0.11475409836065574
"[0, 1, 0, 0, 0, 1, 0, 1, 1, 0, 0, 1, 0, 1, 1]",118,56,62,3,4,0.05357142857142857,0.06451612903225806
"[0, 0, 1, 0, 1, 1, 0, 0, 0, 1, 0, 0, 1, 0, 1]",140,88,52,11,4,0.125,0.07692307692307693
"[1, 0, 0, 0, 1, 0, 0, 1, 1, 1, 1, 0, 1, 0, 0]",118,59,59,6,3,0.1016949152542373,0.05084745762711865
"[1, 1, 1, 0, 0, 1, 1, 0, 0, 0, 1, 1, 0, 0, 1]",238,88,150,14,7,0.1590909090909091,0.04666666666666667
"[1, 0, 1, 1, 1, 0, 0, 1, 0, 0, 0, 1, 0, 0, 1]",108,55,53,4,12,0.07272727272727272,0.22641509433962265
"[1, 0, 0, 1, 0, 1, 1, 0, 1, 0, 1, 1, 0, 1, 1]",149,55,94,8,13,0.14545454545454545,0.13829787234042554
"[0, 1, 0, 1, 0, 1, 0, 0, 1, 0, 0, 0, 1, 1, 1]",137,70,67,8,3,0.11428571428571428,0.04477611940298507
"[1, 0, 1, 1, 0, 0, 1, 1, 0, 1, 1, 0, 0, 1, 0]",103,52,51,5,8,0.09615384615384616,0.1568627450980392
"[1, 0, 1, 1, 0, 1, 0, 0, 0, 0, 1, 0, 1, 0, 1]",113,57,56,8,3,0.14035087719298245,0.05357142857142857
"[1, 0, 1, 0, 0, 1, 0, 1, 1, 0, 1, 0, 1, 0, 0]",113,62,51,8,3,0.12903225806451613,0.058823529411764705
"[1, 0, 1, 1, 1, 0, 0, 0, 1, 0, 1, 1, 1, 0, 0]",120,51,69,4,5,0.0784313725490196,0.07246376811594203
"[0, 1, 0, 1, 1, 1, 0, 0, 0, 1, 0, 1, 1, 1, 0]",101,55,46,4,3,0.07272727272727272,0.06521739130434782
"[1, 0, 1, 0, 0, 1, 0, 0, 0, 1, 1, 0, 0, 1, 0]",124,68,56,8,11,0.11764705882352941,0.19642857142857142
"[1, 1, 0, 1, 1, 1, 0, 1, 0, 0, 0, 1, 1, 0, 1]",153,71,82,6,6,0.08450704225352113,0.07317073170731707
"[0, 0, 1, 1, 0, 1, 0, 1, 0, 0, 1, 0, 0, 1, 0]",134,83,51,6,4,0.07228915662650602,0.0784313725490196
"[0, 0, 0, 1, 1, 0, 1, 0, 1, 0, 0, 1, 0, 0, 1]",145,88,57,8,1,0.09090909090909091,0.017543859649122806
"[1, 0, 1, 0, 0, 1, 1, 0, 1, 0, 1, 0, 1, 0, 0]",120,64,56,6,8,0.09375,0.14285714285714285
"[0, 1, 1, 1, 0, 1, 0, 0, 0, 1, 1, 1, 0, 0, 1]",141,64,77,5,6,0.078125,0.07792207792207792
"[1, 0, 0, 1, 0, 1, 1, 1, 0, 1, 0, 1, 0, 1, 0]",97,39,58,4,2,0.10256410256410256,0.034482758620689655
"[0, 0, 1, 1, 1, 0, 1, 0, 1, 0, 0, 1, 1, 1, 0]",94,39,55,2,10,0.05128205128205128,0.18181818181818182
"[0, 1, 0, 1, 0, 0, 1, 1, 0, 1, 1, 1, 0, 1, 1]",137,59,78,10,9,0.1694915254237288,0.11538461538461539
"[0, 0, 1, 1, 1, 1, 0, 1, 0, 0, 0, 1, 1, 0, 1]",143,66,77,6,8,0.09090909090909091,0.1038961038961039
"[1, 1, 0, 0, 0, 0, 0, 1, 0, 1, 1, 1, 1, 0, 0]",158,82,76,5,12,0.06097560975609756,0.15789473684210525
"[1, 1, 1, 1, 0, 0, 1, 0, 0, 0, 0, 0, 1, 1, 1]",259,124,135,15,16,0.12096774193548387,0.11851851851851852
"[0, 0, 1, 1, 1, 0, 1, 1, 1, 1, 0, 1, 0, 0, 0]",124,68,56,4,6,0.058823529411764705,0.10714285714285714
"[1, 1, 0, 1, 0, 1, 1, 1, 0, 1, 0, 0, 0, 1, 0]",85,39,46,5,4,0.1282051282051282,0.08695652173913043
"[1, 1, 1, 0, 1, 1, 0, 1, 1, 0, 1, 0, 0, 0, 1]",152,50,102,4,12,0.08,0.11764705882352941
"[1, 0, 0, 1, 1, 1, 0, 1, 0, 1, 0, 1, 0, 1, 0]",88,39,49,3,2,0.07692307692307693,0.04081632653061224
"[0, 0, 1, 0, 1, 0, 1, 1, 1, 0, 1, 1, 0, 1, 0]",98,42,56,3,6,0.07142857142857142,0.10714285714285714
"[1, 0, 1, 0, 0, 0, 1, 1, 0, 1, 0, 0, 0, 1, 0]",112,68,44,7,2,0.10294117647058823,0.045454545454545456
"[1, 1, 1, 0, 0, 0, 1, 1, 1, 0, 0, 1, 1, 0, 0]",210,93,117,11,13,0.11827956989247312,0.1111111111111111
"[0, 0, 1, 0, 0, 1, 1, 1, 1, 0, 0, 1, 1, 0, 1]",147,74,73,7,7,0.0945945945945946,0.0958904109589041
"[0, 1, 1, 1, 1, 0, 1, 0, 0, 0, 0, 1, 1, 0, 1]",109,57,52,7,7,0.12280701754385964,0.1346153846153846
"[0, 0, 1, 0, 1, 1, 1, 0, 1, 1, 1, 0, 0, 0, 0]",166,85,81,13,10,0.15294117647058825,0.12345679012345678
"[1, 1, 1, 0, 1, 0, 1, 1, 0, 1, 0, 0, 0, 0, 0]",129,61,68,8,6,0.13114754098360656,0.08823529411764706
"[1, 0, 1, 0, 1, 0, 0, 1, 1, 0, 0, 0, 0, 1, 0]",176,101,75,12,9,0.1188118811881188,0.12
"[1, 1, 1, 0, 0, 1, 0, 0, 0, 0, 0, 1, 0, 0, 1]",166,91,75,11,7,0.12087912087912088,0.09333333333333334
"[1, 0, 0, 0, 1, 0, 0, 0, 1, 1, 1, 1, 0, 0, 1]",195,99,96,9,9,0.09090909090909091,0.09375
"[1, 0, 1, 1, 0, 0, 1, 1, 1, 1, 0, 1, 0, 0, 0]",126,62,64,11,4,0.1774193548387097,0.0625
"[0, 1, 0, 0, 1, 0, 1, 1, 1, 0, 0, 1, 0, 0, 1]",109,54,55,1,4,0.018518518518518517,0.07272727272727272
"[0, 1, 0, 0, 1, 0, 1, 1, 0, 1, 1, 0, 0, 1, 0]",103,57,46,11,3,0.19298245614035087,0.06521739130434782
"[1, 0, 1, 0, 0, 1, 0, 1, 1, 0, 1, 1, 0, 0, 1]",117,52,65,3,5,0.057692307692307696,0.07692307692307693
"[1, 0, 0, 0, 0, 1, 1, 0, 1, 0, 1, 1, 1, 0, 0]",155,75,80,9,13,0.12,0.1625
"[1, 1, 1, 1, 0, 1, 0, 0, 0, 0, 0, 1, 0, 1, 0]",119,62,57,7,4,0.11290322580645161,0.07017543859649122
"[1, 1, 0, 0, 1, 0, 1, 1, 0, 1, 0, 1, 1, 0, 0]",126,50,76,8,11,0.16,0.14473684210526316
"[0, 1, 0, 1, 1, 0, 0, 0, 1, 1, 0, 1, 0, 1, 1]",117,50,67,7,8,0.14,0.11940298507462686
"[1, 1, 1, 0, 0, 0, 1, 0, 1, 1, 1, 1, 0, 0, 1]",210,79,131,6,10,0.0759493670886076,0.07633587786259542
"[1, 0, 0, 1, 0, 1, 0, 1, 0, 0, 1, 1, 1, 1, 0]",137,70,67,6,9,0.08571428571428572,0.13432835820895522
"[0, 0, 0, 1, 1, 1, 1, 1, 0, 1, 0, 1, 0, 1, 0]",127,72,55,5,4,0.06944444444444445,0.07272727272727272
"[1, 1, 0, 0, 1, 0, 1, 1, 0, 1, 1, 0, 1, 0, 1]",131,56,75,7,8,0.125,0.10666666666666667
"[0, 0, 0, 0, 1, 1, 1, 0, 0, 1, 1, 0, 0, 1, 0]",175,97,78,12,3,0.12371134020618557,0.038461538461538464
"[1, 0, 0, 0, 1, 0, 1, 1, 0, 0, 1, 1, 0, 0, 1]",203,113,90,18,8,0.1592920353982301,0.08888888888888889
"[0, 1, 0, 0, 0, 0, 0, 1, 1, 1, 0, 1, 1, 1, 1]",141,72,69,6,6,0.08333333333333333,0.08695652173913043
"[1, 1, 0, 0, 0, 1, 1, 1, 0, 0, 0, 1, 0, 0, 1]",115,56,59,8,10,0.14285714285714285,0.1694915254237288
"[1, 1, 1, 1, 1, 0, 0, 1, 0, 0, 0, 1, 1, 0, 0]",175,67,108,13,7,0.19402985074626866,0.06481481481481481
"[0, 0, 0, 0, 1, 0, 0, 0, 1, 1, 0, 1, 1, 1, 0]",156,100,56,11,9,0.11,0.16071428571428573
"[1, 1, 0, 0, 0, 0, 1, 0, 0, 1, 0, 1, 0, 1, 1]",150,92,58,8,3,0.08695652173913043,0.05172413793103448
"[0, 1, 1, 0, 0, 1, 1, 0, 1, 0, 1, 0, 0, 0, 1]",130,79,51,5,6,0.06329113924050633,0.11764705882352941
"[1, 0, 1, 0, 1, 1, 0, 0, 0, 1, 1, 0, 0, 1, 0]",96,44,52,6,8,0.13636363636363635,0.15384615384615385
"[1, 1, 0, 1, 0, 0, 1, 0, 0, 1, 1, 1, 0, 0, 0]",127,78,49,5,9,0.0641025641025641,0.1836734693877551
"[1, 0, 1, 1, 1, 0, 1, 0, 1, 0, 0, 1, 0, 0, 0]",104,57,47,3,1,0.05263157894736842,0.02127659574468085
"[1, 0, 1, 0, 1, 1, 0, 1, 1, 1, 0, 1, 0, 0, 0]",122,54,68,5,5,0.09259259259259259,0.07352941176470588
"[0, 1, 1, 1, 0, 1, 0, 1, 0, 1, 0, 0, 0, 1, 0]",90,46,44,5,4,0.10869565217391304,0.09090909090909091
"[0, 1, 0, 0, 1, 1, 0, 1, 0, 1, 1, 1, 1, 0, 1]",125,60,65,6,10,0.1,0.15384615384615385
"[0, 1, 1, 1, 0, 0, 0, 0, 0, 1, 0, 1, 1, 1, 1]",172,91,81,8,12,0.08791208791208792,0.14814814814814814
"[1, 0, 1, 0, 1, 1, 0, 1, 0, 0, 1, 1, 0, 0, 1]",121,59,62,7,5,0.11864406779661017,0.08064516129032258
"[0, 1, 0, 1, 0, 0, 0, 1, 0, 1, 1, 0, 0, 0, 1]",142,81,61,8,7,0.09876543209876543,0.11475409836065574
"[0, 0, 0, 0, 1, 0, 0, 1, 0, 1, 1, 0, 1, 0, 1]",140,83,57,13,5,0.1566265060240964,0.08771929824561403
"[0, 1, 1, 0, 0, 1, 0, 1, 0, 0, 0, 1, 1, 1, 0]",113,64,49,3,5,0.046875,0.10204081632653061
"[1, 0, 1, 0, 0, 1, 0, 0, 1, 0, 0, 1, 0, 1, 1]",90,42,48,8,4,0.19047619047619047,0.08333333333333333
"[1, 1, 0, 1, 0, 0, 1, 0, 1, 0, 1, 0, 0, 1, 0]",91,42,49,4,4,0.09523809523809523,0.08163265306122448
"[0, 0, 1, 1, 1, 1, 0, 1, 0, 0, 0, 0, 1, 0, 1]",127,67,60,7,6,0.1044776119402985,0.1
"[0, 1, 1, 1, 0, 1, 0, 0, 0, 1, 1, 1, 0, 1, 0]",89,50,39,4,1,0.08,0.02564102564102564
"[1, 0, 1, 0, 1, 1, 1, 0, 0, 1, 0, 0, 0, 1, 1]",132,71,61,4,11,0.056338028169014086,0.18032786885245902
"[1, 1, 0, 1, 0, 0, 0, 0, 1, 0, 1, 1, 0, 1, 1]",104,57,47,6,3,0.10526315789473684,0.06382978723404255
"[1, 0, 0, 0, 1, 0, 1, 1, 0, 1, 0, 1, 0, 1, 1]",90,43,47,6,4,0.13953488372093023,0.0851063829787234
"[0, 0, 0, 1, 1, 1, 0, 0, 1, 1, 1, 1, 0, 1, 1]",183,82,101,5,11,0.06097560975609756,0.10891089108910891
"[0, 1, 0, 0, 1, 1, 0, 1, 0, 1, 1, 0, 1, 1, 0]",107,65,42,7,3,0.1076923076923077,0.07142857142857142
"[0, 1, 0, 1, 1, 1, 1, 0, 1, 0, 1, 1, 0, 0, 1]",156,64,92,8,8,0.125,0.08695652173913043
"[1, 0, 1, 0, 1, 1, 0, 1, 1, 0, 1, 0, 0, 1, 0]",93,42,51,5,6,0.11904761904761904,0.11764705882352941
"[0, 1, 1, 1, 0, 1, 1, 0, 0, 0, 0, 1, 1, 1, 0]",134,74,60,4,5,0.05405405405405406,0.08333333333333333
"[0, 0, 1, 0, 1, 1, 1, 0, 0, 0, 1, 0, 1, 1, 0]",118,62,56,6,3,0.0967741935483871,0.05357142857142857
"[0, 1, 0, 1, 1, 1, 0, 1, 0, 1, 1, 0, 0, 1, 0]",114,53,61,1,6,0.018867924528301886,0.09836065573770492
"[0, 1, 0, 1, 1, 0, 0, 1, 1, 0, 1, 1, 1, 1, 0]",177,84,93,7,8,0.08333333333333333,0.08602150537634409
"[1, 0, 0, 1, 0, 1, 0, 0, 1, 1, 0, 0, 1, 0, 0]",156,90,66,9,7,0.1,0.10606060606060606
"[0, 1, 0, 1, 1, 0, 0, 1, 0, 1, 0, 0, 0, 1, 1]",125,73,52,9,3,0.1232876712328767,0.057692307692307696
"[0, 0, 1, 1, 0, 1, 1, 0, 1, 0, 1, 0, 0, 0, 1]",108,61,47,8,3,0.13114754098360656,0.06382978723404255
"[0, 1, 1, 0, 1, 0, 0, 0, 1, 1, 1, 0, 1, 1, 0]",108,61,47,6,9,0.09836065573770492,0.19148936170212766
"[0, 0, 1, 0, 0, 1, 0, 1, 1, 1, 1, 1, 0, 1, 0]",104,50,54,6,5,0.12,0.09259259259259259
"[0, 0, 1, 0, 0, 1, 0, 1, 0, 1, 0, 1, 1, 1, 0]",108,60,48,3,11,0.05,0.22916666666666666
"[1, 0, 0, 1, 0, 0, 1, 1, 0, 1, 0, 1, 0, 1, 1]",122,56,66,8,5,0.14285714285714285,0.07575757575757576
"[0, 1, 0, 0, 1, 0, 1, 0, 1, 1, 0, 1, 1, 0, 1]",97,38,59,2,6,0.05263157894736842,0.1016949152542373
"[1, 0, 1, 0, 1, 1, 0, 0, 1, 0, 0, 1, 0, 1, 1]",115,49,66,5,4,0.10204081632653061,0.06060606060606061
"[1, 1, 0, 0, 1, 1, 0, 1, 1, 0, 1, 1, 1, 0, 1]",245,88,157,6,14,0.06818181818181818,0.08917197452229299
"[0, 0, 1, 0, 0, 1, 1, 1, 0, 0, 1, 0, 1, 1, 0]",111,59,52,8,4,0.13559322033898305,0.07692307692307693
"[0, 0, 0, 1, 0, 1, 1, 0, 1, 1, 0, 1, 0, 1, 1]",102,48,54,6,4,0.125,0.07407407407407407
"[0, 1, 1, 1, 0, 0, 0, 1, 0, 1, 1, 0, 1, 1, 0]",117,65,52,6,4,0.09230769230769231,0.07692307692307693
"[1, 0, 1, 1, 0, 1, 1, 0, 1, 1, 0, 1, 0, 0, 0]",117,47,70,3,8,0.06382978723404255,0.11428571428571428
"[0, 0, 0, 0, 1, 0, 1, 1, 0, 0, 0, 1, 1, 0, 1]",144,84,60,8,5,0.09523809523809523,0.08333333333333333
"[0, 1, 0, 1, 0, 0, 0, 0, 1, 0, 1, 1, 0, 1, 1]",102,57,45,5,1,0.08771929824561403,0.022222222222222223
"[1, 0, 0, 1, 1, 0, 1, 0, 1, 0, 1, 0, 1, 1, 0]",93,41,52,3,6,0.07317073170731707,0.11538461538461539
"[0, 1, 0, 0, 0, 1, 0, 1, 1, 1, 0, 1, 1, 1, 0]",118,50,68,4,5,0.08,0.07352941176470588
"[1, 0, 1, 1, 1, 0, 1, 0, 0, 1, 1, 0, 0, 1, 0]",97,47,50,4,7,0.0851063829787234,0.14
"[0, 1, 0, 1, 1, 0, 0, 1, 1, 0, 1, 1, 1, 0, 1]",128,63,65,6,4,0.09523809523809523,0.06153846153846154
"[1, 0, 1, 0, 1, 0, 1, 1, 1, 0, 0, 0, 1, 0, 1]",92,45,47,3,5,0.06666666666666667,0.10638297872340426
"[0, 1, 0, 1, 1, 1, 1, 0, 0, 0, 0, 0, 1, 0, 0]",142,89,53,10,4,0.11235955056179775,0.07547169811320754
"[1, 1, 1, 1, 0, 0, 1, 0, 1, 1, 0, 0, 0, 1, 0]",114,57,57,4,4,0.07017543859649122,0.07017543859649122
"[1, 0, 0, 0, 1, 1, 1, 1, 1, 1, 1, 1, 1, 1, 0]",1019,316,703,29,60,0.09177215189873418,0.08534850640113797
"[0, 1, 1, 0, 0, 0, 1, 1, 1, 1, 1, 1, 1, 1, 1]",1189,458,731,46,76,0.10043668122270742,0.1039671682626539
"[1, 0, 1, 0, 0, 0, 1, 0, 0, 1, 1, 0, 0, 0, 1]",155,96,59,5,6,0.052083333333333336,0.1016949152542373
"[0, 0, 1, 0, 1, 0, 0, 0, 1, 0, 0, 1, 1, 0, 0]",312,202,110,15,12,0.07425742574257425,0.10909090909090909
"[1, 0, 0, 1, 1, 0, 0, 0, 1, 0, 1, 0, 0, 0, 1]",172,101,71,6,8,0.0594059405940594,0.11267605633802817
"[1, 1, 0, 0, 0, 1, 1, 0, 1, 0, 0, 0, 1, 1, 0]",136,70,66,9,9,0.12857142857142856,0.13636363636363635
"[0, 1, 1, 0, 1, 1, 1, 0, 0, 0, 1, 1, 0, 1, 0]",112,47,65,2,8,0.0425531914893617,0.12307692307692308
"[1, 1, 1, 1, 1, 1, 1, 1, 1, 1, 1, 1, 0, 1, 1]",61244,7151,54093,663,5131,0.09271430569151168,0.09485515685948274
"[1, 0, 0, 1, 1, 1, 1, 1, 1, 1, 1, 1, 1, 1, 1]",28721,2760,25961,269,2480,0.09746376811594203,0.09552790724548361
"[1, 1, 1, 0, 1, 0, 1, 1, 1, 0, 1, 0, 0, 1, 1]",269,85,184,10,17,0.11764705882352941,0.09239130434782608
"[1, 1, 0, 1, 1, 0, 1, 1, 1, 1, 1, 0, 1, 0, 1]",492,146,346,8,41,0.0547945205479452,0.11849710982658959
"[0, 1, 1, 1, 1, 0, 1, 1, 0, 1, 1, 0, 1, 1, 1]",542,189,353,18,33,0.09523809523809523,0.09348441926345609
"[0, 1, 0, 1, 0, 1, 1, 1, 1, 0, 1, 1, 0, 1, 1]",249,97,152,9,22,0.09278350515463918,0.14473684210526316
"[1, 1, 1, 1, 0, 1, 0, 1, 0, 1, 1, 1, 1, 0, 1]",500,170,330,9,43,0.052941176470588235,0.1303030303030303
"[1, 1, 1, 1, 1, 1, 1, 1, 1, 0, 1, 0, 1, 0, 1]",1768,415,1353,47,130,0.11325301204819277,0.09608277900960828
"[1, 1, 1, 1, 1, 1, 0, 0, 1, 1, 0, 1, 0, 1, 1]",891,269,622,25,53,0.09293680297397769,0.08520900321543408
"[0, 0, 0, 0, 0, 0, 0, 0, 0, 1, 1, 1, 1, 1, 1]",3113,2521,592,253,52,0.10035700119000397,0.08783783783783784
"[1, 1, 1, 1, 1, 1, 0, 1, 1, 1, 1, 1, 0, 1, 1]",7294,1242,6052,128,602,0.10305958132045089,0.09947124917382684
"[1, 1, 1, 1, 1, 1, 1, 1, 1, 1, 0, 1, 1, 1, 1]",61855,7138,54717,707,5211,0.09904735219949566,0.0952354844015571
"[0, 0, 0, 0, 1, 1, 1, 0, 0, 0, 0, 0, 0, 0, 0]",3140,2414,726,236,64,0.09776304888152444,0.0881542699724518
"[0, 0, 0, 0, 0, 1, 1, 1, 0, 0, 0, 0, 0, 0, 0]",2967,2394,573,219,61,0.09147869674185463,0.10645724258289703
"[1, 1, 0, 0, 0, 1, 0, 1, 0, 0, 0, 0, 1, 1, 0]",188,109,79,11,11,0.10091743119266056,0.13924050632911392
"[1, 0, 1, 1, 0, 0, 0, 1, 0, 1, 0, 0, 0, 0, 1]",147,70,77,6,10,0.08571428571428572,0.12987012987012986
"[0, 1, 0, 1, 0, 0, 0, 0, 0, 0, 1, 1, 0, 1, 1]",203,123,80,15,7,0.12195121951219512,0.0875
"[0, 0, 1, 0, 1, 1, 0, 0, 1, 0, 1, 0, 0, 0, 0]",254,164,90,14,12,0.08536585365853659,0.13333333333333333
"[0, 0, 0, 0, 0, 0, 1, 0, 0, 0, 0, 0, 0, 0, 0]",58811,51886,6925,4915,650,0.09472690128358324,0.09386281588447654
"[1, 1, 1, 1, 1, 1, 1, 1, 1, 1, 1, 1, 1, 0, 0]",29339,3508,25831,370,2478,0.10547320410490307,0.09593124540281057
"[1, 0, 1, 1, 1, 1, 0, 0, 1, 0, 0, 0, 1, 1, 1]",202,71,131,6,12,0.08450704225352113,0.0916030534351145
"[1, 1, 1, 0, 1, 1, 1, 0, 1, 1, 0, 1, 1, 1, 1]",1767,447,1320,42,130,0.09395973154362416,0.09848484848484848
"[0, 1, 1, 1, 1, 1, 1, 0, 1, 1, 1, 0, 1, 1, 0]",485,174,311,15,28,0.08620689655172414,0.09003215434083602
"[1, 1, 0, 1, 1, 1, 1, 0, 1, 1, 1, 1, 1, 1, 1]",8227,1545,6682,144,636,0.09320388349514563,0.09518108350793175
"[1, 1, 1, 1, 1, 1, 1, 0, 1, 0, 1, 1, 0, 1, 1]",1768,391,1377,39,117,0.09974424552429667,0.08496732026143791
"[1, 1, 1, 1, 0, 1, 1, 1, 1, 0, 0, 0, 1, 1, 0]",279,89,190,3,17,0.033707865168539325,0.08947368421052632
"[1, 0, 1, 1, 1, 1, 1, 0, 1, 1, 1, 1, 0, 0, 0]",349,126,223,13,17,0.10317460317460317,0.07623318385650224
"[1, 0, 1, 0, 1, 0, 0, 0, 0, 1, 0, 1, 0, 1, 1]",109,54,55,5,7,0.09259259259259259,0.12727272727272726
"[0, 1, 0, 1, 1, 0, 1, 0, 1, 0, 0, 0, 0, 1, 0]",145,86,59,7,8,0.08139534883720931,0.13559322033898305
"[1, 1, 0, 0, 1, 0, 0, 0, 1, 0, 1, 0, 1, 0, 1]",97,46,51,2,5,0.043478260869565216,0.09803921568627451
"[1, 0, 1, 1, 0, 0, 1, 0, 0, 0, 1, 0, 1, 0, 1]",74,39,35,3,4,0.07692307692307693,0.11428571428571428
"[0, 1, 1, 1, 0, 1, 1, 0, 0, 1, 0, 0, 0, 1, 0]",109,60,49,9,3,0.15,0.061224489795918366
"[0, 0, 1, 1, 0, 0, 1, 1, 0, 0, 0, 0, 0, 1, 1]",730,445,285,51,35,0.1146067415730337,0.12280701754385964
"[1, 1, 1, 1, 1, 1, 1, 1, 0, 1, 1, 1, 0, 1, 1]",7789,1365,6424,140,593,0.10256410256410256,0.09231008717310087
"[1, 1, 0, 1, 1, 1, 1, 1, 1, 1, 1, 1, 0, 1, 1]",7312,1340,5972,132,516,0.09850746268656717,0.08640321500334897
"[0, 1, 0, 0, 0, 0, 0, 1, 1, 1, 1, 1, 0, 0, 0]",267,172,95,16,4,0.09302325581395349,0.042105263157894736
"[0, 0, 0, 0, 0, 0, 1, 0, 0, 0, 0, 1, 1, 1, 0]",590,436,154,39,13,0.08944954128440367,0.08441558441558442
"[0, 0, 0, 0, 0, 0, 0, 0, 0, 0, 1, 0, 1, 0, 1]",2290,1813,477,165,49,0.09100937672366244,0.10272536687631027
"[0, 1, 0, 1, 1, 0, 0, 0, 0, 0, 1, 1, 1, 1, 1]",262,132,130,15,12,0.11363636363636363,0.09230769230769231
"[0, 0, 1, 0, 0, 1, 1, 1, 0, 1, 0, 0, 0, 0, 1]",156,87,69,7,7,0.08045977011494253,0.10144927536231885
"[0, 1, 1, 0, 0, 0, 0, 0, 0, 0, 0, 0, 0, 0, 1]",4263,3632,631,325,61,0.08948237885462555,0.09667194928684628
"[0, 1, 0, 0, 0, 1, 1, 1, 0, 1, 0, 1, 1, 1, 0]",110,61,49,9,3,0.14754098360655737,0.061224489795918366
"[0, 0, 0, 0, 1, 0, 1, 1, 0, 0, 1, 1, 1, 1, 0]",226,131,95,13,9,0.09923664122137404,0.09473684210526316
"[1, 1, 1, 0, 0, 0, 0, 1, 1, 0, 0, 0, 0, 1, 1]",1819,352,1467,45,148,0.1278409090909091,0.10088616223585549
"[1, 0, 0, 1, 1, 0, 0, 1, 1, 1, 1, 0, 0, 0, 0]",1556,355,1201,37,124,0.10422535211267606,0.10324729392173189
"[0, 1, 0, 1, 1, 1, 0, 0, 1, 1, 0, 0, 1, 1, 0]",238,119,119,8,11,0.06722689075630252,0.09243697478991597
"[0, 0, 0, 1, 0, 0, 0, 0, 1, 0, 1, 1, 1, 0, 0]",254,183,71,13,9,0.07103825136612021,0.1267605633802817
"[1, 0, 0, 0, 0, 1, 0, 1, 0, 0, 0, 1, 0, 0, 0]",522,345,177,36,17,0.10434782608695652,0.096045197740113
"[1, 0, 0, 0, 1, 1, 0, 1, 1, 1, 0, 0, 0, 0, 1]",149,71,78,7,5,0.09859154929577464,0.0641025641025641
"[1, 1, 0, 0, 0, 1, 1, 0, 1, 1, 1, 0, 0, 0, 0]",165,75,90,10,10,0.13333333333333333,0.1111111111111111
"[1, 1, 1, 0, 1, 1, 1, 1, 0, 1, 1, 0, 1, 1, 1]",1749,397,1352,37,128,0.09319899244332494,0.09467455621301775
"[1, 0, 1, 1, 1, 1, 1, 1, 0, 0, 1, 1, 1, 1, 1]",3701,847,2854,82,256,0.09681227863046045,0.08969866853538892
"[0, 1, 1, 1, 1, 0, 1, 1, 1, 1, 0, 1, 1, 0, 1]",532,184,348,13,31,0.07065217391304347,0.08908045977011494
"[0, 1, 0, 0, 1, 0, 0, 0, 0, 0, 0, 1, 0, 1, 0]",478,335,143,32,15,0.0955223880597015,0.1048951048951049
"[0, 0, 1, 0, 0, 0, 0, 0, 1, 0, 0, 1, 0, 0, 0]",1592,1221,371,114,30,0.09336609336609336,0.08086253369272237
"[0, 0, 0, 0, 0, 0, 1, 1, 1, 1, 1, 1, 1, 0, 1]",433,203,230,14,17,0.06896551724137931,0.07391304347826087
"[0, 1, 0, 1, 0, 0, 0, 1, 1, 1, 0, 0, 0, 0, 0]",343,215,128,20,15,0.09302325581395349,0.1171875
"[0, 0, 0, 0, 0, 0, 0, 0, 0, 1, 0, 1, 0, 0, 0]",7932,6546,1386,630,130,0.09624197983501374,0.09379509379509379
"[0, 0, 0, 1, 0, 0, 0, 0, 1, 1, 0, 0, 1, 0, 0]",539,400,139,33,17,0.0825,0.1223021582733813
"[1, 0, 0, 0, 0, 1, 0, 0, 0, 0, 0, 1, 0, 0, 0]",1618,1224,394,115,37,0.09395424836601307,0.09390862944162437
"[0, 0, 0, 0, 0, 0, 0, 0, 0, 0, 1, 1, 1, 0, 0]",3254,2549,705,237,69,0.09297763828952531,0.09787234042553192
"[0, 0, 0, 1, 0, 0, 1, 0, 1, 0, 1, 0, 0, 0, 0]",537,371,166,38,15,0.10242587601078167,0.09036144578313253
"[0, 0, 0, 0, 0, 0, 1, 0, 0, 0, 0, 0, 1, 0, 0]",6895,5668,1227,532,118,0.09386026817219478,0.09616951915240424
"[1, 1, 1, 0, 0, 1, 1, 1, 0, 1, 1, 1, 1, 1, 1]",2490,508,1982,47,183,0.09251968503937008,0.09233097880928355
"[1, 1, 1, 0, 0, 0, 0, 0, 0, 0, 0, 1, 1, 1, 1]",1974,385,1589,27,154,0.07012987012987013,0.09691629955947137
"[1, 1, 1, 1, 1, 1, 1, 1, 1, 1, 0, 1, 1, 1, 0]",7922,1353,6569,153,582,0.1130820399113082,0.08859796011569493
"[1, 1, 0, 1, 0, 1, 0, 0, 0, 0, 0, 0, 0, 0, 0]",837,572,265,61,30,0.10664335664335664,0.11320754716981132
"[0, 1, 1, 1, 1, 1, 1, 0, 0, 1, 1, 0, 0, 0, 0]",1680,1295,385,133,25,0.10270270270270271,0.06493506493506493
"[0, 0, 1, 1, 1, 1, 1, 1, 0, 0, 1, 1, 0, 0, 0]",1589,820,769,73,70,0.08902439024390243,0.09102730819245773
"[0, 0, 1, 0, 1, 0, 0, 0, 0, 0, 1, 0, 0, 1, 0]",455,312,143,29,8,0.09294871794871795,0.055944055944055944
"[1, 0, 1, 1, 0, 0, 1, 0, 0, 0, 0, 1, 0, 0, 0]",241,166,75,11,11,0.06626506024096386,0.14666666666666667
"[1, 0, 0, 1, 1, 1, 0, 0, 1, 1, 0, 1, 0, 1, 1]",171,68,103,5,16,0.07352941176470588,0.1553398058252427
"[0, 0, 1, 0, 0, 1, 0, 0, 1, 1, 1, 0, 0, 1, 1]",161,85,76,8,8,0.09411764705882353,0.10526315789473684
"[1, 1, 0, 0, 0, 0, 1, 0, 0, 1, 0, 0, 1, 0, 0]",252,167,85,17,13,0.10179640718562874,0.15294117647058825
"[0, 1, 0, 0, 1, 1, 1, 0, 1, 1, 1, 1, 1, 1, 1]",700,198,502,24,43,0.12121212121212122,0.08565737051792828
"[1, 1, 0, 1, 1, 1, 0, 1, 1, 0, 1, 0, 0, 1, 1]",252,87,165,5,18,0.05747126436781609,0.10909090909090909
"[0, 1, 1, 0, 0, 0, 1, 0, 0, 1, 1, 0, 1, 1, 1]",150,90,60,9,8,0.1,0.13333333333333333
"[1, 1, 0, 0, 0, 0, 1, 1, 0, 0, 1, 0, 0, 0, 0]",475,304,171,25,12,0.08223684210526316,0.07017543859649122
"[0, 0, 0, 1, 1, 0, 0, 0, 0, 1, 1, 0, 0, 1, 0]",605,477,128,42,11,0.0880503144654088,0.0859375
"[0, 1, 0, 0, 0, 1, 0, 0, 0, 0, 0, 0, 0, 0, 1]",1957,1479,478,133,44,0.08992562542258282,0.09205020920502092
"[0, 1, 0, 0, 0, 0, 0, 0, 0, 1, 1, 1, 1, 1, 1]",545,292,253,25,20,0.08561643835616438,0.07905138339920949
"[0, 0, 1, 1, 0, 0, 0, 0, 0, 0, 0, 1, 0, 0, 0]",2284,1708,576,179,53,0.10480093676814989,0.0920138888888889
"[1, 0, 0, 0, 1, 1, 0, 0, 0, 0, 0, 0, 0, 1, 0]",595,402,193,46,21,0.11442786069651742,0.10880829015544041
"[1, 1, 1, 1, 1, 1, 1, 0, 0, 1, 1, 1, 1, 0, 1]",3026,504,2522,49,230,0.09722222222222222,0.09119746233148295
"[0, 0, 0, 0, 1, 1, 0, 0, 1, 1, 1, 1, 0, 0, 0]",1989,1195,794,113,70,0.09456066945606695,0.08816120906801007
"[0, 0, 1, 0, 0, 0, 0, 1, 1, 0, 0, 1, 1, 1, 1]",487,283,204,24,28,0.08480565371024736,0.13725490196078433
"[0, 1, 0, 0, 1, 0, 0, 1, 1, 0, 1, 1, 1, 1, 1]",169,71,98,5,8,0.07042253521126761,0.08163265306122448
"[0, 1, 1, 1, 1, 1, 0, 0, 0, 1, 1, 1, 1, 1, 1]",899,316,583,37,51,0.11708860759493671,0.08747855917667238
"[1, 0, 0, 1, 1, 1, 1, 1, 1, 0, 0, 0, 0, 1, 1]",2100,381,1719,37,169,0.09711286089238845,0.0983129726585224
"[0, 1, 0, 0, 1, 0, 0, 0, 0, 0, 1, 1, 0, 0, 0]",795,557,238,56,16,0.10053859964093358,0.06722689075630252
"[1, 1, 1, 1, 0, 0, 0, 1, 0, 0, 0, 0, 0, 1, 1]",214,121,93,6,11,0.049586776859504134,0.11827956989247312
"[0, 0, 0, 0, 1, 1, 1, 1, 0, 0, 0, 1, 0, 0, 0]",445,286,159,24,11,0.08391608391608392,0.06918238993710692
"[0, 1, 0, 0, 0, 0, 0, 1, 1, 0, 1, 1, 0, 1, 0]",138,86,52,6,4,0.06976744186046512,0.07692307692307693
"[0, 0, 0, 1, 0, 0, 0, 0, 0, 1, 1, 0, 1, 1, 0]",262,179,83,16,9,0.0893854748603352,0.10843373493975904
"[1, 0, 0, 0, 1, 0, 0, 0, 0, 0, 1, 1, 0, 1, 1]",164,104,60,8,8,0.07692307692307693,0.13333333333333333
"[1, 0, 1, 0, 0, 0, 1, 1, 0, 0, 0, 1, 0, 0, 0]",236,147,89,18,6,0.12244897959183673,0.06741573033707865
"[0, 1, 1, 1, 1, 1, 0, 0, 0, 0, 1, 0, 0, 1, 0]",111,62,49,5,5,0.08064516129032258,0.10204081632653061
"[0, 1, 1, 1, 0, 0, 0, 0, 1, 0, 0, 1, 1, 1, 1]",200,109,91,10,6,0.09174311926605505,0.06593406593406594
"[1, 1, 0, 0, 1, 0, 1, 1, 0, 0, 0, 1, 1, 1, 0]",131,66,65,7,7,0.10606060606060606,0.1076923076923077
"[1, 0, 0, 0, 0, 1, 1, 0, 0, 1, 0, 1, 1, 0, 0]",188,93,95,4,7,0.043010752688172046,0.07368421052631578
"[1, 1, 1, 0, 1, 0, 1, 1, 1, 1, 1, 0, 1, 1, 1]",1689,382,1307,26,118,0.06806282722513089,0.090283091048202
"[1, 1, 1, 1, 0, 1, 0, 1, 0, 1, 1, 1, 1, 0, 0]",332,114,218,20,25,0.17543859649122806,0.11467889908256881
"[1, 1, 0, 1, 1, 1, 0, 1, 0, 1, 1, 1, 1, 1, 1]",1954,469,1485,44,136,0.09381663113006397,0.09158249158249158
"[1, 1, 1, 1, 1, 1, 1, 0, 1, 1, 0, 1, 1, 1, 0]",1654,397,1257,30,121,0.07556675062972293,0.09626093874303898
"[1, 1, 0, 1, 1, 1, 1, 1, 1, 1, 1, 1, 0, 0, 1]",3088,703,2385,44,241,0.06258890469416785,0.1010482180293501
"[1, 0, 1, 0, 0, 1, 0, 1, 1, 1, 0, 0, 1, 1, 1]",188,71,117,4,7,0.056338028169014086,0.05982905982905983
"[0, 0, 0, 0, 0, 1, 1, 1, 0, 1, 0, 0, 1, 0, 1]",172,107,65,9,9,0.08411214953271028,0.13846153846153847
"[1, 1, 0, 1, 1, 0, 1, 1, 1, 1, 1, 1, 1, 0, 0]",876,257,619,29,63,0.11284046692607004,0.10177705977382875
"[0, 0, 1, 0, 0, 1, 1, 1, 1, 1, 1, 1, 1, 0, 1]",333,131,202,11,27,0.08396946564885496,0.13366336633663367
"[1, 0, 0, 0, 1, 0, 0, 1, 1, 1, 1, 1, 1, 1, 1]",556,194,362,20,29,0.10309278350515463,0.08011049723756906
"[1, 1, 1, 1, 0, 1, 0, 1, 0, 0, 0, 1, 0, 0, 1]",126,60,66,9,9,0.15,0.13636363636363635
"[0, 0, 0, 1, 1, 1, 1, 0, 1, 0, 1, 0, 0, 0, 1]",141,82,59,11,2,0.13414634146341464,0.03389830508474576
"[1, 1, 0, 0, 1, 1, 1, 0, 0, 1, 0, 1, 1, 1, 1]",361,121,240,12,26,0.09917355371900827,0.10833333333333334
"[0, 1, 1, 1, 1, 1, 0, 0, 1, 1, 0, 1, 1, 1, 0]",259,104,155,8,14,0.07692307692307693,0.09032258064516129
"[1, 1, 0, 1, 1, 0, 0, 1, 1, 1, 1, 1, 0, 0, 1]",362,117,245,8,22,0.06837606837606838,0.08979591836734693
"[0, 0, 1, 1, 0, 1, 0, 1, 1, 1, 0, 1, 1, 0, 0]",98,47,51,6,6,0.1276595744680851,0.11764705882352941
"[0, 1, 1, 0, 1, 0, 0, 0, 0, 0, 0, 0, 1, 0, 0]",523,386,137,46,10,0.11917098445595854,0.072992700729927
"[0, 1, 0, 1, 0, 0, 1, 0, 1, 1, 0, 1, 0, 0, 0]",162,96,66,7,6,0.07291666666666667,0.09090909090909091
"[1, 1, 0, 1, 0, 1, 1, 0, 1, 1, 1, 1, 0, 1, 1]",554,158,396,13,33,0.08227848101265822,0.08333333333333333
"[1, 1, 0, 0, 0, 0, 1, 1, 0, 0, 0, 0, 1, 0, 0]",614,400,214,46,24,0.115,0.11214953271028037
"[0, 0, 0, 0, 0, 1, 1, 0, 0, 1, 1, 0, 0, 0, 0]",5097,4414,683,406,58,0.09198006343452651,0.0849194729136164
"[0, 1, 0, 1, 0, 0, 0, 1, 0, 1, 0, 0, 0, 0, 0]",578,397,181,41,17,0.10327455919395466,0.09392265193370165
"[0, 0, 0, 0, 0, 0, 1, 0, 0, 0, 0, 1, 0, 1, 0]",1557,1199,358,105,26,0.08757297748123437,0.07262569832402235
"[1, 0, 0, 1, 1, 0, 0, 0, 0, 1, 1, 0, 0, 1, 1]",1695,377,1318,40,113,0.10610079575596817,0.08573596358118361
"[1, 1, 1, 1, 0, 0, 1, 1, 0, 1, 0, 0, 1, 1, 0]",179,79,100,8,5,0.10126582278481013,0.05
"[1, 1, 1, 1, 1, 1, 1, 0, 0, 1, 1, 0, 1, 0, 0]",389,101,288,8,38,0.07920792079207921,0.13194444444444445
"[1, 1, 1, 1, 1, 1, 0, 1, 0, 1, 1, 1, 1, 0, 1]",1612,400,1212,39,111,0.0975,0.09158415841584158
"[1, 0, 0, 0, 0, 0, 0, 0, 0, 1, 1, 1, 0, 1, 1]",354,137,217,9,24,0.06569343065693431,0.11059907834101383
"[0, 0, 1, 1, 1, 1, 0, 0, 0, 0, 0, 0, 0, 0, 1]",2471,1582,889,153,88,0.09671302149178256,0.09898762654668167
"[0, 1, 1, 1, 1, 0, 1, 0, 0, 1, 1, 1, 1, 0, 0]",277,118,159,7,11,0.059322033898305086,0.06918238993710692
"[0, 0, 0, 1, 1, 1, 1, 1, 1, 0, 1, 1, 1, 1, 1]",1015,471,544,37,62,0.07855626326963906,0.11397058823529412
"[0, 1, 0, 0, 0, 1, 1, 0, 0, 1, 1, 1, 0, 0, 0]",184,106,78,11,11,0.10377358490566038,0.14102564102564102
"[1, 0, 1, 1, 1, 0, 0, 0, 1, 0, 0, 0, 1, 1, 0]",135,74,61,4,7,0.05405405405405406,0.11475409836065574
"[1, 0, 0, 1, 1, 1, 1, 1, 1, 1, 1, 0, 1, 1, 1]",3056,521,2535,51,262,0.09788867562380038,0.10335305719921105
"[0, 0, 0, 0, 0, 0, 1, 1, 1, 0, 0, 0, 1, 1, 0]",383,260,123,29,7,0.11153846153846154,0.056910569105691054
"[0, 0, 0, 0, 0, 0, 0, 1, 1, 1, 0, 0, 0, 1, 1]",656,491,165,40,11,0.0814663951120163,0.06666666666666667
"[0, 0, 1, 1, 0, 0, 0, 1, 1, 0, 1, 0, 0, 1, 1]",157,87,70,9,7,0.10344827586206896,0.1
"[0, 0, 0, 0, 1, 1, 1, 1, 0, 0, 0, 0, 1, 0, 0]",661,431,230,35,16,0.08120649651972157,0.06956521739130435
"[0, 0, 0, 0, 0, 0, 1, 1, 1, 1, 0, 0, 0, 0, 1]",2539,1583,956,151,89,0.09538850284270373,0.09309623430962342
"[0, 0, 0, 0, 0, 0, 0, 1, 1, 1, 1, 0, 0, 0, 0]",5430,4692,738,442,58,0.09420289855072464,0.07859078590785908
"[0, 1, 0, 0, 1, 0, 0, 1, 0, 0, 0, 0, 0, 0, 0]",1876,1427,449,129,38,0.09039943938332165,0.08463251670378619
"[0, 0, 1, 0, 0, 1, 0, 0, 1, 0, 0, 0, 0, 0, 0]",1783,1377,406,114,28,0.08278867102396514,0.06896551724137931
"[0, 0, 1, 1, 0, 0, 0, 1, 0, 0, 0, 0, 0, 0, 0]",2262,1678,584,162,55,0.09654350417163289,0.09417808219178082
"[1, 1, 0, 0, 1, 1, 0, 0, 0, 1, 0, 0, 0, 0, 0]",402,276,126,27,13,0.09782608695652174,0.10317460317460317
"[1, 1, 0, 1, 1, 0, 0, 0, 1, 1, 1, 1, 0, 0, 1]",288,120,168,11,17,0.09166666666666666,0.10119047619047619
"[1, 1, 1, 1, 0, 1, 1, 0, 1, 0, 1, 1, 1, 1, 1]",1855,444,1411,46,134,0.1036036036036036,0.09496810772501772
"[1, 1, 1, 1, 1, 1, 0, 1, 1, 0, 1, 0, 1, 1, 1]",1846,413,1433,47,138,0.11380145278450363,0.09630146545708304
"[1, 1, 0, 1, 0, 0, 1, 1, 1, 1, 1, 1, 0, 1, 1]",587,186,401,16,36,0.08602150537634409,0.08977556109725686
"[0, 0, 0, 0, 0, 0, 0, 1, 1, 1, 0, 1, 1, 0, 1]",205,139,66,11,6,0.07913669064748201,0.09090909090909091
"[1, 0, 0, 1, 1, 0, 0, 0, 0, 0, 0, 0, 0, 0, 1]",1364,604,760,66,74,0.10927152317880795,0.09736842105263158
"[0, 1, 1, 0, 0, 1, 1, 0, 0, 0, 0, 0, 0, 0, 0]",4580,3982,598,356,56,0.08940231039678553,0.09364548494983277
"[0, 0, 1, 0, 1, 1, 0, 0, 1, 1, 0, 0, 0, 0, 0]",559,365,194,34,17,0.09315068493150686,0.08762886597938144
"[1, 1, 1, 0, 0, 1, 0, 0, 1, 0, 1, 1, 0, 0, 1]",132,58,74,5,10,0.08620689655172414,0.13513513513513514
"[0, 1, 1, 1, 0, 0, 1, 1, 0, 0, 0, 0, 0, 1, 1]",241,144,97,13,8,0.09027777777777778,0.08247422680412371
"[0, 1, 0, 1, 1, 0, 0, 1, 1, 0, 1, 1, 0, 0, 1]",120,56,64,5,6,0.08928571428571429,0.09375
"[1, 1, 0, 1, 1, 0, 1, 0, 1, 1, 0, 0, 1, 1, 0]",158,58,100,1,12,0.017241379310344827,0.12
"[1, 1, 0, 1, 1, 1, 1, 0, 0, 1, 0, 0, 1, 1, 1]",302,116,186,21,26,0.1810344827586207,0.13978494623655913
"[1, 0, 1, 1, 0, 1, 1, 1, 0, 1, 1, 0, 0, 1, 0]",126,49,77,7,9,0.14285714285714285,0.11688311688311688
"[1, 1, 1, 1, 0, 0, 1, 0, 1, 1, 0, 1, 1, 1, 0]",260,94,166,7,22,0.07446808510638298,0.13253012048192772
"[0, 0, 0, 1, 1, 1, 1, 0, 0, 1, 0, 1, 1, 0, 1]",161,99,62,8,11,0.08080808080808081,0.1774193548387097
"[0, 0, 1, 1, 1, 1, 0, 0, 1, 0, 1, 1, 1, 0, 0]",166,79,87,9,10,0.11392405063291139,0.11494252873563218
"[1, 0, 0, 1, 1, 0, 0, 0, 0, 1, 1, 1, 1, 0, 0]",1500,317,1183,22,122,0.0694006309148265,0.10312764158918004
"[0, 0, 1, 1, 1, 0, 0, 1, 1, 0, 0, 0, 0, 1, 1]",434,239,195,27,31,0.11297071129707113,0.15897435897435896
"[1, 1, 1, 1, 1, 1, 1, 0, 0, 1, 1, 0, 0, 0, 0]",2206,417,1789,30,170,0.07194244604316546,0.09502515371716043
"[0, 1, 0, 0, 0, 0, 1, 0, 0, 0, 1, 0, 0, 1, 1]",293,184,109,17,6,0.09239130434782608,0.05504587155963303
"[1, 0, 1, 0, 0, 1, 0, 0, 0, 0, 0, 0, 0, 1, 0]",478,323,155,29,13,0.08978328173374613,0.08387096774193549
"[1, 1, 0, 1, 0, 1, 1, 0, 1, 0, 0, 0, 0, 0, 0]",196,114,82,7,11,0.06140350877192982,0.13414634146341464
"[0, 0, 0, 1, 1, 0, 0, 0, 0, 0, 0, 1, 1, 0, 1]",698,577,121,53,9,0.09185441941074524,0.0743801652892562
"[0, 1, 0, 0, 0, 0, 1, 1, 0, 0, 0, 0, 0, 0, 1]",1147,755,392,64,35,0.0847682119205298,0.08928571428571429
"[1, 0, 0, 0, 0, 1, 1, 1, 1, 1, 0, 1, 1, 1, 1]",592,118,474,12,38,0.1016949152542373,0.08016877637130802
"[0, 1, 1, 0, 1, 0, 1, 1, 1, 0, 0, 0, 0, 0, 0]",268,155,113,15,13,0.0967741935483871,0.11504424778761062
"[0, 0, 0, 0, 1, 0, 1, 1, 0, 1, 0, 1, 1, 1, 0]",125,74,51,9,5,0.12162162162162163,0.09803921568627451
"[1, 0, 0, 0, 1, 0, 0, 0, 1, 1, 0, 0, 1, 0, 0]",246,157,89,12,11,0.07643312101910828,0.12359550561797752
"[0, 1, 0, 0, 0, 1, 0, 0, 0, 1, 1, 0, 0, 1, 0]",239,153,86,15,5,0.09803921568627451,0.05813953488372093
"[0, 1, 0, 0, 0, 1, 0, 0, 0, 0, 1, 1, 1, 0, 0]",278,189,89,19,8,0.10052910052910052,0.0898876404494382
"[0, 0, 0, 1, 0, 0, 0, 0, 0, 0, 1, 0, 1, 0, 0]",1612,1254,358,110,37,0.08771929824561403,0.10335195530726257
"[1, 0, 0, 0, 1, 0, 0, 0, 0, 0, 0, 1, 0, 1, 0]",480,327,153,34,15,0.10397553516819572,0.09803921568627451
"[1, 0, 1, 0, 0, 0, 1, 0, 0, 0, 0, 0, 0, 1, 0]",470,336,134,32,13,0.09523809523809523,0.09701492537313433
"[1, 1, 0, 0, 1, 0, 1, 0, 0, 0, 1, 0, 0, 0, 0]",264,163,101,12,9,0.0736196319018405,0.0891089108910891
"[0, 0, 1, 0, 1, 1, 0, 0, 1, 0, 1, 0, 0, 0, 1]",137,74,63,9,9,0.12162162162162163,0.14285714285714285
"[0, 0, 1, 1, 0, 1, 1, 0, 0, 1, 0, 1, 1, 0, 0]",120,64,56,5,3,0.078125,0.05357142857142857
"[1, 1, 1, 1, 1, 1, 0, 0, 1, 1, 0, 0, 1, 1, 1]",5506,1581,3925,155,343,0.09803921568627451,0.08738853503184714
"[1, 0, 1, 0, 0, 1, 1, 1, 0, 0, 1, 0, 0, 1, 1]",113,59,54,6,5,0.1016949152542373,0.09259259259259259
"[0, 0, 1, 1, 0, 1, 1, 1, 0, 1, 0, 0, 1, 1, 1]",208,109,99,7,7,0.06422018348623854,0.0707070707070707
"[0, 0, 0, 0, 1, 1, 1, 1, 0, 1, 0, 0, 0, 0, 0]",411,269,142,19,13,0.07063197026022305,0.09154929577464789
"[0, 0, 0, 0, 0, 1, 1, 1, 1, 0, 1, 0, 0, 0, 0]",407,298,109,32,5,0.10738255033557047,0.045871559633027525
"[0, 1, 1, 1, 0, 1, 0, 0, 0, 0, 1, 1, 1, 1, 0]",174,83,91,8,9,0.0963855421686747,0.0989010989010989
"[0, 1, 0, 0, 1, 0, 1, 1, 0, 0, 1, 1, 1, 0, 1]",117,52,65,2,6,0.038461538461538464,0.09230769230769231
"[1, 0, 0, 0, 1, 0, 0, 1, 0, 1, 1, 0, 0, 1, 1]",159,90,69,10,10,0.1111111111111111,0.14492753623188406
"[1, 0, 1, 0, 1, 1, 0, 0, 0, 0, 1, 0, 0, 0, 1]",162,94,68,6,6,0.06382978723404255,0.08823529411764706
"[1, 1, 0, 1, 0, 1, 1, 0, 0, 0, 0, 1, 0, 0, 0]",178,102,76,7,5,0.06862745098039216,0.06578947368421052
"[0, 0, 0, 0, 0, 0, 0, 0, 0, 0, 1, 1, 1, 1, 0]",5217,3810,1407,368,145,0.09658792650918635,0.10305614783226724
"[0, 1, 1, 0, 1, 1, 1, 0, 0, 1, 1, 1, 1, 0, 1]",244,97,147,8,15,0.08247422680412371,0.10204081632653061
"[0, 1, 0, 0, 1, 0, 0, 1, 1, 1, 0, 1, 0, 0, 0]",185,113,72,8,12,0.07079646017699115,0.16666666666666666
"[0, 1, 1, 0, 0, 0, 0, 0, 1, 1, 1, 1, 0, 0, 0]",420,245,175,22,18,0.08979591836734693,0.10285714285714286
"[1, 1, 0, 1, 1, 0, 0, 0, 0, 0, 1, 1, 1, 1, 0]",235,116,119,12,9,0.10344827586206896,0.07563025210084033
"[1, 0, 0, 0, 0, 1, 1, 1, 1, 1, 0, 1, 1, 0, 0]",175,64,111,9,4,0.140625,0.036036036036036036
"[0, 0, 1, 0, 0, 1, 0, 1, 0, 1, 0, 0, 0, 0, 1]",245,152,93,17,12,0.1118421052631579,0.12903225806451613
"[1, 1, 0, 1, 1, 0, 1, 0, 1, 0, 0, 0, 1, 1, 1]",161,68,93,9,10,0.1323529411764706,0.10752688172043011
"[0, 0, 0, 1, 1, 1, 1, 1, 0, 1, 1, 1, 1, 1, 0]",311,130,181,9,20,0.06923076923076923,0.11049723756906077
"[1, 0, 0, 0, 1, 1, 1, 1, 0, 1, 0, 0, 1, 1, 0]",140,74,66,9,7,0.12162162162162163,0.10606060606060606
"[0, 0, 0, 0, 0, 0, 0, 1, 1, 0, 0, 0, 0, 1, 1]",6059,5253,806,514,85,0.09784884827717495,0.1054590570719603
"[0, 0, 1, 0, 0, 0, 0, 0, 0, 1, 1, 0, 0, 0, 1]",688,477,211,46,18,0.09643605870020965,0.08530805687203792
"[1, 1, 0, 1, 1, 1, 0, 0, 0, 1, 0, 0, 1, 1, 1]",183,64,119,3,16,0.046875,0.13445378151260504
"[1, 0, 1, 1, 1, 1, 0, 1, 1, 1, 0, 0, 0, 1, 0]",140,57,83,4,6,0.07017543859649122,0.07228915662650602
"[0, 0, 1, 0, 0, 0, 1, 0, 0, 1, 0, 1, 1, 1, 1]",158,90,68,7,1,0.07777777777777778,0.014705882352941176
"[1, 1, 1, 1, 1, 1, 1, 1, 1, 0, 0, 1, 0, 1, 1]",2490,506,1984,51,186,0.1007905138339921,0.09375
"[1, 1, 1, 0, 1, 1, 1, 1, 0, 1, 1, 1, 1, 0, 0]",760,229,531,23,56,0.10043668122270742,0.10546139359698682
"[1, 0, 0, 1, 0, 1, 1, 1, 0, 1, 1, 1, 1, 1, 1]",692,191,501,20,46,0.10471204188481675,0.09181636726546906
"[0, 0, 0, 0, 1, 1, 1, 0, 0, 1, 1, 0, 0, 1, 1]",333,192,141,21,12,0.109375,0.0851063829787234
"[1, 0, 1, 1, 1, 0, 1, 1, 1, 0, 1, 0, 0, 0, 0]",138,70,68,6,7,0.08571428571428572,0.10294117647058823
"[1, 1, 1, 0, 1, 0, 1, 0, 1, 1, 1, 0, 0, 1, 0]",142,58,84,6,7,0.10344827586206896,0.08333333333333333
"[1, 1, 1, 0, 1, 1, 1, 0, 0, 0, 1, 1, 0, 0, 1]",206,72,134,7,17,0.09722222222222222,0.12686567164179105
"[1, 1, 0, 0, 0, 0, 1, 0, 0, 1, 0, 1, 1, 1, 1]",197,89,108,9,9,0.10112359550561797,0.08333333333333333
"[0, 1, 1, 0, 0, 0, 0, 1, 0, 0, 1, 0, 1, 1, 1]",219,163,56,20,8,0.12269938650306748,0.14285714285714285
"[0, 0, 1, 1, 0, 0, 0, 0, 1, 0, 0, 1, 0, 1, 1]",255,149,106,16,12,0.10738255033557047,0.11320754716981132
"[1, 0, 1, 0, 1, 0, 0, 1, 1, 1, 0, 0, 0, 1, 1]",101,42,59,1,7,0.023809523809523808,0.11864406779661017
"[0, 0, 1, 0, 0, 1, 0, 1, 0, 1, 0, 0, 1, 1, 1]",147,67,80,11,10,0.16417910447761194,0.125
"[0, 0, 0, 1, 0, 0, 1, 1, 1, 0, 0, 1, 0, 0, 1]",130,75,55,5,7,0.06666666666666667,0.12727272727272726
"[0, 0, 0, 0, 0, 0, 1, 1, 0, 1, 1, 0, 0, 1, 1]",344,221,123,21,6,0.09502262443438914,0.04878048780487805
"[1, 1, 0, 0, 0, 0, 0, 0, 0, 0, 0, 0, 1, 1, 0]",3996,2735,1261,252,118,0.09213893967093235,0.09357652656621729
"[0, 0, 1, 1, 0, 0, 0, 0, 0, 0, 1, 1, 1, 1, 0]",1913,1150,763,109,67,0.09478260869565218,0.08781127129750983
"[1, 1, 0, 0, 1, 0, 1, 0, 0, 1, 1, 0, 0, 0, 0]",252,146,106,20,8,0.136986301369863,0.07547169811320754
"[1, 1, 1, 0, 0, 1, 0, 1, 0, 0, 1, 1, 0, 0, 0]",166,83,83,12,4,0.14457831325301204,0.04819277108433735
"[0, 0, 0, 1, 0, 0, 0, 0, 1, 1, 0, 0, 1, 1, 1]",487,299,188,29,19,0.09698996655518395,0.10106382978723404
"[0, 0, 1, 1, 1, 1, 0, 0, 0, 1, 1, 0, 0, 1, 0]",150,80,70,13,7,0.1625,0.1
"[0, 0, 1, 0, 1, 0, 0, 1, 1, 1, 1, 0, 0, 0, 1]",121,62,59,4,3,0.06451612903225806,0.05084745762711865
"[0, 1, 0, 1, 1, 1, 1, 1, 0, 1, 0, 0, 0, 0, 0]",130,61,69,3,4,0.04918032786885246,0.057971014492753624
"[0, 0, 0, 1, 0, 1, 0, 1, 1, 1, 1, 1, 0, 1, 0]",121,65,56,7,7,0.1076923076923077,0.125
"[1, 0, 0, 0, 0, 1, 0, 1, 0, 1, 1, 1, 1, 1, 0]",129,60,69,5,4,0.08333333333333333,0.057971014492753624
"[0, 1, 0, 0, 0, 0, 1, 0, 1, 0, 1, 1, 1, 1, 1]",157,88,69,9,5,0.10227272727272728,0.07246376811594203
"[1, 1, 0, 0, 0, 1, 0, 0, 0, 0, 1, 0, 1, 0, 1]",147,94,53,10,6,0.10638297872340426,0.11320754716981132
"[1, 1, 1, 1, 0, 0, 1, 1, 0, 0, 0, 1, 0, 0, 0]",221,134,87,17,8,0.12686567164179105,0.09195402298850575
"[1, 0, 1, 0, 1, 0, 0, 1, 1, 1, 1, 0, 0, 1, 1]",329,114,215,10,24,0.08771929824561403,0.11162790697674418
"[1, 1, 0, 1, 1, 0, 1, 1, 0, 0, 0, 0, 0, 0, 0]",289,157,132,12,13,0.07643312101910828,0.09848484848484848
"[1, 0, 1, 0, 0, 1, 1, 0, 1, 0, 1, 0, 0, 0, 1]",106,51,55,4,7,0.0784313725490196,0.12727272727272726
"[1, 0, 0, 1, 0, 0, 0, 1, 1, 1, 1, 1, 1, 1, 1]",510,186,324,18,29,0.0967741935483871,0.08950617283950617
"[0, 1, 0, 0, 1, 0, 0, 0, 1, 1, 1, 1, 1, 1, 1]",265,115,150,12,18,0.10434782608695652,0.12
"[0, 0, 1, 1, 0, 1, 0, 0, 1, 0, 0, 1, 0, 0, 1]",149,89,60,15,4,0.16853932584269662,0.06666666666666667
"[1, 1, 1, 1, 1, 1, 1, 1, 1, 1, 0, 0, 0, 1, 0]",1025,320,705,30,52,0.09375,0.07375886524822695
"[0, 0, 0, 1, 1, 0, 0, 0, 0, 1, 1, 1, 1, 1, 1]",1908,1489,419,160,47,0.10745466756212223,0.11217183770883055
"[1, 1, 1, 1, 0, 0, 0, 0, 0, 0, 1, 1, 0, 0, 0]",1875,1080,795,102,69,0.09444444444444444,0.08679245283018867
"[0, 0, 1, 1, 1, 1, 0, 0, 0, 0, 0, 0, 1, 1, 0]",1818,1099,719,108,46,0.09827115559599636,0.06397774687065369
"[0, 1, 0, 0, 0, 0, 0, 1, 0, 1, 1, 1, 1, 0, 0]",207,121,86,10,7,0.08264462809917356,0.08139534883720931
"[0, 1, 0, 1, 0, 0, 1, 0, 0, 0, 0, 0, 1, 0, 1]",253,158,95,17,7,0.10759493670886076,0.07368421052631578
"[1, 1, 0, 0, 0, 1, 0, 0, 0, 1, 0, 1, 0, 0, 1]",145,81,64,3,8,0.037037037037037035,0.125
"[0, 1, 0, 1, 1, 0, 0, 0, 0, 0, 1, 0, 0, 0, 0]",601,448,153,49,15,0.109375,0.09803921568627451
"[1, 1, 1, 0, 0, 0, 1, 0, 1, 1, 0, 0, 0, 0, 0]",206,126,80,10,5,0.07936507936507936,0.0625
"[0, 0, 0, 1, 0, 0, 0, 0, 0, 1, 1, 1, 1, 1, 1]",409,257,152,31,15,0.12062256809338522,0.09868421052631579
"[0, 0, 0, 0, 1, 0, 0, 0, 0, 0, 1, 1, 1, 1, 1]",483,296,187,34,15,0.11486486486486487,0.08021390374331551
"[0, 0, 1, 0, 1, 1, 1, 1, 0, 0, 0, 0, 0, 0, 1]",319,184,135,11,17,0.059782608695652176,0.1259259259259259
"[0, 1, 1, 0, 0, 0, 1, 0, 0, 0, 1, 1, 0, 0, 0]",384,265,119,27,12,0.1018867924528302,0.10084033613445378
"[1, 0, 1, 1, 0, 0, 0, 1, 0, 0, 0, 1, 1, 0, 0]",188,116,72,16,4,0.13793103448275862,0.05555555555555555
"[1, 0, 0, 1, 0, 1, 1, 1, 1, 1, 1, 0, 0, 0, 0]",288,122,166,9,19,0.07377049180327869,0.1144578313253012
"[1, 1, 0, 1, 1, 1, 0, 0, 0, 0, 1, 1, 1, 0, 1]",170,75,95,3,8,0.04,0.08421052631578947
"[1, 0, 1, 0, 1, 1, 0, 1, 1, 1, 0, 0, 0, 0, 1]",163,76,87,7,11,0.09210526315789473,0.12643678160919541
"[1, 0, 1, 0, 1, 0, 1, 1, 0, 1, 1, 1, 0, 0, 0]",128,52,76,5,10,0.09615384615384616,0.13157894736842105
"[1, 0, 1, 0, 0, 0, 1, 0, 0, 1, 0, 1, 0, 1, 0]",118,71,47,8,4,0.11267605633802817,0.0851063829787234
"[1, 0, 0, 1, 1, 1, 1, 1, 0, 1, 0, 0, 0, 1, 0]",115,47,68,4,2,0.0851063829787234,0.029411764705882353
"[1, 1, 0, 1, 1, 0, 0, 0, 0, 1, 0, 0, 1, 1, 1]",155,65,90,8,10,0.12307692307692308,0.1111111111111111
"[0, 0, 0, 0, 0, 0, 0, 1, 0, 1, 0, 1, 1, 0, 0]",698,508,190,46,24,0.09055118110236221,0.12631578947368421
"[1, 0, 0, 0, 1, 0, 0, 0, 1, 0, 0, 1, 1, 0, 0]",308,198,110,21,10,0.10606060606060606,0.09090909090909091
"[1, 0, 0, 0, 1, 1, 1, 1, 1, 1, 1, 0, 0, 1, 1]",564,177,387,14,39,0.07909604519774012,0.10077519379844961
"[1, 0, 0, 0, 0, 1, 1, 0, 0, 0, 1, 1, 0, 0, 0]",401,203,198,19,14,0.09359605911330049,0.0707070707070707
"[0, 1, 0, 1, 0, 0, 0, 1, 1, 0, 1, 1, 1, 0, 0]",115,60,55,9,8,0.15,0.14545454545454545
"[1, 0, 0, 1, 0, 1, 1, 0, 1, 1, 0, 1, 0, 1, 0]",92,45,47,2,3,0.044444444444444446,0.06382978723404255
"[0, 1, 0, 0, 1, 0, 0, 1, 1, 1, 0, 1, 0, 1, 1]",105,62,43,8,4,0.12903225806451613,0.09302325581395349
"[1, 1, 1, 0, 0, 0, 0, 1, 1, 1, 1, 0, 0, 0, 0]",1569,340,1229,33,106,0.09705882352941177,0.08624898291293735
"[0, 0, 1, 1, 0, 0, 0, 0, 1, 0, 1, 0, 1, 0, 0]",295,192,103,16,11,0.08333333333333333,0.10679611650485436
"[1, 0, 0, 1, 1, 0, 0, 0, 0, 1, 0, 1, 0, 1, 0]",195,90,105,9,7,0.1,0.06666666666666667
"[0, 1, 1, 1, 0, 0, 1, 1, 0, 0, 0, 0, 1, 0, 1]",143,75,68,11,7,0.14666666666666667,0.10294117647058823
"[0, 1, 0, 1, 1, 1, 0, 0, 1, 1, 0, 0, 0, 0, 1]",285,146,139,17,7,0.11643835616438356,0.050359712230215826
"[0, 0, 0, 1, 1, 1, 0, 0, 0, 0, 1, 0, 0, 0, 0]",652,479,173,46,16,0.09603340292275574,0.09248554913294797
"[1, 1, 1, 1, 0, 1, 0, 0, 0, 1, 1, 1, 0, 0, 0]",147,59,88,7,11,0.11864406779661017,0.125
"[1, 1, 0, 0, 0, 1, 1, 1, 1, 0, 0, 1, 0, 1, 1]",207,85,122,8,10,0.09411764705882353,0.08196721311475409
"[0, 0, 1, 1, 1, 1, 0, 1, 0, 0, 1, 0, 0, 1, 0]",128,68,60,3,4,0.04411764705882353,0.06666666666666667
"[1, 1, 1, 1, 0, 0, 1, 1, 1, 0, 0, 1, 1, 1, 1]",1241,383,858,35,90,0.09138381201044386,0.1048951048951049
"[1, 0, 0, 1, 0, 1, 1, 1, 0, 0, 1, 0, 1, 0, 0]",128,58,70,4,5,0.06896551724137931,0.07142857142857142
"[0, 0, 1, 1, 0, 0, 1, 0, 0, 0, 0, 1, 0, 0, 1]",252,163,89,20,13,0.12269938650306748,0.14606741573033707
"[0, 1, 0, 0, 0, 0, 0, 1, 1, 0, 0, 1, 0, 1, 1]",188,108,80,5,5,0.046296296296296294,0.0625
"[1, 0, 1, 0, 0, 0, 0, 0, 1, 1, 0, 0, 1, 0, 1]",172,103,69,14,2,0.13592233009708737,0.028985507246376812
"[1, 0, 0, 0, 0, 1, 1, 1, 0, 0, 1, 0, 1, 0, 1]",125,65,60,2,10,0.03076923076923077,0.16666666666666666
"[1, 1, 1, 0, 0, 0, 1, 0, 0, 1, 0, 0, 0, 1, 1]",167,77,90,4,7,0.05194805194805195,0.07777777777777778
"[0, 1, 0, 0, 1, 0, 0, 1, 0, 0, 0, 1, 0, 1, 1]",159,90,69,2,11,0.022222222222222223,0.15942028985507245
"[0, 0, 1, 0, 0, 1, 0, 0, 1, 0, 0, 0, 1, 0, 1]",228,141,87,4,7,0.028368794326241134,0.08045977011494253
"[0, 1, 1, 0, 0, 0, 1, 0, 0, 1, 0, 0, 1, 0, 0]",244,171,73,20,5,0.11695906432748537,0.0684931506849315
"[0, 1, 1, 0, 0, 1, 1, 1, 1, 0, 0, 0, 0, 0, 0]",1960,1648,312,160,33,0.0970873786407767,0.10576923076923077
"[0, 0, 0, 1, 1, 1, 1, 0, 0, 0, 0, 1, 1, 0, 1]",390,306,84,22,9,0.0718954248366013,0.10714285714285714
"[1, 1, 0, 1, 0, 0, 1, 0, 1, 0, 0, 0, 0, 0, 0]",314,193,121,17,20,0.08808290155440414,0.1652892561983471
"[0, 0, 1, 0, 1, 1, 1, 0, 0, 0, 0, 1, 0, 0, 0]",244,158,86,14,8,0.08860759493670886,0.09302325581395349
"[0, 0, 0, 0, 0, 1, 0, 1, 1, 1, 0, 0, 0, 0, 1]",389,262,127,19,18,0.07251908396946564,0.14173228346456693
"[0, 0, 0, 1, 0, 0, 0, 0, 0, 0, 0, 1, 1, 0, 0]",3043,2361,682,206,68,0.08725116476069462,0.09970674486803519
"[1, 0, 0, 0, 1, 1, 0, 0, 0, 0, 1, 1, 0, 0, 0]",792,490,302,50,28,0.10204081632653061,0.09271523178807947
"[1, 0, 0, 0, 1, 0, 1, 0, 1, 0, 0, 0, 0, 1, 0]",240,156,84,21,10,0.1346153846153846,0.11904761904761904
"[0, 1, 0, 0, 0, 0, 1, 0, 1, 1, 0, 0, 0, 1, 0]",220,135,85,12,11,0.08888888888888889,0.12941176470588237
"[1, 1, 0, 0, 1, 0, 1, 0, 0, 0, 0, 1, 0, 0, 0]",263,182,81,17,6,0.09340659340659341,0.07407407407407407
"[1, 0, 1, 0, 0, 1, 1, 0, 0, 0, 1, 1, 0, 0, 1]",165,95,70,8,9,0.08421052631578947,0.12857142857142856
"[1, 0, 0, 0, 1, 0, 0, 0, 1, 0, 1, 0, 0, 0, 1]",228,136,92,14,8,0.10294117647058823,0.08695652173913043
"[0, 0, 0, 0, 1, 0, 0, 0, 1, 0, 0, 0, 1, 0, 1]",528,375,153,31,17,0.08266666666666667,0.1111111111111111
"[1, 0, 1, 1, 1, 0, 0, 1, 0, 0, 0, 1, 0, 0, 0]",152,96,56,19,3,0.19791666666666666,0.05357142857142857
"[0, 0, 0, 1, 0, 1, 0, 1, 1, 1, 0, 0, 1, 0, 0]",155,92,63,12,8,0.13043478260869565,0.12698412698412698
"[0, 1, 0, 0, 0, 1, 0, 1, 0, 1, 1, 1, 0, 0, 1]",120,73,47,9,1,0.1232876712328767,0.02127659574468085
"[0, 1, 1, 1, 1, 1, 0, 0, 1, 1, 1, 1, 1, 1, 1]",3756,1103,2653,99,267,0.08975521305530372,0.10064078401809272
"[1, 0, 1, 1, 0, 1, 1, 0, 1, 1, 0, 0, 1, 0, 1]",120,47,73,2,5,0.0425531914893617,0.0684931506849315
"[1, 1, 1, 1, 1, 1, 1, 1, 1, 1, 0, 1, 0, 0, 1]",2262,534,1728,44,171,0.08239700374531835,0.09895833333333333
"[1, 0, 1, 0, 1, 0, 1, 1, 0, 1, 0, 1, 1, 0, 0]",128,53,75,1,3,0.018867924528301886,0.04
"[0, 1, 1, 1, 1, 0, 0, 1, 1, 0, 0, 0, 1, 1, 1]",511,368,143,25,14,0.06793478260869565,0.0979020979020979
"[1, 1, 0, 1, 1, 1, 0, 1, 1, 0, 1, 1, 0, 1, 1]",492,143,349,10,29,0.06993006993006994,0.0830945558739255
"[0, 0, 1, 0, 0, 0, 0, 1, 0, 1, 0, 1, 0, 0, 1]",236,152,84,22,9,0.14473684210526316,0.10714285714285714
"[0, 0, 0, 1, 0, 0, 0, 0, 1, 0, 1, 0, 1, 0, 0]",500,352,148,40,11,0.11363636363636363,0.07432432432432433
"[0, 1, 1, 0, 0, 0, 1, 0, 0, 0, 1, 0, 0, 0, 0]",586,411,175,38,17,0.09245742092457421,0.09714285714285714
"[1, 1, 0, 0, 0, 0, 0, 1, 0, 1, 0, 1, 0, 1, 0]",139,83,56,11,4,0.13253012048192772,0.07142857142857142
"[1, 0, 0, 0, 0, 0, 1, 1, 0, 0, 0, 0, 0, 0, 0]",3541,2595,946,250,90,0.09633911368015415,0.09513742071881606
"[1, 0, 0, 0, 0, 1, 0, 0, 1, 0, 0, 1, 0, 0, 0]",531,370,161,28,25,0.07567567567567568,0.15527950310559005
"[0, 0, 0, 1, 1, 1, 1, 1, 1, 1, 0, 1, 1, 0, 0]",230,130,100,12,10,0.09230769230769231,0.1
"[1, 0, 1, 1, 0, 1, 1, 0, 1, 1, 1, 0, 0, 1, 1]",277,91,186,9,13,0.0989010989010989,0.06989247311827956
"[1, 0, 1, 1, 0, 1, 1, 1, 1, 0, 1, 1, 0, 1, 1]",509,144,365,19,34,0.13194444444444445,0.09315068493150686
"[0, 1, 0, 0, 1, 0, 0, 0, 0, 0, 0, 0, 0, 1, 0]",1552,1190,362,117,32,0.09831932773109243,0.08839779005524862
"[1, 0, 1, 0, 0, 0, 1, 1, 1, 1, 1, 1, 1, 1, 1]",1084,327,757,38,75,0.1162079510703364,0.09907529722589167
"[0, 1, 1, 0, 0, 1, 0, 0, 0, 0, 0, 0, 1, 0, 1]",295,190,105,22,10,0.11578947368421053,0.09523809523809523
"[1, 1, 1, 0, 1, 0, 1, 1, 0, 1, 1, 1, 1, 1, 1]",1968,458,1510,35,157,0.07641921397379912,0.10397350993377484
"[1, 1, 1, 1, 1, 0, 1, 1, 1, 1, 1, 1, 0, 1, 0]",1518,347,1171,28,119,0.08069164265129683,0.10162254483347566
"[1, 1, 1, 1, 0, 1, 1, 1, 1, 1, 0, 0, 1, 1, 1]",2833,641,2192,65,218,0.10140405616224649,0.09945255474452555
"[0, 1, 1, 1, 1, 1, 1, 1, 0, 1, 1, 1, 1, 1, 0]",1803,513,1290,52,130,0.10136452241715399,0.10077519379844961
"[1, 0, 0, 1, 0, 1, 0, 1, 0, 1, 0, 1, 1, 1, 1]",159,60,99,6,10,0.1,0.10101010101010101
"[1, 1, 0, 0, 1, 0, 1, 0, 1, 0, 1, 0, 1, 1, 1]",161,68,93,11,6,0.16176470588235295,0.06451612903225806
"[1, 1, 1, 1, 0, 0, 0, 1, 1, 1, 1, 1, 1, 1, 1]",3461,843,2618,83,273,0.09845788849347568,0.10427807486631016
"[0, 0, 0, 0, 1, 1, 0, 0, 0, 1, 0, 1, 1, 1, 0]",224,138,86,19,9,0.13768115942028986,0.10465116279069768
"[0, 0, 0, 1, 0, 0, 1, 0, 1, 1, 1, 1, 1, 0, 1]",110,54,56,5,4,0.09259259259259259,0.07142857142857142
"[0, 0, 0, 0, 1, 0, 0, 1, 0, 1, 1, 1, 1, 1, 0]",119,76,43,7,6,0.09210526315789473,0.13953488372093023
"[1, 0, 0, 1, 1, 0, 0, 1, 1, 0, 0, 0, 1, 1, 0]",254,79,175,4,23,0.05063291139240506,0.13142857142857142
"[1, 1, 0, 0, 1, 1, 0, 0, 1, 1, 0, 0, 0, 1, 1]",495,242,253,21,29,0.08677685950413223,0.11462450592885376
"[1, 1, 1, 1, 1, 0, 0, 1, 1, 0, 0, 1, 1, 0, 0]",1959,352,1607,35,166,0.09943181818181818,0.10329807093963908
"[1, 1, 1, 0, 1, 0, 0, 1, 0, 1, 0, 0, 0, 1, 0]",97,49,48,3,6,0.061224489795918366,0.125
"[1, 0, 0, 1, 1, 1, 0, 0, 1, 1, 0, 0, 1, 0, 0]",135,64,71,5,12,0.078125,0.16901408450704225
"[0, 1, 1, 0, 0, 0, 0, 0, 0, 1, 1, 1, 1, 0, 1]",370,272,98,31,10,0.11397058823529412,0.10204081632653061
"[1, 1, 0, 1, 1, 1, 1, 1, 0, 0, 0, 0, 0, 0, 0]",345,154,191,10,15,0.06493506493506493,0.07853403141361257
"[0, 0, 1, 0, 1, 0, 0, 0, 1, 1, 1, 1, 0, 1, 0]",125,66,59,6,4,0.09090909090909091,0.06779661016949153
"[1, 0, 0, 1, 0, 0, 1, 0, 1, 0, 0, 0, 1, 1, 1]",176,79,97,10,7,0.12658227848101267,0.07216494845360824
"[1, 1, 0, 0, 1, 0, 0, 1, 0, 1, 0, 0, 0, 1, 1]",150,82,68,6,6,0.07317073170731707,0.08823529411764706
"[0, 0, 0, 1, 1, 0, 0, 1, 0, 0, 1, 0, 1, 0, 0]",262,196,66,16,2,0.08163265306122448,0.030303030303030304
"[0, 0, 0, 1, 1, 1, 0, 0, 0, 0, 0, 1, 1, 0, 0]",404,279,125,28,11,0.1003584229390681,0.088
"[1, 0, 1, 1, 1, 0, 1, 1, 1, 1, 0, 0, 1, 1, 1]",849,241,608,28,66,0.11618257261410789,0.10855263157894737
"[1, 1, 0, 1, 1, 1, 1, 1, 1, 1, 1, 0, 0, 1, 1]",3688,915,2773,89,233,0.09726775956284153,0.08402452217814642
"[1, 1, 1, 1, 0, 0, 1, 0, 1, 0, 0, 0, 0, 0, 1]",157,73,84,8,12,0.1095890410958904,0.14285714285714285
"[0, 1, 1, 0, 1, 1, 1, 1, 0, 0, 1, 0, 1, 0, 0]",116,54,62,5,11,0.09259259259259259,0.1774193548387097
"[0, 1, 1, 0, 0, 1, 1, 0, 0, 1, 1, 1, 0, 1, 1]",326,204,122,15,11,0.07352941176470588,0.09016393442622951
"[1, 1, 0, 1, 0, 1, 1, 1, 0, 0, 1, 0, 1, 0, 1]",132,45,87,3,7,0.06666666666666667,0.08045977011494253
"[1, 0, 1, 1, 0, 1, 0, 1, 1, 1, 0, 0, 1, 0, 1]",148,53,95,6,8,0.11320754716981132,0.08421052631578947
"[1, 0, 1, 1, 0, 0, 0, 1, 0, 1, 0, 1, 0, 1, 1]",103,49,54,3,4,0.061224489795918366,0.07407407407407407
"[1, 0, 0, 0, 0, 0, 0, 0, 0, 1, 1, 0, 0, 1, 0]",918,446,472,39,53,0.08744394618834081,0.11228813559322035
"[0, 0, 1, 0, 0, 1, 0, 1, 0, 1, 0, 0, 0, 1, 1]",163,102,61,10,7,0.09803921568627451,0.11475409836065574
"[1, 1, 1, 0, 1, 0, 1, 0, 0, 0, 1, 0, 0, 1, 0]",102,50,52,10,1,0.2,0.019230769230769232
"[1, 1, 0, 1, 1, 0, 1, 0, 1, 0, 0, 0, 0, 0, 0]",205,118,87,8,10,0.06779661016949153,0.11494252873563218
"[0, 0, 1, 0, 0, 0, 1, 1, 0, 0, 1, 1, 1, 0, 1]",120,52,68,6,8,0.11538461538461539,0.11764705882352941
"[0, 1, 1, 1, 0, 0, 0, 0, 0, 1, 0, 1, 1, 0, 1]",113,61,52,2,4,0.03278688524590164,0.07692307692307693
"[1, 0, 1, 0, 1, 0, 0, 0, 0, 1, 1, 0, 0, 1, 1]",273,143,130,12,10,0.08391608391608392,0.07692307692307693
"[0, 0, 1, 1, 1, 0, 0, 1, 0, 1, 0, 1, 0, 1, 0]",99,52,47,2,6,0.038461538461538464,0.1276595744680851
"[1, 1, 0, 0, 1, 1, 1, 0, 1, 0, 0, 1, 0, 0, 0]",132,67,65,11,6,0.16417910447761194,0.09230769230769231
"[0, 1, 1, 1, 1, 0, 0, 1, 0, 1, 1, 1, 1, 1, 1]",783,338,445,21,44,0.0621301775147929,0.09887640449438202
"[0, 1, 1, 0, 0, 1, 1, 1, 1, 0, 0, 1, 0, 1, 1]",296,187,109,16,9,0.0855614973262032,0.08256880733944955
"[1, 0, 0, 1, 1, 0, 0, 1, 1, 1, 1, 0, 0, 1, 0]",305,75,230,11,17,0.14666666666666667,0.07391304347826087
"[0, 0, 0, 0, 1, 1, 1, 1, 1, 1, 1, 1, 1, 1, 0]",2172,881,1291,87,119,0.09875141884222474,0.09217660728117738
"[1, 1, 0, 0, 1, 1, 1, 1, 0, 1, 1, 0, 1, 1, 1]",882,265,617,18,48,0.06792452830188679,0.07779578606158834
"[1, 1, 0, 0, 1, 1, 0, 0, 0, 0, 0, 0, 1, 0, 1]",435,246,189,28,18,0.11382113821138211,0.09523809523809523
"[0, 0, 0, 0, 1, 1, 1, 0, 0, 0, 0, 1, 1, 0, 0]",649,442,207,48,27,0.1085972850678733,0.13043478260869565
"[1, 0, 1, 1, 0, 0, 0, 0, 0, 0, 1, 1, 1, 0, 0]",199,113,86,10,13,0.08849557522123894,0.1511627906976744
"[0, 1, 1, 1, 1, 1, 0, 0, 1, 0, 1, 1, 1, 0, 0]",198,95,103,7,6,0.07368421052631578,0.05825242718446602
"[0, 1, 1, 1, 1, 0, 0, 0, 0, 1, 1, 1, 1, 1, 1]",2611,1828,783,150,71,0.08205689277899343,0.09067688378033206
"[1, 1, 0, 0, 0, 1, 1, 1, 1, 1, 1, 0, 0, 1, 1]",768,273,495,25,39,0.09157509157509157,0.07878787878787878
"[1, 1, 0, 0, 0, 0, 1, 1, 0, 0, 1, 0, 1, 0, 0]",269,148,121,16,12,0.10810810810810811,0.09917355371900827
"[1, 0, 0, 0, 0, 1, 0, 1, 0, 0, 1, 0, 1, 1, 1]",172,85,87,13,10,0.15294117647058825,0.11494252873563218
"[1, 1, 0, 0, 1, 0, 1, 0, 1, 0, 0, 0, 0, 1, 0]",143,79,64,8,2,0.10126582278481013,0.03125
"[1, 1, 1, 1, 1, 0, 1, 0, 0, 0, 0, 0, 0, 0, 0]",342,162,180,14,14,0.08641975308641975,0.07777777777777778
"[1, 0, 0, 1, 1, 1, 0, 1, 1, 1, 1, 0, 1, 0, 0]",134,45,89,1,11,0.022222222222222223,0.12359550561797752
"[1, 1, 1, 0, 1, 0, 1, 0, 0, 0, 0, 0, 0, 1, 1]",244,108,136,12,12,0.1111111111111111,0.08823529411764706
"[0, 1, 0, 0, 0, 1, 0, 0, 0, 1, 1, 1, 1, 0, 1]",103,56,47,5,4,0.08928571428571429,0.0851063829787234
"[0, 1, 1, 0, 0, 1, 0, 0, 0, 1, 0, 0, 0, 1, 1]",170,111,59,15,8,0.13513513513513514,0.13559322033898305
"[1, 0, 1, 1, 1, 1, 1, 1, 0, 1, 1, 1, 0, 1, 1]",1510,371,1139,22,104,0.05929919137466307,0.0913081650570676
"[1, 0, 0, 1, 0, 1, 0, 1, 0, 1, 0, 0, 1, 1, 1]",147,69,78,7,10,0.10144927536231885,0.1282051282051282
"[1, 1, 1, 1, 1, 1, 1, 0, 1, 0, 0, 1, 0, 1, 0]",271,87,184,8,17,0.09195402298850575,0.09239130434782608
"[0, 0, 1, 1, 1, 0, 0, 1, 1, 1, 0, 0, 1, 1, 1]",253,114,139,10,15,0.08771929824561403,0.1079136690647482
"[1, 0, 0, 1, 1, 1, 0, 0, 1, 1, 0, 1, 0, 1, 0]",117,46,71,7,6,0.15217391304347827,0.08450704225352113
"[0, 1, 1, 1, 0, 0, 1, 1, 1, 0, 0, 1, 1, 0, 1]",154,71,83,4,6,0.056338028169014086,0.07228915662650602
"[0, 1, 1, 0, 0, 0, 0, 0, 0, 0, 1, 1, 1, 1, 1]",571,389,182,46,24,0.11825192802056556,0.13186813186813187
"[1, 1, 1, 1, 0, 0, 1, 1, 1, 1, 1, 0, 1, 1, 0]",757,235,522,22,50,0.09361702127659574,0.09578544061302682
"[1, 0, 1, 0, 0, 1, 0, 0, 0, 0, 1, 0, 0, 0, 0]",555,368,187,34,15,0.09239130434782608,0.08021390374331551
"[0, 0, 0, 0, 0, 0, 1, 0, 0, 1, 0, 1, 0, 0, 1]",600,430,170,38,13,0.08837209302325581,0.07647058823529412
"[1, 0, 0, 0, 0, 0, 1, 1, 0, 0, 1, 1, 0, 0, 0]",850,523,327,44,31,0.0841300191204589,0.09480122324159021
"[1, 1, 0, 0, 1, 1, 1, 0, 0, 1, 1, 1, 1, 1, 1]",1284,383,901,41,87,0.10704960835509138,0.09655937846836848
"[0, 1, 0, 1, 1, 1, 0, 0, 0, 0, 1, 0, 0, 1, 1]",146,76,70,9,5,0.11842105263157894,0.07142857142857142
"[0, 0, 1, 1, 1, 0, 1, 1, 0, 0, 0, 1, 1, 0, 0]",168,97,71,8,6,0.08247422680412371,0.08450704225352113
"[1, 0, 1, 0, 1, 1, 1, 1, 1, 1, 0, 1, 0, 0, 1]",254,85,169,8,14,0.09411764705882353,0.08284023668639054
"[0, 1, 1, 0, 1, 1, 0, 0, 0, 0, 0, 1, 0, 0, 0]",259,166,93,15,9,0.09036144578313253,0.0967741935483871
"[0, 0, 0, 1, 1, 1, 1, 1, 1, 1, 1, 1, 0, 0, 0]",649,340,309,39,29,0.11470588235294117,0.09385113268608414
"[0, 0, 0, 0, 0, 1, 1, 1, 1, 1, 1, 1, 1, 1, 0]",632,427,205,44,15,0.10304449648711944,0.07317073170731707
"[0, 1, 1, 1, 1, 1, 0, 0, 0, 1, 0, 0, 0, 0, 0]",177,116,61,13,5,0.11206896551724138,0.08196721311475409
"[1, 1, 0, 1, 1, 1, 1, 1, 1, 0, 1, 0, 1, 1, 1]",1667,405,1262,40,116,0.09876543209876543,0.0919175911251981
"[1, 1, 0, 0, 1, 1, 1, 1, 1, 1, 1, 0, 0, 1, 1]",1557,495,1062,53,105,0.10707070707070707,0.09887005649717515
"[0, 1, 0, 0, 1, 0, 0, 1, 1, 0, 0, 1, 1, 0, 0]",324,179,145,15,10,0.08379888268156424,0.06896551724137931
"[0, 1, 0, 1, 1, 1, 0, 1, 0, 1, 0, 0, 1, 0, 0]",108,53,55,6,6,0.11320754716981132,0.10909090909090909
"[0, 0, 0, 1, 0, 1, 0, 1, 1, 1, 0, 1, 0, 1, 0]",102,54,48,4,5,0.07407407407407407,0.10416666666666667
"[1, 1, 1, 1, 0, 0, 0, 1, 1, 0, 0, 0, 1, 0, 1]",140,67,73,10,7,0.14925373134328357,0.0958904109589041
"[1, 1, 0, 1, 1, 1, 1, 0, 0, 1, 1, 1, 1, 1, 1]",3593,883,2710,88,283,0.09966024915062288,0.1044280442804428
"[0, 0, 0, 1, 1, 0, 0, 0, 0, 0, 1, 0, 1, 0, 0]",634,486,148,50,8,0.102880658436214,0.05405405405405406
"[1, 0, 1, 1, 0, 0, 1, 1, 1, 0, 0, 1, 1, 0, 1]",152,63,89,6,7,0.09523809523809523,0.07865168539325842
"[1, 1, 1, 1, 1, 1, 0, 1, 0, 1, 0, 1, 1, 0, 1]",547,150,397,13,34,0.08666666666666667,0.08564231738035265
"[0, 0, 1, 1, 0, 1, 1, 1, 1, 1, 1, 0, 0, 1, 1]",513,226,287,20,29,0.08849557522123894,0.10104529616724739
"[0, 0, 0, 0, 1, 0, 1, 0, 1, 1, 0, 0, 1, 1, 0]",212,130,82,9,10,0.06923076923076923,0.12195121951219512
"[0, 0, 0, 0, 0, 1, 0, 1, 0, 1, 1, 0, 0, 1, 1]",253,164,89,13,6,0.07926829268292683,0.06741573033707865
"[1, 0, 0, 1, 0, 0, 1, 0, 0, 1, 0, 0, 0, 0, 0]",569,379,190,37,20,0.09762532981530343,0.10526315789473684
"[1, 0, 0, 0, 0, 0, 1, 0, 1, 0, 0, 0, 0, 0, 1]",582,392,190,34,14,0.08673469387755102,0.07368421052631578
"[0, 0, 0, 0, 0, 0, 0, 0, 0, 1, 1, 0, 1, 0, 1]",935,717,218,70,20,0.09762900976290098,0.09174311926605505
"[0, 1, 0, 0, 0, 0, 1, 0, 0, 0, 1, 0, 0, 0, 0]",1679,1274,405,95,40,0.07456828885400314,0.09876543209876543
"[0, 1, 0, 0, 1, 0, 1, 0, 0, 0, 0, 0, 1, 1, 0]",307,180,127,20,16,0.1111111111111111,0.12598425196850394
"[0, 0, 0, 1, 1, 0, 0, 1, 0, 0, 0, 0, 0, 0, 1]",729,540,189,54,19,0.1,0.10052910052910052
"[0, 1, 0, 0, 0, 0, 0, 0, 0, 1, 1, 0, 0, 1, 0]",612,433,179,46,14,0.10623556581986143,0.0782122905027933
"[0, 0, 1, 0, 0, 0, 0, 0, 0, 0, 1, 1, 0, 0, 1]",1005,722,283,68,29,0.09418282548476455,0.10247349823321555
"[1, 0, 0, 1, 0, 0, 1, 1, 0, 1, 0, 0, 0, 1, 1]",139,64,75,14,5,0.21875,0.06666666666666667
"[1, 0, 0, 1, 1, 0, 1, 1, 0, 1, 1, 1, 0, 0, 0]",140,68,72,3,5,0.04411764705882353,0.06944444444444445
"[1, 0, 0, 1, 1, 0, 1, 0, 0, 1, 0, 1, 0, 1, 0]",84,41,43,3,2,0.07317073170731707,0.046511627906976744
"[1, 1, 1, 1, 1, 1, 1, 1, 1, 0, 1, 1, 0, 1, 0]",1721,388,1333,35,113,0.09020618556701031,0.08477119279819954
"[1, 1, 1, 1, 1, 1, 0, 0, 0, 1, 1, 1, 1, 0, 0]",610,196,414,12,33,0.061224489795918366,0.07971014492753623
"[1, 0, 1, 1, 1, 1, 0, 1, 0, 1, 1, 1, 1, 1, 0]",527,155,372,9,33,0.05806451612903226,0.08870967741935484
"[0, 1, 0, 1, 0, 1, 1, 1, 0, 1, 0, 0, 0, 1, 0]",97,54,43,7,6,0.12962962962962962,0.13953488372093023
"[1, 1, 1, 0, 1, 1, 1, 1, 1, 0, 0, 1, 1, 0, 1]",602,166,436,14,39,0.08433734939759036,0.08944954128440367
"[1, 0, 0, 1, 1, 0, 0, 1, 0, 0, 0, 0, 1, 1, 0]",216,114,102,14,12,0.12280701754385964,0.11764705882352941
"[0, 1, 1, 1, 0, 0, 1, 1, 0, 0, 1, 0, 0, 0, 0]",177,105,72,11,9,0.10476190476190476,0.125
"[0, 0, 1, 0, 1, 0, 1, 1, 0, 0, 1, 1, 1, 0, 0]",136,72,64,5,3,0.06944444444444445,0.046875
"[1, 1, 0, 0, 1, 1, 1, 1, 1, 0, 0, 0, 0, 0, 1]",222,113,109,12,9,0.10619469026548672,0.08256880733944955
"[0, 1, 1, 0, 0, 1, 1, 1, 0, 0, 1, 1, 1, 1, 1]",540,267,273,29,29,0.10861423220973783,0.10622710622710622
"[0, 0, 1, 1, 0, 0, 1, 1, 1, 0, 0, 1, 1, 1, 1]",439,201,238,27,27,0.13432835820895522,0.1134453781512605
"[1, 0, 1, 1, 1, 0, 0, 1, 0, 0, 0, 0, 0, 1, 1]",181,104,77,10,4,0.09615384615384616,0.05194805194805195
"[1, 1, 1, 0, 1, 1, 1, 0, 0, 1, 0, 0, 0, 0, 0]",147,73,74,5,7,0.0684931506849315,0.0945945945945946
"[0, 0, 0, 0, 1, 1, 1, 1, 0, 1, 0, 1, 0, 1, 1]",210,105,105,6,6,0.05714285714285714,0.05714285714285714
"[0, 0, 0, 0, 0, 1, 1, 1, 1, 0, 1, 0, 1, 0, 1]",180,109,71,9,6,0.08256880733944955,0.08450704225352113
"[0, 1, 0, 0, 1, 0, 0, 0, 0, 0, 1, 1, 1, 1, 0]",258,161,97,16,5,0.09937888198757763,0.05154639175257732
"[0, 1, 1, 1, 0, 1, 0, 0, 1, 1, 1, 1, 1, 1, 1]",877,322,555,27,53,0.08385093167701864,0.09549549549549549
"[1, 0, 1, 1, 1, 1, 1, 1, 1, 0, 1, 0, 1, 0, 1]",528,160,368,12,32,0.075,0.08695652173913043
"[1, 1, 0, 1, 1, 1, 1, 0, 1, 1, 1, 0, 1, 1, 1]",1714,390,1324,38,141,0.09743589743589744,0.10649546827794562
"[0, 0, 1, 1, 0, 1, 1, 1, 1, 0, 0, 1, 0, 0, 0]",138,75,63,6,7,0.08,0.1111111111111111
"[1, 1, 0, 1, 1, 1, 0, 0, 0, 0, 1, 1, 1, 1, 1]",688,236,452,23,44,0.09745762711864407,0.09734513274336283
"[1, 0, 0, 0, 0, 0, 0, 1, 0, 0, 1, 1, 0, 0, 0]",767,520,247,57,18,0.10961538461538461,0.0728744939271255
"[0, 1, 1, 0, 0, 1, 1, 0, 0, 0, 0, 0, 0, 1, 0]",634,521,113,46,10,0.08829174664107485,0.08849557522123894
"[0, 1, 1, 0, 0, 0, 0, 1, 1, 1, 1, 1, 1, 0, 0]",1581,1246,335,124,27,0.09951845906902086,0.08059701492537313
"[1, 0, 1, 1, 1, 1, 1, 1, 0, 0, 1, 1, 0, 0, 0]",502,203,299,20,24,0.09852216748768473,0.0802675585284281
"[0, 1, 0, 1, 0, 1, 1, 1, 1, 1, 1, 0, 0, 1, 1]",463,184,279,18,22,0.09782608695652174,0.07885304659498207
"[0, 1, 1, 0, 0, 1, 1, 1, 1, 0, 0, 0, 1, 0, 1]",245,173,72,17,9,0.09826589595375723,0.125
"[1, 1, 0, 0, 1, 1, 0, 0, 1, 0, 1, 0, 1, 0, 1]",141,70,71,6,7,0.08571428571428572,0.09859154929577464
"[1, 1, 1, 0, 0, 1, 1, 0, 0, 1, 0, 1, 0, 1, 0]",154,47,107,7,14,0.14893617021276595,0.1308411214953271
"[0, 1, 1, 1, 0, 1, 1, 1, 0, 1, 1, 1, 0, 0, 1]",251,79,172,8,18,0.10126582278481013,0.10465116279069768
"[0, 0, 1, 1, 0, 1, 1, 0, 0, 1, 1, 0, 0, 0, 0]",355,214,141,17,11,0.0794392523364486,0.07801418439716312
"[1, 1, 0, 0, 0, 1, 1, 0, 0, 1, 0, 0, 1, 0, 0]",155,96,59,13,5,0.13541666666666666,0.0847457627118644
"[1, 1, 0, 0, 0, 0, 1, 1, 1, 0, 0, 0, 1, 1, 0]",163,70,93,5,9,0.07142857142857142,0.0967741935483871
"[1, 0, 1, 1, 0, 1, 1, 0, 0, 1, 1, 1, 1, 1, 1]",992,305,687,27,53,0.08852459016393442,0.07714701601164484
"[0, 0, 1, 1, 1, 1, 0, 0, 0, 0, 0, 0, 1, 0, 0]",678,449,229,48,20,0.10690423162583519,0.08733624454148471
"[1, 1, 0, 0, 0, 1, 1, 0, 0, 1, 1, 0, 0, 0, 0]",497,290,207,24,25,0.08275862068965517,0.12077294685990338
"[0, 0, 1, 0, 0, 1, 0, 1, 1, 0, 1, 1, 1, 1, 0]",120,61,59,3,3,0.04918032786885246,0.05084745762711865
"[0, 1, 0, 0, 0, 1, 0, 0, 1, 1, 1, 0, 0, 0, 0]",330,212,118,22,13,0.10377358490566038,0.11016949152542373
"[0, 0, 0, 0, 0, 0, 0, 1, 1, 0, 0, 0, 1, 1, 1]",1643,1404,239,137,20,0.09757834757834757,0.08368200836820083
"[0, 0, 0, 1, 1, 1, 1, 0, 0, 1, 1, 0, 0, 1, 1]",1686,1299,387,142,42,0.10931485758275597,0.10852713178294573
"[1, 1, 1, 1, 1, 0, 0, 0, 1, 0, 0, 0, 0, 1, 0]",126,51,75,6,4,0.11764705882352941,0.05333333333333334
"[0, 1, 1, 1, 1, 0, 1, 1, 1, 1, 1, 0, 0, 1, 1]",856,293,563,26,54,0.08873720136518772,0.09591474245115453
"[0, 1, 1, 1, 1, 1, 1, 0, 0, 1, 1, 0, 1, 1, 1]",1020,537,483,53,46,0.09869646182495345,0.09523809523809523
"[0, 1, 1, 1, 1, 0, 1, 0, 0, 0, 0, 0, 0, 0, 1]",206,113,93,12,6,0.10619469026548672,0.06451612903225806
"[0, 1, 0, 1, 1, 1, 1, 1, 1, 0, 1, 1, 1, 0, 1]",492,138,354,9,32,0.06521739130434782,0.0903954802259887
"[1, 0, 1, 1, 1, 0, 0, 0, 0, 0, 0, 0, 1, 1, 1]",298,152,146,18,11,0.11842105263157894,0.07534246575342465
"[1, 0, 1, 0, 1, 1, 1, 0, 0, 0, 0, 0, 0, 0, 1]",230,131,99,9,16,0.06870229007633588,0.16161616161616163
"[0, 0, 1, 0, 0, 0, 1, 1, 1, 1, 1, 0, 1, 0, 1]",133,61,72,8,8,0.13114754098360656,0.1111111111111111
"[0, 1, 0, 1, 0, 0, 0, 1, 0, 0, 0, 1, 1, 1, 1]",174,93,81,12,8,0.12903225806451613,0.09876543209876543
"[0, 0, 0, 1, 0, 1, 0, 0, 0, 1, 0, 0, 0, 1, 1]",318,211,107,20,6,0.0947867298578199,0.056074766355140186
"[0, 1, 0, 0, 1, 0, 0, 0, 1, 0, 1, 0, 0, 0, 1]",225,158,67,18,6,0.11392405063291139,0.08955223880597014
"[0, 1, 1, 1, 1, 1, 0, 1, 1, 1, 1, 1, 0, 0, 1]",779,258,521,21,54,0.08139534883720931,0.1036468330134357
"[1, 0, 1, 1, 0, 1, 0, 0, 0, 1, 0, 0, 0, 1, 0]",144,85,59,8,7,0.09411764705882353,0.11864406779661017
"[1, 0, 0, 0, 0, 0, 1, 0, 1, 0, 1, 1, 0, 1, 0]",139,81,58,9,3,0.1111111111111111,0.05172413793103448
"[0, 1, 1, 0, 1, 1, 0, 1, 1, 1, 1, 1, 1, 1, 1]",2133,608,1525,51,142,0.08388157894736842,0.09311475409836066
"[0, 1, 1, 1, 1, 1, 0, 1, 1, 0, 0, 1, 1, 0, 1]",256,104,152,7,17,0.0673076923076923,0.1118421052631579
"[1, 1, 0, 0, 1, 1, 0, 1, 1, 1, 1, 0, 1, 1, 0]",261,102,159,8,11,0.0784313725490196,0.06918238993710692
"[1, 1, 1, 1, 1, 1, 1, 0, 0, 0, 0, 1, 1, 0, 0]",2198,405,1793,51,187,0.1259259259259259,0.10429447852760736
"[1, 1, 1, 0, 0, 1, 1, 1, 1, 1, 1, 1, 1, 1, 0]",3315,585,2730,64,261,0.1094017094017094,0.0956043956043956
"[1, 1, 0, 1, 0, 1, 1, 0, 0, 1, 1, 0, 0, 1, 1]",349,135,214,9,24,0.06666666666666667,0.11214953271028037
"[1, 0, 1, 1, 1, 1, 1, 1, 0, 0, 0, 1, 0, 1, 0]",136,54,82,5,4,0.09259259259259259,0.04878048780487805
"[0, 0, 1, 0, 0, 0, 1, 1, 0, 0, 1, 1, 1, 1, 1]",316,187,129,20,18,0.10695187165775401,0.13953488372093023
"[0, 0, 0, 0, 1, 0, 0, 0, 1, 1, 0, 0, 1, 1, 1]",380,243,137,20,12,0.0823045267489712,0.08759124087591241
"[0, 0, 1, 1, 0, 1, 1, 1, 0, 1, 0, 0, 1, 1, 0]",115,51,64,4,7,0.0784313725490196,0.109375
"[1, 0, 0, 1, 1, 0, 1, 1, 1, 0, 1, 0, 0, 1, 1]",158,59,99,7,10,0.11864406779661017,0.10101010101010101
"[1, 1, 1, 1, 0, 0, 1, 1, 1, 1, 0, 0, 0, 0, 0]",1589,779,810,72,84,0.09242618741976893,0.1037037037037037
"[1, 1, 1, 1, 1, 1, 0, 1, 0, 1, 0, 0, 0, 0, 1]",227,83,144,3,22,0.03614457831325301,0.1527777777777778
"[1, 0, 1, 1, 1, 1, 1, 1, 1, 0, 1, 0, 1, 0, 0]",232,71,161,6,19,0.08450704225352113,0.11801242236024845
"[1, 0, 1, 1, 0, 1, 1, 1, 1, 0, 0, 0, 1, 0, 1]",160,68,92,5,8,0.07352941176470588,0.08695652173913043
"[0, 0, 0, 0, 1, 0, 0, 1, 0, 0, 0, 0, 1, 1, 0]",724,513,211,47,27,0.09161793372319688,0.12796208530805686
"[0, 1, 1, 1, 0, 0, 0, 0, 0, 0, 1, 0, 0, 0, 1]",274,188,86,13,3,0.06914893617021277,0.03488372093023256
"[1, 1, 1, 0, 0, 0, 0, 0, 0, 1, 1, 0, 1, 1, 1]",454,105,349,11,28,0.10476190476190476,0.08022922636103152
"[1, 0, 1, 0, 1, 0, 1, 1, 1, 0, 0, 0, 0, 0, 0]",235,138,97,10,12,0.07246376811594203,0.12371134020618557
"[1, 0, 1, 1, 1, 1, 0, 1, 1, 0, 0, 1, 1, 1, 1]",871,256,615,21,65,0.08203125,0.10569105691056911
"[0, 0, 0, 1, 1, 1, 1, 1, 0, 1, 1, 1, 1, 0, 1]",257,125,132,9,12,0.072,0.09090909090909091
"[1, 1, 1, 1, 1, 1, 0, 0, 1, 0, 1, 0, 1, 1, 1]",830,232,598,27,55,0.11637931034482758,0.09197324414715718
"[1, 0, 1, 0, 1, 0, 0, 1, 1, 1, 1, 1, 1, 0, 0]",350,129,221,11,18,0.08527131782945736,0.08144796380090498
"[1, 1, 1, 0, 1, 1, 0, 1, 0, 1, 0, 0, 1, 1, 1]",314,118,196,20,18,0.1694915254237288,0.09183673469387756
"[0, 1, 0, 1, 1, 0, 1, 1, 1, 1, 1, 1, 0, 0, 1]",401,139,262,14,19,0.10071942446043165,0.07251908396946564
"[1, 1, 0, 0, 1, 1, 1, 0, 1, 1, 0, 1, 1, 1, 1]",675,174,501,14,52,0.08045977011494253,0.10379241516966067
"[1, 1, 1, 0, 0, 1, 1, 1, 0, 1, 1, 0, 1, 1, 1]",735,198,537,23,55,0.11616161616161616,0.10242085661080075
"[0, 0, 1, 0, 0, 0, 0, 1, 0, 1, 0, 0, 0, 1, 1]",307,204,103,19,12,0.09313725490196079,0.11650485436893204
"[1, 1, 0, 0, 1, 0, 1, 1, 1, 1, 0, 0, 1, 1, 1]",430,152,278,16,22,0.10526315789473684,0.07913669064748201
"[1, 0, 1, 1, 1, 1, 1, 1, 0, 1, 1, 0, 0, 1, 0]",210,80,130,8,13,0.1,0.1
"[0, 0, 0, 1, 0, 1, 0, 0, 1, 1, 1, 0, 0, 0, 0]",325,212,113,24,12,0.11320754716981132,0.10619469026548672
"[1, 0, 1, 1, 0, 0, 0, 0, 1, 1, 0, 0, 0, 1, 0]",158,91,67,6,7,0.06593406593406594,0.1044776119402985
"[0, 1, 0, 1, 1, 1, 0, 0, 1, 0, 1, 1, 1, 1, 1]",284,105,179,12,21,0.11428571428571428,0.11731843575418995
"[1, 1, 1, 1, 1, 1, 0, 1, 1, 1, 1, 1, 0, 1, 0]",1545,333,1212,32,89,0.0960960960960961,0.07343234323432343
"[0, 1, 1, 0, 1, 1, 1, 1, 1, 1, 1, 0, 0, 1, 1]",998,306,692,34,63,0.1111111111111111,0.09104046242774566
"[1, 1, 1, 1, 0, 1, 1, 0, 1, 1, 1, 1, 0, 1, 1]",1672,415,1257,47,130,0.11325301204819277,0.10342084327764518
"[1, 1, 0, 1, 1, 1, 0, 1, 1, 0, 0, 1, 0, 1, 1]",234,82,152,8,10,0.0975609756097561,0.06578947368421052
"[0, 1, 1, 1, 1, 1, 0, 1, 1, 0, 0, 1, 0, 0, 1]",177,85,92,5,6,0.058823529411764705,0.06521739130434782
"[1, 0, 0, 1, 1, 0, 1, 1, 0, 1, 1, 1, 0, 1, 1]",234,68,166,7,9,0.10294117647058823,0.05421686746987952
"[1, 0, 1, 0, 1, 0, 0, 1, 1, 0, 1, 1, 0, 1, 1]",142,58,84,4,7,0.06896551724137931,0.08333333333333333
"[0, 0, 0, 1, 1, 1, 1, 1, 1, 1, 0, 0, 0, 0, 1]",396,214,182,21,17,0.09813084112149532,0.09340659340659341
"[1, 1, 1, 1, 0, 0, 0, 0, 0, 0, 0, 0, 0, 1, 0]",690,461,229,53,28,0.11496746203904555,0.1222707423580786
"[0, 1, 1, 1, 1, 0, 0, 0, 0, 0, 0, 0, 0, 0, 1]",1035,839,196,86,18,0.10250297973778308,0.09183673469387756
"[0, 0, 1, 1, 0, 0, 1, 1, 0, 0, 0, 1, 1, 1, 0]",211,111,100,10,11,0.09009009009009009,0.11
"[0, 0, 0, 1, 1, 0, 1, 1, 1, 0, 1, 1, 1, 1, 1]",337,143,194,12,16,0.08391608391608392,0.08247422680412371
"[1, 0, 0, 0, 0, 0, 1, 1, 0, 1, 1, 1, 0, 1, 1]",130,61,69,7,9,0.11475409836065574,0.13043478260869565
"[0, 1, 0, 1, 1, 1, 0, 1, 1, 1, 0, 0, 1, 0, 0]",112,48,64,2,5,0.041666666666666664,0.078125
"[0, 1, 0, 1, 0, 1, 1, 1, 0, 1, 1, 1, 0, 0, 1]",153,59,94,3,6,0.05084745762711865,0.06382978723404255
"[1, 1, 1, 0, 1, 0, 0, 1, 1, 0, 1, 1, 1, 0, 1]",242,78,164,5,22,0.0641025641025641,0.13414634146341464
"[0, 1, 0, 1, 1, 1, 0, 0, 1, 1, 0, 0, 0, 0, 0]",346,197,149,24,22,0.1218274111675127,0.1476510067114094
"[1, 1, 0, 1, 0, 1, 1, 0, 1, 1, 1, 1, 1, 0, 0]",307,110,197,5,15,0.045454545454545456,0.07614213197969544
"[1, 1, 1, 1, 0, 0, 1, 1, 0, 0, 0, 0, 1, 0, 1]",404,181,223,21,13,0.11602209944751381,0.05829596412556054
"[1, 1, 1, 1, 1, 1, 1, 1, 0, 0, 0, 0, 0, 1, 0]",414,179,235,11,24,0.061452513966480445,0.10212765957446808
"[0, 1, 0, 0, 0, 1, 1, 1, 0, 0, 0, 0, 1, 1, 1]",209,104,105,8,9,0.07692307692307693,0.08571428571428572
"[1, 1, 0, 0, 1, 0, 0, 0, 0, 0, 1, 0, 0, 0, 0]",595,418,177,33,15,0.07894736842105263,0.0847457627118644
"[0, 0, 0, 1, 1, 1, 1, 0, 1, 0, 0, 0, 0, 1, 1]",231,147,84,15,11,0.10204081632653061,0.13095238095238096
"[1, 1, 0, 1, 0, 1, 1, 0, 1, 0, 1, 1, 1, 1, 1]",618,199,419,18,45,0.09045226130653267,0.10739856801909307
"[0, 0, 0, 1, 1, 0, 0, 0, 0, 1, 1, 1, 1, 1, 0]",361,277,84,22,13,0.07942238267148015,0.15476190476190477
"[1, 1, 1, 1, 0, 1, 0, 0, 1, 0, 1, 1, 1, 1, 0]",280,111,169,17,14,0.15315315315315314,0.08284023668639054
"[0, 0, 0, 1, 1, 1, 0, 0, 1, 0, 1, 0, 1, 1, 1]",167,87,80,2,10,0.022988505747126436,0.125
"[0, 1, 1, 1, 0, 0, 0, 0, 0, 1, 1, 1, 1, 0, 1]",159,76,83,7,8,0.09210526315789473,0.0963855421686747
"[1, 0, 0, 1, 1, 1, 0, 0, 0, 0, 0, 1, 1, 1, 1]",267,129,138,15,16,0.11627906976744186,0.11594202898550725
"[0, 1, 0, 0, 1, 1, 1, 0, 0, 0, 0, 0, 1, 1, 1]",230,133,97,13,8,0.09774436090225563,0.08247422680412371
"[1, 0, 1, 1, 1, 0, 1, 0, 0, 1, 1, 1, 0, 0, 0]",115,52,63,4,5,0.07692307692307693,0.07936507936507936
"[1, 1, 0, 0, 0, 0, 0, 0, 0, 0, 0, 0, 1, 0, 0]",2728,2009,719,163,65,0.08113489298158287,0.09040333796940195
"[1, 0, 0, 0, 1, 0, 1, 1, 0, 0, 0, 0, 1, 1, 0]",238,141,97,15,9,0.10638297872340426,0.09278350515463918
"[0, 0, 0, 0, 0, 1, 0, 1, 0, 0, 0, 1, 0, 1, 0]",513,364,149,34,23,0.09340659340659341,0.15436241610738255
"[1, 0, 0, 1, 0, 0, 0, 0, 0, 1, 0, 1, 0, 0, 0]",574,404,170,48,15,0.1188118811881188,0.08823529411764706
"[1, 1, 1, 0, 1, 1, 1, 0, 0, 0, 1, 0, 0, 0, 0]",124,61,63,9,7,0.14754098360655737,0.1111111111111111
"[0, 0, 0, 0, 0, 0, 1, 1, 1, 1, 0, 1, 1, 1, 0]",211,97,114,8,12,0.08247422680412371,0.10526315789473684
"[1, 1, 0, 1, 1, 0, 0, 0, 0, 1, 0, 1, 1, 0, 1]",113,47,66,7,5,0.14893617021276595,0.07575757575757576
"[1, 1, 1, 1, 0, 0, 0, 0, 1, 0, 0, 0, 0, 0, 0]",458,281,177,29,14,0.10320284697508897,0.07909604519774012
"[1, 1, 0, 1, 0, 0, 1, 1, 1, 0, 1, 0, 1, 1, 1]",272,92,180,12,19,0.13043478260869565,0.10555555555555556
"[1, 1, 1, 0, 0, 1, 1, 1, 1, 1, 0, 1, 0, 0, 1]",346,96,250,11,29,0.11458333333333333,0.116
"[0, 1, 1, 1, 0, 0, 1, 1, 1, 1, 1, 0, 1, 0, 0]",160,66,94,7,5,0.10606060606060606,0.05319148936170213
"[0, 1, 1, 0, 1, 0, 0, 0, 0, 1, 0, 1, 1, 1, 1]",148,80,68,12,8,0.15,0.11764705882352941
"[1, 1, 1, 1, 1, 1, 1, 0, 0, 1, 0, 0, 1, 0, 0]",229,77,152,9,15,0.11688311688311688,0.09868421052631579
"[1, 0, 1, 1, 1, 1, 0, 0, 1, 1, 1, 1, 0, 1, 0]",288,95,193,10,18,0.10526315789473684,0.09326424870466321
"[1, 1, 0, 1, 0, 1, 1, 1, 0, 1, 1, 0, 0, 0, 1]",146,53,93,8,10,0.1509433962264151,0.10752688172043011
"[0, 1, 1, 0, 0, 0, 0, 0, 0, 1, 0, 1, 1, 0, 1]",195,128,67,13,7,0.1015625,0.1044776119402985
"[1, 0, 1, 1, 0, 0, 0, 0, 0, 0, 1, 0, 1, 1, 0]",149,88,61,13,3,0.14772727272727273,0.04918032786885246
"[1, 0, 0, 1, 0, 0, 1, 1, 0, 1, 1, 1, 0, 1, 1]",138,48,90,6,10,0.125,0.1111111111111111
"[1, 1, 0, 1, 0, 0, 1, 0, 0, 1, 1, 0, 1, 1, 1]",185,80,105,7,4,0.0875,0.0380952380952381
"[0, 1, 1, 0, 1, 1, 0, 0, 1, 1, 1, 1, 1, 1, 0]",451,199,252,18,24,0.09045226130653267,0.09523809523809523
"[0, 0, 1, 1, 1, 1, 1, 1, 0, 1, 0, 1, 0, 0, 1]",225,108,117,14,12,0.12962962962962962,0.10256410256410256
"[0, 1, 0, 1, 1, 1, 0, 1, 1, 1, 1, 1, 1, 1, 0]",564,186,378,16,31,0.08602150537634409,0.082010582010582
"[0, 0, 1, 0, 1, 1, 1, 0, 1, 1, 0, 1, 0, 1, 0]",117,53,64,3,6,0.05660377358490566,0.09375
"[1, 1, 0, 0, 1, 0, 1, 1, 0, 0, 1, 0, 1, 1, 0]",94,42,52,5,2,0.11904761904761904,0.038461538461538464
"[0, 1, 1, 0, 1, 1, 1, 1, 1, 0, 0, 1, 0, 1, 1]",285,108,177,14,17,0.12962962962962962,0.096045197740113
"[0, 1, 1, 0, 1, 1, 0, 1, 1, 1, 1, 1, 0, 0, 1]",325,134,191,11,17,0.08208955223880597,0.08900523560209424
"[0, 0, 1, 0, 0, 0, 1, 1, 0, 1, 0, 0, 0, 0, 1]",238,150,88,9,9,0.06,0.10227272727272728
"[0, 0, 0, 1, 1, 1, 1, 1, 1, 0, 1, 1, 1, 0, 1]",310,156,154,17,17,0.10897435897435898,0.11038961038961038
"[0, 0, 0, 1, 1, 0, 0, 0, 0, 0, 0, 1, 1, 1, 0]",646,498,148,38,11,0.07630522088353414,0.07432432432432433
"[1, 0, 1, 0, 1, 1, 0, 1, 0, 1, 0, 1, 0, 1, 1]",153,55,98,3,10,0.05454545454545454,0.10204081632653061
"[1, 1, 1, 0, 0, 1, 1, 1, 0, 0, 0, 1, 0, 0, 0]",147,68,79,9,8,0.1323529411764706,0.10126582278481013
"[1, 1, 0, 0, 1, 0, 0, 1, 0, 0, 0, 0, 0, 0, 1]",325,222,103,23,11,0.1036036036036036,0.10679611650485436
"[1, 1, 1, 0, 0, 1, 0, 1, 0, 0, 0, 1, 0, 1, 0]",105,60,45,11,2,0.18333333333333332,0.044444444444444446
"[1, 0, 0, 0, 0, 0, 0, 0, 0, 1, 0, 1, 1, 1, 0]",342,206,136,19,8,0.09223300970873786,0.058823529411764705
"[1, 1, 1, 0, 0, 0, 0, 1, 0, 1, 0, 0, 0, 0, 0]",331,181,150,19,24,0.10497237569060773,0.16
"[0, 1, 0, 1, 1, 0, 0, 0, 0, 1, 1, 1, 1, 0, 0]",420,206,214,17,21,0.0825242718446602,0.09813084112149532
"[0, 0, 0, 1, 0, 1, 1, 0, 0, 0, 0, 1, 1, 1, 1]",331,208,123,16,8,0.07692307692307693,0.06504065040650407
"[1, 1, 0, 1, 0, 0, 1, 1, 1, 1, 1, 1, 1, 1, 0]",944,285,659,22,47,0.07719298245614035,0.07132018209408195
"[1, 1, 0, 0, 1, 1, 0, 1, 0, 0, 0, 1, 0, 0, 1]",123,66,57,10,10,0.15151515151515152,0.17543859649122806
"[1, 1, 1, 0, 1, 1, 0, 0, 1, 0, 0, 1, 1, 0, 1]",140,46,94,4,6,0.08695652173913043,0.06382978723404255
"[0, 0, 0, 1, 1, 1, 1, 0, 1, 1, 0, 1, 1, 0, 0]",144,88,56,9,7,0.10227272727272728,0.125
"[1, 0, 1, 1, 0, 0, 0, 1, 1, 0, 0, 1, 0, 1, 1]",107,50,57,4,4,0.08,0.07017543859649122
"[0, 0, 1, 1, 1, 1, 1, 0, 1, 1, 0, 0, 0, 1, 1]",189,82,107,7,6,0.08536585365853659,0.056074766355140186
"[0, 1, 1, 0, 0, 0, 0, 0, 1, 0, 0, 1, 1, 0, 0]",351,231,120,26,10,0.11255411255411256,0.08333333333333333
"[0, 0, 0, 1, 1, 1, 0, 1, 1, 1, 1, 1, 1, 0, 0]",264,127,137,11,11,0.08661417322834646,0.08029197080291971
"[0, 1, 0, 1, 1, 0, 1, 1, 1, 1, 0, 0, 1, 0, 0]",123,57,66,4,5,0.07017543859649122,0.07575757575757576
"[1, 0, 1, 1, 1, 1, 1, 1, 1, 1, 0, 1, 1, 0, 1]",1558,365,1193,33,122,0.09041095890410959,0.10226320201173512
"[1, 0, 0, 1, 1, 0, 0, 0, 0, 1, 0, 0, 1, 0, 1]",197,97,100,15,8,0.15463917525773196,0.08
"[0, 0, 0, 1, 1, 0, 0, 1, 1, 0, 0, 0, 0, 1, 0]",645,534,111,59,7,0.1104868913857678,0.06306306306306306
"[0, 0, 1, 1, 1, 1, 1, 1, 1, 0, 1, 1, 0, 0, 1]",377,147,230,16,23,0.10884353741496598,0.1
"[0, 1, 1, 1, 1, 0, 1, 0, 0, 1, 0, 1, 0, 0, 1]",101,38,63,5,5,0.13157894736842105,0.07936507936507936
"[0, 1, 0, 0, 0, 1, 1, 1, 1, 0, 1, 0, 0, 1, 0]",127,71,56,3,4,0.04225352112676056,0.07142857142857142
"[1, 1, 0, 1, 1, 1, 0, 1, 1, 1, 1, 0, 0, 0, 0]",261,88,173,5,21,0.056818181818181816,0.12138728323699421
"[0, 1, 1, 1, 0, 1, 1, 1, 0, 1, 0, 0, 1, 1, 0]",171,78,93,8,12,0.10256410256410256,0.12903225806451613
"[0, 0, 0, 1, 0, 0, 1, 1, 1, 0, 1, 1, 0, 1, 1]",106,48,58,0,7,0.0,0.1206896551724138
"[1, 0, 1, 1, 0, 0, 0, 0, 0, 0, 1, 1, 0, 1, 0]",170,104,66,11,2,0.10576923076923077,0.030303030303030304
"[1, 0, 1, 1, 0, 0, 0, 0, 1, 1, 1, 0, 0, 1, 1]",184,85,99,9,10,0.10588235294117647,0.10101010101010101
"[0, 0, 0, 0, 0, 0, 1, 0, 1, 0, 1, 1, 0, 1, 0]",252,155,97,14,12,0.09032258064516129,0.12371134020618557
"[0, 0, 0, 1, 0, 0, 1, 1, 0, 0, 0, 1, 1, 0, 1]",142,95,47,9,10,0.09473684210526316,0.2127659574468085
"[0, 0, 0, 1, 1, 1, 0, 0, 0, 1, 0, 0, 1, 1, 0]",167,93,74,8,9,0.08602150537634409,0.12162162162162163
"[0, 1, 1, 0, 0, 1, 0, 1, 0, 1, 1, 0, 1, 0, 1]",100,63,37,8,5,0.12698412698412698,0.13513513513513514
"[1, 0, 0, 0, 1, 1, 0, 0, 1, 0, 1, 0, 1, 1, 0]",101,55,46,4,2,0.07272727272727272,0.043478260869565216
"[0, 1, 0, 0, 0, 1, 1, 0, 0, 1, 0, 1, 0, 1, 1]",105,59,46,6,2,0.1016949152542373,0.043478260869565216
"[1, 0, 1, 0, 0, 0, 1, 1, 0, 0, 1, 0, 1, 0, 1]",103,45,58,10,5,0.2222222222222222,0.08620689655172414
"[1, 0, 0, 1, 0, 0, 1, 0, 0, 0, 0, 1, 0, 0, 0]",518,346,172,33,18,0.0953757225433526,0.10465116279069768
"[1, 1, 0, 1, 1, 0, 0, 1, 0, 0, 1, 0, 0, 0, 0]",160,96,64,6,4,0.0625,0.0625
"[1, 1, 1, 0, 0, 0, 0, 1, 1, 0, 1, 0, 0, 0, 0]",226,109,117,8,8,0.07339449541284404,0.06837606837606838
"[1, 0, 0, 1, 0, 1, 0, 1, 0, 1, 1, 1, 1, 0, 0]",143,68,75,6,9,0.08823529411764706,0.12
"[0, 1, 0, 0, 1, 0, 1, 1, 0, 0, 1, 0, 1, 0, 1]",105,49,56,7,5,0.14285714285714285,0.08928571428571429
"[0, 1, 0, 1, 0, 0, 0, 1, 0, 1, 0, 1, 0, 1, 0]",111,63,48,5,4,0.07936507936507936,0.08333333333333333
"[1, 1, 1, 0, 1, 1, 1, 0, 1, 0, 1, 0, 0, 0, 1]",132,59,73,5,7,0.0847457627118644,0.0958904109589041
"[1, 1, 0, 0, 0, 0, 1, 0, 1, 0, 1, 1, 0, 0, 0]",209,112,97,16,10,0.14285714285714285,0.10309278350515463
"[1, 1, 1, 0, 0, 0, 0, 1, 0, 0, 0, 0, 1, 0, 0]",265,157,108,13,4,0.08280254777070063,0.037037037037037035
"[1, 1, 1, 1, 0, 0, 0, 0, 1, 0, 0, 0, 0, 1, 0]",178,105,73,8,3,0.0761904761904762,0.0410958904109589
"[1, 0, 1, 1, 0, 1, 0, 1, 1, 0, 0, 0, 0, 1, 1]",181,80,101,11,11,0.1375,0.10891089108910891
"[0, 1, 1, 1, 1, 1, 0, 1, 1, 0, 1, 0, 0, 1, 0]",117,54,63,9,10,0.16666666666666666,0.15873015873015872
"[0, 1, 0, 0, 1, 0, 0, 0, 0, 0, 0, 1, 1, 1, 0]",317,199,118,27,6,0.135678391959799,0.05084745762711865
"[1, 1, 1, 0, 0, 0, 0, 0, 0, 0, 0, 0, 0, 1, 0]",1072,490,582,49,64,0.1,0.10996563573883161
"[1, 1, 0, 1, 0, 1, 0, 0, 0, 0, 1, 0, 0, 1, 0]",133,84,49,7,4,0.08333333333333333,0.08163265306122448
"[0, 1, 0, 0, 1, 1, 0, 0, 0, 1, 0, 1, 1, 0, 0]",166,97,69,11,8,0.1134020618556701,0.11594202898550725
"[0, 0, 1, 0, 0, 1, 1, 0, 0, 0, 1, 0, 1, 1, 0]",151,91,60,8,5,0.08791208791208792,0.08333333333333333
"[0, 0, 0, 1, 0, 1, 0, 0, 0, 1, 1, 0, 1, 0, 1]",149,94,55,11,8,0.11702127659574468,0.14545454545454545
"[0, 0, 0, 0, 1, 0, 1, 0, 1, 1, 1, 0, 0, 0, 0]",327,215,112,22,12,0.10232558139534884,0.10714285714285714
"[0, 0, 0, 1, 1, 1, 0, 1, 0, 0, 0, 0, 1, 0, 1]",123,86,37,8,2,0.09302325581395349,0.05405405405405406
"[1, 0, 0, 1, 1, 0, 1, 1, 1, 1, 1, 1, 1, 0, 1]",495,134,361,11,47,0.08208955223880597,0.13019390581717452
"[1, 0, 0, 1, 0, 0, 0, 1, 1, 1, 1, 1, 1, 0, 1]",169,58,111,5,10,0.08620689655172414,0.09009009009009009
"[0, 1, 0, 0, 1, 0, 0, 0, 1, 1, 1, 1, 1, 1, 0]",162,87,75,8,6,0.09195402298850575,0.08
"[1, 0, 1, 1, 0, 1, 1, 0, 0, 1, 0, 0, 0, 0, 1]",117,52,65,3,12,0.057692307692307696,0.18461538461538463
"[1, 0, 0, 0, 0, 0, 1, 0, 1, 1, 1, 0, 0, 1, 0]",152,89,63,6,5,0.06741573033707865,0.07936507936507936
"[0, 1, 0, 1, 1, 1, 0, 0, 0, 0, 0, 1, 0, 1, 1]",125,65,60,7,9,0.1076923076923077,0.15
"[0, 0, 1, 1, 1, 1, 1, 1, 0, 0, 0, 0, 0, 1, 0]",315,184,131,20,17,0.10869565217391304,0.1297709923664122
"[1, 1, 1, 1, 0, 0, 1, 0, 1, 1, 1, 1, 0, 0, 0]",248,109,139,9,14,0.08256880733944955,0.10071942446043165
"[1, 1, 0, 1, 0, 0, 0, 1, 1, 1, 1, 1, 0, 1, 0]",141,64,77,6,8,0.09375,0.1038961038961039
"[1, 0, 0, 1, 1, 0, 0, 1, 1, 1, 1, 0, 1, 0, 0]",201,63,138,5,16,0.07936507936507936,0.11594202898550725
"[0, 1, 1, 1, 0, 0, 1, 0, 0, 0, 0, 1, 1, 0, 0]",255,156,99,19,7,0.12179487179487179,0.0707070707070707
"[1, 0, 0, 1, 1, 1, 0, 0, 1, 0, 0, 0, 0, 1, 1]",189,71,118,8,15,0.11267605633802817,0.1271186440677966
"[0, 0, 1, 1, 0, 0, 0, 0, 0, 1, 0, 0, 0, 1, 1]",487,345,142,36,12,0.10434782608695652,0.08450704225352113
"[1, 1, 1, 0, 1, 1, 1, 0, 0, 1, 0, 0, 1, 1, 1]",297,96,201,7,17,0.07291666666666667,0.0845771144278607
"[1, 0, 0, 1, 0, 1, 1, 1, 0, 1, 1, 1, 1, 1, 0]",253,85,168,4,17,0.047058823529411764,0.10119047619047619
"[1, 1, 0, 0, 1, 0, 1, 1, 0, 1, 1, 0, 1, 1, 1]",279,91,188,11,16,0.12087912087912088,0.0851063829787234
"[1, 0, 0, 0, 0, 0, 1, 1, 0, 0, 0, 0, 1, 0, 1]",310,189,121,10,7,0.05291005291005291,0.05785123966942149
"[0, 0, 0, 0, 0, 0, 0, 1, 0, 0, 1, 1, 1, 1, 0]",495,341,154,28,19,0.08211143695014662,0.12337662337662338
"[1, 0, 1, 0, 0, 0, 1, 1, 0, 1, 0, 0, 0, 0, 0]",278,175,103,15,15,0.08571428571428572,0.14563106796116504
"[1, 0, 0, 0, 1, 1, 1, 1, 0, 0, 0, 0, 1, 1, 0]",425,201,224,19,28,0.0945273631840796,0.125
"[1, 1, 0, 0, 0, 1, 1, 1, 1, 0, 0, 0, 0, 1, 1]",505,244,261,19,30,0.0778688524590164,0.11494252873563218
"[1, 1, 0, 0, 0, 0, 0, 1, 1, 0, 0, 1, 1, 1, 1]",547,260,287,24,32,0.09230769230769231,0.11149825783972125
"[1, 0, 0, 1, 0, 0, 0, 0, 0, 1, 0, 0, 1, 1, 0]",285,181,104,15,11,0.08287292817679558,0.10576923076923077
"[1, 0, 1, 0, 0, 1, 0, 0, 1, 0, 1, 1, 1, 0, 1]",91,37,54,5,5,0.13513513513513514,0.09259259259259259
"[1, 1, 0, 1, 1, 0, 0, 0, 1, 1, 0, 1, 1, 1, 1]",296,112,184,10,19,0.08928571428571429,0.10326086956521739
"[1, 1, 0, 1, 1, 0, 1, 1, 0, 1, 0, 1, 1, 1, 0]",212,73,139,10,7,0.136986301369863,0.050359712230215826
"[1, 1, 0, 0, 1, 0, 1, 1, 1, 1, 1, 1, 1, 1, 1]",2474,610,1864,72,185,0.1180327868852459,0.0992489270386266
"[0, 0, 0, 1, 0, 1, 1, 0, 0, 1, 1, 1, 0, 0, 1]",132,74,58,4,2,0.05405405405405406,0.034482758620689655
"[1, 0, 0, 0, 1, 0, 1, 1, 0, 0, 1, 1, 1, 0, 0]",134,78,56,9,2,0.11538461538461539,0.03571428571428571
"[1, 1, 0, 1, 0, 1, 1, 1, 0, 1, 1, 1, 1, 0, 1]",539,158,381,11,40,0.06962025316455696,0.10498687664041995
"[0, 1, 1, 1, 0, 1, 0, 1, 1, 1, 0, 1, 1, 1, 1]",568,191,377,11,41,0.05759162303664921,0.10875331564986737
"[1, 1, 1, 1, 0, 1, 1, 1, 0, 1, 1, 1, 0, 1, 0]",500,138,362,10,35,0.07246376811594203,0.09668508287292818
"[0, 1, 0, 1, 0, 1, 0, 0, 1, 0, 0, 0, 0, 1, 1]",181,106,75,7,9,0.0660377358490566,0.12
"[0, 0, 0, 1, 0, 0, 1, 1, 0, 0, 0, 0, 1, 0, 1]",256,172,84,14,6,0.08139534883720931,0.07142857142857142
"[1, 1, 1, 1, 0, 1, 1, 0, 0, 0, 0, 0, 0, 0, 0]",438,225,213,27,24,0.12,0.11267605633802817
"[0, 1, 1, 1, 1, 0, 1, 1, 1, 1, 1, 1, 1, 0, 0]",886,279,607,23,67,0.08243727598566308,0.11037891268533773
"[0, 1, 1, 1, 1, 0, 0, 0, 1, 1, 1, 1, 1, 0, 1]",286,125,161,6,13,0.048,0.08074534161490683
"[1, 0, 1, 0, 1, 0, 1, 0, 0, 0, 1, 0, 1, 1, 0]",122,64,58,4,3,0.0625,0.05172413793103448
"[1, 0, 0, 0, 1, 1, 0, 1, 0, 1, 0, 1, 0, 0, 0]",127,80,47,10,3,0.125,0.06382978723404255
"[0, 0, 0, 0, 1, 1, 0, 1, 0, 0, 1, 1, 1, 0, 0]",169,107,62,9,4,0.08411214953271028,0.06451612903225806
"[1, 0, 1, 0, 1, 1, 0, 0, 1, 1, 1, 1, 0, 0, 1]",356,159,197,13,21,0.08176100628930817,0.1065989847715736
"[0, 0, 1, 0, 1, 1, 0, 0, 1, 0, 0, 0, 0, 0, 0]",660,459,201,32,16,0.06971677559912855,0.07960199004975124
"[1, 1, 1, 1, 1, 1, 1, 0, 0, 1, 1, 1, 0, 1, 0]",799,175,624,12,61,0.06857142857142857,0.09775641025641026
"[0, 1, 1, 1, 0, 1, 0, 1, 1, 0, 1, 1, 1, 1, 0]",267,94,173,12,20,0.1276595744680851,0.11560693641618497
"[1, 0, 0, 0, 0, 0, 0, 0, 1, 0, 1, 1, 0, 1, 1]",195,97,98,4,7,0.041237113402061855,0.07142857142857142
"[0, 1, 0, 0, 0, 0, 0, 1, 1, 0, 1, 1, 0, 0, 0]",267,185,82,20,6,0.10810810810810811,0.07317073170731707
"[0, 1, 0, 0, 1, 1, 1, 1, 0, 1, 1, 0, 1, 1, 0]",137,63,74,10,8,0.15873015873015872,0.10810810810810811
"[1, 1, 1, 1, 0, 0, 0, 0, 0, 1, 1, 0, 1, 1, 0]",157,74,83,10,9,0.13513513513513514,0.10843373493975904
"[0, 1, 1, 1, 1, 0, 0, 0, 0, 0, 1, 1, 0, 1, 1]",225,141,84,15,10,0.10638297872340426,0.11904761904761904
"[0, 1, 0, 0, 0, 1, 0, 1, 1, 0, 0, 1, 1, 1, 1]",231,115,116,9,18,0.0782608695652174,0.15517241379310345
"[0, 0, 1, 1, 1, 0, 0, 0, 1, 1, 1, 1, 0, 1, 0]",115,56,59,6,3,0.10714285714285714,0.05084745762711865
"[0, 0, 0, 0, 0, 0, 1, 1, 0, 0, 1, 0, 1, 0, 0]",774,543,231,44,20,0.08103130755064457,0.08658008658008658
"[0, 1, 0, 0, 1, 0, 0, 0, 0, 0, 1, 1, 1, 0, 0]",264,178,86,18,8,0.10112359550561797,0.09302325581395349
"[0, 1, 1, 0, 1, 0, 1, 1, 1, 1, 1, 1, 1, 1, 0]",712,225,487,23,58,0.10222222222222223,0.11909650924024641
"[0, 1, 0, 1, 1, 1, 0, 0, 0, 1, 0, 0, 1, 1, 0]",120,65,55,7,11,0.1076923076923077,0.2
"[1, 1, 0, 1, 0, 0, 0, 1, 1, 0, 0, 1, 1, 1, 1]",367,152,215,19,20,0.125,0.09302325581395349
"[1, 1, 1, 0, 1, 0, 0, 0, 1, 1, 0, 0, 1, 1, 1]",295,133,162,10,10,0.07518796992481203,0.06172839506172839
"[1, 1, 0, 1, 1, 0, 1, 0, 0, 1, 1, 0, 0, 1, 1]",242,100,142,15,15,0.15,0.1056338028169014
"[0, 1, 1, 1, 0, 1, 1, 0, 1, 0, 0, 1, 1, 0, 0]",139,63,76,5,7,0.07936507936507936,0.09210526315789473
"[0, 1, 0, 0, 0, 0, 1, 1, 1, 1, 0, 1, 1, 1, 0]",111,60,51,4,1,0.06666666666666667,0.0196078431372549
"[0, 1, 1, 0, 1, 0, 0, 1, 1, 0, 0, 0, 1, 1, 1]",151,69,82,2,9,0.028985507246376812,0.10975609756097561
"[0, 0, 0, 1, 0, 1, 1, 0, 1, 0, 0, 1, 1, 0, 0]",178,100,78,11,10,0.11,0.1282051282051282
"[0, 1, 0, 1, 1, 1, 1, 0, 0, 1, 1, 0, 0, 1, 1]",485,197,288,16,29,0.08121827411167512,0.10069444444444445
"[1, 0, 0, 1, 1, 0, 1, 0, 1, 1, 1, 1, 0, 0, 1]",202,84,118,6,14,0.07142857142857142,0.11864406779661017
"[1, 0, 1, 1, 1, 1, 1, 1, 0, 1, 1, 0, 0, 1, 1]",700,222,478,20,55,0.09009009009009009,0.11506276150627615
"[1, 1, 1, 0, 1, 1, 0, 1, 0, 0, 0, 0, 1, 0, 1]",105,46,59,5,7,0.10869565217391304,0.11864406779661017
"[1, 1, 1, 0, 1, 0, 1, 1, 1, 0, 0, 0, 0, 1, 1]",314,108,206,15,24,0.1388888888888889,0.11650485436893204
"[1, 1, 1, 0, 1, 1, 1, 0, 1, 1, 1, 0, 0, 1, 1]",732,185,547,15,49,0.08108108108108109,0.08957952468007313
"[0, 0, 1, 1, 0, 1, 0, 1, 0, 1, 0, 1, 1, 1, 1]",212,97,115,7,4,0.07216494845360824,0.034782608695652174
"[0, 0, 0, 0, 1, 1, 1, 1, 1, 0, 1, 1, 1, 1, 0]",234,92,142,9,10,0.09782608695652174,0.07042253521126761
"[1, 1, 1, 0, 0, 0, 1, 1, 0, 1, 1, 0, 1, 0, 0]",126,55,71,3,6,0.05454545454545454,0.08450704225352113
"[0, 1, 0, 1, 1, 1, 1, 1, 1, 1, 1, 0, 0, 0, 0]",563,250,313,24,31,0.096,0.09904153354632587
"[1, 0, 0, 1, 0, 1, 0, 0, 1, 0, 1, 1, 1, 1, 1]",204,84,120,5,9,0.05952380952380952,0.075
"[1, 0, 1, 1, 1, 0, 0, 0, 1, 0, 0, 1, 0, 1, 0]",92,53,39,5,3,0.09433962264150944,0.07692307692307693
"[0, 1, 1, 0, 1, 1, 1, 0, 1, 1, 1, 0, 0, 0, 1]",143,62,81,9,10,0.14516129032258066,0.12345679012345678
"[0, 0, 0, 0, 1, 1, 0, 1, 1, 1, 0, 1, 1, 1, 0]",132,59,73,4,6,0.06779661016949153,0.0821917808219178
"[1, 1, 0, 1, 0, 1, 0, 0, 0, 0, 1, 1, 0, 1, 1]",137,58,79,7,7,0.1206896551724138,0.08860759493670886
"[0, 1, 0, 0, 0, 1, 0, 1, 1, 1, 1, 1, 0, 1, 0]",95,47,48,2,6,0.0425531914893617,0.125
"[0, 1, 0, 0, 1, 0, 0, 0, 1, 0, 1, 1, 1, 1, 1]",157,85,72,5,4,0.058823529411764705,0.05555555555555555
"[1, 0, 0, 1, 0, 0, 1, 0, 0, 1, 0, 0, 0, 1, 0]",230,156,74,19,4,0.12179487179487179,0.05405405405405406
"[1, 0, 1, 0, 1, 1, 0, 0, 1, 0, 0, 0, 1, 1, 1]",141,59,82,2,11,0.03389830508474576,0.13414634146341464
"[0, 1, 1, 0, 1, 1, 1, 0, 1, 0, 1, 0, 1, 1, 0]",139,64,75,9,5,0.140625,0.06666666666666667
"[0, 0, 1, 1, 0, 1, 0, 1, 0, 1, 0, 0, 0, 0, 0]",297,189,108,17,9,0.08994708994708994,0.08333333333333333
"[0, 1, 0, 1, 0, 0, 0, 1, 0, 0, 0, 0, 0, 0, 0]",1819,1342,477,126,50,0.09388971684053651,0.10482180293501048
"[0, 0, 0, 0, 0, 0, 1, 0, 0, 1, 0, 1, 1, 0, 0]",642,476,166,31,15,0.06512605042016807,0.09036144578313253
"[0, 0, 0, 1, 1, 1, 0, 1, 1, 1, 1, 1, 1, 1, 0]",301,132,169,12,17,0.09090909090909091,0.10059171597633136
"[1, 0, 1, 1, 1, 0, 0, 0, 0, 0, 0, 1, 0, 0, 0]",270,177,93,16,7,0.0903954802259887,0.07526881720430108
"[0, 1, 1, 0, 1, 0, 0, 1, 0, 0, 0, 1, 0, 0, 1]",168,97,71,10,12,0.10309278350515463,0.16901408450704225
"[1, 1, 1, 1, 1, 0, 1, 1, 0, 0, 1, 0, 1, 1, 0]",261,87,174,8,24,0.09195402298850575,0.13793103448275862
"[1, 0, 0, 1, 1, 0, 0, 0, 1, 0, 1, 1, 0, 1, 1]",146,54,92,10,5,0.18518518518518517,0.05434782608695652
"[1, 1, 1, 1, 0, 0, 1, 0, 1, 0, 0, 1, 0, 0, 1]",135,71,64,5,5,0.07042253521126761,0.078125
"[0, 0, 0, 1, 0, 1, 0, 1, 0, 0, 1, 0, 1, 1, 1]",133,82,51,11,2,0.13414634146341464,0.0392156862745098
"[0, 0, 0, 1, 0, 0, 1, 1, 1, 0, 0, 0, 1, 0, 1]",151,89,62,11,4,0.12359550561797752,0.06451612903225806
"[0, 0, 1, 1, 1, 0, 0, 1, 1, 1, 0, 0, 1, 0, 1]",142,67,75,5,6,0.07462686567164178,0.08
"[0, 0, 1, 1, 0, 0, 1, 1, 1, 0, 0, 0, 1, 0, 0]",183,108,75,8,4,0.07407407407407407,0.05333333333333334
"[1, 0, 0, 0, 0, 1, 0, 1, 1, 0, 1, 0, 1, 0, 1]",120,61,59,4,4,0.06557377049180328,0.06779661016949153
"[0, 1, 1, 0, 1, 0, 1, 1, 1, 1, 1, 1, 0, 1, 1]",528,193,335,19,25,0.09844559585492228,0.07462686567164178
"[1, 1, 0, 0, 0, 0, 1, 0, 0, 1, 1, 0, 1, 0, 1]",138,72,66,7,6,0.09722222222222222,0.09090909090909091
"[1, 0, 0, 0, 0, 0, 1, 1, 0, 0, 0, 0, 1, 0, 0]",624,430,194,34,16,0.07906976744186046,0.08247422680412371
"[0, 1, 0, 0, 1, 0, 1, 0, 0, 1, 1, 0, 0, 0, 0]",362,233,129,16,12,0.06866952789699571,0.09302325581395349
"[0, 0, 1, 1, 1, 1, 0, 1, 1, 1, 0, 1, 1, 1, 1]",682,198,484,20,56,0.10101010101010101,0.11570247933884298
"[1, 1, 0, 0, 0, 1, 0, 1, 1, 0, 1, 0, 1, 0, 0]",116,65,51,11,12,0.16923076923076924,0.23529411764705882
"[0, 1, 1, 1, 1, 0, 1, 1, 1, 1, 0, 1, 0, 1, 1]",554,186,368,19,34,0.10215053763440861,0.09239130434782608
"[0, 0, 1, 0, 1, 0, 1, 0, 1, 0, 1, 0, 0, 1, 1]",131,67,64,7,6,0.1044776119402985,0.09375
"[0, 1, 0, 0, 1, 0, 1, 1, 1, 0, 0, 0, 0, 0, 1]",187,109,78,8,7,0.07339449541284404,0.08974358974358974
"[1, 1, 1, 0, 1, 0, 0, 1, 0, 1, 1, 1, 0, 0, 0]",137,78,59,8,3,0.10256410256410256,0.05084745762711865
"[0, 1, 0, 1, 1, 1, 0, 1, 0, 0, 1, 0, 1, 1, 1]",145,60,85,7,9,0.11666666666666667,0.10588235294117647
"[0, 1, 0, 1, 0, 0, 0, 1, 0, 1, 1, 1, 0, 1, 0]",105,55,50,4,6,0.07272727272727272,0.12
"[1, 1, 1, 1, 0, 0, 1, 0, 1, 1, 0, 0, 0, 0, 0]",198,105,93,15,11,0.14285714285714285,0.11827956989247312
"[0, 0, 1, 0, 1, 0, 0, 0, 1, 0, 0, 1, 0, 1, 1]",165,97,68,10,3,0.10309278350515463,0.04411764705882353
"[0, 0, 1, 1, 0, 1, 1, 0, 0, 0, 0, 0, 1, 1, 0]",244,138,106,11,11,0.07971014492753623,0.10377358490566038
"[0, 1, 0, 1, 0, 0, 0, 0, 1, 0, 1, 1, 1, 1, 0]",128,53,75,6,6,0.11320754716981132,0.08
"[1, 0, 1, 0, 1, 0, 0, 0, 0, 1, 0, 1, 1, 1, 1]",172,83,89,8,6,0.0963855421686747,0.06741573033707865
"[0, 1, 1, 0, 1, 0, 1, 0, 1, 0, 0, 1, 1, 1, 1]",221,87,134,10,13,0.11494252873563218,0.09701492537313433
"[0, 1, 1, 1, 0, 1, 1, 0, 1, 1, 0, 0, 1, 1, 1]",325,130,195,15,19,0.11538461538461539,0.09743589743589744
"[1, 1, 1, 0, 0, 0, 0, 1, 1, 0, 1, 0, 0, 1, 1]",223,87,136,9,13,0.10344827586206896,0.09558823529411764
"[0, 0, 0, 1, 1, 0, 0, 1, 1, 1, 1, 1, 1, 1, 0]",470,307,163,33,28,0.10749185667752444,0.17177914110429449
"[0, 1, 0, 0, 0, 0, 1, 0, 0, 0, 1, 1, 1, 1, 1]",203,110,93,6,10,0.05454545454545454,0.10752688172043011
"[1, 1, 1, 1, 0, 0, 1, 1, 0, 0, 1, 1, 0, 1, 1]",790,298,492,34,48,0.11409395973154363,0.0975609756097561
"[1, 1, 0, 0, 1, 0, 1, 1, 1, 1, 0, 0, 1, 0, 0]",116,51,65,6,5,0.11764705882352941,0.07692307692307693
"[1, 1, 0, 1, 1, 1, 1, 0, 1, 0, 1, 1, 0, 1, 1]",500,152,348,12,37,0.07894736842105263,0.10632183908045977
"[1, 1, 0, 0, 0, 1, 0, 0, 0, 1, 1, 0, 1, 0, 0]",143,73,70,7,6,0.0958904109589041,0.08571428571428572
"[0, 1, 1, 0, 0, 0, 0, 1, 1, 1, 0, 0, 0, 0, 0]",448,319,129,28,19,0.0877742946708464,0.14728682170542637
"[1, 1, 0, 0, 1, 1, 1, 1, 0, 1, 1, 0, 0, 0, 1]",203,92,111,8,15,0.08695652173913043,0.13513513513513514
"[1, 0, 0, 0, 0, 1, 1, 0, 1, 0, 1, 0, 1, 1, 1]",185,59,126,10,6,0.1694915254237288,0.047619047619047616
"[0, 1, 0, 0, 0, 0, 1, 0, 1, 0, 0, 0, 0, 0, 0]",1783,1338,445,128,52,0.09566517189835576,0.11685393258426967
"[0, 1, 0, 1, 1, 1, 0, 1, 0, 0, 1, 1, 0, 1, 0]",107,53,54,5,3,0.09433962264150944,0.05555555555555555
"[0, 1, 0, 1, 1, 0, 1, 0, 1, 1, 0, 1, 0, 1, 1]",156,68,88,7,9,0.10294117647058823,0.10227272727272728
"[1, 0, 1, 0, 0, 1, 1, 0, 1, 0, 1, 1, 0, 1, 0]",105,57,48,1,6,0.017543859649122806,0.125
"[0, 1, 1, 1, 0, 0, 0, 0, 0, 1, 0, 1, 0, 0, 1]",182,113,69,8,4,0.07079646017699115,0.057971014492753624
"[0, 1, 0, 1, 1, 1, 0, 0, 0, 0, 1, 1, 1, 0, 1]",150,70,80,10,12,0.14285714285714285,0.15
"[1, 0, 0, 1, 1, 0, 0, 1, 1, 1, 0, 0, 1, 0, 1]",153,48,105,3,8,0.0625,0.0761904761904762
"[1, 1, 0, 1, 0, 1, 1, 1, 1, 1, 0, 1, 0, 1, 1]",530,155,375,16,35,0.1032258064516129,0.09333333333333334
"[0, 0, 0, 0, 1, 0, 1, 0, 0, 1, 1, 0, 1, 0, 0]",230,158,72,15,5,0.0949367088607595,0.06944444444444445
"[1, 1, 0, 0, 1, 0, 0, 0, 1, 1, 0, 0, 0, 0, 1]",267,146,121,12,12,0.0821917808219178,0.09917355371900827
"[0, 1, 0, 1, 1, 0, 0, 0, 0, 1, 0, 1, 0, 1, 0]",137,87,50,12,3,0.13793103448275862,0.06
"[0, 0, 0, 1, 0, 1, 0, 0, 0, 0, 0, 1, 1, 1, 0]",249,157,92,14,11,0.08917197452229299,0.11956521739130435
"[1, 0, 0, 0, 1, 0, 0, 0, 0, 0, 1, 0, 1, 0, 0]",515,362,153,39,11,0.10773480662983426,0.0718954248366013
"[0, 0, 1, 1, 1, 0, 0, 0, 0, 1, 1, 1, 0, 0, 1]",150,82,68,10,3,0.12195121951219512,0.04411764705882353
"[1, 0, 1, 0, 1, 1, 1, 1, 0, 0, 1, 1, 1, 1, 0]",446,162,284,17,30,0.10493827160493827,0.1056338028169014
"[1, 1, 1, 1, 1, 1, 0, 0, 0, 1, 1, 0, 0, 0, 0]",344,149,195,19,17,0.12751677852348994,0.08717948717948718
"[0, 0, 0, 0, 0, 0, 1, 0, 1, 0, 0, 1, 0, 0, 1]",593,433,160,28,15,0.06466512702078522,0.09375
"[1, 1, 1, 0, 1, 1, 1, 0, 0, 1, 1, 1, 0, 0, 0]",186,82,104,10,9,0.12195121951219512,0.08653846153846154
"[1, 0, 1, 0, 0, 1, 1, 1, 1, 1, 1, 1, 1, 0, 0]",746,257,489,22,40,0.08560311284046693,0.081799591002045
"[1, 1, 1, 0, 0, 0, 0, 0, 0, 1, 0, 1, 1, 1, 1]",330,110,220,7,24,0.06363636363636363,0.10909090909090909
"[0, 0, 1, 1, 1, 1, 0, 0, 0, 0, 0, 0, 1, 0, 1]",389,238,151,29,17,0.12184873949579832,0.11258278145695365
"[0, 1, 1, 0, 0, 0, 1, 1, 1, 1, 0, 1, 1, 1, 0]",150,66,84,5,14,0.07575757575757576,0.16666666666666666
"[1, 1, 1, 0, 1, 1, 0, 0, 1, 0, 0, 1, 1, 1, 0]",163,69,94,3,11,0.043478260869565216,0.11702127659574468
"[1, 0, 1, 1, 1, 0, 0, 1, 0, 1, 1, 1, 1, 1, 0]",245,95,150,9,17,0.09473684210526316,0.11333333333333333
"[0, 0, 1, 0, 1, 1, 1, 0, 0, 1, 0, 1, 1, 1, 1]",178,71,107,3,11,0.04225352112676056,0.102803738317757
"[0, 0, 0, 0, 0, 1, 1, 0, 0, 1, 1, 1, 0, 1, 1]",327,230,97,24,7,0.10434782608695652,0.07216494845360824
"[0, 0, 1, 0, 0, 0, 1, 0, 1, 0, 1, 0, 0, 1, 1]",168,107,61,10,5,0.09345794392523364,0.08196721311475409
"[1, 1, 0, 1, 1, 0, 1, 0, 0, 1, 1, 1, 0, 0, 1]",150,62,88,4,5,0.06451612903225806,0.056818181818181816
"[1, 1, 0, 0, 0, 1, 1, 0, 1, 1, 1, 1, 0, 1, 1]",305,128,177,5,21,0.0390625,0.11864406779661017
"[1, 0, 1, 1, 0, 0, 0, 1, 1, 0, 1, 1, 1, 1, 0]",181,70,111,4,8,0.05714285714285714,0.07207207207207207
"[0, 1, 0, 0, 1, 0, 0, 1, 0, 1, 0, 0, 0, 0, 1]",259,156,103,15,9,0.09615384615384616,0.08737864077669903
"[1, 0, 0, 1, 0, 1, 1, 1, 1, 0, 0, 1, 0, 1, 1]",155,66,89,6,4,0.09090909090909091,0.0449438202247191
"[0, 0, 1, 0, 0, 1, 1, 1, 1, 1, 0, 1, 1, 1, 1]",318,118,200,11,21,0.09322033898305085,0.105
"[0, 1, 0, 0, 0, 1, 0, 0, 0, 0, 1, 0, 0, 1, 0]",428,315,113,32,9,0.10158730158730159,0.07964601769911504
"[0, 0, 0, 0, 0, 1, 0, 0, 0, 1, 0, 0, 0, 0, 1]",1761,1399,362,151,27,0.10793423874195854,0.07458563535911603
"[0, 1, 1, 0, 0, 0, 1, 0, 1, 0, 0, 1, 1, 0, 0]",198,133,65,13,8,0.09774436090225563,0.12307692307692308
"[1, 0, 1, 0, 0, 0, 1, 1, 0, 1, 0, 0, 0, 0, 1]",173,100,73,10,11,0.1,0.1506849315068493
"[1, 0, 1, 1, 0, 0, 1, 1, 0, 0, 0, 1, 1, 1, 1]",272,129,143,15,11,0.11627906976744186,0.07692307692307693
"[0, 1, 1, 1, 0, 1, 1, 0, 0, 1, 1, 0, 0, 0, 1]",142,76,66,6,2,0.07894736842105263,0.030303030303030304
"[0, 1, 0, 0, 0, 0, 1, 1, 1, 0, 0, 0, 1, 1, 0]",150,92,58,7,3,0.07608695652173914,0.05172413793103448
"[1, 0, 1, 0, 1, 0, 1, 1, 0, 1, 1, 0, 1, 1, 1]",240,89,151,8,19,0.0898876404494382,0.12582781456953643
"[1, 1, 0, 1, 0, 1, 0, 1, 0, 1, 1, 0, 1, 1, 0]",131,60,71,5,7,0.08333333333333333,0.09859154929577464
"[1, 1, 1, 1, 1, 1, 1, 1, 0, 1, 0, 1, 0, 1, 0]",548,149,399,11,48,0.0738255033557047,0.12030075187969924
"[0, 0, 1, 0, 1, 1, 0, 1, 0, 0, 1, 1, 1, 1, 0]",148,72,76,3,6,0.041666666666666664,0.07894736842105263
"[1, 0, 1, 0, 1, 0, 1, 0, 0, 1, 0, 0, 1, 0, 1]",107,56,51,4,10,0.07142857142857142,0.19607843137254902
"[0, 1, 1, 1, 0, 1, 1, 0, 0, 1, 1, 0, 0, 0, 0]",300,168,132,12,13,0.07142857142857142,0.09848484848484848
"[1, 1, 0, 0, 0, 1, 1, 0, 1, 1, 1, 0, 1, 1, 0]",133,52,81,5,4,0.09615384615384616,0.04938271604938271
"[0, 0, 1, 1, 0, 0, 1, 1, 0, 1, 1, 0, 0, 1, 1]",262,143,119,12,12,0.08391608391608392,0.10084033613445378
"[1, 0, 1, 0, 1, 1, 1, 1, 0, 1, 1, 0, 0, 1, 1]",305,99,206,14,22,0.1414141414141414,0.10679611650485436
"[1, 1, 0, 1, 0, 1, 1, 1, 1, 0, 1, 1, 0, 0, 1]",291,106,185,12,15,0.11320754716981132,0.08108108108108109
"[0, 0, 1, 1, 0, 1, 0, 1, 1, 1, 1, 0, 1, 1, 0]",159,59,100,9,15,0.15254237288135594,0.15
"[1, 1, 0, 0, 0, 1, 0, 0, 1, 1, 0, 1, 1, 1, 1]",192,80,112,9,11,0.1125,0.09821428571428571
"[0, 0, 0, 1, 1, 0, 0, 0, 1, 0, 0, 1, 1, 0, 1]",175,114,61,14,6,0.12280701754385964,0.09836065573770492
"[1, 0, 1, 0, 0, 1, 1, 1, 0, 1, 1, 1, 1, 1, 0]",243,96,147,9,15,0.09375,0.10204081632653061
"[0, 1, 0, 1, 1, 1, 0, 1, 1, 0, 1, 0, 0, 1, 1]",155,69,86,5,10,0.07246376811594203,0.11627906976744186
"[0, 0, 0, 1, 1, 0, 1, 0, 1, 1, 1, 1, 1, 0, 0]",170,90,80,8,8,0.08888888888888889,0.1
"[1, 1, 1, 0, 0, 0, 0, 1, 1, 0, 0, 1, 0, 1, 1]",288,93,195,12,18,0.12903225806451613,0.09230769230769231
"[1, 0, 0, 1, 0, 0, 0, 1, 1, 1, 0, 0, 0, 0, 1]",184,111,73,6,8,0.05405405405405406,0.1095890410958904
"[1, 1, 0, 0, 1, 1, 0, 0, 1, 1, 0, 1, 1, 0, 1]",250,104,146,20,10,0.19230769230769232,0.0684931506849315
"[1, 1, 1, 0, 0, 1, 1, 0, 0, 1, 1, 0, 1, 1, 0]",265,67,198,6,18,0.08955223880597014,0.09090909090909091
"[0, 1, 1, 0, 1, 0, 1, 1, 0, 1, 1, 1, 1, 0, 1]",215,68,147,5,11,0.07352941176470588,0.07482993197278912
"[0, 0, 1, 0, 0, 1, 1, 0, 0, 0, 1, 0, 0, 0, 0]",607,428,179,47,19,0.10981308411214953,0.10614525139664804
"[0, 1, 0, 1, 0, 0, 0, 1, 1, 0, 0, 0, 0, 0, 0]",915,654,261,69,18,0.10550458715596331,0.06896551724137931
"[1, 0, 1, 0, 0, 0, 0, 0, 1, 1, 0, 1, 0, 1, 1]",133,62,71,2,6,0.03225806451612903,0.08450704225352113
"[1, 0, 0, 0, 0, 1, 0, 0, 1, 0, 0, 1, 1, 0, 0]",332,188,144,26,13,0.13829787234042554,0.09027777777777778
"[1, 0, 0, 0, 1, 1, 0, 1, 0, 0, 1, 1, 1, 0, 1]",101,40,61,1,4,0.025,0.06557377049180328
"[1, 1, 1, 0, 0, 1, 0, 0, 0, 0, 0, 1, 0, 1, 0]",152,90,62,11,9,0.12222222222222222,0.14516129032258066
"[1, 1, 0, 0, 0, 0, 1, 0, 0, 1, 0, 0, 1, 1, 1]",222,131,91,18,8,0.13740458015267176,0.08791208791208792
"[0, 0, 1, 1, 0, 0, 0, 0, 1, 0, 0, 1, 0, 0, 1]",365,222,143,24,13,0.10810810810810811,0.09090909090909091
"[1, 1, 0, 1, 1, 1, 1, 1, 0, 1, 0, 0, 1, 1, 1]",673,177,496,15,53,0.0847457627118644,0.10685483870967742
"[0, 1, 1, 1, 1, 0, 1, 0, 0, 0, 1, 1, 1, 1, 0]",190,85,105,8,15,0.09411764705882353,0.14285714285714285
"[1, 0, 1, 1, 1, 0, 0, 0, 1, 1, 1, 1, 0, 1, 0]",151,59,92,7,7,0.11864406779661017,0.07608695652173914
"[1, 1, 0, 0, 1, 0, 1, 0, 1, 1, 0, 0, 0, 1, 1]",152,63,89,4,6,0.06349206349206349,0.06741573033707865
"[1, 1, 0, 1, 0, 0, 1, 1, 1, 0, 1, 0, 1, 0, 0]",115,49,66,2,4,0.04081632653061224,0.06060606060606061
"[0, 1, 1, 0, 1, 0, 0, 1, 1, 1, 0, 1, 0, 1, 0]",103,47,56,3,4,0.06382978723404255,0.07142857142857142
"[0, 1, 0, 0, 1, 0, 1, 1, 1, 1, 0, 0, 0, 1, 1]",119,57,62,3,3,0.05263157894736842,0.04838709677419355
"[1, 1, 0, 0, 0, 0, 1, 1, 0, 1, 1, 1, 1, 1, 1]",622,214,408,20,38,0.09345794392523364,0.09313725490196079
"[0, 1, 1, 0, 0, 0, 0, 1, 1, 0, 1, 1, 1, 1, 1]",365,243,122,26,7,0.10699588477366255,0.05737704918032787
"[1, 0, 0, 1, 0, 0, 1, 1, 1, 0, 1, 0, 0, 0, 0]",163,103,60,5,7,0.04854368932038835,0.11666666666666667
"[1, 1, 1, 0, 0, 1, 1, 1, 0, 0, 1, 1, 0, 0, 1]",312,100,212,12,23,0.12,0.10849056603773585
"[1, 1, 1, 1, 1, 0, 0, 1, 0, 0, 1, 1, 1, 0, 0]",186,63,123,7,16,0.1111111111111111,0.13008130081300814
"[0, 1, 1, 1, 1, 1, 1, 1, 1, 1, 0, 0, 1, 0, 0]",369,139,230,13,22,0.09352517985611511,0.09565217391304348
"[1, 1, 1, 0, 1, 0, 1, 1, 0, 1, 0, 0, 1, 0, 1]",112,43,69,3,4,0.06976744186046512,0.057971014492753624
"[0, 0, 0, 1, 0, 1, 1, 0, 0, 0, 0, 0, 1, 1, 0]",337,208,129,15,20,0.07211538461538461,0.15503875968992248
"[1, 0, 1, 1, 0, 1, 1, 1, 0, 0, 1, 0, 1, 0, 1]",138,61,77,2,6,0.03278688524590164,0.07792207792207792
"[0, 1, 0, 1, 1, 0, 1, 1, 1, 0, 0, 1, 0, 1, 0]",111,49,62,3,4,0.061224489795918366,0.06451612903225806
"[0, 0, 1, 0, 1, 0, 1, 0, 1, 0, 1, 1, 0, 1, 1]",106,48,58,4,8,0.08333333333333333,0.13793103448275862
"[1, 1, 1, 1, 0, 0, 0, 0, 0, 0, 0, 0, 1, 0, 1]",483,270,213,26,18,0.0962962962962963,0.08450704225352113
"[1, 1, 1, 0, 0, 1, 1, 0, 1, 1, 0, 1, 1, 1, 1]",831,206,625,25,59,0.12135922330097088,0.0944
"[1, 0, 0, 0, 1, 1, 1, 0, 0, 1, 1, 1, 1, 1, 0]",175,66,109,4,18,0.06060606060606061,0.1651376146788991
"[1, 0, 1, 1, 0, 0, 1, 0, 0, 0, 1, 1, 1, 0, 0]",125,57,68,9,7,0.15789473684210525,0.10294117647058823
"[1, 1, 1, 1, 0, 1, 0, 1, 1, 0, 0, 1, 0, 0, 0]",131,60,71,1,9,0.016666666666666666,0.1267605633802817
"[1, 0, 1, 1, 1, 1, 1, 0, 1, 1, 0, 0, 1, 1, 1]",749,215,534,24,48,0.11162790697674418,0.0898876404494382
"[1, 1, 0, 0, 1, 0, 1, 1, 1, 1, 1, 0, 1, 1, 1]",628,200,428,21,40,0.105,0.09345794392523364
"[1, 0, 1, 1, 0, 1, 1, 0, 0, 1, 0, 0, 1, 1, 1]",179,76,103,6,10,0.07894736842105263,0.0970873786407767
"[0, 1, 1, 0, 0, 1, 1, 1, 1, 0, 1, 0, 1, 1, 1]",451,272,179,23,13,0.08455882352941177,0.07262569832402235
"[0, 0, 1, 1, 0, 1, 1, 1, 1, 1, 1, 1, 1, 0, 1]",569,171,398,25,36,0.14619883040935672,0.09045226130653267
"[0, 1, 0, 1, 1, 0, 0, 1, 0, 0, 1, 1, 0, 1, 1]",121,56,65,8,5,0.14285714285714285,0.07692307692307693
"[0, 1, 0, 0, 0, 0, 0, 0, 0, 1, 0, 1, 0, 1, 0]",506,346,160,40,13,0.11560693641618497,0.08125
"[1, 1, 0, 0, 1, 1, 1, 1, 1, 1, 0, 0, 1, 0, 1]",512,188,324,21,31,0.11170212765957446,0.09567901234567901
"[1, 0, 0, 0, 0, 0, 1, 0, 0, 0, 0, 0, 0, 1, 0]",1503,1135,368,100,43,0.0881057268722467,0.11684782608695653
"[0, 1, 1, 1, 0, 0, 0, 1, 0, 0, 0, 1, 0, 1, 0]",145,91,54,7,5,0.07692307692307693,0.09259259259259259
"[0, 1, 0, 0, 1, 0, 0, 0, 1, 1, 1, 0, 0, 1, 1]",154,85,69,6,8,0.07058823529411765,0.11594202898550725
"[0, 0, 0, 1, 0, 0, 1, 0, 0, 0, 1, 1, 1, 0, 0]",309,211,98,20,14,0.0947867298578199,0.14285714285714285
"[1, 0, 0, 0, 1, 1, 0, 1, 1, 0, 1, 1, 0, 0, 0]",147,68,79,6,8,0.08823529411764706,0.10126582278481013
"[0, 0, 1, 0, 0, 0, 1, 0, 0, 0, 0, 0, 0, 1, 1]",926,672,254,79,32,0.11755952380952381,0.12598425196850394
"[0, 0, 0, 0, 0, 0, 1, 0, 1, 0, 1, 0, 0, 1, 0]",508,376,132,33,15,0.08776595744680851,0.11363636363636363
"[0, 1, 1, 0, 1, 1, 1, 0, 1, 1, 1, 0, 0, 1, 1]",318,130,188,21,16,0.16153846153846155,0.0851063829787234
"[0, 1, 1, 1, 1, 1, 0, 1, 1, 0, 1, 1, 0, 0, 0]",176,72,104,8,11,0.1111111111111111,0.10576923076923077
"[1, 0, 0, 1, 0, 0, 0, 0, 1, 1, 0, 1, 1, 1, 1]",165,69,96,7,12,0.10144927536231885,0.125
"[0, 0, 1, 0, 1, 0, 0, 1, 0, 0, 0, 0, 1, 1, 0]",306,198,108,20,15,0.10101010101010101,0.1388888888888889
"[0, 1, 0, 0, 0, 0, 0, 0, 1, 0, 1, 0, 0, 1, 0]",467,324,143,31,17,0.09567901234567901,0.11888111888111888
"[1, 0, 1, 0, 0, 1, 0, 0, 0, 0, 1, 0, 0, 1, 0]",205,122,83,6,5,0.04918032786885246,0.060240963855421686
"[1, 0, 1, 1, 1, 0, 1, 0, 0, 1, 0, 0, 0, 0, 1]",106,55,51,3,4,0.05454545454545454,0.0784313725490196
"[1, 1, 0, 1, 0, 0, 1, 1, 1, 0, 0, 0, 1, 0, 1]",104,47,57,6,7,0.1276595744680851,0.12280701754385964
"[1, 1, 0, 1, 1, 0, 1, 0, 0, 1, 1, 0, 0, 0, 1]",125,60,65,7,4,0.11666666666666667,0.06153846153846154
"[1, 1, 1, 1, 1, 0, 0, 0, 0, 1, 1, 1, 0, 1, 0]",271,72,199,5,16,0.06944444444444445,0.08040201005025126
"[0, 0, 0, 0, 1, 0, 1, 0, 1, 1, 0, 1, 0, 1, 0]",136,80,56,8,9,0.1,0.16071428571428573
"[1, 0, 1, 0, 0, 1, 1, 0, 1, 1, 0, 0, 1, 1, 1]",199,92,107,8,10,0.08695652173913043,0.09345794392523364
"[1, 0, 0, 1, 0, 1, 0, 1, 0, 0, 1, 0, 0, 0, 1]",135,84,51,7,2,0.08333333333333333,0.0392156862745098
"[0, 0, 1, 0, 0, 1, 0, 1, 0, 1, 0, 0, 1, 0, 0]",227,154,73,19,6,0.12337662337662338,0.0821917808219178
"[1, 1, 1, 0, 0, 1, 1, 0, 1, 0, 0, 0, 1, 1, 1]",229,74,155,6,12,0.08108108108108109,0.07741935483870968
"[0, 1, 1, 1, 1, 0, 0, 1, 1, 0, 1, 0, 0, 0, 1]",168,96,72,8,8,0.08333333333333333,0.1111111111111111
"[1, 1, 1, 0, 0, 1, 1, 0, 1, 0, 0, 1, 1, 0, 1]",158,66,92,3,7,0.045454545454545456,0.07608695652173914
"[1, 0, 0, 0, 0, 1, 0, 0, 1, 1, 0, 1, 0, 0, 0]",253,159,94,14,5,0.0880503144654088,0.05319148936170213
"[1, 1, 1, 0, 0, 0, 0, 1, 0, 0, 1, 1, 0, 1, 0]",140,64,76,8,9,0.125,0.11842105263157894
"[1, 0, 0, 1, 1, 0, 1, 0, 0, 1, 1, 1, 0, 0, 0]",133,71,62,1,7,0.014084507042253521,0.11290322580645161
"[1, 0, 1, 0, 0, 1, 1, 0, 0, 1, 1, 0, 1, 0, 0]",139,61,78,6,6,0.09836065573770492,0.07692307692307693
"[0, 0, 0, 0, 1, 0, 0, 0, 1, 1, 1, 1, 1, 0, 0]",227,134,93,16,14,0.11940298507462686,0.15053763440860216
"[1, 1, 1, 1, 0, 0, 1, 0, 0, 1, 0, 0, 1, 0, 0]",134,66,68,2,8,0.030303030303030304,0.11764705882352941
"[0, 0, 0, 0, 1, 0, 0, 1, 0, 1, 0, 1, 1, 1, 0]",129,82,47,5,5,0.06097560975609756,0.10638297872340426
"[1, 0, 1, 0, 0, 0, 0, 1, 1, 1, 0, 1, 0, 0, 1]",129,81,48,6,2,0.07407407407407407,0.041666666666666664
"[1, 1, 0, 0, 1, 0, 0, 0, 1, 0, 0, 1, 0, 0, 0]",224,145,79,11,7,0.07586206896551724,0.08860759493670886
"[0, 0, 1, 1, 0, 0, 1, 0, 0, 0, 1, 0, 0, 1, 0]",238,151,87,8,8,0.052980132450331126,0.09195402298850575
"[0, 0, 0, 1, 1, 0, 0, 1, 0, 0, 0, 1, 0, 0, 1]",273,181,92,13,9,0.0718232044198895,0.09782608695652174
"[0, 0, 1, 1, 1, 0, 0, 0, 0, 0, 1, 0, 0, 0, 0]",642,482,160,49,14,0.1016597510373444,0.0875
"[1, 1, 0, 0, 1, 0, 0, 0, 0, 1, 1, 0, 0, 1, 0]",167,105,62,13,4,0.12380952380952381,0.06451612903225806
"[1, 0, 1, 0, 1, 1, 0, 1, 1, 0, 0, 0, 1, 1, 1]",181,67,114,6,6,0.08955223880597014,0.05263157894736842
"[1, 1, 1, 1, 0, 1, 0, 1, 1, 0, 1, 1, 0, 0, 0]",178,69,109,7,12,0.10144927536231885,0.11009174311926606
"[0, 1, 0, 1, 0, 0, 0, 1, 1, 1, 1, 1, 1, 1, 1]",499,191,308,19,18,0.09947643979057591,0.05844155844155844
"[1, 1, 1, 1, 1, 1, 0, 0, 0, 0, 1, 1, 1, 0, 1]",682,226,456,26,39,0.11504424778761062,0.08552631578947369
"[0, 0, 0, 0, 1, 1, 0, 0, 1, 1, 1, 1, 0, 1, 0]",352,187,165,25,20,0.13368983957219252,0.12121212121212122
"[0, 1, 1, 1, 1, 1, 1, 1, 1, 1, 1, 1, 0, 0, 0]",1489,590,899,46,89,0.07796610169491526,0.09899888765294772
"[1, 1, 1, 0, 1, 1, 1, 1, 0, 1, 0, 0, 0, 1, 1]",270,93,177,10,17,0.10752688172043011,0.096045197740113
"[1, 1, 1, 1, 1, 0, 1, 1, 1, 1, 0, 1, 0, 0, 0]",268,77,191,10,28,0.12987012987012986,0.14659685863874344
"[1, 1, 1, 0, 0, 1, 0, 1, 0, 0, 1, 1, 1, 1, 1]",403,128,275,11,21,0.0859375,0.07636363636363637
"[1, 1, 1, 1, 1, 0, 0, 1, 0, 1, 0, 0, 1, 1, 1]",406,121,285,10,22,0.08264462809917356,0.07719298245614035
"[0, 1, 1, 0, 1, 1, 0, 0, 0, 0, 1, 1, 1, 1, 1]",423,203,220,28,20,0.13793103448275862,0.09090909090909091
"[0, 1, 0, 0, 0, 1, 1, 1, 1, 1, 0, 1, 1, 1, 0]",141,69,72,8,5,0.11594202898550725,0.06944444444444445
"[1, 1, 1, 0, 0, 0, 0, 1, 0, 1, 1, 1, 1, 0, 0]",178,67,111,5,10,0.07462686567164178,0.09009009009009009
"[0, 1, 1, 1, 0, 0, 0, 0, 1, 0, 1, 1, 1, 1, 0]",118,50,68,4,4,0.08,0.058823529411764705
"[0, 0, 1, 1, 1, 0, 0, 0, 0, 1, 0, 1, 1, 1, 1]",147,67,80,8,5,0.11940298507462686,0.0625
"[1, 0, 1, 1, 0, 1, 1, 0, 1, 0, 0, 0, 1, 1, 1]",171,75,96,5,15,0.06666666666666667,0.15625
"[0, 0, 1, 0, 1, 1, 0, 1, 1, 0, 1, 0, 0, 0, 1]",115,66,49,3,5,0.045454545454545456,0.10204081632653061
"[1, 0, 0, 1, 0, 0, 1, 0, 1, 0, 0, 1, 0, 1, 1]",106,44,62,7,7,0.1590909090909091,0.11290322580645161
"[1, 1, 1, 0, 0, 1, 0, 0, 1, 0, 1, 0, 0, 1, 0]",92,51,41,6,5,0.11764705882352941,0.12195121951219512
"[1, 1, 0, 1, 0, 1, 1, 1, 1, 0, 1, 0, 0, 1, 1]",306,113,193,12,22,0.10619469026548672,0.11398963730569948
"[0, 1, 0, 0, 0, 0, 0, 1, 1, 0, 0, 0, 0, 1, 1]",827,544,283,51,28,0.09375,0.0989399293286219
"[0, 0, 0, 0, 1, 1, 0, 0, 0, 0, 1, 0, 1, 1, 0]",344,237,107,23,10,0.0970464135021097,0.09345794392523364
"[0, 0, 0, 1, 1, 0, 0, 1, 0, 1, 1, 1, 0, 0, 1]",141,86,55,7,6,0.08139534883720931,0.10909090909090909
"[1, 1, 0, 0, 1, 0, 0, 0, 1, 1, 0, 0, 1, 0, 1]",105,45,60,5,7,0.1111111111111111,0.11666666666666667
"[1, 1, 1, 1, 1, 1, 0, 0, 0, 1, 0, 0, 0, 0, 0]",232,124,108,8,8,0.06451612903225806,0.07407407407407407
"[1, 0, 0, 0, 1, 0, 0, 1, 0, 0, 1, 1, 0, 1, 1]",135,63,72,5,6,0.07936507936507936,0.08333333333333333
"[0, 1, 0, 0, 1, 1, 1, 0, 0, 0, 1, 0, 0, 1, 0]",157,90,67,10,4,0.1111111111111111,0.05970149253731343
"[1, 1, 0, 0, 1, 1, 1, 1, 1, 1, 0, 0, 0, 1, 1]",743,277,466,31,40,0.11191335740072202,0.08583690987124463
"[1, 1, 1, 0, 0, 0, 0, 1, 1, 1, 1, 0, 0, 1, 1]",2128,368,1760,30,183,0.08152173913043478,0.10397727272727272
"[1, 0, 0, 1, 1, 0, 1, 0, 1, 1, 0, 0, 1, 0, 0]",102,53,49,9,5,0.16981132075471697,0.10204081632653061
"[1, 0, 0, 1, 1, 0, 0, 0, 0, 1, 1, 1, 1, 0, 1]",408,97,311,7,25,0.07216494845360824,0.08038585209003216
"[0, 1, 1, 1, 1, 1, 0, 0, 1, 1, 0, 0, 0, 0, 1]",468,223,245,20,22,0.08968609865470852,0.08979591836734693
"[1, 1, 0, 1, 0, 0, 1, 0, 1, 0, 1, 0, 1, 1, 1]",153,56,97,3,11,0.05357142857142857,0.1134020618556701
"[0, 1, 1, 1, 1, 0, 0, 0, 0, 1, 1, 1, 0, 1, 0]",212,130,82,12,11,0.09230769230769231,0.13414634146341464
"[0, 1, 0, 1, 1, 1, 1, 1, 0, 0, 1, 0, 1, 0, 1]",135,45,90,3,10,0.06666666666666667,0.1111111111111111
"[1, 1, 1, 1, 0, 1, 1, 0, 1, 0, 1, 0, 1, 1, 0]",233,73,160,8,14,0.1095890410958904,0.0875
"[0, 0, 1, 1, 1, 1, 1, 1, 0, 0, 0, 0, 0, 1, 1]",546,316,230,27,24,0.08544303797468354,0.10434782608695652
"[1, 0, 0, 1, 0, 0, 1, 0, 1, 0, 1, 1, 1, 0, 0]",136,70,66,4,8,0.05714285714285714,0.12121212121212122
"[1, 0, 0, 1, 0, 0, 0, 1, 0, 0, 0, 0, 1, 0, 1]",229,124,105,16,9,0.12903225806451613,0.08571428571428572
"[0, 0, 0, 0, 0, 1, 1, 0, 1, 0, 0, 1, 0, 0, 0]",650,481,169,48,7,0.0997920997920998,0.04142011834319527
"[0, 0, 1, 0, 1, 0, 1, 0, 0, 0, 1, 1, 0, 0, 1]",165,96,69,6,5,0.0625,0.07246376811594203
"[1, 0, 0, 1, 0, 0, 0, 0, 1, 0, 1, 0, 0, 0, 1]",227,149,78,14,6,0.09395973154362416,0.07692307692307693
"[1, 0, 0, 0, 1, 1, 0, 1, 0, 0, 0, 0, 1, 1, 1]",169,88,81,6,8,0.06818181818181818,0.09876543209876543
"[0, 1, 1, 0, 0, 0, 1, 1, 0, 1, 0, 0, 0, 0, 1]",146,98,48,11,3,0.11224489795918367,0.0625
"[0, 0, 1, 1, 0, 0, 0, 1, 1, 0, 1, 0, 0, 0, 0]",299,200,99,19,10,0.095,0.10101010101010101
"[1, 1, 1, 0, 0, 1, 1, 0, 0, 0, 1, 1, 0, 1, 0]",155,52,103,3,6,0.057692307692307696,0.05825242718446602
"[0, 1, 0, 0, 1, 0, 1, 1, 1, 0, 0, 1, 1, 0, 0]",193,93,100,10,12,0.10752688172043011,0.12
"[0, 1, 0, 0, 0, 0, 0, 0, 1, 1, 0, 0, 1, 1, 0]",877,569,308,60,37,0.1054481546572935,0.12012987012987013
"[1, 0, 0, 0, 1, 1, 0, 1, 0, 1, 0, 0, 1, 1, 0]",142,62,80,7,5,0.11290322580645161,0.0625
"[0, 0, 0, 1, 0, 0, 0, 1, 1, 0, 1, 0, 1, 0, 0]",247,164,83,13,7,0.07926829268292683,0.08433734939759036
"[0, 1, 0, 0, 1, 1, 0, 1, 1, 0, 0, 0, 0, 0, 1]",172,102,70,6,6,0.058823529411764705,0.08571428571428572
"[0, 0, 1, 0, 0, 1, 1, 0, 1, 1, 0, 0, 0, 0, 0]",330,205,125,27,18,0.13170731707317074,0.144
"[1, 0, 1, 1, 0, 0, 0, 1, 0, 0, 1, 0, 0, 1, 0]",130,63,67,7,5,0.1111111111111111,0.07462686567164178
"[1, 0, 1, 1, 1, 0, 0, 1, 1, 1, 0, 1, 1, 0, 0]",160,73,87,5,8,0.0684931506849315,0.09195402298850575
"[1, 1, 1, 1, 0, 0, 0, 1, 0, 1, 0, 0, 0, 1, 0]",119,58,61,5,3,0.08620689655172414,0.04918032786885246
"[0, 1, 1, 1, 1, 1, 0, 0, 1, 1, 0, 1, 0, 0, 0]",152,73,79,5,5,0.0684931506849315,0.06329113924050633
"[1, 0, 1, 1, 1, 1, 1, 0, 0, 1, 1, 0, 1, 0, 0]",168,60,108,7,4,0.11666666666666667,0.037037037037037035
"[1, 0, 0, 0, 0, 0, 1, 0, 0, 1, 1, 1, 1, 1, 0]",145,72,73,7,3,0.09722222222222222,0.0410958904109589
"[0, 1, 1, 0, 1, 1, 0, 1, 0, 0, 0, 0, 0, 1, 0]",147,81,66,3,9,0.037037037037037035,0.13636363636363635
"[1, 0, 0, 1, 0, 0, 0, 0, 1, 1, 0, 0, 0, 1, 1]",234,121,113,9,8,0.0743801652892562,0.07079646017699115
"[1, 0, 0, 1, 0, 0, 1, 0, 0, 1, 0, 0, 0, 0, 1]",229,144,85,20,10,0.1388888888888889,0.11764705882352941
"[0, 1, 1, 0, 0, 1, 0, 1, 1, 1, 0, 1, 1, 0, 0]",123,63,60,6,5,0.09523809523809523,0.08333333333333333
"[0, 0, 1, 1, 0, 0, 1, 0, 1, 1, 1, 0, 1, 1, 0]",122,55,67,6,9,0.10909090909090909,0.13432835820895522
"[1, 1, 1, 1, 0, 1, 0, 1, 0, 1, 0, 0, 0, 1, 1]",189,77,112,6,14,0.07792207792207792,0.125
"[1, 0, 1, 0, 1, 0, 1, 0, 0, 1, 1, 0, 0, 0, 0]",248,148,100,16,9,0.10810810810810811,0.09
"[0, 1, 0, 0, 1, 0, 0, 1, 0, 0, 1, 0, 1, 1, 1]",130,87,43,8,4,0.09195402298850575,0.09302325581395349
"[0, 1, 1, 0, 0, 1, 1, 0, 0, 0, 0, 1, 1, 0, 1]",426,319,107,35,5,0.109717868338558,0.04672897196261682
"[0, 1, 1, 0, 1, 1, 0, 0, 1, 1, 0, 0, 0, 0, 1]",278,147,131,11,9,0.07482993197278912,0.06870229007633588
"[0, 0, 0, 1, 1, 1, 1, 1, 0, 1, 1, 0, 1, 1, 0]",168,89,79,10,9,0.11235955056179775,0.11392405063291139
"[1, 1, 0, 1, 0, 1, 0, 0, 1, 1, 0, 1, 1, 0, 0]",134,63,71,2,5,0.031746031746031744,0.07042253521126761
"[1, 1, 0, 1, 0, 0, 1, 1, 1, 1, 0, 1, 1, 0, 1]",233,84,149,12,19,0.14285714285714285,0.12751677852348994
"[0, 0, 0, 0, 0, 0, 0, 1, 1, 1, 0, 1, 1, 1, 0]",235,158,77,20,8,0.12658227848101267,0.1038961038961039
"[1, 1, 0, 1, 1, 0, 0, 1, 1, 0, 1, 1, 1, 1, 1]",689,212,477,14,46,0.0660377358490566,0.09643605870020965
"[1, 0, 0, 1, 0, 1, 1, 1, 1, 1, 0, 1, 1, 0, 0]",143,60,83,7,3,0.11666666666666667,0.03614457831325301
"[0, 0, 1, 0, 1, 0, 1, 0, 1, 0, 0, 1, 0, 0, 0]",228,142,86,15,8,0.1056338028169014,0.09302325581395349
"[1, 0, 1, 0, 0, 1, 1, 1, 0, 0, 0, 1, 0, 1, 0]",96,55,41,5,5,0.09090909090909091,0.12195121951219512
"[1, 0, 1, 0, 1, 1, 0, 1, 1, 0, 0, 1, 0, 0, 0]",111,59,52,8,2,0.13559322033898305,0.038461538461538464
"[1, 0, 0, 0, 0, 0, 1, 0, 1, 1, 1, 1, 1, 1, 1]",299,94,205,13,21,0.13829787234042554,0.1024390243902439
"[0, 0, 1, 0, 1, 1, 0, 0, 0, 1, 1, 0, 0, 0, 1]",141,94,47,11,2,0.11702127659574468,0.0425531914893617
"[0, 0, 1, 1, 1, 0, 0, 0, 0, 1, 0, 1, 1, 0, 0]",193,105,88,9,7,0.08571428571428572,0.07954545454545454
"[1, 0, 1, 0, 0, 1, 0, 0, 1, 0, 0, 0, 1, 0, 0]",226,154,72,13,6,0.08441558441558442,0.08333333333333333
"[0, 1, 0, 1, 0, 0, 0, 1, 0, 0, 0, 0, 0, 1, 0]",445,308,137,33,15,0.10714285714285714,0.10948905109489052
"[0, 1, 0, 0, 1, 1, 1, 1, 0, 0, 1, 1, 1, 1, 0]",393,171,222,22,18,0.1286549707602339,0.08108108108108109
"[1, 1, 1, 1, 0, 1, 0, 1, 0, 1, 1, 0, 0, 1, 1]",337,123,214,14,15,0.11382113821138211,0.07009345794392523
"[1, 1, 0, 0, 0, 0, 1, 1, 1, 1, 0, 1, 0, 1, 1]",337,147,190,12,12,0.08163265306122448,0.06315789473684211
"[1, 1, 0, 0, 0, 0, 1, 0, 0, 0, 1, 1, 0, 0, 1]",203,114,89,10,7,0.08771929824561403,0.07865168539325842
"[1, 0, 1, 0, 1, 0, 0, 0, 1, 0, 0, 0, 0, 0, 0]",644,433,211,58,13,0.13394919168591224,0.061611374407582936
"[0, 0, 1, 0, 1, 0, 1, 0, 0, 0, 1, 0, 0, 0, 0]",557,391,166,35,16,0.08951406649616368,0.0963855421686747
"[0, 0, 1, 1, 1, 0, 0, 1, 0, 0, 1, 1, 0, 1, 1]",124,69,55,4,1,0.057971014492753624,0.01818181818181818
"[1, 0, 1, 1, 0, 0, 1, 0, 0, 0, 0, 0, 1, 1, 0]",167,104,63,7,6,0.0673076923076923,0.09523809523809523
"[0, 0, 1, 0, 1, 0, 0, 0, 0, 1, 0, 1, 0, 0, 0]",533,367,166,39,14,0.10626702997275204,0.08433734939759036
"[0, 0, 0, 1, 0, 1, 0, 0, 0, 0, 0, 1, 1, 1, 1]",404,278,126,28,11,0.10071942446043165,0.0873015873015873
"[1, 0, 1, 0, 1, 0, 0, 1, 1, 0, 0, 1, 1, 1, 1]",317,131,186,15,17,0.11450381679389313,0.0913978494623656
"[0, 1, 0, 0, 1, 0, 0, 0, 0, 1, 0, 0, 1, 1, 0]",249,172,77,17,6,0.09883720930232558,0.07792207792207792
"[1, 1, 0, 1, 1, 0, 0, 1, 0, 0, 1, 1, 0, 0, 0]",154,85,69,4,7,0.047058823529411764,0.10144927536231885
"[0, 1, 1, 0, 1, 1, 1, 1, 1, 0, 1, 1, 0, 0, 1]",274,114,160,7,19,0.06140350877192982,0.11875
"[0, 1, 1, 1, 1, 1, 0, 0, 0, 0, 0, 0, 0, 1, 0]",188,105,83,9,6,0.08571428571428572,0.07228915662650602
"[0, 1, 1, 1, 1, 1, 1, 0, 1, 0, 1, 0, 0, 0, 0]",171,89,82,7,8,0.07865168539325842,0.0975609756097561
"[0, 1, 1, 0, 1, 1, 0, 1, 0, 1, 1, 0, 0, 1, 1]",165,68,97,6,11,0.08823529411764706,0.1134020618556701
"[0, 0, 1, 0, 0, 0, 1, 0, 1, 0, 1, 1, 0, 1, 1]",119,71,48,3,5,0.04225352112676056,0.10416666666666667
"[1, 0, 1, 1, 1, 1, 0, 1, 0, 1, 1, 1, 0, 1, 1]",527,146,381,13,36,0.08904109589041095,0.09448818897637795
"[0, 1, 1, 1, 1, 1, 1, 1, 0, 1, 1, 0, 0, 1, 0]",241,98,143,7,11,0.07142857142857142,0.07692307692307693
"[1, 0, 0, 1, 0, 0, 0, 0, 1, 0, 1, 0, 0, 1, 1]",167,91,76,7,7,0.07692307692307693,0.09210526315789473
"[1, 1, 0, 0, 1, 0, 1, 0, 1, 1, 0, 1, 0, 1, 1]",156,65,91,7,9,0.1076923076923077,0.0989010989010989
"[0, 1, 1, 0, 1, 1, 1, 0, 1, 1, 1, 1, 0, 0, 0]",174,67,107,9,15,0.13432835820895522,0.14018691588785046
"[1, 1, 0, 0, 0, 1, 1, 1, 1, 0, 1, 1, 1, 1, 1]",733,201,532,24,51,0.11940298507462686,0.09586466165413533
"[0, 1, 0, 1, 0, 0, 0, 0, 1, 0, 1, 1, 1, 0, 1]",126,74,52,9,7,0.12162162162162163,0.1346153846153846
"[1, 1, 1, 1, 0, 0, 0, 0, 0, 0, 1, 1, 1, 0, 0]",411,222,189,21,16,0.0945945945945946,0.08465608465608465
"[0, 1, 0, 0, 1, 1, 0, 0, 0, 1, 1, 1, 1, 0, 0]",183,107,76,15,7,0.14018691588785046,0.09210526315789473
"[1, 0, 0, 1, 0, 1, 0, 1, 1, 0, 1, 0, 0, 1, 1]",120,53,67,3,6,0.05660377358490566,0.08955223880597014
"[1, 1, 0, 0, 1, 0, 1, 0, 1, 1, 0, 1, 0, 0, 1]",116,52,64,7,5,0.1346153846153846,0.078125
"[1, 0, 1, 0, 1, 1, 1, 1, 0, 0, 0, 1, 1, 1, 0]",176,75,101,8,10,0.10666666666666667,0.09900990099009901
"[0, 0, 1, 1, 0, 0, 1, 1, 0, 1, 0, 1, 1, 1, 1]",309,136,173,15,9,0.11029411764705882,0.05202312138728324
"[0, 1, 1, 0, 0, 1, 0, 1, 0, 1, 0, 0, 1, 1, 0]",140,82,58,2,7,0.024390243902439025,0.1206896551724138
"[1, 0, 1, 1, 0, 0, 1, 0, 1, 0, 1, 0, 0, 1, 1]",123,57,66,5,7,0.08771929824561403,0.10606060606060606
"[0, 0, 0, 1, 0, 1, 1, 0, 1, 0, 1, 1, 0, 0, 1]",116,58,58,6,6,0.10344827586206896,0.10344827586206896
"[0, 0, 0, 1, 1, 1, 1, 0, 0, 0, 1, 0, 0, 0, 1]",225,152,73,15,8,0.09868421052631579,0.1095890410958904
"[0, 1, 0, 0, 1, 0, 1, 0, 0, 1, 0, 0, 0, 1, 1]",158,90,68,6,8,0.06666666666666667,0.11764705882352941
"[0, 1, 1, 1, 1, 1, 0, 0, 0, 0, 1, 0, 1, 1, 1]",228,102,126,8,16,0.0784313725490196,0.12698412698412698
"[0, 1, 0, 0, 0, 0, 1, 0, 0, 0, 1, 1, 1, 1, 0]",206,123,83,16,10,0.13008130081300814,0.12048192771084337
"[1, 1, 0, 1, 0, 0, 1, 0, 0, 0, 0, 1, 0, 0, 0]",255,167,88,17,5,0.10179640718562874,0.056818181818181816
"[1, 0, 0, 0, 0, 0, 1, 1, 1, 0, 0, 1, 0, 1, 0]",161,80,81,3,8,0.0375,0.09876543209876543
"[0, 1, 1, 0, 1, 1, 0, 0, 1, 1, 1, 1, 1, 0, 0]",198,70,128,9,18,0.12857142857142856,0.140625
"[1, 0, 1, 0, 1, 1, 0, 1, 1, 1, 0, 0, 1, 1, 1]",298,118,180,11,13,0.09322033898305085,0.07222222222222222
"[1, 0, 1, 1, 1, 1, 1, 0, 1, 1, 0, 1, 0, 1, 0]",180,72,108,5,10,0.06944444444444445,0.09259259259259259
"[1, 0, 1, 0, 1, 1, 0, 1, 1, 0, 1, 1, 1, 1, 0]",246,92,154,13,18,0.14130434782608695,0.11688311688311688
"[0, 0, 0, 0, 0, 0, 0, 1, 0, 0, 1, 1, 0, 0, 1]",821,578,243,63,25,0.10899653979238755,0.102880658436214
"[0, 1, 0, 1, 0, 0, 0, 0, 1, 0, 1, 0, 0, 0, 0]",585,418,167,50,16,0.11961722488038277,0.09580838323353294
"[1, 1, 0, 0, 0, 1, 0, 0, 0, 1, 1, 0, 0, 0, 0]",416,277,139,32,23,0.11552346570397112,0.16546762589928057
"[1, 1, 1, 0, 0, 0, 1, 0, 0, 0, 1, 1, 0, 0, 0]",225,121,104,16,14,0.1322314049586777,0.1346153846153846
"[0, 1, 1, 1, 0, 1, 1, 0, 1, 0, 0, 1, 0, 0, 0]",96,43,53,5,5,0.11627906976744186,0.09433962264150944
"[0, 0, 0, 0, 1, 1, 0, 1, 1, 0, 1, 0, 0, 0, 1]",162,92,70,11,6,0.11956521739130435,0.08571428571428572
"[1, 0, 0, 0, 0, 1, 1, 0, 0, 1, 1, 1, 0, 1, 0]",207,61,146,6,19,0.09836065573770492,0.13013698630136986
"[1, 1, 0, 0, 0, 0, 1, 1, 1, 0, 1, 1, 0, 1, 0]",149,57,92,7,9,0.12280701754385964,0.09782608695652174
"[1, 1, 1, 1, 0, 0, 0, 0, 0, 1, 0, 0, 0, 0, 0]",425,258,167,20,12,0.07751937984496124,0.0718562874251497
"[1, 1, 1, 1, 0, 1, 0, 0, 0, 0, 0, 1, 1, 0, 1]",129,55,74,3,7,0.05454545454545454,0.0945945945945946
"[1, 1, 0, 1, 0, 1, 0, 1, 0, 1, 0, 0, 1, 1, 0]",126,52,74,2,11,0.038461538461538464,0.14864864864864866
"[0, 1, 0, 0, 0, 1, 1, 1, 0, 1, 1, 0, 1, 0, 1]",103,52,51,3,12,0.057692307692307696,0.23529411764705882
"[1, 0, 0, 0, 1, 0, 0, 0, 1, 1, 1, 0, 1, 1, 0]",122,64,58,8,5,0.125,0.08620689655172414
"[0, 0, 0, 1, 0, 1, 1, 0, 1, 0, 0, 0, 0, 0, 0]",632,458,174,42,12,0.09170305676855896,0.06896551724137931
"[0, 1, 1, 1, 0, 1, 0, 1, 1, 1, 0, 0, 0, 0, 0]",179,86,93,7,6,0.08139534883720931,0.06451612903225806
"[1, 1, 0, 1, 1, 0, 1, 1, 1, 1, 0, 1, 0, 1, 1]",539,149,390,21,35,0.14093959731543623,0.08974358974358974
"[0, 0, 0, 0, 0, 1, 0, 1, 1, 1, 1, 1, 0, 0, 0]",260,167,93,14,11,0.08383233532934131,0.11827956989247312
"[0, 0, 0, 0, 1, 1, 0, 0, 1, 0, 0, 0, 1, 0, 1]",310,194,116,22,10,0.1134020618556701,0.08620689655172414
"[1, 1, 0, 1, 1, 0, 0, 0, 0, 1, 0, 1, 0, 0, 1]",89,43,46,2,6,0.046511627906976744,0.13043478260869565
"[0, 1, 0, 0, 1, 1, 0, 0, 1, 1, 1, 1, 1, 1, 0]",416,216,200,20,20,0.09259259259259259,0.1
"[0, 1, 1, 0, 0, 1, 1, 1, 0, 1, 0, 1, 1, 0, 1]",177,79,98,4,9,0.05063291139240506,0.09183673469387756
"[0, 0, 1, 1, 0, 0, 1, 0, 1, 1, 0, 0, 1, 1, 1]",217,100,117,14,12,0.14,0.10256410256410256
"[1, 1, 0, 0, 1, 1, 1, 0, 1, 0, 0, 0, 1, 1, 0]",153,77,76,9,8,0.11688311688311688,0.10526315789473684
"[1, 1, 0, 1, 0, 0, 0, 1, 0, 1, 0, 0, 1, 1, 0]",125,65,60,13,3,0.2,0.05
"[1, 0, 0, 1, 1, 1, 0, 1, 1, 1, 1, 0, 1, 1, 1]",582,146,436,20,50,0.136986301369863,0.11467889908256881
"[1, 1, 1, 0, 0, 1, 0, 0, 1, 1, 1, 0, 1, 1, 1]",314,113,201,12,25,0.10619469026548672,0.12437810945273632
"[1, 0, 1, 1, 0, 0, 0, 0, 1, 1, 0, 1, 0, 0, 0]",180,107,73,6,4,0.056074766355140186,0.0547945205479452
"[1, 0, 0, 0, 1, 1, 1, 1, 0, 1, 1, 0, 0, 0, 0]",159,75,84,10,10,0.13333333333333333,0.11904761904761904
"[0, 1, 0, 1, 1, 1, 1, 1, 1, 1, 0, 0, 0, 1, 1]",313,118,195,13,13,0.11016949152542373,0.06666666666666667
"[0, 0, 0, 1, 1, 1, 0, 1, 0, 0, 1, 1, 1, 1, 1]",282,139,143,17,14,0.1223021582733813,0.0979020979020979
"[1, 1, 1, 1, 1, 1, 1, 0, 0, 0, 1, 0, 1, 1, 0]",347,101,246,6,26,0.0594059405940594,0.10569105691056911
"[1, 1, 0, 0, 0, 1, 1, 1, 1, 0, 0, 1, 1, 0, 1]",201,86,115,10,11,0.11627906976744186,0.09565217391304348
"[0, 0, 1, 1, 0, 0, 1, 0, 0, 1, 1, 0, 0, 0, 1]",173,95,78,5,8,0.05263157894736842,0.10256410256410256
"[1, 0, 1, 1, 0, 0, 1, 1, 0, 0, 1, 0, 0, 1, 1]",155,73,82,9,9,0.1232876712328767,0.10975609756097561
"[1, 0, 0, 1, 1, 1, 1, 1, 0, 0, 0, 1, 1, 0, 0]",196,78,118,9,10,0.11538461538461539,0.0847457627118644
"[0, 0, 1, 0, 0, 1, 0, 1, 0, 1, 1, 1, 0, 1, 1]",111,45,66,6,7,0.13333333333333333,0.10606060606060606
"[0, 1, 0, 1, 1, 0, 0, 0, 0, 0, 0, 1, 0, 1, 0]",203,128,75,12,7,0.09375,0.09333333333333334
"[0, 1, 0, 1, 1, 0, 1, 0, 1, 1, 0, 0, 0, 0, 0]",198,124,74,12,3,0.0967741935483871,0.04054054054054054
"[1, 1, 0, 0, 0, 1, 1, 1, 1, 1, 0, 0, 1, 0, 0]",149,62,87,4,13,0.06451612903225806,0.14942528735632185
"[0, 0, 1, 0, 0, 1, 0, 1, 1, 1, 0, 0, 0, 0, 0]",360,249,111,15,10,0.060240963855421686,0.09009009009009009
"[1, 0, 1, 0, 0, 0, 0, 1, 0, 0, 1, 1, 0, 1, 0]",148,101,47,5,4,0.04950495049504951,0.0851063829787234
"[1, 0, 0, 1, 1, 1, 0, 0, 0, 0, 0, 1, 1, 0, 0]",252,115,137,21,14,0.1826086956521739,0.10218978102189781
"[1, 0, 0, 1, 1, 0, 1, 0, 0, 1, 0, 1, 0, 0, 0]",139,76,63,7,4,0.09210526315789473,0.06349206349206349
"[1, 0, 0, 1, 0, 1, 1, 1, 0, 1, 0, 0, 1, 1, 0]",102,39,63,3,6,0.07692307692307693,0.09523809523809523
"[1, 0, 1, 0, 0, 1, 1, 1, 0, 1, 0, 1, 0, 1, 1]",131,54,77,4,6,0.07407407407407407,0.07792207792207792
"[0, 1, 1, 1, 1, 1, 1, 0, 0, 1, 0, 0, 0, 0, 1]",183,111,72,12,5,0.10810810810810811,0.06944444444444445
"[1, 1, 1, 0, 0, 0, 0, 1, 0, 0, 0, 1, 0, 1, 0]",147,72,75,10,7,0.1388888888888889,0.09333333333333334
"[0, 1, 0, 0, 1, 1, 1, 0, 1, 0, 1, 1, 1, 1, 0]",141,53,88,2,12,0.03773584905660377,0.13636363636363635
"[1, 1, 0, 0, 1, 1, 1, 1, 1, 1, 1, 0, 1, 0, 0]",395,150,245,11,23,0.07333333333333333,0.09387755102040816
"[1, 1, 1, 0, 0, 0, 1, 1, 1, 1, 0, 1, 0, 1, 1]",252,87,165,6,18,0.06896551724137931,0.10909090909090909
"[1, 0, 0, 1, 1, 0, 0, 0, 1, 0, 1, 0, 1, 0, 0]",165,92,73,10,4,0.10869565217391304,0.0547945205479452
"[0, 1, 1, 0, 0, 1, 0, 1, 0, 0, 1, 0, 0, 0, 0]",263,165,98,14,9,0.08484848484848485,0.09183673469387756
"[1, 0, 1, 1, 0, 0, 1, 0, 1, 0, 0, 1, 1, 1, 1]",184,70,114,6,14,0.08571428571428572,0.12280701754385964
"[1, 1, 1, 1, 1, 0, 1, 1, 0, 0, 1, 0, 1, 0, 0]",139,48,91,4,9,0.08333333333333333,0.0989010989010989
"[0, 0, 0, 1, 1, 1, 1, 1, 0, 0, 0, 1, 0, 1, 0]",131,71,60,7,5,0.09859154929577464,0.08333333333333333
"[1, 1, 0, 1, 1, 0, 1, 0, 0, 0, 1, 1, 1, 1, 1]",352,110,242,10,15,0.09090909090909091,0.06198347107438017
"[1, 1, 0, 1, 1, 0, 0, 1, 0, 0, 0, 0, 0, 1, 0]",139,81,58,11,8,0.13580246913580246,0.13793103448275862
"[1, 0, 0, 0, 1, 1, 0, 1, 1, 0, 0, 1, 0, 0, 0]",149,94,55,9,6,0.09574468085106383,0.10909090909090909
"[0, 1, 0, 0, 0, 0, 0, 0, 0, 0, 1, 0, 1, 0, 1]",507,363,144,36,15,0.09917355371900827,0.10416666666666667
"[0, 1, 1, 1, 0, 0, 0, 1, 0, 0, 0, 1, 1, 0, 1]",109,57,52,4,7,0.07017543859649122,0.1346153846153846
"[1, 1, 1, 1, 0, 1, 0, 0, 1, 0, 1, 0, 1, 0, 0]",121,55,66,3,6,0.05454545454545454,0.09090909090909091
"[1, 1, 0, 0, 0, 0, 0, 1, 0, 1, 0, 0, 0, 0, 0]",722,512,210,42,15,0.08203125,0.07142857142857142
"[0, 0, 0, 1, 0, 1, 1, 1, 0, 1, 0, 0, 1, 1, 1]",162,85,77,17,11,0.2,0.14285714285714285
"[1, 0, 0, 0, 1, 1, 1, 0, 0, 1, 1, 0, 0, 1, 0]",118,69,49,9,5,0.13043478260869565,0.10204081632653061
"[1, 0, 0, 1, 1, 0, 0, 0, 1, 1, 1, 0, 0, 1, 1]",193,71,122,8,9,0.11267605633802817,0.07377049180327869
"[1, 0, 0, 0, 0, 0, 0, 0, 1, 1, 1, 1, 0, 1, 0]",171,86,85,15,9,0.1744186046511628,0.10588235294117647
"[1, 1, 0, 1, 0, 0, 0, 0, 0, 0, 0, 1, 1, 1, 1]",360,180,180,18,17,0.1,0.09444444444444444
"[0, 1, 1, 0, 1, 0, 0, 1, 0, 1, 1, 1, 1, 1, 0]",153,77,76,3,8,0.03896103896103896,0.10526315789473684
"[1, 0, 0, 1, 1, 0, 0, 1, 1, 1, 1, 0, 1, 1, 0]",299,78,221,3,24,0.038461538461538464,0.1085972850678733
"[0, 1, 1, 0, 1, 1, 0, 1, 1, 0, 1, 1, 0, 0, 1]",179,72,107,8,10,0.1111111111111111,0.09345794392523364
"[0, 0, 0, 1, 1, 0, 0, 1, 0, 1, 1, 0, 1, 1, 0]",139,83,56,10,6,0.12048192771084337,0.10714285714285714
"[0, 0, 0, 0, 1, 1, 0, 0, 1, 0, 1, 1, 0, 1, 1]",187,105,82,13,7,0.12380952380952381,0.08536585365853659
"[1, 1, 1, 1, 0, 0, 1, 1, 0, 0, 0, 1, 1, 1, 1]",717,293,424,29,44,0.09897610921501707,0.10377358490566038
"[1, 1, 1, 1, 1, 0, 0, 1, 1, 0, 0, 0, 1, 1, 1]",666,130,536,11,52,0.08461538461538462,0.09701492537313433
"[1, 0, 0, 1, 0, 1, 0, 1, 0, 1, 1, 1, 0, 0, 1]",124,52,72,5,1,0.09615384615384616,0.013888888888888888
"[1, 1, 1, 1, 1, 1, 0, 1, 1, 1, 1, 0, 0, 1, 0]",545,154,391,17,27,0.11038961038961038,0.06905370843989769
"[1, 1, 0, 0, 1, 1, 1, 0, 0, 0, 1, 1, 0, 1, 1]",198,89,109,6,14,0.06741573033707865,0.12844036697247707
"[0, 1, 1, 1, 0, 0, 0, 0, 1, 1, 1, 0, 0, 0, 0]",237,148,89,13,7,0.08783783783783784,0.07865168539325842
"[1, 0, 1, 0, 0, 0, 0, 0, 0, 1, 0, 1, 0, 0, 0]",528,376,152,26,5,0.06914893617021277,0.03289473684210526
"[1, 0, 1, 1, 0, 1, 0, 0, 0, 0, 0, 0, 1, 0, 1]",158,93,65,1,8,0.010752688172043012,0.12307692307692308
"[1, 0, 0, 1, 1, 1, 1, 0, 0, 1, 1, 0, 1, 0, 1]",278,87,191,11,17,0.12643678160919541,0.08900523560209424
"[0, 1, 0, 0, 1, 1, 1, 1, 1, 1, 1, 0, 0, 0, 1]",207,90,117,6,7,0.06666666666666667,0.05982905982905983
"[0, 0, 1, 1, 1, 1, 1, 1, 1, 0, 1, 0, 0, 0, 1]",222,90,132,8,10,0.08888888888888889,0.07575757575757576
"[1, 0, 1, 1, 0, 0, 1, 1, 0, 0, 0, 1, 1, 1, 0]",138,69,69,10,5,0.14492753623188406,0.07246376811594203
"[0, 1, 0, 0, 1, 1, 1, 1, 1, 1, 0, 1, 0, 1, 0]",143,68,75,6,5,0.08823529411764706,0.06666666666666667
"[1, 1, 0, 0, 1, 1, 0, 1, 0, 0, 1, 0, 0, 1, 1]",179,82,97,9,7,0.10975609756097561,0.07216494845360824
"[1, 1, 1, 0, 0, 1, 1, 0, 0, 1, 0, 0, 1, 1, 0]",152,57,95,7,6,0.12280701754385964,0.06315789473684211
"[1, 1, 1, 1, 1, 0, 0, 1, 1, 0, 0, 1, 0, 0, 1]",274,82,192,9,20,0.10975609756097561,0.10416666666666667
"[1, 1, 1, 1, 0, 0, 1, 1, 1, 0, 0, 0, 1, 1, 1]",467,163,304,9,40,0.05521472392638037,0.13157894736842105
"[0, 1, 1, 1, 1, 0, 0, 1, 1, 1, 0, 0, 0, 1, 1]",242,121,121,8,12,0.06611570247933884,0.09917355371900827
"[1, 0, 0, 0, 0, 0, 1, 0, 0, 0, 1, 0, 0, 1, 1]",287,159,128,17,12,0.1069182389937107,0.09375
"[1, 0, 0, 0, 0, 0, 1, 1, 1, 1, 1, 0, 0, 1, 1]",266,132,134,15,11,0.11363636363636363,0.08208955223880597
"[1, 1, 0, 0, 1, 1, 1, 1, 1, 0, 1, 1, 1, 1, 0]",706,190,516,15,44,0.07894736842105263,0.08527131782945736
"[1, 1, 0, 1, 1, 1, 0, 1, 1, 0, 1, 1, 1, 0, 1]",492,138,354,13,33,0.09420289855072464,0.09322033898305085
"[1, 1, 1, 1, 1, 0, 1, 0, 1, 0, 1, 0, 1, 0, 1]",227,70,157,7,13,0.1,0.08280254777070063
"[1, 0, 0, 0, 1, 0, 1, 0, 0, 0, 0, 0, 0, 1, 0]",513,358,155,28,19,0.0782122905027933,0.12258064516129032
"[0, 0, 1, 0, 1, 1, 0, 0, 0, 1, 0, 1, 1, 1, 0]",108,58,50,2,3,0.034482758620689655,0.06
"[0, 0, 0, 0, 0, 0, 1, 0, 1, 1, 1, 0, 1, 0, 0]",255,164,91,13,10,0.07926829268292683,0.10989010989010989
"[1, 1, 0, 1, 0, 0, 1, 0, 1, 0, 0, 1, 1, 1, 1]",192,81,111,5,12,0.06172839506172839,0.10810810810810811
"[1, 1, 1, 0, 1, 0, 0, 1, 0, 1, 0, 0, 1, 1, 1]",162,57,105,9,10,0.15789473684210525,0.09523809523809523
"[1, 0, 0, 1, 1, 1, 1, 0, 1, 0, 1, 0, 1, 0, 1]",139,41,98,3,19,0.07317073170731707,0.19387755102040816
"[0, 1, 1, 1, 0, 0, 1, 0, 1, 0, 0, 0, 1, 1, 0]",132,63,69,8,4,0.12698412698412698,0.057971014492753624
"[1, 0, 0, 1, 1, 1, 0, 0, 1, 0, 1, 0, 0, 0, 1]",139,65,74,8,9,0.12307692307692308,0.12162162162162163
"[0, 1, 0, 0, 1, 0, 0, 0, 1, 1, 0, 0, 0, 1, 0]",235,161,74,15,5,0.09316770186335403,0.06756756756756757
"[1, 0, 0, 1, 0, 0, 1, 0, 0, 0, 1, 1, 0, 0, 0]",315,203,112,12,5,0.059113300492610835,0.044642857142857144
"[1, 1, 1, 1, 1, 0, 0, 0, 1, 1, 0, 1, 0, 0, 1]",174,57,117,5,12,0.08771929824561403,0.10256410256410256
"[1, 1, 0, 1, 1, 1, 0, 0, 1, 1, 0, 0, 0, 0, 1]",290,114,176,12,20,0.10526315789473684,0.11363636363636363
"[1, 0, 1, 0, 1, 0, 0, 1, 1, 1, 0, 0, 1, 1, 0]",138,63,75,11,5,0.1746031746031746,0.06666666666666667
"[1, 0, 1, 1, 0, 1, 1, 1, 0, 1, 0, 1, 0, 0, 0]",114,43,71,5,3,0.11627906976744186,0.04225352112676056
"[1, 0, 0, 0, 1, 0, 1, 0, 0, 0, 1, 1, 0, 0, 0]",322,203,119,19,10,0.09359605911330049,0.08403361344537816
"[0, 1, 1, 0, 0, 1, 0, 1, 1, 0, 0, 1, 0, 0, 1]",117,67,50,7,2,0.1044776119402985,0.04
"[0, 1, 0, 1, 1, 0, 0, 1, 0, 1, 1, 0, 0, 1, 0]",111,57,54,2,6,0.03508771929824561,0.1111111111111111
"[1, 0, 0, 0, 0, 0, 1, 0, 1, 1, 0, 0, 1, 0, 1]",132,67,65,5,8,0.07462686567164178,0.12307692307692308
"[1, 1, 0, 0, 0, 0, 0, 1, 0, 1, 1, 0, 0, 1, 0]",146,82,64,7,8,0.08536585365853659,0.125
"[1, 1, 0, 1, 0, 0, 0, 0, 1, 1, 1, 0, 0, 1, 0]",104,51,53,6,6,0.11764705882352941,0.11320754716981132
"[0, 1, 0, 1, 0, 1, 0, 0, 1, 0, 1, 1, 0, 1, 1]",111,51,60,4,8,0.0784313725490196,0.13333333333333333
"[1, 1, 0, 1, 0, 1, 0, 0, 0, 1, 0, 1, 0, 1, 1]",132,55,77,4,1,0.07272727272727272,0.012987012987012988
"[1, 1, 1, 1, 1, 0, 1, 0, 1, 0, 0, 0, 1, 0, 1]",159,63,96,3,11,0.047619047619047616,0.11458333333333333
"[1, 0, 0, 1, 0, 1, 0, 1, 1, 1, 1, 1, 1, 1, 1]",814,206,608,18,59,0.08737864077669903,0.09703947368421052
"[1, 1, 0, 0, 0, 1, 1, 1, 0, 1, 1, 0, 1, 0, 1]",151,56,95,6,11,0.10714285714285714,0.11578947368421053
"[1, 1, 1, 0, 0, 0, 1, 1, 1, 0, 1, 1, 0, 1, 0]",158,49,109,6,13,0.12244897959183673,0.11926605504587157
"[0, 0, 0, 0, 0, 1, 0, 1, 0, 1, 0, 1, 1, 1, 1]",198,126,72,13,9,0.10317460317460317,0.125
"[1, 0, 0, 1, 0, 0, 1, 0, 0, 0, 0, 1, 1, 1, 1]",249,127,122,10,11,0.07874015748031496,0.09016393442622951
"[1, 1, 0, 0, 1, 1, 0, 0, 1, 0, 1, 1, 1, 1, 1]",531,194,337,22,27,0.1134020618556701,0.08011869436201781
"[0, 1, 1, 0, 0, 1, 0, 0, 0, 1, 1, 0, 1, 1, 0]",124,68,56,7,5,0.10294117647058823,0.08928571428571429
"[1, 0, 1, 1, 0, 0, 0, 0, 1, 0, 0, 1, 1, 0, 0]",167,94,73,10,6,0.10638297872340426,0.0821917808219178
"[0, 0, 0, 1, 0, 0, 1, 1, 0, 1, 0, 1, 1, 0, 0]",152,86,66,7,7,0.08139534883720931,0.10606060606060606
"[1, 1, 1, 1, 0, 1, 1, 1, 0, 1, 0, 0, 1, 1, 1]",639,191,448,15,48,0.07853403141361257,0.10714285714285714
"[1, 1, 1, 1, 1, 1, 1, 0, 1, 1, 1, 0, 1, 0, 0]",627,176,451,19,43,0.10795454545454546,0.09534368070953436
"[0, 0, 1, 0, 1, 1, 0, 1, 0, 1, 1, 1, 1, 0, 1]",144,58,86,11,8,0.1896551724137931,0.09302325581395349
"[1, 1, 0, 0, 1, 0, 1, 1, 0, 1, 1, 1, 1, 0, 1]",247,88,159,9,13,0.10227272727272728,0.08176100628930817
"[1, 1, 0, 0, 1, 1, 0, 1, 0, 0, 0, 0, 0, 0, 0]",412,253,159,26,15,0.10276679841897234,0.09433962264150944
"[0, 0, 1, 0, 0, 0, 1, 1, 0, 1, 0, 0, 0, 0, 0]",605,429,176,37,18,0.08624708624708624,0.10227272727272728
"[0, 1, 0, 0, 0, 0, 1, 0, 0, 0, 1, 1, 0, 0, 0]",716,520,196,43,22,0.08269230769230769,0.11224489795918367
"[0, 0, 0, 0, 0, 1, 0, 1, 1, 1, 0, 1, 0, 0, 0]",243,165,78,15,6,0.09090909090909091,0.07692307692307693
"[0, 0, 1, 0, 0, 0, 0, 1, 0, 1, 1, 1, 0, 0, 0]",244,156,88,9,7,0.057692307692307696,0.07954545454545454
"[0, 0, 1, 0, 0, 1, 0, 0, 0, 1, 1, 0, 0, 1, 1]",281,167,114,12,12,0.0718562874251497,0.10526315789473684
"[0, 0, 1, 1, 0, 0, 1, 1, 0, 1, 0, 0, 0, 1, 1]",199,114,85,10,11,0.08771929824561403,0.12941176470588237
"[1, 1, 0, 0, 0, 0, 0, 0, 0, 0, 1, 1, 0, 1, 0]",532,331,201,36,17,0.10876132930513595,0.0845771144278607
"[1, 1, 0, 1, 0, 0, 1, 1, 1, 1, 1, 0, 1, 1, 1]",619,185,434,10,39,0.05405405405405406,0.08986175115207373
"[0, 0, 1, 1, 0, 1, 1, 0, 1, 0, 1, 1, 0, 0, 1]",120,66,54,4,4,0.06060606060606061,0.07407407407407407
"[0, 0, 0, 0, 0, 1, 1, 0, 1, 1, 0, 1, 0, 1, 1]",159,106,53,14,3,0.1320754716981132,0.05660377358490566
"[1, 0, 1, 0, 0, 0, 1, 0, 0, 0, 1, 0, 1, 0, 0]",200,125,75,13,6,0.104,0.08
"[1, 1, 0, 1, 0, 0, 0, 1, 0, 0, 0, 1, 0, 1, 0]",144,85,59,11,6,0.12941176470588237,0.1016949152542373
"[1, 1, 0, 1, 1, 0, 1, 1, 1, 0, 1, 0, 0, 0, 1]",148,61,87,4,6,0.06557377049180328,0.06896551724137931
"[0, 1, 1, 1, 0, 0, 0, 1, 1, 1, 1, 0, 0, 0, 1]",148,75,73,5,7,0.06666666666666667,0.0958904109589041
"[0, 0, 0, 0, 1, 1, 1, 1, 1, 0, 0, 0, 0, 1, 0]",201,128,73,13,3,0.1015625,0.0410958904109589
"[0, 1, 0, 0, 0, 0, 1, 1, 1, 0, 0, 1, 1, 1, 0]",126,74,52,7,8,0.0945945945945946,0.15384615384615385
"[0, 0, 0, 0, 0, 0, 0, 1, 1, 1, 0, 1, 0, 1, 1]",306,210,96,14,14,0.06666666666666667,0.14583333333333334
"[0, 1, 1, 0, 0, 0, 1, 1, 1, 0, 0, 0, 0, 0, 1]",188,121,67,8,6,0.06611570247933884,0.08955223880597014
"[0, 1, 0, 0, 1, 0, 1, 1, 0, 0, 0, 0, 0, 1, 0]",242,149,93,15,6,0.10067114093959731,0.06451612903225806
"[1, 0, 0, 1, 0, 1, 0, 0, 1, 1, 0, 0, 0, 0, 1]",224,134,90,11,9,0.08208955223880597,0.1
"[0, 1, 1, 1, 0, 0, 0, 0, 0, 0, 0, 1, 1, 0, 0]",454,297,157,28,11,0.09427609427609428,0.07006369426751592
"[1, 1, 1, 1, 1, 0, 0, 0, 1, 0, 1, 1, 1, 0, 1]",287,68,219,6,23,0.08823529411764706,0.1050228310502283
"[1, 1, 1, 1, 0, 0, 0, 0, 1, 0, 1, 0, 0, 1, 0]",162,99,63,9,5,0.09090909090909091,0.07936507936507936
"[0, 0, 1, 0, 1, 0, 0, 1, 1, 0, 1, 1, 0, 1, 0]",110,57,53,5,4,0.08771929824561403,0.07547169811320754
"[0, 0, 0, 0, 1, 0, 1, 0, 0, 1, 1, 0, 1, 1, 0]",143,86,57,14,4,0.16279069767441862,0.07017543859649122
"[1, 0, 0, 0, 0, 0, 1, 1, 0, 0, 1, 0, 1, 0, 0]",264,167,97,17,4,0.10179640718562874,0.041237113402061855
"[0, 0, 0, 1, 0, 0, 0, 1, 0, 1, 0, 1, 1, 0, 1]",134,83,51,11,5,0.13253012048192772,0.09803921568627451
"[1, 1, 1, 1, 0, 1, 0, 0, 0, 1, 1, 1, 0, 1, 1]",262,96,166,15,13,0.15625,0.0783132530120482
"[0, 0, 0, 1, 1, 1, 1, 0, 1, 0, 0, 1, 1, 0, 1]",122,67,55,7,5,0.1044776119402985,0.09090909090909091
"[1, 0, 0, 0, 1, 0, 0, 0, 0, 1, 1, 1, 1, 0, 1]",133,62,71,6,5,0.0967741935483871,0.07042253521126761
"[1, 1, 1, 1, 0, 0, 0, 0, 0, 1, 0, 0, 1, 1, 0]",169,79,90,7,6,0.08860759493670886,0.06666666666666667
"[0, 1, 1, 1, 1, 0, 0, 0, 0, 0, 1, 0, 0, 1, 1]",228,171,57,20,5,0.11695906432748537,0.08771929824561403
"[0, 1, 0, 0, 1, 1, 1, 1, 0, 0, 0, 0, 0, 1, 0]",187,103,84,17,7,0.1650485436893204,0.08333333333333333
"[0, 1, 0, 1, 0, 0, 1, 0, 0, 1, 1, 1, 1, 0, 0]",156,84,72,9,2,0.10714285714285714,0.027777777777777776
"[0, 1, 0, 1, 0, 1, 0, 1, 0, 0, 0, 0, 1, 0, 1]",111,68,43,7,3,0.10294117647058823,0.06976744186046512
"[1, 0, 0, 1, 1, 1, 1, 0, 1, 0, 1, 0, 1, 1, 1]",340,78,262,5,20,0.0641025641025641,0.07633587786259542
"[0, 1, 1, 1, 1, 1, 0, 0, 1, 0, 0, 1, 1, 1, 0]",154,67,87,8,9,0.11940298507462686,0.10344827586206896
"[1, 0, 0, 1, 1, 1, 1, 1, 0, 0, 1, 0, 0, 1, 1]",224,75,149,7,11,0.09333333333333334,0.0738255033557047
"[1, 0, 0, 0, 1, 0, 1, 1, 1, 1, 1, 1, 1, 1, 0]",331,136,195,8,21,0.058823529411764705,0.1076923076923077
"[0, 0, 1, 1, 0, 0, 0, 1, 0, 1, 1, 1, 1, 1, 1]",304,141,163,13,14,0.09219858156028368,0.08588957055214724
"[1, 0, 1, 1, 1, 0, 0, 0, 0, 0, 1, 1, 0, 1, 1]",131,73,58,5,7,0.0684931506849315,0.1206896551724138
"[1, 1, 1, 0, 0, 1, 1, 0, 1, 0, 0, 1, 0, 1, 0]",110,42,68,6,3,0.14285714285714285,0.04411764705882353
"[1, 1, 1, 0, 0, 1, 1, 1, 1, 0, 0, 1, 0, 1, 0]",255,73,182,7,20,0.0958904109589041,0.10989010989010989
"[0, 1, 0, 1, 0, 1, 0, 0, 1, 0, 1, 1, 1, 0, 1]",91,36,55,1,4,0.027777777777777776,0.07272727272727272
"[0, 0, 0, 1, 0, 1, 0, 0, 1, 0, 1, 0, 1, 0, 0]",248,167,81,18,9,0.10778443113772455,0.1111111111111111
"[1, 0, 1, 0, 0, 1, 1, 0, 0, 1, 0, 1, 1, 1, 0]",138,74,64,6,5,0.08108108108108109,0.078125
"[0, 0, 1, 0, 0, 0, 0, 0, 1, 1, 0, 0, 1, 0, 1]",259,167,92,16,9,0.09580838323353294,0.09782608695652174
"[1, 0, 0, 1, 0, 1, 1, 0, 0, 1, 1, 1, 1, 1, 1]",504,172,332,8,32,0.046511627906976744,0.0963855421686747
"[0, 0, 1, 0, 1, 0, 1, 0, 1, 0, 0, 1, 0, 1, 0]",136,83,53,9,5,0.10843373493975904,0.09433962264150944
"[1, 1, 1, 0, 1, 0, 1, 0, 0, 1, 0, 1, 1, 0, 1]",121,46,75,1,10,0.021739130434782608,0.13333333333333333
"[1, 0, 0, 1, 1, 1, 1, 0, 1, 0, 1, 0, 0, 1, 0]",114,51,63,4,3,0.0784313725490196,0.047619047619047616
"[0, 0, 0, 1, 0, 0, 1, 1, 1, 1, 0, 1, 0, 1, 0]",117,59,58,4,4,0.06779661016949153,0.06896551724137931
"[1, 0, 1, 1, 1, 0, 0, 0, 1, 1, 0, 1, 1, 1, 0]",147,56,91,10,8,0.17857142857142858,0.08791208791208792
"[1, 0, 0, 1, 1, 1, 1, 0, 1, 1, 1, 0, 0, 0, 1]",188,63,125,2,12,0.031746031746031744,0.096
"[1, 1, 0, 0, 0, 0, 1, 0, 1, 1, 1, 1, 0, 1, 1]",191,76,115,7,8,0.09210526315789473,0.06956521739130435
"[0, 0, 0, 1, 0, 1, 0, 1, 0, 1, 0, 1, 0, 0, 1]",130,76,54,6,8,0.07894736842105263,0.14814814814814814
"[0, 0, 0, 1, 1, 1, 0, 1, 0, 1, 0, 0, 1, 0, 0]",130,80,50,9,3,0.1125,0.06
"[1, 1, 0, 0, 0, 1, 0, 0, 1, 0, 0, 1, 1, 0, 0]",192,108,84,8,6,0.07407407407407407,0.07142857142857142
"[0, 0, 0, 0, 0, 0, 1, 1, 1, 0, 1, 0, 0, 0, 1]",348,234,114,24,12,0.10256410256410256,0.10526315789473684
"[0, 1, 1, 1, 0, 0, 1, 0, 0, 1, 1, 1, 0, 0, 0]",139,85,54,8,8,0.09411764705882353,0.14814814814814814
"[0, 0, 0, 0, 1, 1, 0, 0, 0, 1, 0, 1, 0, 1, 1]",259,147,112,11,8,0.07482993197278912,0.07142857142857142
"[0, 0, 1, 1, 0, 1, 1, 1, 0, 1, 1, 1, 0, 1, 0]",133,60,73,3,6,0.05,0.0821917808219178
"[1, 0, 0, 0, 1, 0, 1, 1, 0, 0, 1, 1, 0, 1, 1]",142,63,79,7,8,0.1111111111111111,0.10126582278481013
"[0, 1, 1, 0, 1, 0, 0, 0, 1, 0, 0, 1, 0, 1, 0]",134,79,55,12,3,0.1518987341772152,0.05454545454545454
"[0, 1, 1, 0, 1, 1, 1, 0, 1, 1, 1, 0, 0, 1, 0]",137,56,81,6,2,0.10714285714285714,0.024691358024691357
"[1, 1, 1, 0, 1, 0, 1, 0, 1, 0, 0, 0, 0, 0, 0]",186,101,85,8,6,0.07920792079207921,0.07058823529411765
"[0, 0, 0, 1, 1, 1, 1, 0, 1, 0, 0, 1, 1, 1, 0]",122,70,52,3,8,0.04285714285714286,0.15384615384615385
"[1, 0, 0, 0, 1, 0, 0, 1, 1, 1, 0, 0, 0, 1, 0]",158,99,59,7,6,0.0707070707070707,0.1016949152542373
"[1, 0, 1, 0, 1, 0, 1, 0, 1, 1, 1, 0, 1, 1, 0]",131,46,85,6,7,0.13043478260869565,0.08235294117647059
"[1, 1, 1, 0, 1, 0, 1, 0, 1, 0, 1, 1, 1, 0, 1]",213,66,147,9,19,0.13636363636363635,0.1292517006802721
"[1, 1, 1, 0, 1, 1, 0, 0, 1, 0, 1, 1, 1, 0, 1]",218,81,137,12,12,0.14814814814814814,0.08759124087591241
"[0, 0, 1, 1, 0, 0, 1, 0, 1, 0, 1, 0, 1, 1, 1]",188,101,87,12,10,0.1188118811881188,0.11494252873563218
"[0, 1, 1, 1, 1, 0, 0, 0, 0, 0, 1, 0, 0, 1, 0]",205,154,51,12,3,0.07792207792207792,0.058823529411764705
"[1, 1, 0, 1, 1, 0, 0, 0, 0, 1, 1, 1, 0, 0, 0]",147,84,63,9,4,0.10714285714285714,0.06349206349206349
"[0, 1, 0, 1, 0, 0, 1, 0, 1, 1, 0, 0, 1, 0, 0]",141,79,62,7,7,0.08860759493670886,0.11290322580645161
"[0, 1, 0, 1, 1, 1, 0, 1, 0, 1, 0, 0, 1, 0, 1]",109,55,54,3,5,0.05454545454545454,0.09259259259259259
"[1, 1, 0, 0, 1, 0, 1, 1, 1, 1, 1, 0, 0, 0, 0]",181,72,109,8,9,0.1111111111111111,0.08256880733944955
"[1, 0, 0, 1, 1, 1, 0, 1, 1, 1, 0, 1, 1, 0, 1]",223,81,142,3,10,0.037037037037037035,0.07042253521126761
"[0, 1, 1, 1, 1, 0, 1, 0, 0, 0, 0, 0, 1, 0, 0]",168,109,59,15,4,0.13761467889908258,0.06779661016949153
"[1, 0, 1, 1, 1, 1, 0, 1, 0, 0, 0, 0, 0, 1, 0]",111,53,58,5,5,0.09433962264150944,0.08620689655172414
"[0, 0, 0, 1, 0, 1, 1, 0, 1, 0, 1, 1, 1, 1, 1]",208,92,116,6,4,0.06521739130434782,0.034482758620689655
"[1, 1, 1, 1, 0, 0, 1, 1, 0, 1, 1, 1, 0, 0, 0]",231,95,136,7,11,0.07368421052631578,0.08088235294117647
"[1, 0, 1, 1, 1, 1, 0, 0, 0, 1, 0, 0, 0, 1, 1]",132,65,67,5,7,0.07692307692307693,0.1044776119402985
"[1, 0, 1, 0, 1, 1, 0, 0, 0, 1, 1, 0, 1, 1, 1]",159,70,89,5,11,0.07142857142857142,0.12359550561797752
"[0, 1, 1, 0, 0, 0, 1, 0, 1, 0, 1, 1, 0, 0, 0]",188,105,83,6,10,0.05714285714285714,0.12048192771084337
"[0, 1, 0, 1, 1, 0, 0, 0, 1, 0, 1, 1, 0, 1, 0]",132,66,66,3,6,0.045454545454545456,0.09090909090909091
"[1, 0, 0, 0, 1, 0, 0, 1, 0, 0, 0, 1, 1, 0, 1]",146,85,61,4,10,0.047058823529411764,0.16393442622950818
"[0, 0, 1, 0, 1, 1, 1, 1, 1, 1, 1, 0, 1, 1, 0]",255,99,156,8,18,0.08080808080808081,0.11538461538461539
"[1, 0, 1, 1, 1, 0, 0, 1, 1, 0, 0, 1, 0, 0, 0]",125,69,56,12,6,0.17391304347826086,0.10714285714285714
"[1, 0, 1, 0, 0, 0, 0, 1, 0, 1, 0, 0, 0, 0, 1]",278,178,100,12,12,0.06741573033707865,0.12
"[0, 0, 1, 0, 0, 0, 1, 0, 0, 0, 1, 0, 0, 1, 1]",281,195,86,20,12,0.10256410256410256,0.13953488372093023
"[0, 0, 1, 0, 1, 0, 0, 1, 1, 1, 0, 1, 0, 0, 0]",140,87,53,10,3,0.11494252873563218,0.05660377358490566
"[1, 0, 1, 0, 1, 0, 1, 0, 1, 1, 0, 0, 1, 1, 1]",199,92,107,8,9,0.08695652173913043,0.08411214953271028
"[1, 1, 1, 1, 1, 0, 0, 1, 1, 1, 0, 1, 1, 1, 0]",650,152,498,20,39,0.13157894736842105,0.0783132530120482
"[1, 0, 0, 1, 0, 0, 0, 1, 1, 1, 0, 0, 0, 1, 0]",132,70,62,7,8,0.1,0.12903225806451613
"[1, 1, 1, 1, 1, 0, 1, 0, 1, 0, 0, 0, 0, 0, 1]",141,63,78,4,9,0.06349206349206349,0.11538461538461539
"[1, 0, 0, 1, 1, 1, 1, 0, 0, 1, 1, 1, 1, 1, 0]",739,160,579,15,62,0.09375,0.1070811744386874
"[1, 0, 1, 1, 0, 0, 0, 0, 0, 1, 1, 1, 0, 0, 0]",198,110,88,12,8,0.10909090909090909,0.09090909090909091
"[0, 0, 0, 1, 0, 1, 1, 1, 0, 1, 1, 1, 0, 1, 1]",144,69,75,7,6,0.10144927536231885,0.08
"[1, 0, 0, 1, 0, 1, 0, 1, 1, 1, 1, 1, 0, 1, 1]",264,89,175,8,14,0.0898876404494382,0.08
"[1, 1, 0, 0, 1, 0, 0, 0, 1, 1, 0, 0, 1, 1, 0]",190,114,76,6,8,0.05263157894736842,0.10526315789473684
"[0, 0, 0, 0, 0, 1, 1, 1, 1, 1, 0, 1, 1, 1, 1]",384,247,137,25,14,0.10121457489878542,0.10218978102189781
"[0, 1, 0, 1, 0, 1, 1, 0, 0, 1, 0, 1, 0, 1, 0]",100,50,50,4,8,0.08,0.16
"[1, 1, 1, 0, 1, 0, 1, 0, 1, 1, 0, 0, 1, 0, 1]",149,63,86,9,14,0.14285714285714285,0.16279069767441862
"[1, 1, 1, 1, 0, 1, 0, 1, 0, 1, 1, 0, 0, 1, 0]",143,58,85,7,15,0.1206896551724138,0.17647058823529413
"[0, 0, 0, 1, 0, 0, 0, 1, 0, 1, 0, 0, 0, 1, 1]",308,226,82,26,10,0.11504424778761062,0.12195121951219512
"[1, 1, 0, 0, 1, 0, 1, 1, 1, 1, 1, 1, 0, 1, 1]",575,168,407,19,28,0.1130952380952381,0.0687960687960688
"[0, 0, 1, 1, 1, 0, 1, 0, 0, 1, 0, 1, 0, 0, 1]",116,64,52,7,7,0.109375,0.1346153846153846
"[0, 1, 0, 0, 1, 1, 1, 0, 1, 0, 0, 1, 0, 1, 0]",118,69,49,7,9,0.10144927536231885,0.1836734693877551
"[1, 0, 0, 1, 0, 1, 0, 1, 1, 1, 0, 1, 0, 1, 1]",151,59,92,8,10,0.13559322033898305,0.10869565217391304
"[1, 1, 1, 1, 1, 1, 1, 0, 1, 1, 1, 0, 0, 0, 0]",510,139,371,17,26,0.1223021582733813,0.07008086253369272
"[1, 1, 0, 0, 1, 1, 0, 1, 0, 0, 0, 0, 0, 0, 1]",239,132,107,13,12,0.09848484848484848,0.11214953271028037
"[1, 0, 0, 1, 0, 0, 1, 1, 0, 1, 1, 0, 0, 1, 1]",147,67,80,5,8,0.07462686567164178,0.1
"[0, 0, 1, 1, 1, 1, 0, 1, 1, 1, 0, 0, 1, 1, 0]",210,93,117,10,9,0.10752688172043011,0.07692307692307693
"[0, 1, 0, 0, 0, 1, 0, 0, 0, 1, 1, 0, 1, 0, 1]",142,83,59,11,4,0.13253012048192772,0.06779661016949153
"[1, 0, 1, 1, 0, 1, 0, 1, 1, 1, 0, 0, 0, 0, 1]",148,66,82,8,10,0.12121212121212122,0.12195121951219512
"[0, 1, 0, 1, 0, 0, 1, 0, 1, 0, 1, 1, 0, 1, 0]",83,49,34,6,1,0.12244897959183673,0.029411764705882353
"[0, 0, 1, 1, 1, 0, 1, 1, 0, 0, 1, 1, 0, 1, 1]",162,74,88,10,17,0.13513513513513514,0.19318181818181818
"[1, 0, 1, 1, 1, 1, 1, 1, 0, 0, 0, 1, 1, 1, 0]",290,103,187,8,19,0.07766990291262135,0.10160427807486631
"[0, 1, 1, 1, 1, 1, 1, 0, 0, 1, 1, 0, 1, 0, 1]",398,211,187,22,22,0.10426540284360189,0.11764705882352941
"[0, 0, 1, 1, 0, 1, 0, 0, 1, 0, 1, 1, 0, 1, 1]",104,44,60,6,5,0.13636363636363635,0.08333333333333333
"[1, 1, 0, 0, 1, 0, 0, 1, 1, 1, 0, 1, 1, 0, 0]",123,51,72,1,7,0.0196078431372549,0.09722222222222222
"[1, 0, 0, 0, 0, 1, 0, 0, 0, 0, 0, 1, 1, 1, 0]",262,159,103,21,6,0.1320754716981132,0.05825242718446602
"[0, 0, 1, 1, 0, 1, 0, 1, 0, 1, 1, 1, 0, 1, 0]",85,40,45,4,6,0.1,0.13333333333333333
"[0, 0, 1, 0, 0, 1, 1, 1, 0, 1, 1, 1, 1, 0, 0]",162,84,78,6,5,0.07142857142857142,0.0641025641025641
"[0, 1, 1, 0, 0, 0, 0, 0, 1, 0, 0, 1, 1, 1, 0]",168,114,54,12,10,0.10526315789473684,0.18518518518518517
"[0, 0, 0, 0, 0, 1, 0, 0, 1, 1, 0, 1, 0, 1, 1]",161,103,58,8,5,0.07766990291262135,0.08620689655172414
"[0, 1, 0, 1, 1, 0, 0, 0, 1, 1, 1, 0, 1, 1, 0]",118,53,65,2,5,0.03773584905660377,0.07692307692307693
"[0, 1, 1, 1, 0, 0, 0, 0, 1, 0, 0, 0, 1, 0, 1]",130,82,48,9,7,0.10975609756097561,0.14583333333333334
"[1, 0, 1, 0, 1, 0, 1, 0, 0, 0, 1, 1, 0, 1, 1]",120,52,68,4,6,0.07692307692307693,0.08823529411764706
"[1, 1, 1, 0, 1, 0, 1, 0, 1, 0, 1, 0, 0, 0, 1]",113,51,62,4,4,0.0784313725490196,0.06451612903225806
"[1, 0, 1, 1, 0, 1, 1, 0, 0, 0, 0, 0, 1, 1, 1]",210,96,114,11,11,0.11458333333333333,0.09649122807017543
"[0, 1, 1, 0, 1, 1, 0, 0, 0, 1, 0, 0, 1, 1, 1]",142,76,66,4,7,0.05263157894736842,0.10606060606060606
"[1, 1, 0, 1, 0, 1, 0, 0, 1, 0, 0, 0, 0, 1, 1]",154,81,73,4,2,0.04938271604938271,0.0273972602739726
"[1, 1, 0, 1, 1, 1, 1, 0, 1, 0, 1, 0, 0, 1, 0]",137,61,76,5,6,0.08196721311475409,0.07894736842105263
"[0, 1, 0, 1, 0, 1, 1, 0, 1, 1, 1, 1, 1, 0, 0]",171,64,107,7,12,0.109375,0.11214953271028037
"[0, 1, 1, 1, 0, 1, 0, 1, 1, 0, 1, 1, 0, 1, 1]",239,85,154,8,11,0.09411764705882353,0.07142857142857142
"[1, 1, 1, 1, 1, 0, 0, 1, 0, 0, 0, 1, 1, 0, 1]",153,66,87,5,13,0.07575757575757576,0.14942528735632185
"[1, 0, 1, 0, 0, 1, 0, 1, 1, 1, 1, 1, 1, 0, 0]",215,103,112,11,9,0.10679611650485436,0.08035714285714286
"[1, 1, 1, 1, 1, 1, 1, 0, 1, 0, 1, 0, 0, 1, 0]",260,82,178,4,15,0.04878048780487805,0.08426966292134831
"[0, 0, 0, 0, 1, 0, 1, 0, 1, 0, 0, 0, 0, 1, 0]",487,360,127,26,16,0.07222222222222222,0.12598425196850394
"[0, 0, 1, 0, 0, 0, 0, 0, 1, 0, 1, 0, 1, 0, 0]",526,372,154,35,15,0.09408602150537634,0.09740259740259741
"[0, 1, 0, 0, 0, 0, 1, 0, 0, 1, 0, 1, 1, 1, 1]",129,72,57,4,7,0.05555555555555555,0.12280701754385964
"[1, 0, 1, 0, 0, 0, 0, 1, 0, 0, 1, 0, 1, 1, 1]",132,71,61,7,6,0.09859154929577464,0.09836065573770492
"[1, 1, 0, 1, 1, 0, 0, 0, 1, 0, 1, 0, 1, 0, 0]",113,61,52,2,2,0.03278688524590164,0.038461538461538464
"[1, 0, 1, 1, 0, 1, 0, 0, 0, 0, 1, 0, 0, 1, 1]",123,63,60,7,5,0.1111111111111111,0.08333333333333333
"[0, 0, 0, 0, 1, 1, 1, 1, 0, 1, 1, 0, 0, 1, 1]",272,137,135,8,13,0.058394160583941604,0.0962962962962963
"[1, 1, 0, 1, 0, 1, 0, 0, 1, 1, 1, 0, 1, 0, 1]",144,62,82,8,8,0.12903225806451613,0.0975609756097561
"[0, 0, 1, 0, 1, 1, 0, 1, 1, 1, 1, 1, 0, 1, 0]",147,60,87,4,5,0.06666666666666667,0.05747126436781609
"[0, 1, 1, 0, 1, 0, 0, 0, 0, 1, 1, 1, 0, 0, 0]",158,90,68,8,6,0.08888888888888889,0.08823529411764706
"[1, 0, 1, 1, 0, 1, 0, 0, 1, 1, 0, 1, 1, 1, 1]",280,106,174,16,12,0.1509433962264151,0.06896551724137931
"[1, 1, 1, 1, 0, 0, 1, 0, 1, 0, 1, 1, 1, 1, 0]",278,114,164,5,19,0.043859649122807015,0.11585365853658537
"[0, 0, 0, 1, 0, 1, 1, 1, 1, 0, 1, 1, 1, 0, 1]",140,55,85,4,5,0.07272727272727272,0.058823529411764705
"[1, 0, 0, 0, 0, 1, 1, 0, 1, 0, 1, 1, 0, 0, 0]",170,85,85,10,8,0.11764705882352941,0.09411764705882353
"[0, 0, 0, 1, 1, 0, 1, 1, 0, 0, 1, 1, 0, 1, 1]",135,59,76,8,7,0.13559322033898305,0.09210526315789473
"[0, 1, 0, 0, 1, 0, 1, 1, 1, 0, 1, 0, 0, 1, 1]",103,44,59,8,4,0.18181818181818182,0.06779661016949153
"[0, 0, 1, 1, 1, 1, 0, 0, 0, 1, 1, 1, 0, 1, 0]",139,66,73,7,6,0.10606060606060606,0.0821917808219178
"[1, 0, 0, 1, 1, 1, 1, 0, 0, 0, 1, 1, 1, 0, 1]",201,57,144,5,22,0.08771929824561403,0.1527777777777778
"[0, 1, 1, 0, 1, 0, 0, 0, 0, 1, 1, 1, 0, 1, 1]",122,59,63,6,4,0.1016949152542373,0.06349206349206349
"[1, 1, 0, 1, 0, 1, 0, 1, 1, 0, 1, 0, 0, 0, 0]",120,64,56,8,0,0.125,0.0
"[1, 1, 1, 1, 0, 0, 1, 1, 1, 1, 1, 0, 0, 1, 0]",383,136,247,6,18,0.04411764705882353,0.0728744939271255
"[1, 1, 1, 1, 0, 0, 0, 0, 1, 1, 0, 1, 1, 0, 1]",284,105,179,7,16,0.06666666666666667,0.0893854748603352
"[0, 0, 1, 0, 1, 1, 1, 1, 0, 0, 1, 0, 0, 0, 0]",180,101,79,13,4,0.12871287128712872,0.05063291139240506
"[0, 0, 1, 0, 1, 1, 1, 1, 1, 0, 0, 1, 1, 0, 0]",302,145,157,16,9,0.1103448275862069,0.05732484076433121
"[1, 0, 1, 0, 0, 0, 1, 1, 1, 0, 0, 1, 1, 0, 1]",119,56,63,7,7,0.125,0.1111111111111111
"[1, 0, 1, 1, 1, 0, 1, 1, 0, 1, 1, 0, 0, 1, 0]",129,48,81,6,7,0.125,0.08641975308641975
"[1, 0, 0, 0, 1, 0, 0, 1, 1, 1, 0, 0, 1, 0, 0]",130,72,58,13,5,0.18055555555555555,0.08620689655172414
"[0, 1, 1, 0, 0, 1, 1, 0, 1, 1, 1, 1, 0, 0, 0]",174,92,82,8,6,0.08695652173913043,0.07317073170731707
"[1, 0, 1, 0, 0, 1, 0, 0, 0, 1, 0, 1, 1, 1, 0]",116,65,51,4,6,0.06153846153846154,0.11764705882352941
"[0, 0, 1, 1, 1, 1, 0, 1, 0, 1, 0, 0, 1, 0, 0]",113,55,58,7,3,0.12727272727272726,0.05172413793103448
"[0, 0, 1, 1, 1, 1, 1, 0, 0, 1, 1, 1, 1, 0, 1]",312,120,192,13,14,0.10833333333333334,0.07291666666666667
"[0, 1, 0, 0, 0, 1, 1, 1, 1, 1, 0, 0, 1, 1, 1]",278,136,142,7,13,0.051470588235294115,0.09154929577464789
"[0, 0, 0, 1, 0, 1, 0, 0, 0, 0, 0, 1, 0, 1, 0]",483,345,138,24,12,0.06956521739130435,0.08695652173913043
"[0, 0, 0, 1, 1, 1, 0, 1, 1, 0, 1, 0, 0, 0, 1]",124,62,62,4,6,0.06451612903225806,0.0967741935483871
"[0, 0, 1, 0, 1, 1, 0, 1, 0, 0, 1, 1, 1, 0, 0]",113,60,53,5,9,0.08333333333333333,0.16981132075471697
"[1, 0, 0, 0, 1, 0, 0, 0, 0, 1, 0, 0, 0, 0, 1]",579,397,182,29,26,0.07304785894206549,0.14285714285714285
"[0, 0, 0, 1, 1, 1, 1, 1, 1, 0, 1, 0, 1, 0, 1]",184,99,85,9,6,0.09090909090909091,0.07058823529411765
"[0, 0, 1, 0, 0, 0, 0, 1, 1, 0, 0, 1, 0, 1, 0]",271,178,93,20,11,0.11235955056179775,0.11827956989247312
"[1, 1, 1, 0, 0, 1, 1, 1, 0, 0, 0, 1, 0, 0, 1]",136,49,87,1,6,0.02040816326530612,0.06896551724137931
"[0, 1, 1, 0, 0, 1, 0, 1, 1, 1, 0, 0, 0, 1, 0]",115,62,53,6,6,0.0967741935483871,0.11320754716981132
"[1, 0, 0, 0, 0, 0, 0, 0, 1, 0, 0, 0, 1, 1, 1]",581,309,272,39,25,0.1262135922330097,0.09191176470588236
"[0, 1, 1, 0, 0, 0, 1, 0, 0, 1, 0, 0, 1, 0, 1]",137,78,59,7,5,0.08974358974358974,0.0847457627118644
"[1, 1, 0, 0, 0, 1, 0, 0, 1, 1, 0, 0, 1, 1, 0]",189,100,89,12,9,0.12,0.10112359550561797
"[0, 0, 1, 0, 1, 1, 1, 0, 0, 1, 0, 0, 1, 1, 1]",162,81,81,8,5,0.09876543209876543,0.06172839506172839
"[0, 0, 1, 0, 0, 1, 1, 1, 1, 0, 1, 0, 0, 0, 1]",127,66,61,5,11,0.07575757575757576,0.18032786885245902
"[0, 1, 1, 1, 1, 0, 0, 0, 1, 1, 0, 1, 0, 0, 0]",145,76,69,8,4,0.10526315789473684,0.057971014492753624
"[0, 0, 0, 0, 0, 1, 1, 0, 1, 1, 0, 1, 1, 0, 1]",130,82,48,10,4,0.12195121951219512,0.08333333333333333
"[0, 0, 1, 1, 1, 1, 0, 0, 0, 0, 1, 0, 1, 0, 1]",211,106,105,6,9,0.05660377358490566,0.08571428571428572
"[0, 1, 0, 0, 1, 0, 0, 0, 1, 1, 0, 0, 0, 1, 1]",207,119,88,11,7,0.09243697478991597,0.07954545454545454
"[0, 1, 1, 1, 1, 0, 1, 0, 1, 1, 0, 1, 0, 0, 1]",140,68,72,8,7,0.11764705882352941,0.09722222222222222
"[1, 1, 0, 1, 1, 1, 1, 0, 1, 0, 1, 1, 0, 1, 0]",214,78,136,9,15,0.11538461538461539,0.11029411764705882
"[0, 1, 1, 1, 0, 0, 0, 0, 1, 1, 1, 0, 1, 0, 1]",136,71,65,5,11,0.07042253521126761,0.16923076923076924
"[0, 0, 0, 1, 0, 0, 1, 1, 1, 0, 0, 1, 1, 1, 0]",136,68,68,3,7,0.04411764705882353,0.10294117647058823
"[0, 1, 1, 0, 1, 1, 1, 0, 1, 0, 0, 1, 1, 0, 0]",155,66,89,3,12,0.045454545454545456,0.1348314606741573
"[1, 1, 0, 0, 0, 1, 0, 1, 1, 0, 1, 1, 1, 0, 1]",126,50,76,4,5,0.08,0.06578947368421052
"[0, 1, 1, 1, 0, 1, 1, 0, 0, 0, 1, 0, 1, 1, 0]",100,53,47,2,6,0.03773584905660377,0.1276595744680851
"[1, 0, 1, 0, 0, 0, 1, 0, 1, 1, 1, 0, 1, 1, 0]",105,44,61,5,5,0.11363636363636363,0.08196721311475409
"[1, 0, 1, 1, 1, 1, 1, 1, 0, 1, 1, 0, 1, 0, 1]",480,142,338,16,33,0.11267605633802817,0.09763313609467456
"[0, 1, 1, 1, 0, 0, 0, 0, 1, 0, 0, 1, 1, 1, 0]",114,54,60,2,6,0.037037037037037035,0.1
"[0, 0, 1, 0, 1, 1, 1, 0, 0, 1, 1, 1, 1, 0, 0]",280,145,135,11,14,0.07586206896551724,0.1037037037037037
"[1, 1, 1, 1, 0, 0, 0, 0, 1, 1, 0, 0, 1, 0, 0]",337,181,156,24,18,0.13259668508287292,0.11538461538461539
"[1, 0, 1, 0, 1, 0, 1, 0, 1, 0, 1, 0, 0, 0, 0]",143,86,57,10,2,0.11627906976744186,0.03508771929824561
"[0, 0, 1, 0, 0, 1, 0, 1, 1, 0, 0, 1, 0, 0, 0]",213,137,76,16,8,0.11678832116788321,0.10526315789473684
"[1, 0, 1, 0, 0, 0, 1, 0, 1, 1, 1, 0, 0, 0, 0]",160,92,68,9,9,0.09782608695652174,0.1323529411764706
"[0, 0, 1, 1, 0, 0, 1, 0, 0, 1, 0, 0, 1, 0, 1]",126,65,61,6,8,0.09230769230769231,0.13114754098360656
"[0, 0, 0, 0, 1, 0, 0, 0, 1, 1, 1, 0, 1, 0, 0]",227,142,85,16,8,0.11267605633802817,0.09411764705882353
"[0, 1, 0, 0, 0, 1, 0, 0, 0, 1, 0, 1, 1, 0, 0]",264,156,108,8,11,0.05128205128205128,0.10185185185185185
"[1, 0, 1, 1, 1, 1, 0, 1, 1, 0, 0, 1, 1, 0, 0]",241,95,146,7,13,0.07368421052631578,0.08904109589041095
"[1, 0, 1, 0, 0, 0, 1, 1, 0, 0, 1, 1, 0, 0, 1]",262,124,138,7,14,0.056451612903225805,0.10144927536231885
"[1, 1, 1, 0, 0, 0, 1, 1, 1, 0, 1, 1, 1, 0, 1]",259,85,174,3,13,0.03529411764705882,0.07471264367816093
"[1, 0, 1, 1, 0, 0, 0, 1, 1, 0, 0, 1, 0, 0, 1]",131,59,72,6,9,0.1016949152542373,0.125
"[1, 1, 1, 1, 0, 0, 0, 1, 1, 0, 0, 0, 1, 1, 1]",292,129,163,12,20,0.09302325581395349,0.12269938650306748
"[1, 0, 1, 1, 0, 0, 1, 0, 1, 0, 1, 0, 0, 0, 0]",178,87,91,7,9,0.08045977011494253,0.0989010989010989
"[0, 1, 1, 0, 1, 1, 1, 1, 1, 0, 0, 0, 0, 0, 0]",290,162,128,12,13,0.07407407407407407,0.1015625
"[0, 0, 0, 1, 1, 0, 1, 0, 1, 0, 0, 0, 1, 1, 0]",135,87,48,8,3,0.09195402298850575,0.0625
"[0, 1, 1, 1, 1, 1, 1, 0, 0, 0, 0, 1, 1, 1, 0]",413,257,156,27,11,0.10505836575875487,0.07051282051282051
"[1, 0, 0, 0, 0, 0, 1, 1, 1, 1, 0, 1, 0, 1, 1]",172,65,107,8,11,0.12307692307692308,0.102803738317757
"[1, 1, 0, 1, 1, 0, 0, 0, 1, 0, 0, 1, 0, 1, 1]",138,72,66,11,4,0.1527777777777778,0.06060606060606061
"[0, 0, 0, 0, 1, 1, 1, 1, 1, 0, 0, 1, 0, 1, 1]",226,129,97,13,8,0.10077519379844961,0.08247422680412371
"[0, 1, 0, 1, 1, 1, 1, 1, 1, 1, 0, 1, 0, 1, 0]",223,71,152,7,19,0.09859154929577464,0.125
"[1, 1, 0, 0, 1, 0, 0, 1, 1, 0, 0, 0, 1, 0, 1]",120,66,54,5,6,0.07575757575757576,0.1111111111111111
"[0, 1, 1, 0, 1, 0, 1, 1, 0, 0, 0, 1, 0, 0, 0]",145,97,48,5,6,0.05154639175257732,0.125
"[0, 1, 0, 0, 0, 0, 0, 0, 1, 0, 1, 1, 1, 1, 1]",203,110,93,7,10,0.06363636363636363,0.10752688172043011
"[0, 0, 0, 1, 0, 0, 1, 1, 0, 0, 1, 1, 1, 1, 0]",292,190,102,25,8,0.13157894736842105,0.0784313725490196
"[1, 1, 0, 1, 0, 0, 1, 0, 0, 0, 0, 1, 0, 1, 0]",136,83,53,10,4,0.12048192771084337,0.07547169811320754
"[1, 1, 0, 0, 0, 1, 0, 0, 0, 1, 0, 1, 0, 0, 0]",248,145,103,14,9,0.09655172413793103,0.08737864077669903
"[0, 0, 1, 0, 0, 1, 1, 1, 0, 1, 1, 0, 0, 0, 0]",179,100,79,8,11,0.08,0.13924050632911392
"[0, 0, 1, 1, 1, 1, 0, 0, 1, 1, 1, 0, 1, 0, 1]",256,115,141,10,13,0.08695652173913043,0.09219858156028368
"[1, 1, 1, 0, 0, 1, 0, 0, 1, 0, 1, 0, 0, 0, 1]",122,66,56,6,5,0.09090909090909091,0.08928571428571429
"[0, 1, 0, 0, 1, 1, 1, 0, 1, 1, 1, 1, 1, 0, 1]",224,83,141,9,11,0.10843373493975904,0.07801418439716312
"[0, 0, 1, 1, 0, 1, 1, 0, 1, 0, 0, 0, 1, 0, 0]",148,91,57,8,10,0.08791208791208792,0.17543859649122806
"[1, 0, 1, 0, 1, 1, 1, 0, 0, 0, 0, 1, 1, 1, 1]",385,153,232,18,26,0.11764705882352941,0.11206896551724138
"[0, 0, 1, 0, 0, 1, 0, 0, 1, 0, 1, 0, 1, 0, 0]",214,141,73,18,7,0.1276595744680851,0.0958904109589041
"[0, 1, 1, 1, 1, 0, 0, 0, 1, 0, 0, 1, 1, 0, 0]",184,116,68,8,8,0.06896551724137931,0.11764705882352941
"[1, 0, 1, 1, 1, 1, 1, 1, 0, 0, 1, 0, 0, 1, 0]",142,65,77,2,9,0.03076923076923077,0.11688311688311688
"[1, 0, 1, 1, 0, 0, 1, 0, 1, 1, 1, 1, 1, 0, 0]",170,73,97,6,6,0.0821917808219178,0.061855670103092786
"[0, 1, 1, 1, 1, 1, 0, 1, 1, 0, 0, 1, 0, 1, 1]",240,103,137,9,12,0.08737864077669903,0.08759124087591241
"[1, 1, 0, 1, 1, 1, 1, 0, 1, 1, 0, 0, 1, 1, 0]",299,120,179,15,15,0.125,0.08379888268156424
"[1, 0, 1, 1, 1, 1, 0, 0, 1, 0, 1, 0, 1, 1, 1]",308,116,192,8,18,0.06896551724137931,0.09375
"[0, 1, 1, 0, 0, 1, 0, 1, 0, 1, 0, 1, 0, 0, 1]",126,75,51,11,9,0.14666666666666667,0.17647058823529413
"[0, 1, 1, 1, 1, 1, 1, 0, 0, 0, 0, 0, 1, 1, 1]",554,372,182,39,20,0.10483870967741936,0.10989010989010989
"[1, 1, 0, 1, 1, 1, 1, 0, 0, 0, 0, 0, 1, 1, 1]",272,97,175,8,12,0.08247422680412371,0.06857142857142857
"[1, 1, 1, 1, 1, 0, 0, 1, 0, 0, 1, 0, 0, 0, 0]",153,57,96,8,9,0.14035087719298245,0.09375
"[0, 1, 0, 0, 1, 1, 1, 0, 0, 1, 1, 0, 1, 1, 1]",174,81,93,7,5,0.08641975308641975,0.053763440860215055
"[1, 0, 0, 1, 0, 1, 0, 1, 1, 1, 0, 0, 0, 0, 0]",215,125,90,12,11,0.096,0.12222222222222222
"[1, 0, 1, 1, 1, 1, 1, 1, 0, 0, 0, 0, 1, 0, 0]",142,68,74,7,14,0.10294117647058823,0.1891891891891892
"[1, 1, 0, 0, 1, 0, 0, 1, 0, 0, 1, 0, 0, 1, 0]",129,79,50,4,2,0.05063291139240506,0.04
"[1, 1, 1, 0, 0, 1, 0, 0, 0, 0, 1, 0, 1, 1, 1]",160,76,84,4,6,0.05263157894736842,0.07142857142857142
"[0, 0, 0, 1, 0, 0, 1, 0, 0, 1, 1, 1, 1, 0, 1]",125,68,57,4,3,0.058823529411764705,0.05263157894736842
"[1, 0, 1, 0, 0, 0, 1, 0, 0, 1, 0, 0, 1, 1, 1]",124,68,56,6,6,0.08823529411764706,0.10714285714285714
"[1, 1, 0, 1, 0, 1, 0, 0, 1, 1, 1, 1, 0, 1, 0]",136,60,76,11,5,0.18333333333333332,0.06578947368421052
"[1, 0, 1, 0, 1, 0, 0, 0, 1, 1, 0, 1, 0, 1, 1]",101,50,51,5,4,0.1,0.0784313725490196
"[1, 0, 1, 0, 0, 1, 1, 0, 1, 1, 1, 0, 0, 0, 1]",116,50,66,10,5,0.2,0.07575757575757576
"[1, 0, 1, 1, 0, 0, 1, 1, 0, 1, 1, 1, 1, 1, 0]",280,95,185,8,17,0.08421052631578947,0.0918918918918919
"[1, 0, 1, 1, 0, 1, 0, 0, 0, 1, 0, 0, 0, 1, 1]",153,91,62,9,3,0.0989010989010989,0.04838709677419355
"[0, 1, 1, 0, 0, 1, 1, 0, 1, 1, 1, 0, 0, 0, 0]",176,104,72,10,6,0.09615384615384616,0.08333333333333333
"[0, 0, 1, 0, 1, 1, 0, 0, 1, 1, 0, 1, 1, 1, 0]",120,61,59,8,5,0.13114754098360656,0.0847457627118644
"[0, 0, 0, 1, 1, 0, 1, 1, 1, 0, 1, 0, 1, 1, 1]",189,101,88,11,8,0.10891089108910891,0.09090909090909091
"[0, 1, 1, 1, 1, 1, 1, 1, 0, 1, 0, 1, 0, 0, 1]",274,127,147,14,17,0.11023622047244094,0.11564625850340136
"[1, 1, 0, 1, 0, 1, 1, 1, 1, 0, 1, 1, 1, 1, 0]",534,158,376,11,34,0.06962025316455696,0.09042553191489362
"[1, 0, 1, 0, 1, 1, 1, 0, 0, 1, 1, 1, 1, 0, 1]",237,89,148,7,14,0.07865168539325842,0.0945945945945946
"[0, 0, 0, 1, 1, 0, 1, 0, 0, 0, 1, 0, 1, 1, 1]",164,113,51,8,4,0.07079646017699115,0.0784313725490196
"[0, 1, 0, 1, 1, 0, 0, 0, 1, 1, 0, 1, 0, 0, 0]",128,79,49,10,3,0.12658227848101267,0.061224489795918366
"[1, 0, 1, 0, 0, 0, 0, 0, 1, 1, 1, 0, 0, 1, 1]",184,100,84,6,4,0.06,0.047619047619047616
"[0, 0, 0, 1, 1, 0, 1, 1, 0, 1, 0, 0, 0, 0, 0]",299,207,92,15,9,0.07246376811594203,0.09782608695652174
"[1, 1, 0, 1, 1, 0, 0, 0, 0, 1, 0, 0, 0, 1, 0]",139,69,70,8,6,0.11594202898550725,0.08571428571428572
"[1, 0, 0, 1, 1, 1, 0, 0, 1, 1, 1, 1, 0, 1, 1]",281,93,188,8,14,0.08602150537634409,0.07446808510638298
"[1, 0, 1, 0, 1, 0, 1, 1, 1, 1, 1, 0, 0, 1, 1]",352,121,231,10,27,0.08264462809917356,0.11688311688311688
"[0, 0, 0, 0, 1, 1, 0, 0, 1, 0, 1, 0, 1, 0, 1]",183,109,74,11,8,0.10091743119266056,0.10810810810810811
"[0, 1, 0, 0, 1, 0, 0, 1, 0, 0, 0, 0, 0, 0, 1]",566,400,166,33,12,0.0825,0.07228915662650602
"[0, 1, 0, 0, 0, 0, 0, 0, 1, 0, 0, 1, 0, 0, 1]",553,397,156,35,18,0.08816120906801007,0.11538461538461539
"[0, 0, 0, 0, 0, 1, 1, 1, 0, 1, 0, 0, 1, 0, 0]",276,177,99,15,8,0.0847457627118644,0.08080808080808081
"[0, 1, 1, 1, 0, 0, 0, 0, 1, 1, 1, 1, 0, 1, 1]",225,111,114,11,12,0.0990990990990991,0.10526315789473684
"[1, 1, 1, 1, 0, 0, 0, 1, 1, 1, 0, 0, 0, 1, 0]",145,71,74,6,10,0.08450704225352113,0.13513513513513514
"[0, 0, 0, 0, 0, 1, 1, 1, 0, 0, 0, 1, 1, 1, 0]",237,168,69,12,6,0.07142857142857142,0.08695652173913043
"[0, 0, 0, 1, 0, 1, 0, 0, 1, 0, 0, 0, 1, 0, 1]",213,134,79,15,6,0.11194029850746269,0.0759493670886076
"[1, 0, 0, 0, 1, 0, 1, 0, 0, 1, 0, 0, 0, 1, 0]",213,144,69,12,3,0.08333333333333333,0.043478260869565216
"[1, 1, 0, 0, 0, 1, 0, 1, 0, 0, 1, 0, 0, 0, 1]",162,97,65,6,3,0.061855670103092786,0.046153846153846156
"[0, 1, 1, 0, 1, 0, 0, 0, 0, 1, 1, 0, 0, 0, 1]",176,111,65,9,7,0.08108108108108109,0.1076923076923077
"[0, 0, 1, 1, 0, 1, 0, 0, 0, 0, 1, 1, 0, 0, 0]",407,258,149,28,14,0.10852713178294573,0.09395973154362416
"[0, 1, 1, 0, 1, 1, 1, 0, 0, 0, 1, 1, 0, 0, 0]",156,81,75,9,8,0.1111111111111111,0.10666666666666667
"[0, 1, 1, 0, 1, 1, 1, 1, 0, 1, 0, 1, 1, 1, 0]",240,85,155,14,18,0.16470588235294117,0.11612903225806452
"[1, 1, 0, 1, 1, 1, 0, 1, 0, 1, 0, 1, 0, 0, 1]",140,60,80,8,4,0.13333333333333333,0.05
"[0, 1, 1, 0, 0, 0, 0, 1, 1, 0, 1, 1, 0, 1, 1]",205,137,68,10,4,0.072992700729927,0.058823529411764705
"[0, 1, 1, 0, 1, 1, 0, 0, 0, 0, 1, 1, 0, 1, 1]",160,73,87,6,11,0.0821917808219178,0.12643678160919541
"[1, 1, 1, 0, 1, 1, 0, 1, 0, 1, 1, 0, 1, 1, 0]",246,87,159,8,11,0.09195402298850575,0.06918238993710692
"[1, 0, 1, 1, 0, 1, 1, 1, 0, 1, 1, 0, 1, 0, 0]",120,45,75,4,4,0.08888888888888889,0.05333333333333334
"[0, 1, 0, 1, 1, 0, 1, 1, 0, 1, 1, 0, 1, 1, 1]",219,83,136,4,10,0.04819277108433735,0.07352941176470588
"[0, 1, 0, 1, 1, 0, 1, 1, 1, 1, 0, 1, 0, 1, 1]",248,89,159,10,15,0.11235955056179775,0.09433962264150944
"[1, 1, 1, 0, 0, 1, 1, 1, 1, 0, 1, 1, 0, 1, 0]",272,90,182,10,17,0.1111111111111111,0.09340659340659341
"[1, 0, 0, 1, 1, 1, 0, 1, 0, 0, 1, 0, 0, 1, 1]",133,55,78,2,13,0.03636363636363636,0.16666666666666666
"[0, 0, 0, 1, 0, 0, 0, 1, 1, 1, 1, 1, 1, 0, 0]",335,203,132,18,9,0.08866995073891626,0.06818181818181818
"[1, 0, 1, 0, 1, 0, 0, 0, 0, 0, 0, 0, 1, 0, 0]",539,369,170,32,18,0.08672086720867209,0.10588235294117647
"[1, 0, 0, 0, 1, 1, 0, 0, 0, 1, 0, 1, 0, 1, 0]",154,102,52,7,6,0.06862745098039216,0.11538461538461539
"[1, 0, 0, 0, 1, 0, 0, 0, 0, 1, 1, 1, 1, 1, 1]",308,147,161,13,20,0.08843537414965986,0.12422360248447205
"[0, 1, 0, 1, 1, 1, 1, 1, 1, 1, 0, 0, 0, 0, 0]",353,156,197,16,18,0.10256410256410256,0.09137055837563451
"[0, 0, 1, 0, 1, 0, 1, 1, 1, 1, 1, 1, 1, 0, 0]",245,124,121,12,10,0.0967741935483871,0.08264462809917356
"[1, 1, 1, 1, 0, 0, 1, 1, 1, 0, 1, 0, 1, 0, 1]",299,110,189,8,18,0.07272727272727272,0.09523809523809523
"[1, 0, 1, 1, 1, 1, 0, 0, 0, 1, 1, 0, 0, 0, 1]",148,70,78,6,10,0.08571428571428572,0.1282051282051282
"[0, 0, 1, 1, 1, 1, 0, 0, 1, 0, 1, 0, 0, 0, 0]",238,138,100,8,17,0.057971014492753624,0.17
"[0, 0, 1, 1, 0, 1, 0, 0, 1, 0, 1, 1, 1, 1, 1]",230,85,145,6,17,0.07058823529411765,0.11724137931034483
"[1, 0, 0, 0, 0, 1, 1, 0, 1, 0, 0, 1, 0, 1, 1]",148,66,82,6,4,0.09090909090909091,0.04878048780487805
"[1, 0, 0, 1, 0, 0, 0, 0, 0, 0, 1, 0, 0, 1, 1]",351,217,134,25,18,0.1152073732718894,0.13432835820895522
"[1, 1, 1, 1, 1, 0, 1, 0, 1, 0, 0, 0, 1, 1, 1]",341,114,227,6,21,0.05263157894736842,0.09251101321585903
"[1, 0, 0, 0, 1, 1, 0, 1, 0, 0, 1, 1, 0, 1, 1]",110,48,62,4,11,0.08333333333333333,0.1774193548387097
"[1, 1, 1, 0, 0, 0, 1, 1, 0, 1, 0, 0, 1, 1, 0]",109,52,57,2,6,0.038461538461538464,0.10526315789473684
"[0, 0, 0, 1, 1, 0, 0, 0, 0, 1, 0, 1, 1, 0, 0]",334,223,111,23,11,0.1031390134529148,0.0990990990990991
"[1, 1, 1, 1, 0, 0, 0, 0, 1, 0, 1, 1, 0, 0, 0]",191,107,84,10,9,0.09345794392523364,0.10714285714285714
"[1, 1, 1, 1, 1, 1, 0, 0, 0, 0, 1, 0, 1, 1, 0]",257,108,149,10,14,0.09259259259259259,0.09395973154362416
"[1, 0, 1, 1, 1, 1, 1, 1, 0, 0, 0, 0, 1, 0, 1]",169,63,106,2,8,0.031746031746031744,0.07547169811320754
"[1, 0, 0, 1, 0, 0, 0, 0, 1, 1, 1, 0, 1, 1, 1]",148,67,81,5,9,0.07462686567164178,0.1111111111111111
"[1, 0, 1, 1, 1, 0, 0, 0, 0, 1, 0, 0, 1, 0, 0]",148,88,60,8,6,0.09090909090909091,0.1
"[0, 1, 1, 0, 1, 1, 0, 1, 1, 1, 1, 0, 1, 0, 0]",135,51,84,8,11,0.1568627450980392,0.13095238095238096
"[0, 0, 1, 1, 0, 0, 0, 0, 0, 0, 1, 0, 1, 1, 0]",373,245,128,21,7,0.08571428571428572,0.0546875
"[0, 1, 0, 0, 1, 1, 1, 0, 0, 0, 1, 1, 0, 0, 0]",185,107,78,16,10,0.14953271028037382,0.1282051282051282
"[0, 0, 0, 0, 1, 0, 1, 0, 0, 0, 1, 1, 1, 0, 0]",273,160,113,13,16,0.08125,0.1415929203539823
"[1, 0, 0, 1, 0, 1, 0, 0, 1, 0, 1, 1, 0, 1, 0]",116,64,52,3,7,0.046875,0.1346153846153846
"[0, 1, 0, 0, 0, 1, 0, 1, 0, 0, 0, 0, 0, 0, 1]",566,400,166,36,18,0.09,0.10843373493975904
"[0, 1, 0, 0, 0, 1, 1, 0, 1, 0, 0, 0, 1, 1, 1]",130,74,56,11,5,0.14864864864864866,0.08928571428571429
"[1, 0, 1, 1, 0, 0, 0, 1, 0, 0, 1, 0, 0, 0, 0]",280,185,95,16,7,0.08648648648648649,0.07368421052631578
"[1, 0, 1, 0, 1, 1, 0, 0, 0, 1, 0, 0, 1, 0, 0]",139,80,59,8,7,0.1,0.11864406779661017
"[0, 1, 0, 1, 1, 0, 1, 0, 1, 0, 1, 1, 0, 1, 0]",92,47,45,3,5,0.06382978723404255,0.1111111111111111
"[1, 0, 1, 0, 1, 0, 0, 1, 1, 1, 1, 0, 1, 0, 0]",116,48,68,2,8,0.041666666666666664,0.11764705882352941
"[0, 0, 1, 1, 1, 0, 1, 0, 1, 0, 1, 0, 1, 1, 0]",117,60,57,5,9,0.08333333333333333,0.15789473684210525
"[0, 0, 1, 0, 0, 1, 1, 1, 0, 1, 1, 1, 0, 0, 0]",142,69,73,8,7,0.11594202898550725,0.0958904109589041
"[0, 0, 0, 1, 0, 0, 1, 1, 1, 1, 0, 0, 0, 0, 1]",341,218,123,20,21,0.09174311926605505,0.17073170731707318
"[1, 0, 1, 0, 0, 0, 1, 0, 0, 1, 1, 1, 1, 0, 0]",170,83,87,6,8,0.07228915662650602,0.09195402298850575
"[1, 1, 0, 1, 0, 0, 0, 1, 0, 0, 1, 1, 1, 1, 0]",157,83,74,9,7,0.10843373493975904,0.0945945945945946
"[1, 1, 0, 0, 1, 1, 1, 1, 0, 0, 1, 0, 0, 0, 1]",186,95,91,7,11,0.07368421052631578,0.12087912087912088
"[1, 1, 1, 1, 0, 1, 1, 0, 1, 0, 1, 1, 1, 0, 0]",304,123,181,12,11,0.0975609756097561,0.06077348066298342
"[1, 1, 0, 1, 1, 0, 0, 0, 1, 1, 1, 0, 1, 1, 0]",153,51,102,6,12,0.11764705882352941,0.11764705882352941
"[1, 1, 1, 1, 0, 0, 0, 1, 1, 0, 1, 1, 0, 1, 1]",298,92,206,12,21,0.13043478260869565,0.10194174757281553
"[1, 0, 0, 0, 1, 0, 0, 1, 0, 1, 1, 1, 1, 0, 0]",149,74,75,10,10,0.13513513513513514,0.13333333333333333
"[1, 1, 1, 0, 0, 1, 0, 1, 1, 1, 1, 0, 0, 0, 0]",239,102,137,13,10,0.12745098039215685,0.072992700729927
"[0, 0, 1, 0, 1, 1, 1, 0, 0, 0, 1, 0, 0, 0, 1]",150,90,60,8,10,0.08888888888888889,0.16666666666666666
"[1, 0, 1, 0, 0, 1, 0, 1, 0, 0, 0, 0, 1, 0, 1]",128,73,55,5,4,0.0684931506849315,0.07272727272727272
"[0, 0, 0, 1, 0, 1, 0, 0, 1, 1, 1, 1, 0, 0, 1]",226,126,100,10,12,0.07936507936507936,0.12
"[1, 0, 0, 1, 1, 1, 1, 0, 0, 1, 0, 1, 1, 1, 0]",187,61,126,10,14,0.16393442622950818,0.1111111111111111
"[1, 0, 0, 1, 0, 0, 0, 0, 0, 1, 1, 1, 1, 1, 0]",155,78,77,8,6,0.10256410256410256,0.07792207792207792
"[0, 1, 1, 0, 1, 1, 0, 0, 0, 0, 1, 0, 0, 1, 0]",142,75,67,8,7,0.10666666666666667,0.1044776119402985
"[0, 0, 1, 1, 0, 1, 1, 0, 0, 0, 0, 1, 0, 0, 1]",141,87,54,7,8,0.08045977011494253,0.14814814814814814
"[1, 0, 0, 1, 0, 1, 1, 1, 0, 1, 1, 1, 1, 0, 0]",160,72,88,6,7,0.08333333333333333,0.07954545454545454
"[0, 1, 0, 0, 0, 0, 1, 0, 0, 1, 1, 0, 0, 0, 1]",255,174,81,21,11,0.1206896551724138,0.13580246913580246
"[0, 0, 0, 1, 0, 0, 0, 0, 1, 0, 0, 1, 1, 0, 0]",700,501,199,49,23,0.09780439121756487,0.11557788944723618
"[1, 0, 0, 0, 1, 0, 1, 0, 0, 1, 0, 1, 0, 0, 1]",134,79,55,7,5,0.08860759493670886,0.09090909090909091
"[1, 0, 0, 1, 1, 0, 0, 0, 1, 0, 1, 0, 0, 1, 0]",139,75,64,7,4,0.09333333333333334,0.0625
"[0, 0, 0, 0, 0, 1, 0, 0, 0, 1, 1, 1, 1, 0, 0]",517,347,170,32,19,0.09221902017291066,0.11176470588235295
"[1, 1, 1, 0, 0, 0, 1, 1, 0, 1, 1, 0, 0, 0, 1]",114,46,68,4,5,0.08695652173913043,0.07352941176470588
"[0, 1, 0, 0, 0, 0, 0, 1, 0, 1, 0, 0, 0, 1, 1]",306,213,93,13,6,0.06103286384976526,0.06451612903225806
"[1, 0, 0, 1, 0, 0, 0, 1, 1, 1, 1, 0, 1, 1, 1]",185,67,118,6,9,0.08955223880597014,0.07627118644067797
"[1, 1, 1, 1, 0, 1, 1, 0, 1, 1, 0, 1, 0, 0, 1]",219,60,159,3,12,0.05,0.07547169811320754
"[1, 0, 0, 1, 0, 1, 0, 0, 0, 1, 0, 0, 1, 0, 1]",145,89,56,10,2,0.11235955056179775,0.03571428571428571
"[0, 1, 1, 0, 1, 1, 0, 0, 1, 0, 1, 1, 0, 1, 0]",94,44,50,1,3,0.022727272727272728,0.06
"[0, 1, 1, 1, 0, 1, 0, 0, 0, 0, 0, 1, 0, 1, 1]",117,63,54,7,6,0.1111111111111111,0.1111111111111111
"[1, 1, 1, 1, 1, 0, 1, 1, 1, 0, 1, 0, 0, 0, 0]",204,78,126,9,9,0.11538461538461539,0.07142857142857142
"[1, 1, 0, 1, 1, 1, 1, 1, 0, 1, 0, 0, 1, 1, 0]",256,90,166,8,14,0.08888888888888889,0.08433734939759036
"[0, 0, 0, 0, 1, 1, 0, 1, 1, 0, 0, 1, 0, 0, 1]",165,101,64,11,6,0.10891089108910891,0.09375
"[1, 1, 1, 0, 0, 1, 1, 1, 0, 0, 0, 0, 0, 0, 0]",321,150,171,16,16,0.10666666666666667,0.0935672514619883
"[0, 1, 0, 1, 0, 1, 0, 0, 0, 0, 0, 1, 0, 1, 1]",148,88,60,10,7,0.11363636363636363,0.11666666666666667
"[1, 0, 0, 1, 1, 1, 0, 1, 0, 1, 0, 0, 0, 1, 1]",138,53,85,8,8,0.1509433962264151,0.09411764705882353
"[1, 0, 1, 0, 1, 0, 1, 0, 1, 1, 0, 1, 0, 1, 0]",111,48,63,7,3,0.14583333333333334,0.047619047619047616
"[1, 0, 1, 0, 1, 0, 1, 0, 1, 0, 1, 1, 0, 1, 0]",107,50,57,4,8,0.08,0.14035087719298245
"[0, 1, 1, 0, 0, 1, 0, 1, 1, 1, 0, 1, 1, 1, 1]",313,135,178,10,18,0.07407407407407407,0.10112359550561797
"[0, 0, 0, 1, 1, 1, 1, 1, 1, 1, 1, 0, 0, 0, 1]",466,321,145,31,14,0.09657320872274143,0.09655172413793103
"[1, 0, 1, 1, 1, 1, 0, 1, 1, 1, 0, 1, 0, 0, 0]",147,56,91,5,9,0.08928571428571429,0.0989010989010989
"[0, 1, 1, 1, 0, 0, 0, 1, 1, 1, 1, 0, 0, 1, 1]",305,143,162,21,15,0.14685314685314685,0.09259259259259259
"[0, 1, 0, 0, 1, 1, 0, 1, 1, 1, 0, 0, 0, 1, 1]",137,70,67,6,8,0.08571428571428572,0.11940298507462686
"[0, 1, 1, 0, 0, 0, 1, 1, 0, 1, 1, 0, 1, 0, 1]",123,67,56,6,4,0.08955223880597014,0.07142857142857142
"[1, 0, 1, 0, 1, 1, 0, 1, 1, 1, 1, 1, 0, 0, 0]",188,78,110,11,10,0.14102564102564102,0.09090909090909091
"[0, 0, 0, 1, 0, 1, 1, 1, 0, 0, 0, 1, 1, 0, 1]",106,60,46,7,3,0.11666666666666667,0.06521739130434782
"[0, 0, 1, 0, 1, 1, 0, 1, 0, 0, 1, 0, 0, 1, 1]",124,60,64,7,3,0.11666666666666667,0.046875
"[1, 1, 1, 1, 1, 1, 1, 1, 0, 0, 1, 0, 0, 0, 1]",405,154,251,11,23,0.07142857142857142,0.09163346613545817
"[0, 1, 0, 1, 1, 1, 0, 1, 0, 0, 0, 1, 1, 1, 0]",100,53,47,4,3,0.07547169811320754,0.06382978723404255
"[1, 0, 1, 0, 1, 0, 1, 1, 1, 0, 1, 0, 1, 1, 1]",248,76,172,6,14,0.07894736842105263,0.08139534883720931
"[1, 0, 1, 0, 1, 0, 1, 0, 1, 1, 1, 1, 0, 0, 1]",186,76,110,6,12,0.07894736842105263,0.10909090909090909
"[0, 1, 1, 0, 0, 1, 1, 1, 0, 1, 0, 1, 0, 0, 0]",149,94,55,7,6,0.07446808510638298,0.10909090909090909
"[1, 0, 1, 0, 1, 0, 0, 1, 0, 0, 1, 0, 0, 0, 1]",143,91,52,8,2,0.08791208791208792,0.038461538461538464
"[1, 0, 0, 1, 1, 0, 1, 1, 0, 0, 1, 0, 1, 1, 1]",200,76,124,7,9,0.09210526315789473,0.07258064516129033
"[1, 0, 0, 1, 0, 0, 0, 1, 0, 0, 1, 1, 1, 1, 1]",203,88,115,9,15,0.10227272727272728,0.13043478260869565
"[1, 0, 1, 0, 0, 1, 1, 0, 1, 0, 0, 0, 0, 0, 0]",271,167,104,17,9,0.10179640718562874,0.08653846153846154
"[1, 1, 0, 0, 1, 0, 1, 0, 0, 1, 1, 0, 1, 0, 0]",101,51,50,6,0,0.11764705882352941,0.0
"[0, 0, 0, 0, 1, 0, 0, 1, 1, 1, 0, 0, 0, 0, 1]",353,231,122,16,10,0.06926406926406926,0.08196721311475409
"[0, 1, 0, 0, 1, 1, 0, 0, 0, 1, 0, 1, 0, 0, 0]",278,193,85,17,10,0.08808290155440414,0.11764705882352941
"[0, 0, 1, 1, 0, 1, 0, 0, 0, 1, 0, 1, 1, 1, 0]",116,56,60,6,4,0.10714285714285714,0.06666666666666667
"[1, 1, 0, 0, 1, 0, 1, 0, 0, 0, 1, 1, 1, 0, 1]",115,47,68,7,6,0.14893617021276595,0.08823529411764706
"[0, 0, 1, 0, 1, 0, 0, 1, 1, 0, 0, 0, 1, 0, 0]",250,163,87,13,7,0.07975460122699386,0.08045977011494253
"[0, 0, 1, 1, 1, 0, 0, 0, 1, 0, 1, 0, 0, 0, 1]",152,93,59,7,7,0.07526881720430108,0.11864406779661017
"[1, 0, 1, 0, 1, 0, 0, 0, 1, 1, 0, 0, 0, 0, 0]",356,216,140,17,9,0.0787037037037037,0.06428571428571428
"[1, 1, 1, 0, 0, 1, 0, 1, 0, 0, 1, 0, 0, 0, 1]",110,53,57,6,5,0.11320754716981132,0.08771929824561403
"[1, 0, 1, 1, 1, 1, 0, 1, 0, 1, 0, 1, 0, 0, 1]",146,60,86,3,15,0.05,0.1744186046511628
"[1, 1, 0, 1, 0, 1, 0, 0, 1, 1, 0, 1, 0, 0, 1]",114,52,62,4,2,0.07692307692307693,0.03225806451612903
"[1, 0, 1, 0, 0, 1, 0, 0, 1, 0, 1, 0, 0, 1, 0]",120,73,47,12,6,0.1643835616438356,0.1276595744680851
"[1, 0, 1, 1, 1, 1, 0, 1, 0, 0, 1, 1, 0, 0, 0]",146,55,91,10,6,0.18181818181818182,0.06593406593406594
"[1, 1, 1, 0, 1, 1, 0, 0, 0, 0, 0, 0, 1, 1, 0]",275,139,136,13,13,0.09352517985611511,0.09558823529411764
"[1, 0, 1, 1, 1, 0, 0, 0, 1, 1, 1, 0, 1, 1, 1]",300,109,191,11,24,0.10091743119266056,0.1256544502617801
"[0, 1, 0, 1, 1, 1, 1, 1, 1, 0, 0, 1, 1, 0, 1]",271,91,180,6,15,0.06593406593406594,0.08333333333333333
"[0, 0, 1, 0, 0, 1, 1, 0, 0, 0, 0, 0, 1, 1, 1]",306,192,114,17,13,0.08854166666666667,0.11403508771929824
"[0, 1, 0, 1, 1, 0, 0, 1, 1, 0, 0, 1, 0, 1, 1]",135,67,68,3,10,0.04477611940298507,0.14705882352941177
"[0, 0, 1, 0, 1, 1, 1, 1, 0, 1, 1, 0, 1, 1, 0]",127,54,73,2,8,0.037037037037037035,0.1095890410958904
"[1, 0, 0, 0, 0, 1, 0, 1, 0, 1, 1, 0, 1, 1, 1]",144,63,81,3,5,0.047619047619047616,0.06172839506172839
"[0, 1, 0, 1, 1, 0, 1, 0, 1, 1, 1, 1, 1, 0, 1]",236,82,154,9,15,0.10975609756097561,0.09740259740259741
"[1, 1, 0, 0, 1, 0, 1, 1, 0, 1, 1, 1, 1, 1, 0]",254,79,175,14,15,0.17721518987341772,0.08571428571428572
"[1, 1, 1, 0, 1, 0, 1, 0, 0, 0, 1, 1, 0, 0, 0]",160,79,81,7,7,0.08860759493670886,0.08641975308641975
"[0, 1, 1, 1, 0, 0, 0, 1, 1, 1, 0, 0, 1, 1, 1]",230,97,133,10,14,0.10309278350515463,0.10526315789473684
"[0, 1, 0, 1, 0, 1, 0, 1, 0, 1, 0, 1, 1, 1, 1]",187,82,105,7,12,0.08536585365853659,0.11428571428571428
"[1, 1, 1, 1, 0, 0, 0, 1, 1, 1, 1, 1, 0, 0, 0]",257,112,145,6,13,0.05357142857142857,0.0896551724137931
"[1, 0, 0, 1, 0, 0, 1, 1, 1, 0, 0, 0, 0, 1, 0]",146,82,64,6,5,0.07317073170731707,0.078125
"[1, 0, 0, 1, 1, 0, 1, 1, 0, 1, 0, 1, 0, 0, 0]",112,49,63,6,4,0.12244897959183673,0.06349206349206349
"[1, 0, 0, 0, 1, 0, 1, 1, 1, 1, 1, 0, 1, 1, 1]",292,103,189,11,22,0.10679611650485436,0.1164021164021164
"[1, 0, 0, 0, 0, 1, 1, 1, 1, 0, 0, 0, 1, 1, 0]",248,76,172,8,15,0.10526315789473684,0.0872093023255814
"[1, 0, 1, 0, 1, 0, 0, 1, 1, 0, 1, 0, 1, 0, 1]",99,46,53,6,5,0.13043478260869565,0.09433962264150944
"[1, 1, 0, 1, 0, 1, 0, 0, 1, 1, 0, 1, 0, 1, 0]",104,57,47,7,2,0.12280701754385964,0.0425531914893617
"[0, 0, 0, 0, 0, 1, 0, 0, 1, 1, 1, 1, 0, 1, 1]",154,99,55,11,3,0.1111111111111111,0.05454545454545454
"[1, 1, 0, 0, 1, 1, 0, 0, 0, 0, 1, 1, 0, 1, 1]",483,248,235,23,31,0.09274193548387097,0.13191489361702127
"[0, 0, 0, 0, 1, 1, 0, 1, 0, 0, 0, 1, 1, 0, 1]",181,113,68,15,9,0.13274336283185842,0.1323529411764706
"[1, 0, 0, 0, 0, 1, 1, 0, 1, 0, 0, 0, 1, 1, 0]",182,97,85,5,5,0.05154639175257732,0.058823529411764705
"[1, 1, 0, 0, 1, 1, 0, 1, 0, 1, 1, 1, 1, 0, 0]",199,76,123,13,9,0.17105263157894737,0.07317073170731707
"[0, 0, 0, 0, 1, 0, 1, 1, 1, 0, 1, 1, 1, 0, 1]",119,75,44,7,6,0.09333333333333334,0.13636363636363635
"[0, 0, 0, 1, 1, 1, 1, 0, 0, 1, 1, 0, 1, 0, 1]",210,148,62,14,5,0.0945945945945946,0.08064516129032258
"[0, 1, 1, 1, 1, 0, 1, 1, 0, 1, 1, 0, 0, 1, 0]",141,67,74,9,8,0.13432835820895522,0.10810810810810811
"[0, 0, 0, 1, 1, 1, 0, 1, 1, 1, 1, 0, 1, 0, 0]",117,64,53,4,6,0.0625,0.11320754716981132
"[0, 1, 1, 1, 0, 0, 1, 0, 1, 0, 0, 0, 1, 1, 1]",169,71,98,8,9,0.11267605633802817,0.09183673469387756
"[0, 0, 1, 0, 0, 0, 0, 1, 1, 1, 1, 1, 1, 1, 1]",568,241,327,25,42,0.1037344398340249,0.12844036697247707
"[0, 1, 1, 1, 0, 0, 1, 0, 1, 1, 1, 1, 0, 0, 0]",163,73,90,9,8,0.1232876712328767,0.08888888888888889
"[0, 1, 0, 1, 1, 0, 1, 0, 0, 0, 0, 1, 0, 1, 0]",142,83,59,7,4,0.08433734939759036,0.06779661016949153
"[0, 0, 1, 1, 0, 0, 1, 1, 0, 1, 0, 0, 0, 0, 0]",388,245,143,23,15,0.09387755102040816,0.1048951048951049
"[1, 1, 1, 0, 0, 0, 0, 1, 1, 0, 0, 1, 1, 0, 1]",365,108,257,13,28,0.12037037037037036,0.10894941634241245
"[0, 1, 1, 1, 0, 0, 1, 1, 0, 1, 0, 1, 0, 0, 0]",119,66,53,9,5,0.13636363636363635,0.09433962264150944
"[1, 0, 0, 0, 1, 1, 1, 0, 0, 1, 1, 0, 1, 0, 1]",119,55,64,2,7,0.03636363636363636,0.109375
"[0, 0, 0, 1, 1, 0, 0, 0, 0, 0, 1, 1, 1, 1, 1]",452,322,130,44,12,0.13664596273291926,0.09230769230769231
"[0, 0, 1, 0, 1, 0, 1, 0, 1, 0, 1, 1, 1, 0, 0]",92,46,46,2,5,0.043478260869565216,0.10869565217391304
"[1, 1, 1, 0, 1, 1, 0, 0, 1, 0, 1, 0, 1, 0, 1]",138,57,81,4,11,0.07017543859649122,0.13580246913580246
"[1, 1, 0, 1, 1, 0, 1, 0, 1, 1, 1, 0, 0, 1, 0]",145,52,93,6,12,0.11538461538461539,0.12903225806451613
"[0, 1, 1, 1, 1, 0, 1, 1, 1, 1, 0, 1, 1, 0, 0]",262,105,157,15,17,0.14285714285714285,0.10828025477707007
"[0, 0, 1, 1, 0, 1, 1, 0, 1, 1, 1, 0, 0, 0, 1]",119,52,67,6,5,0.11538461538461539,0.07462686567164178
"[0, 0, 1, 1, 0, 0, 1, 1, 0, 1, 0, 0, 0, 0, 1]",218,122,96,17,9,0.13934426229508196,0.09375
"[0, 1, 0, 0, 0, 1, 1, 0, 0, 1, 1, 0, 1, 0, 0]",152,84,68,7,5,0.08333333333333333,0.07352941176470588
"[1, 0, 1, 0, 1, 1, 0, 1, 0, 1, 0, 1, 1, 0, 1]",127,40,87,2,8,0.05,0.09195402298850575
"[1, 1, 1, 1, 0, 1, 1, 0, 1, 0, 0, 0, 1, 1, 0]",165,66,99,7,8,0.10606060606060606,0.08080808080808081
"[1, 0, 0, 1, 0, 1, 1, 0, 1, 1, 1, 0, 0, 0, 1]",111,52,59,5,5,0.09615384615384616,0.0847457627118644
"[1, 1, 0, 0, 0, 1, 0, 0, 1, 1, 1, 1, 0, 1, 1]",158,68,90,8,9,0.11764705882352941,0.1
"[0, 0, 1, 1, 0, 1, 1, 1, 1, 1, 0, 0, 1, 1, 1]",471,167,304,9,33,0.05389221556886228,0.10855263157894737
"[1, 1, 1, 1, 1, 0, 0, 0, 0, 0, 1, 0, 0, 0, 1]",189,80,109,11,10,0.1375,0.09174311926605505
"[0, 0, 1, 1, 1, 1, 1, 1, 1, 0, 1, 1, 1, 0, 0]",347,116,231,13,21,0.11206896551724138,0.09090909090909091
"[0, 1, 0, 1, 0, 0, 1, 0, 1, 1, 0, 1, 0, 0, 1]",119,69,50,6,5,0.08695652173913043,0.1
"[1, 0, 0, 0, 1, 0, 0, 1, 0, 1, 0, 1, 0, 1, 0]",141,91,50,10,7,0.10989010989010989,0.14
"[1, 1, 0, 0, 1, 1, 0, 1, 1, 0, 1, 0, 0, 0, 1]",118,58,60,4,5,0.06896551724137931,0.08333333333333333
"[0, 1, 0, 1, 1, 1, 0, 0, 1, 0, 0, 1, 1, 1, 1]",217,97,120,12,10,0.12371134020618557,0.08333333333333333
"[0, 0, 0, 0, 0, 0, 1, 0, 1, 1, 1, 0, 1, 1, 1]",236,144,92,12,7,0.08333333333333333,0.07608695652173914
"[1, 1, 1, 0, 0, 0, 0, 0, 0, 0, 1, 0, 0, 1, 0]",328,184,144,18,14,0.09782608695652174,0.09722222222222222
"[0, 0, 0, 1, 1, 1, 0, 1, 0, 0, 0, 1, 0, 1, 0]",132,84,48,8,3,0.09523809523809523,0.0625
"[1, 0, 1, 0, 0, 0, 0, 1, 1, 1, 0, 1, 0, 0, 0]",187,103,84,6,11,0.05825242718446602,0.13095238095238096
"[1, 0, 1, 1, 0, 0, 0, 0, 0, 1, 1, 1, 0, 1, 0]",119,60,59,5,7,0.08333333333333333,0.11864406779661017
"[1, 0, 0, 0, 1, 1, 0, 0, 0, 0, 1, 1, 0, 0, 1]",478,258,220,28,23,0.10852713178294573,0.10454545454545454
"[0, 1, 1, 0, 0, 1, 0, 1, 0, 0, 0, 1, 1, 0, 0]",191,112,79,12,7,0.10714285714285714,0.08860759493670886
"[1, 1, 1, 1, 1, 1, 1, 0, 0, 0, 1, 0, 0, 1, 1]",450,113,337,13,27,0.11504424778761062,0.08011869436201781
"[0, 0, 1, 0, 1, 1, 0, 0, 1, 1, 1, 0, 0, 0, 1]",121,68,53,9,5,0.1323529411764706,0.09433962264150944
"[0, 1, 0, 0, 0, 1, 0, 1, 1, 0, 1, 1, 0, 0, 1]",130,81,49,3,7,0.037037037037037035,0.14285714285714285
"[1, 1, 0, 0, 0, 1, 0, 0, 1, 0, 1, 1, 1, 0, 0]",129,69,60,6,9,0.08695652173913043,0.15
"[1, 0, 0, 0, 1, 0, 0, 0, 1, 1, 1, 0, 0, 0, 1]",149,86,63,6,6,0.06976744186046512,0.09523809523809523
"[1, 0, 1, 0, 0, 0, 0, 0, 1, 1, 0, 0, 1, 1, 1]",298,164,134,17,15,0.10365853658536585,0.11194029850746269
"[0, 0, 0, 0, 1, 0, 1, 1, 1, 0, 1, 0, 0, 0, 1]",148,84,64,7,9,0.08333333333333333,0.140625
"[1, 1, 0, 0, 0, 1, 0, 0, 0, 1, 1, 0, 1, 0, 1]",98,50,48,2,4,0.04,0.08333333333333333
"[0, 1, 1, 1, 1, 1, 0, 0, 1, 1, 0, 1, 1, 0, 0]",210,79,131,6,11,0.0759493670886076,0.08396946564885496
"[0, 1, 0, 0, 1, 1, 0, 0, 0, 1, 0, 0, 1, 0, 1]",147,83,64,7,6,0.08433734939759036,0.09375
"[1, 0, 1, 0, 0, 1, 1, 0, 0, 0, 1, 0, 0, 1, 0]",142,80,62,9,4,0.1125,0.06451612903225806
"[1, 1, 0, 1, 1, 1, 0, 1, 0, 1, 0, 1, 0, 0, 0]",124,62,62,4,4,0.06451612903225806,0.06451612903225806
"[1, 0, 0, 1, 1, 0, 0, 1, 1, 1, 0, 0, 1, 1, 0]",190,66,124,7,15,0.10606060606060606,0.12096774193548387
"[1, 0, 1, 0, 1, 0, 0, 1, 1, 0, 0, 1, 1, 0, 0]",255,128,127,14,16,0.109375,0.12598425196850394
"[0, 0, 0, 0, 1, 0, 1, 0, 1, 0, 1, 1, 0, 0, 1]",170,79,91,7,6,0.08860759493670886,0.06593406593406594
"[0, 1, 1, 0, 0, 1, 1, 0, 1, 1, 1, 0, 1, 0, 1]",160,70,90,7,12,0.1,0.13333333333333333
"[0, 1, 1, 0, 1, 0, 0, 0, 1, 0, 1, 0, 0, 0, 0]",273,174,99,27,5,0.15517241379310345,0.050505050505050504
"[0, 0, 1, 1, 0, 1, 1, 1, 1, 1, 1, 0, 1, 0, 1]",238,87,151,14,11,0.16091954022988506,0.0728476821192053
"[1, 1, 0, 0, 0, 1, 0, 0, 1, 1, 1, 0, 1, 0, 0]",123,64,59,4,3,0.0625,0.05084745762711865
"[1, 0, 0, 1, 1, 0, 0, 0, 1, 0, 0, 1, 1, 0, 1]",132,65,67,5,6,0.07692307692307693,0.08955223880597014
"[1, 0, 1, 0, 0, 1, 1, 0, 0, 0, 1, 0, 0, 1, 1]",150,59,91,6,13,0.1016949152542373,0.14285714285714285
"[0, 1, 0, 0, 0, 1, 1, 1, 0, 1, 1, 1, 0, 1, 0]",108,51,57,3,10,0.058823529411764705,0.17543859649122806
"[0, 0, 0, 1, 0, 1, 0, 0, 0, 1, 1, 1, 0, 1, 1]",119,64,55,4,4,0.0625,0.07272727272727272
"[0, 0, 1, 1, 1, 1, 0, 1, 1, 0, 1, 1, 0, 1, 0]",138,55,83,3,8,0.05454545454545454,0.0963855421686747
"[0, 0, 1, 1, 1, 0, 1, 1, 1, 0, 0, 0, 0, 0, 0]",271,150,121,14,8,0.09333333333333334,0.06611570247933884
"[0, 0, 0, 1, 0, 0, 0, 1, 0, 1, 1, 0, 0, 1, 0]",241,162,79,15,4,0.09259259259259259,0.05063291139240506
"[1, 1, 0, 1, 1, 0, 0, 0, 1, 0, 1, 1, 1, 1, 0]",162,69,93,6,9,0.08695652173913043,0.0967741935483871
"[0, 0, 1, 0, 0, 1, 0, 0, 1, 0, 1, 0, 1, 1, 1]",139,81,58,5,7,0.06172839506172839,0.1206896551724138
"[1, 1, 0, 0, 1, 0, 0, 0, 0, 0, 0, 0, 0, 0, 1]",818,568,250,49,27,0.08626760563380281,0.108
"[1, 0, 1, 1, 1, 0, 0, 0, 1, 1, 0, 0, 0, 0, 1]",190,92,98,6,12,0.06521739130434782,0.12244897959183673
"[0, 1, 1, 0, 0, 1, 0, 0, 1, 0, 1, 1, 0, 0, 0]",166,93,73,9,5,0.0967741935483871,0.0684931506849315
"[0, 1, 1, 1, 1, 0, 0, 0, 1, 0, 1, 1, 1, 0, 1]",144,73,71,6,5,0.0821917808219178,0.07042253521126761
"[0, 1, 0, 1, 1, 0, 0, 1, 0, 0, 1, 1, 1, 0, 0]",132,68,64,9,7,0.1323529411764706,0.109375
"[1, 0, 1, 1, 1, 0, 0, 1, 1, 1, 0, 1, 0, 1, 1]",251,78,173,8,12,0.10256410256410256,0.06936416184971098
"[1, 1, 0, 0, 0, 0, 1, 0, 0, 0, 0, 1, 1, 0, 1]",175,109,66,9,10,0.08256880733944955,0.15151515151515152
"[0, 0, 1, 0, 0, 0, 0, 0, 0, 1, 1, 1, 1, 1, 0]",240,136,104,16,12,0.11764705882352941,0.11538461538461539
"[1, 1, 0, 0, 0, 1, 1, 1, 0, 0, 0, 0, 1, 1, 0]",204,90,114,12,12,0.13333333333333333,0.10526315789473684
"[1, 1, 1, 0, 0, 0, 1, 1, 1, 0, 0, 0, 0, 1, 1]",257,99,158,7,26,0.0707070707070707,0.16455696202531644
"[1, 1, 0, 0, 1, 0, 0, 0, 1, 0, 0, 1, 0, 0, 1]",148,87,61,8,5,0.09195402298850575,0.08196721311475409
"[0, 0, 0, 1, 0, 1, 1, 1, 1, 1, 1, 0, 0, 1, 0]",136,53,83,3,8,0.05660377358490566,0.0963855421686747
"[0, 1, 1, 0, 0, 1, 0, 0, 0, 0, 1, 0, 1, 1, 1]",170,108,62,14,8,0.12962962962962962,0.12903225806451613
"[1, 0, 0, 1, 0, 1, 0, 1, 1, 0, 0, 1, 1, 1, 0]",123,47,76,4,4,0.0851063829787234,0.05263157894736842
"[1, 1, 1, 1, 0, 0, 1, 0, 1, 0, 1, 1, 0, 0, 1]",197,99,98,10,10,0.10101010101010101,0.10204081632653061
"[0, 0, 0, 0, 0, 0, 1, 1, 0, 1, 1, 1, 1, 1, 0]",162,79,83,10,6,0.12658227848101267,0.07228915662650602
"[1, 1, 1, 0, 0, 0, 0, 1, 0, 0, 0, 0, 1, 1, 1]",258,118,140,15,13,0.1271186440677966,0.09285714285714286
"[1, 1, 0, 0, 0, 1, 1, 0, 1, 1, 0, 0, 1, 1, 0]",157,75,82,4,6,0.05333333333333334,0.07317073170731707
"[1, 1, 1, 0, 0, 0, 1, 1, 0, 1, 1, 0, 0, 1, 1]",222,82,140,14,11,0.17073170731707318,0.07857142857142857
"[1, 1, 0, 1, 0, 1, 1, 1, 0, 1, 1, 1, 0, 1, 1]",542,144,398,9,41,0.0625,0.10301507537688442
"[1, 0, 0, 1, 1, 1, 1, 0, 0, 1, 1, 1, 0, 0, 1]",352,81,271,9,30,0.1111111111111111,0.11070110701107011
"[0, 0, 1, 1, 0, 1, 1, 1, 1, 0, 1, 0, 0, 1, 1]",165,76,89,9,11,0.11842105263157894,0.12359550561797752
"[1, 1, 1, 0, 0, 0, 1, 1, 1, 0, 0, 1, 0, 1, 1]",137,53,84,5,13,0.09433962264150944,0.15476190476190477
"[1, 0, 0, 1, 0, 0, 1, 0, 0, 0, 1, 1, 1, 0, 1]",106,52,54,2,4,0.038461538461538464,0.07407407407407407
"[0, 0, 1, 0, 0, 1, 1, 1, 1, 0, 0, 1, 0, 1, 0]",123,70,53,4,6,0.05714285714285714,0.11320754716981132
"[1, 0, 0, 0, 1, 1, 0, 0, 0, 1, 1, 1, 0, 1, 1]",136,68,68,9,7,0.1323529411764706,0.10294117647058823
"[0, 1, 1, 1, 0, 0, 1, 1, 0, 0, 0, 1, 1, 0, 0]",177,108,69,8,9,0.07407407407407407,0.13043478260869565
"[1, 0, 0, 1, 1, 1, 0, 0, 1, 1, 0, 0, 0, 1, 1]",182,78,104,8,9,0.10256410256410256,0.08653846153846154
"[0, 1, 0, 0, 1, 0, 1, 1, 1, 1, 0, 1, 0, 0, 0]",110,51,59,7,3,0.13725490196078433,0.05084745762711865
"[0, 0, 0, 0, 1, 1, 1, 0, 1, 0, 1, 1, 1, 0, 1]",123,64,59,7,7,0.109375,0.11864406779661017
"[1, 1, 1, 0, 1, 0, 0, 0, 0, 0, 1, 0, 1, 0, 0]",166,97,69,12,6,0.12371134020618557,0.08695652173913043
"[1, 0, 0, 0, 0, 1, 0, 0, 1, 1, 1, 1, 0, 0, 0]",278,155,123,9,10,0.05806451612903226,0.08130081300813008
"[0, 1, 1, 1, 0, 0, 0, 0, 1, 1, 1, 0, 0, 1, 0]",114,56,58,4,5,0.07142857142857142,0.08620689655172414
"[1, 1, 1, 0, 1, 1, 1, 0, 0, 0, 0, 1, 1, 1, 0]",157,54,103,5,10,0.09259259259259259,0.0970873786407767
"[0, 1, 1, 1, 1, 0, 1, 1, 1, 1, 0, 0, 1, 0, 0]",165,79,86,6,6,0.0759493670886076,0.06976744186046512
"[1, 1, 0, 0, 0, 1, 0, 0, 1, 1, 0, 0, 0, 1, 0]",137,87,50,13,5,0.14942528735632185,0.1
"[0, 1, 1, 0, 0, 0, 0, 0, 1, 0, 0, 0, 1, 0, 1]",274,184,90,15,11,0.08152173913043478,0.12222222222222222
"[0, 1, 0, 1, 0, 0, 1, 0, 0, 0, 1, 0, 1, 0, 1]",119,63,56,3,3,0.047619047619047616,0.05357142857142857
"[0, 1, 1, 0, 1, 1, 1, 0, 1, 0, 1, 0, 0, 0, 1]",120,62,58,4,3,0.06451612903225806,0.05172413793103448
"[0, 1, 1, 1, 0, 1, 1, 1, 0, 0, 0, 1, 0, 1, 1]",147,63,84,6,8,0.09523809523809523,0.09523809523809523
"[1, 0, 1, 1, 1, 0, 0, 1, 1, 0, 0, 1, 0, 1, 1]",191,89,102,9,8,0.10112359550561797,0.0784313725490196
"[0, 0, 1, 0, 0, 1, 0, 1, 0, 1, 1, 1, 1, 1, 1]",204,92,112,2,6,0.021739130434782608,0.05357142857142857
"[1, 1, 0, 0, 1, 0, 0, 1, 0, 1, 0, 1, 1, 1, 1]",193,84,109,11,10,0.13095238095238096,0.09174311926605505
"[1, 0, 1, 0, 1, 0, 0, 0, 0, 0, 0, 0, 1, 0, 1]",263,171,92,15,10,0.08771929824561403,0.10869565217391304
"[1, 0, 1, 0, 1, 0, 1, 0, 0, 0, 1, 1, 1, 0, 1]",118,56,62,6,9,0.10714285714285714,0.14516129032258066
"[1, 1, 1, 0, 0, 1, 1, 0, 1, 0, 1, 0, 1, 0, 1]",149,51,98,2,9,0.0392156862745098,0.09183673469387756
"[1, 0, 0, 1, 0, 1, 0, 0, 0, 0, 0, 0, 0, 1, 1]",459,279,180,28,16,0.1003584229390681,0.08888888888888889
"[0, 0, 0, 0, 1, 1, 1, 1, 0, 1, 1, 0, 0, 1, 0]",140,80,60,8,6,0.1,0.1
"[0, 0, 1, 1, 0, 1, 0, 0, 1, 1, 0, 0, 1, 0, 0]",163,96,67,10,5,0.10416666666666667,0.07462686567164178
"[0, 1, 1, 1, 0, 0, 1, 0, 1, 0, 1, 1, 0, 0, 1]",134,70,64,4,6,0.05714285714285714,0.09375
"[0, 1, 1, 1, 1, 0, 1, 0, 1, 1, 0, 1, 1, 1, 0]",232,88,144,8,12,0.09090909090909091,0.08333333333333333
"[1, 1, 1, 0, 0, 1, 1, 1, 0, 0, 0, 1, 1, 1, 0]",162,61,101,7,10,0.11475409836065574,0.09900990099009901
"[1, 0, 1, 1, 0, 0, 0, 1, 1, 1, 1, 0, 1, 1, 0]",149,60,89,5,8,0.08333333333333333,0.0898876404494382
"[0, 0, 1, 1, 0, 1, 0, 1, 0, 1, 1, 0, 1, 1, 1]",183,81,102,8,15,0.09876543209876543,0.14705882352941177
"[1, 0, 1, 1, 0, 0, 1, 0, 0, 1, 1, 1, 1, 0, 1]",148,59,89,5,9,0.0847457627118644,0.10112359550561797
"[0, 0, 0, 0, 1, 0, 0, 1, 1, 0, 0, 0, 1, 0, 0]",584,404,180,43,15,0.10643564356435643,0.08333333333333333
"[1, 0, 1, 1, 0, 0, 1, 0, 0, 0, 1, 0, 1, 0, 0]",147,79,68,8,6,0.10126582278481013,0.08823529411764706
"[1, 1, 0, 1, 1, 1, 1, 0, 1, 1, 0, 0, 1, 0, 1]",237,83,154,7,12,0.08433734939759036,0.07792207792207792
"[1, 0, 1, 0, 0, 1, 0, 0, 1, 0, 1, 1, 1, 0, 0]",94,51,43,1,5,0.0196078431372549,0.11627906976744186
"[1, 0, 0, 1, 1, 0, 1, 1, 1, 0, 0, 0, 1, 1, 0]",152,68,84,11,6,0.16176470588235295,0.07142857142857142
"[0, 1, 1, 0, 0, 1, 1, 1, 0, 1, 1, 0, 0, 0, 1]",120,66,54,8,6,0.12121212121212122,0.1111111111111111
"[0, 1, 0, 0, 0, 0, 1, 0, 0, 1, 1, 1, 0, 0, 1]",141,86,55,10,7,0.11627906976744186,0.12727272727272726
"[0, 1, 0, 0, 0, 1, 0, 0, 1, 1, 0, 0, 1, 0, 0]",229,148,81,18,18,0.12162162162162163,0.2222222222222222
"[0, 1, 1, 0, 0, 1, 0, 1, 0, 1, 1, 0, 0, 1, 0]",111,60,51,5,6,0.08333333333333333,0.11764705882352941
"[0, 0, 1, 1, 1, 0, 1, 0, 0, 1, 0, 1, 1, 0, 0]",127,69,58,11,8,0.15942028985507245,0.13793103448275862
"[0, 0, 1, 0, 1, 0, 1, 0, 0, 1, 1, 1, 1, 1, 0]",126,59,67,6,4,0.1016949152542373,0.05970149253731343
"[0, 0, 1, 0, 0, 0, 1, 0, 1, 0, 0, 0, 1, 1, 0]",300,202,98,25,7,0.12376237623762376,0.07142857142857142
"[1, 1, 0, 0, 1, 0, 0, 0, 1, 1, 0, 1, 1, 1, 1]",189,77,112,6,7,0.07792207792207792,0.0625
"[0, 1, 0, 1, 1, 1, 0, 0, 1, 1, 1, 1, 1, 0, 1]",267,97,170,5,15,0.05154639175257732,0.08823529411764706
"[0, 0, 0, 0, 1, 0, 1, 0, 0, 0, 0, 1, 1, 0, 1]",249,154,95,13,12,0.08441558441558442,0.12631578947368421
"[1, 1, 0, 1, 1, 1, 0, 0, 0, 1, 1, 1, 0, 0, 1]",183,76,107,10,18,0.13157894736842105,0.16822429906542055
"[0, 1, 0, 0, 0, 0, 0, 1, 0, 1, 0, 1, 1, 1, 1]",141,74,67,5,3,0.06756756756756757,0.04477611940298507
"[0, 1, 0, 1, 1, 1, 1, 0, 1, 0, 0, 0, 1, 0, 0]",120,64,56,9,6,0.140625,0.10714285714285714
"[0, 0, 0, 1, 0, 0, 1, 1, 0, 0, 1, 0, 1, 0, 1]",161,99,62,10,3,0.10101010101010101,0.04838709677419355
"[1, 1, 1, 0, 1, 0, 0, 0, 0, 0, 1, 0, 0, 1, 1]",159,77,82,4,4,0.05194805194805195,0.04878048780487805
"[1, 1, 0, 0, 1, 0, 0, 0, 1, 0, 1, 0, 1, 1, 0]",97,42,55,3,8,0.07142857142857142,0.14545454545454545
"[1, 0, 1, 1, 1, 1, 1, 0, 0, 1, 1, 0, 1, 1, 0]",273,99,174,9,17,0.09090909090909091,0.09770114942528736
"[0, 1, 1, 1, 0, 1, 1, 1, 0, 1, 0, 0, 1, 0, 1]",141,58,83,2,14,0.034482758620689655,0.1686746987951807
"[0, 0, 0, 0, 1, 0, 1, 0, 1, 0, 0, 0, 1, 1, 1]",238,150,88,17,6,0.11333333333333333,0.06818181818181818
"[1, 0, 1, 1, 1, 0, 1, 0, 0, 1, 0, 0, 0, 0, 0]",165,97,68,8,11,0.08247422680412371,0.16176470588235295
"[1, 1, 0, 0, 0, 0, 1, 1, 0, 1, 0, 1, 1, 1, 0]",152,64,88,9,7,0.140625,0.07954545454545454
"[0, 1, 1, 1, 1, 0, 1, 1, 1, 0, 0, 0, 0, 0, 0]",228,124,104,17,13,0.13709677419354838,0.125
"[1, 0, 1, 1, 0, 0, 0, 0, 0, 1, 1, 1, 1, 0, 1]",145,68,77,7,10,0.10294117647058823,0.12987012987012986
"[0, 0, 1, 0, 1, 0, 1, 0, 1, 0, 0, 1, 1, 0, 0]",157,93,64,7,8,0.07526881720430108,0.125
"[1, 0, 1, 1, 1, 1, 0, 0, 1, 0, 1, 1, 1, 0, 1]",237,75,162,12,13,0.16,0.08024691358024691
"[0, 1, 1, 1, 0, 1, 1, 1, 0, 0, 0, 1, 1, 0, 1]",133,58,75,5,6,0.08620689655172414,0.08
"[0, 1, 0, 0, 1, 1, 0, 0, 1, 0, 0, 1, 1, 1, 0]",130,62,68,3,7,0.04838709677419355,0.10294117647058823
"[1, 1, 0, 1, 1, 0, 0, 1, 1, 1, 0, 1, 0, 0, 1]",152,61,91,9,9,0.14754098360655737,0.0989010989010989
"[0, 1, 1, 1, 0, 1, 1, 0, 0, 1, 1, 1, 0, 1, 0]",135,45,90,3,18,0.06666666666666667,0.2
"[1, 1, 1, 1, 1, 0, 0, 0, 1, 0, 0, 1, 1, 1, 0]",185,68,117,6,13,0.08823529411764706,0.1111111111111111
"[0, 0, 1, 0, 1, 0, 1, 1, 1, 1, 0, 0, 0, 1, 1]",159,80,79,12,9,0.15,0.11392405063291139
"[0, 0, 0, 0, 1, 0, 1, 0, 1, 1, 1, 1, 0, 0, 0]",238,138,100,16,8,0.11594202898550725,0.08
"[1, 0, 0, 0, 0, 1, 0, 1, 0, 1, 1, 1, 1, 0, 0]",164,79,85,12,9,0.1518987341772152,0.10588235294117647
"[0, 0, 1, 1, 1, 0, 0, 0, 0, 0, 1, 1, 1, 0, 1]",150,72,78,10,11,0.1388888888888889,0.14102564102564102
"[1, 0, 0, 0, 1, 1, 0, 1, 0, 0, 0, 1, 1, 0, 1]",106,55,51,6,4,0.10909090909090909,0.0784313725490196
"[1, 1, 1, 0, 1, 1, 0, 0, 1, 0, 0, 0, 0, 1, 1]",173,88,85,5,9,0.056818181818181816,0.10588235294117647
"[0, 1, 0, 1, 0, 0, 0, 1, 1, 0, 1, 1, 0, 0, 1]",130,70,60,7,3,0.1,0.05
"[0, 1, 1, 1, 0, 0, 0, 1, 1, 1, 0, 0, 0, 0, 1]",162,91,71,8,7,0.08791208791208792,0.09859154929577464
"[1, 1, 0, 1, 0, 1, 0, 0, 0, 0, 0, 1, 0, 1, 1]",129,63,66,7,6,0.1111111111111111,0.09090909090909091
"[1, 0, 1, 0, 1, 1, 1, 1, 1, 0, 0, 0, 0, 0, 0]",310,144,166,12,16,0.08333333333333333,0.0963855421686747
"[0, 0, 1, 0, 1, 0, 1, 1, 1, 1, 1, 0, 0, 0, 0]",202,109,93,8,4,0.07339449541284404,0.043010752688172046
"[1, 1, 0, 1, 1, 0, 1, 1, 1, 0, 0, 1, 1, 0, 0]",246,87,159,9,14,0.10344827586206896,0.0880503144654088
"[0, 1, 1, 1, 1, 0, 1, 0, 0, 1, 0, 1, 0, 1, 1]",169,77,92,7,7,0.09090909090909091,0.07608695652173914
"[1, 0, 0, 0, 1, 0, 0, 1, 1, 0, 1, 1, 0, 0, 0]",185,104,81,10,11,0.09615384615384616,0.13580246913580246
"[1, 1, 0, 1, 1, 0, 1, 0, 0, 1, 1, 0, 1, 0, 0]",118,44,74,3,5,0.06818181818181818,0.06756756756756757
"[1, 0, 1, 1, 1, 0, 0, 1, 1, 1, 0, 1, 0, 0, 0]",153,70,83,8,11,0.11428571428571428,0.13253012048192772
"[0, 1, 1, 0, 0, 0, 0, 1, 1, 1, 0, 0, 1, 0, 1]",147,94,53,12,4,0.1276595744680851,0.07547169811320754
"[1, 0, 1, 0, 1, 1, 1, 1, 1, 1, 0, 0, 1, 0, 1]",256,85,171,11,18,0.12941176470588237,0.10526315789473684
"[0, 0, 0, 1, 0, 0, 0, 1, 1, 0, 0, 0, 1, 0, 1]",290,182,108,24,14,0.13186813186813187,0.12962962962962962
"[0, 1, 0, 1, 0, 1, 1, 0, 1, 1, 1, 0, 0, 1, 1]",199,85,114,6,15,0.07058823529411765,0.13157894736842105
"[1, 0, 0, 0, 1, 1, 1, 0, 0, 1, 0, 0, 0, 1, 1]",129,60,69,10,8,0.16666666666666666,0.11594202898550725
"[0, 1, 0, 0, 0, 1, 1, 1, 0, 0, 1, 0, 0, 0, 1]",120,69,51,6,6,0.08695652173913043,0.11764705882352941
"[1, 1, 0, 1, 1, 0, 1, 0, 1, 1, 0, 1, 0, 0, 0]",111,45,66,6,6,0.13333333333333333,0.09090909090909091
"[1, 0, 0, 0, 1, 1, 1, 0, 0, 1, 0, 1, 1, 1, 1]",161,70,91,5,7,0.07142857142857142,0.07692307692307693
"[0, 0, 1, 0, 1, 0, 0, 1, 1, 0, 1, 1, 0, 1, 1]",101,42,59,5,4,0.11904761904761904,0.06779661016949153
"[0, 1, 0, 0, 1, 0, 1, 1, 1, 1, 0, 1, 0, 1, 1]",133,63,70,8,6,0.12698412698412698,0.08571428571428572
"[0, 0, 1, 1, 0, 0, 1, 1, 0, 1, 0, 0, 1, 0, 1]",153,80,73,3,5,0.0375,0.0684931506849315
"[1, 1, 0, 1, 1, 1, 1, 1, 1, 0, 0, 1, 0, 1, 1]",557,168,389,14,31,0.08333333333333333,0.07969151670951156
"[1, 0, 0, 0, 1, 0, 1, 0, 1, 0, 0, 0, 1, 0, 0]",233,157,76,17,4,0.10828025477707007,0.05263157894736842
"[0, 0, 0, 1, 1, 0, 1, 0, 1, 1, 1, 1, 0, 1, 0]",131,62,69,10,8,0.16129032258064516,0.11594202898550725
"[1, 0, 1, 1, 1, 0, 0, 0, 0, 0, 0, 1, 0, 1, 1]",152,74,78,5,4,0.06756756756756757,0.05128205128205128
"[1, 0, 1, 1, 1, 1, 0, 1, 0, 1, 1, 1, 0, 0, 1]",321,122,199,14,13,0.11475409836065574,0.06532663316582915
"[0, 1, 1, 0, 0, 1, 0, 0, 1, 0, 0, 1, 0, 1, 1]",123,59,64,12,10,0.2033898305084746,0.15625
"[1, 0, 1, 0, 0, 0, 1, 0, 1, 1, 1, 0, 1, 0, 1]",104,55,49,5,3,0.09090909090909091,0.061224489795918366
"[0, 1, 1, 0, 0, 0, 0, 1, 0, 0, 0, 1, 0, 1, 0]",254,162,92,20,8,0.12345679012345678,0.08695652173913043
"[1, 1, 0, 0, 1, 0, 0, 0, 0, 0, 1, 0, 0, 1, 1]",209,111,98,14,12,0.12612612612612611,0.12244897959183673
"[1, 0, 0, 1, 0, 0, 1, 1, 0, 1, 0, 1, 0, 0, 1]",122,66,56,8,8,0.12121212121212122,0.14285714285714285
"[0, 0, 0, 1, 1, 1, 0, 0, 1, 1, 1, 0, 0, 0, 0]",217,142,75,17,4,0.11971830985915492,0.05333333333333334
"[0, 1, 1, 0, 0, 0, 1, 1, 1, 0, 0, 1, 1, 1, 0]",119,65,54,6,9,0.09230769230769231,0.16666666666666666
"[0, 0, 1, 1, 1, 1, 1, 1, 0, 1, 0, 1, 1, 0, 0]",186,85,101,6,7,0.07058823529411765,0.06930693069306931
"[0, 0, 1, 1, 1, 0, 0, 0, 1, 0, 0, 1, 0, 1, 0]",150,91,59,6,4,0.06593406593406594,0.06779661016949153
"[1, 0, 1, 0, 1, 0, 0, 0, 0, 1, 1, 0, 1, 0, 1]",142,73,69,7,5,0.0958904109589041,0.07246376811594203
"[1, 1, 1, 1, 0, 1, 1, 1, 0, 0, 0, 1, 0, 1, 0]",144,58,86,5,10,0.08620689655172414,0.11627906976744186
"[0, 1, 0, 1, 1, 1, 1, 1, 0, 0, 0, 0, 0, 1, 1]",188,82,106,7,7,0.08536585365853659,0.0660377358490566
"[0, 0, 0, 1, 0, 0, 1, 0, 0, 1, 1, 0, 0, 1, 1]",271,181,90,23,12,0.1270718232044199,0.13333333333333333
"[0, 1, 0, 1, 1, 1, 0, 1, 0, 0, 0, 0, 0, 1, 0]",138,79,59,10,5,0.12658227848101267,0.0847457627118644
"[0, 0, 1, 0, 1, 1, 0, 1, 0, 0, 1, 0, 1, 1, 1]",117,62,55,4,5,0.06451612903225806,0.09090909090909091
"[1, 1, 0, 1, 1, 1, 0, 0, 1, 0, 0, 0, 1, 0, 0]",109,63,46,6,2,0.09523809523809523,0.043478260869565216
"[1, 1, 1, 1, 1, 0, 0, 0, 0, 0, 1, 0, 1, 0, 0]",186,84,102,5,13,0.05952380952380952,0.12745098039215685
"[1, 0, 1, 0, 1, 1, 1, 1, 1, 0, 0, 1, 1, 1, 0]",237,75,162,6,15,0.08,0.09259259259259259
"[1, 0, 0, 1, 1, 1, 1, 0, 1, 1, 0, 1, 0, 0, 1]",172,63,109,6,9,0.09523809523809523,0.08256880733944955
"[0, 1, 1, 1, 1, 0, 1, 1, 0, 1, 0, 1, 0, 0, 0]",95,48,47,3,5,0.0625,0.10638297872340426
"[1, 1, 1, 0, 1, 1, 0, 1, 0, 1, 0, 0, 0, 1, 0]",116,67,49,7,3,0.1044776119402985,0.061224489795918366
"[0, 1, 0, 1, 0, 0, 0, 1, 1, 1, 1, 0, 1, 1, 0]",112,52,60,4,5,0.07692307692307693,0.08333333333333333
"[1, 1, 1, 0, 0, 0, 1, 0, 1, 0, 1, 1, 0, 1, 1]",164,57,107,4,14,0.07017543859649122,0.1308411214953271
"[1, 1, 0, 0, 1, 1, 1, 0, 0, 0, 1, 0, 1, 0, 1]",127,63,64,4,7,0.06349206349206349,0.109375
"[1, 0, 0, 0, 1, 1, 0, 0, 1, 0, 1, 1, 1, 1, 1]",189,68,121,7,13,0.10294117647058823,0.10743801652892562
"[1, 0, 1, 1, 1, 0, 0, 1, 0, 0, 0, 0, 1, 1, 0]",149,75,74,4,7,0.05333333333333334,0.0945945945945946
"[1, 0, 1, 1, 0, 1, 1, 1, 0, 0, 1, 0, 0, 0, 0]",135,75,60,4,4,0.05333333333333334,0.06666666666666667
"[1, 1, 1, 0, 1, 1, 0, 1, 1, 1, 0, 0, 1, 0, 0]",151,57,94,4,9,0.07017543859649122,0.09574468085106383
"[0, 1, 1, 0, 1, 1, 1, 1, 0, 0, 1, 0, 1, 0, 1]",162,71,91,10,9,0.14084507042253522,0.0989010989010989
"[0, 1, 0, 0, 1, 1, 0, 0, 1, 1, 1, 0, 1, 0, 0]",123,70,53,6,7,0.08571428571428572,0.1320754716981132
"[0, 0, 0, 1, 0, 1, 1, 0, 0, 1, 0, 1, 0, 0, 1]",123,69,54,6,5,0.08695652173913043,0.09259259259259259
"[1, 1, 0, 0, 1, 1, 1, 0, 1, 0, 0, 1, 1, 1, 0]",155,60,95,4,11,0.06666666666666667,0.11578947368421053
"[0, 1, 1, 1, 1, 0, 0, 0, 0, 0, 1, 0, 1, 0, 0]",245,176,69,17,4,0.09659090909090909,0.057971014492753624
"[0, 1, 1, 1, 0, 1, 0, 1, 0, 1, 1, 1, 1, 0, 1]",230,76,154,9,25,0.11842105263157894,0.16233766233766234
"[0, 0, 1, 0, 1, 0, 0, 1, 1, 0, 0, 1, 0, 1, 1]",135,72,63,7,10,0.09722222222222222,0.15873015873015872
"[1, 1, 1, 1, 0, 0, 0, 1, 1, 0, 1, 1, 1, 0, 0]",206,71,135,6,17,0.08450704225352113,0.1259259259259259
"[0, 1, 1, 1, 0, 1, 1, 1, 0, 1, 0, 1, 1, 0, 0]",175,71,104,8,12,0.11267605633802817,0.11538461538461539
"[0, 1, 0, 0, 1, 1, 1, 0, 0, 1, 1, 1, 0, 1, 1]",157,54,103,5,10,0.09259259259259259,0.0970873786407767
"[0, 0, 1, 0, 1, 0, 1, 0, 0, 0, 1, 1, 1, 1, 0]",138,67,71,3,6,0.04477611940298507,0.08450704225352113
"[0, 1, 0, 1, 1, 1, 0, 0, 1, 0, 0, 1, 0, 1, 0]",118,64,54,4,4,0.0625,0.07407407407407407
"[0, 1, 1, 1, 0, 1, 1, 0, 0, 0, 1, 1, 0, 0, 0]",157,83,74,5,7,0.060240963855421686,0.0945945945945946
"[1, 0, 1, 0, 0, 1, 0, 1, 0, 0, 0, 0, 1, 1, 0]",179,106,73,12,5,0.11320754716981132,0.0684931506849315
"[0, 1, 1, 1, 0, 0, 1, 1, 1, 0, 1, 0, 1, 0, 0]",125,67,58,9,4,0.13432835820895522,0.06896551724137931
"[1, 1, 0, 0, 1, 1, 1, 0, 0, 0, 0, 0, 1, 1, 0]",197,107,90,13,13,0.12149532710280374,0.14444444444444443
"[0, 1, 1, 1, 0, 1, 0, 0, 1, 1, 1, 1, 0, 1, 1]",232,94,138,17,8,0.18085106382978725,0.057971014492753624
"[0, 1, 0, 1, 0, 0, 1, 0, 1, 1, 1, 0, 1, 1, 1]",138,61,77,6,8,0.09836065573770492,0.1038961038961039
"[1, 0, 1, 0, 1, 0, 0, 1, 0, 1, 1, 1, 0, 1, 1]",137,45,92,6,8,0.13333333333333333,0.08695652173913043
"[1, 1, 1, 1, 1, 0, 1, 0, 0, 1, 0, 0, 0, 1, 1]",138,51,87,9,9,0.17647058823529413,0.10344827586206896
"[0, 1, 1, 0, 1, 0, 1, 0, 1, 1, 0, 0, 0, 0, 0]",176,112,64,9,6,0.08035714285714286,0.09375
"[0, 0, 1, 1, 1, 0, 1, 0, 1, 0, 0, 0, 1, 1, 0]",106,61,45,3,7,0.04918032786885246,0.15555555555555556
"[1, 1, 0, 0, 0, 1, 0, 0, 0, 0, 1, 0, 1, 1, 1]",187,97,90,8,8,0.08247422680412371,0.08888888888888889
"[1, 1, 0, 1, 0, 1, 1, 0, 0, 0, 1, 1, 0, 0, 0]",146,67,79,4,7,0.05970149253731343,0.08860759493670886
"[1, 0, 1, 0, 0, 1, 0, 0, 1, 1, 1, 1, 1, 0, 1]",153,66,87,8,10,0.12121212121212122,0.11494252873563218
"[1, 0, 0, 1, 0, 0, 1, 1, 1, 0, 0, 0, 1, 0, 1]",118,68,50,3,4,0.04411764705882353,0.08
"[0, 0, 0, 1, 0, 1, 1, 1, 0, 0, 1, 0, 0, 1, 0]",116,69,47,11,5,0.15942028985507245,0.10638297872340426
"[1, 1, 1, 0, 1, 0, 1, 0, 0, 0, 1, 0, 1, 0, 0]",97,56,41,8,5,0.14285714285714285,0.12195121951219512
"[1, 0, 1, 1, 0, 0, 0, 0, 1, 0, 0, 1, 0, 1, 0]",141,89,52,10,6,0.11235955056179775,0.11538461538461539
"[1, 0, 1, 1, 0, 1, 0, 1, 0, 0, 0, 1, 0, 1, 0]",108,51,57,4,11,0.0784313725490196,0.19298245614035087
"[1, 1, 0, 1, 1, 0, 0, 0, 1, 0, 1, 1, 0, 1, 0]",113,43,70,3,5,0.06976744186046512,0.07142857142857142
"[0, 1, 1, 1, 1, 1, 0, 1, 0, 0, 1, 0, 0, 1, 1]",189,76,113,12,8,0.15789473684210525,0.07079646017699115
"[1, 1, 0, 1, 0, 1, 1, 0, 1, 0, 0, 0, 1, 1, 0]",120,56,64,3,9,0.05357142857142857,0.140625
"[1, 0, 0, 0, 0, 1, 0, 0, 1, 0, 1, 0, 1, 0, 1]",147,87,60,12,2,0.13793103448275862,0.03333333333333333
"[0, 1, 1, 1, 0, 0, 1, 0, 1, 1, 1, 0, 1, 0, 1]",144,50,94,8,14,0.16,0.14893617021276595
"[1, 1, 1, 1, 1, 0, 0, 1, 0, 1, 1, 0, 1, 1, 0]",241,64,177,4,21,0.0625,0.11864406779661017
"[0, 1, 0, 0, 0, 0, 0, 1, 1, 0, 1, 0, 0, 0, 1]",252,156,96,18,14,0.11538461538461539,0.14583333333333334
"[1, 1, 0, 1, 1, 0, 1, 0, 0, 0, 1, 1, 1, 1, 0]",174,64,110,6,9,0.09375,0.08181818181818182
"[0, 1, 0, 1, 1, 0, 1, 0, 1, 0, 0, 1, 1, 1, 0]",109,61,48,6,6,0.09836065573770492,0.125
"[0, 0, 0, 1, 1, 0, 0, 0, 1, 1, 0, 1, 1, 0, 0]",202,127,75,10,10,0.07874015748031496,0.13333333333333333
"[1, 1, 0, 1, 0, 0, 1, 0, 0, 0, 0, 1, 1, 1, 1]",203,97,106,10,10,0.10309278350515463,0.09433962264150944
"[0, 1, 0, 0, 1, 1, 1, 0, 0, 0, 1, 0, 0, 0, 1]",147,82,65,8,5,0.0975609756097561,0.07692307692307693
"[1, 0, 1, 0, 1, 1, 1, 0, 0, 0, 1, 0, 0, 0, 0]",150,85,65,11,3,0.12941176470588237,0.046153846153846156
"[1, 1, 1, 1, 1, 1, 0, 1, 0, 1, 0, 1, 0, 1, 0]",224,84,140,4,11,0.047619047619047616,0.07857142857142857
"[0, 1, 0, 0, 0, 0, 1, 0, 1, 0, 1, 1, 0, 1, 1]",113,59,54,5,1,0.0847457627118644,0.018518518518518517
"[1, 1, 0, 1, 0, 0, 0, 1, 0, 0, 0, 1, 1, 0, 0]",188,116,72,16,8,0.13793103448275862,0.1111111111111111
"[0, 0, 0, 1, 1, 0, 1, 0, 1, 1, 1, 1, 1, 1, 0]",179,91,88,5,8,0.054945054945054944,0.09090909090909091
"[1, 0, 1, 1, 0, 1, 0, 0, 0, 1, 0, 1, 1, 0, 1]",82,45,37,3,4,0.06666666666666667,0.10810810810810811
"[1, 1, 1, 0, 1, 1, 0, 0, 0, 1, 1, 0, 0, 0, 1]",118,58,60,8,7,0.13793103448275862,0.11666666666666667
"[1, 1, 0, 1, 1, 1, 0, 1, 1, 0, 0, 1, 0, 0, 0]",126,51,75,2,2,0.0392156862745098,0.02666666666666667
"[1, 1, 1, 0, 0, 0, 1, 1, 1, 1, 0, 0, 0, 1, 1]",206,85,121,10,14,0.11764705882352941,0.11570247933884298
"[1, 0, 1, 0, 1, 1, 1, 0, 1, 1, 0, 0, 1, 0, 1]",138,72,66,5,9,0.06944444444444445,0.13636363636363635
"[1, 1, 0, 1, 0, 1, 1, 1, 0, 1, 1, 0, 0, 1, 0]",118,43,75,7,9,0.16279069767441862,0.12
"[0, 1, 0, 1, 1, 0, 1, 1, 1, 0, 1, 1, 1, 1, 1]",633,186,447,19,37,0.10215053763440861,0.08277404921700224
"[1, 1, 1, 0, 0, 1, 0, 1, 0, 0, 0, 1, 0, 0, 0]",157,91,66,8,11,0.08791208791208792,0.16666666666666666
"[0, 0, 0, 1, 1, 0, 0, 1, 1, 0, 1, 1, 1, 1, 0]",155,87,68,13,7,0.14942528735632185,0.10294117647058823
"[0, 0, 1, 1, 0, 1, 0, 1, 0, 0, 1, 1, 1, 1, 0]",172,91,81,16,8,0.17582417582417584,0.09876543209876543
"[1, 1, 0, 1, 0, 0, 0, 0, 1, 0, 0, 1, 0, 1, 0]",130,83,47,12,4,0.14457831325301204,0.0851063829787234
"[1, 0, 0, 1, 1, 1, 0, 1, 1, 0, 1, 0, 0, 1, 0]",110,48,62,2,8,0.041666666666666664,0.12903225806451613
"[1, 0, 1, 1, 1, 0, 1, 0, 0, 0, 0, 1, 0, 1, 1]",106,50,56,8,9,0.16,0.16071428571428573
"[1, 1, 1, 1, 0, 1, 0, 1, 1, 0, 0, 1, 0, 1, 1]",263,79,184,8,11,0.10126582278481013,0.059782608695652176
"[1, 1, 0, 0, 0, 0, 0, 1, 1, 1, 0, 1, 0, 0, 1]",156,92,64,10,11,0.10869565217391304,0.171875
"[1, 1, 0, 1, 0, 1, 1, 0, 1, 1, 1, 0, 1, 1, 0]",202,81,121,8,15,0.09876543209876543,0.12396694214876033
"[0, 0, 0, 1, 1, 1, 0, 1, 1, 1, 0, 0, 1, 0, 0]",104,61,43,4,6,0.06557377049180328,0.13953488372093023
"[1, 1, 1, 1, 1, 1, 0, 1, 0, 1, 1, 0, 0, 0, 1]",273,92,181,6,16,0.06521739130434782,0.08839779005524862
"[0, 0, 0, 1, 1, 0, 0, 1, 0, 1, 1, 1, 0, 0, 0]",183,119,64,13,9,0.1092436974789916,0.140625
"[1, 1, 1, 0, 0, 1, 1, 0, 0, 1, 1, 0, 0, 1, 0]",306,83,223,8,21,0.0963855421686747,0.09417040358744394
"[1, 0, 0, 1, 0, 1, 0, 0, 1, 0, 1, 0, 1, 0, 1]",90,54,36,6,5,0.1111111111111111,0.1388888888888889
"[0, 1, 0, 1, 0, 1, 0, 0, 0, 1, 0, 0, 0, 1, 1]",157,103,54,10,4,0.0970873786407767,0.07407407407407407
"[1, 0, 1, 0, 1, 0, 1, 0, 0, 0, 1, 0, 0, 0, 1]",122,64,58,6,7,0.09375,0.1206896551724138
"[1, 0, 1, 0, 1, 0, 1, 0, 1, 0, 0, 0, 1, 0, 0]",139,80,59,7,5,0.0875,0.0847457627118644
"[1, 1, 1, 1, 0, 1, 1, 0, 1, 0, 0, 0, 0, 0, 1]",131,53,78,3,8,0.05660377358490566,0.10256410256410256
"[0, 1, 0, 0, 1, 0, 1, 0, 0, 0, 0, 1, 1, 1, 0]",155,95,60,11,6,0.11578947368421053,0.1
"[0, 1, 0, 1, 0, 0, 1, 1, 1, 0, 0, 1, 0, 1, 0]",86,47,39,6,1,0.1276595744680851,0.02564102564102564
"[1, 1, 1, 1, 0, 0, 1, 0, 1, 0, 1, 0, 0, 0, 1]",133,68,65,5,10,0.07352941176470588,0.15384615384615385
"[1, 0, 0, 0, 1, 1, 1, 1, 0, 0, 1, 0, 0, 1, 0]",111,68,43,4,3,0.058823529411764705,0.06976744186046512
"[0, 1, 1, 1, 0, 0, 0, 0, 1, 0, 0, 0, 1, 1, 1]",175,95,80,15,11,0.15789473684210525,0.1375
"[1, 1, 1, 0, 1, 1, 0, 0, 0, 1, 0, 1, 0, 0, 1]",100,40,60,4,7,0.1,0.11666666666666667
"[1, 0, 0, 0, 0, 0, 0, 0, 1, 0, 1, 1, 1, 1, 1]",298,131,167,18,11,0.13740458015267176,0.0658682634730539
"[0, 0, 0, 1, 0, 0, 0, 1, 1, 0, 1, 1, 1, 1, 1]",183,97,86,7,4,0.07216494845360824,0.046511627906976744
"[0, 1, 0, 1, 1, 0, 0, 0, 0, 1, 1, 0, 1, 0, 0]",162,93,69,8,3,0.08602150537634409,0.043478260869565216
"[0, 0, 0, 0, 1, 1, 1, 0, 1, 1, 0, 1, 1, 1, 0]",135,74,61,4,6,0.05405405405405406,0.09836065573770492
"[0, 0, 1, 0, 1, 0, 1, 1, 1, 0, 0, 0, 0, 1, 1]",210,117,93,11,12,0.09401709401709402,0.12903225806451613
"[0, 1, 0, 0, 0, 0, 1, 0, 0, 1, 0, 1, 0, 1, 0]",217,146,71,14,6,0.0958904109589041,0.08450704225352113
"[0, 0, 1, 1, 0, 0, 0, 1, 1, 0, 1, 0, 1, 1, 0]",123,71,52,9,2,0.1267605633802817,0.038461538461538464
"[0, 1, 0, 0, 0, 1, 1, 1, 1, 0, 1, 1, 0, 1, 0]",117,50,67,2,2,0.04,0.029850746268656716
"[1, 1, 0, 0, 0, 1, 0, 0, 1, 1, 1, 0, 1, 1, 1]",201,91,110,10,16,0.10989010989010989,0.14545454545454545
"[0, 0, 1, 1, 0, 0, 0, 1, 0, 0, 1, 1, 1, 0, 1]",135,76,59,11,5,0.14473684210526316,0.0847457627118644
"[1, 0, 1, 0, 1, 1, 0, 1, 1, 0, 0, 1, 1, 1, 0]",139,60,79,5,8,0.08333333333333333,0.10126582278481013
"[0, 0, 0, 1, 0, 0, 1, 0, 0, 1, 1, 1, 1, 1, 1]",238,139,99,10,10,0.07194244604316546,0.10101010101010101
"[0, 0, 0, 1, 1, 0, 1, 0, 1, 0, 1, 1, 0, 1, 0]",88,50,38,7,6,0.14,0.15789473684210525
"[0, 1, 0, 1, 1, 0, 1, 1, 0, 0, 0, 1, 0, 0, 0]",138,78,60,6,7,0.07692307692307693,0.11666666666666667
"[1, 1, 0, 1, 0, 1, 1, 0, 1, 0, 1, 1, 1, 1, 0]",264,83,181,9,26,0.10843373493975904,0.143646408839779
"[0, 1, 0, 1, 1, 0, 0, 0, 1, 1, 1, 0, 0, 1, 1]",159,77,82,10,5,0.12987012987012986,0.06097560975609756
"[1, 1, 1, 0, 0, 1, 0, 0, 1, 1, 1, 0, 0, 0, 1]",127,50,77,2,6,0.04,0.07792207792207792
"[0, 0, 0, 1, 1, 1, 0, 0, 1, 0, 1, 1, 0, 1, 0]",112,54,58,11,8,0.2037037037037037,0.13793103448275862
"[0, 0, 0, 0, 1, 1, 0, 1, 0, 1, 0, 1, 0, 1, 0]",142,69,73,6,8,0.08695652173913043,0.1095890410958904
"[0, 0, 1, 1, 1, 1, 0, 0, 1, 0, 0, 0, 1, 1, 0]",159,89,70,9,4,0.10112359550561797,0.05714285714285714
"[1, 1, 0, 0, 1, 1, 0, 1, 0, 1, 0, 1, 0, 0, 0]",119,58,61,5,9,0.08620689655172414,0.14754098360655737
"[0, 1, 1, 0, 1, 0, 1, 0, 1, 1, 0, 0, 0, 1, 0]",111,72,39,9,2,0.125,0.05128205128205128
"[0, 1, 1, 1, 0, 1, 1, 0, 0, 0, 1, 0, 0, 1, 0]",101,48,53,2,3,0.041666666666666664,0.05660377358490566
"[0, 1, 1, 0, 1, 1, 1, 0, 1, 1, 0, 0, 0, 1, 0]",85,38,47,1,8,0.02631578947368421,0.1702127659574468
"[1, 1, 0, 0, 1, 1, 0, 1, 1, 1, 1, 0, 1, 0, 1]",258,106,152,14,9,0.1320754716981132,0.05921052631578947
"[1, 0, 1, 1, 1, 0, 0, 1, 0, 1, 1, 0, 1, 0, 0]",95,54,41,7,4,0.12962962962962962,0.0975609756097561
"[0, 0, 0, 1, 0, 0, 1, 0, 0, 0, 1, 0, 1, 0, 1]",212,138,74,13,12,0.09420289855072464,0.16216216216216217
"[1, 1, 0, 0, 0, 0, 1, 0, 0, 1, 0, 0, 1, 1, 0]",214,117,97,11,6,0.09401709401709402,0.061855670103092786
"[0, 1, 0, 0, 1, 0, 1, 1, 1, 1, 1, 1, 1, 0, 0]",257,100,157,7,17,0.07,0.10828025477707007
"[1, 1, 0, 0, 0, 1, 0, 0, 1, 0, 1, 1, 0, 1, 0]",107,59,48,5,5,0.0847457627118644,0.10416666666666667
"[1, 1, 0, 1, 0, 0, 1, 0, 1, 0, 1, 1, 0, 0, 0]",140,70,70,4,13,0.05714285714285714,0.18571428571428572
"[1, 1, 0, 0, 0, 1, 1, 1, 0, 0, 1, 0, 0, 0, 1]",144,75,69,7,6,0.09333333333333334,0.08695652173913043
"[0, 1, 1, 1, 0, 1, 1, 0, 0, 0, 0, 0, 0, 1, 1]",288,149,139,18,8,0.12080536912751678,0.05755395683453238
"[1, 0, 1, 1, 0, 1, 1, 1, 0, 1, 0, 0, 1, 1, 1]",274,77,197,4,25,0.05194805194805195,0.12690355329949238
"[0, 0, 1, 1, 0, 1, 0, 0, 0, 0, 1, 1, 0, 1, 0]",155,91,64,9,4,0.0989010989010989,0.0625
"[1, 0, 0, 1, 1, 0, 1, 0, 0, 1, 0, 0, 1, 1, 0]",140,68,72,6,2,0.08823529411764706,0.027777777777777776
"[1, 0, 1, 0, 0, 1, 1, 0, 1, 0, 0, 1, 0, 0, 1]",105,50,55,4,7,0.08,0.12727272727272726
"[1, 0, 0, 0, 1, 1, 1, 0, 1, 0, 1, 1, 0, 0, 1]",153,78,75,6,7,0.07692307692307693,0.09333333333333334
"[1, 0, 0, 0, 0, 1, 0, 1, 0, 1, 0, 0, 0, 1, 0]",226,141,85,10,7,0.07092198581560284,0.08235294117647059
"[0, 0, 0, 0, 1, 0, 1, 0, 1, 1, 1, 1, 0, 1, 0]",110,65,45,4,4,0.06153846153846154,0.08888888888888889
"[1, 0, 1, 1, 0, 1, 0, 0, 0, 0, 1, 0, 0, 0, 1]",135,88,47,7,3,0.07954545454545454,0.06382978723404255
"[0, 0, 1, 1, 0, 1, 1, 0, 1, 1, 0, 1, 0, 1, 1]",131,58,73,6,10,0.10344827586206896,0.136986301369863
"[1, 0, 0, 0, 1, 0, 0, 0, 0, 0, 1, 1, 1, 0, 1]",142,87,55,13,6,0.14942528735632185,0.10909090909090909
"[1, 1, 0, 1, 1, 1, 1, 0, 1, 0, 0, 0, 0, 0, 1]",134,59,75,6,10,0.1016949152542373,0.13333333333333333
"[1, 0, 1, 0, 1, 0, 0, 0, 0, 1, 0, 0, 1, 0, 1]",115,59,56,7,4,0.11864406779661017,0.07142857142857142
"[0, 1, 1, 1, 1, 0, 0, 0, 1, 1, 0, 1, 1, 0, 0]",146,78,68,10,8,0.1282051282051282,0.11764705882352941
"[1, 0, 1, 1, 1, 0, 1, 0, 1, 0, 0, 1, 1, 0, 1]",119,42,77,5,7,0.11904761904761904,0.09090909090909091
"[0, 1, 1, 0, 0, 0, 1, 0, 1, 0, 0, 0, 1, 0, 1]",138,84,54,11,2,0.13095238095238096,0.037037037037037035
"[0, 1, 0, 0, 1, 1, 1, 0, 1, 1, 1, 1, 0, 1, 0]",107,49,58,1,3,0.02040816326530612,0.05172413793103448
"[0, 1, 1, 1, 0, 1, 0, 1, 0, 1, 0, 0, 0, 1, 1]",122,61,61,6,6,0.09836065573770492,0.09836065573770492
"[1, 0, 0, 1, 1, 0, 0, 1, 1, 0, 1, 0, 1, 1, 0]",137,49,88,5,12,0.10204081632653061,0.13636363636363635
"[0, 1, 0, 0, 0, 1, 0, 0, 0, 1, 0, 0, 1, 0, 1]",248,172,76,11,11,0.06395348837209303,0.14473684210526316
"[0, 0, 0, 0, 0, 1, 0, 0, 1, 1, 0, 0, 1, 0, 1]",258,161,97,9,10,0.055900621118012424,0.10309278350515463
"[1, 1, 1, 0, 1, 0, 1, 0, 0, 1, 0, 1, 0, 0, 1]",115,43,72,7,10,0.16279069767441862,0.1388888888888889
"[1, 1, 0, 1, 0, 1, 1, 1, 0, 0, 1, 1, 0, 1, 0]",159,61,98,5,8,0.08196721311475409,0.08163265306122448
"[0, 0, 0, 0, 0, 0, 1, 1, 1, 0, 1, 0, 1, 1, 0]",210,125,85,17,9,0.136,0.10588235294117647
"[0, 0, 1, 0, 1, 0, 1, 0, 1, 1, 1, 1, 1, 1, 0]",167,77,90,9,11,0.11688311688311688,0.12222222222222222
"[0, 0, 1, 1, 0, 1, 0, 0, 1, 0, 1, 0, 1, 1, 0]",123,62,61,7,8,0.11290322580645161,0.13114754098360656
"[1, 1, 0, 1, 0, 0, 1, 1, 0, 1, 0, 0, 0, 0, 0]",176,109,67,4,10,0.03669724770642202,0.14925373134328357
"[0, 1, 1, 1, 1, 1, 1, 0, 1, 0, 1, 0, 0, 0, 1]",158,72,86,14,6,0.19444444444444445,0.06976744186046512
"[0, 0, 1, 1, 0, 0, 1, 0, 1, 1, 1, 1, 1, 1, 0]",206,79,127,9,19,0.11392405063291139,0.14960629921259844
"[0, 0, 1, 0, 1, 1, 1, 0, 0, 1, 0, 0, 1, 1, 0]",127,80,47,10,2,0.125,0.0425531914893617
"[0, 0, 0, 0, 0, 1, 1, 1, 1, 1, 0, 1, 1, 1, 0]",183,106,77,12,11,0.11320754716981132,0.14285714285714285
"[1, 0, 1, 0, 1, 1, 1, 1, 1, 0, 0, 1, 1, 0, 1]",232,81,151,4,14,0.04938271604938271,0.09271523178807947
"[0, 0, 1, 0, 0, 0, 1, 0, 1, 1, 1, 1, 1, 1, 0]",158,81,77,5,9,0.06172839506172839,0.11688311688311688
"[1, 1, 0, 1, 0, 1, 0, 0, 1, 1, 1, 0, 0, 1, 0]",116,59,57,2,5,0.03389830508474576,0.08771929824561403
"[1, 0, 0, 0, 1, 0, 1, 1, 1, 1, 1, 1, 0, 0, 1]",268,110,158,4,13,0.03636363636363636,0.08227848101265822
"[0, 0, 1, 1, 0, 0, 1, 0, 0, 0, 1, 1, 1, 1, 0]",163,94,69,14,6,0.14893617021276595,0.08695652173913043
"[1, 0, 0, 1, 0, 0, 1, 0, 1, 0, 1, 0, 0, 0, 1]",127,73,54,4,6,0.0547945205479452,0.1111111111111111
"[0, 0, 1, 0, 1, 1, 1, 0, 0, 1, 1, 0, 1, 1, 0]",120,48,72,3,7,0.0625,0.09722222222222222
"[0, 1, 0, 0, 1, 1, 0, 0, 0, 0, 1, 1, 0, 1, 0]",187,113,74,14,7,0.12389380530973451,0.0945945945945946
"[0, 0, 1, 1, 0, 1, 0, 0, 0, 1, 0, 0, 1, 1, 0]",147,98,49,12,2,0.12244897959183673,0.04081632653061224
"[1, 0, 1, 1, 0, 1, 1, 0, 1, 0, 1, 0, 1, 1, 0]",128,58,70,10,8,0.1724137931034483,0.11428571428571428
"[0, 1, 1, 0, 1, 0, 1, 0, 0, 1, 0, 0, 1, 0, 0]",137,87,50,7,1,0.08045977011494253,0.02
"[0, 0, 0, 1, 0, 0, 1, 0, 0, 1, 0, 1, 1, 1, 1]",157,91,66,10,5,0.10989010989010989,0.07575757575757576
"[1, 0, 1, 0, 0, 1, 0, 0, 0, 1, 0, 1, 1, 0, 1]",114,68,46,9,2,0.1323529411764706,0.043478260869565216
"[0, 1, 0, 1, 1, 1, 1, 0, 0, 1, 0, 0, 0, 1, 1]",127,67,60,4,6,0.05970149253731343,0.1
"[1, 0, 0, 0, 1, 1, 0, 1, 1, 1, 0, 1, 0, 1, 1]",119,31,88,1,11,0.03225806451612903,0.125
"[0, 0, 0, 1, 1, 1, 0, 1, 0, 1, 0, 0, 1, 0, 1]",90,47,43,7,5,0.14893617021276595,0.11627906976744186
"[1, 1, 0, 0, 0, 1, 0, 0, 0, 1, 0, 0, 1, 1, 1]",200,107,93,13,11,0.12149532710280374,0.11827956989247312
"[0, 1, 0, 0, 0, 1, 1, 0, 1, 1, 0, 1, 0, 0, 0]",142,87,55,10,5,0.11494252873563218,0.09090909090909091
"[0, 1, 0, 1, 0, 0, 0, 1, 0, 0, 1, 1, 0, 1, 1]",99,55,44,8,3,0.14545454545454545,0.06818181818181818
"[1, 0, 0, 1, 0, 0, 1, 0, 0, 1, 1, 0, 1, 0, 1]",117,63,54,8,4,0.12698412698412698,0.07407407407407407
"[1, 1, 0, 0, 1, 1, 1, 1, 1, 0, 0, 0, 1, 0, 0]",157,69,88,10,9,0.14492753623188406,0.10227272727272728
"[1, 0, 1, 1, 0, 0, 1, 1, 1, 1, 1, 0, 0, 0, 1]",184,72,112,9,14,0.125,0.125
"[1, 1, 0, 1, 1, 1, 0, 1, 0, 1, 0, 0, 1, 0, 1]",128,52,76,7,9,0.1346153846153846,0.11842105263157894
"[0, 1, 1, 0, 1, 1, 1, 0, 1, 0, 1, 0, 0, 1, 0]",97,40,57,2,4,0.05,0.07017543859649122
"[1, 1, 1, 0, 1, 0, 1, 1, 0, 1, 1, 1, 0, 1, 0]",211,73,138,5,14,0.0684931506849315,0.10144927536231885
"[0, 1, 0, 1, 1, 0, 1, 1, 1, 0, 0, 0, 1, 1, 0]",122,52,70,6,3,0.11538461538461539,0.04285714285714286
"[0, 1, 0, 1, 1, 0, 1, 0, 0, 1, 0, 0, 0, 1, 1]",155,89,66,10,7,0.11235955056179775,0.10606060606060606
"[1, 0, 1, 0, 1, 0, 0, 1, 1, 0, 1, 1, 0, 1, 0]",111,51,60,3,9,0.058823529411764705,0.15
"[1, 1, 0, 0, 1, 0, 1, 1, 1, 0, 1, 0, 1, 1, 0]",158,63,95,1,12,0.015873015873015872,0.12631578947368421
"[0, 0, 0, 1, 1, 1, 0, 0, 1, 0, 0, 1, 1, 1, 0]",126,65,61,7,7,0.1076923076923077,0.11475409836065574
"[1, 1, 1, 1, 0, 0, 0, 0, 1, 1, 1, 0, 0, 1, 0]",227,110,117,12,14,0.10909090909090909,0.11965811965811966
"[1, 1, 0, 0, 0, 1, 1, 1, 1, 0, 1, 1, 0, 0, 1]",163,59,104,4,13,0.06779661016949153,0.125
"[1, 0, 1, 0, 0, 0, 0, 1, 1, 1, 1, 1, 0, 0, 1]",161,70,91,8,6,0.11428571428571428,0.06593406593406594
"[0, 1, 0, 1, 1, 0, 0, 0, 1, 1, 0, 0, 1, 1, 1]",208,99,109,11,13,0.1111111111111111,0.11926605504587157
"[1, 0, 1, 0, 0, 1, 0, 0, 0, 1, 1, 1, 0, 1, 0]",113,63,50,4,8,0.06349206349206349,0.16
"[1, 0, 0, 0, 1, 0, 0, 1, 1, 1, 0, 1, 1, 1, 0]",121,48,73,5,6,0.10416666666666667,0.0821917808219178
"[1, 0, 1, 1, 0, 1, 0, 0, 1, 1, 1, 0, 1, 1, 0]",154,66,88,7,8,0.10606060606060606,0.09090909090909091
"[1, 0, 1, 0, 1, 1, 1, 1, 1, 1, 1, 0, 0, 1, 0]",258,78,180,6,13,0.07692307692307693,0.07222222222222222
"[1, 0, 1, 0, 1, 1, 1, 1, 0, 1, 0, 0, 0, 1, 1]",154,55,99,7,13,0.12727272727272726,0.13131313131313133
"[0, 1, 1, 1, 0, 1, 1, 1, 0, 0, 1, 0, 0, 0, 0]",118,67,51,7,4,0.1044776119402985,0.0784313725490196
"[1, 0, 1, 0, 1, 1, 1, 0, 1, 1, 1, 0, 0, 0, 1]",146,59,87,5,12,0.0847457627118644,0.13793103448275862
"[0, 1, 0, 1, 1, 0, 0, 0, 1, 1, 0, 1, 1, 0, 0]",136,68,68,6,3,0.08823529411764706,0.04411764705882353
"[0, 1, 0, 0, 1, 0, 0, 0, 0, 0, 1, 0, 1, 1, 0]",239,149,90,9,9,0.06040268456375839,0.1
"[0, 0, 0, 0, 1, 1, 0, 1, 0, 1, 1, 1, 1, 1, 0]",166,83,83,9,6,0.10843373493975904,0.07228915662650602
"[0, 0, 1, 0, 1, 0, 0, 0, 0, 1, 1, 0, 1, 0, 1]",141,89,52,12,3,0.1348314606741573,0.057692307692307696
"[0, 1, 0, 1, 0, 0, 1, 0, 1, 0, 1, 0, 1, 0, 1]",91,47,44,3,1,0.06382978723404255,0.022727272727272728
"[0, 1, 1, 1, 0, 0, 0, 0, 0, 1, 1, 0, 0, 0, 1]",161,93,68,3,3,0.03225806451612903,0.04411764705882353
"[0, 0, 1, 1, 1, 1, 0, 1, 1, 1, 0, 1, 1, 0, 0]",184,79,105,6,11,0.0759493670886076,0.10476190476190476
"[1, 0, 0, 0, 0, 0, 1, 1, 0, 1, 0, 0, 0, 1, 1]",197,110,87,8,8,0.07272727272727272,0.09195402298850575
"[1, 0, 1, 0, 0, 0, 0, 0, 1, 0, 1, 1, 0, 1, 0]",130,80,50,8,4,0.1,0.08
"[0, 0, 0, 1, 0, 0, 1, 1, 0, 0, 1, 0, 1, 1, 1]",165,90,75,6,9,0.06666666666666667,0.12
"[1, 1, 1, 0, 1, 0, 1, 0, 1, 0, 0, 0, 0, 0, 1]",117,55,62,10,8,0.18181818181818182,0.12903225806451613
"[0, 1, 1, 1, 1, 0, 1, 0, 1, 0, 1, 0, 0, 0, 0]",159,89,70,8,10,0.0898876404494382,0.14285714285714285
"[0, 1, 0, 0, 1, 0, 1, 1, 1, 1, 0, 1, 0, 1, 0]",108,46,62,5,11,0.10869565217391304,0.1774193548387097
"[1, 1, 1, 0, 1, 1, 1, 0, 0, 1, 0, 0, 0, 0, 1]",145,47,98,5,7,0.10638297872340426,0.07142857142857142
"[1, 1, 1, 1, 1, 0, 1, 0, 1, 0, 1, 0, 0, 0, 1]",170,78,92,9,10,0.11538461538461539,0.10869565217391304
"[0, 1, 0, 1, 1, 0, 1, 1, 0, 1, 0, 1, 1, 1, 0]",134,57,77,4,8,0.07017543859649122,0.1038961038961039
"[1, 1, 0, 1, 0, 1, 1, 1, 0, 0, 1, 0, 0, 1, 0]",108,48,60,5,11,0.10416666666666667,0.18333333333333332
"[1, 0, 0, 1, 0, 0, 1, 0, 0, 0, 1, 0, 0, 1, 0]",208,140,68,18,5,0.12857142857142856,0.07352941176470588
"[1, 1, 1, 0, 0, 0, 1, 0, 0, 1, 1, 1, 1, 0, 1]",152,64,88,13,10,0.203125,0.11363636363636363
"[1, 1, 1, 0, 0, 1, 0, 1, 1, 0, 1, 0, 0, 1, 0]",119,42,77,4,7,0.09523809523809523,0.09090909090909091
"[1, 0, 0, 1, 1, 1, 0, 1, 0, 1, 1, 0, 1, 0, 0]",95,37,58,2,5,0.05405405405405406,0.08620689655172414
"[0, 0, 1, 0, 0, 0, 1, 1, 0, 0, 1, 1, 0, 1, 0]",137,72,65,7,6,0.09722222222222222,0.09230769230769231
"[0, 0, 0, 1, 1, 0, 0, 1, 1, 1, 1, 1, 0, 0, 0]",332,225,107,16,9,0.07111111111111111,0.08411214953271028
"[1, 1, 0, 0, 1, 1, 0, 0, 1, 0, 1, 0, 0, 0, 1]",169,85,84,6,7,0.07058823529411765,0.08333333333333333
"[1, 1, 0, 0, 0, 0, 0, 1, 1, 1, 0, 1, 1, 0, 0]",149,77,72,6,3,0.07792207792207792,0.041666666666666664
"[0, 0, 0, 0, 1, 0, 1, 0, 1, 1, 0, 1, 0, 0, 1]",141,91,50,5,2,0.054945054945054944,0.04
"[1, 0, 0, 0, 1, 1, 0, 0, 0, 1, 0, 1, 0, 0, 1]",135,79,56,9,6,0.11392405063291139,0.10714285714285714
"[1, 0, 0, 1, 1, 1, 0, 1, 0, 0, 1, 1, 0, 1, 1]",161,50,111,2,8,0.04,0.07207207207207207
"[0, 1, 1, 1, 0, 1, 1, 0, 0, 1, 1, 0, 1, 0, 1]",136,62,74,5,13,0.08064516129032258,0.17567567567567569
"[0, 1, 0, 1, 0, 0, 1, 1, 0, 1, 0, 1, 0, 0, 0]",147,92,55,5,5,0.05434782608695652,0.09090909090909091
"[1, 0, 0, 1, 1, 1, 1, 1, 0, 0, 1, 0, 1, 1, 1]",388,104,284,12,30,0.11538461538461539,0.1056338028169014
"[1, 0, 0, 0, 1, 0, 1, 1, 0, 1, 0, 0, 0, 1, 0]",135,78,57,8,6,0.10256410256410256,0.10526315789473684
"[1, 1, 1, 0, 1, 0, 0, 0, 1, 0, 1, 0, 0, 1, 0]",112,53,59,7,4,0.1320754716981132,0.06779661016949153
"[0, 1, 1, 0, 0, 0, 1, 0, 1, 1, 1, 1, 0, 1, 0]",94,43,51,4,4,0.09302325581395349,0.0784313725490196
"[1, 0, 1, 1, 0, 0, 0, 0, 0, 1, 1, 0, 1, 1, 1]",144,74,70,4,5,0.05405405405405406,0.07142857142857142
"[1, 0, 1, 1, 1, 1, 0, 0, 0, 0, 0, 1, 0, 1, 1]",171,86,85,18,13,0.20930232558139536,0.15294117647058825
"[1, 0, 1, 1, 0, 0, 1, 1, 1, 0, 0, 0, 1, 0, 1]",124,57,67,3,8,0.05263157894736842,0.11940298507462686
"[1, 1, 1, 0, 1, 0, 0, 1, 0, 0, 0, 0, 0, 1, 1]",164,85,79,6,5,0.07058823529411765,0.06329113924050633
"[1, 1, 1, 0, 0, 0, 0, 1, 0, 0, 0, 1, 0, 1, 1]",147,62,85,8,3,0.12903225806451613,0.03529411764705882
"[0, 1, 1, 0, 0, 1, 1, 1, 0, 1, 1, 1, 0, 1, 0]",132,60,72,7,10,0.11666666666666667,0.1388888888888889
"[1, 1, 1, 0, 0, 1, 0, 1, 0, 0, 1, 1, 0, 1, 0]",118,55,63,3,7,0.05454545454545454,0.1111111111111111
"[1, 0, 0, 0, 0, 1, 1, 0, 1, 0, 1, 0, 0, 1, 1]",174,77,97,6,12,0.07792207792207792,0.12371134020618557
"[1, 0, 0, 0, 1, 0, 1, 0, 1, 1, 0, 0, 0, 0, 0]",289,165,124,16,8,0.09696969696969697,0.06451612903225806
"[1, 1, 0, 1, 1, 0, 0, 0, 1, 0, 0, 0, 1, 1, 1]",134,59,75,8,7,0.13559322033898305,0.09333333333333334
"[0, 1, 0, 0, 0, 0, 1, 0, 1, 1, 0, 1, 1, 0, 1]",85,49,36,5,3,0.10204081632653061,0.08333333333333333
"[0, 0, 1, 0, 1, 0, 1, 0, 0, 1, 1, 0, 1, 1, 1]",129,56,73,1,11,0.017857142857142856,0.1506849315068493
"[1, 0, 0, 1, 0, 1, 0, 1, 0, 0, 1, 1, 0, 1, 1]",126,52,74,7,8,0.1346153846153846,0.10810810810810811
"[0, 1, 1, 1, 0, 1, 0, 1, 1, 1, 0, 0, 0, 1, 0]",92,40,52,5,10,0.125,0.19230769230769232
"[1, 0, 1, 1, 0, 0, 1, 0, 0, 0, 1, 1, 1, 1, 0]",159,78,81,6,5,0.07692307692307693,0.06172839506172839
"[0, 0, 1, 1, 1, 0, 1, 1, 0, 1, 1, 0, 0, 0, 1]",109,46,63,6,6,0.13043478260869565,0.09523809523809523
"[1, 0, 1, 0, 0, 0, 0, 0, 1, 0, 1, 1, 1, 0, 1]",102,47,55,2,2,0.0425531914893617,0.03636363636363636
"[1, 1, 0, 0, 0, 1, 1, 0, 1, 1, 0, 0, 0, 0, 1]",160,86,74,12,10,0.13953488372093023,0.13513513513513514
"[0, 0, 1, 0, 1, 1, 1, 1, 1, 0, 0, 1, 0, 0, 0]",111,66,45,7,7,0.10606060606060606,0.15555555555555556
"[1, 1, 1, 1, 0, 0, 1, 1, 0, 1, 0, 0, 0, 0, 1]",196,98,98,15,12,0.15306122448979592,0.12244897959183673
"[1, 1, 1, 1, 1, 0, 0, 1, 0, 0, 1, 1, 0, 1, 0]",144,52,92,6,5,0.11538461538461539,0.05434782608695652
"[1, 0, 1, 0, 1, 1, 0, 0, 1, 1, 0, 1, 0, 1, 1]",162,64,98,6,5,0.09375,0.05102040816326531
"[1, 0, 1, 1, 0, 0, 0, 1, 0, 1, 1, 1, 0, 1, 0]",107,56,51,4,3,0.07142857142857142,0.058823529411764705
"[0, 0, 1, 1, 0, 0, 1, 0, 0, 0, 0, 1, 1, 0, 1]",163,95,68,5,10,0.05263157894736842,0.14705882352941177
"[0, 1, 0, 0, 1, 1, 0, 0, 1, 0, 1, 0, 0, 0, 1]",135,79,56,4,5,0.05063291139240506,0.08928571428571429
"[1, 0, 1, 1, 0, 1, 0, 0, 1, 0, 1, 0, 1, 1, 1]",148,55,93,6,11,0.10909090909090909,0.11827956989247312
"[1, 0, 1, 0, 1, 1, 0, 0, 0, 1, 1, 0, 0, 1, 1]",205,102,103,11,10,0.10784313725490197,0.0970873786407767
"[0, 1, 0, 1, 1, 1, 1, 0, 1, 0, 0, 1, 0, 1, 0]",83,36,47,4,7,0.1111111111111111,0.14893617021276595
"[1, 1, 0, 0, 1, 1, 1, 1, 1, 0, 1, 0, 0, 1, 0]",154,57,97,3,10,0.05263157894736842,0.10309278350515463
"[0, 1, 0, 1, 1, 0, 0, 1, 0, 1, 0, 0, 1, 0, 0]",132,70,62,8,6,0.11428571428571428,0.0967741935483871
"[0, 1, 0, 1, 0, 1, 1, 0, 0, 0, 1, 1, 0, 0, 0]",178,93,85,8,6,0.08602150537634409,0.07058823529411765
"[1, 0, 0, 1, 0, 1, 1, 0, 1, 1, 1, 1, 0, 0, 0]",170,72,98,8,11,0.1111111111111111,0.11224489795918367
"[1, 0, 1, 0, 0, 1, 1, 1, 0, 1, 1, 1, 1, 0, 1]",193,59,134,5,10,0.0847457627118644,0.07462686567164178
"[0, 0, 1, 0, 0, 1, 1, 0, 1, 1, 0, 0, 0, 1, 1]",160,84,76,12,6,0.14285714285714285,0.07894736842105263
"[0, 1, 0, 1, 0, 0, 0, 1, 1, 0, 1, 0, 0, 0, 1]",123,70,53,5,8,0.07142857142857142,0.1509433962264151
"[1, 1, 0, 0, 1, 0, 1, 0, 0, 0, 1, 1, 1, 0, 0]",135,72,63,4,7,0.05555555555555555,0.1111111111111111
"[1, 1, 0, 1, 1, 1, 1, 1, 1, 0, 0, 0, 0, 1, 0]",177,79,98,7,9,0.08860759493670886,0.09183673469387756
"[1, 0, 1, 0, 0, 0, 0, 1, 1, 0, 1, 1, 1, 1, 0]",109,53,56,6,8,0.11320754716981132,0.14285714285714285
"[0, 1, 1, 0, 0, 1, 1, 0, 1, 0, 0, 1, 1, 0, 1]",106,66,40,8,3,0.12121212121212122,0.075
"[0, 0, 1, 0, 1, 0, 1, 0, 0, 0, 1, 0, 1, 1, 1]",147,90,57,13,9,0.14444444444444443,0.15789473684210525
"[0, 1, 0, 1, 1, 0, 1, 1, 0, 1, 1, 1, 1, 0, 1]",234,83,151,10,19,0.12048192771084337,0.12582781456953643
"[0, 1, 1, 1, 0, 1, 0, 0, 1, 0, 1, 0, 1, 0, 1]",99,39,60,1,8,0.02564102564102564,0.13333333333333333
"[0, 1, 1, 0, 0, 1, 0, 1, 0, 0, 1, 1, 1, 1, 0]",136,70,66,7,6,0.1,0.09090909090909091
"[1, 0, 1, 1, 0, 1, 0, 1, 1, 0, 1, 1, 0, 1, 1]",207,63,144,10,18,0.15873015873015872,0.125
"[0, 1, 0, 0, 0, 0, 1, 0, 1, 1, 1, 1, 1, 0, 1]",128,65,63,4,9,0.06153846153846154,0.14285714285714285
"[0, 1, 1, 0, 0, 1, 0, 0, 0, 1, 1, 0, 1, 0, 1]",91,59,32,7,0,0.11864406779661017,0.0
"[1, 1, 0, 0, 1, 1, 0, 1, 1, 0, 1, 0, 1, 0, 0]",123,60,63,5,5,0.08333333333333333,0.07936507936507936
"[0, 0, 1, 0, 0, 1, 1, 0, 0, 1, 1, 0, 1, 1, 0]",128,66,62,7,2,0.10606060606060606,0.03225806451612903
"[0, 1, 1, 0, 1, 0, 1, 1, 1, 0, 0, 1, 0, 0, 0]",134,81,53,12,3,0.14814814814814814,0.05660377358490566
"[0, 0, 1, 0, 1, 0, 1, 1, 0, 0, 0, 0, 1, 0, 1]",128,73,55,11,8,0.1506849315068493,0.14545454545454545
"[0, 1, 1, 0, 1, 0, 0, 1, 1, 0, 1, 0, 0, 1, 0]",90,54,36,7,4,0.12962962962962962,0.1111111111111111
"[0, 1, 0, 1, 0, 1, 1, 1, 1, 1, 0, 1, 1, 0, 0]",132,59,73,6,3,0.1016949152542373,0.0410958904109589
"[1, 1, 0, 1, 0, 0, 1, 0, 1, 1, 0, 0, 0, 1, 1]",136,68,68,9,5,0.1323529411764706,0.07352941176470588
"[0, 0, 1, 1, 1, 0, 1, 0, 1, 1, 1, 0, 0, 0, 0]",150,84,66,10,2,0.11904761904761904,0.030303030303030304
"[1, 0, 0, 0, 1, 0, 1, 0, 0, 1, 0, 1, 1, 0, 1]",108,69,39,3,2,0.043478260869565216,0.05128205128205128
"[0, 1, 0, 1, 0, 0, 1, 1, 0, 1, 1, 1, 1, 0, 1]",132,47,85,4,9,0.0851063829787234,0.10588235294117647
"[0, 1, 0, 0, 1, 1, 1, 0, 1, 0, 1, 0, 1, 0, 1]",95,35,60,2,3,0.05714285714285714,0.05
"[0, 0, 1, 0, 0, 1, 0, 0, 1, 0, 1, 0, 0, 1, 0]",205,120,85,14,9,0.11666666666666667,0.10588235294117647
"[1, 0, 1, 0, 1, 0, 1, 1, 0, 0, 1, 1, 0, 1, 0]",127,62,65,5,7,0.08064516129032258,0.1076923076923077
"[0, 1, 1, 0, 1, 0, 1, 1, 0, 0, 0, 1, 1, 0, 0]",136,67,69,7,6,0.1044776119402985,0.08695652173913043
"[0, 1, 1, 1, 0, 1, 0, 1, 1, 0, 0, 1, 1, 0, 1]",138,52,86,3,10,0.057692307692307696,0.11627906976744186
"[0, 0, 1, 1, 0, 1, 1, 1, 0, 0, 0, 1, 0, 1, 1]",157,78,79,8,11,0.10256410256410256,0.13924050632911392
"[0, 0, 1, 1, 0, 1, 0, 0, 1, 0, 1, 1, 0, 0, 1]",122,54,68,6,5,0.1111111111111111,0.07352941176470588
"[0, 1, 0, 0, 1, 1, 0, 0, 0, 1, 0, 0, 1, 1, 1]",179,96,83,7,7,0.07291666666666667,0.08433734939759036
"[0, 0, 0, 1, 1, 0, 1, 1, 1, 1, 1, 0, 1, 0, 0]",118,51,67,4,6,0.0784313725490196,0.08955223880597014
"[0, 1, 1, 1, 0, 1, 0, 1, 0, 0, 0, 1, 1, 0, 1]",92,47,45,6,4,0.1276595744680851,0.08888888888888889
"[1, 1, 0, 0, 1, 0, 1, 1, 1, 0, 0, 1, 1, 0, 1]",149,50,99,3,7,0.06,0.0707070707070707
"[0, 1, 0, 0, 1, 0, 1, 0, 0, 0, 1, 1, 0, 1, 1]",111,62,49,8,4,0.12903225806451613,0.08163265306122448
"[0, 0, 1, 0, 1, 0, 1, 1, 0, 0, 1, 0, 0, 0, 1]",127,81,46,4,2,0.04938271604938271,0.043478260869565216
"[0, 1, 1, 0, 0, 0, 0, 0, 1, 0, 1, 1, 0, 1, 1]",156,97,59,10,1,0.10309278350515463,0.01694915254237288
"[0, 1, 1, 0, 1, 0, 1, 1, 0, 0, 0, 0, 1, 0, 1]",109,71,38,5,4,0.07042253521126761,0.10526315789473684
"[1, 1, 1, 1, 0, 0, 0, 1, 0, 0, 1, 0, 0, 1, 0]",105,57,48,7,5,0.12280701754385964,0.10416666666666667
"[1, 0, 1, 0, 0, 0, 1, 1, 1, 0, 1, 0, 0, 1, 0]",87,52,35,4,6,0.07692307692307693,0.17142857142857143
"[1, 0, 0, 0, 1, 0, 1, 1, 1, 1, 0, 1, 0, 1, 0]",103,62,41,5,4,0.08064516129032258,0.0975609756097561
"[0, 1, 0, 0, 1, 0, 1, 0, 0, 1, 0, 1, 1, 1, 0]",103,49,54,5,5,0.10204081632653061,0.09259259259259259
"[1, 0, 1, 0, 1, 1, 0, 1, 0, 0, 0, 0, 0, 1, 1]",133,75,58,8,0,0.10666666666666667,0.0
"[1, 0, 1, 0, 0, 1, 0, 0, 1, 0, 1, 1, 0, 1, 1]",110,49,61,4,6,0.08163265306122448,0.09836065573770492
"[0, 0, 1, 0, 0, 1, 0, 1, 0, 0, 1, 1, 0, 1, 0]",124,73,51,7,6,0.0958904109589041,0.11764705882352941
"[0, 0, 0, 1, 0, 1, 1, 1, 1, 0, 1, 0, 1, 1, 0]",115,52,63,4,10,0.07692307692307693,0.15873015873015872
"[1, 0, 0, 0, 0, 1, 0, 1, 0, 1, 0, 0, 1, 0, 1]",126,56,70,6,2,0.10714285714285714,0.02857142857142857
"[0, 1, 0, 0, 1, 0, 1, 0, 1, 0, 0, 0, 1, 0, 1]",140,83,57,6,2,0.07228915662650602,0.03508771929824561
"[1, 0, 1, 0, 0, 1, 0, 1, 0, 1, 0, 0, 0, 1, 0]",139,76,63,5,7,0.06578947368421052,0.1111111111111111
"[0, 0, 1, 1, 0, 0, 0, 1, 0, 1, 0, 1, 1, 1, 0]",144,81,63,7,7,0.08641975308641975,0.1111111111111111
"[1, 0, 1, 0, 1, 0, 1, 1, 0, 1, 1, 0, 0, 0, 1]",111,52,59,8,5,0.15384615384615385,0.0847457627118644
"[1, 1, 0, 1, 0, 0, 1, 1, 1, 1, 0, 1, 0, 0, 0]",125,59,66,3,4,0.05084745762711865,0.06060606060606061
"[0, 1, 1, 0, 1, 0, 1, 1, 0, 1, 0, 0, 0, 1, 1]",138,73,65,7,4,0.0958904109589041,0.06153846153846154
"[0, 1, 0, 1, 1, 0, 0, 1, 0, 1, 1, 0, 0, 1, 1]",129,57,72,2,4,0.03508771929824561,0.05555555555555555
"[0, 0, 0, 0, 1, 0, 1, 0, 1, 1, 0, 1, 1, 1, 0]",114,61,53,3,4,0.04918032786885246,0.07547169811320754
"[0, 1, 1, 1, 1, 0, 1, 0, 1, 0, 1, 0, 0, 1, 0]",113,60,53,9,4,0.15,0.07547169811320754
"[1, 0, 1, 1, 1, 0, 0, 1, 0, 1, 0, 0, 0, 1, 0]",94,51,43,8,3,0.1568627450980392,0.06976744186046512
"[1, 0, 0, 0, 1, 1, 0, 1, 0, 1, 0, 0, 1, 0, 0]",135,78,57,4,3,0.05128205128205128,0.05263157894736842
"[1, 0, 0, 0, 1, 1, 1, 1, 1, 0, 0, 0, 1, 0, 1]",124,59,65,10,8,0.1694915254237288,0.12307692307692308
"[1, 0, 0, 1, 0, 0, 1, 0, 1, 1, 0, 0, 1, 1, 1]",173,80,93,8,9,0.1,0.0967741935483871
"[0, 0, 1, 1, 0, 1, 1, 1, 0, 1, 0, 1, 1, 0, 1]",128,32,96,2,13,0.0625,0.13541666666666666
"[1, 0, 0, 1, 1, 1, 0, 1, 0, 0, 1, 1, 0, 1, 0]",109,46,63,7,3,0.15217391304347827,0.047619047619047616
"[1, 0, 0, 1, 1, 0, 1, 0, 0, 1, 1, 0, 0, 0, 1]",108,56,52,3,3,0.05357142857142857,0.057692307692307696
"[1, 0, 1, 0, 1, 0, 1, 1, 1, 0, 0, 1, 0, 0, 0]",134,64,70,8,2,0.125,0.02857142857142857
"[0, 1, 1, 1, 1, 0, 1, 0, 1, 0, 0, 0, 0, 1, 0]",115,69,46,10,4,0.14492753623188406,0.08695652173913043
"[0, 1, 0, 1, 1, 1, 1, 0, 0, 1, 0, 1, 1, 0, 1]",136,47,89,1,13,0.02127659574468085,0.14606741573033707
"[1, 0, 1, 0, 1, 1, 1, 0, 1, 1, 1, 0, 1, 0, 1]",212,69,143,8,15,0.11594202898550725,0.1048951048951049
"[0, 1, 0, 1, 0, 1, 0, 1, 1, 1, 0, 0, 1, 0, 1]",106,49,57,10,8,0.20408163265306123,0.14035087719298245
"[0, 0, 1, 0, 0, 1, 0, 1, 0, 1, 1, 0, 0, 1, 1]",151,88,63,6,7,0.06818181818181818,0.1111111111111111
"[0, 0, 1, 0, 1, 1, 1, 1, 0, 1, 1, 0, 1, 0, 1]",140,58,82,2,12,0.034482758620689655,0.14634146341463414
"[0, 1, 0, 1, 1, 0, 1, 0, 1, 0, 0, 1, 0, 1, 1]",111,57,54,6,4,0.10526315789473684,0.07407407407407407
"[0, 1, 1, 1, 1, 1, 0, 0, 1, 0, 0, 1, 0, 0, 1]",141,66,75,6,5,0.09090909090909091,0.06666666666666667
"[1, 0, 0, 1, 0, 1, 0, 1, 1, 1, 1, 1, 0, 0, 1]",185,67,118,8,8,0.11940298507462686,0.06779661016949153
"[0, 0, 1, 1, 0, 1, 1, 1, 0, 1, 0, 1, 1, 0, 0]",117,48,69,5,6,0.10416666666666667,0.08695652173913043
"[1, 0, 0, 0, 1, 1, 1, 1, 0, 0, 1, 0, 0, 0, 1]",127,70,57,6,7,0.08571428571428572,0.12280701754385964
"[0, 1, 1, 1, 1, 0, 0, 1, 0, 0, 0, 1, 1, 0, 0]",173,96,77,9,7,0.09375,0.09090909090909091
"[0, 1, 1, 1, 0, 0, 0, 1, 1, 1, 1, 0, 1, 1, 0]",153,71,82,5,9,0.07042253521126761,0.10975609756097561
"[0, 0, 1, 0, 0, 0, 1, 1, 1, 0, 1, 0, 1, 1, 0]",120,66,54,5,8,0.07575757575757576,0.14814814814814814
"[0, 1, 0, 0, 1, 0, 1, 0, 1, 1, 1, 0, 1, 0, 1]",107,37,70,4,7,0.10810810810810811,0.1
"[1, 0, 1, 1, 0, 1, 0, 0, 1, 0, 0, 1, 0, 1, 0]",97,45,52,4,2,0.08888888888888889,0.038461538461538464
"[0, 1, 0, 0, 1, 0, 1, 0, 0, 1, 1, 0, 0, 0, 1]",141,93,48,6,6,0.06451612903225806,0.125
"[0, 1, 1, 0, 1, 1, 0, 0, 1, 0, 1, 0, 0, 1, 1]",120,55,65,7,4,0.12727272727272726,0.06153846153846154
"[1, 0, 0, 0, 1, 1, 0, 1, 1, 0, 1, 0, 1, 0, 0]",118,58,60,6,3,0.10344827586206896,0.05
"[0, 1, 1, 1, 0, 0, 0, 1, 0, 1, 1, 0, 0, 0, 0]",172,97,75,10,9,0.10309278350515463,0.12
"[1, 1, 0, 1, 1, 1, 0, 0, 1, 1, 0, 1, 0, 0, 0]",118,58,60,8,8,0.13793103448275862,0.13333333333333333
"[1, 0, 0, 1, 0, 1, 0, 0, 0, 1, 1, 0, 1, 1, 0]",123,57,66,3,6,0.05263157894736842,0.09090909090909091
"[1, 1, 0, 0, 1, 0, 0, 1, 0, 1, 0, 1, 0, 1, 1]",107,58,49,7,4,0.1206896551724138,0.08163265306122448
"[0, 0, 1, 1, 0, 1, 1, 0, 1, 1, 1, 1, 0, 0, 0]",179,96,83,5,6,0.052083333333333336,0.07228915662650602
"[0, 1, 0, 0, 1, 1, 0, 0, 1, 1, 0, 1, 0, 1, 0]",114,66,48,6,4,0.09090909090909091,0.08333333333333333
"[1, 0, 1, 0, 0, 1, 0, 0, 0, 1, 1, 1, 0, 0, 0]",143,86,57,15,1,0.1744186046511628,0.017543859649122806
"[1, 1, 1, 0, 1, 0, 1, 0, 0, 1, 1, 0, 1, 0, 1]",138,47,91,7,8,0.14893617021276595,0.08791208791208792
"[1, 0, 0, 0, 1, 1, 1, 1, 0, 0, 0, 1, 1, 1, 0]",116,55,61,2,2,0.03636363636363636,0.03278688524590164
"[1, 1, 0, 1, 1, 0, 0, 0, 1, 0, 1, 0, 1, 1, 1]",180,70,110,10,11,0.14285714285714285,0.1
"[0, 1, 1, 0, 1, 0, 0, 0, 1, 0, 1, 1, 0, 1, 0]",88,51,37,4,3,0.0784313725490196,0.08108108108108109
"[1, 1, 1, 1, 0, 1, 0, 1, 0, 0, 1, 1, 0, 1, 0]",149,63,86,10,10,0.15873015873015872,0.11627906976744186
"[1, 0, 0, 1, 1, 1, 0, 0, 1, 0, 1, 1, 0, 0, 1]",129,59,70,9,6,0.15254237288135594,0.08571428571428572
"[1, 1, 0, 0, 1, 1, 1, 0, 0, 1, 0, 1, 1, 0, 0]",127,51,76,3,8,0.058823529411764705,0.10526315789473684
"[0, 1, 0, 1, 1, 0, 1, 0, 0, 1, 0, 1, 0, 0, 1]",104,54,50,4,6,0.07407407407407407,0.12
"[0, 0, 0, 1, 0, 1, 0, 0, 1, 1, 1, 1, 0, 1, 0]",102,49,53,1,7,0.02040816326530612,0.1320754716981132
"[1, 0, 1, 0, 0, 1, 0, 1, 1, 1, 0, 0, 1, 0, 0]",118,55,63,2,7,0.03636363636363636,0.1111111111111111
"[1, 0, 0, 0, 1, 1, 1, 1, 0, 0, 0, 1, 1, 0, 1]",111,46,65,6,10,0.13043478260869565,0.15384615384615385
"[1, 0, 0, 1, 0, 1, 0, 0, 1, 1, 0, 1, 1, 1, 1]",175,65,110,6,5,0.09230769230769231,0.045454545454545456
"[1, 0, 1, 0, 0, 1, 0, 1, 0, 1, 1, 1, 0, 1, 0]",110,46,64,5,6,0.10869565217391304,0.09375
"[0, 1, 0, 0, 1, 0, 1, 0, 1, 0, 1, 1, 0, 1, 0]",96,52,44,1,5,0.019230769230769232,0.11363636363636363
"[1, 1, 0, 1, 0, 1, 0, 1, 0, 1, 0, 0, 1, 0, 1]",122,54,68,4,13,0.07407407407407407,0.19117647058823528
"[0, 1, 0, 0, 1, 0, 0, 1, 1, 1, 0, 0, 0, 1, 0]",145,95,50,4,6,0.042105263157894736,0.12
"[0, 0, 0, 1, 1, 1, 0, 0, 1, 0, 0, 0, 0, 0, 1]",295,200,95,10,12,0.05,0.12631578947368421
"[1, 0, 0, 1, 1, 0, 0, 0, 1, 1, 1, 1, 1, 1, 1]",588,167,421,14,32,0.08383233532934131,0.07600950118764846
"[1, 1, 0, 1, 0, 1, 1, 1, 1, 0, 0, 1, 1, 0, 0]",362,153,209,15,18,0.09803921568627451,0.0861244019138756
"[1, 1, 1, 0, 0, 0, 1, 1, 0, 1, 0, 0, 0, 1, 1]",170,69,101,6,13,0.08695652173913043,0.12871287128712872
"[1, 1, 1, 1, 0, 0, 1, 1, 1, 1, 1, 1, 1, 1, 1]",30596,5571,25025,562,2412,0.10087955483755161,0.09638361638361638
"[1, 0, 1, 0, 1, 1, 1, 0, 1, 0, 0, 1, 1, 1, 1]",284,109,175,12,21,0.11009174311926606,0.12
"[1, 1, 1, 0, 1, 1, 0, 1, 1, 0, 1, 1, 1, 1, 1]",1787,412,1375,42,137,0.10194174757281553,0.09963636363636363
"[1, 1, 1, 0, 1, 0, 1, 0, 1, 1, 1, 1, 0, 1, 1]",526,156,370,23,22,0.14743589743589744,0.05945945945945946
"[1, 1, 1, 1, 1, 1, 1, 1, 1, 1, 1, 0, 1, 0, 1]",8620,1435,7185,136,707,0.09477351916376307,0.09839944328462073
"[1, 1, 0, 1, 1, 1, 1, 1, 1, 1, 1, 1, 1, 1, 0]",8476,1534,6942,140,604,0.09126466753585398,0.08700662633246903
"[0, 0, 1, 1, 0, 1, 0, 1, 1, 1, 1, 0, 1, 1, 1]",270,105,165,6,13,0.05714285714285714,0.07878787878787878
"[1, 1, 1, 0, 0, 1, 1, 0, 1, 0, 1, 1, 1, 1, 0]",291,95,196,15,23,0.15789473684210525,0.11734693877551021
"[0, 0, 0, 1, 1, 1, 1, 1, 1, 1, 1, 0, 0, 1, 1]",2349,1728,621,171,57,0.09895833333333333,0.09178743961352658
"[1, 1, 0, 0, 0, 0, 0, 0, 0, 0, 0, 0, 1, 1, 1]",3910,2602,1308,285,134,0.10953112990007687,0.10244648318042814
"[1, 1, 1, 1, 1, 1, 1, 0, 0, 0, 0, 0, 0, 0, 0]",1888,417,1471,34,130,0.0815347721822542,0.08837525492861999
"[1, 1, 1, 1, 1, 0, 1, 1, 1, 1, 1, 0, 1, 1, 1]",7528,1308,6220,130,569,0.09938837920489296,0.09147909967845659
"[0, 1, 1, 1, 1, 1, 1, 1, 1, 1, 1, 0, 1, 1, 1]",8760,2645,6115,266,557,0.10056710775047259,0.0910874897792314
"[0, 0, 1, 1, 1, 0, 0, 0, 0, 0, 0, 0, 0, 0, 0]",3503,2607,896,247,84,0.09474491752972766,0.09375
"[0, 0, 0, 1, 1, 0, 0, 1, 0, 0, 0, 0, 0, 0, 0]",2254,1777,477,161,54,0.09060213843556555,0.11320754716981132
"[0, 0, 0, 0, 1, 1, 0, 0, 1, 0, 0, 0, 0, 0, 0]",2279,1764,515,167,51,0.09467120181405896,0.09902912621359224
"[0, 0, 0, 0, 0, 1, 0, 0, 0, 0, 0, 0, 0, 0, 1]",8713,7231,1482,724,156,0.10012446411284746,0.10526315789473684
"[0, 0, 0, 0, 0, 0, 0, 0, 0, 0, 0, 1, 0, 0, 0]",56577,50017,6560,4747,618,0.09490773137133375,0.09420731707317073
"[0, 0, 1, 1, 1, 1, 0, 0, 1, 1, 1, 1, 1, 1, 1]",5215,1556,3659,149,356,0.09575835475578406,0.09729434271658924
"[0, 0, 1, 0, 0, 0, 1, 1, 1, 1, 0, 0, 0, 1, 1]",177,91,86,10,8,0.10989010989010989,0.09302325581395349
"[1, 0, 0, 1, 0, 0, 0, 1, 1, 1, 1, 0, 0, 0, 1]",140,73,67,10,6,0.136986301369863,0.08955223880597014
"[1, 1, 0, 0, 1, 0, 0, 0, 1, 1, 1, 1, 0, 0, 0]",221,117,104,8,10,0.06837606837606838,0.09615384615384616
"[1, 1, 0, 0, 1, 1, 0, 1, 0, 0, 0, 0, 0, 1, 1]",230,105,125,13,7,0.12380952380952381,0.056
"[0, 0, 1, 1, 1, 1, 1, 1, 0, 1, 1, 1, 0, 1, 1]",712,212,500,23,42,0.10849056603773585,0.084
"[0, 1, 1, 0, 1, 0, 1, 1, 1, 1, 1, 1, 1, 1, 1]",2215,617,1598,63,145,0.10210696920583469,0.09073842302878599
"[1, 1, 0, 1, 1, 0, 1, 0, 1, 1, 1, 1, 1, 1, 1]",1951,447,1504,51,154,0.11409395973154363,0.1023936170212766
"[1, 0, 1, 1, 1, 0, 1, 1, 0, 1, 0, 1, 1, 1, 1]",575,176,399,17,47,0.09659090909090909,0.11779448621553884
"[1, 1, 1, 1, 1, 1, 0, 1, 0, 1, 1, 1, 0, 1, 1]",1738,394,1344,41,150,0.10406091370558376,0.11160714285714286
"[1, 1, 1, 1, 1, 1, 1, 1, 1, 0, 1, 0, 1, 1, 1]",9125,1530,7595,133,727,0.0869281045751634,0.09572086899275839
"[1, 1, 1, 0, 1, 1, 1, 1, 0, 0, 0, 1, 1, 0, 1]",225,78,147,5,11,0.0641025641025641,0.07482993197278912
"[1, 1, 1, 1, 1, 0, 1, 1, 1, 1, 0, 0, 0, 1, 1]",736,208,528,17,61,0.08173076923076923,0.11553030303030302
"[0, 0, 1, 0, 1, 1, 1, 1, 1, 0, 1, 1, 1, 1, 0]",271,103,168,15,14,0.14563106796116504,0.08333333333333333
"[0, 1, 1, 1, 0, 1, 0, 1, 1, 1, 1, 0, 1, 0, 0]",165,80,85,5,10,0.0625,0.11764705882352941
"[0, 0, 0, 0, 0, 1, 1, 0, 1, 0, 0, 1, 1, 1, 0]",166,104,62,7,3,0.0673076923076923,0.04838709677419355
"[0, 1, 1, 0, 1, 0, 0, 0, 1, 1, 0, 0, 1, 1, 0]",207,98,109,10,13,0.10204081632653061,0.11926605504587157
"[1, 1, 1, 1, 1, 1, 1, 0, 1, 1, 1, 0, 1, 1, 1]",7975,1331,6644,127,637,0.09541697971450037,0.09587597832630945
"[1, 0, 1, 1, 1, 1, 1, 1, 1, 1, 1, 0, 1, 1, 1]",7614,1371,6243,130,526,0.09482129832239242,0.08425436488867531
"[0, 0, 0, 1, 1, 1, 1, 1, 0, 1, 0, 0, 0, 1, 1]",182,107,75,6,12,0.056074766355140186,0.16
"[0, 0, 0, 0, 0, 1, 1, 1, 1, 1, 0, 0, 0, 1, 0]",215,133,82,7,3,0.05263157894736842,0.036585365853658534
"[0, 0, 1, 0, 0, 0, 1, 0, 0, 0, 0, 0, 1, 1, 1]",513,360,153,34,17,0.09444444444444444,0.1111111111111111
"[1, 1, 1, 0, 0, 0, 0, 0, 0, 0, 0, 1, 0, 0, 0]",889,455,434,44,42,0.0967032967032967,0.0967741935483871
"[1, 0, 0, 0, 0, 0, 0, 0, 0, 0, 0, 0, 0, 0, 1]",12035,8223,3812,810,339,0.09850419554906968,0.08892969569779643
"[0, 1, 1, 1, 1, 1, 1, 1, 1, 0, 1, 1, 0, 1, 0]",581,204,377,18,31,0.08823529411764706,0.08222811671087533
"[1, 0, 0, 0, 0, 0, 1, 1, 1, 1, 1, 1, 1, 1, 0]",503,206,297,19,18,0.09223300970873786,0.06060606060606061
"[0, 0, 0, 1, 1, 0, 0, 1, 1, 0, 1, 0, 1, 1, 0]",161,111,50,10,4,0.09009009009009009,0.08
"[1, 1, 1, 1, 0, 0, 0, 1, 1, 0, 0, 1, 1, 0, 1]",174,76,98,5,8,0.06578947368421052,0.08163265306122448
"[1, 1, 1, 1, 1, 1, 1, 1, 0, 0, 0, 1, 1, 0, 0]",562,169,393,18,37,0.10650887573964497,0.09414758269720101
"[1, 1, 1, 0, 0, 0, 1, 0, 1, 1, 1, 1, 1, 1, 1]",864,230,634,26,69,0.11304347826086956,0.10883280757097792
"[1, 1, 1, 1, 1, 1, 0, 0, 0, 1, 0, 1, 1, 1, 1]",966,294,672,25,69,0.08503401360544217,0.10267857142857142
"[0, 1, 0, 1, 1, 1, 1, 1, 1, 0, 0, 0, 1, 0, 1]",161,66,95,5,9,0.07575757575757576,0.09473684210526316
"[0, 1, 0, 1, 0, 1, 1, 1, 1, 1, 1, 0, 0, 0, 1]",163,77,86,8,10,0.1038961038961039,0.11627906976744186
"[0, 1, 1, 0, 0, 1, 0, 1, 0, 1, 1, 1, 1, 1, 1]",378,160,218,17,15,0.10625,0.06880733944954129
"[1, 1, 0, 1, 0, 1, 1, 0, 0, 1, 0, 1, 0, 1, 1]",144,56,88,5,9,0.08928571428571429,0.10227272727272728
"[0, 1, 1, 0, 0, 0, 0, 0, 0, 0, 0, 1, 1, 1, 1]",2431,2036,395,179,38,0.08791748526522593,0.09620253164556962
"[0, 1, 0, 0, 0, 0, 1, 1, 0, 0, 0, 0, 0, 0, 0]",3444,2612,832,262,88,0.1003062787136294,0.10576923076923077
"[0, 0, 0, 0, 0, 0, 0, 1, 0, 0, 1, 1, 1, 0, 1]",277,196,81,18,6,0.09183673469387756,0.07407407407407407
"[0, 0, 0, 0, 0, 0, 0, 0, 0, 0, 0, 1, 0, 0, 1]",10259,8678,1581,847,149,0.0976031343627564,0.09424414927261227
"[1, 0, 1, 0, 1, 1, 0, 0, 0, 0, 0, 0, 0, 0, 0]",966,651,315,58,27,0.0890937019969278,0.08571428571428572
"[0, 0, 0, 1, 1, 1, 0, 1, 0, 1, 1, 1, 0, 1, 0]",93,47,46,3,1,0.06382978723404255,0.021739130434782608
"[1, 1, 0, 1, 0, 0, 0, 1, 1, 1, 0, 1, 0, 1, 1]",156,70,86,7,6,0.1,0.06976744186046512
"[0, 0, 0, 0, 0, 0, 0, 0, 1, 0, 1, 1, 0, 0, 1]",787,575,212,54,25,0.09391304347826086,0.1179245283018868
"[0, 0, 0, 0, 0, 1, 0, 1, 0, 0, 0, 0, 0, 0, 0]",8541,6992,1549,625,140,0.08938787185354691,0.09038089089735313
"[1, 0, 1, 1, 1, 0, 0, 1, 1, 0, 0, 1, 1, 0, 0]",394,173,221,17,21,0.09826589595375723,0.09502262443438914
"[0, 0, 0, 0, 1, 0, 0, 1, 0, 0, 0, 0, 0, 0, 0]",8384,6925,1459,714,157,0.10310469314079422,0.10760795065113091
"[0, 0, 0, 0, 0, 0, 0, 0, 0, 0, 1, 0, 0, 1, 0]",7794,6504,1290,655,129,0.10070725707257072,0.1
"[1, 1, 1, 1, 0, 0, 1, 1, 0, 1, 1, 1, 1, 1, 1]",2643,669,1974,70,180,0.10463378176382661,0.0911854103343465
"[1, 1, 1, 0, 1, 1, 1, 1, 1, 1, 0, 0, 1, 1, 1]",3265,748,2517,79,239,0.10561497326203209,0.09495431068732618
"[1, 1, 0, 0, 1, 1, 1, 1, 0, 1, 1, 1, 1, 0, 1]",668,188,480,11,37,0.05851063829787234,0.07708333333333334
"[1, 0, 0, 1, 1, 0, 0, 1, 0, 1, 0, 1, 1, 1, 1]",245,79,166,6,17,0.0759493670886076,0.10240963855421686
"[0, 0, 0, 0, 1, 1, 1, 1, 1, 1, 1, 0, 1, 0, 1]",295,131,164,12,21,0.0916030534351145,0.12804878048780488
"[0, 1, 0, 0, 0, 1, 1, 1, 0, 0, 0, 0, 0, 0, 1]",367,226,141,19,16,0.084070796460177,0.11347517730496454
"[1, 0, 1, 0, 1, 0, 0, 0, 1, 1, 1, 0, 0, 0, 0]",204,117,87,10,10,0.08547008547008547,0.11494252873563218
"[0, 0, 0, 0, 1, 0, 0, 0, 0, 0, 1, 0, 0, 0, 0]",7145,5862,1283,592,109,0.10098942340498124,0.08495713172252534
"[0, 1, 0, 1, 0, 1, 0, 0, 0, 0, 1, 0, 0, 0, 0]",539,373,166,41,21,0.10991957104557641,0.12650602409638553
"[0, 1, 0, 0, 0, 0, 0, 1, 0, 0, 0, 0, 0, 0, 0]",7847,6435,1412,599,143,0.09308469308469308,0.10127478753541076
"[0, 0, 0, 0, 1, 0, 0, 0, 0, 1, 0, 0, 0, 0, 0]",7514,6141,1373,552,138,0.0898876404494382,0.10050983248361253
"[1, 1, 1, 0, 0, 0, 0, 0, 0, 1, 0, 0, 0, 0, 0]",798,442,356,37,27,0.083710407239819,0.07584269662921349
"[0, 0, 0, 0, 0, 1, 1, 1, 0, 0, 0, 0, 0, 0, 1]",959,731,228,68,16,0.09302325581395349,0.07017543859649122
"[0, 0, 1, 0, 1, 0, 1, 0, 0, 0, 0, 0, 0, 0, 1]",591,415,176,46,16,0.1108433734939759,0.09090909090909091
"[1, 0, 0, 1, 0, 1, 0, 1, 0, 0, 0, 0, 0, 0, 0]",649,427,222,36,35,0.08430913348946135,0.15765765765765766
"[1, 0, 0, 0, 0, 0, 0, 0, 1, 0, 0, 0, 0, 0, 0]",7974,6225,1749,591,154,0.09493975903614457,0.0880503144654088
"[0, 0, 0, 0, 0, 0, 1, 1, 1, 1, 1, 1, 1, 1, 1]",2894,1232,1662,110,159,0.08928571428571429,0.09566787003610108
"[1, 1, 1, 1, 1, 1, 0, 0, 0, 0, 0, 0, 0, 0, 1]",1777,921,856,83,64,0.09011943539630836,0.07476635514018691
"[0, 1, 1, 1, 1, 1, 1, 0, 0, 0, 0, 0, 0, 0, 0]",2215,1848,367,180,36,0.09740259740259741,0.09809264305177112
"[1, 1, 1, 0, 0, 1, 1, 1, 1, 1, 1, 0, 0, 0, 0]",1980,333,1647,35,166,0.10510510510510511,0.100789313904068
"[1, 1, 1, 1, 1, 0, 1, 1, 0, 0, 1, 1, 1, 1, 1]",2834,630,2204,56,221,0.08888888888888889,0.10027223230490018
"[1, 1, 1, 1, 1, 1, 1, 0, 1, 1, 0, 0, 1, 1, 1]",2752,590,2162,54,178,0.09152542372881356,0.08233117483811286
"[1, 1, 1, 1, 1, 1, 1, 1, 1, 1, 1, 0, 1, 1, 0]",8426,1439,6987,152,689,0.10562890896455872,0.0986117074567053
"[0, 1, 1, 1, 1, 1, 1, 1, 1, 1, 1, 1, 1, 1, 0]",10168,2875,7293,259,712,0.09008695652173913,0.09762786233374468
"[1, 0, 1, 1, 1, 0, 0, 1, 1, 1, 1, 1, 1, 0, 0]",720,247,473,26,43,0.10526315789473684,0.09090909090909091
"[0, 1, 0, 1, 0, 0, 0, 0, 0, 0, 0, 0, 0, 0, 0]",9911,8098,1813,775,164,0.09570264262780934,0.09045780474351903
"[1, 0, 0, 0, 0, 1, 1, 1, 1, 0, 1, 0, 1, 0, 0]",165,63,102,8,14,0.12698412698412698,0.13725490196078433
"[0, 0, 1, 0, 0, 1, 0, 0, 0, 1, 1, 0, 1, 0, 1]",152,92,60,12,4,0.13043478260869565,0.06666666666666667
"[0, 1, 0, 1, 1, 0, 0, 1, 0, 0, 0, 0, 1, 0, 0]",238,146,92,14,11,0.0958904109589041,0.11956521739130435
"[1, 1, 1, 0, 0, 1, 1, 0, 1, 0, 1, 1, 0, 0, 0]",149,60,89,5,6,0.08333333333333333,0.06741573033707865
"[0, 0, 0, 1, 0, 0, 1, 0, 0, 1, 0, 0, 1, 1, 1]",231,151,80,7,6,0.046357615894039736,0.075
"[1, 1, 1, 1, 1, 1, 1, 0, 0, 0, 0, 1, 0, 0, 1]",339,102,237,10,26,0.09803921568627451,0.10970464135021098
"[1, 1, 0, 0, 0, 1, 0, 0, 1, 1, 0, 1, 1, 1, 0]",109,51,58,3,5,0.058823529411764705,0.08620689655172414
"[1, 0, 0, 1, 0, 0, 0, 0, 0, 0, 0, 0, 1, 0, 0]",1623,1224,399,117,48,0.09558823529411764,0.12030075187969924
"[1, 1, 0, 0, 1, 0, 0, 0, 0, 0, 0, 0, 0, 1, 0]",568,367,201,37,14,0.1008174386920981,0.06965174129353234
"[0, 0, 0, 0, 0, 1, 0, 0, 0, 0, 0, 0, 1, 1, 0]",2779,2154,625,187,57,0.08681522748375116,0.0912
"[0, 1, 0, 0, 1, 1, 0, 0, 0, 0, 0, 0, 0, 0, 1]",1114,770,344,77,36,0.1,0.10465116279069768
"[1, 1, 0, 1, 0, 0, 1, 0, 0, 1, 1, 0, 0, 0, 0]",242,149,93,17,7,0.11409395973154363,0.07526881720430108
"[0, 0, 0, 0, 0, 1, 0, 0, 1, 1, 0, 1, 1, 0, 0]",273,174,99,17,9,0.09770114942528736,0.09090909090909091
"[0, 0, 0, 0, 0, 0, 0, 0, 1, 0, 0, 1, 1, 0, 1]",654,460,194,37,10,0.08043478260869565,0.05154639175257732
"[0, 1, 0, 0, 1, 1, 0, 1, 1, 1, 1, 1, 1, 1, 1]",798,255,543,20,51,0.0784313725490196,0.09392265193370165
"[0, 0, 1, 0, 0, 0, 0, 0, 0, 0, 0, 1, 0, 0, 1]",1775,1350,425,135,44,0.1,0.10352941176470588
"[0, 1, 0, 0, 0, 1, 1, 0, 1, 0, 0, 0, 1, 0, 0]",203,141,62,15,5,0.10638297872340426,0.08064516129032258
"[1, 1, 1, 0, 0, 1, 1, 0, 0, 0, 0, 0, 0, 0, 0]",2311,596,1715,63,150,0.10570469798657718,0.08746355685131195
"[0, 0, 1, 1, 0, 0, 0, 0, 1, 0, 0, 0, 0, 0, 0]",2363,1813,550,154,52,0.08494208494208494,0.09454545454545454
"[1, 0, 0, 0, 0, 0, 0, 0, 1, 0, 0, 0, 0, 1, 1]",906,545,361,56,39,0.10275229357798166,0.10803324099722991
"[1, 1, 1, 0, 1, 1, 0, 1, 0, 1, 0, 1, 1, 1, 0]",215,65,150,8,15,0.12307692307692308,0.1
"[1, 1, 1, 1, 0, 1, 1, 0, 1, 0, 1, 0, 1, 1, 1]",546,165,381,15,28,0.09090909090909091,0.07349081364829396
"[1, 1, 1, 1, 1, 1, 0, 1, 1, 0, 1, 1, 1, 1, 1]",8300,1448,6852,134,616,0.0925414364640884,0.08990075890251022
"[0, 1, 1, 1, 1, 1, 1, 1, 0, 1, 1, 0, 1, 1, 1]",1846,556,1290,50,126,0.08992805755395683,0.09767441860465116
"[0, 0, 1, 1, 0, 0, 0, 0, 0, 0, 0, 0, 0, 0, 1]",6949,5172,1777,494,156,0.09551430781129157,0.08778840742824986
"[1, 0, 0, 0, 0, 1, 1, 0, 0, 1, 1, 1, 1, 0, 0]",1570,354,1216,39,105,0.11016949152542373,0.08634868421052631
"[1, 1, 1, 1, 1, 1, 1, 1, 1, 0, 1, 1, 0, 0, 0]",920,228,692,20,61,0.08771929824561403,0.08815028901734104
"[0, 0, 1, 1, 1, 1, 1, 0, 0, 1, 1, 1, 1, 1, 1]",1582,513,1069,40,100,0.07797270955165692,0.09354536950420954
"[1, 0, 1, 0, 0, 1, 0, 0, 1, 1, 1, 1, 1, 0, 0]",163,71,92,0,6,0.0,0.06521739130434782
"[0, 0, 0, 1, 1, 0, 0, 1, 0, 0, 0, 0, 0, 1, 1]",509,389,120,36,12,0.09254498714652956,0.1
"[0, 0, 0, 0, 0, 1, 1, 0, 0, 0, 0, 0, 1, 0, 0]",2351,1909,442,184,48,0.0963855421686747,0.1085972850678733
"[1, 0, 0, 1, 0, 1, 0, 0, 1, 0, 0, 1, 0, 0, 0]",222,143,79,16,6,0.11188811188811189,0.0759493670886076
"[1, 1, 0, 0, 0, 1, 0, 0, 0, 0, 0, 1, 1, 0, 0]",388,231,157,22,12,0.09523809523809523,0.07643312101910828
"[0, 0, 1, 1, 1, 1, 0, 0, 0, 1, 0, 0, 0, 0, 0]",440,292,148,22,12,0.07534246575342465,0.08108108108108109
"[0, 1, 0, 0, 0, 0, 0, 0, 0, 1, 1, 1, 1, 0, 0]",855,575,280,62,26,0.10782608695652174,0.09285714285714286
"[1, 1, 0, 0, 0, 1, 0, 0, 0, 0, 0, 1, 1, 0, 1]",134,87,47,7,4,0.08045977011494253,0.0851063829787234
"[0, 0, 0, 1, 1, 0, 0, 0, 1, 0, 0, 0, 0, 0, 1]",680,503,177,54,22,0.1073558648111332,0.12429378531073447
"[1, 1, 0, 0, 0, 0, 1, 0, 0, 1, 0, 0, 0, 1, 1]",218,133,85,10,8,0.07518796992481203,0.09411764705882353
"[1, 1, 1, 1, 0, 0, 0, 0, 1, 0, 0, 1, 0, 0, 0]",240,141,99,9,14,0.06382978723404255,0.1414141414141414
"[0, 0, 0, 0, 1, 1, 0, 0, 1, 0, 1, 1, 0, 0, 0]",338,230,108,26,10,0.11304347826086956,0.09259259259259259
"[1, 1, 1, 1, 1, 1, 0, 0, 0, 1, 1, 1, 1, 1, 0]",763,205,558,23,62,0.11219512195121951,0.1111111111111111
"[0, 1, 1, 1, 1, 1, 1, 0, 0, 0, 1, 1, 1, 1, 1]",1062,479,583,56,58,0.11691022964509394,0.09948542024013722
"[1, 0, 1, 1, 1, 0, 1, 1, 1, 0, 1, 1, 1, 1, 1]",1695,403,1292,39,106,0.0967741935483871,0.08204334365325078
"[1, 1, 1, 0, 1, 1, 0, 1, 1, 1, 0, 1, 1, 1, 0]",495,153,342,14,30,0.0915032679738562,0.08771929824561403
"[1, 1, 1, 0, 1, 0, 0, 1, 0, 1, 1, 1, 0, 0, 1]",149,63,86,5,8,0.07936507936507936,0.09302325581395349
"[0, 0, 0, 0, 0, 0, 1, 1, 1, 0, 1, 0, 0, 1, 0]",279,186,93,23,9,0.12365591397849462,0.0967741935483871
"[0, 0, 0, 0, 0, 0, 0, 1, 1, 1, 0, 1, 0, 0, 1]",344,248,96,26,3,0.10483870967741936,0.03125
"[1, 1, 1, 0, 1, 1, 1, 1, 1, 1, 0, 0, 0, 0, 1]",661,211,450,15,54,0.07109004739336493,0.12
"[0, 1, 1, 1, 1, 0, 1, 1, 1, 1, 1, 1, 0, 0, 0]",390,140,250,10,20,0.07142857142857142,0.08
"[1, 0, 1, 1, 0, 1, 1, 1, 1, 1, 0, 1, 1, 1, 0]",487,152,335,11,21,0.07236842105263158,0.0626865671641791
"[0, 1, 1, 1, 1, 1, 1, 1, 1, 0, 1, 0, 1, 1, 0]",596,207,389,18,25,0.08695652173913043,0.06426735218508997
"[1, 1, 0, 1, 0, 1, 0, 0, 0, 1, 0, 0, 1, 1, 1]",162,77,85,6,8,0.07792207792207792,0.09411764705882353
"[0, 0, 1, 1, 0, 1, 1, 1, 0, 0, 1, 1, 1, 0, 0]",143,69,74,5,9,0.07246376811594203,0.12162162162162163
"[1, 1, 0, 0, 1, 1, 0, 1, 1, 1, 0, 0, 1, 1, 1]",406,143,263,9,26,0.06293706293706294,0.09885931558935361
"[1, 1, 0, 1, 0, 1, 1, 1, 0, 1, 1, 0, 0, 1, 1]",288,83,205,3,20,0.03614457831325301,0.0975609756097561
"[1, 0, 0, 1, 1, 0, 1, 0, 1, 1, 1, 0, 1, 1, 0]",138,51,87,5,6,0.09803921568627451,0.06896551724137931
"[1, 0, 0, 0, 0, 0, 0, 0, 0, 1, 0, 1, 0, 0, 0]",1844,1272,572,113,59,0.08883647798742138,0.10314685314685315
"[0, 1, 0, 1, 1, 0, 1, 0, 0, 0, 0, 1, 0, 0, 0]",216,150,66,11,7,0.07333333333333333,0.10606060606060606
"[0, 1, 0, 0, 0, 0, 0, 0, 0, 1, 0, 1, 1, 0, 1]",241,156,85,13,10,0.08333333333333333,0.11764705882352941
"[0, 0, 0, 1, 1, 1, 1, 1, 1, 1, 1, 1, 1, 1, 0]",1325,690,635,56,73,0.08115942028985507,0.11496062992125984
"[1, 1, 0, 0, 0, 0, 1, 1, 1, 1, 1, 1, 1, 1, 1]",5980,1793,4187,184,393,0.10262130507529281,0.09386195366610939
"[1, 1, 1, 1, 1, 1, 0, 0, 0, 0, 1, 1, 1, 1, 1]",5987,1679,4308,155,393,0.09231685527099463,0.09122562674094707
"[0, 1, 0, 1, 1, 0, 1, 1, 1, 1, 0, 1, 1, 1, 1]",577,163,414,21,32,0.12883435582822086,0.07729468599033816
"[1, 1, 1, 1, 0, 1, 0, 1, 1, 0, 1, 1, 1, 1, 0]",569,166,403,16,35,0.0963855421686747,0.08684863523573201
"[0, 0, 1, 0, 0, 1, 1, 1, 0, 1, 0, 0, 0, 0, 0]",291,196,95,12,13,0.061224489795918366,0.1368421052631579
"[0, 0, 1, 0, 0, 0, 0, 0, 0, 0, 0, 1, 0, 1, 1]",752,540,212,64,20,0.11851851851851852,0.09433962264150944
"[0, 0, 0, 0, 0, 0, 0, 1, 1, 1, 0, 0, 0, 1, 0]",675,506,169,38,13,0.07509881422924901,0.07692307692307693
"[1, 0, 0, 0, 0, 0, 0, 0, 0, 0, 1, 1, 1, 0, 0]",891,532,359,39,32,0.07330827067669173,0.08913649025069638
"[0, 1, 0, 0, 0, 1, 0, 1, 0, 0, 0, 0, 0, 0, 0]",1895,1444,451,122,49,0.08448753462603878,0.10864745011086474
"[1, 0, 0, 1, 1, 0, 0, 1, 1, 0, 0, 0, 0, 1, 1]",1679,340,1339,38,126,0.11176470588235295,0.09410007468259896
"[1, 1, 1, 0, 0, 1, 1, 1, 1, 1, 1, 0, 1, 0, 1]",801,165,636,25,55,0.15151515151515152,0.08647798742138364
"[0, 0, 1, 1, 1, 0, 1, 1, 1, 0, 0, 1, 1, 1, 1]",422,157,265,23,26,0.1464968152866242,0.09811320754716982
"[1, 1, 0, 0, 1, 1, 1, 0, 0, 1, 1, 1, 0, 1, 1]",287,104,183,8,17,0.07692307692307693,0.09289617486338798
"[1, 1, 1, 1, 1, 1, 0, 0, 1, 1, 1, 0, 0, 1, 1]",1167,340,827,31,81,0.09117647058823529,0.09794437726723096
"[0, 0, 0, 0, 0, 0, 0, 1, 1, 1, 0, 1, 1, 1, 1]",403,277,126,21,11,0.07581227436823104,0.0873015873015873
"[0, 0, 0, 0, 0, 0, 0, 1, 1, 1, 1, 1, 1, 0, 1]",479,352,127,29,14,0.08238636363636363,0.11023622047244094
"[0, 1, 1, 0, 0, 1, 1, 1, 0, 0, 0, 0, 0, 0, 0]",547,388,159,35,16,0.09020618556701031,0.10062893081761007
"[1, 0, 0, 0, 1, 1, 0, 0, 1, 1, 1, 0, 0, 0, 0]",232,125,107,13,8,0.104,0.07476635514018691
"[1, 0, 1, 0, 1, 1, 1, 0, 0, 0, 1, 0, 0, 0, 1]",134,67,67,6,8,0.08955223880597014,0.11940298507462686
"[1, 1, 1, 0, 1, 1, 1, 1, 1, 0, 0, 0, 0, 1, 1]",677,213,464,20,47,0.09389671361502347,0.10129310344827586
"[1, 1, 0, 1, 1, 1, 0, 0, 1, 1, 1, 1, 1, 1, 1]",2952,675,2277,66,224,0.09777777777777778,0.09837505489679403
"[1, 1, 0, 1, 1, 1, 1, 1, 0, 1, 0, 1, 1, 1, 1]",1667,404,1263,39,107,0.09653465346534654,0.08471892319873317
"[0, 1, 0, 0, 0, 0, 0, 0, 0, 0, 0, 1, 0, 0, 1]",1759,1336,423,130,38,0.09730538922155689,0.08983451536643026
"[1, 0, 0, 1, 1, 1, 1, 1, 1, 1, 1, 1, 1, 0, 1]",3059,472,2587,54,259,0.11440677966101695,0.10011596443757248
"[1, 1, 0, 0, 1, 1, 1, 1, 1, 1, 1, 1, 1, 1, 0]",5999,1569,4430,153,437,0.09751434034416825,0.09864559819413092
"[1, 1, 1, 1, 0, 1, 0, 1, 1, 1, 0, 0, 1, 1, 1]",837,262,575,25,49,0.09541984732824428,0.08521739130434783
"[0, 1, 0, 1, 1, 1, 1, 1, 1, 1, 0, 1, 0, 1, 1]",540,162,378,15,44,0.09259259259259259,0.1164021164021164
"[1, 1, 1, 1, 1, 0, 1, 1, 0, 1, 0, 1, 1, 1, 1]",1813,384,1429,42,129,0.109375,0.09027291812456263
"[0, 0, 1, 1, 1, 0, 1, 1, 0, 1, 1, 0, 0, 0, 0]",151,82,69,11,7,0.13414634146341464,0.10144927536231885
"[0, 0, 1, 1, 1, 0, 0, 1, 1, 0, 0, 0, 0, 0, 1]",243,159,84,16,4,0.10062893081761007,0.047619047619047616
"[1, 1, 0, 0, 1, 1, 0, 1, 1, 0, 0, 1, 1, 1, 0]",187,82,105,7,9,0.08536585365853659,0.08571428571428572
"[1, 0, 1, 1, 0, 0, 1, 1, 0, 1, 1, 0, 0, 1, 1]",190,73,117,4,21,0.0547945205479452,0.1794871794871795
"[0, 0, 1, 1, 1, 1, 1, 0, 1, 1, 0, 1, 0, 1, 1]",265,107,158,10,17,0.09345794392523364,0.10759493670886076
"[0, 1, 1, 0, 1, 1, 1, 1, 0, 0, 1, 0, 0, 1, 1]",174,77,97,9,9,0.11688311688311688,0.09278350515463918
"[0, 0, 1, 0, 1, 1, 1, 0, 0, 1, 0, 0, 0, 1, 1]",128,72,56,2,5,0.027777777777777776,0.08928571428571429
"[1, 1, 0, 0, 0, 0, 1, 1, 1, 1, 0, 0, 1, 0, 1]",369,145,224,7,21,0.04827586206896552,0.09375
"[1, 1, 1, 1, 0, 0, 1, 1, 0, 0, 0, 0, 1, 1, 1]",2464,969,1495,82,143,0.0846233230134159,0.09565217391304348
"[1, 0, 0, 1, 0, 0, 0, 0, 0, 0, 0, 1, 0, 0, 0]",1610,1210,400,122,35,0.10082644628099173,0.0875
"[0, 0, 1, 1, 0, 0, 0, 0, 0, 0, 1, 1, 0, 1, 0]",557,362,195,22,24,0.06077348066298342,0.12307692307692308
"[0, 0, 0, 0, 1, 1, 0, 0, 0, 0, 0, 0, 1, 1, 0]",4451,3161,1290,275,119,0.08699778551091426,0.09224806201550388
"[0, 0, 1, 1, 1, 1, 1, 0, 1, 1, 1, 1, 1, 1, 0]",688,212,476,17,46,0.08018867924528301,0.09663865546218488
"[1, 1, 0, 0, 0, 0, 1, 1, 1, 1, 1, 0, 1, 1, 1]",739,258,481,27,56,0.10465116279069768,0.11642411642411643
"[1, 1, 1, 1, 1, 1, 1, 1, 1, 1, 1, 0, 0, 0, 0]",5715,871,4844,70,485,0.08036739380022963,0.10012386457473163
"[0, 1, 1, 0, 0, 0, 0, 0, 0, 0, 0, 0, 1, 1, 0]",1394,1053,341,92,27,0.08736942070275404,0.07917888563049853
"[0, 0, 1, 0, 1, 1, 0, 0, 0, 0, 0, 0, 0, 0, 0]",2726,2071,655,187,65,0.09029454369869629,0.09923664122137404
"[0, 0, 0, 1, 0, 1, 1, 0, 0, 0, 0, 0, 0, 0, 0]",2618,1997,621,199,55,0.09964947421131698,0.08856682769726248
"[0, 0, 0, 0, 0, 0, 0, 0, 0, 1, 1, 1, 1, 0, 0]",5501,4646,855,434,84,0.09341368919500646,0.09824561403508772
"[0, 1, 0, 0, 1, 0, 0, 0, 0, 1, 0, 1, 1, 0, 1]",131,66,65,6,4,0.09090909090909091,0.06153846153846154
"[1, 0, 0, 0, 1, 0, 0, 1, 0, 0, 0, 0, 1, 0, 1]",234,141,93,13,7,0.09219858156028368,0.07526881720430108
"[0, 0, 0, 1, 0, 0, 0, 1, 1, 0, 0, 1, 0, 0, 0]",524,365,159,39,12,0.10684931506849316,0.07547169811320754
"[0, 0, 0, 1, 0, 0, 0, 0, 0, 0, 0, 1, 0, 0, 1]",1727,1335,392,117,41,0.08764044943820225,0.10459183673469388
"[0, 0, 0, 1, 0, 1, 0, 0, 1, 0, 1, 0, 0, 0, 0]",556,411,145,32,13,0.07785888077858881,0.0896551724137931
"[1, 1, 0, 0, 0, 0, 0, 0, 1, 0, 0, 0, 0, 1, 0]",669,459,210,44,26,0.09586056644880174,0.12380952380952381
"[1, 0, 0, 0, 0, 0, 1, 1, 0, 1, 0, 0, 0, 0, 0]",643,454,189,37,13,0.08149779735682819,0.06878306878306878
"[0, 0, 0, 1, 0, 0, 0, 1, 0, 0, 1, 0, 1, 1, 0]",246,150,96,17,6,0.11333333333333333,0.0625
"[1, 0, 1, 0, 1, 1, 0, 1, 0, 1, 1, 0, 0, 0, 0]",134,65,69,6,8,0.09230769230769231,0.11594202898550725
"[0, 0, 1, 0, 0, 0, 0, 0, 0, 1, 0, 0, 0, 0, 0]",7376,6088,1288,548,109,0.0900131406044678,0.08462732919254658
"[0, 0, 0, 0, 1, 0, 0, 0, 0, 0, 0, 1, 0, 0, 0]",6902,5671,1231,549,117,0.09680832304708165,0.0950446791226645
"[0, 0, 0, 0, 0, 1, 1, 0, 0, 0, 0, 0, 0, 0, 1]",3886,3287,599,329,70,0.10009126863401278,0.11686143572621036
"[0, 0, 0, 1, 1, 0, 0, 0, 0, 0, 0, 1, 1, 0, 0]",4488,3889,599,329,55,0.0845975829262021,0.09181969949916527
"[0, 1, 0, 0, 0, 1, 1, 0, 0, 0, 0, 0, 0, 1, 1]",826,535,291,42,31,0.07850467289719626,0.10652920962199312
"[0, 0, 0, 0, 0, 0, 1, 0, 0, 0, 1, 1, 0, 0, 0]",2378,1827,551,159,49,0.08702791461412152,0.08892921960072596
"[0, 0, 1, 1, 1, 1, 0, 0, 0, 1, 0, 0, 1, 1, 1]",286,152,134,16,8,0.10526315789473684,0.05970149253731343
"[1, 0, 0, 0, 0, 0, 0, 0, 0, 0, 0, 0, 1, 0, 1]",2132,1396,736,136,67,0.09742120343839542,0.09103260869565218
"[0, 0, 1, 0, 1, 1, 0, 1, 1, 0, 0, 1, 0, 0, 0]",135,79,56,8,2,0.10126582278481013,0.03571428571428571
"[0, 1, 0, 1, 1, 1, 1, 0, 0, 0, 1, 0, 0, 0, 0]",184,105,79,12,6,0.11428571428571428,0.0759493670886076
"[0, 0, 1, 0, 0, 1, 0, 0, 1, 1, 1, 0, 1, 0, 0]",170,100,70,10,9,0.1,0.12857142857142856
"[0, 0, 0, 0, 0, 0, 0, 0, 1, 1, 1, 1, 1, 0, 1]",423,256,167,26,13,0.1015625,0.07784431137724551
"[1, 0, 0, 0, 0, 0, 0, 0, 0, 1, 1, 1, 1, 1, 0]",429,163,266,13,25,0.07975460122699386,0.09398496240601503
"[0, 0, 1, 0, 1, 0, 1, 0, 0, 0, 0, 1, 1, 1, 1]",223,121,102,8,7,0.06611570247933884,0.06862745098039216
"[0, 1, 1, 1, 0, 0, 0, 0, 1, 0, 0, 0, 1, 0, 0]",251,169,82,14,3,0.08284023668639054,0.036585365853658534
"[0, 1, 0, 1, 0, 1, 1, 1, 0, 0, 0, 0, 1, 0, 0]",150,76,74,9,3,0.11842105263157894,0.04054054054054054
"[0, 0, 0, 1, 1, 1, 1, 0, 0, 1, 0, 1, 0, 1, 1]",212,140,72,14,11,0.1,0.1527777777777778
"[1, 1, 1, 0, 1, 1, 0, 1, 0, 1, 0, 0, 0, 1, 1]",145,54,91,6,14,0.1111111111111111,0.15384615384615385
"[0, 0, 1, 1, 1, 1, 1, 0, 1, 1, 1, 1, 1, 0, 1]",624,182,442,18,40,0.0989010989010989,0.09049773755656108
"[1, 0, 0, 1, 1, 0, 1, 0, 0, 1, 0, 0, 0, 1, 1]",134,62,72,3,9,0.04838709677419355,0.125
"[1, 1, 1, 0, 1, 0, 1, 0, 1, 1, 1, 1, 1, 0, 0]",306,97,209,10,17,0.10309278350515463,0.08133971291866028
"[1, 1, 1, 0, 1, 0, 0, 1, 1, 0, 0, 0, 1, 1, 1]",225,90,135,7,14,0.07777777777777778,0.1037037037037037
"[1, 0, 1, 1, 1, 1, 1, 1, 0, 0, 1, 0, 0, 0, 1]",165,80,85,8,2,0.1,0.023529411764705882
"[0, 0, 1, 0, 1, 1, 1, 1, 1, 1, 0, 0, 1, 0, 0]",143,68,75,8,4,0.11764705882352941,0.05333333333333334
"[0, 0, 0, 0, 0, 1, 1, 0, 1, 0, 1, 0, 0, 0, 1]",281,205,76,19,4,0.09268292682926829,0.05263157894736842
"[0, 1, 0, 0, 0, 0, 0, 0, 0, 0, 1, 1, 0, 1, 0]",594,407,187,42,11,0.10319410319410319,0.058823529411764705
"[0, 0, 0, 0, 0, 1, 0, 0, 0, 0, 1, 0, 0, 0, 0]",7226,5961,1265,551,117,0.09243415534306325,0.09249011857707509
"[0, 1, 1, 0, 1, 0, 0, 0, 0, 0, 0, 0, 0, 1, 0]",529,374,155,37,13,0.09893048128342247,0.08387096774193549
"[1, 0, 0, 0, 0, 1, 1, 0, 0, 0, 0, 0, 1, 1, 1]",698,198,500,18,43,0.09090909090909091,0.086
"[0, 0, 0, 0, 1, 1, 0, 0, 0, 0, 1, 1, 0, 0, 0]",4630,3320,1310,286,131,0.086144578313253,0.1
"[1, 0, 0, 0, 0, 0, 0, 1, 1, 0, 0, 0, 1, 0, 0]",784,417,367,53,40,0.12709832134292565,0.10899182561307902
"[0, 0, 1, 0, 0, 1, 1, 1, 1, 1, 1, 1, 1, 0, 0]",456,225,231,16,26,0.07111111111111111,0.11255411255411256
"[1, 0, 0, 1, 0, 1, 1, 1, 1, 0, 1, 1, 1, 0, 0]",137,57,80,3,10,0.05263157894736842,0.125
"[0, 1, 0, 0, 1, 0, 1, 1, 1, 1, 0, 1, 1, 1, 0]",129,51,78,7,5,0.13725490196078433,0.0641025641025641
"[1, 1, 1, 0, 1, 1, 1, 0, 0, 0, 1, 0, 0, 0, 1]",135,62,73,3,10,0.04838709677419355,0.136986301369863
"[1, 1, 0, 1, 1, 1, 1, 0, 0, 1, 1, 1, 1, 1, 0]",724,219,505,22,46,0.1004566210045662,0.09108910891089109
"[1, 1, 0, 1, 1, 1, 1, 0, 1, 1, 1, 1, 0, 0, 1]",720,196,524,15,43,0.07653061224489796,0.08206106870229007
"[1, 1, 1, 1, 0, 1, 1, 1, 1, 0, 1, 1, 1, 1, 0]",1644,350,1294,40,114,0.11428571428571428,0.08809891808346214
"[1, 1, 0, 0, 1, 0, 0, 1, 0, 1, 1, 1, 0, 1, 1]",170,56,114,3,14,0.05357142857142857,0.12280701754385964
"[1, 1, 0, 1, 1, 1, 0, 1, 1, 1, 1, 1, 0, 0, 1]",725,196,529,13,60,0.0663265306122449,0.11342155009451796
"[0, 0, 1, 0, 1, 1, 1, 0, 1, 1, 1, 0, 1, 0, 0]",113,61,52,2,6,0.03278688524590164,0.11538461538461539
"[0, 1, 1, 1, 0, 1, 0, 1, 0, 1, 1, 1, 0, 0, 1]",167,65,102,5,9,0.07692307692307693,0.08823529411764706
"[0, 0, 1, 0, 1, 1, 1, 0, 1, 0, 1, 0, 1, 1, 1]",182,82,100,8,8,0.0975609756097561,0.08
"[1, 0, 0, 0, 1, 1, 0, 0, 1, 0, 1, 1, 1, 0, 1]",120,55,65,4,9,0.07272727272727272,0.13846153846153847
"[1, 1, 1, 1, 0, 1, 1, 1, 0, 0, 0, 1, 1, 0, 0]",240,93,147,7,10,0.07526881720430108,0.06802721088435375
"[0, 0, 1, 0, 1, 1, 0, 0, 0, 0, 0, 0, 0, 1, 0]",529,370,159,28,13,0.07567567567567568,0.08176100628930817
"[0, 0, 0, 1, 0, 1, 1, 0, 0, 0, 0, 0, 0, 0, 1]",649,476,173,37,15,0.07773109243697479,0.08670520231213873
"[1, 0, 0, 1, 0, 1, 0, 1, 0, 0, 1, 1, 1, 0, 0]",117,54,63,5,6,0.09259259259259259,0.09523809523809523
"[1, 1, 0, 0, 0, 0, 1, 0, 0, 1, 1, 1, 0, 0, 1]",182,94,88,9,13,0.09574468085106383,0.14772727272727273
"[0, 0, 0, 0, 1, 1, 0, 1, 1, 0, 0, 1, 1, 1, 1]",304,164,140,14,9,0.08536585365853659,0.06428571428571428
"[0, 0, 0, 0, 0, 1, 1, 0, 1, 1, 0, 0, 1, 1, 1]",298,192,106,22,15,0.11458333333333333,0.14150943396226415
"[0, 1, 1, 0, 0, 0, 0, 0, 1, 0, 1, 0, 1, 1, 1]",236,170,66,13,4,0.07647058823529412,0.06060606060606061
"[0, 0, 1, 0, 1, 0, 0, 1, 1, 0, 0, 0, 0, 0, 1]",295,198,97,20,11,0.10101010101010101,0.1134020618556701
"[0, 1, 1, 1, 0, 0, 1, 0, 1, 0, 0, 1, 1, 0, 0]",148,83,65,5,6,0.060240963855421686,0.09230769230769231
"[0, 1, 1, 0, 0, 1, 1, 1, 0, 0, 1, 0, 1, 0, 0]",126,69,57,11,8,0.15942028985507245,0.14035087719298245
"[0, 0, 1, 1, 0, 0, 1, 1, 1, 0, 0, 1, 0, 1, 0]",124,65,59,8,4,0.12307692307692308,0.06779661016949153
"[1, 0, 0, 1, 1, 1, 1, 0, 0, 0, 1, 1, 0, 0, 1]",234,72,162,10,22,0.1388888888888889,0.13580246913580246
"[1, 0, 0, 1, 1, 1, 1, 0, 0, 0, 1, 1, 0, 1, 1]",251,73,178,5,20,0.0684931506849315,0.11235955056179775
"[0, 0, 0, 0, 0, 0, 1, 0, 1, 0, 0, 1, 1, 1, 1]",389,262,127,28,8,0.10687022900763359,0.06299212598425197
"[0, 1, 1, 0, 0, 0, 0, 0, 0, 1, 0, 0, 0, 0, 0]",2357,1881,476,165,48,0.08771929824561403,0.10084033613445378
"[1, 0, 0, 0, 0, 0, 0, 0, 1, 1, 1, 0, 1, 1, 0]",180,91,89,7,11,0.07692307692307693,0.12359550561797752
"[1, 0, 0, 0, 1, 0, 0, 0, 0, 1, 0, 1, 0, 1, 1]",154,83,71,11,7,0.13253012048192772,0.09859154929577464
"[0, 0, 1, 1, 0, 0, 0, 1, 0, 0, 0, 0, 1, 0, 1]",268,175,93,14,13,0.08,0.13978494623655913
"[1, 1, 0, 1, 0, 0, 0, 1, 1, 1, 0, 1, 0, 0, 1]",85,46,39,3,4,0.06521739130434782,0.10256410256410256
"[0, 0, 1, 1, 1, 0, 1, 1, 0, 1, 0, 0, 0, 1, 1]",134,71,63,8,5,0.11267605633802817,0.07936507936507936
"[1, 0, 0, 0, 1, 0, 1, 1, 0, 0, 1, 1, 0, 0, 0]",284,174,110,14,9,0.08045977011494253,0.08181818181818182
"[0, 0, 1, 1, 0, 0, 0, 0, 1, 1, 1, 1, 1, 1, 1]",2480,1029,1451,115,135,0.11175898931000972,0.09303928325292901
"[0, 0, 0, 0, 0, 0, 1, 1, 0, 0, 0, 0, 1, 1, 1]",3920,2725,1195,255,114,0.09357798165137615,0.09539748953974896
"[0, 1, 1, 1, 1, 0, 0, 0, 0, 0, 0, 1, 1, 0, 0]",1833,1523,310,148,25,0.09717662508207485,0.08064516129032258
"[1, 0, 1, 0, 0, 1, 0, 1, 0, 0, 1, 0, 0, 1, 1]",118,64,54,7,3,0.109375,0.05555555555555555
"[0, 0, 1, 0, 1, 1, 1, 1, 0, 0, 0, 0, 0, 0, 0]",604,384,220,28,18,0.07291666666666667,0.08181818181818182
"[0, 0, 0, 1, 0, 1, 1, 0, 0, 0, 0, 0, 1, 0, 0]",580,424,156,55,13,0.12971698113207547,0.08333333333333333
"[0, 0, 0, 1, 1, 1, 1, 1, 1, 0, 0, 0, 1, 0, 1]",260,179,81,24,9,0.1340782122905028,0.1111111111111111
"[0, 0, 0, 0, 0, 0, 1, 0, 0, 0, 0, 0, 1, 1, 1]",2485,2057,428,177,43,0.08604764219737482,0.10046728971962617
"[0, 0, 0, 0, 1, 0, 0, 0, 1, 1, 0, 0, 0, 1, 1]",363,250,113,22,12,0.088,0.10619469026548672
"[1, 1, 0, 0, 0, 0, 0, 0, 1, 1, 0, 0, 1, 1, 1]",2042,1069,973,89,94,0.0832553788587465,0.09660842754367935
"[0, 1, 0, 1, 1, 1, 1, 1, 1, 0, 0, 0, 0, 0, 0]",441,242,199,30,18,0.12396694214876033,0.09045226130653267
"[1, 1, 1, 1, 1, 1, 1, 1, 1, 1, 0, 0, 1, 0, 1]",2545,584,1961,41,183,0.0702054794520548,0.09331973482916879
"[1, 0, 1, 1, 0, 0, 0, 0, 1, 0, 0, 1, 1, 1, 1]",158,67,91,5,12,0.07462686567164178,0.13186813186813187
"[0, 0, 0, 1, 0, 0, 1, 1, 0, 0, 0, 0, 0, 0, 1]",969,683,286,68,33,0.09956076134699854,0.11538461538461539
"[0, 1, 0, 0, 0, 1, 0, 0, 1, 1, 0, 0, 0, 0, 0]",807,588,219,49,28,0.08333333333333333,0.1278538812785388
"[1, 0, 1, 1, 0, 1, 0, 1, 0, 0, 0, 1, 1, 0, 1]",100,49,51,6,7,0.12244897959183673,0.13725490196078433
"[1, 1, 0, 1, 0, 1, 1, 1, 0, 1, 0, 0, 1, 0, 1]",121,46,75,6,7,0.13043478260869565,0.09333333333333334
"[1, 1, 0, 1, 0, 1, 0, 0, 1, 0, 0, 1, 1, 1, 0]",119,61,58,8,8,0.13114754098360656,0.13793103448275862
"[1, 0, 0, 0, 0, 1, 0, 1, 0, 0, 0, 0, 1, 1, 0]",333,216,117,19,12,0.08796296296296297,0.10256410256410256
"[0, 0, 1, 0, 1, 0, 0, 1, 0, 0, 0, 0, 0, 0, 1]",582,403,179,41,20,0.10173697270471464,0.11173184357541899
"[1, 0, 1, 0, 0, 1, 0, 1, 0, 0, 0, 0, 0, 1, 0]",255,164,91,15,5,0.09146341463414634,0.054945054945054944
"[1, 1, 0, 0, 1, 1, 0, 0, 0, 0, 0, 0, 1, 1, 0]",1855,1116,739,100,65,0.08960573476702509,0.08795669824086604
"[0, 0, 1, 0, 1, 1, 1, 1, 1, 1, 1, 0, 0, 1, 1]",527,221,306,23,31,0.10407239819004525,0.10130718954248366
"[0, 0, 0, 1, 0, 1, 1, 1, 1, 1, 1, 1, 0, 0, 1]",295,136,159,8,14,0.058823529411764705,0.0880503144654088
"[0, 1, 1, 0, 0, 0, 1, 0, 1, 1, 1, 1, 1, 1, 1]",407,189,218,20,19,0.10582010582010581,0.0871559633027523
"[0, 0, 1, 0, 0, 0, 0, 1, 1, 0, 1, 1, 0, 0, 0]",291,196,95,19,7,0.09693877551020408,0.07368421052631578
"[0, 0, 0, 0, 0, 0, 1, 0, 1, 1, 1, 0, 0, 1, 1]",272,173,99,25,11,0.14450867052023122,0.1111111111111111
"[0, 0, 1, 0, 0, 0, 1, 1, 1, 0, 1, 1, 0, 0, 0]",160,108,52,15,7,0.1388888888888889,0.1346153846153846
"[0, 0, 1, 1, 0, 0, 1, 1, 0, 0, 1, 1, 0, 1, 0]",313,174,139,13,10,0.07471264367816093,0.07194244604316546
"[0, 1, 1, 1, 0, 0, 0, 0, 1, 0, 0, 0, 0, 1, 1]",230,146,84,23,6,0.15753424657534246,0.07142857142857142
"[1, 1, 0, 1, 1, 1, 0, 0, 0, 1, 1, 1, 1, 1, 0]",282,100,182,7,12,0.07,0.06593406593406594
"[0, 0, 1, 0, 0, 1, 1, 1, 0, 1, 0, 0, 1, 1, 1]",142,69,73,3,4,0.043478260869565216,0.0547945205479452
"[1, 0, 0, 0, 1, 1, 1, 1, 0, 0, 1, 0, 1, 1, 1]",219,84,135,4,14,0.047619047619047616,0.1037037037037037
"[1, 0, 0, 0, 0, 1, 1, 0, 0, 0, 1, 1, 1, 1, 0]",232,113,119,9,13,0.07964601769911504,0.1092436974789916
"[0, 0, 0, 1, 1, 1, 1, 0, 0, 1, 1, 1, 0, 0, 1]",275,198,77,16,11,0.08080808080808081,0.14285714285714285
"[1, 0, 1, 1, 1, 0, 0, 1, 0, 1, 0, 0, 0, 0, 0]",202,119,83,10,6,0.08403361344537816,0.07228915662650602
"[1, 0, 0, 1, 0, 0, 0, 0, 1, 0, 0, 1, 0, 1, 1]",140,81,59,5,10,0.06172839506172839,0.1694915254237288
"[1, 0, 0, 0, 0, 0, 1, 1, 0, 0, 1, 0, 1, 1, 0]",175,94,81,11,6,0.11702127659574468,0.07407407407407407
"[0, 1, 1, 0, 1, 0, 1, 0, 0, 0, 0, 0, 1, 1, 0]",199,123,76,12,10,0.0975609756097561,0.13157894736842105
"[0, 0, 1, 0, 0, 1, 0, 0, 1, 1, 0, 1, 0, 1, 0]",143,79,64,5,7,0.06329113924050633,0.109375
"[0, 0, 1, 0, 0, 0, 0, 1, 1, 1, 0, 0, 1, 0, 1]",148,91,57,7,7,0.07692307692307693,0.12280701754385964
"[0, 1, 1, 0, 0, 1, 0, 0, 0, 0, 1, 1, 1, 0, 0]",157,104,53,11,6,0.10576923076923077,0.11320754716981132
"[0, 0, 1, 1, 0, 0, 1, 0, 0, 0, 0, 1, 1, 1, 0]",159,91,68,8,11,0.08791208791208792,0.16176470588235295
"[1, 0, 0, 0, 0, 0, 0, 0, 1, 1, 0, 0, 1, 1, 1]",704,374,330,37,35,0.09893048128342247,0.10606060606060606
"[0, 0, 0, 0, 1, 0, 1, 1, 1, 0, 1, 1, 1, 0, 0]",138,68,70,13,8,0.19117647058823528,0.11428571428571428
"[1, 0, 1, 0, 0, 0, 0, 1, 0, 1, 1, 1, 0, 1, 1]",121,59,62,8,10,0.13559322033898305,0.16129032258064516
"[0, 0, 1, 1, 0, 0, 0, 1, 0, 0, 1, 0, 0, 1, 0]",243,168,75,17,10,0.10119047619047619,0.13333333333333333
"[1, 1, 0, 0, 1, 1, 1, 1, 0, 0, 0, 0, 0, 0, 0]",2029,1165,864,118,73,0.10128755364806867,0.08449074074074074
"[1, 0, 0, 0, 0, 0, 0, 0, 0, 1, 1, 0, 0, 1, 1]",2518,807,1711,83,154,0.10285006195786865,0.09000584453535944
"[0, 0, 0, 0, 1, 1, 1, 0, 0, 1, 0, 1, 0, 0, 0]",244,174,70,11,6,0.06321839080459771,0.08571428571428572
"[0, 0, 0, 0, 0, 0, 1, 0, 1, 1, 0, 0, 1, 0, 1]",257,164,93,15,8,0.09146341463414634,0.08602150537634409
"[0, 1, 1, 0, 1, 0, 0, 1, 0, 1, 0, 0, 0, 0, 0]",290,178,112,13,8,0.07303370786516854,0.07142857142857142
"[1, 0, 1, 1, 0, 1, 0, 0, 1, 0, 1, 0, 0, 0, 0]",164,110,54,11,3,0.1,0.05555555555555555
"[1, 0, 1, 0, 0, 0, 0, 1, 0, 1, 0, 0, 0, 1, 0]",238,145,93,18,9,0.12413793103448276,0.0967741935483871
"[0, 1, 0, 0, 1, 1, 0, 0, 0, 1, 1, 0, 0, 1, 0]",158,92,66,5,2,0.05434782608695652,0.030303030303030304
"[1, 0, 0, 0, 1, 0, 0, 0, 0, 0, 1, 0, 0, 0, 1]",486,316,170,32,16,0.10126582278481013,0.09411764705882353
"[0, 1, 0, 0, 0, 1, 0, 0, 0, 0, 0, 1, 0, 0, 0]",1480,1175,305,123,30,0.1046808510638298,0.09836065573770492
"[1, 1, 0, 1, 1, 0, 1, 0, 1, 0, 1, 1, 1, 1, 1]",557,167,390,17,33,0.10179640718562874,0.08461538461538462
"[0, 1, 1, 1, 0, 1, 1, 0, 1, 1, 0, 1, 0, 1, 0]",131,51,80,4,7,0.0784313725490196,0.0875
"[0, 1, 1, 1, 1, 0, 0, 0, 1, 0, 1, 1, 0, 0, 0]",128,80,48,6,4,0.075,0.08333333333333333
"[0, 1, 0, 1, 1, 0, 1, 0, 1, 1, 0, 0, 1, 0, 1]",109,42,67,4,7,0.09523809523809523,0.1044776119402985
"[1, 1, 0, 0, 0, 1, 1, 1, 0, 1, 0, 1, 0, 1, 1]",149,52,97,2,6,0.038461538461538464,0.061855670103092786
"[0, 0, 1, 1, 1, 1, 0, 0, 0, 1, 1, 1, 1, 1, 1]",707,269,438,33,47,0.12267657992565056,0.10730593607305935
"[1, 0, 1, 1, 0, 0, 0, 0, 1, 0, 1, 1, 0, 0, 0]",163,102,61,13,5,0.12745098039215685,0.08196721311475409
"[0, 0, 0, 1, 0, 0, 1, 0, 0, 0, 0, 0, 1, 1, 0]",704,511,193,60,23,0.11741682974559686,0.11917098445595854
"[0, 0, 1, 0, 0, 1, 0, 0, 1, 0, 0, 0, 0, 1, 0]",488,352,136,31,12,0.08806818181818182,0.08823529411764706
"[0, 0, 1, 0, 0, 0, 0, 1, 0, 0, 1, 0, 0, 1, 0]",496,362,134,36,9,0.09944751381215469,0.06716417910447761
"[1, 0, 0, 0, 1, 0, 0, 0, 0, 1, 0, 0, 1, 0, 0]",493,321,172,23,17,0.07165109034267912,0.09883720930232558
"[1, 1, 1, 1, 1, 0, 1, 1, 0, 0, 0, 0, 1, 1, 0]",234,87,147,5,18,0.05747126436781609,0.12244897959183673
"[1, 1, 0, 1, 1, 0, 1, 1, 1, 0, 0, 1, 1, 1, 1]",784,233,551,25,44,0.1072961373390558,0.07985480943738657
"[1, 1, 0, 1, 1, 0, 1, 1, 0, 1, 1, 0, 1, 1, 1]",531,160,371,18,24,0.1125,0.0646900269541779
"[1, 0, 0, 1, 1, 0, 0, 0, 0, 0, 0, 0, 0, 1, 1]",2480,670,1810,77,177,0.11492537313432835,0.09779005524861878
"[0, 0, 1, 1, 0, 0, 0, 0, 0, 0, 0, 1, 1, 0, 0]",1372,962,410,97,38,0.10083160083160084,0.09268292682926829
"[0, 0, 0, 0, 1, 0, 0, 0, 0, 0, 1, 1, 1, 0, 0]",664,473,191,47,16,0.09936575052854123,0.08376963350785341
"[1, 0, 0, 0, 1, 0, 0, 0, 1, 0, 0, 1, 0, 0, 0]",539,358,181,31,19,0.08659217877094973,0.10497237569060773
"[1, 1, 1, 1, 1, 1, 0, 1, 0, 0, 0, 1, 1, 1, 1]",895,234,661,26,65,0.1111111111111111,0.09833585476550681
"[0, 0, 1, 0, 1, 0, 0, 0, 1, 1, 0, 0, 0, 0, 1]",384,244,140,18,10,0.07377049180327869,0.07142857142857142
"[0, 0, 0, 0, 0, 0, 1, 0, 1, 0, 0, 0, 1, 1, 0]",694,517,177,50,15,0.09671179883945841,0.0847457627118644
"[1, 0, 0, 1, 1, 0, 0, 1, 0, 0, 0, 0, 0, 0, 1]",359,194,165,17,17,0.08762886597938144,0.10303030303030303
"[1, 1, 1, 1, 0, 0, 1, 1, 0, 0, 1, 0, 0, 0, 0]",285,149,136,14,13,0.09395973154362416,0.09558823529411764
"[0, 0, 1, 1, 1, 1, 1, 0, 0, 1, 1, 0, 0, 1, 0]",171,91,80,7,10,0.07692307692307693,0.125
"[1, 1, 1, 1, 1, 1, 1, 0, 0, 1, 1, 0, 0, 1, 1]",5242,723,4519,71,438,0.09820193637621023,0.09692409825182563
"[1, 1, 0, 1, 0, 1, 0, 1, 1, 1, 0, 1, 0, 1, 1]",252,81,171,12,18,0.14814814814814814,0.10526315789473684
"[0, 0, 1, 0, 0, 0, 0, 1, 0, 0, 0, 0, 0, 1, 1]",798,576,222,65,14,0.11284722222222222,0.06306306306306306
"[1, 0, 1, 0, 0, 0, 0, 0, 0, 0, 0, 0, 0, 1, 0]",1561,1201,360,119,27,0.09908409658617819,0.075
"[0, 1, 0, 0, 0, 0, 0, 1, 1, 0, 1, 1, 1, 1, 1]",148,73,75,8,12,0.1095890410958904,0.16
"[0, 1, 0, 0, 1, 0, 1, 0, 0, 0, 1, 0, 0, 0, 0]",546,387,159,42,14,0.10852713178294573,0.0880503144654088
"[1, 0, 1, 0, 0, 1, 0, 1, 0, 0, 0, 1, 0, 0, 0]",232,155,77,14,9,0.09032258064516129,0.11688311688311688
"[1, 1, 1, 0, 1, 0, 1, 1, 1, 1, 0, 1, 0, 1, 0]",233,76,157,12,22,0.15789473684210525,0.14012738853503184
"[1, 0, 1, 0, 1, 1, 1, 0, 1, 0, 1, 1, 1, 1, 0]",268,110,158,14,17,0.12727272727272726,0.10759493670886076
"[1, 1, 1, 1, 0, 1, 0, 0, 1, 1, 0, 0, 1, 1, 1]",516,180,336,20,30,0.1111111111111111,0.08928571428571429
"[0, 0, 0, 0, 0, 0, 1, 1, 1, 1, 0, 1, 0, 0, 1]",297,170,127,14,11,0.08235294117647059,0.08661417322834646
"[0, 1, 1, 1, 0, 1, 1, 1, 1, 0, 0, 1, 1, 1, 1]",1010,333,677,35,65,0.10510510510510511,0.09601181683899557
"[1, 0, 1, 1, 1, 1, 1, 1, 1, 1, 0, 0, 1, 1, 0]",1141,347,794,29,71,0.08357348703170028,0.08942065491183879
"[0, 0, 0, 0, 1, 1, 1, 0, 0, 0, 0, 0, 0, 1, 1]",753,520,233,52,22,0.1,0.0944206008583691
"[0, 0, 0, 1, 1, 0, 1, 1, 1, 1, 0, 0, 1, 0, 1]",115,67,48,4,4,0.05970149253731343,0.08333333333333333
"[0, 0, 0, 0, 1, 1, 0, 0, 1, 1, 0, 0, 1, 1, 1]",1957,1032,925,100,86,0.09689922480620156,0.09297297297297297
"[1, 0, 0, 0, 1, 0, 0, 1, 0, 0, 1, 0, 0, 0, 0]",554,382,172,35,20,0.09162303664921466,0.11627906976744186
"[0, 1, 1, 0, 1, 1, 0, 1, 0, 0, 0, 1, 0, 0, 1]",124,74,50,7,5,0.0945945945945946,0.1
"[1, 1, 1, 0, 0, 1, 0, 1, 0, 1, 0, 1, 1, 0, 1]",138,61,77,5,5,0.08196721311475409,0.06493506493506493
"[0, 1, 0, 1, 0, 1, 0, 1, 1, 0, 1, 0, 1, 1, 1]",151,69,82,6,13,0.08695652173913043,0.15853658536585366
"[1, 0, 0, 0, 1, 0, 1, 0, 1, 0, 1, 1, 0, 1, 0]",99,49,50,7,5,0.14285714285714285,0.1
"[0, 0, 1, 0, 1, 1, 0, 1, 1, 0, 0, 0, 1, 0, 1]",115,62,53,7,7,0.11290322580645161,0.1320754716981132
"[0, 1, 1, 0, 0, 1, 0, 0, 1, 1, 0, 1, 0, 1, 1]",129,61,68,5,7,0.08196721311475409,0.10294117647058823
"[0, 0, 0, 1, 0, 0, 1, 1, 1, 0, 0, 0, 0, 0, 1]",310,194,116,21,7,0.10824742268041238,0.0603448275862069
"[0, 0, 0, 0, 1, 0, 0, 1, 1, 1, 0, 0, 0, 0, 0]",809,571,238,55,20,0.09632224168126094,0.08403361344537816
"[0, 0, 0, 0, 0, 1, 0, 0, 1, 1, 1, 0, 0, 0, 0]",789,568,221,44,20,0.07746478873239436,0.09049773755656108
"[1, 0, 1, 1, 0, 1, 0, 1, 1, 0, 0, 1, 1, 1, 0]",140,56,84,3,12,0.05357142857142857,0.14285714285714285
"[1, 0, 1, 1, 1, 0, 1, 1, 1, 0, 1, 1, 0, 1, 0]",208,72,136,9,10,0.125,0.07352941176470588
"[0, 0, 1, 1, 0, 0, 1, 1, 1, 1, 0, 0, 1, 0, 1]",321,150,171,18,14,0.12,0.08187134502923976
"[0, 0, 0, 0, 0, 1, 0, 1, 0, 0, 0, 0, 1, 0, 0]",1586,1210,376,106,35,0.08760330578512397,0.09308510638297872
"[0, 1, 1, 0, 0, 1, 1, 1, 1, 0, 0, 1, 1, 0, 0]",1512,1176,336,96,31,0.08163265306122448,0.09226190476190477
"[1, 1, 1, 1, 0, 1, 1, 1, 1, 1, 0, 0, 1, 0, 1]",519,130,389,10,46,0.07692307692307693,0.11825192802056556
"[0, 1, 1, 1, 1, 0, 1, 1, 1, 1, 1, 0, 0, 1, 0]",221,87,134,6,17,0.06896551724137931,0.12686567164179105
"[0, 0, 1, 0, 1, 0, 1, 1, 0, 1, 0, 1, 1, 1, 1]",183,80,103,5,10,0.0625,0.0970873786407767
"[0, 0, 0, 1, 0, 1, 0, 1, 1, 0, 1, 0, 1, 1, 1]",152,94,58,6,6,0.06382978723404255,0.10344827586206896
"[0, 0, 1, 1, 0, 0, 1, 0, 1, 0, 0, 0, 0, 1, 1]",230,140,90,15,5,0.10714285714285714,0.05555555555555555
"[0, 1, 0, 1, 1, 1, 1, 0, 0, 0, 0, 1, 1, 0, 0]",393,201,192,23,15,0.11442786069651742,0.078125
"[0, 0, 0, 1, 0, 1, 0, 0, 1, 0, 1, 1, 1, 1, 0]",125,77,48,7,6,0.09090909090909091,0.125
"[1, 0, 0, 1, 0, 1, 0, 1, 0, 0, 0, 0, 1, 0, 1]",161,94,67,7,4,0.07446808510638298,0.05970149253731343
"[0, 1, 1, 1, 1, 1, 0, 1, 0, 0, 0, 0, 0, 0, 0]",258,164,94,17,13,0.10365853658536585,0.13829787234042554
"[1, 0, 1, 1, 1, 1, 0, 1, 0, 0, 1, 1, 1, 1, 1]",725,208,517,24,42,0.11538461538461539,0.08123791102514506
"[0, 1, 0, 0, 0, 1, 1, 1, 1, 0, 1, 0, 0, 0, 1]",114,55,59,3,4,0.05454545454545454,0.06779661016949153
"[0, 0, 1, 1, 0, 1, 0, 0, 0, 1, 0, 0, 0, 1, 1]",183,119,64,12,9,0.10084033613445378,0.140625
"[1, 1, 0, 0, 0, 0, 0, 0, 0, 1, 0, 1, 0, 1, 1]",276,171,105,16,7,0.0935672514619883,0.06666666666666667
"[1, 1, 0, 0, 1, 0, 1, 0, 1, 0, 1, 1, 0, 1, 0]",101,47,54,3,13,0.06382978723404255,0.24074074074074073
"[0, 1, 0, 0, 1, 1, 0, 0, 1, 0, 1, 0, 1, 0, 1]",114,62,52,8,10,0.12903225806451613,0.19230769230769232
"[0, 0, 1, 1, 0, 0, 1, 0, 0, 0, 1, 0, 0, 0, 1]",262,176,86,15,9,0.08522727272727272,0.10465116279069768
"[1, 1, 0, 1, 1, 0, 1, 1, 1, 1, 1, 1, 0, 0, 1]",855,234,621,15,67,0.0641025641025641,0.10789049919484701
"[1, 1, 0, 1, 1, 1, 1, 0, 0, 0, 1, 0, 1, 1, 1]",293,101,192,10,13,0.09900990099009901,0.06770833333333333
"[1, 1, 1, 1, 1, 1, 1, 0, 1, 1, 1, 1, 0, 0, 0]",895,238,657,22,59,0.09243697478991597,0.0898021308980213
"[1, 1, 1, 1, 1, 1, 1, 1, 1, 0, 1, 0, 0, 1, 0]",589,180,409,14,41,0.07777777777777778,0.10024449877750612
"[0, 1, 0, 0, 1, 1, 1, 0, 0, 1, 1, 1, 0, 0, 1]",137,66,71,5,8,0.07575757575757576,0.11267605633802817
"[1, 1, 0, 0, 0, 1, 0, 1, 1, 0, 0, 0, 1, 0, 0]",146,87,59,10,3,0.11494252873563218,0.05084745762711865
"[1, 0, 0, 0, 0, 0, 1, 1, 1, 0, 0, 0, 0, 1, 1]",330,187,143,15,17,0.08021390374331551,0.11888111888111888
"[1, 1, 1, 0, 1, 1, 0, 1, 1, 0, 1, 1, 0, 0, 0]",184,64,120,6,11,0.09375,0.09166666666666666
"[1, 0, 1, 0, 1, 1, 0, 1, 0, 0, 1, 1, 1, 1, 1]",337,110,227,8,31,0.07272727272727272,0.13656387665198239
"[1, 0, 0, 0, 0, 0, 0, 0, 1, 0, 0, 1, 0, 0, 0]",1700,1242,458,122,41,0.09822866344605476,0.08951965065502183
"[1, 0, 0, 0, 0, 1, 1, 0, 0, 0, 0, 0, 1, 1, 0]",510,258,252,25,23,0.09689922480620156,0.09126984126984126
"[0, 1, 0, 0, 0, 1, 1, 1, 1, 1, 1, 1, 1, 1, 0]",426,172,254,13,20,0.0755813953488372,0.07874015748031496
"[1, 1, 1, 1, 0, 1, 1, 1, 1, 0, 0, 1, 1, 1, 0]",599,185,414,16,34,0.08648648648648649,0.0821256038647343
"[1, 1, 0, 0, 0, 0, 1, 0, 0, 1, 1, 1, 1, 1, 1]",349,150,199,16,17,0.10666666666666667,0.08542713567839195
"[1, 1, 1, 0, 1, 1, 0, 0, 0, 1, 1, 0, 0, 1, 1]",271,114,157,10,19,0.08771929824561403,0.12101910828025478
"[0, 1, 1, 1, 1, 1, 1, 0, 1, 0, 0, 1, 0, 0, 1]",189,99,90,6,7,0.06060606060606061,0.07777777777777778
"[1, 0, 1, 1, 1, 1, 1, 1, 0, 1, 0, 0, 1, 0, 0]",146,54,92,9,9,0.16666666666666666,0.09782608695652174
"[1, 1, 0, 1, 1, 0, 0, 0, 0, 0, 1, 0, 0, 0, 1]",165,102,63,14,3,0.13725490196078433,0.047619047619047616
"[0, 0, 0, 0, 0, 0, 1, 0, 0, 1, 0, 1, 1, 0, 1]",255,175,80,15,10,0.08571428571428572,0.125
"[0, 0, 1, 0, 1, 0, 1, 0, 0, 0, 0, 0, 0, 0, 0]",2040,1552,488,150,53,0.09664948453608248,0.10860655737704918
"[1, 0, 1, 1, 1, 1, 1, 1, 1, 0, 1, 1, 1, 1, 0]",1583,373,1210,45,113,0.12064343163538874,0.09338842975206611
"[1, 0, 0, 0, 1, 0, 0, 0, 0, 1, 1, 0, 0, 0, 0]",967,645,322,53,29,0.08217054263565891,0.09006211180124224
"[1, 1, 1, 1, 1, 0, 1, 0, 1, 1, 1, 1, 1, 0, 0]",784,215,569,24,52,0.11162790697674418,0.0913884007029877
"[0, 1, 1, 1, 1, 1, 1, 1, 0, 0, 1, 1, 1, 0, 1]",630,238,392,19,34,0.07983193277310924,0.08673469387755102
"[1, 1, 0, 1, 0, 0, 0, 0, 0, 0, 0, 1, 1, 0, 0]",499,315,184,21,18,0.06666666666666667,0.09782608695652174
"[0, 0, 1, 0, 0, 1, 1, 0, 1, 0, 0, 0, 0, 0, 0]",649,478,171,51,10,0.10669456066945607,0.05847953216374269
"[1, 0, 0, 1, 0, 0, 1, 1, 0, 1, 0, 0, 0, 0, 0]",255,141,114,15,8,0.10638297872340426,0.07017543859649122
"[0, 1, 0, 0, 0, 0, 0, 1, 0, 0, 1, 0, 0, 1, 1]",306,201,105,15,8,0.07462686567164178,0.0761904761904762
"[1, 1, 0, 0, 0, 1, 0, 1, 0, 1, 1, 1, 0, 1, 0]",120,60,60,6,6,0.1,0.1
"[1, 1, 0, 0, 1, 1, 0, 1, 1, 1, 0, 0, 0, 1, 0]",132,61,71,6,10,0.09836065573770492,0.14084507042253522
"[0, 1, 0, 0, 0, 1, 0, 0, 1, 1, 0, 0, 1, 1, 0]",244,145,99,11,4,0.07586206896551724,0.04040404040404041
"[0, 1, 0, 0, 0, 0, 1, 0, 1, 0, 0, 0, 1, 0, 0]",501,344,157,30,22,0.0872093023255814,0.14012738853503184
"[1, 1, 1, 0, 1, 0, 1, 0, 1, 0, 0, 0, 0, 1, 0]",127,70,57,8,4,0.11428571428571428,0.07017543859649122
"[1, 0, 0, 0, 1, 0, 1, 1, 1, 0, 1, 0, 1, 0, 1]",101,44,57,7,4,0.1590909090909091,0.07017543859649122
"[1, 1, 1, 1, 0, 1, 0, 1, 0, 0, 1, 1, 1, 1, 0]",306,89,217,6,22,0.06741573033707865,0.10138248847926268
"[0, 0, 0, 1, 1, 1, 1, 1, 1, 0, 0, 0, 0, 0, 0]",2306,1879,427,190,45,0.10111761575306014,0.1053864168618267
"[0, 1, 0, 0, 0, 0, 0, 0, 1, 0, 1, 0, 1, 0, 0]",505,346,159,37,18,0.1069364161849711,0.11320754716981132
"[0, 0, 1, 0, 0, 0, 0, 0, 0, 1, 0, 1, 0, 1, 0]",479,331,148,39,23,0.11782477341389729,0.1554054054054054
"[1, 0, 0, 0, 0, 0, 1, 0, 1, 0, 1, 1, 0, 0, 1]",168,103,65,9,8,0.08737864077669903,0.12307692307692308
"[0, 1, 0, 1, 0, 0, 0, 0, 0, 1, 0, 0, 0, 1, 0]",465,321,144,25,15,0.0778816199376947,0.10416666666666667
"[0, 0, 0, 1, 0, 1, 0, 0, 0, 0, 0, 1, 0, 0, 0]",1618,1247,371,111,32,0.08901363271852446,0.0862533692722372
"[1, 1, 0, 0, 0, 0, 0, 1, 0, 1, 0, 1, 0, 0, 0]",246,154,92,21,8,0.13636363636363635,0.08695652173913043
"[1, 1, 1, 0, 0, 0, 0, 0, 1, 0, 1, 0, 1, 0, 0]",150,86,64,5,5,0.05813953488372093,0.078125
"[1, 1, 1, 1, 0, 1, 1, 1, 0, 0, 0, 0, 0, 1, 0]",150,72,78,5,11,0.06944444444444445,0.14102564102564102
"[0, 1, 1, 1, 1, 1, 1, 0, 1, 1, 1, 0, 0, 0, 0]",252,98,154,4,9,0.04081632653061224,0.05844155844155844
"[0, 0, 0, 0, 1, 0, 0, 1, 1, 1, 1, 1, 1, 0, 1]",156,81,75,10,6,0.12345679012345678,0.08
"[0, 0, 0, 0, 0, 1, 0, 0, 1, 1, 1, 1, 1, 1, 0]",267,166,101,18,10,0.10843373493975904,0.09900990099009901
"[0, 1, 0, 0, 0, 0, 0, 0, 0, 1, 0, 0, 1, 1, 1]",473,332,141,29,11,0.08734939759036145,0.07801418439716312
"[1, 1, 1, 0, 0, 0, 0, 1, 1, 1, 0, 1, 0, 0, 0]",171,76,95,6,6,0.07894736842105263,0.06315789473684211
"[1, 1, 0, 1, 0, 1, 1, 0, 0, 0, 0, 0, 0, 0, 1]",214,133,81,18,10,0.13533834586466165,0.12345679012345678
"[1, 0, 0, 0, 1, 0, 0, 0, 0, 1, 0, 0, 0, 0, 0]",1820,1337,483,128,57,0.09573672400897532,0.11801242236024845
"[0, 1, 1, 0, 1, 0, 0, 0, 0, 0, 0, 0, 0, 0, 0]",2502,1898,604,182,50,0.0958904109589041,0.08278145695364239
"[0, 1, 1, 0, 0, 1, 0, 0, 0, 0, 0, 0, 1, 1, 0]",370,239,131,24,8,0.100418410041841,0.061068702290076333
"[0, 0, 1, 0, 0, 1, 1, 0, 1, 1, 0, 1, 1, 1, 0]",114,45,69,2,8,0.044444444444444446,0.11594202898550725
"[0, 1, 1, 0, 0, 1, 0, 0, 1, 0, 0, 1, 1, 0, 1]",112,65,47,7,8,0.1076923076923077,0.1702127659574468
"[1, 1, 0, 0, 0, 0, 1, 0, 0, 1, 1, 0, 0, 1, 0]",158,89,69,8,9,0.0898876404494382,0.13043478260869565
"[1, 1, 1, 1, 0, 0, 0, 0, 1, 0, 0, 1, 1, 0, 0]",234,125,109,7,16,0.056,0.14678899082568808
"[1, 1, 1, 1, 1, 1, 0, 0, 0, 0, 1, 0, 0, 1, 1]",402,187,215,25,24,0.13368983957219252,0.11162790697674418
"[0, 1, 1, 1, 1, 1, 1, 0, 0, 0, 0, 1, 0, 0, 1]",270,189,81,21,5,0.1111111111111111,0.06172839506172839
"[1, 0, 0, 0, 1, 0, 1, 0, 0, 1, 1, 0, 0, 1, 0]",132,76,56,6,1,0.07894736842105263,0.017857142857142856
"[0, 1, 0, 0, 1, 0, 0, 1, 0, 0, 0, 1, 0, 1, 0]",209,140,69,17,4,0.12142857142857143,0.057971014492753624
"[1, 1, 0, 1, 0, 0, 0, 0, 0, 1, 0, 0, 0, 0, 0]",567,396,171,34,13,0.08585858585858586,0.07602339181286549
"[0, 0, 0, 0, 1, 1, 0, 1, 0, 0, 0, 0, 0, 1, 0]",552,402,150,36,15,0.08955223880597014,0.1
"[0, 0, 0, 1, 1, 1, 1, 1, 1, 0, 1, 0, 0, 0, 1]",172,102,70,5,6,0.049019607843137254,0.08571428571428572
"[1, 0, 1, 1, 1, 0, 1, 0, 0, 0, 1, 0, 1, 1, 1]",162,70,92,8,11,0.11428571428571428,0.11956521739130435
"[0, 1, 0, 1, 1, 1, 0, 1, 0, 0, 0, 1, 0, 1, 1]",121,63,58,5,5,0.07936507936507936,0.08620689655172414
"[0, 1, 1, 0, 1, 0, 1, 0, 1, 1, 1, 1, 0, 1, 0]",136,63,73,7,5,0.1111111111111111,0.0684931506849315
"[0, 0, 1, 1, 1, 0, 0, 1, 1, 0, 0, 1, 0, 0, 0]",174,99,75,12,5,0.12121212121212122,0.06666666666666667
"[1, 1, 1, 1, 0, 0, 0, 0, 0, 1, 0, 1, 0, 1, 1]",163,82,81,7,8,0.08536585365853659,0.09876543209876543
"[1, 1, 1, 0, 1, 1, 1, 1, 0, 0, 1, 1, 0, 0, 1]",655,205,450,23,44,0.11219512195121951,0.09777777777777778
"[1, 0, 1, 0, 1, 0, 1, 1, 1, 0, 1, 1, 0, 0, 1]",157,63,94,6,3,0.09523809523809523,0.031914893617021274
"[0, 0, 0, 0, 1, 1, 0, 1, 0, 1, 0, 1, 1, 1, 0]",118,65,53,5,10,0.07692307692307693,0.18867924528301888
"[1, 1, 1, 1, 1, 0, 0, 1, 1, 1, 1, 0, 1, 0, 1]",885,181,704,14,62,0.07734806629834254,0.08806818181818182
"[0, 1, 0, 1, 0, 0, 0, 0, 0, 1, 0, 0, 0, 0, 0]",1745,1356,389,122,43,0.08997050147492626,0.11053984575835475
"[0, 1, 0, 0, 1, 0, 1, 0, 0, 0, 0, 0, 1, 0, 0]",532,361,171,38,25,0.10526315789473684,0.14619883040935672
"[0, 0, 1, 0, 0, 0, 0, 0, 1, 1, 1, 1, 0, 1, 0]",173,102,71,6,10,0.058823529411764705,0.14084507042253522
"[1, 1, 1, 1, 1, 0, 1, 0, 1, 0, 1, 1, 0, 1, 1]",538,154,384,14,37,0.09090909090909091,0.09635416666666667
"[0, 1, 1, 1, 0, 1, 1, 1, 0, 1, 1, 1, 1, 1, 0]",517,170,347,16,35,0.09411764705882353,0.10086455331412104
"[1, 1, 1, 1, 0, 1, 1, 1, 0, 1, 1, 1, 0, 1, 1]",1605,388,1217,41,102,0.1056701030927835,0.0838126540673788
"[1, 1, 1, 1, 1, 1, 0, 1, 1, 1, 0, 1, 1, 1, 0]",1585,378,1207,33,105,0.0873015873015873,0.08699254349627175
"[1, 1, 0, 0, 1, 1, 0, 1, 1, 1, 1, 0, 0, 1, 0]",173,75,98,8,12,0.10666666666666667,0.12244897959183673
"[1, 1, 1, 1, 0, 0, 1, 1, 1, 1, 0, 0, 0, 1, 1]",819,298,521,26,59,0.087248322147651,0.11324376199616124
"[1, 1, 1, 0, 1, 1, 1, 0, 0, 0, 0, 1, 1, 1, 1]",651,206,445,14,29,0.06796116504854369,0.0651685393258427
"[0, 0, 1, 0, 0, 1, 1, 0, 0, 0, 0, 1, 1, 0, 0]",788,509,279,47,22,0.09233791748526522,0.07885304659498207
"[0, 1, 0, 0, 0, 0, 0, 0, 1, 0, 0, 1, 1, 0, 0]",703,511,192,44,22,0.08610567514677103,0.11458333333333333
"[0, 1, 0, 1, 1, 1, 1, 1, 1, 0, 0, 1, 1, 0, 0]",486,192,294,19,37,0.09895833333333333,0.12585034013605442
"[1, 0, 1, 0, 1, 1, 1, 1, 1, 1, 0, 0, 1, 1, 0]",466,171,295,15,26,0.08771929824561403,0.08813559322033898
"[1, 0, 0, 0, 1, 0, 0, 1, 0, 1, 1, 1, 0, 1, 1]",124,45,79,6,14,0.13333333333333333,0.17721518987341772
"[1, 1, 0, 1, 0, 0, 0, 1, 0, 0, 1, 0, 1, 1, 1]",111,45,66,1,14,0.022222222222222223,0.21212121212121213
"[1, 1, 1, 0, 1, 1, 0, 0, 0, 1, 1, 1, 0, 1, 0]",154,68,86,8,8,0.11764705882352941,0.09302325581395349
"[0, 0, 1, 1, 1, 0, 0, 0, 1, 1, 0, 0, 1, 0, 0]",142,82,60,9,5,0.10975609756097561,0.08333333333333333
"[0, 0, 0, 1, 1, 0, 0, 0, 0, 1, 1, 1, 0, 0, 0]",486,368,118,31,11,0.08423913043478261,0.09322033898305085
"[0, 0, 1, 0, 0, 0, 1, 0, 0, 0, 0, 0, 0, 0, 1]",1786,1371,415,139,31,0.10138584974471189,0.0746987951807229
"[0, 0, 1, 0, 0, 1, 0, 1, 0, 0, 1, 1, 0, 0, 1]",170,108,62,15,4,0.1388888888888889,0.06451612903225806
"[0, 1, 1, 0, 1, 1, 0, 1, 1, 0, 0, 1, 1, 1, 1]",409,176,233,16,18,0.09090909090909091,0.07725321888412018
"[0, 1, 1, 1, 0, 1, 1, 0, 1, 1, 0, 1, 1, 0, 0]",156,62,94,5,6,0.08064516129032258,0.06382978723404255
"[0, 1, 0, 1, 0, 0, 1, 1, 1, 1, 0, 0, 0, 0, 0]",347,210,137,14,13,0.06666666666666667,0.0948905109489051
"[1, 0, 0, 1, 1, 1, 1, 0, 1, 0, 1, 1, 0, 0, 0]",158,74,84,8,5,0.10810810810810811,0.05952380952380952
"[1, 0, 0, 0, 0, 1, 1, 0, 0, 0, 1, 1, 0, 0, 1]",259,97,162,14,12,0.14432989690721648,0.07407407407407407
"[1, 1, 1, 1, 0, 1, 0, 1, 0, 0, 1, 1, 1, 1, 1]",812,232,580,22,66,0.09482758620689655,0.11379310344827587
"[0, 1, 0, 1, 0, 0, 0, 0, 1, 0, 0, 0, 0, 0, 0]",1808,1402,406,110,37,0.07845934379457917,0.09113300492610837
"[0, 0, 0, 0, 1, 1, 1, 1, 0, 0, 1, 1, 0, 0, 1]",1588,850,738,84,77,0.0988235294117647,0.1043360433604336
"[1, 0, 0, 0, 0, 0, 0, 1, 1, 1, 1, 0, 0, 1, 1]",1746,396,1350,47,119,0.11868686868686869,0.08814814814814814
"[1, 1, 0, 0, 0, 0, 0, 0, 1, 1, 1, 1, 0, 0, 1]",1597,784,813,66,95,0.08418367346938775,0.11685116851168512
"[0, 1, 0, 0, 0, 0, 1, 0, 0, 1, 1, 1, 1, 1, 0]",138,70,68,9,9,0.12857142857142856,0.1323529411764706
"[0, 0, 1, 0, 0, 0, 0, 1, 0, 0, 1, 1, 1, 1, 1]",204,117,87,7,12,0.05982905982905983,0.13793103448275862
"[1, 1, 1, 1, 1, 0, 1, 0, 0, 1, 1, 1, 1, 1, 0]",615,171,444,13,45,0.07602339181286549,0.10135135135135136
"[0, 1, 0, 0, 0, 0, 0, 1, 0, 0, 1, 0, 0, 0, 1]",504,372,132,29,13,0.07795698924731183,0.09848484848484848
"[0, 1, 1, 0, 1, 1, 1, 1, 0, 1, 0, 0, 0, 0, 1]",125,53,72,4,7,0.07547169811320754,0.09722222222222222
"[1, 1, 1, 1, 0, 0, 1, 1, 0, 1, 1, 1, 1, 0, 1]",616,184,432,13,32,0.07065217391304347,0.07407407407407407
"[0, 1, 1, 1, 0, 0, 0, 1, 1, 1, 1, 1, 0, 1, 1]",299,110,189,13,15,0.11818181818181818,0.07936507936507936
"[1, 1, 0, 1, 1, 1, 0, 1, 0, 1, 0, 1, 0, 1, 1]",243,86,157,7,11,0.08139534883720931,0.07006369426751592
"[1, 0, 0, 0, 0, 1, 0, 1, 0, 1, 1, 1, 0, 1, 0]",115,57,58,4,4,0.07017543859649122,0.06896551724137931
"[1, 1, 1, 1, 1, 0, 0, 0, 0, 1, 0, 1, 0, 1, 1]",269,69,200,2,24,0.028985507246376812,0.12
"[0, 0, 0, 1, 0, 0, 0, 1, 1, 1, 1, 1, 0, 1, 0]",122,70,52,6,4,0.08571428571428572,0.07692307692307693
"[1, 0, 0, 0, 1, 0, 0, 0, 1, 1, 1, 1, 1, 0, 1]",113,53,60,4,4,0.07547169811320754,0.06666666666666667
"[0, 0, 0, 1, 0, 1, 0, 0, 0, 0, 0, 1, 1, 0, 0]",835,608,227,61,17,0.10032894736842106,0.07488986784140969
"[0, 1, 0, 1, 1, 1, 1, 1, 1, 1, 1, 1, 0, 1, 1]",1696,417,1279,39,127,0.09352517985611511,0.09929632525410477
"[1, 0, 0, 0, 1, 0, 0, 0, 0, 0, 0, 0, 1, 1, 1]",610,345,265,25,32,0.07246376811594203,0.12075471698113208
"[1, 0, 1, 0, 1, 1, 0, 1, 0, 0, 0, 1, 0, 0, 0]",154,72,82,15,8,0.20833333333333334,0.0975609756097561
"[0, 0, 1, 0, 1, 0, 1, 1, 0, 1, 0, 0, 0, 1, 0]",123,70,53,13,7,0.18571428571428572,0.1320754716981132
"[0, 0, 1, 1, 0, 1, 1, 0, 1, 1, 1, 1, 1, 1, 1]",829,247,582,20,66,0.08097165991902834,0.1134020618556701
"[1, 1, 0, 1, 1, 1, 1, 1, 0, 1, 1, 0, 0, 1, 1]",742,200,542,21,50,0.105,0.09225092250922509
"[1, 1, 0, 1, 1, 1, 1, 1, 0, 0, 1, 1, 0, 1, 1]",614,175,439,12,45,0.06857142857142857,0.10250569476082004
"[1, 1, 1, 0, 1, 0, 1, 1, 0, 0, 1, 1, 0, 0, 1]",270,116,154,20,12,0.1724137931034483,0.07792207792207792
"[0, 1, 1, 1, 1, 1, 1, 0, 1, 1, 1, 0, 1, 0, 1]",504,167,337,11,34,0.0658682634730539,0.10089020771513353
"[0, 1, 0, 1, 0, 1, 0, 1, 0, 0, 0, 0, 0, 0, 1]",261,165,96,12,3,0.07272727272727272,0.03125
"[0, 0, 0, 1, 0, 0, 0, 1, 1, 0, 0, 1, 1, 1, 1]",371,220,151,17,15,0.07727272727272727,0.09933774834437085
"[1, 1, 0, 0, 1, 1, 0, 0, 1, 0, 0, 0, 1, 1, 1]",311,148,163,8,16,0.05405405405405406,0.09815950920245399
"[1, 0, 0, 0, 1, 1, 0, 1, 1, 0, 1, 1, 0, 1, 0]",100,41,59,3,4,0.07317073170731707,0.06779661016949153
"[0, 1, 1, 1, 1, 1, 1, 1, 1, 1, 0, 1, 1, 0, 1]",1664,503,1161,37,107,0.073558648111332,0.0921619293712317
"[1, 0, 1, 1, 1, 1, 1, 0, 0, 0, 0, 1, 1, 1, 1]",872,296,576,32,57,0.10810810810810811,0.09895833333333333
"[0, 1, 0, 1, 1, 1, 1, 1, 1, 1, 1, 1, 0, 0, 0]",545,202,343,18,38,0.0891089108910891,0.11078717201166181
"[0, 1, 0, 0, 0, 0, 1, 1, 0, 0, 0, 0, 1, 0, 1]",286,184,102,18,12,0.09782608695652174,0.11764705882352941
"[1, 0, 1, 0, 0, 1, 1, 1, 0, 0, 0, 1, 1, 1, 0]",111,57,54,3,10,0.05263157894736842,0.18518518518518517
"[1, 1, 0, 0, 0, 0, 0, 0, 1, 1, 0, 1, 1, 1, 1]",446,210,236,23,19,0.10952380952380952,0.08050847457627118
"[0, 0, 1, 0, 1, 0, 0, 1, 0, 0, 1, 1, 0, 1, 0]",155,88,67,4,7,0.045454545454545456,0.1044776119402985
"[1, 1, 1, 1, 0, 1, 1, 0, 0, 1, 1, 0, 1, 1, 1]",655,199,456,21,54,0.10552763819095477,0.11842105263157894
"[0, 0, 0, 1, 1, 0, 0, 1, 1, 0, 1, 1, 0, 0, 0]",230,164,66,11,6,0.06707317073170732,0.09090909090909091
"[1, 0, 0, 1, 0, 0, 0, 0, 0, 0, 0, 1, 1, 0, 0]",997,695,302,64,38,0.0920863309352518,0.12582781456953643
"[1, 1, 1, 1, 1, 1, 1, 0, 1, 1, 0, 1, 0, 1, 0]",562,178,384,11,35,0.06179775280898876,0.09114583333333333
"[0, 1, 0, 0, 0, 0, 0, 0, 0, 1, 0, 1, 0, 0, 0]",1571,1204,367,111,32,0.09219269102990033,0.08719346049046321
"[0, 0, 1, 1, 0, 0, 1, 0, 1, 0, 1, 1, 0, 0, 0]",176,116,60,14,4,0.1206896551724138,0.06666666666666667
"[1, 0, 1, 0, 1, 1, 1, 0, 0, 1, 0, 1, 1, 1, 1]",275,97,178,10,17,0.10309278350515463,0.09550561797752809
"[0, 0, 0, 1, 1, 1, 1, 1, 1, 0, 0, 1, 0, 1, 1]",348,228,120,22,12,0.09649122807017543,0.1
"[1, 0, 0, 0, 0, 1, 1, 1, 1, 1, 1, 0, 0, 1, 0]",347,90,257,10,27,0.1111111111111111,0.10505836575875487
"[0, 0, 0, 1, 1, 1, 0, 0, 1, 1, 0, 1, 1, 1, 1]",221,108,113,10,12,0.09259259259259259,0.10619469026548672
"[1, 0, 0, 0, 1, 1, 0, 0, 1, 1, 0, 0, 1, 1, 1]",466,221,245,24,23,0.1085972850678733,0.09387755102040816
"[0, 0, 1, 0, 0, 1, 0, 1, 1, 0, 0, 0, 1, 0, 1]",133,79,54,8,3,0.10126582278481013,0.05555555555555555
"[1, 1, 1, 1, 0, 0, 0, 1, 0, 0, 1, 0, 1, 1, 0]",129,53,76,11,7,0.20754716981132076,0.09210526315789473
"[0, 0, 0, 0, 0, 1, 0, 1, 0, 1, 0, 0, 0, 0, 1]",597,422,175,39,15,0.0924170616113744,0.08571428571428572
"[1, 1, 0, 0, 1, 1, 0, 0, 0, 1, 1, 1, 0, 0, 1]",197,93,104,6,8,0.06451612903225806,0.07692307692307693
"[1, 0, 1, 0, 0, 0, 0, 0, 0, 0, 1, 1, 0, 0, 1]",479,290,189,29,17,0.1,0.08994708994708994
"[1, 1, 0, 1, 1, 1, 0, 0, 1, 1, 1, 0, 1, 1, 0]",256,93,163,12,11,0.12903225806451613,0.06748466257668712
"[1, 0, 1, 1, 1, 0, 0, 1, 0, 0, 1, 0, 0, 1, 1]",114,56,58,3,6,0.05357142857142857,0.10344827586206896
"[0, 0, 1, 0, 1, 1, 1, 1, 0, 0, 0, 0, 1, 0, 1]",128,64,64,7,10,0.109375,0.15625
"[0, 1, 1, 0, 1, 0, 1, 1, 0, 1, 1, 1, 1, 1, 0]",250,97,153,7,13,0.07216494845360824,0.08496732026143791
"[0, 1, 0, 1, 1, 1, 1, 0, 1, 0, 1, 0, 1, 0, 1]",152,74,78,9,7,0.12162162162162163,0.08974358974358974
"[1, 0, 1, 0, 1, 1, 1, 1, 0, 1, 0, 1, 0, 1, 0]",139,61,78,4,8,0.06557377049180328,0.10256410256410256
"[0, 1, 0, 1, 1, 1, 0, 1, 0, 1, 0, 0, 0, 1, 1]",128,61,67,8,4,0.13114754098360656,0.05970149253731343
"[1, 1, 1, 1, 1, 0, 0, 1, 1, 0, 0, 0, 0, 1, 0]",373,86,287,8,21,0.09302325581395349,0.07317073170731707
"[1, 0, 1, 1, 1, 0, 1, 0, 0, 1, 1, 0, 1, 1, 1]",254,87,167,10,12,0.11494252873563218,0.0718562874251497
"[1, 0, 1, 1, 0, 1, 1, 1, 0, 1, 0, 0, 1, 1, 0]",167,69,98,9,9,0.13043478260869565,0.09183673469387756
"[1, 1, 1, 1, 0, 0, 1, 0, 0, 0, 0, 0, 1, 0, 0]",179,93,86,5,4,0.053763440860215055,0.046511627906976744
"[0, 0, 1, 0, 1, 0, 0, 0, 1, 1, 1, 1, 1, 0, 0]",163,85,78,10,9,0.11764705882352941,0.11538461538461539
"[0, 1, 0, 0, 0, 0, 1, 0, 1, 0, 0, 0, 0, 1, 1]",347,226,121,24,17,0.10619469026548672,0.14049586776859505
"[0, 1, 0, 1, 0, 0, 1, 0, 0, 0, 0, 1, 0, 1, 0]",222,145,77,10,9,0.06896551724137931,0.11688311688311688
"[0, 1, 0, 1, 0, 1, 0, 0, 1, 0, 0, 0, 0, 1, 0]",193,137,56,15,5,0.10948905109489052,0.08928571428571429
"[0, 1, 1, 1, 1, 1, 0, 0, 1, 0, 1, 0, 1, 0, 0]",122,59,63,12,11,0.2033898305084746,0.1746031746031746
"[1, 0, 1, 1, 0, 1, 0, 1, 1, 1, 1, 1, 0, 0, 1]",336,105,231,17,28,0.1619047619047619,0.12121212121212122
"[0, 1, 1, 0, 0, 0, 0, 1, 1, 1, 1, 1, 0, 0, 0]",276,181,95,19,8,0.10497237569060773,0.08421052631578947
"[0, 0, 0, 0, 1, 0, 0, 0, 1, 0, 1, 0, 0, 1, 1]",331,223,108,26,13,0.11659192825112108,0.12037037037037036
"[0, 0, 0, 0, 1, 1, 0, 1, 1, 1, 1, 0, 0, 1, 1]",258,143,115,17,13,0.11888111888111888,0.11304347826086956
"[1, 0, 1, 0, 0, 1, 1, 1, 1, 0, 0, 0, 1, 0, 0]",120,60,60,7,4,0.11666666666666667,0.06666666666666667
"[1, 0, 0, 0, 1, 1, 0, 1, 0, 0, 1, 1, 1, 1, 0]",137,64,73,7,8,0.109375,0.1095890410958904
"[0, 1, 0, 1, 0, 1, 1, 1, 1, 1, 0, 1, 0, 0, 1]",152,56,96,4,6,0.07142857142857142,0.0625
"[0, 1, 1, 1, 1, 0, 0, 0, 0, 1, 1, 0, 0, 1, 1]",1661,1308,353,98,26,0.07492354740061162,0.07365439093484419
"[1, 0, 0, 0, 1, 0, 1, 1, 0, 0, 0, 1, 0, 1, 1]",104,50,54,5,8,0.1,0.14814814814814814
"[1, 0, 0, 1, 1, 0, 0, 0, 1, 1, 0, 0, 0, 1, 0]",150,81,69,9,8,0.1111111111111111,0.11594202898550725
"[1, 1, 1, 1, 1, 1, 1, 0, 0, 1, 1, 0, 0, 0, 1]",677,143,534,11,43,0.07692307692307693,0.08052434456928839
"[1, 1, 0, 1, 1, 1, 1, 0, 0, 1, 1, 0, 0, 0, 0]",472,208,264,19,27,0.09134615384615384,0.10227272727272728
"[0, 1, 0, 1, 1, 0, 1, 1, 0, 1, 1, 1, 0, 1, 1]",241,95,146,11,15,0.11578947368421053,0.10273972602739725
"[1, 0, 1, 1, 1, 1, 0, 0, 1, 1, 1, 1, 0, 0, 1]",733,244,489,17,49,0.06967213114754098,0.10020449897750511
"[0, 1, 1, 1, 0, 1, 1, 1, 0, 1, 1, 1, 1, 0, 0]",296,100,196,7,20,0.07,0.10204081632653061
"[0, 1, 1, 1, 1, 1, 0, 0, 0, 1, 1, 0, 0, 0, 1]",127,67,60,6,9,0.08955223880597014,0.15
"[0, 0, 0, 1, 1, 1, 0, 0, 0, 1, 1, 1, 0, 0, 0]",263,164,99,12,9,0.07317073170731707,0.09090909090909091
"[0, 0, 0, 0, 1, 0, 0, 0, 1, 0, 0, 0, 0, 0, 0]",7857,6479,1378,637,119,0.09831764161135978,0.08635703918722787
"[1, 1, 1, 1, 0, 1, 1, 1, 0, 1, 1, 1, 0, 0, 0]",281,100,181,10,19,0.1,0.10497237569060773
"[1, 1, 1, 0, 0, 0, 0, 0, 0, 1, 1, 0, 1, 1, 0]",214,77,137,11,11,0.14285714285714285,0.08029197080291971
"[0, 1, 1, 0, 0, 1, 1, 1, 0, 0, 0, 0, 0, 0, 1]",317,195,122,22,8,0.11282051282051282,0.06557377049180328
"[0, 0, 0, 1, 0, 0, 0, 0, 0, 0, 1, 1, 0, 1, 1]",343,229,114,17,16,0.07423580786026202,0.14035087719298245
"[1, 1, 1, 0, 1, 0, 1, 1, 1, 0, 0, 0, 1, 1, 0]",152,59,93,2,12,0.03389830508474576,0.12903225806451613
"[1, 0, 0, 1, 1, 1, 1, 1, 0, 1, 0, 0, 1, 1, 1]",400,92,308,11,33,0.11956521739130435,0.10714285714285714
"[0, 0, 1, 0, 1, 1, 0, 0, 0, 0, 1, 0, 0, 0, 0]",616,435,181,41,20,0.09425287356321839,0.11049723756906077
"[0, 1, 0, 0, 1, 1, 0, 0, 0, 0, 1, 0, 1, 1, 0]",151,81,70,3,6,0.037037037037037035,0.08571428571428572
"[0, 1, 1, 1, 1, 0, 1, 1, 0, 1, 0, 0, 1, 0, 0]",114,58,56,7,2,0.1206896551724138,0.03571428571428571
"[0, 1, 0, 1, 1, 1, 1, 0, 1, 1, 0, 1, 0, 0, 1]",152,68,84,5,9,0.07352941176470588,0.10714285714285714
"[0, 0, 1, 0, 1, 1, 1, 1, 0, 1, 1, 0, 1, 0, 0]",109,44,65,4,5,0.09090909090909091,0.07692307692307693
"[1, 1, 0, 1, 0, 0, 0, 0, 1, 0, 1, 1, 1, 1, 0]",134,63,71,6,6,0.09523809523809523,0.08450704225352113
"[0, 1, 0, 0, 1, 0, 0, 1, 1, 1, 1, 1, 1, 1, 1]",521,213,308,21,42,0.09859154929577464,0.13636363636363635
"[0, 0, 1, 0, 0, 1, 0, 0, 1, 1, 1, 1, 1, 1, 1]",306,131,175,9,18,0.06870229007633588,0.10285714285714286
"[1, 0, 0, 1, 0, 0, 1, 0, 0, 1, 1, 1, 1, 1, 1]",285,108,177,10,16,0.09259259259259259,0.0903954802259887
"[1, 1, 1, 0, 0, 1, 0, 0, 1, 0, 0, 1, 1, 1, 1]",276,84,192,9,17,0.10714285714285714,0.08854166666666667
"[0, 0, 1, 1, 0, 0, 1, 0, 0, 0, 0, 1, 1, 1, 1]",340,192,148,18,13,0.09375,0.08783783783783784
"[1, 0, 1, 0, 0, 1, 0, 0, 1, 0, 0, 0, 1, 1, 0]",142,83,59,5,3,0.060240963855421686,0.05084745762711865
"[0, 1, 1, 0, 1, 1, 1, 1, 1, 0, 1, 0, 0, 0, 1]",154,58,96,6,8,0.10344827586206896,0.08333333333333333
"[0, 0, 1, 0, 1, 1, 0, 1, 0, 1, 1, 1, 0, 1, 1]",164,64,100,3,4,0.046875,0.04
"[1, 0, 0, 1, 1, 0, 1, 1, 1, 0, 1, 1, 0, 0, 0]",135,59,76,7,12,0.11864406779661017,0.15789473684210525
"[1, 1, 1, 1, 0, 1, 0, 1, 1, 0, 1, 1, 0, 0, 1]",290,108,182,13,18,0.12037037037037036,0.0989010989010989
"[0, 0, 0, 0, 1, 1, 0, 0, 1, 0, 0, 0, 0, 1, 1]",523,355,168,42,13,0.11830985915492957,0.07738095238095238
"[1, 1, 1, 0, 0, 0, 0, 1, 0, 1, 1, 1, 0, 1, 1]",187,73,114,9,10,0.1232876712328767,0.08771929824561403
"[1, 1, 0, 1, 1, 1, 0, 0, 0, 0, 1, 0, 1, 1, 1]",197,89,108,8,13,0.0898876404494382,0.12037037037037036
"[1, 0, 1, 1, 0, 1, 1, 1, 0, 1, 1, 0, 1, 1, 1]",517,149,368,11,34,0.0738255033557047,0.09239130434782608
"[0, 1, 1, 0, 0, 1, 0, 1, 1, 0, 1, 1, 1, 0, 1]",139,64,75,11,4,0.171875,0.05333333333333334
"[1, 0, 0, 0, 1, 1, 0, 1, 0, 0, 0, 0, 1, 0, 0]",222,159,63,21,5,0.1320754716981132,0.07936507936507936
"[1, 0, 1, 0, 1, 1, 1, 1, 0, 0, 0, 0, 0, 0, 1]",301,154,147,20,8,0.12987012987012986,0.05442176870748299
"[0, 1, 0, 1, 1, 0, 0, 0, 0, 0, 0, 1, 1, 0, 1]",192,113,79,2,13,0.017699115044247787,0.16455696202531644
"[0, 1, 1, 1, 1, 0, 0, 1, 1, 0, 0, 1, 1, 1, 0]",376,259,117,26,15,0.10038610038610038,0.1282051282051282
"[0, 1, 1, 1, 0, 0, 0, 1, 0, 0, 0, 0, 0, 1, 1]",215,144,71,16,8,0.1111111111111111,0.11267605633802817
"[1, 0, 1, 1, 1, 0, 1, 1, 0, 0, 0, 0, 1, 1, 1]",286,103,183,8,15,0.07766990291262135,0.08196721311475409
"[1, 0, 0, 0, 0, 1, 0, 1, 0, 0, 0, 0, 0, 0, 0]",1932,1384,548,139,47,0.10043352601156069,0.08576642335766424
"[0, 1, 1, 1, 1, 0, 0, 0, 0, 1, 0, 1, 0, 0, 0]",210,155,55,15,7,0.0967741935483871,0.12727272727272726
"[1, 0, 0, 0, 0, 1, 1, 1, 1, 0, 0, 0, 0, 1, 0]",430,161,269,10,20,0.062111801242236024,0.07434944237918216
"[0, 0, 0, 0, 0, 1, 0, 1, 1, 0, 0, 0, 0, 1, 1]",551,386,165,39,10,0.10103626943005181,0.06060606060606061
"[0, 1, 1, 0, 0, 0, 0, 0, 0, 1, 1, 0, 0, 1, 1]",2168,1832,336,150,29,0.08187772925764192,0.08630952380952381
"[1, 0, 1, 1, 1, 0, 1, 1, 0, 0, 1, 0, 0, 1, 1]",142,56,86,3,7,0.05357142857142857,0.08139534883720931
"[1, 1, 1, 1, 0, 1, 1, 0, 1, 1, 0, 0, 1, 1, 0]",356,137,219,8,23,0.058394160583941604,0.1050228310502283
"[1, 0, 0, 1, 0, 1, 1, 1, 1, 0, 1, 0, 0, 0, 0]",146,66,80,7,10,0.10606060606060606,0.125
"[1, 0, 0, 1, 1, 0, 0, 1, 1, 1, 1, 1, 1, 0, 0]",1824,308,1516,33,156,0.10714285714285714,0.10290237467018469
"[0, 1, 1, 0, 1, 1, 1, 1, 0, 0, 1, 0, 0, 0, 0]",139,79,60,8,10,0.10126582278481013,0.16666666666666666
"[1, 1, 1, 0, 1, 1, 1, 1, 1, 1, 1, 0, 0, 0, 1]",689,181,508,24,58,0.13259668508287292,0.1141732283464567
"[1, 1, 0, 0, 0, 1, 0, 0, 0, 0, 1, 1, 0, 0, 0]",421,258,163,28,9,0.10852713178294573,0.05521472392638037
"[0, 0, 1, 0, 0, 1, 0, 0, 1, 1, 0, 0, 0, 1, 1]",187,123,64,14,5,0.11382113821138211,0.078125
"[1, 1, 0, 1, 0, 0, 0, 1, 0, 0, 1, 0, 0, 1, 1]",130,70,60,8,3,0.11428571428571428,0.05
"[1, 0, 1, 1, 1, 0, 1, 1, 0, 0, 0, 1, 1, 1, 1]",345,127,218,15,24,0.11811023622047244,0.11009174311926606
"[1, 0, 0, 1, 0, 1, 0, 0, 1, 0, 0, 0, 0, 0, 0]",605,403,202,38,21,0.09429280397022333,0.10396039603960396
"[1, 0, 1, 1, 1, 0, 1, 1, 1, 1, 0, 0, 0, 0, 1]",252,107,145,6,11,0.056074766355140186,0.07586206896551724
"[0, 1, 0, 0, 0, 1, 0, 1, 1, 1, 1, 0, 0, 1, 1]",177,85,92,7,5,0.08235294117647059,0.05434782608695652
"[0, 0, 1, 0, 0, 0, 1, 0, 1, 1, 1, 1, 0, 0, 1]",135,63,72,11,7,0.1746031746031746,0.09722222222222222
"[1, 0, 0, 0, 0, 0, 1, 1, 1, 1, 0, 1, 1, 1, 0]",150,66,84,3,6,0.045454545454545456,0.07142857142857142
"[1, 1, 0, 1, 1, 0, 0, 1, 1, 1, 1, 0, 0, 0, 1]",224,92,132,8,18,0.08695652173913043,0.13636363636363635
"[0, 1, 0, 1, 0, 1, 0, 0, 0, 1, 0, 1, 1, 1, 1]",140,66,74,10,6,0.15151515151515152,0.08108108108108109
"[1, 1, 0, 1, 0, 0, 0, 0, 1, 1, 0, 0, 1, 1, 1]",349,163,186,16,12,0.09815950920245399,0.06451612903225806
"[0, 0, 0, 0, 0, 0, 1, 1, 0, 1, 0, 0, 0, 0, 1]",704,490,214,51,22,0.10408163265306122,0.102803738317757
"[1, 0, 0, 0, 0, 1, 1, 1, 0, 0, 1, 1, 1, 0, 0]",166,70,96,7,11,0.1,0.11458333333333333
"[0, 0, 0, 0, 0, 0, 1, 1, 1, 1, 1, 0, 0, 1, 1]",498,286,212,27,20,0.0944055944055944,0.09433962264150944
"[0, 0, 0, 0, 1, 1, 0, 0, 1, 1, 1, 0, 0, 1, 1]",389,222,167,24,16,0.10810810810810811,0.09580838323353294
"[0, 0, 1, 0, 0, 0, 0, 0, 0, 1, 1, 0, 0, 1, 1]",956,635,321,68,30,0.10708661417322834,0.09345794392523364
"[0, 1, 0, 0, 1, 1, 0, 0, 0, 0, 1, 1, 0, 1, 1]",155,94,61,8,11,0.0851063829787234,0.18032786885245902
"[1, 0, 1, 0, 1, 1, 0, 1, 0, 0, 0, 0, 0, 0, 1]",169,96,73,11,3,0.11458333333333333,0.0410958904109589
"[0, 0, 1, 0, 0, 0, 0, 0, 0, 1, 0, 1, 1, 0, 1]",242,148,94,13,8,0.08783783783783784,0.0851063829787234
"[0, 1, 0, 0, 1, 1, 1, 0, 0, 0, 0, 0, 1, 0, 0]",263,170,93,23,5,0.13529411764705881,0.053763440860215055
"[1, 0, 0, 0, 0, 1, 0, 0, 0, 0, 1, 0, 0, 1, 1]",319,190,129,23,18,0.12105263157894737,0.13953488372093023
"[1, 0, 0, 1, 0, 1, 0, 0, 0, 1, 1, 0, 0, 1, 0]",125,75,50,13,4,0.17333333333333334,0.08
"[0, 1, 0, 0, 1, 0, 1, 0, 0, 0, 1, 1, 0, 0, 1]",192,108,84,9,5,0.08333333333333333,0.05952380952380952
"[0, 1, 0, 1, 0, 1, 0, 1, 0, 1, 1, 1, 1, 1, 1]",295,88,207,6,21,0.06818181818181818,0.10144927536231885
"[1, 0, 0, 1, 0, 1, 1, 0, 0, 1, 0, 1, 0, 1, 0]",105,59,46,4,3,0.06779661016949153,0.06521739130434782
"[1, 0, 0, 0, 1, 0, 1, 0, 1, 0, 1, 0, 0, 1, 0]",123,62,61,3,10,0.04838709677419355,0.16393442622950818
"[1, 0, 1, 0, 1, 0, 0, 0, 1, 0, 1, 0, 1, 0, 1]",85,46,39,6,5,0.13043478260869565,0.1282051282051282
"[0, 1, 1, 1, 1, 0, 1, 1, 1, 0, 1, 0, 1, 0, 0]",147,70,77,8,13,0.11428571428571428,0.16883116883116883
"[0, 0, 0, 0, 1, 1, 0, 0, 0, 0, 1, 0, 1, 0, 1]",424,282,142,22,15,0.07801418439716312,0.1056338028169014
"[0, 1, 1, 0, 1, 1, 0, 1, 0, 1, 0, 1, 1, 0, 1]",104,48,56,2,4,0.041666666666666664,0.07142857142857142
"[0, 0, 0, 1, 1, 0, 1, 1, 0, 1, 0, 1, 0, 1, 1]",131,69,62,8,5,0.11594202898550725,0.08064516129032258
"[0, 0, 1, 1, 0, 1, 1, 0, 0, 0, 0, 1, 1, 1, 1]",362,173,189,23,18,0.1329479768786127,0.09523809523809523
"[0, 0, 1, 1, 1, 0, 1, 1, 0, 1, 0, 0, 0, 0, 1]",145,82,63,7,5,0.08536585365853659,0.07936507936507936
"[0, 0, 0, 0, 1, 1, 1, 0, 1, 1, 0, 1, 0, 0, 0]",165,95,70,7,6,0.07368421052631578,0.08571428571428572
"[0, 0, 0, 1, 0, 0, 0, 0, 1, 1, 1, 0, 1, 1, 0]",153,81,72,8,8,0.09876543209876543,0.1111111111111111
"[1, 1, 0, 1, 0, 0, 1, 0, 0, 0, 1, 0, 1, 0, 0]",150,80,70,8,8,0.1,0.11428571428571428
"[1, 0, 1, 1, 1, 1, 1, 0, 1, 0, 0, 1, 1, 1, 1]",707,186,521,15,49,0.08064516129032258,0.09404990403071017
"[1, 1, 1, 0, 0, 1, 1, 1, 1, 1, 0, 1, 0, 1, 1]",846,201,645,31,57,0.15422885572139303,0.08837209302325581
"[1, 1, 1, 1, 1, 1, 0, 0, 0, 0, 1, 0, 0, 0, 0]",255,132,123,11,14,0.08333333333333333,0.11382113821138211
"[1, 1, 0, 0, 0, 0, 1, 1, 1, 0, 0, 1, 1, 1, 1]",430,202,228,27,20,0.13366336633663367,0.08771929824561403
"[1, 1, 0, 1, 0, 0, 1, 0, 1, 1, 0, 0, 0, 0, 0]",186,111,75,12,9,0.10810810810810811,0.12
"[1, 0, 1, 1, 0, 1, 0, 0, 1, 0, 1, 1, 0, 0, 0]",141,76,65,7,6,0.09210526315789473,0.09230769230769231
"[1, 0, 1, 1, 1, 1, 1, 0, 1, 1, 0, 1, 0, 0, 1]",206,68,138,9,11,0.1323529411764706,0.07971014492753623
"[1, 0, 1, 1, 0, 1, 0, 1, 0, 1, 1, 1, 1, 1, 0]",234,100,134,6,17,0.06,0.12686567164179105
"[0, 1, 0, 1, 1, 0, 1, 0, 1, 0, 1, 1, 1, 1, 1]",289,96,193,11,7,0.11458333333333333,0.03626943005181347
"[0, 1, 1, 1, 0, 0, 0, 1, 0, 1, 0, 1, 0, 0, 1]",129,69,60,6,10,0.08695652173913043,0.16666666666666666
"[0, 0, 0, 1, 0, 1, 1, 0, 0, 0, 0, 0, 1, 1, 1]",341,218,123,19,11,0.0871559633027523,0.08943089430894309
"[0, 0, 1, 0, 1, 1, 1, 0, 1, 1, 0, 0, 0, 0, 0]",188,108,80,8,6,0.07407407407407407,0.075
"[0, 1, 1, 1, 0, 1, 0, 0, 0, 0, 1, 0, 1, 0, 1]",103,49,54,3,4,0.061224489795918366,0.07407407407407407
"[1, 0, 0, 1, 1, 0, 0, 0, 0, 0, 1, 0, 0, 0, 0]",742,417,325,43,24,0.10311750599520383,0.07384615384615385
"[0, 1, 1, 0, 1, 1, 1, 0, 0, 0, 1, 0, 0, 0, 0]",154,100,54,5,3,0.05,0.05555555555555555
"[0, 1, 0, 1, 1, 0, 1, 1, 1, 0, 0, 0, 1, 0, 0]",110,57,53,5,2,0.08771929824561403,0.03773584905660377
"[1, 0, 1, 0, 1, 1, 1, 1, 1, 0, 1, 0, 1, 1, 0]",184,62,122,4,6,0.06451612903225806,0.04918032786885246
"[0, 1, 1, 1, 1, 1, 1, 0, 0, 1, 1, 1, 1, 0, 1]",1065,542,523,46,50,0.08487084870848709,0.09560229445506692
"[0, 0, 1, 0, 1, 1, 0, 1, 1, 1, 1, 1, 1, 0, 0]",233,106,127,12,13,0.11320754716981132,0.10236220472440945
"[1, 0, 1, 1, 1, 0, 0, 1, 1, 0, 1, 1, 1, 1, 0]",248,85,163,9,11,0.10588235294117647,0.06748466257668712
"[0, 0, 0, 1, 1, 1, 1, 1, 1, 0, 1, 0, 1, 1, 1]",479,285,194,27,20,0.09473684210526316,0.10309278350515463
"[0, 1, 1, 0, 0, 1, 1, 0, 0, 1, 1, 1, 1, 0, 1]",423,298,125,35,12,0.1174496644295302,0.096
"[1, 1, 0, 0, 1, 1, 1, 0, 0, 1, 0, 0, 0, 0, 1]",171,85,86,10,11,0.11764705882352941,0.12790697674418605
"[1, 1, 0, 0, 0, 0, 0, 1, 0, 0, 0, 1, 1, 1, 0]",158,105,53,7,6,0.06666666666666667,0.11320754716981132
"[1, 0, 1, 1, 1, 1, 1, 0, 0, 0, 0, 1, 0, 0, 0]",146,71,75,3,5,0.04225352112676056,0.06666666666666667
"[1, 0, 1, 1, 1, 1, 1, 0, 1, 0, 0, 0, 0, 0, 1]",138,55,83,4,10,0.07272727272727272,0.12048192771084337
"[1, 1, 1, 0, 0, 0, 0, 0, 1, 1, 0, 0, 0, 0, 1]",367,173,194,15,24,0.08670520231213873,0.12371134020618557
"[0, 1, 1, 1, 1, 0, 0, 0, 0, 0, 1, 1, 0, 0, 0]",388,256,132,25,13,0.09765625,0.09848484848484848
"[0, 0, 0, 0, 1, 0, 0, 1, 1, 1, 1, 0, 0, 0, 0]",661,456,205,36,19,0.07894736842105263,0.09268292682926829
"[0, 0, 0, 0, 0, 0, 1, 0, 0, 1, 1, 1, 1, 0, 0]",586,401,185,32,7,0.0798004987531172,0.03783783783783784
"[0, 1, 0, 0, 0, 1, 0, 0, 0, 0, 0, 0, 1, 0, 0]",1589,1253,336,111,34,0.08858739026336791,0.10119047619047619
"[1, 0, 0, 0, 0, 0, 1, 1, 0, 0, 0, 1, 1, 1, 1]",261,128,133,14,13,0.109375,0.09774436090225563
"[1, 0, 1, 1, 1, 0, 0, 0, 0, 1, 1, 0, 1, 1, 0]",132,60,72,8,6,0.13333333333333333,0.08333333333333333
"[0, 1, 0, 1, 0, 1, 1, 1, 0, 0, 0, 0, 1, 1, 1]",234,115,119,11,7,0.09565217391304348,0.058823529411764705
"[1, 1, 0, 0, 0, 0, 0, 0, 1, 1, 1, 1, 1, 0, 1]",385,149,236,13,18,0.087248322147651,0.07627118644067797
"[1, 0, 0, 1, 1, 0, 0, 0, 0, 0, 1, 1, 0, 0, 1]",283,134,149,12,15,0.08955223880597014,0.10067114093959731
"[1, 1, 1, 1, 1, 0, 1, 0, 0, 1, 0, 0, 1, 0, 1]",148,56,92,5,12,0.08928571428571429,0.13043478260869565
"[0, 0, 0, 0, 0, 0, 1, 1, 1, 0, 0, 1, 1, 0, 0]",539,352,187,34,19,0.09659090909090909,0.10160427807486631
"[0, 1, 1, 1, 0, 1, 1, 0, 0, 1, 1, 0, 0, 1, 1]",329,130,199,16,17,0.12307692307692308,0.08542713567839195
"[0, 1, 1, 1, 0, 0, 0, 0, 0, 1, 0, 0, 1, 1, 0]",199,111,88,7,8,0.06306306306306306,0.09090909090909091
"[0, 0, 1, 0, 1, 1, 1, 1, 0, 0, 1, 1, 1, 0, 0]",148,66,82,4,5,0.06060606060606061,0.06097560975609756
"[0, 0, 1, 0, 0, 0, 0, 1, 1, 1, 1, 0, 0, 1, 1]",466,262,204,23,20,0.08778625954198473,0.09803921568627451
"[0, 0, 1, 0, 1, 1, 0, 0, 1, 1, 1, 0, 0, 1, 1]",174,88,86,11,7,0.125,0.08139534883720931
"[0, 1, 1, 1, 0, 1, 1, 1, 0, 1, 0, 1, 0, 0, 0]",119,63,56,6,11,0.09523809523809523,0.19642857142857142
"[0, 1, 0, 1, 1, 1, 1, 0, 0, 1, 1, 0, 0, 1, 0]",141,68,73,10,7,0.14705882352941177,0.0958904109589041
"[1, 0, 1, 1, 1, 1, 0, 1, 0, 1, 1, 1, 1, 0, 0]",297,110,187,13,19,0.11818181818181818,0.10160427807486631
"[1, 0, 1, 0, 1, 1, 1, 0, 1, 1, 1, 1, 0, 1, 0]",227,75,152,6,14,0.08,0.09210526315789473
"[1, 1, 1, 0, 1, 1, 1, 0, 1, 0, 1, 1, 1, 0, 1]",472,119,353,14,42,0.11764705882352941,0.11898016997167139
"[1, 1, 0, 0, 1, 1, 0, 0, 1, 0, 1, 0, 1, 1, 1]",283,119,164,6,13,0.05042016806722689,0.07926829268292683
"[0, 1, 1, 1, 1, 1, 1, 1, 0, 0, 0, 0, 0, 0, 0]",562,315,247,38,17,0.12063492063492064,0.06882591093117409
"[1, 1, 1, 1, 0, 0, 0, 1, 1, 1, 1, 1, 0, 1, 1]",691,206,485,20,56,0.0970873786407767,0.1154639175257732
"[0, 1, 0, 0, 0, 1, 1, 0, 1, 0, 1, 0, 1, 0, 0]",128,78,50,4,4,0.05128205128205128,0.08
"[0, 1, 1, 1, 1, 0, 0, 1, 0, 0, 0, 0, 1, 1, 0]",178,105,73,8,8,0.0761904761904762,0.1095890410958904
"[1, 0, 0, 1, 0, 1, 0, 1, 1, 0, 0, 1, 1, 1, 1]",281,100,181,13,22,0.13,0.12154696132596685
"[0, 1, 0, 1, 0, 0, 1, 0, 1, 0, 0, 1, 0, 1, 0]",115,74,41,6,4,0.08108108108108109,0.0975609756097561
"[1, 1, 1, 1, 1, 0, 0, 1, 1, 1, 0, 1, 0, 0, 1]",339,90,249,7,28,0.07777777777777778,0.11244979919678715
"[1, 1, 0, 1, 0, 0, 0, 1, 0, 1, 0, 0, 0, 1, 0]",129,73,56,8,5,0.1095890410958904,0.08928571428571429
"[1, 0, 1, 1, 1, 1, 1, 1, 0, 1, 0, 1, 1, 0, 0]",277,104,173,13,21,0.125,0.12138728323699421
"[0, 1, 1, 0, 1, 1, 0, 0, 0, 0, 0, 0, 0, 1, 0]",241,155,86,14,7,0.09032258064516129,0.08139534883720931
"[1, 1, 1, 1, 0, 0, 0, 1, 0, 1, 0, 0, 0, 0, 1]",166,95,71,10,7,0.10526315789473684,0.09859154929577464
"[1, 1, 0, 1, 1, 1, 0, 1, 1, 1, 0, 0, 0, 0, 0]",157,64,93,5,4,0.078125,0.043010752688172046
"[1, 1, 0, 1, 1, 0, 1, 1, 0, 1, 1, 1, 0, 1, 1]",491,136,355,13,41,0.09558823529411764,0.11549295774647887
"[1, 0, 0, 0, 1, 0, 0, 1, 1, 0, 0, 1, 0, 0, 1]",138,79,59,6,2,0.0759493670886076,0.03389830508474576
"[1, 0, 0, 0, 0, 1, 1, 1, 0, 0, 0, 1, 0, 0, 1]",160,82,78,11,11,0.13414634146341464,0.14102564102564102
"[1, 0, 1, 0, 0, 0, 0, 1, 1, 1, 0, 0, 0, 1, 0]",146,88,58,8,5,0.09090909090909091,0.08620689655172414
"[0, 1, 0, 1, 0, 0, 0, 0, 1, 1, 1, 0, 0, 0, 1]",174,99,75,11,6,0.1111111111111111,0.08
"[1, 0, 1, 0, 1, 0, 0, 0, 0, 1, 1, 1, 0, 0, 0]",191,102,89,16,6,0.1568627450980392,0.06741573033707865
"[1, 0, 1, 0, 1, 0, 1, 1, 0, 1, 1, 1, 0, 1, 1]",199,54,145,6,12,0.1111111111111111,0.08275862068965517
"[0, 1, 0, 1, 0, 1, 0, 1, 0, 1, 1, 0, 0, 1, 0]",96,52,44,2,4,0.038461538461538464,0.09090909090909091
"[1, 1, 0, 0, 0, 1, 1, 0, 0, 0, 0, 0, 1, 1, 1]",282,144,138,18,14,0.125,0.10144927536231885
"[1, 1, 0, 1, 1, 0, 1, 0, 1, 1, 0, 1, 0, 0, 1]",143,55,88,4,11,0.07272727272727272,0.125
"[0, 1, 1, 1, 0, 0, 0, 1, 1, 1, 1, 1, 1, 0, 0]",380,186,194,19,16,0.10215053763440861,0.08247422680412371
"[1, 1, 0, 1, 1, 0, 0, 1, 1, 1, 0, 1, 1, 1, 1]",653,194,459,22,45,0.1134020618556701,0.09803921568627451
"[0, 1, 1, 1, 1, 0, 1, 1, 0, 0, 1, 1, 1, 0, 1]",243,93,150,6,11,0.06451612903225806,0.07333333333333333
"[1, 1, 1, 1, 1, 1, 0, 1, 0, 1, 1, 1, 0, 0, 0]",335,114,221,11,16,0.09649122807017543,0.07239819004524888
"[1, 1, 0, 1, 1, 1, 0, 1, 0, 1, 0, 0, 1, 1, 1]",294,96,198,14,17,0.14583333333333334,0.08585858585858586
"[1, 1, 1, 1, 0, 1, 1, 0, 1, 0, 0, 0, 0, 1, 0]",109,53,56,6,5,0.11320754716981132,0.08928571428571429
"[1, 1, 1, 1, 1, 0, 1, 1, 0, 1, 0, 0, 0, 0, 1]",204,92,112,6,10,0.06521739130434782,0.08928571428571429
"[0, 1, 1, 1, 1, 1, 1, 0, 1, 1, 0, 1, 0, 0, 0]",179,82,97,7,12,0.08536585365853659,0.12371134020618557
"[0, 0, 0, 1, 1, 1, 1, 1, 1, 0, 1, 1, 0, 1, 0]",195,113,82,13,5,0.11504424778761062,0.06097560975609756
"[1, 0, 1, 0, 0, 1, 1, 0, 0, 0, 1, 1, 1, 1, 0]",123,45,78,4,6,0.08888888888888889,0.07692307692307693
"[0, 0, 1, 0, 1, 1, 0, 1, 0, 0, 1, 1, 0, 0, 0]",196,101,95,12,8,0.1188118811881188,0.08421052631578947
"[0, 1, 0, 0, 1, 1, 0, 1, 0, 1, 1, 1, 1, 0, 0]",154,88,66,11,4,0.125,0.06060606060606061
"[1, 0, 1, 1, 0, 1, 1, 0, 1, 0, 0, 1, 1, 0, 1]",127,57,70,6,3,0.10526315789473684,0.04285714285714286
"[1, 1, 0, 1, 0, 1, 1, 0, 1, 1, 0, 1, 0, 0, 1]",148,55,93,9,13,0.16363636363636364,0.13978494623655913
"[1, 1, 1, 0, 1, 1, 1, 1, 0, 1, 1, 1, 0, 0, 1]",659,192,467,15,37,0.078125,0.07922912205567452
"[0, 1, 1, 1, 0, 1, 0, 1, 1, 1, 0, 0, 0, 0, 1]",161,70,91,8,7,0.11428571428571428,0.07692307692307693
"[1, 1, 0, 1, 1, 1, 0, 1, 0, 1, 1, 1, 0, 0, 0]",181,71,110,2,16,0.028169014084507043,0.14545454545454545
"[1, 0, 1, 1, 1, 0, 1, 1, 1, 0, 0, 1, 1, 1, 1]",800,218,582,24,58,0.11009174311926606,0.09965635738831616
"[1, 1, 1, 1, 1, 0, 1, 1, 0, 1, 0, 0, 1, 1, 0]",275,95,180,8,20,0.08421052631578947,0.1111111111111111
"[1, 0, 1, 0, 1, 1, 1, 1, 0, 0, 0, 0, 1, 1, 1]",411,167,244,21,23,0.12574850299401197,0.0942622950819672
"[0, 0, 1, 0, 1, 0, 1, 1, 1, 1, 0, 0, 0, 0, 1]",190,98,92,7,16,0.07142857142857142,0.17391304347826086
"[1, 1, 1, 0, 1, 1, 1, 1, 0, 0, 0, 1, 0, 1, 0]",156,57,99,3,9,0.05263157894736842,0.09090909090909091
"[0, 0, 1, 1, 0, 1, 1, 0, 1, 0, 0, 1, 1, 0, 1]",121,53,68,5,8,0.09433962264150944,0.11764705882352941
"[1, 0, 0, 0, 0, 1, 1, 0, 1, 1, 1, 0, 1, 1, 1]",219,59,160,4,13,0.06779661016949153,0.08125
"[1, 0, 0, 0, 1, 0, 1, 1, 1, 1, 1, 0, 1, 0, 1]",120,46,74,4,6,0.08695652173913043,0.08108108108108109
"[1, 0, 1, 1, 0, 0, 1, 0, 0, 0, 1, 1, 1, 1, 1]",235,111,124,12,10,0.10810810810810811,0.08064516129032258
"[0, 1, 1, 1, 0, 1, 0, 1, 0, 1, 1, 0, 0, 1, 0]",113,54,59,2,5,0.037037037037037035,0.0847457627118644
"[0, 0, 1, 1, 1, 0, 1, 1, 1, 1, 1, 1, 1, 0, 0]",415,155,260,12,26,0.07741935483870968,0.1
"[1, 1, 0, 1, 1, 0, 1, 1, 0, 0, 0, 1, 1, 1, 0]",127,59,68,5,5,0.0847457627118644,0.07352941176470588
"[1, 1, 1, 1, 0, 1, 1, 1, 1, 1, 1, 0, 0, 0, 1]",672,179,493,19,45,0.10614525139664804,0.09127789046653144
"[0, 1, 0, 0, 0, 0, 1, 1, 0, 1, 0, 0, 1, 0, 0]",258,161,97,11,13,0.06832298136645963,0.13402061855670103
"[1, 1, 1, 1, 1, 0, 0, 1, 0, 0, 0, 0, 1, 1, 0]",190,98,92,11,9,0.11224489795918367,0.09782608695652174
"[0, 1, 1, 0, 0, 1, 0, 1, 1, 0, 0, 1, 1, 1, 1]",262,132,130,14,15,0.10606060606060606,0.11538461538461539
"[1, 1, 0, 1, 0, 1, 0, 1, 0, 1, 1, 0, 1, 0, 0]",110,44,66,9,4,0.20454545454545456,0.06060606060606061
"[0, 0, 1, 0, 1, 1, 0, 1, 0, 1, 0, 1, 0, 1, 1]",98,47,51,0,4,0.0,0.0784313725490196
"[1, 0, 0, 1, 0, 1, 1, 1, 1, 0, 0, 1, 0, 1, 0]",117,62,55,4,12,0.06451612903225806,0.21818181818181817
"[1, 1, 0, 0, 0, 1, 0, 0, 0, 0, 0, 0, 1, 1, 0]",386,230,156,28,17,0.12173913043478261,0.10897435897435898
"[0, 0, 0, 1, 1, 1, 0, 1, 1, 0, 0, 0, 0, 0, 0]",387,263,124,23,11,0.08745247148288973,0.08870967741935484
"[1, 1, 1, 1, 0, 1, 0, 1, 0, 0, 1, 1, 1, 0, 0]",162,69,93,7,9,0.10144927536231885,0.0967741935483871
"[0, 1, 0, 1, 0, 0, 0, 0, 0, 0, 0, 0, 0, 1, 0]",1628,1228,400,109,40,0.08876221498371335,0.1
"[0, 0, 0, 0, 0, 0, 1, 0, 1, 1, 0, 1, 0, 1, 0]",251,159,92,16,5,0.10062893081761007,0.05434782608695652
"[0, 1, 0, 0, 0, 1, 0, 1, 1, 1, 1, 1, 0, 0, 1]",125,57,68,7,4,0.12280701754385964,0.058823529411764705
"[1, 0, 0, 0, 1, 1, 0, 1, 0, 1, 0, 0, 0, 1, 0]",109,61,48,1,4,0.01639344262295082,0.08333333333333333
"[0, 0, 0, 1, 0, 0, 0, 0, 1, 0, 0, 1, 0, 1, 1]",279,189,90,16,9,0.08465608465608465,0.1
"[0, 1, 0, 0, 1, 1, 0, 0, 0, 0, 0, 1, 1, 1, 1]",259,139,120,12,12,0.08633093525179857,0.1
"[1, 0, 1, 1, 1, 1, 0, 1, 0, 0, 1, 1, 0, 1, 1]",247,95,152,8,16,0.08421052631578947,0.10526315789473684
"[0, 1, 0, 1, 1, 0, 1, 0, 1, 0, 1, 1, 1, 1, 0]",144,61,83,5,7,0.08196721311475409,0.08433734939759036
"[1, 1, 0, 1, 0, 1, 0, 1, 0, 1, 1, 1, 0, 0, 1]",159,72,87,7,8,0.09722222222222222,0.09195402298850575
"[0, 1, 1, 0, 1, 0, 1, 0, 1, 0, 1, 1, 1, 0, 0]",137,68,69,7,11,0.10294117647058823,0.15942028985507245
"[1, 1, 0, 0, 1, 1, 1, 0, 1, 1, 0, 1, 0, 1, 1]",299,95,204,9,16,0.09473684210526316,0.0784313725490196
"[1, 1, 1, 1, 0, 0, 1, 1, 1, 0, 1, 1, 0, 1, 0]",295,102,193,11,16,0.10784313725490197,0.08290155440414508
"[0, 0, 1, 1, 0, 0, 0, 0, 1, 0, 0, 1, 1, 0, 1]",187,110,77,10,7,0.09090909090909091,0.09090909090909091
"[1, 0, 1, 0, 0, 1, 0, 0, 1, 1, 0, 0, 1, 1, 1]",205,98,107,12,10,0.12244897959183673,0.09345794392523364
"[1, 1, 1, 1, 1, 1, 0, 1, 1, 0, 1, 0, 0, 1, 0]",242,101,141,11,15,0.10891089108910891,0.10638297872340426
"[0, 1, 1, 1, 1, 1, 1, 0, 1, 0, 0, 1, 1, 1, 0]",246,98,148,7,19,0.07142857142857142,0.12837837837837837
"[0, 1, 0, 0, 1, 1, 1, 1, 1, 0, 0, 1, 1, 1, 0]",162,61,101,5,5,0.08196721311475409,0.04950495049504951
"[0, 1, 0, 1, 0, 1, 0, 0, 1, 0, 1, 0, 0, 1, 1]",128,73,55,8,4,0.1095890410958904,0.07272727272727272
"[1, 1, 1, 1, 1, 1, 0, 1, 0, 0, 0, 0, 0, 0, 1]",232,96,136,8,14,0.08333333333333333,0.10294117647058823
"[0, 0, 0, 1, 0, 1, 1, 1, 0, 0, 1, 1, 1, 1, 1]",267,122,145,10,16,0.08196721311475409,0.1103448275862069
"[0, 0, 0, 0, 0, 1, 0, 0, 0, 0, 1, 0, 1, 1, 1]",556,415,141,42,18,0.10120481927710843,0.1276595744680851
"[0, 0, 0, 0, 0, 0, 1, 0, 0, 0, 0, 1, 0, 1, 1]",780,586,194,39,22,0.06655290102389079,0.1134020618556701
"[1, 1, 1, 0, 0, 1, 0, 0, 1, 1, 1, 1, 0, 0, 1]",285,104,181,13,14,0.125,0.07734806629834254
"[1, 1, 1, 1, 1, 1, 0, 0, 1, 0, 0, 1, 1, 1, 1]",1073,292,781,23,73,0.07876712328767123,0.09346991037131883
"[0, 1, 0, 1, 0, 0, 1, 1, 1, 1, 0, 1, 1, 1, 0]",149,69,80,8,10,0.11594202898550725,0.125
"[1, 1, 1, 0, 1, 1, 1, 0, 0, 1, 1, 1, 1, 0, 0]",602,195,407,20,48,0.10256410256410256,0.11793611793611794
"[1, 1, 1, 1, 0, 1, 1, 1, 0, 0, 1, 1, 1, 1, 0]",790,228,562,21,53,0.09210526315789473,0.09430604982206406
"[1, 0, 1, 0, 0, 0, 1, 0, 1, 1, 1, 0, 1, 0, 0]",96,54,42,6,5,0.1111111111111111,0.11904761904761904
"[1, 1, 0, 1, 0, 0, 0, 0, 0, 1, 1, 1, 1, 0, 0]",278,144,134,13,7,0.09027777777777778,0.05223880597014925
"[1, 1, 0, 1, 1, 0, 0, 0, 0, 0, 1, 1, 0, 0, 0]",283,166,117,12,11,0.07228915662650602,0.09401709401709402
"[1, 1, 0, 1, 0, 0, 1, 0, 0, 0, 0, 0, 0, 1, 1]",255,139,116,17,15,0.1223021582733813,0.12931034482758622
"[0, 1, 0, 1, 0, 1, 0, 0, 0, 0, 1, 0, 1, 1, 1]",157,78,79,8,6,0.10256410256410256,0.0759493670886076
"[0, 0, 0, 0, 1, 1, 0, 1, 1, 0, 0, 0, 1, 1, 0]",213,116,97,9,6,0.07758620689655173,0.061855670103092786
"[0, 1, 0, 1, 1, 1, 1, 1, 0, 0, 1, 0, 0, 1, 1]",146,63,83,5,8,0.07936507936507936,0.0963855421686747
"[1, 1, 1, 0, 0, 1, 1, 1, 0, 0, 1, 1, 0, 0, 0]",236,89,147,6,16,0.06741573033707865,0.10884353741496598
"[1, 0, 0, 0, 1, 1, 1, 1, 1, 0, 0, 1, 1, 1, 1]",522,188,334,14,30,0.07446808510638298,0.08982035928143713
"[0, 1, 1, 1, 1, 1, 0, 1, 1, 1, 0, 1, 1, 0, 1]",525,169,356,21,34,0.1242603550295858,0.09550561797752809
"[0, 1, 0, 1, 1, 0, 1, 1, 1, 1, 1, 0, 1, 1, 0]",208,68,140,4,11,0.058823529411764705,0.07857142857142857
"[0, 1, 0, 0, 0, 0, 0, 1, 1, 1, 0, 0, 1, 0, 0]",262,149,113,18,10,0.12080536912751678,0.08849557522123894
"[0, 0, 1, 1, 0, 1, 1, 1, 0, 0, 1, 0, 0, 1, 1]",122,58,64,10,7,0.1724137931034483,0.109375
"[1, 1, 0, 0, 1, 1, 0, 0, 1, 1, 0, 1, 1, 1, 0]",263,113,150,11,12,0.09734513274336283,0.08
"[1, 1, 0, 1, 1, 1, 1, 0, 1, 1, 1, 1, 0, 1, 1]",1520,352,1168,33,111,0.09375,0.09503424657534247
"[1, 0, 0, 1, 0, 0, 1, 1, 0, 1, 1, 1, 1, 0, 1]",157,70,87,7,4,0.1,0.04597701149425287
"[1, 0, 1, 1, 1, 0, 1, 0, 0, 0, 0, 1, 1, 1, 1]",259,98,161,10,11,0.10204081632653061,0.06832298136645963
"[0, 1, 1, 1, 0, 1, 0, 1, 1, 1, 1, 0, 1, 1, 1]",534,160,374,18,43,0.1125,0.11497326203208556
"[1, 0, 0, 1, 1, 1, 0, 1, 1, 1, 1, 0, 1, 0, 1]",227,66,161,5,19,0.07575757575757576,0.11801242236024845
"[0, 1, 1, 1, 1, 0, 0, 1, 1, 0, 1, 1, 0, 0, 0]",200,109,91,6,7,0.05504587155963303,0.07692307692307693
"[1, 0, 1, 0, 1, 1, 0, 0, 0, 1, 1, 1, 0, 1, 1]",161,64,97,4,9,0.0625,0.09278350515463918
"[1, 1, 0, 0, 0, 0, 0, 0, 0, 0, 0, 1, 1, 0, 1]",467,281,186,25,10,0.08896797153024912,0.053763440860215055
"[0, 0, 1, 0, 0, 1, 0, 0, 0, 0, 1, 1, 0, 1, 0]",221,134,87,8,9,0.05970149253731343,0.10344827586206896
"[0, 1, 0, 0, 1, 1, 0, 0, 1, 0, 1, 1, 0, 0, 0]",161,94,67,8,7,0.0851063829787234,0.1044776119402985
"[1, 1, 0, 0, 0, 0, 1, 0, 1, 0, 1, 1, 1, 1, 1]",263,111,152,15,13,0.13513513513513514,0.08552631578947369
"[1, 1, 0, 1, 0, 1, 1, 1, 0, 1, 0, 0, 1, 1, 0]",164,61,103,5,16,0.08196721311475409,0.1553398058252427
"[1, 0, 1, 1, 0, 1, 0, 1, 1, 1, 0, 1, 0, 0, 1]",130,55,75,7,12,0.12727272727272726,0.16
"[1, 1, 0, 1, 0, 1, 1, 0, 1, 0, 1, 1, 1, 0, 1]",197,65,132,8,13,0.12307692307692308,0.09848484848484848
"[0, 0, 1, 0, 0, 1, 0, 0, 1, 0, 0, 1, 1, 1, 1]",199,109,90,7,6,0.06422018348623854,0.06666666666666667
"[0, 1, 1, 1, 0, 0, 1, 0, 1, 1, 1, 1, 1, 0, 1]",227,86,141,11,12,0.12790697674418605,0.0851063829787234
"[0, 0, 1, 1, 1, 0, 1, 1, 1, 1, 0, 0, 1, 1, 1]",442,172,270,19,31,0.11046511627906977,0.11481481481481481
"[0, 1, 0, 1, 0, 0, 1, 1, 0, 1, 0, 0, 1, 1, 1]",137,73,64,7,9,0.0958904109589041,0.140625
"[0, 1, 1, 1, 0, 0, 1, 0, 0, 0, 1, 1, 0, 0, 0]",214,117,97,13,8,0.1111111111111111,0.08247422680412371
"[1, 0, 1, 0, 1, 1, 0, 0, 0, 0, 1, 0, 1, 0, 1]",111,65,46,7,3,0.1076923076923077,0.06521739130434782
"[0, 1, 1, 1, 0, 1, 0, 1, 1, 0, 0, 0, 0, 1, 0]",123,70,53,14,5,0.2,0.09433962264150944
"[0, 0, 1, 1, 1, 0, 1, 0, 1, 1, 0, 0, 0, 0, 1]",170,92,78,9,14,0.09782608695652174,0.1794871794871795
"[0, 0, 0, 0, 1, 0, 1, 0, 0, 0, 0, 0, 1, 1, 1]",614,427,187,31,18,0.07259953161592506,0.0962566844919786
"[0, 0, 1, 1, 0, 0, 1, 0, 0, 0, 1, 0, 0, 0, 0]",579,391,188,36,19,0.09207161125319693,0.10106382978723404
"[0, 0, 0, 0, 0, 1, 1, 0, 0, 1, 0, 0, 0, 1, 0]",575,425,150,44,12,0.10352941176470588,0.08
"[0, 0, 0, 0, 1, 1, 1, 0, 0, 0, 0, 1, 1, 1, 0]",194,121,73,11,3,0.09090909090909091,0.0410958904109589
"[1, 0, 0, 0, 1, 0, 1, 0, 1, 1, 1, 1, 0, 0, 1]",143,64,79,7,5,0.109375,0.06329113924050633
"[0, 1, 0, 1, 1, 1, 0, 1, 0, 0, 0, 0, 1, 1, 0]",135,85,50,10,9,0.11764705882352941,0.18
"[1, 1, 1, 1, 0, 0, 0, 0, 0, 0, 1, 0, 1, 1, 1]",420,200,220,20,25,0.1,0.11363636363636363
"[0, 1, 0, 1, 0, 0, 0, 1, 1, 0, 0, 0, 1, 1, 1]",145,85,60,7,7,0.08235294117647059,0.11666666666666667
"[0, 0, 1, 0, 1, 0, 0, 1, 0, 1, 0, 0, 0, 1, 1]",157,88,69,8,10,0.09090909090909091,0.14492753623188406
"[0, 0, 0, 1, 1, 1, 0, 1, 1, 0, 0, 1, 0, 0, 1]",121,71,50,8,7,0.11267605633802817,0.14
"[0, 1, 1, 0, 0, 1, 1, 1, 0, 1, 1, 0, 0, 0, 0]",193,108,85,9,9,0.08333333333333333,0.10588235294117647
"[0, 0, 0, 0, 1, 1, 0, 1, 1, 0, 0, 0, 1, 0, 0]",284,168,116,13,12,0.07738095238095238,0.10344827586206896
"[0, 1, 1, 0, 1, 1, 0, 1, 0, 0, 1, 1, 1, 0, 0]",119,44,75,6,4,0.13636363636363635,0.05333333333333334
"[0, 0, 0, 0, 1, 1, 0, 1, 0, 1, 1, 0, 1, 1, 0]",125,70,55,9,9,0.12857142857142856,0.16363636363636364
"[1, 1, 1, 0, 1, 0, 1, 1, 0, 1, 0, 0, 1, 1, 0]",129,49,80,7,9,0.14285714285714285,0.1125
"[1, 1, 0, 0, 0, 0, 1, 0, 0, 1, 1, 0, 0, 0, 0]",450,268,182,14,13,0.05223880597014925,0.07142857142857142
"[1, 1, 0, 1, 0, 1, 1, 1, 0, 1, 0, 1, 1, 1, 0]",230,77,153,6,19,0.07792207792207792,0.12418300653594772
"[0, 1, 1, 0, 0, 1, 0, 1, 1, 1, 1, 0, 0, 1, 0]",112,55,57,5,4,0.09090909090909091,0.07017543859649122
"[1, 0, 1, 1, 1, 0, 0, 0, 0, 0, 1, 1, 0, 0, 0]",215,121,94,9,9,0.0743801652892562,0.09574468085106383
"[0, 1, 1, 1, 0, 0, 0, 0, 0, 0, 0, 1, 0, 1, 1]",213,129,84,14,6,0.10852713178294573,0.07142857142857142
"[1, 0, 0, 0, 0, 0, 1, 0, 0, 0, 1, 1, 0, 0, 0]",682,474,208,42,14,0.08860759493670886,0.0673076923076923
"[0, 0, 0, 1, 0, 0, 1, 0, 0, 0, 0, 0, 1, 0, 0]",1514,1170,344,109,36,0.09316239316239316,0.10465116279069768
"[1, 1, 1, 0, 1, 0, 0, 0, 1, 0, 0, 0, 0, 0, 0]",320,178,142,17,16,0.09550561797752809,0.11267605633802817
"[1, 0, 0, 1, 0, 0, 0, 1, 0, 1, 1, 0, 0, 0, 1]",163,90,73,11,10,0.12222222222222222,0.136986301369863
"[0, 0, 1, 1, 0, 1, 0, 1, 0, 0, 1, 1, 1, 1, 1]",277,113,164,13,21,0.11504424778761062,0.12804878048780488
"[0, 1, 0, 1, 0, 0, 0, 1, 0, 0, 1, 0, 1, 0, 0]",257,157,100,14,11,0.08917197452229299,0.11
"[0, 1, 1, 0, 1, 0, 1, 0, 1, 0, 1, 1, 0, 0, 0]",116,55,61,2,7,0.03636363636363636,0.11475409836065574
"[1, 0, 1, 1, 0, 1, 1, 1, 1, 0, 1, 1, 0, 0, 0]",182,71,111,10,6,0.14084507042253522,0.05405405405405406
"[0, 1, 0, 1, 0, 0, 0, 0, 1, 1, 1, 0, 1, 1, 1]",158,81,77,7,6,0.08641975308641975,0.07792207792207792
"[1, 0, 1, 0, 1, 0, 0, 0, 0, 1, 1, 1, 0, 1, 1]",120,52,68,5,9,0.09615384615384616,0.1323529411764706
"[1, 1, 0, 1, 0, 1, 0, 0, 0, 0, 1, 1, 1, 0, 1]",129,60,69,4,7,0.06666666666666667,0.10144927536231885
"[1, 0, 0, 1, 1, 1, 1, 0, 1, 0, 1, 0, 0, 0, 0]",196,77,119,8,12,0.1038961038961039,0.10084033613445378
"[1, 0, 1, 0, 0, 1, 1, 1, 1, 0, 1, 0, 1, 0, 0]",100,38,62,5,3,0.13157894736842105,0.04838709677419355
"[1, 0, 0, 1, 0, 0, 1, 0, 1, 1, 0, 1, 0, 0, 1]",107,50,57,3,2,0.06,0.03508771929824561
"[0, 0, 1, 1, 0, 1, 1, 1, 0, 1, 1, 0, 0, 1, 1]",199,99,100,10,9,0.10101010101010101,0.09
"[1, 0, 0, 0, 1, 1, 0, 1, 0, 1, 1, 1, 1, 0, 1]",145,48,97,5,13,0.10416666666666667,0.13402061855670103
"[1, 1, 1, 0, 0, 0, 1, 1, 0, 1, 0, 1, 1, 1, 1]",328,104,224,7,26,0.0673076923076923,0.11607142857142858
"[0, 1, 0, 1, 1, 1, 1, 0, 1, 1, 1, 1, 1, 0, 1]",531,169,362,24,42,0.14201183431952663,0.11602209944751381
"[1, 1, 0, 0, 1, 1, 1, 1, 1, 0, 0, 0, 0, 1, 1]",493,205,288,20,25,0.0975609756097561,0.08680555555555555
"[1, 0, 0, 1, 1, 1, 1, 1, 1, 0, 1, 1, 0, 1, 0]",295,74,221,6,22,0.08108108108108109,0.09954751131221719
"[1, 1, 1, 0, 1, 0, 0, 1, 0, 0, 1, 1, 0, 0, 1]",151,68,83,5,4,0.07352941176470588,0.04819277108433735
"[1, 1, 1, 1, 0, 0, 0, 0, 1, 1, 0, 0, 0, 1, 0]",322,182,140,24,15,0.13186813186813187,0.10714285714285714
"[1, 1, 1, 1, 0, 0, 1, 0, 1, 1, 1, 0, 1, 1, 0]",264,88,176,8,20,0.09090909090909091,0.11363636363636363
"[0, 1, 1, 0, 1, 0, 1, 1, 1, 1, 1, 0, 0, 1, 0]",151,59,92,7,12,0.11864406779661017,0.13043478260869565
"[1, 0, 1, 0, 0, 0, 0, 1, 1, 0, 1, 1, 1, 1, 1]",208,95,113,12,11,0.12631578947368421,0.09734513274336283
"[1, 0, 1, 0, 1, 0, 1, 1, 1, 0, 1, 0, 1, 0, 0]",107,46,61,9,4,0.1956521739130435,0.06557377049180328
"[1, 0, 1, 1, 0, 1, 0, 1, 0, 1, 1, 1, 0, 1, 0]",134,53,81,6,9,0.11320754716981132,0.1111111111111111
"[1, 1, 0, 0, 0, 0, 1, 1, 0, 0, 1, 0, 1, 1, 0]",185,86,99,7,14,0.08139534883720931,0.1414141414141414
"[0, 0, 1, 1, 1, 0, 0, 0, 0, 1, 1, 0, 0, 1, 0]",214,118,96,9,7,0.07627118644067797,0.07291666666666667
"[1, 0, 0, 1, 0, 0, 1, 0, 0, 0, 1, 1, 1, 0, 0]",161,100,61,5,9,0.05,0.14754098360655737
"[0, 1, 1, 1, 1, 0, 1, 1, 0, 1, 1, 1, 0, 0, 1]",287,96,191,8,22,0.08333333333333333,0.11518324607329843
"[0, 0, 1, 1, 1, 1, 0, 0, 1, 1, 0, 0, 1, 0, 0]",360,215,145,15,15,0.06976744186046512,0.10344827586206896
"[1, 1, 0, 1, 0, 0, 1, 0, 0, 0, 0, 0, 0, 0, 1]",309,185,124,18,14,0.0972972972972973,0.11290322580645161
"[0, 0, 1, 0, 1, 1, 0, 0, 0, 1, 1, 0, 1, 0, 0]",152,85,67,8,3,0.09411764705882353,0.04477611940298507
"[0, 0, 0, 0, 1, 1, 1, 0, 0, 1, 0, 1, 1, 0, 0]",185,112,73,18,6,0.16071428571428573,0.0821917808219178
"[0, 1, 0, 0, 0, 0, 0, 1, 1, 1, 0, 0, 1, 0, 1]",133,78,55,6,2,0.07692307692307693,0.03636363636363636
"[1, 0, 0, 0, 0, 0, 0, 1, 0, 1, 0, 0, 1, 0, 0]",550,353,197,33,15,0.09348441926345609,0.07614213197969544
"[0, 0, 1, 0, 0, 1, 0, 0, 1, 1, 1, 1, 0, 0, 1]",198,106,92,14,7,0.1320754716981132,0.07608695652173914
"[1, 0, 0, 0, 1, 1, 1, 1, 0, 0, 0, 0, 1, 1, 1]",477,193,284,17,32,0.08808290155440414,0.11267605633802817
"[0, 1, 0, 0, 0, 1, 1, 1, 1, 0, 0, 0, 0, 1, 1]",393,224,169,15,22,0.06696428571428571,0.1301775147928994
"[0, 0, 0, 1, 1, 1, 1, 1, 0, 1, 1, 1, 0, 0, 0]",159,86,73,16,6,0.18604651162790697,0.0821917808219178
"[0, 0, 0, 0, 1, 0, 0, 0, 1, 1, 1, 0, 0, 1, 0]",231,157,74,16,5,0.10191082802547771,0.06756756756756757
"[0, 0, 0, 1, 1, 1, 1, 1, 1, 1, 0, 0, 1, 1, 0]",372,201,171,15,16,0.07462686567164178,0.0935672514619883
"[0, 0, 1, 0, 1, 0, 1, 1, 0, 0, 0, 1, 1, 1, 1]",183,91,92,5,13,0.054945054945054944,0.14130434782608695
"[1, 0, 0, 1, 0, 1, 0, 1, 1, 0, 0, 0, 1, 1, 1]",163,73,90,5,9,0.0684931506849315,0.1
"[1, 1, 0, 0, 0, 1, 1, 1, 0, 0, 1, 1, 1, 0, 0]",138,60,78,5,10,0.08333333333333333,0.1282051282051282
"[0, 0, 0, 0, 1, 0, 1, 1, 1, 1, 1, 1, 1, 1, 0]",283,134,149,13,5,0.09701492537313433,0.03355704697986577
"[1, 0, 1, 0, 0, 0, 0, 1, 0, 0, 0, 1, 0, 0, 1]",255,163,92,14,10,0.08588957055214724,0.10869565217391304
"[1, 0, 1, 1, 1, 1, 0, 0, 0, 1, 1, 0, 1, 0, 0]",115,53,62,3,9,0.05660377358490566,0.14516129032258066
"[0, 0, 1, 0, 1, 1, 1, 1, 0, 0, 0, 1, 1, 0, 1]",113,63,50,12,6,0.19047619047619047,0.12
"[1, 1, 1, 1, 1, 1, 1, 1, 0, 0, 0, 1, 0, 1, 0]",409,147,262,15,19,0.10204081632653061,0.07251908396946564
"[1, 1, 1, 0, 1, 1, 1, 1, 1, 0, 0, 0, 1, 1, 1]",718,196,522,19,61,0.09693877551020408,0.11685823754789272
"[1, 1, 0, 1, 1, 1, 1, 1, 1, 0, 0, 0, 0, 0, 0]",516,240,276,23,24,0.09583333333333334,0.08695652173913043
"[1, 0, 1, 0, 0, 1, 0, 0, 1, 1, 1, 0, 1, 0, 0]",121,74,47,8,3,0.10810810810810811,0.06382978723404255
"[1, 0, 0, 1, 1, 1, 1, 0, 0, 0, 0, 0, 1, 1, 1]",483,112,371,9,26,0.08035714285714286,0.07008086253369272
"[0, 1, 1, 0, 0, 0, 1, 1, 0, 0, 0, 0, 0, 1, 0]",253,171,82,14,9,0.08187134502923976,0.10975609756097561
"[0, 0, 1, 0, 0, 0, 0, 0, 1, 1, 0, 0, 1, 1, 0]",554,374,180,40,18,0.10695187165775401,0.1
"[0, 0, 1, 1, 1, 1, 1, 1, 0, 0, 1, 0, 0, 1, 1]",358,143,215,13,22,0.09090909090909091,0.10232558139534884
"[1, 0, 1, 0, 0, 1, 0, 1, 1, 1, 1, 1, 1, 1, 0]",289,107,182,13,20,0.12149532710280374,0.10989010989010989
"[1, 0, 0, 0, 0, 0, 1, 0, 0, 0, 0, 0, 1, 0, 1]",529,357,172,33,11,0.09243697478991597,0.06395348837209303
"[0, 1, 1, 0, 1, 1, 1, 0, 0, 1, 0, 1, 0, 1, 1]",134,55,79,2,8,0.03636363636363636,0.10126582278481013
"[1, 0, 1, 1, 1, 1, 1, 1, 1, 0, 0, 1, 0, 1, 0]",264,105,159,11,17,0.10476190476190476,0.1069182389937107
"[1, 1, 1, 1, 0, 0, 1, 1, 0, 1, 1, 0, 1, 1, 1]",891,273,618,26,45,0.09523809523809523,0.07281553398058252
"[1, 0, 0, 1, 0, 0, 1, 0, 1, 0, 0, 0, 0, 1, 0]",220,133,87,15,7,0.11278195488721804,0.08045977011494253
"[1, 0, 1, 0, 0, 1, 0, 0, 1, 0, 1, 0, 0, 0, 0]",275,168,107,20,6,0.11904761904761904,0.056074766355140186
"[0, 0, 0, 0, 0, 0, 0, 0, 0, 1, 1, 0, 1, 0, 0]",2289,1825,464,182,55,0.09972602739726028,0.11853448275862069
"[1, 0, 0, 1, 0, 0, 1, 1, 0, 0, 0, 0, 0, 0, 1]",419,250,169,26,14,0.104,0.08284023668639054
"[0, 0, 0, 1, 0, 1, 0, 1, 0, 1, 0, 1, 0, 0, 0]",255,166,89,17,11,0.10240963855421686,0.12359550561797752
"[0, 0, 0, 0, 1, 0, 1, 0, 1, 0, 1, 0, 1, 0, 0]",239,163,76,25,5,0.15337423312883436,0.06578947368421052
"[1, 1, 0, 0, 0, 0, 0, 0, 1, 1, 1, 0, 1, 1, 1]",479,228,251,15,23,0.06578947368421052,0.09163346613545817
"[0, 0, 0, 0, 1, 0, 0, 1, 0, 0, 0, 1, 1, 1, 0]",284,181,103,19,11,0.10497237569060773,0.10679611650485436
"[1, 0, 1, 1, 0, 1, 1, 0, 1, 0, 0, 0, 0, 1, 0]",104,61,43,4,2,0.06557377049180328,0.046511627906976744
"[1, 0, 1, 1, 0, 1, 1, 1, 0, 0, 1, 1, 0, 1, 1]",245,89,156,12,20,0.1348314606741573,0.1282051282051282
"[0, 1, 1, 1, 0, 1, 0, 0, 1, 1, 1, 1, 1, 0, 1]",223,84,139,9,8,0.10714285714285714,0.05755395683453238
"[1, 0, 1, 1, 1, 0, 1, 0, 0, 1, 1, 1, 1, 1, 0]",258,97,161,9,6,0.09278350515463918,0.037267080745341616
"[1, 1, 0, 1, 1, 0, 1, 0, 1, 1, 1, 0, 1, 0, 0]",118,45,73,2,7,0.044444444444444446,0.0958904109589041
"[1, 1, 1, 1, 0, 1, 1, 0, 1, 0, 1, 1, 1, 0, 1]",529,152,377,19,29,0.125,0.07692307692307693
"[0, 1, 0, 0, 0, 1, 0, 1, 1, 1, 1, 1, 1, 1, 0]",161,68,93,8,10,0.11764705882352941,0.10752688172043011
"[1, 0, 1, 1, 1, 0, 0, 1, 1, 1, 1, 1, 0, 1, 0]",254,109,145,13,15,0.11926605504587157,0.10344827586206896
"[1, 1, 1, 0, 1, 0, 0, 1, 0, 0, 0, 0, 1, 0, 0]",146,85,61,11,5,0.12941176470588237,0.08196721311475409
"[1, 1, 1, 1, 0, 0, 1, 1, 0, 1, 1, 1, 0, 1, 1]",736,220,516,16,53,0.07272727272727272,0.10271317829457365
"[1, 1, 1, 1, 1, 1, 1, 0, 0, 1, 1, 0, 1, 1, 0]",806,202,604,22,78,0.10891089108910891,0.1291390728476821
"[0, 0, 1, 1, 1, 1, 1, 0, 0, 1, 1, 1, 1, 1, 0]",402,149,253,14,23,0.09395973154362416,0.09090909090909091
"[1, 1, 0, 1, 1, 1, 1, 1, 0, 1, 1, 0, 1, 0, 0]",220,83,137,9,10,0.10843373493975904,0.072992700729927
"[1, 1, 1, 1, 1, 0, 1, 0, 0, 0, 0, 0, 0, 0, 1]",203,101,102,12,8,0.1188118811881188,0.0784313725490196
"[0, 0, 1, 1, 0, 1, 1, 0, 1, 1, 0, 0, 1, 1, 1]",261,114,147,12,10,0.10526315789473684,0.06802721088435375
"[0, 1, 0, 1, 0, 1, 1, 1, 1, 1, 1, 1, 1, 0, 0]",459,174,285,18,18,0.10344827586206896,0.06315789473684211
"[1, 0, 1, 0, 0, 0, 0, 1, 1, 1, 1, 1, 1, 0, 1]",203,79,124,10,9,0.12658227848101267,0.07258064516129033
"[1, 0, 0, 0, 1, 0, 1, 0, 1, 0, 0, 0, 1, 0, 1]",148,89,59,8,4,0.0898876404494382,0.06779661016949153
"[1, 0, 1, 0, 0, 0, 1, 0, 1, 0, 1, 0, 0, 0, 1]",152,91,61,12,4,0.13186813186813187,0.06557377049180328
"[1, 0, 1, 0, 1, 1, 0, 1, 0, 1, 0, 0, 0, 1, 0]",89,45,44,4,4,0.08888888888888889,0.09090909090909091
"[1, 0, 0, 0, 0, 1, 1, 0, 1, 0, 0, 1, 1, 0, 1]",126,63,63,7,4,0.1111111111111111,0.06349206349206349
"[0, 0, 0, 0, 1, 1, 0, 0, 0, 1, 0, 1, 0, 1, 0]",279,178,101,19,6,0.10674157303370786,0.0594059405940594
"[1, 1, 0, 0, 0, 0, 1, 0, 0, 1, 1, 0, 1, 0, 0]",164,89,75,9,6,0.10112359550561797,0.08
"[0, 1, 1, 0, 0, 1, 1, 0, 1, 0, 0, 1, 1, 1, 0]",126,72,54,8,7,0.1111111111111111,0.12962962962962962
"[1, 0, 1, 1, 0, 0, 0, 0, 1, 0, 1, 0, 0, 0, 0]",304,198,106,20,9,0.10101010101010101,0.08490566037735849
"[1, 1, 1, 0, 0, 0, 1, 0, 0, 1, 0, 0, 0, 0, 0]",316,189,127,17,7,0.08994708994708994,0.05511811023622047
"[0, 1, 0, 1, 1, 1, 0, 0, 0, 1, 0, 0, 1, 0, 0]",148,87,61,8,3,0.09195402298850575,0.04918032786885246
"[0, 1, 0, 0, 1, 0, 1, 0, 1, 1, 1, 0, 0, 0, 1]",103,56,47,6,1,0.10714285714285714,0.02127659574468085
"[0, 0, 1, 0, 0, 1, 0, 1, 0, 1, 1, 1, 0, 0, 0]",167,89,78,11,9,0.12359550561797752,0.11538461538461539
"[0, 0, 0, 1, 0, 0, 1, 0, 1, 0, 1, 1, 1, 0, 0]",149,85,64,6,7,0.07058823529411765,0.109375
"[1, 0, 0, 0, 0, 1, 1, 0, 0, 1, 1, 0, 0, 0, 1]",387,125,262,12,26,0.096,0.09923664122137404
"[1, 1, 0, 0, 0, 1, 0, 1, 0, 1, 1, 0, 0, 1, 1]",160,74,86,11,11,0.14864864864864866,0.12790697674418605
"[1, 0, 1, 0, 1, 1, 0, 0, 0, 0, 0, 0, 1, 1, 1]",343,167,176,20,17,0.11976047904191617,0.09659090909090909
"[0, 1, 1, 0, 0, 1, 0, 0, 0, 1, 0, 0, 1, 0, 0]",224,152,72,13,4,0.08552631578947369,0.05555555555555555
"[0, 0, 1, 1, 0, 0, 0, 0, 1, 1, 0, 1, 0, 0, 1]",299,188,111,21,8,0.11170212765957446,0.07207207207207207
"[1, 0, 1, 1, 1, 0, 0, 0, 0, 0, 0, 1, 1, 1, 0]",169,94,75,12,8,0.1276595744680851,0.10666666666666667
"[1, 0, 1, 0, 1, 1, 1, 1, 0, 1, 0, 1, 1, 0, 1]",220,78,142,9,12,0.11538461538461539,0.08450704225352113
"[0, 1, 0, 0, 1, 0, 0, 1, 1, 0, 0, 1, 1, 0, 1]",120,64,56,6,3,0.09375,0.05357142857142857
"[1, 0, 0, 1, 1, 0, 0, 1, 0, 0, 0, 1, 0, 0, 0]",267,153,114,10,15,0.06535947712418301,0.13157894736842105
"[0, 0, 1, 0, 1, 1, 1, 1, 1, 1, 0, 1, 1, 1, 1]",648,196,452,17,45,0.08673469387755102,0.09955752212389381
"[0, 0, 0, 1, 0, 1, 1, 1, 1, 1, 1, 0, 1, 1, 1]",290,110,180,14,12,0.12727272727272726,0.06666666666666667
"[1, 0, 0, 1, 1, 1, 0, 0, 1, 1, 1, 1, 1, 0, 1]",286,110,176,14,16,0.12727272727272726,0.09090909090909091
"[0, 1, 0, 0, 0, 0, 0, 0, 1, 0, 0, 0, 1, 1, 1]",469,319,150,33,14,0.10344827586206896,0.09333333333333334
"[1, 1, 1, 1, 1, 0, 0, 0, 1, 1, 0, 1, 1, 1, 1]",835,201,634,25,54,0.12437810945273632,0.08517350157728706
"[1, 1, 0, 0, 1, 0, 1, 0, 0, 1, 1, 1, 1, 1, 1]",402,128,274,15,27,0.1171875,0.09854014598540146
"[1, 1, 0, 1, 1, 1, 1, 0, 1, 0, 0, 0, 0, 1, 1]",210,87,123,12,13,0.13793103448275862,0.10569105691056911
"[0, 0, 1, 0, 1, 1, 1, 1, 0, 0, 1, 1, 0, 0, 0]",327,179,148,14,8,0.0782122905027933,0.05405405405405406
"[0, 1, 0, 0, 0, 1, 1, 1, 0, 0, 0, 0, 1, 0, 1]",150,83,67,8,3,0.0963855421686747,0.04477611940298507
"[0, 0, 0, 0, 1, 0, 1, 1, 0, 1, 1, 0, 1, 0, 0]",137,78,59,4,4,0.05128205128205128,0.06779661016949153
"[1, 1, 0, 0, 0, 0, 1, 0, 1, 1, 0, 1, 1, 0, 1]",116,48,68,2,8,0.041666666666666664,0.11764705882352941
"[0, 0, 1, 0, 1, 0, 0, 1, 0, 1, 1, 0, 1, 1, 0]",117,59,58,6,10,0.1016949152542373,0.1724137931034483
"[1, 0, 1, 1, 0, 1, 0, 1, 1, 1, 0, 1, 1, 0, 1]",238,81,157,10,13,0.12345679012345678,0.08280254777070063
"[1, 0, 1, 0, 0, 0, 0, 0, 1, 1, 0, 0, 0, 0, 1]",450,285,165,36,16,0.12631578947368421,0.09696969696969697
"[1, 0, 0, 0, 1, 1, 1, 1, 1, 1, 1, 0, 1, 0, 0]",167,71,96,9,5,0.1267605633802817,0.052083333333333336
"[1, 1, 1, 0, 0, 1, 0, 0, 0, 1, 1, 0, 0, 1, 0]",116,57,59,5,8,0.08771929824561403,0.13559322033898305
"[1, 1, 0, 0, 1, 1, 0, 1, 1, 0, 0, 1, 1, 1, 1]",466,167,299,12,29,0.0718562874251497,0.09698996655518395
"[1, 0, 1, 1, 1, 1, 1, 0, 0, 1, 1, 0, 0, 0, 0]",443,206,237,18,19,0.08737864077669903,0.08016877637130802
"[0, 1, 1, 1, 1, 1, 0, 1, 1, 0, 1, 0, 1, 0, 1]",211,90,121,9,13,0.1,0.10743801652892562
"[0, 0, 1, 0, 1, 1, 0, 0, 1, 0, 1, 0, 1, 1, 1]",131,68,63,7,5,0.10294117647058823,0.07936507936507936
"[0, 0, 1, 1, 0, 0, 1, 0, 0, 1, 1, 1, 1, 1, 0]",153,73,80,8,5,0.1095890410958904,0.0625
"[1, 0, 0, 0, 0, 0, 1, 0, 0, 0, 1, 1, 0, 1, 0]",208,118,90,12,3,0.1016949152542373,0.03333333333333333
"[0, 0, 0, 0, 0, 1, 0, 0, 1, 0, 1, 0, 0, 0, 0]",1694,1314,380,127,35,0.09665144596651445,0.09210526315789473
"[0, 0, 0, 1, 1, 0, 0, 0, 0, 0, 1, 0, 0, 1, 1]",528,421,107,40,10,0.09501187648456057,0.09345794392523364
"[1, 0, 0, 0, 1, 1, 1, 1, 0, 0, 0, 1, 0, 1, 0]",107,52,55,3,1,0.057692307692307696,0.01818181818181818
"[0, 1, 0, 0, 0, 1, 1, 1, 1, 0, 0, 0, 1, 0, 1]",108,59,49,7,7,0.11864406779661017,0.14285714285714285
"[0, 0, 1, 0, 0, 1, 0, 0, 0, 0, 1, 0, 1, 0, 0]",480,343,137,31,15,0.09037900874635568,0.10948905109489052
"[1, 0, 0, 1, 0, 0, 1, 0, 1, 1, 1, 0, 0, 1, 1]",159,75,84,10,10,0.13333333333333333,0.11904761904761904
"[0, 0, 0, 1, 1, 0, 1, 0, 0, 1, 1, 1, 0, 0, 1]",127,74,53,7,4,0.0945945945945946,0.07547169811320754
"[0, 1, 0, 0, 0, 0, 0, 0, 0, 1, 0, 0, 0, 1, 1]",722,511,211,40,27,0.07827788649706457,0.12796208530805686
"[0, 1, 1, 0, 0, 0, 1, 1, 0, 1, 1, 0, 0, 0, 1]",130,65,65,2,9,0.03076923076923077,0.13846153846153847
"[1, 1, 1, 0, 1, 1, 0, 0, 0, 1, 1, 0, 1, 1, 0]",136,62,74,3,7,0.04838709677419355,0.0945945945945946
"[1, 0, 0, 0, 1, 1, 0, 1, 1, 1, 0, 0, 1, 1, 1]",218,76,142,9,9,0.11842105263157894,0.06338028169014084
"[0, 0, 1, 0, 1, 0, 0, 0, 1, 0, 0, 0, 1, 1, 0]",272,180,92,12,9,0.06666666666666667,0.09782608695652174
"[0, 1, 0, 0, 0, 0, 1, 0, 1, 1, 1, 1, 1, 0, 0]",151,89,62,11,5,0.12359550561797752,0.08064516129032258
"[1, 1, 1, 0, 1, 0, 0, 0, 1, 0, 0, 1, 0, 0, 0]",122,72,50,12,6,0.16666666666666666,0.12
"[1, 1, 0, 1, 1, 0, 1, 0, 0, 0, 0, 0, 1, 0, 0]",141,89,52,12,4,0.1348314606741573,0.07692307692307693
"[0, 0, 1, 1, 1, 0, 1, 0, 0, 1, 1, 0, 1, 1, 0]",111,55,56,6,2,0.10909090909090909,0.03571428571428571
"[0, 0, 0, 1, 1, 1, 0, 1, 0, 0, 1, 1, 0, 1, 1]",141,74,67,8,6,0.10810810810810811,0.08955223880597014
"[1, 0, 0, 1, 0, 0, 0, 1, 1, 1, 0, 1, 0, 0, 1]",113,61,52,4,1,0.06557377049180328,0.019230769230769232
"[1, 1, 0, 0, 1, 0, 0, 0, 1, 1, 1, 0, 1, 0, 0]",109,55,54,5,3,0.09090909090909091,0.05555555555555555
"[0, 1, 0, 0, 0, 1, 1, 0, 1, 0, 1, 1, 1, 0, 1]",97,43,54,2,3,0.046511627906976744,0.05555555555555555
"[0, 1, 0, 0, 1, 0, 0, 1, 0, 0, 0, 0, 1, 1, 0]",268,173,95,23,6,0.1329479768786127,0.06315789473684211
"[1, 0, 0, 1, 1, 1, 1, 1, 0, 0, 0, 1, 0, 0, 1]",157,71,86,7,6,0.09859154929577464,0.06976744186046512
"[1, 1, 1, 0, 1, 1, 0, 1, 1, 0, 0, 1, 1, 0, 0]",320,106,214,9,20,0.08490566037735849,0.09345794392523364
"[0, 0, 1, 1, 0, 1, 1, 0, 0, 1, 0, 1, 0, 1, 1]",140,76,64,10,4,0.13157894736842105,0.0625
"[0, 1, 1, 0, 1, 0, 1, 0, 0, 1, 1, 0, 1, 1, 0]",121,52,69,7,4,0.1346153846153846,0.057971014492753624
"[1, 1, 1, 0, 0, 1, 1, 1, 1, 0, 1, 0, 0, 1, 1]",411,103,308,5,34,0.04854368932038835,0.11038961038961038
"[1, 0, 0, 0, 0, 1, 0, 1, 1, 1, 0, 1, 1, 1, 1]",216,80,136,8,12,0.1,0.08823529411764706
"[0, 1, 1, 0, 0, 0, 1, 0, 1, 1, 0, 1, 1, 0, 0]",120,75,45,3,6,0.04,0.13333333333333333
"[1, 1, 0, 0, 0, 1, 1, 0, 1, 0, 0, 0, 0, 0, 0]",330,207,123,23,19,0.1111111111111111,0.15447154471544716
"[0, 1, 1, 0, 0, 0, 1, 1, 0, 1, 0, 0, 0, 0, 0]",305,203,102,15,9,0.07389162561576355,0.08823529411764706
"[1, 0, 1, 1, 0, 0, 0, 1, 1, 0, 1, 0, 0, 0, 0]",146,79,67,8,5,0.10126582278481013,0.07462686567164178
"[1, 1, 0, 1, 0, 0, 0, 0, 1, 1, 1, 0, 1, 1, 1]",186,72,114,7,17,0.09722222222222222,0.14912280701754385
"[1, 1, 1, 0, 0, 1, 1, 0, 0, 0, 0, 0, 1, 0, 0]",274,99,175,9,13,0.09090909090909091,0.07428571428571429
"[1, 1, 0, 1, 1, 0, 0, 1, 0, 0, 0, 1, 1, 1, 0]",111,50,61,5,5,0.1,0.08196721311475409
"[0, 1, 0, 1, 0, 1, 0, 1, 0, 1, 1, 0, 1, 1, 0]",105,52,53,9,4,0.17307692307692307,0.07547169811320754
"[0, 1, 0, 1, 1, 0, 1, 1, 0, 1, 0, 1, 0, 1, 0]",98,51,47,1,6,0.0196078431372549,0.1276595744680851
"[1, 1, 0, 0, 1, 1, 0, 1, 1, 0, 1, 0, 1, 1, 0]",119,36,83,5,12,0.1388888888888889,0.14457831325301204
"[1, 0, 0, 0, 1, 1, 0, 1, 1, 0, 0, 1, 1, 0, 0]",204,109,95,9,7,0.08256880733944955,0.07368421052631578
"[1, 0, 0, 0, 0, 1, 0, 1, 1, 0, 0, 0, 1, 1, 0]",162,86,76,11,8,0.12790697674418605,0.10526315789473684
"[1, 0, 0, 0, 1, 0, 0, 0, 1, 1, 1, 0, 1, 0, 0]",114,64,50,5,5,0.078125,0.1
"[1, 0, 1, 1, 1, 0, 0, 1, 0, 1, 1, 1, 0, 0, 1]",186,79,107,5,7,0.06329113924050633,0.06542056074766354
"[0, 1, 0, 1, 1, 0, 0, 1, 0, 0, 1, 0, 1, 1, 1]",126,61,65,5,7,0.08196721311475409,0.1076923076923077
"[0, 1, 0, 1, 1, 1, 1, 1, 1, 1, 1, 0, 0, 1, 0]",261,103,158,14,17,0.13592233009708737,0.10759493670886076
"[1, 0, 1, 0, 1, 1, 1, 0, 1, 0, 1, 1, 1, 1, 1]",558,173,385,21,32,0.12138728323699421,0.08311688311688312
"[0, 1, 1, 0, 0, 1, 1, 0, 1, 1, 0, 1, 1, 1, 0]",155,80,75,8,7,0.1,0.09333333333333334
"[0, 0, 1, 1, 0, 0, 1, 0, 1, 0, 0, 1, 1, 0, 0]",207,111,96,7,10,0.06306306306306306,0.10416666666666667
"[0, 0, 0, 1, 0, 0, 0, 1, 1, 1, 1, 0, 1, 1, 0]",132,77,55,4,5,0.05194805194805195,0.09090909090909091
"[1, 1, 0, 1, 0, 1, 0, 0, 1, 0, 1, 0, 1, 1, 0]",100,50,50,1,3,0.02,0.06
"[0, 1, 1, 1, 0, 0, 1, 0, 1, 0, 1, 1, 0, 1, 0]",110,47,63,4,3,0.0851063829787234,0.047619047619047616
"[0, 1, 0, 1, 0, 0, 0, 0, 0, 1, 1, 1, 1, 0, 0]",391,258,133,29,14,0.1124031007751938,0.10526315789473684
"[0, 1, 0, 0, 1, 0, 0, 1, 0, 1, 1, 0, 0, 1, 0]",124,76,48,6,9,0.07894736842105263,0.1875
"[0, 1, 1, 1, 0, 1, 1, 0, 1, 1, 1, 1, 0, 0, 1]",298,106,192,7,25,0.0660377358490566,0.13020833333333334
"[0, 0, 0, 0, 0, 1, 1, 1, 1, 1, 0, 0, 0, 0, 0]",663,478,185,46,15,0.09623430962343096,0.08108108108108109
"[1, 0, 0, 0, 0, 1, 1, 0, 1, 1, 1, 0, 1, 0, 0]",114,48,66,3,3,0.0625,0.045454545454545456
"[1, 0, 1, 1, 1, 1, 1, 1, 0, 1, 0, 1, 0, 0, 0]",166,75,91,8,7,0.10666666666666667,0.07692307692307693
"[0, 0, 0, 1, 0, 1, 1, 1, 1, 1, 1, 0, 1, 0, 1]",144,51,93,7,12,0.13725490196078433,0.12903225806451613
"[1, 0, 1, 0, 0, 0, 1, 0, 1, 1, 1, 1, 1, 1, 0]",169,74,95,7,11,0.0945945945945946,0.11578947368421053
"[0, 0, 0, 0, 0, 0, 0, 1, 1, 1, 1, 1, 0, 0, 1]",464,328,136,30,7,0.09146341463414634,0.051470588235294115
"[0, 1, 1, 0, 0, 1, 0, 1, 1, 1, 1, 1, 1, 1, 1]",819,314,505,35,53,0.11146496815286625,0.10495049504950495
"[1, 1, 0, 1, 1, 0, 0, 1, 0, 1, 1, 1, 1, 1, 1]",653,206,447,15,41,0.07281553398058252,0.09172259507829977
"[0, 1, 0, 1, 0, 1, 1, 0, 0, 1, 0, 0, 0, 0, 1]",153,93,60,10,8,0.10752688172043011,0.13333333333333333
"[1, 1, 1, 0, 1, 0, 1, 1, 1, 0, 0, 1, 0, 1, 0]",144,56,88,10,10,0.17857142857142858,0.11363636363636363
"[0, 1, 0, 1, 1, 0, 0, 0, 1, 1, 1, 1, 0, 1, 1]",153,49,104,7,10,0.14285714285714285,0.09615384615384616
"[0, 0, 0, 0, 1, 0, 1, 0, 0, 0, 0, 1, 0, 1, 1]",311,201,110,28,11,0.13930348258706468,0.1
"[1, 1, 1, 0, 0, 0, 0, 0, 1, 0, 1, 1, 1, 0, 1]",124,46,78,5,6,0.10869565217391304,0.07692307692307693
"[1, 1, 1, 0, 0, 0, 1, 1, 1, 0, 0, 1, 0, 1, 0]",112,49,63,6,3,0.12244897959183673,0.047619047619047616
"[1, 0, 0, 0, 1, 0, 0, 1, 0, 1, 1, 0, 0, 1, 0]",116,63,53,5,7,0.07936507936507936,0.1320754716981132
"[1, 1, 1, 0, 0, 1, 1, 1, 1, 1, 0, 1, 1, 1, 0]",674,165,509,14,57,0.08484848484848485,0.11198428290766209
"[0, 0, 0, 1, 0, 1, 0, 0, 0, 1, 0, 0, 0, 1, 0]",498,363,135,33,10,0.09090909090909091,0.07407407407407407
"[1, 0, 1, 0, 0, 0, 0, 0, 1, 0, 1, 0, 0, 0, 1]",213,126,87,11,10,0.0873015873015873,0.11494252873563218
"[0, 1, 1, 0, 0, 1, 0, 0, 1, 0, 1, 0, 0, 1, 0]",141,90,51,9,5,0.1,0.09803921568627451
"[1, 0, 0, 1, 0, 0, 0, 0, 1, 0, 0, 0, 1, 1, 1]",228,131,97,10,8,0.07633587786259542,0.08247422680412371
"[0, 0, 1, 1, 1, 0, 1, 0, 0, 1, 0, 0, 0, 0, 1]",177,104,73,10,8,0.09615384615384616,0.1095890410958904
"[1, 0, 1, 0, 1, 0, 1, 1, 0, 1, 0, 1, 1, 1, 1]",294,96,198,8,20,0.08333333333333333,0.10101010101010101
"[0, 1, 1, 1, 1, 1, 0, 0, 0, 0, 0, 1, 1, 1, 0]",127,53,74,6,5,0.11320754716981132,0.06756756756756757
"[0, 1, 0, 1, 0, 1, 1, 0, 1, 1, 0, 0, 1, 1, 1]",216,89,127,7,16,0.07865168539325842,0.12598425196850394
"[0, 0, 0, 1, 1, 0, 1, 0, 1, 0, 1, 1, 0, 0, 0]",190,115,75,8,7,0.06956521739130435,0.09333333333333334
"[0, 0, 0, 1, 1, 0, 0, 0, 0, 1, 0, 1, 1, 1, 0]",182,113,69,17,5,0.1504424778761062,0.07246376811594203
"[0, 0, 1, 1, 1, 1, 1, 1, 1, 0, 0, 1, 1, 0, 1]",374,125,249,7,24,0.056,0.0963855421686747
"[0, 0, 1, 1, 0, 1, 1, 1, 0, 1, 0, 0, 0, 1, 1]",141,64,77,7,2,0.109375,0.025974025974025976
"[0, 1, 0, 1, 1, 0, 0, 0, 0, 1, 1, 1, 1, 1, 0]",127,62,65,5,10,0.08064516129032258,0.15384615384615385
"[0, 0, 0, 0, 0, 0, 1, 1, 1, 0, 0, 1, 1, 1, 1]",458,264,194,21,21,0.07954545454545454,0.10824742268041238
"[1, 0, 1, 1, 1, 0, 1, 1, 0, 1, 0, 0, 1, 0, 0]",123,66,57,6,6,0.09090909090909091,0.10526315789473684
"[0, 1, 0, 1, 1, 1, 0, 1, 1, 0, 1, 0, 0, 1, 0]",126,52,74,0,9,0.0,0.12162162162162163
"[1, 0, 0, 1, 0, 1, 0, 0, 1, 0, 1, 1, 1, 0, 1]",92,45,47,2,7,0.044444444444444446,0.14893617021276595
"[0, 1, 1, 0, 0, 1, 1, 1, 0, 1, 0, 1, 1, 1, 1]",345,171,174,19,15,0.1111111111111111,0.08620689655172414
"[1, 1, 0, 0, 0, 0, 0, 1, 1, 0, 1, 1, 0, 0, 0]",234,128,106,15,14,0.1171875,0.1320754716981132
"[1, 1, 1, 1, 0, 0, 0, 0, 1, 1, 1, 0, 1, 1, 0]",270,110,160,9,15,0.08181818181818182,0.09375
"[1, 1, 0, 0, 1, 0, 1, 0, 1, 0, 1, 1, 1, 1, 1]",321,114,207,14,27,0.12280701754385964,0.13043478260869565
"[1, 1, 0, 0, 1, 1, 1, 1, 0, 1, 1, 0, 0, 1, 0]",181,84,97,5,14,0.05952380952380952,0.14432989690721648
"[1, 0, 0, 1, 1, 1, 1, 1, 0, 1, 1, 1, 0, 1, 1]",606,147,459,16,55,0.10884353741496598,0.11982570806100218
"[1, 1, 0, 0, 1, 1, 1, 1, 1, 0, 1, 1, 1, 0, 1]",631,187,444,20,41,0.10695187165775401,0.09234234234234234
"[0, 0, 0, 0, 0, 1, 0, 1, 0, 0, 1, 0, 0, 0, 1]",572,412,160,44,18,0.10679611650485436,0.1125
"[1, 0, 1, 0, 0, 1, 0, 0, 1, 0, 0, 1, 1, 1, 1]",158,72,86,6,7,0.08333333333333333,0.08139534883720931
"[0, 0, 0, 0, 0, 1, 1, 0, 1, 0, 1, 1, 0, 0, 1]",217,141,76,10,4,0.07092198581560284,0.05263157894736842
"[1, 0, 1, 0, 0, 0, 0, 0, 0, 1, 1, 0, 1, 0, 1]",171,96,75,13,4,0.13541666666666666,0.05333333333333334
"[0, 0, 0, 1, 1, 1, 0, 1, 1, 0, 1, 0, 1, 0, 1]",116,53,63,4,4,0.07547169811320754,0.06349206349206349
"[1, 1, 0, 0, 1, 1, 1, 0, 1, 0, 0, 0, 1, 0, 0]",138,72,66,10,5,0.1388888888888889,0.07575757575757576
"[0, 0, 1, 0, 1, 0, 1, 1, 1, 0, 1, 0, 1, 1, 1]",182,83,99,8,12,0.0963855421686747,0.12121212121212122
"[0, 1, 0, 0, 1, 0, 1, 0, 0, 0, 0, 1, 0, 0, 1]",222,151,71,8,8,0.052980132450331126,0.11267605633802817
"[1, 0, 1, 1, 1, 0, 0, 0, 0, 0, 0, 0, 1, 0, 1]",171,93,78,7,6,0.07526881720430108,0.07692307692307693
"[0, 1, 1, 0, 1, 1, 0, 1, 1, 1, 1, 0, 1, 0, 1]",230,91,139,12,14,0.13186813186813187,0.10071942446043165
"[0, 1, 0, 1, 1, 0, 0, 0, 0, 1, 0, 1, 1, 1, 1]",147,72,75,7,7,0.09722222222222222,0.09333333333333334
"[1, 1, 1, 1, 0, 1, 0, 1, 1, 0, 0, 0, 0, 1, 0]",134,65,69,3,10,0.046153846153846156,0.14492753623188406
"[0, 0, 1, 0, 1, 0, 1, 0, 0, 1, 1, 1, 1, 1, 1]",273,127,146,10,12,0.07874015748031496,0.0821917808219178
"[1, 1, 1, 0, 1, 1, 1, 0, 0, 1, 1, 1, 1, 1, 0]",611,159,452,15,47,0.09433962264150944,0.10398230088495575
"[0, 0, 0, 1, 1, 1, 0, 1, 1, 0, 1, 1, 0, 1, 1]",155,78,77,5,7,0.0641025641025641,0.09090909090909091
"[1, 0, 1, 1, 1, 0, 1, 0, 0, 1, 1, 0, 0, 1, 1]",240,90,150,10,12,0.1111111111111111,0.08
"[0, 1, 1, 1, 0, 1, 0, 0, 0, 1, 1, 0, 0, 1, 0]",116,69,47,5,7,0.07246376811594203,0.14893617021276595
"[1, 0, 1, 0, 0, 0, 1, 0, 1, 0, 0, 1, 1, 0, 1]",102,54,48,3,4,0.05555555555555555,0.08333333333333333
"[1, 1, 0, 1, 1, 1, 1, 0, 1, 0, 0, 0, 1, 1, 0]",132,52,80,2,8,0.038461538461538464,0.1
"[1, 0, 1, 0, 1, 0, 1, 1, 0, 0, 1, 1, 1, 1, 1]",427,147,280,18,19,0.12244897959183673,0.06785714285714285
"[0, 0, 0, 1, 1, 1, 1, 1, 0, 0, 1, 1, 1, 1, 0]",342,183,159,12,12,0.06557377049180328,0.07547169811320754
"[1, 1, 0, 1, 1, 1, 1, 0, 1, 1, 1, 0, 1, 1, 0]",501,168,333,19,32,0.1130952380952381,0.0960960960960961
"[0, 1, 1, 1, 0, 1, 1, 1, 1, 0, 1, 1, 1, 0, 1]",477,139,338,21,31,0.1510791366906475,0.09171597633136094
"[1, 1, 1, 1, 1, 1, 0, 0, 0, 1, 0, 1, 0, 1, 0]",187,63,124,6,10,0.09523809523809523,0.08064516129032258
"[0, 0, 1, 0, 0, 1, 1, 1, 0, 0, 1, 0, 0, 1, 1]",128,65,63,6,5,0.09230769230769231,0.07936507936507936
"[0, 1, 1, 1, 1, 0, 1, 1, 0, 0, 0, 0, 1, 1, 0]",204,106,98,11,5,0.10377358490566038,0.05102040816326531
"[1, 0, 1, 0, 1, 1, 1, 1, 1, 1, 1, 0, 0, 0, 1]",271,91,180,6,14,0.06593406593406594,0.07777777777777778
"[1, 0, 0, 0, 1, 1, 1, 0, 1, 0, 0, 1, 1, 1, 1]",218,84,134,7,9,0.08333333333333333,0.06716417910447761
"[1, 0, 0, 0, 1, 1, 1, 1, 0, 0, 1, 1, 0, 1, 0]",126,54,72,5,6,0.09259259259259259,0.08333333333333333
"[1, 1, 0, 0, 1, 1, 0, 0, 1, 0, 0, 1, 0, 0, 1]",167,84,83,7,10,0.08333333333333333,0.12048192771084337
"[0, 0, 0, 1, 0, 1, 0, 1, 1, 1, 0, 0, 1, 0, 1]",126,67,59,9,6,0.13432835820895522,0.1016949152542373
"[0, 0, 0, 0, 0, 0, 1, 0, 1, 1, 1, 1, 1, 0, 1]",140,76,64,6,9,0.07894736842105263,0.140625
"[1, 1, 1, 1, 0, 0, 0, 1, 1, 0, 0, 0, 0, 0, 0]",416,214,202,19,24,0.08878504672897196,0.1188118811881188
"[0, 0, 1, 1, 1, 1, 1, 0, 0, 0, 1, 1, 0, 0, 0]",197,93,104,14,14,0.15053763440860216,0.1346153846153846
"[1, 1, 1, 1, 1, 1, 1, 0, 1, 1, 0, 0, 1, 0, 0]",300,94,206,7,21,0.07446808510638298,0.10194174757281553
"[1, 0, 1, 1, 1, 0, 0, 0, 1, 1, 1, 1, 1, 0, 0]",217,97,120,12,9,0.12371134020618557,0.075
"[0, 1, 1, 0, 1, 0, 1, 1, 1, 0, 0, 0, 1, 1, 1]",193,103,90,10,11,0.0970873786407767,0.12222222222222222
"[1, 0, 0, 0, 1, 0, 1, 1, 0, 0, 1, 0, 0, 0, 0]",253,167,86,14,9,0.08383233532934131,0.10465116279069768
"[0, 0, 0, 1, 0, 0, 1, 0, 1, 1, 1, 0, 0, 0, 0]",359,246,113,21,8,0.08536585365853659,0.07079646017699115
"[0, 1, 1, 1, 0, 0, 1, 0, 0, 0, 0, 0, 0, 0, 1]",330,213,117,23,12,0.107981220657277,0.10256410256410256
"[1, 0, 1, 0, 1, 0, 1, 0, 0, 0, 1, 1, 0, 0, 1]",131,73,58,8,7,0.1095890410958904,0.1206896551724138
"[0, 0, 0, 1, 0, 0, 0, 1, 0, 1, 1, 1, 0, 1, 0]",126,77,49,3,8,0.03896103896103896,0.16326530612244897
"[0, 1, 1, 0, 1, 0, 0, 0, 0, 1, 0, 0, 0, 1, 0]",235,158,77,20,4,0.12658227848101267,0.05194805194805195
"[0, 1, 1, 1, 0, 0, 1, 0, 0, 0, 0, 1, 0, 0, 1]",157,81,76,7,7,0.08641975308641975,0.09210526315789473
"[0, 1, 0, 0, 1, 1, 0, 1, 0, 0, 1, 0, 1, 0, 0]",128,81,47,11,6,0.13580246913580246,0.1276595744680851
"[0, 1, 0, 0, 1, 0, 1, 0, 0, 1, 1, 1, 0, 1, 0]",79,32,47,3,5,0.09375,0.10638297872340426
"[1, 1, 1, 1, 1, 1, 0, 0, 1, 0, 1, 0, 0, 1, 0]",180,70,110,2,12,0.02857142857142857,0.10909090909090909
"[0, 0, 0, 0, 0, 1, 1, 1, 1, 0, 1, 1, 1, 1, 1]",416,262,154,23,8,0.08778625954198473,0.05194805194805195
"[0, 1, 0, 0, 1, 1, 1, 1, 1, 1, 0, 0, 0, 1, 0]",148,68,80,6,7,0.08823529411764706,0.0875
"[0, 0, 0, 0, 1, 0, 0, 1, 1, 1, 1, 1, 1, 0, 0]",328,191,137,18,6,0.09424083769633508,0.043795620437956206
"[0, 1, 1, 0, 1, 1, 0, 1, 1, 0, 0, 0, 0, 1, 0]",105,61,44,4,5,0.06557377049180328,0.11363636363636363
"[1, 1, 0, 1, 0, 0, 1, 1, 0, 1, 1, 0, 1, 1, 0]",130,56,74,8,7,0.14285714285714285,0.0945945945945946
"[1, 1, 1, 0, 0, 0, 0, 0, 1, 1, 0, 0, 0, 1, 1]",210,81,129,7,18,0.08641975308641975,0.13953488372093023
"[0, 0, 0, 1, 0, 1, 1, 0, 1, 0, 0, 1, 0, 0, 0]",254,168,86,14,13,0.08333333333333333,0.1511627906976744
"[0, 0, 1, 1, 1, 0, 1, 0, 1, 1, 1, 1, 0, 1, 1]",244,83,161,10,12,0.12048192771084337,0.07453416149068323
"[1, 0, 1, 1, 1, 1, 1, 1, 0, 0, 1, 1, 1, 0, 0]",342,143,199,10,18,0.06993006993006994,0.09045226130653267
"[0, 1, 0, 0, 1, 0, 0, 1, 1, 0, 0, 1, 0, 1, 0]",173,106,67,9,7,0.08490566037735849,0.1044776119402985
"[1, 0, 0, 0, 0, 1, 1, 1, 1, 1, 0, 0, 0, 1, 0]",147,62,85,7,12,0.11290322580645161,0.1411764705882353
"[1, 1, 1, 0, 0, 1, 0, 1, 0, 1, 1, 0, 1, 1, 1]",305,85,220,11,25,0.12941176470588237,0.11363636363636363
"[1, 0, 1, 1, 1, 0, 1, 1, 0, 1, 0, 0, 0, 1, 1]",161,71,90,7,6,0.09859154929577464,0.06666666666666667
"[1, 1, 1, 0, 0, 1, 1, 0, 0, 0, 1, 0, 0, 0, 1]",171,63,108,7,13,0.1111111111111111,0.12037037037037036
"[1, 1, 0, 1, 0, 1, 0, 1, 1, 0, 0, 1, 1, 1, 0]",159,67,92,5,12,0.07462686567164178,0.13043478260869565
"[0, 0, 1, 0, 0, 1, 1, 0, 1, 0, 1, 0, 1, 1, 0]",107,59,48,7,8,0.11864406779661017,0.16666666666666666
"[1, 0, 0, 0, 1, 0, 0, 1, 1, 0, 1, 0, 1, 0, 1]",94,51,43,7,4,0.13725490196078433,0.09302325581395349
"[0, 0, 0, 1, 0, 0, 0, 1, 0, 0, 1, 1, 0, 1, 0]",199,132,67,17,3,0.12878787878787878,0.04477611940298507
"[0, 0, 1, 0, 0, 0, 0, 0, 1, 0, 1, 0, 1, 0, 1]",232,156,76,16,5,0.10256410256410256,0.06578947368421052
"[0, 0, 1, 1, 0, 1, 0, 1, 0, 0, 1, 1, 1, 0, 1]",128,69,59,4,9,0.057971014492753624,0.15254237288135594
"[0, 0, 0, 0, 0, 1, 0, 1, 1, 0, 0, 1, 1, 1, 0]",159,95,64,9,7,0.09473684210526316,0.109375
"[0, 0, 0, 1, 0, 0, 0, 0, 1, 0, 0, 0, 0, 1, 0]",1496,1112,384,102,37,0.09172661870503597,0.09635416666666667
"[0, 0, 1, 0, 1, 1, 0, 1, 0, 0, 0, 1, 1, 0, 0]",193,118,75,13,7,0.11016949152542373,0.09333333333333334
"[0, 0, 0, 1, 1, 1, 1, 0, 0, 1, 0, 0, 0, 0, 1]",272,173,99,16,11,0.09248554913294797,0.1111111111111111
"[1, 0, 0, 1, 1, 0, 0, 0, 0, 0, 1, 0, 1, 0, 0]",358,176,182,17,10,0.09659090909090909,0.054945054945054944
"[0, 0, 0, 1, 1, 1, 0, 0, 1, 1, 0, 0, 1, 0, 1]",134,76,58,8,7,0.10526315789473684,0.1206896551724138
"[1, 0, 1, 0, 0, 1, 0, 1, 1, 1, 1, 0, 0, 1, 1]",252,103,149,9,22,0.08737864077669903,0.1476510067114094
"[0, 1, 1, 0, 1, 1, 0, 0, 1, 1, 0, 1, 1, 0, 0]",141,70,71,7,6,0.1,0.08450704225352113
"[0, 1, 1, 1, 1, 1, 0, 0, 0, 0, 1, 1, 1, 1, 0]",489,231,258,18,26,0.07792207792207792,0.10077519379844961
"[0, 1, 1, 1, 0, 0, 0, 0, 1, 1, 1, 1, 1, 1, 0]",480,203,277,19,22,0.09359605911330049,0.07942238267148015
"[1, 1, 1, 1, 0, 0, 1, 1, 0, 1, 0, 1, 1, 0, 1]",273,107,166,11,15,0.102803738317757,0.09036144578313253
"[0, 1, 1, 1, 0, 1, 1, 0, 1, 0, 1, 0, 0, 1, 1]",178,88,90,6,15,0.06818181818181818,0.16666666666666666
"[0, 0, 1, 0, 1, 0, 1, 1, 0, 1, 0, 0, 0, 0, 1]",150,101,49,7,1,0.06930693069306931,0.02040816326530612
"[1, 0, 0, 1, 0, 1, 0, 1, 0, 0, 1, 1, 1, 1, 1]",224,85,139,10,12,0.11764705882352941,0.08633093525179857
"[0, 1, 0, 0, 1, 0, 1, 0, 1, 0, 0, 1, 1, 1, 1]",161,86,75,14,2,0.16279069767441862,0.02666666666666667
"[0, 0, 1, 1, 1, 1, 0, 0, 1, 0, 1, 0, 0, 0, 1]",176,94,82,10,8,0.10638297872340426,0.0975609756097561
"[0, 0, 0, 1, 1, 0, 1, 0, 0, 1, 0, 0, 1, 0, 0]",241,168,73,14,8,0.08333333333333333,0.1095890410958904
"[1, 0, 0, 1, 0, 0, 0, 0, 0, 1, 1, 0, 0, 1, 0]",232,138,94,10,12,0.07246376811594203,0.1276595744680851
"[1, 1, 0, 1, 0, 0, 1, 1, 1, 0, 1, 1, 0, 0, 0]",133,68,65,6,6,0.08823529411764706,0.09230769230769231
"[0, 1, 1, 1, 0, 1, 1, 0, 1, 1, 1, 0, 1, 0, 1]",206,70,136,11,13,0.15714285714285714,0.09558823529411764
"[0, 1, 1, 1, 1, 1, 0, 0, 0, 0, 0, 0, 1, 1, 1]",620,337,283,27,32,0.08011869436201781,0.11307420494699646
"[0, 1, 0, 1, 0, 0, 0, 1, 1, 1, 1, 1, 0, 0, 0]",175,91,84,7,8,0.07692307692307693,0.09523809523809523
"[1, 0, 1, 0, 0, 0, 0, 0, 0, 1, 0, 1, 1, 0, 0]",255,162,93,17,8,0.10493827160493827,0.08602150537634409
"[1, 1, 0, 0, 1, 0, 0, 1, 0, 0, 0, 1, 0, 0, 0]",230,139,91,11,6,0.07913669064748201,0.06593406593406594
"[1, 1, 0, 0, 1, 1, 0, 1, 0, 0, 0, 1, 1, 0, 0]",166,92,74,4,13,0.043478260869565216,0.17567567567567569
"[1, 1, 0, 0, 1, 1, 0, 0, 0, 0, 1, 0, 0, 1, 1]",346,171,175,16,15,0.0935672514619883,0.08571428571428572
"[1, 0, 0, 1, 1, 1, 0, 0, 1, 0, 1, 1, 0, 0, 0]",117,56,61,4,9,0.07142857142857142,0.14754098360655737
"[1, 1, 1, 0, 1, 0, 1, 0, 1, 0, 1, 1, 0, 0, 0]",141,68,73,6,5,0.08823529411764706,0.0684931506849315
"[1, 0, 0, 1, 0, 0, 0, 0, 0, 0, 0, 1, 1, 0, 1]",285,176,109,13,14,0.07386363636363637,0.12844036697247707
"[1, 0, 0, 1, 0, 0, 0, 1, 0, 1, 0, 1, 0, 0, 0]",215,140,75,8,7,0.05714285714285714,0.09333333333333334
"[1, 0, 0, 1, 0, 1, 0, 0, 0, 1, 1, 0, 0, 0, 0]",384,231,153,20,14,0.08658008658008658,0.0915032679738562
"[0, 0, 0, 0, 0, 1, 1, 0, 1, 1, 1, 0, 1, 1, 0]",108,61,47,4,4,0.06557377049180328,0.0851063829787234
"[1, 1, 1, 1, 0, 1, 0, 0, 1, 0, 1, 1, 1, 0, 1]",254,76,178,8,15,0.10526315789473684,0.08426966292134831
"[1, 1, 1, 1, 0, 0, 0, 1, 1, 0, 1, 0, 0, 1, 0]",114,47,67,3,11,0.06382978723404255,0.16417910447761194
"[0, 1, 0, 1, 0, 0, 1, 1, 1, 0, 0, 1, 1, 0, 1]",95,40,55,4,6,0.1,0.10909090909090909
"[0, 1, 1, 1, 0, 0, 0, 1, 1, 0, 1, 1, 0, 1, 1]",144,64,80,9,9,0.140625,0.1125
"[1, 0, 1, 1, 0, 0, 0, 0, 0, 1, 0, 1, 1, 0, 0]",173,94,79,13,5,0.13829787234042554,0.06329113924050633
"[1, 1, 1, 0, 1, 1, 0, 0, 0, 0, 0, 1, 0, 1, 1]",135,67,68,6,9,0.08955223880597014,0.1323529411764706
"[1, 0, 0, 1, 1, 1, 0, 1, 1, 0, 0, 0, 0, 0, 1]",161,82,79,11,11,0.13414634146341464,0.13924050632911392
"[1, 1, 0, 1, 0, 1, 0, 0, 0, 1, 1, 0, 1, 0, 0]",97,46,51,4,5,0.08695652173913043,0.09803921568627451
"[0, 0, 0, 1, 0, 0, 1, 0, 0, 0, 1, 0, 1, 1, 0]",233,156,77,11,11,0.07051282051282051,0.14285714285714285
"[0, 0, 0, 1, 1, 1, 1, 0, 1, 0, 1, 1, 0, 0, 0]",162,95,67,10,5,0.10526315789473684,0.07462686567164178
"[1, 1, 0, 1, 0, 1, 0, 1, 0, 0, 1, 0, 1, 1, 0]",123,55,68,3,11,0.05454545454545454,0.16176470588235295
"[0, 0, 0, 0, 0, 1, 1, 1, 0, 1, 1, 1, 0, 1, 1]",168,92,76,6,7,0.06521739130434782,0.09210526315789473
"[1, 0, 0, 1, 0, 0, 0, 0, 0, 1, 1, 1, 0, 1, 1]",131,66,65,5,8,0.07575757575757576,0.12307692307692308
"[1, 0, 1, 1, 1, 1, 0, 1, 1, 0, 0, 1, 0, 0, 0]",113,54,59,7,7,0.12962962962962962,0.11864406779661017
"[0, 1, 0, 1, 1, 1, 1, 0, 1, 1, 0, 0, 1, 0, 0]",124,57,67,4,7,0.07017543859649122,0.1044776119402985
"[0, 0, 1, 1, 0, 0, 0, 0, 1, 0, 0, 0, 0, 0, 1]",765,537,228,49,20,0.09124767225325885,0.08771929824561403
"[1, 0, 1, 1, 1, 1, 0, 1, 0, 0, 0, 1, 0, 0, 1]",106,50,56,4,3,0.08,0.05357142857142857
"[0, 1, 0, 0, 0, 0, 1, 0, 1, 0, 1, 0, 0, 0, 0]",537,371,166,30,16,0.08086253369272237,0.0963855421686747
"[0, 1, 1, 0, 1, 1, 0, 0, 1, 0, 1, 0, 0, 1, 0]",113,58,55,3,5,0.05172413793103448,0.09090909090909091
"[1, 1, 0, 1, 0, 1, 0, 0, 0, 0, 1, 0, 0, 1, 1]",154,94,60,10,6,0.10638297872340426,0.1
"[1, 0, 1, 0, 1, 1, 0, 0, 0, 0, 1, 0, 0, 1, 1]",127,66,61,5,5,0.07575757575757576,0.08196721311475409
"[0, 0, 0, 0, 1, 0, 1, 1, 0, 1, 0, 1, 1, 1, 1]",156,95,61,16,6,0.16842105263157894,0.09836065573770492
"[0, 1, 0, 1, 1, 1, 1, 1, 1, 0, 1, 1, 0, 1, 0]",208,75,133,12,14,0.16,0.10526315789473684
"[0, 0, 0, 1, 1, 0, 1, 0, 1, 0, 1, 1, 1, 1, 1]",187,85,102,6,10,0.07058823529411765,0.09803921568627451
"[1, 1, 1, 0, 0, 0, 0, 1, 0, 0, 0, 1, 1, 0, 1]",137,59,78,4,4,0.06779661016949153,0.05128205128205128
"[0, 1, 0, 0, 1, 0, 1, 0, 0, 0, 1, 0, 1, 0, 0]",217,135,82,12,8,0.08888888888888889,0.0975609756097561
"[0, 0, 1, 0, 1, 1, 0, 1, 1, 1, 1, 0, 1, 0, 0]",133,70,63,8,6,0.11428571428571428,0.09523809523809523
"[1, 1, 1, 0, 0, 1, 0, 1, 1, 0, 1, 1, 1, 1, 0]",273,92,181,10,20,0.10869565217391304,0.11049723756906077
"[1, 1, 1, 1, 1, 1, 0, 0, 1, 1, 0, 1, 0, 0, 0]",252,96,156,14,16,0.14583333333333334,0.10256410256410256
"[0, 0, 0, 1, 0, 0, 1, 0, 0, 0, 1, 1, 0, 1, 0]",236,145,91,21,6,0.14482758620689656,0.06593406593406594
"[0, 0, 0, 1, 0, 0, 0, 0, 1, 0, 0, 0, 1, 1, 0]",643,467,176,43,20,0.09207708779443255,0.11363636363636363
"[1, 0, 0, 0, 0, 1, 0, 0, 0, 0, 1, 0, 0, 0, 1]",538,367,171,42,16,0.11444141689373297,0.0935672514619883
"[1, 0, 1, 0, 0, 0, 0, 1, 0, 0, 1, 1, 0, 0, 1]",176,97,79,7,8,0.07216494845360824,0.10126582278481013
"[0, 1, 0, 1, 0, 0, 0, 0, 1, 0, 0, 1, 1, 0, 0]",321,200,121,27,9,0.135,0.0743801652892562
"[0, 0, 0, 0, 1, 0, 1, 0, 0, 0, 0, 1, 0, 0, 1]",515,363,152,40,13,0.11019283746556474,0.08552631578947369
"[1, 1, 0, 1, 1, 1, 0, 0, 1, 0, 0, 1, 1, 0, 1]",146,47,99,5,14,0.10638297872340426,0.1414141414141414
"[0, 1, 1, 0, 0, 0, 1, 1, 0, 0, 1, 0, 1, 1, 0]",120,75,45,5,4,0.06666666666666667,0.08888888888888889
"[1, 0, 0, 0, 0, 0, 1, 1, 0, 1, 1, 1, 1, 0, 0]",175,77,98,5,13,0.06493506493506493,0.1326530612244898
"[0, 1, 1, 1, 1, 0, 0, 0, 0, 1, 1, 1, 1, 1, 0]",402,258,144,21,14,0.08139534883720931,0.09722222222222222
"[1, 0, 1, 1, 1, 1, 0, 1, 0, 0, 1, 1, 0, 1, 0]",138,67,71,8,5,0.11940298507462686,0.07042253521126761
"[1, 1, 0, 0, 1, 0, 1, 1, 1, 1, 0, 1, 0, 0, 1]",164,63,101,6,13,0.09523809523809523,0.12871287128712872
"[0, 1, 1, 0, 1, 1, 0, 1, 0, 1, 1, 0, 0, 1, 0]",95,52,43,5,3,0.09615384615384616,0.06976744186046512
"[1, 0, 1, 1, 0, 1, 1, 1, 0, 1, 0, 0, 0, 1, 0]",103,49,54,6,6,0.12244897959183673,0.1111111111111111
"[0, 0, 0, 1, 1, 1, 1, 1, 0, 0, 1, 1, 0, 0, 0]",311,201,110,24,14,0.11940298507462686,0.12727272727272726
"[0, 1, 0, 0, 0, 0, 1, 0, 0, 1, 0, 1, 1, 0, 0]",212,141,71,14,2,0.09929078014184398,0.028169014084507043
"[0, 0, 0, 1, 0, 1, 1, 1, 0, 1, 1, 1, 1, 1, 1]",371,153,218,11,20,0.0718954248366013,0.09174311926605505
"[0, 1, 1, 0, 1, 0, 0, 1, 0, 1, 1, 1, 0, 1, 1]",119,58,61,1,5,0.017241379310344827,0.08196721311475409
"[1, 0, 0, 1, 1, 0, 1, 0, 0, 1, 0, 1, 1, 1, 0]",110,50,60,7,5,0.14,0.08333333333333333
"[1, 1, 1, 1, 1, 1, 1, 0, 0, 1, 0, 0, 0, 0, 0]",254,97,157,7,19,0.07216494845360824,0.12101910828025478
"[0, 1, 0, 0, 0, 1, 1, 1, 1, 1, 0, 1, 0, 1, 0]",107,51,56,6,1,0.11764705882352941,0.017857142857142856
"[1, 1, 0, 0, 1, 1, 1, 0, 0, 0, 1, 1, 1, 1, 0]",225,83,142,8,17,0.0963855421686747,0.11971830985915492
"[1, 1, 1, 1, 1, 0, 1, 0, 0, 1, 1, 0, 0, 0, 0]",232,102,130,8,7,0.0784313725490196,0.05384615384615385
"[1, 0, 0, 0, 0, 0, 1, 0, 0, 1, 0, 1, 0, 0, 1]",224,135,89,11,6,0.08148148148148149,0.06741573033707865
"[0, 0, 1, 1, 1, 0, 0, 0, 0, 1, 1, 1, 0, 0, 0]",206,112,94,13,7,0.11607142857142858,0.07446808510638298
"[1, 0, 0, 0, 1, 1, 1, 0, 0, 0, 0, 1, 1, 1, 0]",134,58,76,4,7,0.06896551724137931,0.09210526315789473
"[0, 0, 1, 0, 1, 1, 1, 0, 1, 0, 1, 1, 1, 0, 1]",135,52,83,0,5,0.0,0.060240963855421686
"[0, 0, 0, 1, 0, 0, 1, 0, 1, 1, 1, 1, 1, 0, 0]",160,70,90,7,5,0.1,0.05555555555555555
"[1, 1, 0, 0, 0, 0, 0, 1, 1, 1, 1, 1, 1, 0, 0]",494,239,255,18,29,0.07531380753138076,0.11372549019607843
"[0, 0, 1, 1, 0, 1, 1, 0, 1, 0, 0, 0, 1, 1, 0]",124,70,54,4,8,0.05714285714285714,0.14814814814814814
"[1, 0, 0, 1, 1, 0, 1, 1, 0, 1, 0, 0, 0, 1, 1]",124,53,71,12,7,0.22641509433962265,0.09859154929577464
"[1, 0, 1, 1, 0, 0, 0, 0, 0, 1, 1, 0, 0, 1, 0]",148,86,62,9,5,0.10465116279069768,0.08064516129032258
"[1, 1, 1, 0, 1, 0, 0, 0, 0, 1, 1, 1, 0, 0, 0]",153,77,76,7,4,0.09090909090909091,0.05263157894736842
"[0, 1, 0, 1, 0, 1, 1, 1, 0, 1, 0, 0, 0, 0, 1]",110,74,36,6,4,0.08108108108108109,0.1111111111111111
"[1, 1, 1, 0, 1, 0, 1, 1, 1, 0, 1, 1, 0, 0, 0]",188,72,116,12,17,0.16666666666666666,0.14655172413793102
"[1, 0, 0, 1, 1, 1, 0, 0, 0, 0, 1, 0, 0, 0, 1]",159,92,67,5,5,0.05434782608695652,0.07462686567164178
"[0, 0, 1, 0, 0, 1, 1, 1, 0, 0, 0, 0, 1, 0, 0]",262,167,95,14,8,0.08383233532934131,0.08421052631578947
"[1, 1, 1, 1, 0, 1, 0, 0, 1, 1, 0, 1, 1, 1, 1]",658,180,478,14,42,0.07777777777777778,0.08786610878661087
"[0, 0, 0, 1, 0, 0, 0, 0, 1, 1, 1, 1, 0, 1, 0]",162,104,58,7,7,0.0673076923076923,0.1206896551724138
"[1, 1, 0, 0, 1, 1, 1, 1, 0, 1, 0, 1, 0, 1, 1]",350,134,216,9,22,0.06716417910447761,0.10185185185185185
"[1, 0, 1, 1, 0, 0, 1, 1, 1, 1, 0, 1, 0, 1, 0]",156,64,92,5,8,0.078125,0.08695652173913043
"[1, 0, 1, 1, 0, 1, 1, 0, 0, 1, 1, 0, 0, 0, 1]",137,60,77,6,8,0.1,0.1038961038961039
"[1, 1, 1, 0, 0, 1, 1, 1, 0, 0, 0, 0, 0, 1, 1]",210,89,121,12,9,0.1348314606741573,0.0743801652892562
"[0, 1, 1, 1, 0, 0, 0, 0, 0, 1, 1, 0, 1, 1, 1]",171,88,83,10,7,0.11363636363636363,0.08433734939759036
"[0, 1, 1, 0, 1, 0, 1, 0, 0, 1, 0, 1, 1, 1, 0]",99,44,55,4,4,0.09090909090909091,0.07272727272727272
"[0, 0, 0, 0, 0, 1, 0, 1, 0, 1, 1, 1, 0, 1, 1]",139,74,65,5,8,0.06756756756756757,0.12307692307692308
"[0, 0, 1, 0, 1, 0, 1, 0, 1, 0, 1, 1, 1, 1, 0]",131,62,69,5,8,0.08064516129032258,0.11594202898550725
"[0, 0, 1, 1, 0, 1, 0, 0, 1, 0, 1, 0, 0, 0, 1]",138,91,47,10,5,0.10989010989010989,0.10638297872340426
"[1, 0, 0, 1, 1, 1, 1, 0, 0, 1, 0, 1, 0, 1, 0]",138,48,90,4,11,0.08333333333333333,0.12222222222222222
"[0, 1, 0, 0, 0, 1, 1, 0, 0, 1, 1, 1, 1, 0, 0]",411,220,191,17,21,0.07727272727272727,0.1099476439790576
"[0, 1, 0, 0, 1, 1, 0, 0, 1, 0, 1, 1, 1, 0, 0]",143,67,76,7,8,0.1044776119402985,0.10526315789473684
"[0, 0, 0, 0, 1, 0, 0, 1, 1, 1, 1, 0, 1, 0, 1]",121,55,66,8,6,0.14545454545454545,0.09090909090909091
"[1, 0, 1, 1, 0, 1, 0, 1, 0, 0, 0, 1, 1, 1, 0]",102,51,51,3,3,0.058823529411764705,0.058823529411764705
"[0, 0, 0, 0, 1, 1, 1, 0, 0, 0, 0, 1, 0, 1, 1]",208,141,67,12,5,0.0851063829787234,0.07462686567164178
"[0, 0, 0, 0, 0, 0, 1, 1, 1, 0, 0, 0, 0, 1, 0]",660,474,186,48,19,0.10126582278481013,0.10215053763440861
"[1, 0, 1, 1, 0, 0, 0, 1, 0, 1, 0, 1, 0, 1, 0]",100,54,46,3,3,0.05555555555555555,0.06521739130434782
"[0, 1, 1, 1, 0, 1, 0, 0, 0, 1, 1, 0, 0, 0, 0]",251,151,100,13,9,0.08609271523178808,0.09
"[0, 1, 0, 1, 1, 1, 0, 0, 1, 1, 0, 1, 0, 0, 1]",117,55,62,8,7,0.14545454545454545,0.11290322580645161
"[1, 1, 0, 0, 0, 0, 0, 0, 1, 1, 1, 0, 1, 0, 0]",253,128,125,3,10,0.0234375,0.08
"[1, 0, 1, 0, 0, 1, 0, 1, 1, 0, 0, 1, 1, 1, 1]",239,100,139,7,13,0.07,0.09352517985611511
"[1, 0, 0, 1, 1, 1, 1, 0, 1, 1, 0, 1, 1, 1, 0]",267,75,192,10,17,0.13333333333333333,0.08854166666666667
"[0, 1, 1, 1, 0, 1, 0, 1, 0, 1, 0, 0, 0, 0, 0]",156,91,65,7,7,0.07692307692307693,0.1076923076923077
"[1, 1, 0, 1, 0, 0, 1, 1, 1, 0, 1, 0, 1, 0, 1]",131,57,74,5,8,0.08771929824561403,0.10810810810810811
"[0, 0, 1, 1, 1, 1, 0, 1, 0, 0, 1, 1, 1, 0, 1]",172,77,95,8,7,0.1038961038961039,0.07368421052631578
"[0, 0, 1, 0, 0, 1, 0, 1, 0, 0, 0, 0, 0, 0, 1]",614,439,175,35,20,0.07972665148063782,0.11428571428571428
"[1, 0, 0, 0, 1, 0, 0, 1, 0, 0, 0, 1, 0, 0, 1]",241,137,104,7,12,0.051094890510948905,0.11538461538461539
"[1, 0, 1, 1, 0, 1, 1, 1, 1, 0, 1, 1, 1, 1, 0]",511,142,369,19,39,0.13380281690140844,0.10569105691056911
"[1, 1, 0, 1, 0, 1, 0, 1, 0, 1, 1, 1, 0, 1, 1]",257,103,154,9,13,0.08737864077669903,0.08441558441558442
"[1, 1, 0, 0, 1, 0, 1, 1, 1, 0, 1, 1, 0, 1, 1]",245,90,155,8,15,0.08888888888888889,0.0967741935483871
"[1, 0, 0, 0, 0, 0, 1, 1, 0, 0, 0, 0, 0, 1, 1]",475,287,188,27,18,0.09407665505226481,0.09574468085106383
"[0, 0, 1, 0, 1, 1, 1, 1, 0, 1, 1, 1, 1, 0, 1]",241,83,158,5,13,0.060240963855421686,0.08227848101265822
"[0, 1, 1, 0, 0, 1, 0, 0, 0, 1, 1, 0, 0, 1, 0]",134,84,50,6,5,0.07142857142857142,0.1
"[0, 0, 1, 0, 0, 0, 1, 0, 1, 1, 0, 0, 1, 0, 0]",258,162,96,13,8,0.08024691358024691,0.08333333333333333
"[0, 1, 0, 1, 1, 1, 1, 0, 0, 1, 0, 0, 0, 1, 0]",98,57,41,7,9,0.12280701754385964,0.21951219512195122
"[0, 1, 0, 0, 1, 0, 0, 1, 0, 1, 0, 0, 0, 1, 1]",167,99,68,10,8,0.10101010101010101,0.11764705882352941
"[0, 0, 1, 0, 0, 1, 1, 0, 1, 1, 0, 1, 1, 0, 0]",136,77,59,9,1,0.11688311688311688,0.01694915254237288
"[0, 1, 0, 0, 1, 0, 1, 1, 0, 0, 1, 0, 0, 1, 1]",122,62,60,5,10,0.08064516129032258,0.16666666666666666
"[1, 0, 1, 1, 1, 0, 1, 0, 1, 0, 0, 1, 0, 1, 1]",144,66,78,3,11,0.045454545454545456,0.14102564102564102
"[1, 1, 0, 0, 0, 0, 0, 0, 1, 1, 0, 0, 1, 0, 1]",450,250,200,25,16,0.1,0.08
"[0, 0, 1, 0, 0, 1, 0, 0, 1, 1, 1, 0, 1, 1, 1]",137,74,63,8,5,0.10810810810810811,0.07936507936507936
"[1, 1, 0, 1, 1, 1, 1, 0, 0, 0, 1, 0, 0, 1, 0]",121,53,68,2,8,0.03773584905660377,0.11764705882352941
"[0, 1, 0, 1, 1, 1, 1, 0, 1, 0, 0, 0, 0, 0, 1]",124,55,69,4,8,0.07272727272727272,0.11594202898550725
"[1, 0, 0, 0, 0, 1, 0, 0, 1, 0, 1, 0, 0, 0, 1]",269,164,105,21,10,0.12804878048780488,0.09523809523809523
"[1, 1, 1, 0, 0, 0, 0, 1, 0, 0, 1, 0, 1, 0, 0]",159,87,72,6,4,0.06896551724137931,0.05555555555555555
"[0, 0, 1, 1, 0, 0, 0, 1, 0, 1, 0, 1, 1, 0, 0]",166,91,75,6,15,0.06593406593406594,0.2
"[1, 1, 0, 0, 1, 0, 1, 0, 0, 1, 0, 0, 1, 1, 1]",172,84,88,5,6,0.05952380952380952,0.06818181818181818
"[1, 1, 1, 0, 0, 1, 0, 1, 0, 0, 1, 0, 0, 1, 1]",151,68,83,7,7,0.10294117647058823,0.08433734939759036
"[1, 1, 0, 0, 0, 1, 0, 1, 1, 0, 1, 0, 1, 1, 0]",119,56,63,2,12,0.03571428571428571,0.19047619047619047
"[1, 1, 0, 1, 0, 0, 0, 1, 1, 1, 0, 0, 0, 1, 1]",131,59,72,6,9,0.1016949152542373,0.125
"[1, 0, 1, 1, 1, 0, 0, 1, 1, 1, 1, 0, 1, 0, 0]",157,68,89,6,6,0.08823529411764706,0.06741573033707865
"[1, 1, 0, 0, 0, 1, 1, 1, 1, 1, 0, 0, 1, 1, 0]",251,101,150,9,11,0.0891089108910891,0.07333333333333333
"[1, 0, 0, 1, 0, 0, 0, 1, 1, 0, 1, 0, 1, 1, 1]",140,67,73,7,7,0.1044776119402985,0.0958904109589041
"[1, 1, 1, 1, 0, 1, 1, 0, 0, 1, 1, 0, 0, 0, 0]",324,131,193,9,22,0.06870229007633588,0.11398963730569948
"[0, 1, 1, 0, 0, 1, 0, 1, 1, 0, 0, 1, 1, 0, 0]",198,115,83,12,8,0.10434782608695652,0.0963855421686747
"[1, 0, 0, 1, 1, 0, 0, 1, 0, 1, 0, 0, 0, 0, 0]",340,182,158,14,13,0.07692307692307693,0.08227848101265822
"[0, 0, 1, 0, 0, 0, 1, 0, 0, 1, 1, 0, 0, 1, 0]",235,146,89,14,10,0.0958904109589041,0.11235955056179775
"[0, 1, 0, 0, 0, 1, 0, 0, 0, 1, 0, 0, 1, 1, 0]",258,183,75,12,5,0.06557377049180328,0.06666666666666667
"[0, 0, 0, 0, 1, 1, 0, 0, 1, 0, 1, 0, 0, 1, 1]",278,164,114,16,11,0.0975609756097561,0.09649122807017543
"[1, 0, 1, 1, 0, 0, 1, 1, 1, 1, 1, 1, 0, 0, 0]",491,198,293,20,27,0.10101010101010101,0.09215017064846416
"[1, 1, 1, 0, 1, 0, 0, 1, 0, 0, 0, 1, 0, 1, 0]",108,47,61,6,2,0.1276595744680851,0.03278688524590164
"[1, 0, 0, 0, 1, 0, 0, 0, 1, 0, 1, 1, 1, 1, 1]",165,75,90,6,6,0.08,0.06666666666666667
"[1, 1, 0, 1, 0, 1, 0, 1, 0, 1, 1, 0, 1, 0, 1]",147,54,93,7,11,0.12962962962962962,0.11827956989247312
"[0, 1, 1, 0, 1, 0, 1, 0, 0, 1, 1, 0, 0, 0, 0]",289,177,112,12,14,0.06779661016949153,0.125
"[0, 1, 0, 0, 1, 1, 1, 1, 1, 0, 1, 0, 1, 0, 0]",93,33,60,3,7,0.09090909090909091,0.11666666666666667
"[1, 1, 1, 1, 0, 0, 1, 1, 1, 1, 1, 0, 0, 0, 1]",459,182,277,15,32,0.08241758241758242,0.11552346570397112
"[1, 1, 1, 0, 0, 0, 0, 1, 0, 1, 0, 0, 1, 1, 1]",233,87,146,12,10,0.13793103448275862,0.0684931506849315
"[1, 1, 1, 1, 1, 1, 0, 0, 0, 0, 1, 0, 1, 0, 0]",232,97,135,11,20,0.1134020618556701,0.14814814814814814
"[1, 1, 0, 1, 1, 0, 0, 1, 0, 0, 0, 1, 1, 0, 0]",146,87,59,10,5,0.11494252873563218,0.0847457627118644
"[0, 1, 0, 1, 0, 1, 0, 0, 0, 0, 0, 1, 0, 0, 1]",227,148,79,12,10,0.08108108108108109,0.12658227848101267
"[0, 0, 0, 1, 0, 0, 0, 0, 1, 0, 1, 0, 1, 0, 1]",248,149,99,16,10,0.10738255033557047,0.10101010101010101
"[0, 0, 0, 0, 0, 0, 1, 1, 1, 1, 1, 0, 1, 1, 1]",459,227,232,23,11,0.1013215859030837,0.04741379310344827
"[0, 1, 0, 1, 0, 1, 0, 1, 1, 0, 1, 0, 0, 0, 1]",119,55,64,5,6,0.09090909090909091,0.09375
"[0, 0, 1, 0, 1, 0, 1, 0, 1, 0, 1, 1, 0, 1, 0]",90,54,36,5,1,0.09259259259259259,0.027777777777777776
"[0, 0, 1, 1, 1, 1, 1, 0, 0, 0, 1, 1, 1, 0, 0]",164,76,88,7,8,0.09210526315789473,0.09090909090909091
"[0, 0, 1, 0, 1, 1, 0, 1, 0, 1, 1, 1, 0, 0, 1]",117,51,66,8,6,0.1568627450980392,0.09090909090909091
"[1, 0, 0, 0, 1, 0, 1, 0, 0, 0, 1, 1, 1, 1, 1]",185,79,106,14,18,0.17721518987341772,0.16981132075471697
"[0, 1, 0, 0, 1, 1, 1, 0, 1, 1, 0, 1, 0, 1, 1]",156,61,95,2,8,0.03278688524590164,0.08421052631578947
"[0, 1, 0, 0, 1, 0, 1, 0, 0, 1, 1, 1, 1, 0, 1]",115,62,53,8,4,0.12903225806451613,0.07547169811320754
"[1, 1, 0, 1, 1, 0, 1, 1, 0, 0, 1, 0, 0, 1, 1]",171,53,118,7,11,0.1320754716981132,0.09322033898305085
"[1, 1, 0, 1, 0, 1, 0, 0, 1, 1, 0, 1, 1, 0, 1]",142,62,80,3,10,0.04838709677419355,0.125
"[1, 1, 0, 0, 1, 1, 0, 1, 1, 0, 0, 1, 0, 1, 0]",127,61,66,5,8,0.08196721311475409,0.12121212121212122
"[0, 0, 0, 1, 0, 0, 1, 1, 1, 1, 0, 1, 0, 0, 1]",115,59,56,4,4,0.06779661016949153,0.07142857142857142
"[0, 0, 0, 0, 0, 1, 0, 0, 1, 1, 1, 1, 0, 1, 0]",144,87,57,11,7,0.12643678160919541,0.12280701754385964
"[0, 1, 1, 0, 1, 0, 1, 1, 1, 0, 0, 0, 0, 1, 1]",213,118,95,7,11,0.059322033898305086,0.11578947368421053
"[0, 0, 1, 1, 1, 1, 1, 0, 1, 1, 1, 0, 1, 0, 0]",181,73,108,6,11,0.0821917808219178,0.10185185185185185
"[1, 1, 0, 1, 1, 0, 1, 1, 1, 0, 0, 1, 1, 1, 0]",255,85,170,10,19,0.11764705882352941,0.11176470588235295
"[0, 0, 0, 1, 0, 1, 1, 1, 1, 1, 1, 0, 0, 0, 1]",173,81,92,8,13,0.09876543209876543,0.14130434782608695
"[1, 0, 0, 0, 1, 0, 1, 1, 1, 0, 0, 0, 1, 0, 0]",142,85,57,9,3,0.10588235294117647,0.05263157894736842
"[1, 0, 1, 1, 1, 1, 1, 1, 0, 0, 1, 1, 0, 1, 0]",257,89,168,5,11,0.056179775280898875,0.06547619047619048
"[1, 0, 0, 1, 0, 0, 0, 1, 0, 0, 0, 0, 0, 1, 1]",325,197,128,14,17,0.07106598984771574,0.1328125
"[0, 1, 0, 0, 0, 0, 0, 1, 1, 1, 0, 0, 1, 1, 1]",222,119,103,15,11,0.12605042016806722,0.10679611650485436
"[0, 0, 0, 1, 0, 0, 0, 0, 1, 1, 1, 1, 0, 0, 1]",369,215,154,15,14,0.06976744186046512,0.09090909090909091
"[1, 0, 1, 0, 1, 0, 1, 1, 1, 0, 1, 0, 0, 0, 1]",96,45,51,5,7,0.1111111111111111,0.13725490196078433
"[0, 0, 1, 1, 0, 0, 0, 0, 1, 0, 0, 1, 0, 1, 0]",275,182,93,21,8,0.11538461538461539,0.08602150537634409
"[1, 0, 1, 1, 1, 1, 0, 1, 0, 1, 0, 0, 0, 0, 0]",134,71,63,6,4,0.08450704225352113,0.06349206349206349
"[1, 1, 1, 0, 1, 0, 1, 1, 1, 1, 1, 0, 0, 0, 0]",293,100,193,9,28,0.09,0.14507772020725387
"[0, 1, 1, 1, 1, 0, 0, 0, 0, 0, 0, 0, 1, 0, 1]",329,246,83,24,9,0.0975609756097561,0.10843373493975904
"[1, 0, 1, 0, 0, 0, 1, 1, 0, 1, 1, 1, 0, 1, 0]",96,50,46,5,8,0.1,0.17391304347826086
"[1, 0, 0, 1, 1, 0, 1, 1, 1, 1, 0, 0, 0, 1, 0]",108,45,63,5,8,0.1111111111111111,0.12698412698412698
"[1, 1, 1, 1, 0, 1, 1, 0, 0, 0, 0, 1, 0, 1, 0]",118,61,57,10,5,0.16393442622950818,0.08771929824561403
"[0, 1, 0, 1, 0, 1, 1, 0, 1, 1, 0, 0, 0, 1, 0]",101,49,52,2,6,0.04081632653061224,0.11538461538461539
"[1, 0, 0, 0, 1, 0, 1, 0, 0, 1, 1, 1, 1, 1, 0]",113,51,62,2,8,0.0392156862745098,0.12903225806451613
"[0, 1, 0, 1, 1, 0, 1, 1, 0, 1, 1, 0, 1, 0, 1]",139,57,82,8,10,0.14035087719298245,0.12195121951219512
"[0, 0, 0, 1, 1, 0, 1, 1, 0, 1, 1, 1, 0, 1, 1]",154,72,82,7,9,0.09722222222222222,0.10975609756097561
"[0, 1, 0, 0, 1, 0, 1, 1, 1, 1, 1, 1, 0, 0, 1]",219,82,137,7,11,0.08536585365853659,0.08029197080291971
"[1, 0, 0, 0, 1, 0, 1, 0, 0, 0, 0, 0, 1, 1, 0]",312,180,132,14,18,0.07777777777777778,0.13636363636363635
"[0, 1, 1, 1, 1, 1, 0, 1, 0, 1, 1, 0, 1, 1, 0]",235,86,149,10,20,0.11627906976744186,0.1342281879194631
"[0, 1, 1, 0, 0, 0, 1, 0, 1, 0, 1, 0, 0, 0, 1]",151,101,50,14,4,0.13861386138613863,0.08
"[0, 1, 1, 1, 0, 0, 1, 0, 1, 0, 0, 1, 0, 1, 1]",121,60,61,9,5,0.15,0.08196721311475409
"[1, 1, 0, 0, 0, 1, 1, 1, 1, 1, 1, 1, 0, 1, 0]",259,87,172,8,10,0.09195402298850575,0.05813953488372093
"[0, 0, 0, 1, 0, 1, 1, 0, 1, 1, 1, 1, 1, 0, 1]",141,62,79,8,9,0.12903225806451613,0.11392405063291139
"[1, 1, 0, 0, 0, 1, 0, 1, 1, 0, 1, 1, 1, 1, 1]",324,101,223,11,19,0.10891089108910891,0.08520179372197309
"[1, 0, 0, 1, 1, 0, 1, 1, 1, 1, 0, 0, 1, 1, 1]",462,151,311,17,26,0.11258278145695365,0.08360128617363344
"[0, 0, 1, 1, 1, 1, 0, 0, 0, 0, 1, 1, 1, 0, 0]",370,186,184,20,12,0.10752688172043011,0.06521739130434782
"[1, 1, 0, 0, 0, 1, 1, 1, 0, 1, 0, 0, 1, 0, 1]",122,49,73,6,4,0.12244897959183673,0.0547945205479452
"[0, 1, 0, 1, 1, 0, 0, 1, 0, 1, 1, 0, 1, 0, 1]",92,39,53,6,5,0.15384615384615385,0.09433962264150944
"[0, 1, 0, 1, 0, 1, 0, 1, 1, 1, 1, 1, 0, 1, 1]",208,68,140,9,12,0.1323529411764706,0.08571428571428572
"[0, 1, 0, 1, 1, 0, 1, 0, 0, 0, 1, 1, 1, 0, 0]",140,72,68,11,6,0.1527777777777778,0.08823529411764706
"[1, 1, 1, 0, 1, 1, 1, 0, 0, 1, 1, 0, 0, 1, 1]",637,223,414,23,37,0.1031390134529148,0.0893719806763285
"[0, 0, 1, 0, 1, 1, 0, 1, 1, 1, 1, 1, 0, 0, 1]",183,86,97,9,7,0.10465116279069768,0.07216494845360824
"[1, 1, 1, 0, 1, 1, 1, 0, 0, 0, 0, 1, 1, 0, 0]",325,119,206,9,21,0.07563025210084033,0.10194174757281553
"[0, 0, 0, 1, 1, 0, 1, 0, 0, 0, 0, 0, 1, 1, 0]",355,242,113,16,11,0.06611570247933884,0.09734513274336283
"[1, 1, 1, 0, 0, 1, 0, 0, 1, 0, 0, 1, 0, 1, 0]",111,65,46,6,3,0.09230769230769231,0.06521739130434782
"[1, 0, 0, 1, 1, 0, 1, 0, 1, 0, 0, 1, 0, 1, 1]",97,46,51,4,5,0.08695652173913043,0.09803921568627451
"[0, 0, 1, 0, 0, 1, 0, 0, 0, 0, 0, 1, 1, 0, 1]",266,173,93,18,11,0.10404624277456648,0.11827956989247312
"[1, 0, 1, 1, 0, 1, 0, 0, 0, 1, 1, 0, 0, 1, 0]",91,55,36,6,3,0.10909090909090909,0.08333333333333333
"[0, 0, 1, 0, 0, 0, 1, 1, 1, 1, 0, 1, 1, 0, 0]",129,71,58,6,6,0.08450704225352113,0.10344827586206896
"[1, 0, 0, 1, 0, 0, 0, 1, 1, 1, 1, 0, 1, 1, 0]",104,56,48,9,3,0.16071428571428573,0.0625
"[0, 0, 1, 1, 0, 1, 0, 0, 1, 1, 0, 1, 1, 1, 1]",163,76,87,6,9,0.07894736842105263,0.10344827586206896
"[0, 0, 1, 0, 0, 1, 1, 0, 1, 0, 0, 1, 1, 0, 1]",92,51,41,4,3,0.0784313725490196,0.07317073170731707
"[0, 1, 0, 0, 0, 1, 0, 1, 1, 0, 0, 0, 1, 0, 0]",249,162,87,20,10,0.12345679012345678,0.11494252873563218
"[0, 0, 0, 1, 1, 0, 0, 1, 0, 0, 0, 1, 0, 1, 1]",222,156,66,11,11,0.07051282051282051,0.16666666666666666
"[0, 1, 1, 0, 1, 0, 0, 0, 1, 1, 1, 0, 1, 0, 1]",116,59,57,4,2,0.06779661016949153,0.03508771929824561
"[1, 1, 0, 0, 0, 1, 1, 0, 0, 0, 0, 0, 0, 1, 0]",317,209,108,21,11,0.10047846889952153,0.10185185185185185
"[0, 0, 1, 0, 0, 1, 1, 1, 1, 1, 1, 0, 1, 1, 0]",164,80,84,5,6,0.0625,0.07142857142857142
"[1, 1, 1, 1, 0, 1, 0, 0, 0, 1, 0, 1, 1, 1, 0]",146,60,86,6,4,0.1,0.046511627906976744
"[0, 0, 0, 0, 0, 0, 1, 0, 0, 1, 1, 1, 1, 0, 1]",182,104,78,11,7,0.10576923076923077,0.08974358974358974
"[0, 0, 0, 1, 1, 0, 1, 1, 0, 1, 1, 0, 1, 1, 0]",118,61,57,7,11,0.11475409836065574,0.19298245614035087
"[0, 0, 0, 1, 0, 0, 1, 1, 1, 0, 0, 0, 0, 1, 0]",237,159,78,8,8,0.050314465408805034,0.10256410256410256
"[1, 1, 1, 0, 1, 1, 0, 0, 0, 1, 1, 1, 1, 0, 1]",245,78,167,9,19,0.11538461538461539,0.11377245508982035
"[1, 1, 1, 1, 0, 0, 1, 0, 1, 1, 1, 1, 0, 1, 0]",295,103,192,9,13,0.08737864077669903,0.06770833333333333
"[1, 0, 0, 1, 0, 1, 0, 0, 1, 0, 0, 0, 1, 1, 0]",157,97,60,9,4,0.09278350515463918,0.06666666666666667
"[1, 0, 0, 0, 0, 1, 1, 0, 0, 1, 0, 1, 0, 0, 1]",207,89,118,8,13,0.0898876404494382,0.11016949152542373
"[1, 0, 1, 0, 1, 0, 0, 1, 0, 1, 0, 0, 0, 0, 1]",141,84,57,6,7,0.07142857142857142,0.12280701754385964
"[0, 0, 1, 1, 0, 1, 1, 1, 0, 0, 1, 0, 1, 0, 1]",116,55,61,3,8,0.05454545454545454,0.13114754098360656
"[1, 0, 0, 1, 1, 0, 1, 1, 1, 0, 0, 1, 0, 1, 0]",115,44,71,4,2,0.09090909090909091,0.028169014084507043
"[0, 1, 1, 0, 0, 1, 0, 0, 0, 0, 1, 1, 1, 0, 1]",117,58,59,7,8,0.1206896551724138,0.13559322033898305
"[0, 1, 0, 1, 0, 0, 0, 1, 0, 0, 1, 1, 1, 0, 0]",169,91,78,7,10,0.07692307692307693,0.1282051282051282
"[1, 0, 0, 1, 0, 1, 0, 0, 0, 1, 0, 0, 1, 1, 1]",145,71,74,13,13,0.18309859154929578,0.17567567567567569
"[0, 0, 0, 1, 0, 1, 1, 0, 1, 1, 1, 0, 1, 0, 0]",103,51,52,4,2,0.0784313725490196,0.038461538461538464
"[0, 1, 1, 0, 0, 1, 0, 0, 1, 1, 0, 1, 1, 1, 0]",113,48,65,6,6,0.125,0.09230769230769231
"[1, 1, 0, 0, 1, 1, 1, 0, 1, 0, 0, 0, 1, 0, 1]",119,57,62,6,3,0.10526315789473684,0.04838709677419355
"[0, 0, 0, 0, 1, 1, 1, 1, 1, 0, 0, 1, 0, 0, 0]",224,138,86,6,12,0.043478260869565216,0.13953488372093023
"[0, 1, 0, 1, 0, 1, 1, 0, 1, 0, 1, 0, 0, 0, 0]",150,86,64,12,10,0.13953488372093023,0.15625
"[0, 1, 1, 0, 0, 1, 1, 0, 0, 1, 1, 1, 0, 1, 0]",224,142,82,15,9,0.1056338028169014,0.10975609756097561
"[1, 0, 0, 0, 1, 0, 1, 0, 1, 1, 0, 1, 0, 0, 0]",146,87,59,15,7,0.1724137931034483,0.11864406779661017
"[1, 1, 1, 1, 0, 0, 1, 0, 0, 1, 1, 0, 0, 0, 0]",228,111,117,9,13,0.08108108108108109,0.1111111111111111
"[1, 0, 1, 0, 0, 0, 0, 0, 1, 1, 0, 1, 1, 0, 0]",140,86,54,7,5,0.08139534883720931,0.09259259259259259
"[0, 1, 0, 0, 0, 0, 1, 0, 1, 0, 1, 0, 1, 1, 0]",162,102,60,5,7,0.049019607843137254,0.11666666666666667
"[0, 0, 0, 0, 1, 0, 1, 1, 0, 1, 0, 1, 0, 1, 0]",140,82,58,6,7,0.07317073170731707,0.1206896551724138
"[0, 1, 0, 1, 0, 0, 1, 0, 1, 1, 0, 0, 0, 0, 1]",195,108,87,11,8,0.10185185185185185,0.09195402298850575
"[0, 1, 0, 1, 0, 0, 0, 1, 0, 1, 0, 1, 0, 1, 1]",105,64,41,4,11,0.0625,0.2682926829268293
"[0, 1, 0, 0, 0, 1, 1, 0, 0, 1, 0, 0, 1, 0, 1]",118,65,53,9,7,0.13846153846153847,0.1320754716981132
"[1, 1, 0, 1, 0, 0, 0, 1, 0, 1, 1, 1, 0, 0, 0]",124,60,64,8,6,0.13333333333333333,0.09375
"[1, 1, 1, 1, 1, 0, 0, 0, 1, 1, 0, 0, 1, 1, 1]",612,179,433,18,33,0.1005586592178771,0.07621247113163972
"[1, 1, 0, 1, 1, 1, 0, 0, 0, 0, 1, 1, 0, 1, 0]",136,67,69,6,6,0.08955223880597014,0.08695652173913043
"[0, 0, 0, 1, 0, 1, 1, 0, 0, 1, 1, 1, 1, 0, 1]",146,66,80,5,5,0.07575757575757576,0.0625
"[0, 0, 1, 0, 0, 0, 0, 1, 0, 1, 1, 1, 1, 0, 0]",204,127,77,17,3,0.13385826771653545,0.03896103896103896
"[0, 1, 1, 0, 1, 1, 0, 1, 0, 0, 0, 1, 0, 0, 0]",134,77,57,15,8,0.19480519480519481,0.14035087719298245
"[0, 0, 0, 1, 0, 1, 0, 1, 0, 1, 1, 0, 1, 1, 0]",130,68,62,6,4,0.08823529411764706,0.06451612903225806
"[1, 1, 0, 0, 1, 1, 0, 0, 0, 0, 0, 1, 0, 1, 0]",297,167,130,17,9,0.10179640718562874,0.06923076923076923
"[0, 0, 0, 1, 0, 0, 0, 1, 1, 0, 0, 1, 0, 1, 0]",239,156,83,16,9,0.10256410256410256,0.10843373493975904
"[1, 1, 0, 1, 1, 1, 0, 1, 0, 0, 1, 0, 1, 1, 0]",144,54,90,6,8,0.1111111111111111,0.08888888888888889
"[0, 0, 1, 0, 1, 1, 1, 1, 1, 1, 0, 0, 1, 0, 1]",149,71,78,7,4,0.09859154929577464,0.05128205128205128
"[1, 1, 1, 1, 1, 0, 0, 0, 1, 1, 0, 0, 0, 1, 1]",232,73,159,9,15,0.1232876712328767,0.09433962264150944
"[1, 1, 1, 1, 1, 1, 1, 0, 0, 0, 1, 1, 0, 0, 0]",339,120,219,11,29,0.09166666666666666,0.1324200913242009
"[1, 1, 0, 1, 0, 0, 0, 1, 1, 1, 0, 0, 1, 0, 1]",115,57,58,9,3,0.15789473684210525,0.05172413793103448
"[0, 0, 1, 1, 0, 0, 1, 1, 0, 1, 1, 1, 1, 0, 1]",190,69,121,7,14,0.10144927536231885,0.11570247933884298
"[1, 1, 0, 0, 1, 1, 0, 0, 1, 1, 0, 1, 1, 1, 1]",737,261,476,19,47,0.07279693486590039,0.09873949579831932
"[0, 1, 0, 1, 1, 0, 1, 1, 0, 0, 1, 1, 0, 0, 1]",165,70,95,5,13,0.07142857142857142,0.1368421052631579
"[0, 1, 0, 0, 0, 0, 0, 1, 0, 1, 1, 0, 1, 1, 0]",140,84,56,10,7,0.11904761904761904,0.125
"[0, 0, 0, 1, 1, 0, 0, 0, 1, 0, 0, 0, 1, 1, 1]",410,313,97,29,11,0.0926517571884984,0.1134020618556701
"[1, 0, 0, 1, 0, 1, 0, 0, 0, 1, 0, 1, 0, 0, 0]",211,138,73,16,6,0.11594202898550725,0.0821917808219178
"[0, 1, 1, 0, 1, 0, 0, 0, 0, 1, 0, 1, 1, 0, 0]",161,91,70,8,10,0.08791208791208792,0.14285714285714285
"[0, 1, 1, 0, 1, 0, 1, 0, 0, 0, 1, 1, 0, 0, 0]",171,98,73,9,3,0.09183673469387756,0.0410958904109589
"[0, 0, 0, 0, 0, 0, 1, 1, 1, 1, 0, 1, 0, 1, 0]",244,145,99,19,12,0.1310344827586207,0.12121212121212122
"[0, 1, 0, 1, 1, 0, 0, 1, 1, 0, 1, 0, 0, 0, 0]",181,100,81,9,8,0.09,0.09876543209876543
"[0, 0, 0, 0, 1, 1, 1, 1, 0, 1, 0, 1, 1, 0, 0]",180,106,74,9,12,0.08490566037735849,0.16216216216216217
"[0, 1, 0, 0, 0, 0, 0, 0, 1, 1, 1, 0, 1, 0, 1]",161,95,66,7,7,0.07368421052631578,0.10606060606060606
"[0, 1, 1, 1, 0, 1, 1, 0, 1, 0, 1, 1, 1, 0, 0]",142,55,87,6,12,0.10909090909090909,0.13793103448275862
"[1, 1, 0, 1, 1, 0, 1, 1, 0, 0, 0, 1, 0, 0, 1]",121,56,65,2,8,0.03571428571428571,0.12307692307692308
"[1, 1, 1, 1, 1, 0, 1, 0, 0, 0, 0, 0, 0, 1, 0]",122,50,72,5,9,0.1,0.125
"[0, 1, 0, 1, 0, 1, 1, 1, 1, 1, 0, 0, 1, 0, 0]",134,58,76,11,7,0.1896551724137931,0.09210526315789473
"[1, 0, 0, 1, 0, 1, 0, 0, 0, 0, 0, 1, 0, 0, 1]",218,139,79,11,11,0.07913669064748201,0.13924050632911392
"[1, 0, 1, 1, 1, 0, 1, 0, 0, 0, 1, 0, 0, 0, 0]",139,88,51,14,4,0.1590909090909091,0.0784313725490196
"[0, 0, 1, 0, 0, 1, 1, 0, 0, 0, 1, 0, 1, 1, 1]",154,83,71,5,5,0.060240963855421686,0.07042253521126761
"[1, 0, 0, 1, 0, 0, 1, 1, 0, 0, 0, 1, 0, 1, 1]",129,65,64,6,3,0.09230769230769231,0.046875
"[0, 1, 1, 1, 0, 0, 1, 1, 1, 1, 0, 0, 1, 0, 0]",145,63,82,7,13,0.1111111111111111,0.15853658536585366
"[0, 0, 1, 1, 1, 0, 0, 0, 0, 0, 0, 1, 0, 0, 1]",335,227,108,24,10,0.10572687224669604,0.09259259259259259
"[1, 1, 0, 1, 0, 1, 1, 0, 0, 0, 1, 0, 0, 0, 1]",108,55,53,4,4,0.07272727272727272,0.07547169811320754
"[0, 0, 1, 1, 0, 1, 1, 0, 1, 0, 1, 1, 0, 0, 0]",122,71,51,11,2,0.15492957746478872,0.0392156862745098
"[1, 0, 0, 0, 1, 1, 0, 1, 1, 0, 1, 0, 1, 1, 0]",118,58,60,8,1,0.13793103448275862,0.016666666666666666
"[1, 1, 0, 0, 1, 1, 1, 0, 1, 0, 1, 1, 1, 0, 1]",209,75,134,13,19,0.17333333333333334,0.1417910447761194
"[1, 1, 1, 1, 0, 1, 1, 1, 0, 1, 1, 0, 0, 0, 0]",245,88,157,10,19,0.11363636363636363,0.12101910828025478
"[0, 0, 0, 1, 1, 0, 1, 0, 1, 1, 0, 1, 0, 1, 1]",116,51,65,6,6,0.11764705882352941,0.09230769230769231
"[0, 0, 1, 0, 0, 1, 0, 1, 1, 0, 0, 0, 0, 1, 1]",243,136,107,15,8,0.11029411764705882,0.07476635514018691
"[0, 1, 0, 0, 1, 1, 1, 0, 1, 1, 0, 0, 0, 0, 0]",202,113,89,13,9,0.11504424778761062,0.10112359550561797
"[0, 0, 0, 1, 0, 0, 0, 1, 0, 0, 1, 1, 1, 0, 1]",145,72,73,4,6,0.05555555555555555,0.0821917808219178
"[1, 1, 0, 1, 0, 1, 1, 1, 0, 0, 1, 0, 1, 1, 0]",153,69,84,4,10,0.057971014492753624,0.11904761904761904
"[0, 0, 1, 1, 1, 0, 1, 0, 1, 1, 0, 1, 0, 1, 0]",132,56,76,8,6,0.14285714285714285,0.07894736842105263
"[1, 0, 0, 0, 1, 1, 0, 0, 0, 0, 1, 0, 1, 0, 0]",260,156,104,9,9,0.057692307692307696,0.08653846153846154
"[0, 1, 0, 0, 0, 1, 1, 0, 0, 0, 0, 1, 0, 1, 0]",252,160,92,16,6,0.1,0.06521739130434782
"[1, 0, 0, 1, 1, 1, 1, 1, 1, 1, 0, 1, 1, 0, 0]",359,115,244,8,26,0.06956521739130435,0.10655737704918032
"[0, 1, 1, 0, 1, 1, 0, 0, 1, 0, 1, 1, 0, 1, 1]",126,57,69,5,9,0.08771929824561403,0.13043478260869565
"[0, 0, 0, 0, 1, 1, 0, 1, 1, 1, 1, 1, 0, 1, 0]",115,51,64,5,7,0.09803921568627451,0.109375
"[0, 1, 0, 1, 1, 1, 1, 0, 0, 1, 0, 1, 0, 1, 1]",172,62,110,7,12,0.11290322580645161,0.10909090909090909
"[1, 1, 0, 1, 0, 0, 0, 1, 0, 1, 1, 1, 1, 0, 0]",145,67,78,7,4,0.1044776119402985,0.05128205128205128
"[0, 1, 1, 0, 0, 1, 1, 0, 1, 1, 1, 0, 1, 0, 0]",121,56,65,3,8,0.05357142857142857,0.12307692307692308
"[1, 0, 1, 1, 0, 0, 1, 0, 1, 1, 0, 1, 1, 0, 1]",121,47,74,3,3,0.06382978723404255,0.04054054054054054
"[0, 1, 0, 0, 1, 1, 1, 1, 0, 1, 1, 1, 1, 1, 1]",724,231,493,17,46,0.0735930735930736,0.09330628803245436
"[1, 0, 0, 0, 0, 0, 1, 1, 1, 0, 0, 1, 0, 0, 1]",159,95,64,11,5,0.11578947368421053,0.078125
"[1, 1, 0, 0, 1, 0, 1, 0, 0, 1, 0, 1, 1, 1, 1]",206,92,114,5,13,0.05434782608695652,0.11403508771929824
"[1, 1, 1, 1, 1, 0, 0, 0, 1, 1, 1, 0, 1, 0, 1]",268,83,185,9,16,0.10843373493975904,0.08648648648648649
"[1, 0, 1, 1, 0, 1, 0, 0, 1, 1, 1, 0, 0, 1, 1]",183,83,100,5,12,0.060240963855421686,0.12
"[1, 1, 1, 0, 0, 0, 1, 1, 0, 1, 0, 0, 0, 0, 0]",192,96,96,5,12,0.052083333333333336,0.125
"[1, 0, 1, 1, 1, 1, 0, 0, 0, 0, 0, 1, 1, 1, 1]",314,138,176,9,18,0.06521739130434782,0.10227272727272728
"[1, 0, 0, 1, 1, 1, 0, 0, 1, 1, 0, 1, 1, 1, 1]",299,102,197,3,19,0.029411764705882353,0.09644670050761421
"[0, 0, 1, 0, 0, 1, 1, 1, 0, 0, 1, 1, 0, 1, 1]",143,70,73,9,7,0.12857142857142856,0.0958904109589041
"[0, 0, 1, 0, 1, 1, 1, 1, 0, 1, 1, 1, 1, 1, 0]",268,98,170,12,21,0.12244897959183673,0.12352941176470589
"[0, 1, 0, 0, 1, 1, 1, 1, 0, 1, 1, 0, 0, 0, 0]",155,77,78,8,14,0.1038961038961039,0.1794871794871795
"[1, 0, 0, 0, 1, 0, 0, 1, 1, 1, 1, 0, 0, 1, 0]",128,71,57,8,3,0.11267605633802817,0.05263157894736842
"[1, 0, 1, 0, 1, 0, 1, 1, 0, 1, 0, 1, 0, 1, 0]",101,57,44,5,4,0.08771929824561403,0.09090909090909091
"[1, 0, 1, 0, 0, 1, 0, 0, 1, 0, 0, 0, 0, 1, 0]",217,148,69,10,6,0.06756756756756757,0.08695652173913043
"[1, 0, 0, 1, 1, 1, 1, 0, 1, 0, 0, 0, 0, 1, 1]",198,83,115,7,14,0.08433734939759036,0.12173913043478261
"[1, 0, 0, 1, 0, 0, 1, 1, 1, 1, 0, 1, 0, 0, 0]",140,80,60,9,9,0.1125,0.15
"[0, 0, 0, 0, 1, 0, 1, 1, 1, 1, 1, 0, 0, 0, 1]",133,65,68,13,3,0.2,0.04411764705882353
"[0, 0, 1, 0, 1, 0, 0, 0, 1, 1, 1, 1, 0, 1, 1]",133,65,68,6,6,0.09230769230769231,0.08823529411764706
"[0, 1, 1, 1, 0, 1, 1, 1, 0, 0, 0, 1, 1, 1, 1]",348,158,190,14,16,0.08860759493670886,0.08421052631578947
"[1, 1, 0, 1, 0, 1, 0, 1, 1, 1, 0, 1, 1, 1, 1]",603,173,430,12,42,0.06936416184971098,0.09767441860465116
"[0, 1, 1, 1, 1, 0, 1, 0, 1, 0, 1, 1, 1, 1, 0]",278,123,155,11,12,0.08943089430894309,0.07741935483870968
"[1, 1, 0, 1, 1, 0, 0, 0, 1, 1, 0, 1, 1, 0, 1]",130,58,72,5,10,0.08620689655172414,0.1388888888888889
"[1, 0, 0, 0, 1, 1, 0, 1, 0, 0, 0, 0, 1, 0, 1]",124,75,49,9,3,0.12,0.061224489795918366
"[1, 1, 1, 0, 1, 0, 1, 0, 0, 1, 1, 0, 1, 1, 1]",265,94,171,8,12,0.0851063829787234,0.07017543859649122
"[0, 0, 0, 1, 0, 1, 1, 0, 1, 1, 1, 0, 0, 1, 0]",111,57,54,8,2,0.14035087719298245,0.037037037037037035
"[0, 1, 1, 0, 0, 1, 0, 0, 1, 1, 1, 1, 0, 0, 0]",213,128,85,16,12,0.125,0.1411764705882353
"[0, 1, 1, 1, 1, 1, 1, 0, 0, 0, 0, 0, 0, 1, 0]",374,288,86,23,14,0.0798611111111111,0.16279069767441862
"[1, 0, 0, 1, 1, 1, 0, 1, 1, 1, 0, 1, 0, 0, 1]",154,54,100,4,9,0.07407407407407407,0.09
"[1, 1, 1, 0, 1, 1, 0, 0, 0, 0, 1, 1, 1, 1, 1]",689,232,457,27,41,0.11637931034482758,0.08971553610503283
"[1, 0, 0, 0, 0, 0, 0, 1, 0, 1, 1, 1, 0, 0, 0]",309,189,120,19,10,0.10052910052910052,0.08333333333333333
"[1, 1, 1, 0, 0, 0, 1, 1, 0, 0, 0, 1, 0, 0, 0]",162,91,71,2,6,0.02197802197802198,0.08450704225352113
"[1, 1, 1, 1, 0, 0, 1, 1, 1, 0, 0, 1, 0, 1, 1]",355,150,205,18,20,0.12,0.0975609756097561
"[1, 1, 0, 1, 0, 1, 0, 1, 0, 0, 1, 0, 1, 0, 0]",99,55,44,7,9,0.12727272727272726,0.20454545454545456
"[1, 1, 1, 0, 1, 0, 1, 0, 1, 0, 0, 1, 0, 1, 0]",101,50,51,2,4,0.04,0.0784313725490196
"[0, 0, 1, 1, 1, 0, 1, 1, 1, 0, 1, 0, 1, 0, 1]",138,70,68,8,8,0.11428571428571428,0.11764705882352941
"[1, 0, 1, 1, 0, 1, 1, 0, 0, 0, 0, 1, 1, 0, 1]",142,69,73,9,7,0.13043478260869565,0.0958904109589041
"[0, 0, 0, 1, 0, 0, 1, 1, 1, 1, 1, 0, 0, 1, 1]",217,112,105,10,9,0.08928571428571429,0.08571428571428572
"[0, 0, 1, 1, 1, 0, 1, 0, 0, 1, 0, 0, 1, 1, 0]",133,77,56,6,6,0.07792207792207792,0.10714285714285714
"[0, 0, 1, 0, 0, 1, 1, 1, 0, 1, 0, 0, 1, 0, 0]",161,101,60,8,6,0.07920792079207921,0.1
"[0, 1, 0, 0, 0, 1, 0, 1, 1, 0, 0, 0, 0, 1, 0]",233,152,81,10,8,0.06578947368421052,0.09876543209876543
"[0, 0, 0, 1, 1, 1, 0, 0, 0, 0, 1, 0, 1, 0, 0]",264,177,87,15,14,0.0847457627118644,0.16091954022988506
"[0, 0, 0, 1, 0, 1, 1, 0, 0, 0, 1, 1, 1, 0, 0]",164,110,54,7,7,0.06363636363636363,0.12962962962962962
"[1, 0, 1, 1, 0, 1, 0, 1, 0, 0, 0, 0, 1, 0, 0]",148,93,55,14,3,0.15053763440860216,0.05454545454545454
"[1, 1, 0, 1, 1, 0, 1, 0, 1, 0, 0, 0, 0, 1, 0]",108,59,49,4,5,0.06779661016949153,0.10204081632653061
"[1, 1, 1, 0, 0, 1, 1, 0, 1, 0, 1, 1, 0, 1, 0]",145,59,86,13,4,0.22033898305084745,0.046511627906976744
"[0, 1, 0, 1, 0, 1, 0, 1, 1, 1, 0, 0, 1, 1, 0]",129,66,63,9,7,0.13636363636363635,0.1111111111111111
"[0, 1, 0, 0, 0, 1, 0, 0, 0, 0, 0, 1, 1, 1, 0]",269,179,90,16,5,0.0893854748603352,0.05555555555555555
"[0, 0, 0, 1, 1, 1, 0, 1, 1, 1, 1, 0, 1, 0, 1]",136,68,68,7,8,0.10294117647058823,0.11764705882352941
"[0, 1, 1, 1, 0, 1, 0, 1, 0, 1, 1, 0, 0, 0, 0]",144,76,68,4,4,0.05263157894736842,0.058823529411764705
"[1, 0, 0, 1, 1, 1, 0, 1, 0, 1, 0, 1, 1, 0, 0]",133,49,84,3,5,0.061224489795918366,0.05952380952380952
"[1, 1, 0, 0, 1, 1, 1, 0, 1, 0, 1, 0, 1, 1, 0]",160,54,106,5,10,0.09259259259259259,0.09433962264150944
"[1, 1, 1, 1, 0, 0, 0, 1, 1, 0, 0, 0, 1, 1, 0]",151,76,75,7,7,0.09210526315789473,0.09333333333333334
"[0, 1, 0, 0, 0, 0, 0, 1, 1, 0, 1, 1, 1, 0, 0]",159,91,68,6,1,0.06593406593406594,0.014705882352941176
"[0, 0, 1, 1, 1, 1, 0, 1, 1, 1, 0, 0, 1, 0, 0]",125,65,60,6,5,0.09230769230769231,0.08333333333333333
"[1, 0, 1, 0, 0, 1, 1, 1, 1, 0, 1, 1, 1, 0, 0]",174,78,96,5,10,0.0641025641025641,0.10416666666666667
"[1, 1, 0, 1, 0, 0, 1, 1, 1, 1, 0, 1, 1, 1, 0]",235,85,150,6,16,0.07058823529411765,0.10666666666666667
"[0, 0, 0, 1, 1, 0, 1, 0, 0, 1, 1, 0, 1, 1, 1]",137,72,65,3,9,0.041666666666666664,0.13846153846153847
"[1, 1, 0, 1, 0, 1, 0, 0, 1, 1, 0, 0, 1, 1, 0]",184,88,96,16,8,0.18181818181818182,0.08333333333333333
"[1, 1, 0, 1, 1, 1, 1, 0, 0, 1, 0, 0, 1, 0, 1]",138,63,75,4,2,0.06349206349206349,0.02666666666666667
"[1, 0, 1, 0, 1, 1, 0, 1, 0, 1, 1, 0, 1, 1, 1]",250,81,169,7,19,0.08641975308641975,0.11242603550295859
"[1, 1, 0, 1, 1, 0, 1, 1, 0, 1, 0, 1, 1, 0, 1]",201,61,140,4,12,0.06557377049180328,0.08571428571428572
"[0, 0, 1, 0, 0, 0, 1, 1, 0, 0, 1, 1, 1, 1, 0]",299,159,140,15,15,0.09433962264150944,0.10714285714285714
"[0, 1, 1, 1, 0, 0, 1, 1, 0, 0, 1, 0, 1, 1, 0]",142,67,75,6,7,0.08955223880597014,0.09333333333333334
"[0, 0, 1, 1, 1, 0, 0, 1, 1, 0, 0, 1, 0, 1, 1]",153,71,82,4,10,0.056338028169014086,0.12195121951219512
"[1, 0, 1, 0, 0, 0, 1, 1, 1, 0, 0, 1, 1, 0, 0]",187,83,104,7,6,0.08433734939759036,0.057692307692307696
"[0, 0, 0, 1, 0, 1, 1, 0, 0, 0, 0, 1, 0, 1, 1]",147,86,61,11,7,0.12790697674418605,0.11475409836065574
"[1, 0, 1, 0, 0, 0, 1, 1, 0, 0, 1, 1, 1, 0, 1]",126,52,74,4,5,0.07692307692307693,0.06756756756756757
"[1, 0, 0, 0, 1, 0, 1, 1, 1, 1, 0, 0, 1, 1, 0]",191,86,105,7,9,0.08139534883720931,0.08571428571428572
"[1, 0, 0, 1, 0, 1, 0, 0, 1, 0, 1, 1, 0, 0, 1]",134,68,66,5,5,0.07352941176470588,0.07575757575757576
"[1, 1, 1, 1, 0, 0, 1, 1, 1, 0, 0, 0, 0, 1, 0]",135,64,71,3,8,0.046875,0.11267605633802817
"[1, 0, 0, 0, 1, 0, 1, 1, 1, 0, 0, 0, 0, 1, 0]",124,66,58,9,5,0.13636363636363635,0.08620689655172414
"[0, 0, 0, 1, 1, 0, 1, 1, 1, 0, 0, 0, 0, 0, 0]",380,253,127,25,14,0.09881422924901186,0.11023622047244094
"[0, 1, 1, 0, 1, 1, 0, 1, 0, 1, 0, 0, 1, 1, 1]",162,71,91,5,7,0.07042253521126761,0.07692307692307693
"[0, 1, 1, 1, 0, 1, 0, 1, 0, 1, 0, 1, 1, 0, 1]",135,56,79,2,8,0.03571428571428571,0.10126582278481013
"[1, 0, 0, 1, 0, 1, 0, 0, 1, 1, 1, 0, 0, 1, 1]",164,80,84,6,8,0.075,0.09523809523809523
"[0, 0, 1, 1, 0, 0, 1, 1, 0, 1, 0, 1, 0, 1, 0]",127,70,57,7,9,0.1,0.15789473684210525
"[0, 0, 1, 0, 1, 0, 0, 1, 0, 0, 1, 0, 0, 1, 0]",219,148,71,15,7,0.10135135135135136,0.09859154929577464
"[0, 1, 0, 1, 0, 0, 1, 0, 0, 1, 1, 0, 1, 0, 0]",145,82,63,11,5,0.13414634146341464,0.07936507936507936
"[1, 0, 0, 0, 1, 1, 0, 0, 1, 0, 1, 0, 0, 1, 0]",140,81,59,10,7,0.12345679012345678,0.11864406779661017
"[0, 0, 0, 1, 1, 1, 0, 1, 1, 0, 1, 1, 1, 0, 1]",139,63,76,6,10,0.09523809523809523,0.13157894736842105
"[0, 1, 1, 1, 1, 1, 1, 0, 0, 0, 1, 1, 0, 1, 1]",382,192,190,29,20,0.15104166666666666,0.10526315789473684
"[1, 0, 0, 1, 0, 0, 0, 1, 0, 0, 1, 0, 1, 1, 1]",136,61,75,6,4,0.09836065573770492,0.05333333333333334
"[1, 0, 0, 1, 0, 1, 1, 1, 1, 0, 1, 1, 0, 0, 1]",161,64,97,5,8,0.078125,0.08247422680412371
"[0, 0, 1, 1, 1, 0, 0, 0, 0, 1, 1, 0, 1, 1, 0]",151,75,76,11,5,0.14666666666666667,0.06578947368421052
"[1, 1, 1, 1, 1, 1, 0, 1, 0, 0, 0, 1, 0, 0, 1]",153,56,97,10,12,0.17857142857142858,0.12371134020618557
"[0, 1, 0, 0, 1, 1, 1, 0, 1, 1, 0, 1, 1, 1, 0]",117,50,67,5,5,0.1,0.07462686567164178
"[1, 1, 1, 0, 1, 1, 1, 1, 0, 0, 0, 0, 0, 1, 0]",134,70,64,6,6,0.08571428571428572,0.09375
"[0, 1, 0, 0, 1, 1, 0, 1, 0, 0, 0, 1, 0, 1, 0]",138,68,70,5,9,0.07352941176470588,0.12857142857142856
"[0, 0, 0, 1, 0, 0, 1, 0, 1, 0, 1, 1, 1, 1, 0]",122,69,53,7,11,0.10144927536231885,0.20754716981132076
"[0, 1, 0, 1, 1, 1, 0, 1, 0, 0, 1, 0, 0, 0, 1]",105,58,47,6,7,0.10344827586206896,0.14893617021276595
"[0, 1, 1, 1, 1, 0, 0, 1, 1, 1, 1, 0, 1, 0, 1]",413,225,188,29,19,0.1288888888888889,0.10106382978723404
"[0, 0, 1, 1, 0, 1, 0, 1, 0, 1, 1, 1, 0, 0, 1]",123,58,65,7,5,0.1206896551724138,0.07692307692307693
"[1, 1, 0, 1, 0, 1, 1, 0, 1, 0, 1, 1, 0, 0, 0]",128,51,77,9,9,0.17647058823529413,0.11688311688311688
"[1, 1, 1, 1, 0, 1, 0, 1, 1, 0, 1, 0, 1, 1, 0]",251,91,160,7,13,0.07692307692307693,0.08125
"[1, 0, 1, 1, 1, 0, 0, 1, 1, 1, 0, 1, 0, 0, 1]",154,59,95,5,8,0.0847457627118644,0.08421052631578947
"[1, 0, 1, 0, 1, 1, 1, 0, 0, 1, 1, 1, 0, 1, 0]",142,62,80,6,8,0.0967741935483871,0.1
"[1, 0, 0, 1, 0, 1, 1, 0, 1, 1, 0, 1, 1, 1, 1]",283,95,188,8,19,0.08421052631578947,0.10106382978723404
"[1, 1, 0, 1, 0, 0, 0, 0, 1, 0, 1, 0, 0, 1, 1]",140,73,67,6,5,0.0821917808219178,0.07462686567164178
"[1, 1, 1, 1, 0, 0, 1, 1, 0, 1, 0, 1, 0, 0, 1]",203,95,108,12,17,0.12631578947368421,0.1574074074074074
"[0, 0, 0, 0, 0, 1, 1, 1, 0, 0, 0, 1, 0, 1, 0]",272,191,81,14,6,0.07329842931937172,0.07407407407407407
"[0, 1, 1, 0, 1, 0, 0, 1, 0, 0, 0, 1, 0, 1, 0]",136,88,48,6,7,0.06818181818181818,0.14583333333333334
"[0, 1, 1, 0, 0, 1, 1, 0, 1, 0, 0, 1, 0, 0, 0]",185,124,61,16,8,0.12903225806451613,0.13114754098360656
"[1, 0, 1, 0, 1, 1, 1, 1, 0, 0, 0, 0, 1, 1, 0]",265,111,154,10,17,0.09009009009009009,0.11038961038961038
"[0, 1, 1, 1, 1, 0, 1, 0, 1, 1, 1, 1, 0, 0, 0]",214,85,129,10,13,0.11764705882352941,0.10077519379844961
"[0, 1, 1, 1, 1, 1, 0, 1, 0, 0, 1, 1, 0, 1, 1]",270,100,170,9,10,0.09,0.058823529411764705
"[1, 0, 1, 0, 0, 0, 0, 0, 1, 0, 1, 1, 1, 1, 1]",161,93,68,7,4,0.07526881720430108,0.058823529411764705
"[1, 1, 0, 1, 0, 1, 1, 1, 0, 1, 0, 1, 0, 1, 1]",234,81,153,8,9,0.09876543209876543,0.058823529411764705
"[0, 0, 0, 1, 0, 1, 1, 0, 0, 1, 1, 0, 1, 0, 1]",116,66,50,6,6,0.09090909090909091,0.12
"[0, 0, 0, 0, 0, 1, 0, 0, 1, 1, 0, 1, 1, 0, 1]",165,103,62,6,2,0.05825242718446602,0.03225806451612903
"[1, 0, 0, 1, 0, 1, 1, 1, 0, 1, 1, 1, 1, 0, 1]",226,73,153,6,15,0.0821917808219178,0.09803921568627451
"[0, 1, 0, 0, 0, 0, 0, 1, 0, 1, 1, 1, 0, 0, 0]",294,197,97,20,8,0.10152284263959391,0.08247422680412371
"[0, 0, 0, 1, 1, 0, 0, 0, 1, 1, 0, 0, 1, 0, 1]",186,141,45,18,5,0.1276595744680851,0.1111111111111111
"[0, 1, 1, 1, 1, 1, 0, 1, 1, 0, 0, 1, 1, 1, 0]",255,101,154,16,17,0.15841584158415842,0.11038961038961038
"[0, 0, 0, 1, 0, 0, 1, 1, 0, 1, 0, 0, 1, 1, 1]",181,109,72,8,2,0.07339449541284404,0.027777777777777776
"[0, 0, 1, 1, 1, 0, 0, 0, 1, 0, 1, 0, 1, 0, 1]",119,57,62,3,3,0.05263157894736842,0.04838709677419355
"[0, 1, 0, 0, 0, 0, 0, 1, 0, 0, 1, 0, 1, 0, 0]",471,346,125,45,9,0.13005780346820808,0.072
"[1, 0, 1, 0, 0, 1, 0, 0, 1, 1, 1, 1, 0, 1, 1]",155,59,96,4,9,0.06779661016949153,0.09375
"[1, 0, 0, 0, 1, 1, 0, 1, 1, 0, 0, 0, 1, 1, 1]",172,91,81,12,12,0.13186813186813187,0.14814814814814814
"[1, 1, 1, 0, 1, 0, 1, 0, 1, 0, 0, 1, 1, 0, 1]",134,43,91,4,5,0.09302325581395349,0.054945054945054944
"[1, 1, 0, 1, 1, 1, 1, 0, 0, 1, 1, 1, 0, 1, 1]",595,167,428,15,37,0.08982035928143713,0.08644859813084112
"[0, 1, 1, 1, 0, 1, 1, 0, 1, 0, 0, 0, 1, 0, 0]",97,62,35,8,2,0.12903225806451613,0.05714285714285714
"[1, 0, 1, 0, 1, 1, 1, 0, 0, 1, 0, 0, 0, 0, 1]",133,59,74,4,9,0.06779661016949153,0.12162162162162163
"[0, 0, 0, 0, 1, 1, 1, 0, 1, 0, 0, 1, 1, 0, 0]",186,107,79,13,10,0.12149532710280374,0.12658227848101267
"[1, 0, 1, 1, 0, 1, 1, 0, 0, 0, 1, 1, 0, 0, 1]",155,75,80,5,16,0.06666666666666667,0.2
"[0, 1, 1, 1, 0, 0, 0, 1, 1, 0, 0, 1, 1, 0, 1]",95,40,55,7,5,0.175,0.09090909090909091
"[0, 0, 1, 1, 1, 0, 1, 0, 0, 1, 1, 1, 1, 1, 0]",174,76,98,7,13,0.09210526315789473,0.1326530612244898
"[0, 0, 0, 1, 0, 0, 1, 0, 1, 0, 1, 1, 0, 1, 0]",115,66,49,5,3,0.07575757575757576,0.061224489795918366
"[0, 0, 1, 0, 1, 0, 0, 1, 1, 0, 1, 0, 0, 0, 0]",238,160,78,10,7,0.0625,0.08974358974358974
"[0, 0, 1, 0, 1, 0, 0, 0, 1, 1, 1, 0, 1, 1, 0]",106,51,55,4,4,0.0784313725490196,0.07272727272727272
"[1, 0, 0, 1, 1, 0, 1, 1, 0, 1, 0, 0, 1, 0, 0]",121,57,64,4,8,0.07017543859649122,0.125
"[0, 0, 0, 1, 0, 1, 0, 0, 1, 1, 0, 0, 0, 1, 0]",255,175,80,15,8,0.08571428571428572,0.1
"[0, 0, 0, 1, 0, 0, 0, 1, 0, 1, 1, 1, 0, 0, 1]",145,93,52,10,3,0.10752688172043011,0.057692307692307696
"[1, 0, 0, 0, 1, 1, 0, 0, 0, 1, 1, 1, 1, 0, 0]",201,105,96,12,10,0.11428571428571428,0.10416666666666667
"[0, 1, 1, 0, 1, 0, 0, 0, 1, 0, 1, 1, 0, 1, 1]",101,55,46,2,6,0.03636363636363636,0.13043478260869565
"[1, 1, 1, 0, 0, 0, 0, 0, 1, 0, 1, 0, 0, 0, 1]",180,88,92,11,10,0.125,0.10869565217391304
"[1, 1, 1, 1, 1, 0, 0, 1, 0, 0, 0, 1, 1, 1, 0]",160,54,106,3,12,0.05555555555555555,0.11320754716981132
"[0, 1, 0, 1, 0, 0, 0, 0, 0, 1, 1, 1, 0, 0, 1]",188,109,79,4,10,0.03669724770642202,0.12658227848101267
"[1, 1, 1, 0, 0, 1, 0, 1, 0, 0, 1, 0, 1, 1, 0]",133,53,80,12,9,0.22641509433962265,0.1125
"[0, 0, 0, 1, 0, 0, 1, 1, 1, 1, 1, 1, 0, 0, 1]",310,157,153,14,11,0.08917197452229299,0.0718954248366013
"[1, 0, 1, 1, 0, 1, 1, 1, 1, 0, 1, 0, 1, 0, 1]",220,57,163,7,11,0.12280701754385964,0.06748466257668712
"[1, 1, 1, 1, 1, 0, 1, 0, 0, 1, 1, 0, 1, 1, 0]",228,85,143,6,16,0.07058823529411765,0.11188811188811189
"[1, 1, 0, 1, 0, 1, 0, 0, 1, 1, 0, 0, 1, 0, 1]",101,46,55,6,8,0.13043478260869565,0.14545454545454545
"[0, 0, 1, 1, 1, 0, 1, 0, 0, 1, 0, 0, 1, 0, 1]",102,49,53,3,5,0.061224489795918366,0.09433962264150944
"[1, 0, 0, 0, 0, 1, 1, 1, 0, 1, 0, 1, 1, 1, 1]",286,93,193,10,22,0.10752688172043011,0.11398963730569948
"[0, 1, 0, 1, 1, 1, 0, 0, 1, 0, 1, 1, 0, 0, 1]",117,60,57,6,6,0.1,0.10526315789473684
"[0, 0, 1, 0, 1, 0, 0, 1, 0, 0, 0, 0, 1, 0, 1]",229,165,64,18,6,0.10909090909090909,0.09375
"[1, 0, 0, 1, 0, 1, 0, 1, 0, 0, 1, 1, 1, 0, 1]",104,44,60,6,6,0.13636363636363635,0.1
"[0, 1, 1, 1, 0, 0, 1, 0, 1, 0, 1, 0, 0, 1, 1]",133,67,66,8,7,0.11940298507462686,0.10606060606060606
"[0, 1, 0, 1, 1, 0, 1, 1, 1, 1, 1, 0, 0, 0, 0]",192,92,100,6,9,0.06521739130434782,0.09
"[0, 0, 0, 0, 1, 1, 1, 1, 0, 1, 1, 1, 1, 1, 0]",250,103,147,7,17,0.06796116504854369,0.11564625850340136
"[1, 1, 0, 1, 1, 0, 1, 1, 0, 1, 0, 1, 1, 0, 0]",151,60,91,3,10,0.05,0.10989010989010989
"[0, 0, 0, 1, 1, 1, 1, 1, 1, 1, 1, 1, 0, 1, 0]",433,238,195,25,20,0.10504201680672269,0.10256410256410256
"[1, 1, 0, 1, 0, 1, 0, 1, 0, 1, 0, 1, 1, 1, 1]",264,74,190,10,22,0.13513513513513514,0.11578947368421053
"[1, 0, 1, 0, 1, 0, 0, 1, 0, 0, 1, 0, 1, 1, 1]",106,51,55,6,4,0.11764705882352941,0.07272727272727272
"[0, 1, 0, 1, 1, 0, 1, 1, 1, 0, 0, 0, 0, 0, 0]",241,145,96,11,2,0.07586206896551724,0.020833333333333332
"[0, 1, 1, 1, 0, 1, 1, 1, 0, 0, 1, 0, 1, 0, 0]",127,60,67,6,5,0.1,0.07462686567164178
"[0, 1, 1, 0, 1, 1, 0, 0, 0, 0, 0, 1, 1, 1, 1]",272,134,138,13,9,0.09701492537313433,0.06521739130434782
"[0, 1, 0, 1, 1, 1, 1, 1, 0, 0, 0, 1, 1, 0, 1]",143,65,78,9,11,0.13846153846153847,0.14102564102564102
"[0, 0, 1, 1, 0, 0, 0, 1, 0, 0, 1, 0, 0, 0, 1]",258,173,85,21,7,0.12138728323699421,0.08235294117647059
"[0, 0, 0, 0, 1, 1, 1, 0, 1, 0, 1, 0, 1, 0, 1]",120,69,51,6,5,0.08695652173913043,0.09803921568627451
"[1, 0, 0, 0, 0, 0, 1, 1, 1, 0, 1, 0, 1, 0, 1]",124,60,64,7,4,0.11666666666666667,0.0625
"[1, 1, 0, 1, 0, 0, 0, 0, 0, 1, 1, 1, 0, 1, 0]",107,57,50,8,5,0.14035087719298245,0.1
"[1, 1, 0, 0, 0, 0, 1, 1, 0, 1, 1, 1, 0, 1, 0]",138,65,73,7,9,0.1076923076923077,0.1232876712328767
"[1, 0, 1, 1, 1, 0, 0, 0, 0, 1, 0, 1, 1, 1, 1]",195,75,120,9,15,0.12,0.125
"[1, 1, 1, 1, 1, 1, 1, 0, 1, 0, 0, 0, 0, 0, 0]",279,126,153,15,20,0.11904761904761904,0.13071895424836602
"[1, 0, 1, 1, 0, 1, 1, 0, 1, 0, 1, 1, 1, 1, 0]",255,99,156,9,22,0.09090909090909091,0.14102564102564102
"[1, 0, 1, 1, 0, 0, 0, 0, 0, 1, 0, 0, 0, 1, 0]",230,139,91,17,7,0.1223021582733813,0.07692307692307693
"[0, 1, 0, 0, 0, 0, 1, 1, 0, 1, 0, 0, 0, 1, 1]",201,132,69,9,2,0.06818181818181818,0.028985507246376812
"[1, 0, 1, 0, 0, 0, 1, 1, 0, 0, 1, 0, 1, 1, 1]",129,67,62,6,9,0.08955223880597014,0.14516129032258066
"[0, 0, 1, 1, 0, 0, 0, 1, 1, 1, 1, 1, 0, 1, 1]",204,78,126,10,14,0.1282051282051282,0.1111111111111111
"[1, 1, 0, 1, 0, 0, 1, 0, 1, 1, 1, 1, 1, 0, 0]",202,79,123,9,12,0.11392405063291139,0.0975609756097561
"[1, 0, 1, 1, 1, 1, 1, 0, 0, 0, 1, 0, 1, 1, 0]",117,41,76,4,7,0.0975609756097561,0.09210526315789473
"[1, 0, 1, 0, 0, 0, 1, 1, 0, 1, 1, 0, 1, 1, 1]",157,71,86,9,5,0.1267605633802817,0.05813953488372093
"[1, 1, 0, 1, 1, 0, 0, 1, 1, 1, 1, 0, 1, 0, 1]",243,91,152,8,12,0.08791208791208792,0.07894736842105263
"[1, 1, 0, 0, 1, 0, 1, 1, 0, 0, 0, 1, 1, 1, 1]",228,100,128,11,10,0.11,0.078125
"[0, 1, 1, 1, 1, 0, 0, 1, 0, 1, 1, 0, 0, 0, 1]",136,76,60,13,3,0.17105263157894737,0.05
"[1, 1, 0, 1, 0, 0, 0, 1, 0, 0, 0, 0, 1, 1, 1]",206,129,77,16,12,0.12403100775193798,0.15584415584415584
"[1, 1, 1, 0, 1, 0, 0, 0, 1, 0, 0, 0, 0, 1, 1]",142,63,79,6,12,0.09523809523809523,0.1518987341772152
"[0, 1, 1, 1, 0, 1, 0, 0, 0, 1, 0, 0, 0, 0, 1]",138,81,57,8,7,0.09876543209876543,0.12280701754385964
"[0, 1, 1, 0, 1, 1, 1, 1, 0, 1, 1, 1, 1, 0, 1]",478,144,334,18,44,0.125,0.1317365269461078
"[1, 1, 1, 0, 1, 1, 0, 0, 1, 0, 1, 0, 0, 1, 0]",114,53,61,3,2,0.05660377358490566,0.03278688524590164
"[1, 0, 0, 0, 0, 0, 1, 1, 1, 0, 1, 0, 1, 1, 1]",162,64,98,7,13,0.109375,0.1326530612244898
"[0, 0, 1, 0, 0, 1, 1, 1, 1, 0, 1, 1, 1, 1, 1]",347,125,222,10,19,0.08,0.08558558558558559
"[1, 0, 1, 0, 0, 0, 0, 0, 0, 0, 1, 1, 0, 1, 1]",186,113,73,9,3,0.07964601769911504,0.0410958904109589
"[0, 0, 1, 0, 1, 0, 0, 0, 1, 1, 1, 1, 1, 1, 0]",228,109,119,9,7,0.08256880733944955,0.058823529411764705
"[1, 0, 1, 0, 1, 0, 0, 1, 1, 1, 1, 0, 0, 1, 0]",113,57,56,5,8,0.08771929824561403,0.14285714285714285
"[0, 1, 0, 1, 0, 1, 0, 0, 1, 1, 1, 1, 0, 0, 1]",168,82,86,13,7,0.15853658536585366,0.08139534883720931
"[0, 0, 1, 1, 1, 0, 0, 1, 0, 0, 0, 0, 1, 1, 1]",234,121,113,9,13,0.0743801652892562,0.11504424778761062
"[1, 1, 1, 0, 0, 1, 0, 0, 1, 1, 1, 1, 0, 0, 0]",206,83,123,10,7,0.12048192771084337,0.056910569105691054
"[0, 1, 1, 0, 1, 0, 1, 1, 1, 1, 0, 0, 1, 0, 0]",111,56,55,7,7,0.125,0.12727272727272726
"[1, 1, 1, 0, 0, 0, 1, 1, 0, 0, 0, 0, 0, 1, 1]",235,99,136,11,14,0.1111111111111111,0.10294117647058823
"[1, 1, 1, 1, 0, 0, 0, 1, 1, 0, 0, 1, 1, 1, 1]",683,234,449,19,29,0.0811965811965812,0.0645879732739421
"[1, 1, 1, 1, 1, 0, 1, 1, 1, 1, 0, 0, 0, 0, 0]",367,132,235,17,22,0.12878787878787878,0.09361702127659574
"[0, 1, 1, 0, 1, 0, 1, 0, 0, 1, 0, 0, 0, 1, 0]",134,83,51,7,7,0.08433734939759036,0.13725490196078433
"[0, 1, 0, 0, 0, 1, 0, 1, 0, 1, 0, 1, 0, 0, 0]",221,138,83,14,8,0.10144927536231885,0.0963855421686747
"[1, 0, 0, 0, 0, 0, 1, 1, 1, 1, 1, 1, 1, 0, 1]",209,70,139,8,16,0.11428571428571428,0.11510791366906475
"[1, 1, 0, 1, 0, 1, 0, 1, 0, 0, 0, 0, 0, 1, 1]",158,86,72,4,8,0.046511627906976744,0.1111111111111111
"[0, 0, 0, 0, 0, 1, 1, 1, 1, 1, 0, 1, 0, 1, 1]",217,137,80,16,10,0.11678832116788321,0.125
"[0, 1, 0, 1, 1, 0, 0, 0, 1, 0, 0, 0, 1, 0, 0]",228,146,82,11,7,0.07534246575342465,0.08536585365853659
"[1, 0, 1, 1, 1, 1, 0, 1, 1, 0, 0, 1, 0, 1, 0]",134,54,80,3,11,0.05555555555555555,0.1375
"[0, 1, 1, 0, 0, 0, 0, 0, 1, 0, 0, 1, 1, 0, 1]",177,118,59,7,3,0.059322033898305086,0.05084745762711865
"[1, 0, 0, 0, 1, 1, 1, 1, 1, 1, 1, 1, 0, 1, 0]",258,89,169,5,12,0.056179775280898875,0.07100591715976332
"[0, 0, 1, 0, 0, 1, 1, 1, 1, 0, 1, 1, 1, 1, 0]",168,62,106,6,12,0.0967741935483871,0.11320754716981132
"[1, 1, 0, 1, 1, 0, 1, 1, 1, 0, 0, 0, 1, 1, 0]",152,49,103,4,10,0.08163265306122448,0.0970873786407767
"[0, 1, 1, 0, 1, 1, 0, 1, 1, 1, 0, 0, 0, 1, 1]",144,72,72,6,8,0.08333333333333333,0.1111111111111111
"[1, 0, 0, 0, 1, 1, 0, 0, 0, 0, 0, 1, 1, 1, 1]",284,140,144,13,15,0.09285714285714286,0.10416666666666667
"[0, 1, 1, 1, 1, 0, 0, 0, 1, 1, 0, 0, 0, 0, 0]",308,196,112,19,9,0.09693877551020408,0.08035714285714286
"[0, 1, 1, 1, 1, 0, 0, 0, 1, 0, 0, 0, 1, 1, 0]",164,104,60,8,6,0.07692307692307693,0.1
"[1, 1, 0, 1, 0, 1, 1, 0, 1, 0, 1, 0, 1, 1, 0]",138,44,94,4,9,0.09090909090909091,0.09574468085106383
"[0, 0, 1, 0, 0, 1, 1, 0, 1, 0, 0, 1, 1, 1, 0]",123,66,57,7,8,0.10606060606060606,0.14035087719298245
"[1, 0, 1, 0, 0, 1, 0, 0, 1, 0, 0, 1, 1, 0, 1]",98,48,50,5,4,0.10416666666666667,0.08
"[0, 1, 1, 0, 1, 0, 0, 1, 0, 1, 0, 0, 0, 1, 0]",120,69,51,10,4,0.14492753623188406,0.0784313725490196
"[0, 0, 0, 0, 1, 0, 0, 1, 1, 1, 1, 0, 0, 0, 1]",213,137,76,10,5,0.072992700729927,0.06578947368421052
"[0, 1, 0, 1, 0, 1, 0, 0, 1, 0, 0, 1, 1, 0, 0]",189,100,89,11,7,0.11,0.07865168539325842
"[0, 1, 0, 1, 0, 1, 0, 1, 0, 0, 1, 0, 0, 1, 1]",136,80,56,7,2,0.0875,0.03571428571428571
"[1, 0, 0, 0, 0, 1, 1, 0, 0, 0, 1, 0, 1, 0, 1]",203,95,108,10,8,0.10526315789473684,0.07407407407407407
"[1, 0, 0, 1, 0, 0, 0, 1, 1, 0, 0, 0, 0, 1, 1]",361,193,168,23,18,0.11917098445595854,0.10714285714285714
"[1, 0, 1, 0, 1, 1, 0, 1, 0, 1, 0, 0, 0, 0, 1]",119,56,63,9,9,0.16071428571428573,0.14285714285714285
"[1, 0, 0, 0, 0, 0, 1, 0, 0, 0, 1, 1, 1, 1, 0]",231,141,90,18,5,0.1276595744680851,0.05555555555555555
"[0, 1, 1, 1, 0, 1, 0, 1, 1, 1, 1, 0, 1, 1, 0]",220,89,131,8,11,0.0898876404494382,0.08396946564885496
"[1, 1, 0, 1, 0, 0, 1, 1, 0, 1, 1, 1, 0, 0, 1]",156,58,98,5,5,0.08620689655172414,0.05102040816326531
"[0, 1, 0, 1, 0, 1, 0, 0, 1, 0, 1, 1, 0, 1, 0]",115,69,46,7,2,0.10144927536231885,0.043478260869565216
"[1, 0, 1, 0, 1, 1, 0, 0, 1, 1, 1, 0, 1, 1, 0]",127,55,72,7,8,0.12727272727272726,0.1111111111111111
"[1, 0, 0, 1, 1, 0, 1, 0, 1, 0, 0, 0, 1, 1, 1]",159,69,90,4,6,0.057971014492753624,0.06666666666666667
"[1, 0, 1, 1, 0, 0, 1, 0, 1, 1, 0, 0, 0, 1, 1]",138,62,76,5,8,0.08064516129032258,0.10526315789473684
"[0, 1, 0, 0, 1, 1, 1, 0, 1, 1, 0, 0, 1, 0, 1]",123,52,71,5,8,0.09615384615384616,0.11267605633802817
"[1, 1, 1, 1, 1, 1, 0, 0, 0, 1, 0, 0, 1, 1, 1]",525,196,329,24,31,0.12244897959183673,0.09422492401215805
"[1, 1, 0, 1, 0, 1, 0, 1, 1, 1, 1, 0, 0, 0, 0]",215,100,115,5,15,0.05,0.13043478260869565
"[0, 1, 0, 0, 0, 1, 1, 1, 1, 1, 0, 0, 0, 1, 0]",123,65,58,9,11,0.13846153846153847,0.1896551724137931
"[1, 0, 0, 0, 1, 0, 0, 0, 1, 1, 1, 1, 1, 0, 0]",167,85,82,5,7,0.058823529411764705,0.08536585365853659
"[0, 0, 1, 0, 0, 0, 0, 0, 1, 1, 1, 1, 1, 0, 1]",122,70,52,9,3,0.12857142857142856,0.057692307692307696
"[0, 1, 1, 0, 1, 0, 1, 1, 0, 0, 0, 1, 1, 1, 0]",106,47,59,6,0,0.1276595744680851,0.0
"[1, 0, 0, 0, 1, 0, 0, 1, 0, 1, 1, 1, 0, 0, 0]",173,98,75,15,6,0.15306122448979592,0.08
"[1, 1, 1, 0, 1, 0, 0, 1, 1, 1, 0, 0, 1, 1, 1]",351,127,224,15,25,0.11811023622047244,0.11160714285714286
"[0, 0, 1, 0, 0, 1, 0, 0, 0, 0, 0, 0, 1, 1, 1]",628,443,185,48,16,0.10835214446952596,0.08648648648648649
"[0, 1, 0, 1, 1, 1, 0, 1, 0, 0, 0, 1, 1, 1, 1]",198,78,120,5,16,0.0641025641025641,0.13333333333333333
"[0, 1, 1, 0, 1, 0, 1, 0, 0, 1, 0, 1, 1, 0, 0]",126,72,54,10,5,0.1388888888888889,0.09259259259259259
"[0, 0, 1, 1, 1, 1, 1, 0, 0, 1, 1, 0, 1, 1, 0]",178,86,92,12,9,0.13953488372093023,0.09782608695652174
"[1, 0, 1, 0, 1, 0, 1, 0, 0, 0, 0, 1, 0, 1, 1]",125,57,68,5,8,0.08771929824561403,0.11764705882352941
"[0, 1, 1, 0, 1, 1, 1, 0, 1, 0, 1, 0, 1, 0, 0]",122,65,57,9,8,0.13846153846153847,0.14035087719298245
"[1, 0, 0, 1, 0, 1, 0, 1, 1, 0, 1, 1, 1, 0, 1]",125,46,79,2,10,0.043478260869565216,0.12658227848101267
"[1, 1, 0, 1, 0, 1, 0, 1, 1, 0, 1, 0, 1, 0, 1]",119,46,73,7,4,0.15217391304347827,0.0547945205479452
"[0, 1, 0, 0, 1, 1, 1, 0, 0, 1, 0, 0, 0, 0, 0]",286,184,102,16,11,0.08695652173913043,0.10784313725490197
"[1, 0, 1, 1, 1, 0, 0, 1, 1, 0, 0, 1, 1, 0, 1]",170,69,101,2,8,0.028985507246376812,0.07920792079207921
"[1, 0, 1, 1, 1, 0, 0, 1, 0, 0, 1, 1, 0, 0, 1]",148,64,84,6,7,0.09375,0.08333333333333333
"[1, 0, 1, 0, 0, 1, 0, 1, 0, 0, 0, 0, 1, 1, 1]",162,79,83,5,9,0.06329113924050633,0.10843373493975904
"[1, 0, 0, 0, 1, 0, 0, 1, 1, 1, 0, 1, 0, 0, 0]",165,94,71,14,4,0.14893617021276595,0.056338028169014086
"[0, 1, 0, 0, 1, 1, 0, 1, 0, 1, 1, 1, 0, 0, 0]",131,67,64,9,5,0.13432835820895522,0.078125
"[0, 0, 0, 1, 1, 0, 1, 1, 1, 1, 1, 1, 0, 1, 0]",153,64,89,11,13,0.171875,0.14606741573033707
"[0, 1, 0, 1, 1, 0, 1, 0, 1, 1, 1, 0, 0, 1, 1]",182,79,103,7,7,0.08860759493670886,0.06796116504854369
"[1, 1, 0, 0, 0, 1, 1, 1, 0, 1, 1, 0, 1, 0, 0]",136,67,69,9,10,0.13432835820895522,0.14492753623188406
"[0, 1, 1, 0, 0, 0, 1, 0, 1, 1, 1, 0, 1, 1, 0]",125,71,54,9,3,0.1267605633802817,0.05555555555555555
"[1, 0, 1, 0, 1, 1, 0, 0, 0, 1, 0, 1, 1, 1, 0]",123,65,58,9,6,0.13846153846153847,0.10344827586206896
"[0, 1, 0, 1, 0, 0, 0, 1, 1, 1, 0, 1, 1, 1, 0]",95,51,44,8,5,0.1568627450980392,0.11363636363636363
"[0, 0, 0, 0, 0, 1, 1, 1, 0, 1, 1, 1, 0, 0, 0]",240,156,84,12,12,0.07692307692307693,0.14285714285714285
"[0, 1, 1, 0, 0, 0, 0, 0, 0, 1, 0, 1, 0, 0, 1]",312,229,83,25,9,0.1091703056768559,0.10843373493975904
"[1, 0, 0, 0, 1, 0, 1, 1, 0, 0, 1, 0, 1, 0, 0]",121,74,47,3,1,0.04054054054054054,0.02127659574468085
"[0, 1, 1, 0, 0, 0, 1, 0, 0, 0, 1, 0, 1, 1, 0]",156,91,65,4,5,0.04395604395604396,0.07692307692307693
"[1, 1, 0, 1, 0, 1, 1, 1, 0, 0, 1, 1, 1, 0, 1]",256,84,172,7,20,0.08333333333333333,0.11627906976744186
"[1, 1, 0, 1, 1, 0, 0, 0, 0, 1, 1, 0, 1, 1, 1]",196,86,110,7,10,0.08139534883720931,0.09090909090909091
"[1, 0, 1, 1, 0, 0, 1, 0, 1, 0, 1, 0, 1, 0, 0]",98,45,53,11,7,0.24444444444444444,0.1320754716981132
"[0, 1, 1, 0, 1, 1, 1, 0, 0, 1, 1, 1, 0, 1, 0]",161,65,96,7,9,0.1076923076923077,0.09375
"[1, 0, 0, 0, 0, 0, 1, 0, 0, 1, 0, 0, 1, 1, 1]",242,123,119,8,12,0.06504065040650407,0.10084033613445378
"[0, 1, 1, 1, 1, 0, 0, 1, 0, 0, 0, 1, 0, 0, 0]",165,109,56,14,8,0.12844036697247707,0.14285714285714285
"[1, 0, 1, 1, 1, 0, 1, 1, 0, 1, 0, 0, 0, 0, 0]",129,61,68,2,7,0.03278688524590164,0.10294117647058823
"[0, 0, 1, 1, 1, 1, 1, 0, 1, 0, 1, 0, 1, 0, 1]",161,73,88,8,5,0.1095890410958904,0.056818181818181816
"[0, 0, 0, 0, 1, 1, 1, 0, 1, 1, 1, 1, 1, 1, 0]",235,104,131,8,10,0.07692307692307693,0.07633587786259542
"[0, 1, 1, 1, 0, 0, 0, 0, 0, 0, 0, 1, 1, 1, 0]",198,110,88,12,7,0.10909090909090909,0.07954545454545454
"[1, 1, 1, 1, 0, 0, 1, 1, 1, 0, 1, 1, 0, 0, 1]",339,116,223,10,17,0.08620689655172414,0.07623318385650224
"[0, 1, 1, 1, 0, 0, 0, 0, 1, 1, 0, 0, 1, 0, 0]",194,119,75,12,5,0.10084033613445378,0.06666666666666667
"[1, 0, 1, 1, 1, 0, 0, 0, 0, 1, 1, 0, 0, 1, 0]",144,78,66,6,4,0.07692307692307693,0.06060606060606061
"[0, 0, 0, 1, 0, 1, 0, 1, 0, 1, 0, 1, 1, 1, 0]",102,45,57,4,3,0.08888888888888889,0.05263157894736842
"[0, 1, 0, 0, 0, 1, 0, 1, 0, 1, 0, 1, 0, 1, 1]",106,54,52,4,3,0.07407407407407407,0.057692307692307696
"[0, 0, 1, 1, 1, 0, 1, 0, 0, 0, 1, 0, 1, 0, 1]",121,61,60,4,4,0.06557377049180328,0.06666666666666667
"[0, 0, 1, 1, 1, 1, 0, 0, 1, 0, 1, 0, 1, 1, 0]",184,97,87,8,3,0.08247422680412371,0.034482758620689655
"[1, 1, 1, 1, 0, 1, 1, 1, 1, 0, 0, 0, 1, 0, 0]",171,77,94,6,8,0.07792207792207792,0.0851063829787234
"[0, 0, 0, 1, 1, 1, 1, 1, 1, 0, 0, 0, 1, 1, 0]",250,163,87,29,8,0.17791411042944785,0.09195402298850575
"[0, 0, 0, 0, 0, 1, 1, 1, 0, 0, 0, 1, 0, 1, 1]",227,152,75,15,7,0.09868421052631579,0.09333333333333334
"[1, 1, 0, 0, 0, 0, 0, 1, 1, 1, 0, 0, 0, 1, 0]",155,96,59,7,4,0.07291666666666667,0.06779661016949153
"[0, 0, 0, 0, 0, 1, 0, 1, 1, 1, 1, 1, 0, 1, 0]",125,63,62,8,5,0.12698412698412698,0.08064516129032258
"[1, 0, 0, 0, 0, 1, 0, 0, 0, 0, 0, 1, 0, 1, 1]",325,186,139,20,10,0.10752688172043011,0.07194244604316546
"[1, 0, 0, 1, 0, 1, 1, 0, 0, 1, 1, 0, 0, 0, 1]",133,67,66,7,5,0.1044776119402985,0.07575757575757576
"[1, 1, 0, 1, 1, 0, 0, 1, 1, 0, 1, 0, 1, 0, 1]",155,62,93,6,9,0.0967741935483871,0.0967741935483871
"[1, 0, 1, 1, 0, 1, 0, 1, 1, 1, 1, 0, 0, 0, 0]",240,111,129,12,9,0.10810810810810811,0.06976744186046512
"[1, 1, 1, 1, 0, 1, 0, 0, 1, 1, 1, 1, 0, 1, 0]",240,73,167,6,15,0.0821917808219178,0.08982035928143713
"[1, 0, 0, 1, 0, 1, 0, 1, 1, 1, 1, 1, 1, 1, 0]",274,104,170,12,13,0.11538461538461539,0.07647058823529412
"[1, 1, 0, 0, 0, 1, 1, 0, 0, 1, 0, 1, 0, 1, 1]",120,61,59,10,7,0.16393442622950818,0.11864406779661017
"[0, 1, 0, 1, 1, 1, 0, 1, 0, 0, 1, 1, 0, 1, 1]",144,57,87,3,13,0.05263157894736842,0.14942528735632185
"[1, 1, 0, 1, 0, 0, 1, 0, 0, 0, 1, 1, 0, 0, 0]",179,100,79,10,5,0.1,0.06329113924050633
"[0, 0, 1, 0, 0, 0, 1, 1, 1, 0, 1, 1, 1, 1, 0]",111,56,55,4,4,0.07142857142857142,0.07272727272727272
"[0, 0, 0, 1, 1, 1, 0, 1, 1, 1, 0, 0, 0, 0, 1]",154,93,61,9,8,0.0967741935483871,0.13114754098360656
"[0, 1, 0, 0, 1, 1, 0, 0, 0, 0, 1, 0, 0, 1, 1]",173,122,51,5,12,0.040983606557377046,0.23529411764705882
"[0, 0, 0, 0, 0, 1, 0, 0, 1, 1, 0, 1, 1, 1, 0]",156,93,63,10,2,0.10752688172043011,0.031746031746031744
"[1, 1, 0, 0, 1, 0, 0, 0, 1, 1, 1, 1, 1, 0, 0]",172,67,105,7,12,0.1044776119402985,0.11428571428571428
"[0, 1, 0, 0, 1, 1, 0, 0, 1, 1, 1, 1, 1, 0, 1]",175,75,100,5,10,0.06666666666666667,0.1
"[1, 1, 0, 0, 0, 1, 1, 0, 1, 0, 0, 1, 0, 0, 1]",108,64,44,8,5,0.125,0.11363636363636363
"[0, 1, 1, 1, 0, 0, 0, 1, 1, 1, 0, 1, 0, 1, 1]",150,57,93,4,8,0.07017543859649122,0.08602150537634409
"[1, 0, 0, 1, 1, 1, 0, 1, 0, 0, 1, 1, 1, 0, 0]",125,49,76,4,8,0.08163265306122448,0.10526315789473684
"[1, 1, 0, 1, 0, 1, 0, 0, 1, 1, 1, 0, 1, 0, 0]",112,59,53,4,4,0.06779661016949153,0.07547169811320754
"[0, 1, 0, 0, 1, 1, 1, 1, 0, 1, 0, 1, 0, 1, 1]",134,67,67,7,5,0.1044776119402985,0.07462686567164178
"[0, 1, 1, 0, 0, 0, 1, 0, 0, 1, 1, 0, 0, 0, 1]",170,99,71,10,7,0.10101010101010101,0.09859154929577464
"[0, 0, 1, 1, 1, 0, 0, 1, 0, 0, 0, 0, 1, 0, 1]",149,94,55,8,1,0.0851063829787234,0.01818181818181818
"[1, 1, 1, 1, 1, 0, 1, 0, 0, 0, 1, 1, 1, 1, 0]",342,124,218,8,19,0.06451612903225806,0.0871559633027523
"[1, 1, 0, 1, 0, 0, 0, 0, 1, 1, 0, 0, 0, 1, 0]",169,100,69,9,6,0.09,0.08695652173913043
"[0, 0, 1, 0, 1, 0, 0, 1, 1, 1, 0, 1, 1, 1, 0]",114,57,57,4,7,0.07017543859649122,0.12280701754385964
"[1, 1, 0, 1, 0, 0, 0, 0, 0, 1, 0, 0, 0, 0, 1]",251,154,97,12,8,0.07792207792207792,0.08247422680412371
"[0, 1, 0, 1, 0, 0, 1, 0, 0, 1, 0, 0, 0, 0, 1]",255,160,95,12,9,0.075,0.09473684210526316
"[1, 0, 1, 1, 1, 0, 0, 0, 1, 0, 1, 1, 1, 1, 1]",324,113,211,12,21,0.10619469026548672,0.0995260663507109
"[0, 0, 0, 1, 0, 0, 0, 1, 1, 1, 0, 0, 0, 1, 0]",246,151,95,16,7,0.10596026490066225,0.07368421052631578
"[1, 0, 1, 1, 1, 1, 0, 1, 1, 0, 0, 0, 1, 0, 0]",99,47,52,7,8,0.14893617021276595,0.15384615384615385
"[0, 1, 1, 0, 1, 0, 1, 0, 1, 1, 1, 1, 0, 1, 1]",245,101,144,17,18,0.16831683168316833,0.125
"[0, 1, 1, 1, 0, 0, 0, 1, 1, 0, 1, 1, 0, 1, 0]",114,52,62,3,2,0.057692307692307696,0.03225806451612903
"[0, 0, 1, 0, 1, 1, 0, 1, 1, 1, 1, 0, 0, 0, 0]",194,106,88,10,8,0.09433962264150944,0.09090909090909091
"[0, 0, 0, 1, 1, 1, 1, 0, 1, 1, 0, 1, 0, 1, 1]",200,98,102,8,3,0.08163265306122448,0.029411764705882353
"[0, 0, 0, 1, 0, 0, 0, 1, 1, 1, 1, 1, 0, 0, 1]",181,96,85,9,10,0.09375,0.11764705882352941
"[1, 0, 1, 0, 0, 1, 1, 1, 1, 1, 1, 0, 0, 0, 1]",207,92,115,12,14,0.13043478260869565,0.12173913043478261
"[1, 1, 1, 1, 1, 0, 1, 0, 1, 1, 0, 1, 0, 1, 0]",222,71,151,7,4,0.09859154929577464,0.026490066225165563
"[1, 0, 0, 1, 0, 1, 0, 1, 1, 1, 0, 0, 0, 1, 1]",113,51,62,7,8,0.13725490196078433,0.12903225806451613
"[0, 1, 1, 1, 0, 1, 1, 0, 1, 0, 1, 1, 1, 0, 1]",194,73,121,4,11,0.0547945205479452,0.09090909090909091
"[1, 0, 0, 1, 0, 1, 0, 1, 1, 0, 0, 1, 0, 1, 0]",96,54,42,7,4,0.12962962962962962,0.09523809523809523
"[1, 1, 0, 0, 1, 0, 1, 0, 1, 1, 0, 0, 1, 0, 1]",123,60,63,6,6,0.1,0.09523809523809523
"[1, 1, 1, 0, 1, 1, 1, 1, 0, 1, 1, 0, 0, 0, 0]",231,83,148,10,9,0.12048192771084337,0.060810810810810814
"[1, 1, 1, 0, 1, 1, 0, 1, 1, 0, 0, 0, 0, 0, 1]",139,56,83,5,6,0.08928571428571429,0.07228915662650602
"[1, 1, 1, 0, 0, 1, 0, 0, 1, 0, 0, 0, 1, 0, 0]",151,87,64,8,5,0.09195402298850575,0.078125
"[0, 0, 1, 0, 1, 0, 0, 0, 0, 1, 1, 0, 1, 0, 0]",216,152,64,13,7,0.08552631578947369,0.109375
"[0, 0, 0, 1, 1, 0, 1, 0, 1, 0, 1, 0, 0, 1, 1]",131,75,56,8,6,0.10666666666666667,0.10714285714285714
"[1, 0, 0, 0, 1, 1, 0, 1, 0, 1, 0, 1, 0, 0, 1]",103,51,52,1,8,0.0196078431372549,0.15384615384615385
"[1, 1, 1, 1, 0, 0, 1, 0, 1, 0, 0, 0, 1, 1, 0]",152,76,76,8,8,0.10526315789473684,0.10526315789473684
"[0, 0, 0, 1, 1, 1, 0, 1, 1, 1, 0, 0, 0, 1, 0]",114,70,44,8,6,0.11428571428571428,0.13636363636363635
"[1, 1, 0, 1, 0, 1, 0, 0, 1, 0, 1, 0, 0, 0, 0]",160,88,72,7,6,0.07954545454545454,0.08333333333333333
"[1, 1, 0, 0, 0, 0, 1, 0, 0, 0, 0, 1, 0, 0, 1]",285,192,93,14,12,0.07291666666666667,0.12903225806451613
"[1, 0, 0, 1, 0, 1, 1, 1, 0, 1, 0, 0, 1, 0, 0]",109,58,51,8,3,0.13793103448275862,0.058823529411764705
"[0, 0, 0, 0, 1, 1, 0, 1, 0, 0, 0, 1, 1, 0, 0]",344,228,116,25,7,0.10964912280701754,0.0603448275862069
"[1, 0, 0, 0, 1, 1, 1, 0, 0, 1, 1, 0, 0, 1, 1]",277,126,151,9,18,0.07142857142857142,0.11920529801324503
"[0, 0, 0, 1, 1, 0, 1, 1, 1, 1, 0, 0, 0, 0, 1]",196,107,89,10,7,0.09345794392523364,0.07865168539325842
"[0, 1, 0, 1, 1, 0, 1, 1, 0, 0, 1, 1, 0, 0, 0]",178,88,90,9,5,0.10227272727272728,0.05555555555555555
"[0, 0, 0, 1, 0, 0, 0, 1, 1, 1, 0, 1, 1, 1, 0]",105,55,50,3,1,0.05454545454545454,0.02
"[1, 0, 0, 1, 0, 0, 1, 0, 0, 1, 1, 1, 1, 1, 0]",139,69,70,4,7,0.057971014492753624,0.1
"[0, 1, 0, 1, 0, 1, 1, 0, 1, 1, 1, 1, 1, 0, 1]",222,100,122,13,9,0.13,0.07377049180327869
"[0, 0, 1, 0, 0, 0, 1, 1, 1, 0, 1, 1, 1, 1, 1]",183,75,108,7,8,0.09333333333333334,0.07407407407407407
"[0, 0, 1, 1, 1, 1, 0, 1, 0, 0, 0, 0, 0, 1, 1]",194,104,90,11,7,0.10576923076923077,0.07777777777777778
"[0, 0, 1, 0, 0, 1, 1, 1, 0, 1, 1, 1, 1, 0, 1]",131,53,78,4,12,0.07547169811320754,0.15384615384615385
"[1, 0, 1, 1, 1, 0, 1, 1, 0, 0, 0, 0, 1, 0, 0]",112,61,51,7,5,0.11475409836065574,0.09803921568627451
"[1, 1, 0, 1, 1, 1, 0, 1, 1, 0, 0, 0, 0, 1, 0]",115,50,65,5,3,0.1,0.046153846153846156
"[1, 1, 0, 0, 0, 1, 0, 1, 1, 0, 0, 1, 1, 1, 0]",121,58,63,3,3,0.05172413793103448,0.047619047619047616
"[1, 1, 1, 1, 0, 0, 1, 1, 1, 0, 0, 1, 0, 1, 0]",172,61,111,5,12,0.08196721311475409,0.10810810810810811
"[0, 0, 0, 0, 0, 1, 0, 1, 1, 0, 1, 1, 1, 1, 1]",199,100,99,16,11,0.16,0.1111111111111111
"[0, 0, 0, 1, 0, 0, 1, 1, 0, 0, 0, 1, 0, 0, 1]",270,199,71,23,7,0.11557788944723618,0.09859154929577464
"[1, 0, 1, 1, 0, 0, 0, 1, 0, 0, 1, 1, 0, 0, 0]",199,105,94,20,8,0.19047619047619047,0.0851063829787234
"[1, 0, 0, 1, 0, 0, 0, 1, 1, 0, 0, 0, 1, 0, 1]",150,83,67,6,7,0.07228915662650602,0.1044776119402985
"[0, 1, 0, 0, 1, 1, 1, 0, 0, 0, 1, 0, 1, 1, 0]",103,58,45,9,3,0.15517241379310345,0.06666666666666667
"[1, 1, 0, 0, 1, 0, 1, 1, 0, 0, 1, 1, 0, 1, 0]",112,55,57,5,6,0.09090909090909091,0.10526315789473684
"[1, 1, 0, 1, 1, 1, 1, 1, 0, 0, 1, 0, 1, 0, 1]",224,74,150,8,12,0.10810810810810811,0.08
"[0, 0, 0, 1, 1, 0, 1, 1, 0, 1, 1, 0, 1, 0, 0]",107,61,46,2,9,0.03278688524590164,0.1956521739130435
"[0, 0, 0, 0, 0, 0, 1, 0, 1, 0, 1, 0, 1, 1, 1]",288,177,111,21,9,0.11864406779661017,0.08108108108108109
"[0, 1, 0, 1, 0, 0, 1, 1, 1, 1, 0, 1, 0, 0, 0]",133,79,54,3,5,0.0379746835443038,0.09259259259259259
"[0, 1, 0, 0, 1, 0, 1, 1, 0, 0, 1, 0, 0, 0, 0]",248,144,104,20,13,0.1388888888888889,0.125
"[1, 0, 0, 0, 1, 0, 0, 0, 1, 0, 0, 1, 0, 1, 1]",165,105,60,10,5,0.09523809523809523,0.08333333333333333
"[0, 0, 1, 1, 0, 1, 0, 0, 0, 1, 1, 0, 0, 1, 1]",225,125,100,14,12,0.112,0.12
"[1, 0, 1, 0, 1, 0, 1, 0, 1, 1, 0, 0, 1, 0, 0]",98,54,44,6,4,0.1111111111111111,0.09090909090909091
"[0, 0, 1, 1, 1, 1, 0, 0, 0, 1, 0, 0, 1, 0, 0]",193,140,53,16,5,0.11428571428571428,0.09433962264150944
"[1, 1, 1, 0, 0, 1, 0, 1, 1, 0, 0, 0, 1, 0, 0]",111,59,52,7,5,0.11864406779661017,0.09615384615384616
"[0, 1, 1, 0, 1, 0, 1, 1, 1, 1, 0, 1, 0, 1, 0]",124,60,64,8,6,0.13333333333333333,0.09375
"[0, 1, 1, 0, 0, 0, 0, 0, 1, 1, 0, 1, 1, 1, 1]",221,132,89,16,6,0.12121212121212122,0.06741573033707865
"[0, 0, 0, 1, 1, 0, 0, 0, 1, 0, 0, 1, 0, 1, 0]",283,186,97,23,8,0.12365591397849462,0.08247422680412371
"[0, 0, 0, 0, 0, 0, 1, 0, 1, 0, 1, 1, 0, 0, 1]",311,200,111,26,14,0.13,0.12612612612612611
"[0, 1, 0, 0, 1, 1, 1, 0, 0, 0, 0, 1, 1, 0, 0]",331,202,129,15,15,0.07425742574257425,0.11627906976744186
"[1, 0, 1, 0, 0, 1, 1, 0, 1, 0, 1, 1, 1, 0, 0]",121,57,64,4,3,0.07017543859649122,0.046875
"[1, 1, 0, 0, 1, 1, 1, 1, 0, 1, 0, 0, 1, 1, 0]",214,90,124,7,13,0.07777777777777778,0.10483870967741936
"[1, 1, 1, 0, 1, 0, 1, 1, 0, 0, 0, 0, 0, 1, 1]",175,79,96,5,13,0.06329113924050633,0.13541666666666666
"[1, 1, 0, 0, 0, 1, 0, 0, 1, 0, 1, 0, 0, 0, 1]",166,96,70,9,7,0.09375,0.1
"[1, 0, 0, 0, 0, 1, 0, 0, 1, 0, 1, 1, 0, 1, 0]",125,63,62,4,5,0.06349206349206349,0.08064516129032258
"[0, 1, 1, 1, 0, 1, 0, 0, 1, 0, 1, 0, 1, 0, 0]",108,57,51,4,2,0.07017543859649122,0.0392156862745098
"[0, 1, 0, 0, 0, 0, 1, 1, 0, 0, 0, 1, 0, 0, 1]",262,163,99,18,8,0.11042944785276074,0.08080808080808081
"[0, 0, 0, 1, 1, 0, 1, 1, 0, 1, 1, 0, 0, 0, 1]",132,71,61,5,5,0.07042253521126761,0.08196721311475409
"[0, 0, 0, 0, 1, 1, 1, 0, 1, 0, 0, 1, 0, 0, 1]",162,95,67,3,4,0.031578947368421054,0.05970149253731343
"[0, 1, 1, 1, 1, 0, 1, 1, 1, 1, 0, 1, 0, 0, 0]",165,70,95,10,6,0.14285714285714285,0.06315789473684211
"[0, 1, 1, 0, 1, 1, 1, 0, 0, 1, 0, 0, 0, 1, 0]",105,54,51,5,6,0.09259259259259259,0.11764705882352941
"[0, 1, 0, 1, 1, 1, 1, 1, 0, 0, 1, 1, 1, 0, 1]",235,88,147,10,20,0.11363636363636363,0.1360544217687075
"[0, 1, 0, 1, 1, 0, 1, 0, 1, 1, 0, 0, 0, 1, 0]",104,53,51,3,4,0.05660377358490566,0.0784313725490196
"[1, 1, 0, 1, 0, 0, 1, 1, 1, 1, 1, 0, 0, 0, 0]",227,101,126,15,11,0.1485148514851485,0.0873015873015873
"[0, 1, 1, 0, 1, 1, 1, 0, 0, 0, 0, 1, 0, 1, 1]",153,79,74,11,5,0.13924050632911392,0.06756756756756757
"[1, 1, 0, 0, 1, 0, 0, 1, 1, 1, 1, 1, 0, 0, 0]",177,85,92,5,7,0.058823529411764705,0.07608695652173914
"[0, 0, 0, 0, 0, 0, 1, 0, 1, 1, 0, 0, 0, 1, 1]",392,264,128,23,13,0.08712121212121213,0.1015625
"[1, 0, 0, 0, 1, 1, 1, 0, 0, 0, 1, 1, 0, 1, 0]",106,53,53,4,5,0.07547169811320754,0.09433962264150944
"[0, 0, 0, 1, 0, 1, 0, 1, 1, 0, 1, 1, 1, 0, 0]",140,75,65,3,7,0.04,0.1076923076923077
"[0, 0, 0, 0, 1, 0, 0, 1, 1, 1, 0, 0, 1, 1, 0]",223,132,91,8,9,0.06060606060606061,0.0989010989010989
"[0, 0, 1, 1, 0, 0, 1, 0, 1, 1, 1, 0, 0, 0, 1]",138,76,62,8,5,0.10526315789473684,0.08064516129032258
"[0, 1, 1, 0, 0, 1, 1, 0, 0, 1, 0, 1, 1, 1, 1]",335,213,122,21,12,0.09859154929577464,0.09836065573770492
"[1, 0, 0, 0, 0, 1, 1, 0, 1, 1, 0, 0, 1, 1, 0]",167,93,74,5,11,0.053763440860215055,0.14864864864864866
"[0, 1, 1, 0, 1, 1, 1, 0, 0, 1, 0, 0, 0, 0, 1]",122,56,66,5,4,0.08928571428571429,0.06060606060606061
"[1, 0, 0, 1, 0, 1, 1, 0, 1, 1, 1, 1, 0, 0, 1]",190,76,114,7,10,0.09210526315789473,0.08771929824561403
"[0, 1, 1, 0, 0, 1, 0, 0, 1, 0, 1, 1, 0, 1, 1]",129,69,60,5,5,0.07246376811594203,0.08333333333333333
"[0, 1, 1, 1, 1, 0, 0, 0, 1, 1, 0, 0, 1, 1, 1]",350,192,158,19,14,0.09895833333333333,0.08860759493670886
"[0, 0, 1, 0, 1, 1, 0, 1, 1, 0, 0, 0, 1, 0, 0]",132,82,50,7,4,0.08536585365853659,0.08
"[0, 0, 0, 1, 0, 1, 1, 0, 1, 1, 0, 0, 0, 1, 0]",141,90,51,10,6,0.1111111111111111,0.11764705882352941
"[0, 0, 1, 0, 1, 1, 0, 0, 1, 0, 1, 0, 0, 1, 0]",111,58,53,5,1,0.08620689655172414,0.018867924528301886
"[1, 0, 0, 0, 1, 1, 0, 0, 0, 1, 1, 1, 0, 1, 0]",104,45,59,3,8,0.06666666666666667,0.13559322033898305
"[1, 1, 0, 1, 0, 1, 0, 0, 0, 1, 1, 1, 0, 0, 1]",116,55,61,6,3,0.10909090909090909,0.04918032786885246
"[0, 1, 0, 1, 1, 1, 0, 1, 1, 1, 0, 0, 0, 0, 1]",140,71,69,9,7,0.1267605633802817,0.10144927536231885
"[1, 0, 1, 0, 1, 1, 0, 1, 0, 0, 1, 1, 0, 1, 1]",135,61,74,4,7,0.06557377049180328,0.0945945945945946
"[0, 0, 0, 0, 1, 0, 0, 1, 0, 1, 0, 1, 0, 0, 1]",237,163,74,20,6,0.12269938650306748,0.08108108108108109
"[0, 0, 1, 0, 0, 0, 1, 1, 1, 0, 0, 0, 1, 0, 0]",244,162,82,23,10,0.1419753086419753,0.12195121951219512
"[1, 0, 1, 0, 0, 0, 1, 0, 0, 0, 1, 1, 1, 0, 0]",163,97,66,10,4,0.10309278350515463,0.06060606060606061
"[1, 1, 1, 1, 1, 0, 0, 0, 1, 1, 0, 1, 1, 1, 0]",301,81,220,8,21,0.09876543209876543,0.09545454545454546
"[1, 0, 1, 1, 1, 0, 1, 1, 1, 0, 1, 0, 1, 1, 0]",237,91,146,10,16,0.10989010989010989,0.1095890410958904
"[0, 1, 0, 1, 0, 1, 0, 0, 0, 1, 1, 1, 1, 1, 1]",247,122,125,19,9,0.1557377049180328,0.072
"[1, 1, 0, 0, 0, 0, 0, 0, 0, 1, 0, 0, 1, 0, 1]",338,213,125,16,13,0.07511737089201878,0.104
"[0, 0, 1, 1, 0, 1, 0, 0, 0, 0, 1, 0, 1, 0, 1]",140,85,55,5,5,0.058823529411764705,0.09090909090909091
"[1, 1, 1, 1, 0, 1, 1, 1, 0, 1, 0, 0, 0, 0, 1]",188,84,104,8,12,0.09523809523809523,0.11538461538461539
"[0, 1, 0, 0, 1, 1, 1, 0, 1, 0, 1, 0, 1, 1, 0]",94,43,51,1,7,0.023255813953488372,0.13725490196078433
"[1, 0, 0, 0, 0, 1, 0, 0, 0, 1, 1, 1, 0, 1, 0]",139,83,56,8,3,0.0963855421686747,0.05357142857142857
"[1, 1, 0, 0, 1, 0, 0, 1, 0, 1, 0, 0, 0, 0, 0]",289,189,100,17,9,0.08994708994708994,0.09
"[1, 1, 0, 1, 1, 0, 1, 0, 1, 0, 1, 0, 0, 0, 1]",120,56,64,8,4,0.14285714285714285,0.0625
"[0, 1, 1, 1, 1, 1, 0, 1, 0, 0, 1, 1, 1, 0, 0]",166,79,87,7,8,0.08860759493670886,0.09195402298850575
"[1, 0, 0, 1, 0, 1, 1, 0, 1, 0, 1, 0, 1, 1, 0]",101,43,58,11,9,0.2558139534883721,0.15517241379310345
"[1, 0, 1, 0, 0, 1, 0, 1, 1, 0, 1, 0, 0, 1, 0]",109,63,46,4,5,0.06349206349206349,0.10869565217391304
"[1, 1, 1, 1, 0, 0, 1, 0, 1, 1, 0, 1, 0, 0, 1]",183,75,108,9,15,0.12,0.1388888888888889
"[1, 1, 1, 1, 1, 1, 0, 0, 1, 0, 1, 1, 0, 0, 0]",203,72,131,8,10,0.1111111111111111,0.07633587786259542
"[0, 1, 1, 0, 0, 0, 0, 0, 1, 1, 1, 0, 0, 1, 0]",178,105,73,9,5,0.08571428571428572,0.0684931506849315
"[1, 0, 0, 1, 0, 0, 1, 0, 0, 1, 0, 1, 1, 0, 1]",97,36,61,2,7,0.05555555555555555,0.11475409836065574
"[0, 0, 1, 0, 0, 1, 1, 1, 0, 1, 0, 1, 1, 1, 1]",168,52,116,6,6,0.11538461538461539,0.05172413793103448
"[1, 1, 0, 0, 1, 0, 1, 0, 0, 1, 0, 1, 0, 0, 0]",122,71,51,9,7,0.1267605633802817,0.13725490196078433
"[1, 0, 0, 1, 0, 1, 1, 0, 0, 1, 0, 1, 1, 1, 1]",207,83,124,8,11,0.0963855421686747,0.08870967741935484
"[0, 0, 1, 0, 0, 1, 1, 0, 0, 1, 1, 1, 1, 0, 1]",142,61,81,5,5,0.08196721311475409,0.06172839506172839
"[0, 1, 0, 0, 0, 1, 0, 1, 1, 1, 0, 0, 1, 1, 0]",140,66,74,8,1,0.12121212121212122,0.013513513513513514
"[1, 1, 1, 0, 0, 0, 1, 0, 0, 1, 0, 1, 1, 1, 0]",121,56,65,7,6,0.125,0.09230769230769231
"[0, 1, 0, 1, 0, 1, 0, 0, 1, 1, 1, 1, 0, 1, 0]",88,42,46,3,2,0.07142857142857142,0.043478260869565216
"[1, 1, 0, 0, 1, 1, 0, 1, 0, 0, 1, 1, 0, 0, 0]",168,103,65,6,7,0.05825242718446602,0.1076923076923077
"[0, 0, 0, 1, 1, 1, 0, 0, 1, 1, 0, 1, 0, 0, 0]",142,77,65,7,11,0.09090909090909091,0.16923076923076924
"[0, 0, 0, 0, 0, 0, 1, 1, 1, 0, 0, 1, 1, 0, 1]",207,123,84,17,7,0.13821138211382114,0.08333333333333333
"[1, 0, 1, 0, 1, 0, 1, 1, 0, 0, 0, 0, 0, 0, 0]",363,236,127,21,10,0.08898305084745763,0.07874015748031496
"[0, 0, 1, 0, 0, 1, 0, 0, 0, 1, 1, 1, 1, 0, 0]",239,146,93,17,9,0.11643835616438356,0.0967741935483871
"[1, 1, 0, 1, 0, 0, 0, 1, 1, 0, 1, 0, 1, 1, 1]",169,74,95,2,6,0.02702702702702703,0.06315789473684211
"[0, 1, 0, 1, 1, 1, 1, 0, 1, 0, 0, 0, 0, 1, 0]",123,60,63,6,5,0.1,0.07936507936507936
"[1, 0, 0, 0, 1, 1, 0, 0, 0, 1, 1, 0, 0, 1, 1]",242,120,122,13,6,0.10833333333333334,0.04918032786885246
"[0, 1, 1, 0, 0, 0, 1, 1, 0, 1, 0, 0, 1, 0, 0]",160,99,61,5,6,0.050505050505050504,0.09836065573770492
"[1, 1, 0, 0, 0, 0, 1, 0, 0, 1, 1, 1, 0, 0, 0]",223,143,80,12,9,0.08391608391608392,0.1125
"[1, 1, 0, 0, 1, 0, 0, 1, 1, 1, 0, 0, 0, 1, 0]",105,60,45,5,3,0.08333333333333333,0.06666666666666667
"[1, 0, 0, 1, 0, 1, 1, 0, 1, 1, 1, 1, 0, 1, 1]",254,91,163,8,20,0.08791208791208792,0.12269938650306748
"[1, 1, 0, 1, 0, 0, 1, 0, 1, 1, 0, 0, 1, 0, 0]",118,60,58,8,7,0.13333333333333333,0.1206896551724138
"[1, 0, 0, 0, 1, 1, 0, 1, 0, 0, 1, 0, 1, 0, 0]",133,72,61,8,1,0.1111111111111111,0.01639344262295082
"[1, 1, 0, 0, 1, 0, 0, 1, 0, 0, 1, 0, 0, 0, 1]",161,75,86,5,7,0.06666666666666667,0.08139534883720931
"[1, 0, 0, 1, 1, 1, 0, 0, 1, 1, 0, 1, 1, 1, 0]",155,63,92,5,10,0.07936507936507936,0.10869565217391304
"[0, 1, 1, 1, 0, 1, 1, 1, 0, 1, 1, 0, 0, 0, 1]",144,57,87,5,9,0.08771929824561403,0.10344827586206896
"[1, 1, 1, 1, 0, 0, 0, 0, 0, 0, 0, 1, 0, 1, 0]",264,152,112,12,9,0.07894736842105263,0.08035714285714286
"[0, 1, 1, 1, 1, 0, 1, 1, 0, 0, 1, 0, 1, 1, 0]",146,63,83,8,11,0.12698412698412698,0.13253012048192772
"[0, 0, 1, 0, 0, 1, 0, 1, 0, 0, 1, 0, 1, 0, 1]",144,85,59,12,5,0.1411764705882353,0.0847457627118644
"[1, 1, 0, 1, 1, 0, 0, 1, 0, 1, 0, 1, 0, 0, 1]",112,55,57,4,4,0.07272727272727272,0.07017543859649122
"[0, 0, 1, 0, 1, 1, 1, 0, 1, 1, 0, 1, 1, 0, 1]",130,61,69,8,9,0.13114754098360656,0.13043478260869565
"[1, 0, 0, 0, 1, 1, 1, 0, 1, 0, 1, 0, 1, 0, 0]",91,44,47,4,4,0.09090909090909091,0.0851063829787234
"[1, 1, 0, 0, 0, 1, 1, 1, 1, 1, 1, 0, 0, 1, 0]",190,69,121,6,5,0.08695652173913043,0.04132231404958678
"[0, 0, 1, 0, 1, 1, 0, 1, 1, 0, 1, 0, 0, 1, 1]",122,56,66,4,4,0.07142857142857142,0.06060606060606061
"[0, 1, 1, 0, 0, 1, 0, 1, 1, 0, 1, 1, 0, 1, 0]",114,59,55,10,4,0.1694915254237288,0.07272727272727272
"[0, 1, 1, 0, 1, 0, 1, 1, 1, 1, 0, 0, 0, 1, 1]",195,89,106,7,6,0.07865168539325842,0.05660377358490566
"[0, 0, 0, 1, 0, 0, 1, 0, 0, 0, 0, 1, 1, 1, 0]",261,166,95,20,10,0.12048192771084337,0.10526315789473684
"[0, 1, 0, 0, 0, 0, 1, 1, 0, 1, 1, 1, 1, 0, 0]",141,75,66,4,9,0.05333333333333334,0.13636363636363635
"[1, 0, 0, 0, 1, 1, 0, 0, 0, 0, 0, 1, 0, 1, 1]",172,101,71,17,6,0.16831683168316833,0.08450704225352113
"[0, 0, 1, 0, 1, 1, 0, 0, 1, 1, 1, 1, 0, 1, 0]",131,67,64,3,7,0.04477611940298507,0.109375
"[1, 1, 0, 0, 0, 1, 0, 0, 1, 0, 0, 0, 0, 0, 1]",277,168,109,12,5,0.07142857142857142,0.045871559633027525
"[0, 0, 0, 0, 1, 0, 0, 1, 1, 1, 0, 1, 1, 1, 1]",139,71,68,6,8,0.08450704225352113,0.11764705882352941
"[1, 0, 1, 0, 1, 1, 0, 0, 0, 1, 1, 1, 0, 1, 0]",98,50,48,6,2,0.12,0.041666666666666664
"[1, 1, 1, 0, 0, 1, 1, 0, 1, 0, 1, 1, 0, 0, 1]",196,72,124,11,10,0.1527777777777778,0.08064516129032258
"[0, 1, 1, 1, 1, 0, 1, 1, 1, 1, 0, 1, 0, 0, 1]",269,106,163,10,18,0.09433962264150944,0.11042944785276074
"[0, 0, 1, 0, 1, 1, 0, 1, 1, 0, 0, 1, 0, 1, 1]",118,60,58,7,7,0.11666666666666667,0.1206896551724138
"[0, 1, 0, 1, 1, 0, 1, 0, 0, 0, 1, 0, 0, 1, 1]",109,53,56,3,7,0.05660377358490566,0.125
"[1, 1, 1, 1, 1, 0, 0, 1, 0, 1, 1, 0, 1, 0, 0]",175,54,121,5,14,0.09259259259259259,0.11570247933884298
"[0, 0, 0, 1, 1, 0, 0, 1, 0, 1, 1, 1, 1, 1, 0]",148,83,65,6,4,0.07228915662650602,0.06153846153846154
"[1, 0, 0, 1, 0, 1, 1, 1, 1, 1, 0, 0, 1, 1, 1]",407,127,280,11,28,0.08661417322834646,0.1
"[1, 0, 0, 0, 0, 1, 0, 0, 1, 0, 1, 1, 0, 0, 1]",138,71,67,8,3,0.11267605633802817,0.04477611940298507
"[1, 0, 0, 1, 1, 0, 0, 0, 0, 1, 1, 1, 0, 0, 0]",278,112,166,11,14,0.09821428571428571,0.08433734939759036
"[0, 1, 1, 0, 0, 1, 1, 0, 1, 1, 1, 1, 0, 0, 1]",213,116,97,10,8,0.08620689655172414,0.08247422680412371
"[1, 0, 1, 0, 1, 0, 1, 0, 0, 1, 0, 0, 0, 1, 0]",137,86,51,7,4,0.08139534883720931,0.0784313725490196
"[0, 0, 0, 1, 1, 1, 1, 0, 1, 1, 1, 1, 0, 0, 0]",170,103,67,9,6,0.08737864077669903,0.08955223880597014
"[1, 1, 1, 1, 0, 1, 1, 0, 0, 0, 0, 1, 1, 1, 0]",178,74,104,12,12,0.16216216216216217,0.11538461538461539
"[1, 1, 0, 0, 0, 0, 0, 1, 0, 1, 1, 1, 1, 0, 1]",116,52,64,3,8,0.057692307692307696,0.125
"[0, 1, 0, 0, 1, 0, 1, 0, 0, 1, 1, 0, 1, 1, 1]",125,66,59,8,5,0.12121212121212122,0.0847457627118644
"[1, 0, 0, 0, 0, 0, 0, 1, 1, 1, 1, 0, 1, 1, 0]",234,86,148,6,15,0.06976744186046512,0.10135135135135136
"[1, 0, 1, 0, 1, 1, 0, 0, 1, 0, 1, 1, 0, 1, 1]",165,67,98,3,10,0.04477611940298507,0.10204081632653061
"[0, 0, 0, 1, 1, 0, 1, 1, 0, 1, 1, 1, 0, 0, 1]",128,66,62,8,5,0.12121212121212122,0.08064516129032258
"[0, 0, 0, 1, 1, 1, 0, 0, 1, 0, 1, 1, 1, 1, 0]",124,75,49,11,5,0.14666666666666667,0.10204081632653061
"[1, 0, 0, 1, 1, 1, 0, 0, 0, 0, 1, 0, 1, 0, 0]",138,69,69,7,6,0.10144927536231885,0.08695652173913043
"[0, 1, 1, 0, 0, 1, 1, 1, 0, 0, 0, 0, 1, 0, 1]",127,80,47,8,2,0.1,0.0425531914893617
"[1, 1, 0, 0, 1, 1, 1, 0, 1, 0, 0, 1, 0, 1, 1]",172,79,93,8,8,0.10126582278481013,0.08602150537634409
"[1, 0, 1, 1, 0, 1, 0, 1, 0, 1, 1, 0, 0, 0, 0]",129,55,74,3,7,0.05454545454545454,0.0945945945945946
"[1, 1, 1, 1, 0, 1, 0, 1, 1, 0, 1, 0, 0, 0, 1]",150,63,87,3,7,0.047619047619047616,0.08045977011494253
"[0, 1, 1, 1, 0, 0, 1, 1, 0, 1, 0, 1, 0, 0, 1]",114,52,62,3,5,0.057692307692307696,0.08064516129032258
"[1, 1, 0, 1, 1, 0, 1, 0, 0, 0, 0, 0, 1, 1, 0]",147,72,75,6,6,0.08333333333333333,0.08
"[1, 1, 1, 0, 1, 0, 0, 0, 0, 0, 1, 1, 1, 1, 0]",198,96,102,7,10,0.07291666666666667,0.09803921568627451
"[0, 0, 0, 0, 1, 1, 0, 1, 0, 1, 1, 1, 1, 1, 1]",324,137,187,14,23,0.10218978102189781,0.12299465240641712
"[1, 0, 1, 0, 1, 0, 0, 0, 1, 1, 1, 0, 0, 0, 1]",133,72,61,8,3,0.1111111111111111,0.04918032786885246
"[0, 1, 1, 1, 1, 1, 1, 0, 0, 1, 0, 0, 1, 0, 0]",162,108,54,6,5,0.05555555555555555,0.09259259259259259
"[0, 1, 1, 0, 1, 0, 0, 1, 1, 0, 0, 0, 0, 1, 0]",138,83,55,4,6,0.04819277108433735,0.10909090909090909
"[0, 1, 1, 0, 1, 1, 1, 0, 0, 1, 0, 1, 1, 0, 0]",119,58,61,8,1,0.13793103448275862,0.01639344262295082
"[1, 0, 0, 1, 1, 1, 0, 1, 1, 1, 1, 1, 0, 1, 0]",205,72,133,7,14,0.09722222222222222,0.10526315789473684
"[0, 0, 1, 0, 1, 1, 1, 0, 0, 0, 0, 1, 0, 1, 0]",132,75,57,1,6,0.013333333333333334,0.10526315789473684
"[0, 0, 1, 0, 1, 1, 0, 1, 0, 1, 1, 0, 0, 0, 0]",187,110,77,8,4,0.07272727272727272,0.05194805194805195
"[1, 1, 0, 1, 0, 0, 0, 0, 0, 0, 1, 0, 0, 1, 1]",188,120,68,12,9,0.1,0.1323529411764706
"[1, 1, 1, 0, 1, 0, 1, 1, 1, 0, 1, 0, 1, 0, 1]",214,70,144,6,11,0.08571428571428572,0.0763888888888889
"[1, 1, 0, 1, 1, 0, 1, 1, 0, 1, 0, 0, 1, 0, 1]",132,46,86,6,6,0.13043478260869565,0.06976744186046512
"[0, 0, 0, 0, 1, 1, 0, 1, 0, 1, 0, 1, 1, 0, 1]",117,69,48,7,6,0.10144927536231885,0.125
"[1, 1, 1, 0, 0, 1, 1, 0, 0, 0, 0, 0, 1, 0, 1]",272,87,185,10,21,0.11494252873563218,0.11351351351351352
"[0, 0, 0, 1, 1, 1, 0, 0, 1, 0, 1, 1, 0, 0, 1]",145,85,60,7,3,0.08235294117647059,0.05
"[1, 1, 1, 1, 0, 0, 1, 0, 0, 0, 0, 1, 0, 0, 1]",129,67,62,2,7,0.029850746268656716,0.11290322580645161
"[1, 0, 0, 1, 0, 1, 0, 0, 1, 0, 0, 0, 0, 1, 1]",213,127,86,17,7,0.13385826771653545,0.08139534883720931
"[0, 1, 0, 0, 1, 1, 1, 1, 1, 1, 1, 0, 0, 1, 0]",181,71,110,9,9,0.1267605633802817,0.08181818181818182
"[1, 1, 0, 1, 0, 0, 0, 0, 1, 1, 1, 0, 0, 0, 1]",109,53,56,5,5,0.09433962264150944,0.08928571428571429
"[1, 1, 1, 0, 0, 0, 1, 0, 0, 0, 0, 1, 1, 1, 0]",131,67,64,4,7,0.05970149253731343,0.109375
"[0, 0, 1, 0, 0, 0, 1, 0, 1, 1, 1, 1, 0, 0, 0]",207,116,91,5,8,0.04310344827586207,0.08791208791208792
"[0, 1, 0, 0, 1, 1, 1, 1, 1, 0, 0, 0, 1, 1, 0]",154,83,71,7,7,0.08433734939759036,0.09859154929577464
"[1, 1, 1, 1, 0, 0, 0, 1, 1, 0, 1, 1, 0, 0, 0]",146,69,77,5,9,0.07246376811594203,0.11688311688311688
"[1, 0, 1, 1, 0, 0, 1, 0, 1, 0, 0, 1, 0, 0, 1]",116,49,67,5,5,0.10204081632653061,0.07462686567164178
"[1, 0, 1, 0, 1, 1, 1, 0, 0, 0, 1, 1, 1, 1, 0]",167,65,102,7,15,0.1076923076923077,0.14705882352941177
"[1, 0, 1, 0, 0, 0, 0, 0, 0, 1, 1, 1, 0, 0, 1]",193,125,68,16,5,0.128,0.07352941176470588
"[1, 1, 0, 1, 0, 0, 1, 0, 1, 0, 1, 0, 0, 1, 1]",125,56,69,7,5,0.125,0.07246376811594203
"[1, 0, 0, 0, 0, 0, 1, 0, 0, 1, 1, 1, 1, 0, 0]",275,161,114,15,4,0.09316770186335403,0.03508771929824561
"[1, 1, 0, 1, 1, 0, 0, 0, 0, 0, 0, 1, 0, 1, 0]",146,83,63,9,3,0.10843373493975904,0.047619047619047616
"[1, 1, 0, 1, 1, 1, 1, 0, 1, 1, 1, 0, 0, 0, 1]",276,81,195,5,22,0.06172839506172839,0.11282051282051282
"[1, 0, 1, 0, 1, 1, 0, 0, 1, 0, 0, 0, 1, 0, 1]",102,51,51,2,7,0.0392156862745098,0.13725490196078433
"[1, 0, 0, 1, 1, 0, 1, 0, 0, 0, 1, 1, 0, 1, 1]",116,52,64,11,7,0.21153846153846154,0.109375
"[1, 0, 0, 0, 0, 1, 1, 1, 0, 1, 1, 0, 0, 0, 1]",130,55,75,2,4,0.03636363636363636,0.05333333333333334
"[0, 1, 0, 0, 0, 1, 1, 0, 1, 0, 1, 1, 1, 1, 0]",126,63,63,6,9,0.09523809523809523,0.14285714285714285
"[1, 1, 1, 0, 1, 0, 0, 1, 0, 1, 0, 1, 1, 0, 0]",126,60,66,9,10,0.15,0.15151515151515152
"[0, 0, 0, 1, 0, 0, 0, 0, 1, 1, 1, 1, 1, 0, 1]",126,64,62,8,5,0.125,0.08064516129032258
"[1, 0, 1, 1, 0, 0, 0, 1, 0, 1, 1, 1, 0, 0, 1]",139,69,70,5,4,0.07246376811594203,0.05714285714285714
"[1, 0, 0, 0, 1, 1, 1, 0, 0, 0, 1, 1, 1, 0, 1]",111,53,58,6,2,0.11320754716981132,0.034482758620689655
"[0, 1, 0, 0, 0, 1, 1, 0, 1, 0, 0, 0, 0, 1, 1]",192,95,97,9,21,0.09473684210526316,0.21649484536082475
"[0, 1, 1, 0, 1, 0, 0, 0, 0, 1, 0, 1, 1, 0, 1]",99,49,50,6,4,0.12244897959183673,0.08
"[0, 0, 0, 0, 0, 0, 1, 0, 0, 1, 1, 1, 1, 1, 0]",257,149,108,14,6,0.09395973154362416,0.05555555555555555
"[1, 0, 0, 1, 0, 0, 1, 1, 0, 1, 0, 0, 1, 0, 0]",139,72,67,7,6,0.09722222222222222,0.08955223880597014
"[0, 1, 0, 0, 0, 1, 0, 1, 0, 0, 0, 1, 1, 0, 1]",118,70,48,9,3,0.12857142857142856,0.0625
"[1, 1, 0, 1, 0, 0, 0, 1, 1, 0, 1, 0, 1, 0, 1]",118,47,71,3,5,0.06382978723404255,0.07042253521126761
"[1, 0, 1, 0, 0, 1, 1, 0, 0, 1, 0, 1, 1, 0, 1]",88,35,53,3,10,0.08571428571428572,0.18867924528301888
"[0, 1, 1, 1, 1, 0, 0, 1, 1, 0, 1, 0, 0, 1, 0]",157,86,71,3,8,0.03488372093023256,0.11267605633802817
"[0, 0, 1, 1, 0, 1, 0, 0, 0, 1, 1, 1, 0, 1, 0]",112,59,53,3,5,0.05084745762711865,0.09433962264150944
"[0, 1, 0, 1, 0, 0, 1, 0, 1, 0, 0, 1, 0, 0, 0]",208,137,71,11,9,0.08029197080291971,0.1267605633802817
"[1, 0, 0, 0, 0, 1, 0, 1, 0, 1, 1, 0, 1, 0, 1]",123,66,57,10,4,0.15151515151515152,0.07017543859649122
"[1, 0, 0, 1, 0, 1, 1, 0, 1, 1, 0, 1, 0, 0, 0]",125,70,55,6,5,0.08571428571428572,0.09090909090909091
"[1, 0, 0, 1, 0, 0, 1, 0, 1, 0, 0, 1, 1, 1, 1]",178,89,89,10,12,0.11235955056179775,0.1348314606741573
"[0, 1, 0, 1, 0, 1, 1, 0, 0, 1, 1, 1, 0, 0, 0]",139,74,65,6,8,0.08108108108108109,0.12307692307692308
"[0, 1, 1, 0, 0, 0, 0, 0, 1, 0, 0, 1, 0, 0, 1]",271,189,82,19,13,0.10052910052910052,0.15853658536585366
"[1, 0, 0, 1, 0, 1, 1, 0, 1, 0, 0, 0, 0, 1, 0]",115,64,51,5,4,0.078125,0.0784313725490196
"[1, 0, 0, 0, 1, 1, 0, 1, 0, 1, 0, 1, 0, 1, 1]",121,58,63,6,7,0.10344827586206896,0.1111111111111111
"[1, 0, 1, 0, 0, 1, 1, 0, 0, 0, 0, 1, 0, 1, 1]",146,74,72,6,7,0.08108108108108109,0.09722222222222222
"[1, 1, 0, 1, 1, 0, 1, 0, 0, 1, 1, 0, 0, 0, 0]",191,101,90,9,13,0.0891089108910891,0.14444444444444443
"[1, 0, 1, 0, 0, 1, 1, 0, 1, 0, 1, 0, 0, 0, 0]",169,101,68,5,9,0.04950495049504951,0.1323529411764706
"[0, 1, 1, 0, 1, 1, 0, 1, 0, 1, 1, 0, 1, 0, 0]",98,36,62,4,11,0.1111111111111111,0.1774193548387097
"[0, 1, 1, 0, 1, 1, 1, 1, 0, 0, 0, 1, 1, 0, 1]",156,66,90,4,11,0.06060606060606061,0.12222222222222222
"[0, 1, 0, 1, 1, 1, 0, 0, 0, 1, 1, 0, 1, 1, 0]",103,47,56,2,3,0.0425531914893617,0.05357142857142857
"[0, 0, 0, 0, 1, 0, 0, 1, 1, 1, 1, 1, 0, 1, 1]",145,77,68,13,4,0.16883116883116883,0.058823529411764705
"[1, 1, 0, 1, 0, 1, 0, 0, 0, 0, 1, 1, 0, 1, 0]",132,67,65,5,3,0.07462686567164178,0.046153846153846156
"[1, 0, 1, 0, 1, 1, 0, 0, 0, 0, 0, 1, 1, 0, 1]",114,61,53,6,6,0.09836065573770492,0.11320754716981132
"[1, 1, 0, 0, 0, 1, 0, 1, 0, 1, 1, 1, 0, 0, 0]",131,67,64,7,7,0.1044776119402985,0.109375
"[0, 1, 1, 0, 1, 0, 1, 1, 1, 1, 0, 0, 0, 1, 0]",116,48,68,9,11,0.1875,0.16176470588235295
"[0, 0, 1, 1, 1, 0, 1, 0, 1, 1, 0, 1, 0, 0, 0]",104,58,46,6,10,0.10344827586206896,0.21739130434782608
"[1, 0, 0, 1, 0, 1, 1, 1, 0, 0, 0, 0, 1, 0, 1]",106,59,47,7,5,0.11864406779661017,0.10638297872340426
"[1, 0, 1, 1, 1, 0, 0, 0, 1, 0, 1, 1, 0, 1, 1]",139,58,81,8,8,0.13793103448275862,0.09876543209876543
"[1, 0, 1, 0, 0, 1, 0, 1, 1, 1, 0, 1, 0, 0, 0]",128,67,61,9,7,0.13432835820895522,0.11475409836065574
"[1, 0, 0, 0, 1, 1, 1, 1, 0, 0, 0, 1, 0, 0, 1]",130,54,76,4,11,0.07407407407407407,0.14473684210526316
"[0, 1, 1, 0, 0, 1, 1, 1, 1, 0, 1, 0, 0, 0, 0]",184,114,70,9,6,0.07894736842105263,0.08571428571428572
"[1, 0, 0, 0, 0, 1, 0, 0, 1, 1, 0, 1, 1, 1, 1]",161,57,104,6,9,0.10526315789473684,0.08653846153846154
"[0, 1, 0, 1, 0, 0, 1, 1, 1, 0, 0, 1, 1, 0, 0]",196,108,88,6,9,0.05555555555555555,0.10227272727272728
"[1, 1, 0, 0, 0, 1, 1, 1, 0, 1, 1, 0, 0, 1, 1]",226,91,135,15,13,0.16483516483516483,0.0962962962962963
"[0, 1, 1, 0, 0, 1, 1, 1, 1, 1, 0, 0, 1, 0, 1]",194,96,98,7,14,0.07291666666666667,0.14285714285714285
"[1, 1, 1, 0, 1, 1, 0, 1, 0, 0, 0, 0, 1, 1, 1]",275,109,166,11,12,0.10091743119266056,0.07228915662650602
"[0, 0, 0, 1, 1, 0, 1, 0, 0, 1, 0, 1, 1, 0, 0]",165,90,75,6,6,0.06666666666666667,0.08
"[0, 1, 1, 0, 0, 1, 0, 0, 0, 1, 1, 1, 1, 0, 1]",110,39,71,5,7,0.1282051282051282,0.09859154929577464
"[0, 0, 0, 1, 0, 1, 0, 0, 1, 1, 0, 1, 0, 1, 0]",136,78,58,5,6,0.0641025641025641,0.10344827586206896
"[0, 1, 0, 1, 1, 1, 1, 0, 0, 0, 0, 0, 0, 0, 1]",264,167,97,12,7,0.0718562874251497,0.07216494845360824
"[1, 0, 1, 0, 0, 1, 0, 1, 1, 1, 1, 1, 0, 0, 1]",187,75,112,6,8,0.08,0.07142857142857142
"[1, 0, 1, 0, 0, 1, 0, 1, 0, 0, 1, 0, 1, 1, 1]",120,53,67,6,5,0.11320754716981132,0.07462686567164178
"[0, 1, 0, 1, 1, 0, 0, 1, 1, 1, 0, 1, 1, 0, 0]",118,56,62,5,5,0.08928571428571429,0.08064516129032258
"[0, 1, 0, 1, 1, 0, 1, 0, 1, 0, 0, 1, 0, 0, 1]",113,65,48,11,1,0.16923076923076924,0.020833333333333332
"[0, 0, 1, 1, 0, 1, 0, 0, 1, 1, 1, 1, 1, 0, 0]",150,69,81,10,6,0.14492753623188406,0.07407407407407407
"[0, 1, 1, 1, 1, 1, 0, 0, 0, 1, 1, 0, 0, 1, 1]",267,117,150,9,15,0.07692307692307693,0.1
"[1, 1, 0, 0, 0, 0, 1, 1, 0, 1, 1, 1, 0, 0, 1]",181,79,102,9,8,0.11392405063291139,0.0784313725490196
"[1, 0, 0, 1, 1, 1, 0, 1, 1, 1, 0, 0, 0, 1, 1]",208,66,142,7,16,0.10606060606060606,0.11267605633802817
"[1, 1, 0, 0, 1, 1, 0, 1, 1, 0, 0, 1, 0, 0, 0]",123,65,58,4,4,0.06153846153846154,0.06896551724137931
"[0, 1, 0, 1, 0, 0, 0, 0, 1, 0, 1, 1, 0, 0, 1]",148,78,70,10,8,0.1282051282051282,0.11428571428571428
"[1, 1, 0, 1, 1, 0, 1, 0, 0, 0, 1, 0, 1, 0, 1]",98,51,47,6,3,0.11764705882352941,0.06382978723404255
"[1, 0, 1, 1, 1, 1, 0, 1, 1, 0, 1, 0, 1, 0, 0]",119,49,70,6,6,0.12244897959183673,0.08571428571428572
"[1, 1, 0, 0, 1, 1, 1, 0, 1, 1, 1, 0, 1, 0, 1]",228,71,157,10,19,0.14084507042253522,0.12101910828025478
"[1, 1, 1, 0, 0, 0, 0, 0, 1, 1, 0, 0, 0, 1, 0]",189,85,104,6,10,0.07058823529411765,0.09615384615384616
"[1, 0, 0, 1, 0, 1, 0, 1, 1, 1, 1, 1, 1, 0, 1]",227,79,148,7,14,0.08860759493670886,0.0945945945945946
"[0, 0, 1, 0, 1, 1, 0, 0, 0, 1, 1, 0, 1, 1, 0]",122,57,65,7,5,0.12280701754385964,0.07692307692307693
"[0, 0, 1, 0, 1, 1, 0, 0, 0, 1, 1, 0, 0, 1, 1]",209,112,97,14,13,0.125,0.13402061855670103
"[1, 1, 0, 0, 0, 0, 1, 0, 1, 0, 1, 0, 0, 1, 1]",153,88,65,5,6,0.056818181818181816,0.09230769230769231
"[0, 1, 0, 0, 0, 1, 1, 1, 1, 1, 1, 1, 0, 1, 1]",274,105,169,13,14,0.12380952380952381,0.08284023668639054
"[1, 0, 0, 0, 1, 0, 1, 1, 0, 0, 1, 1, 1, 1, 1]",294,126,168,9,15,0.07142857142857142,0.08928571428571429
"[0, 0, 1, 0, 0, 1, 0, 0, 0, 0, 0, 1, 0, 1, 1]",272,180,92,18,10,0.1,0.10869565217391304
"[1, 1, 0, 0, 0, 0, 1, 0, 1, 1, 1, 0, 0, 0, 1]",114,51,63,3,4,0.058823529411764705,0.06349206349206349
"[0, 0, 0, 1, 0, 1, 1, 0, 1, 0, 1, 0, 1, 0, 1]",115,61,54,6,3,0.09836065573770492,0.05555555555555555
"[0, 1, 0, 1, 0, 0, 0, 0, 0, 1, 0, 1, 1, 0, 1]",146,86,60,7,6,0.08139534883720931,0.1
"[1, 0, 1, 0, 1, 1, 0, 0, 1, 0, 1, 0, 0, 0, 1]",117,70,47,8,3,0.11428571428571428,0.06382978723404255
"[0, 0, 1, 0, 0, 0, 1, 0, 1, 0, 1, 0, 1, 1, 0]",130,85,45,9,6,0.10588235294117647,0.13333333333333333
"[0, 0, 1, 1, 0, 1, 1, 0, 1, 0, 1, 0, 0, 1, 1]",138,68,70,8,6,0.11764705882352941,0.08571428571428572
"[1, 0, 1, 0, 0, 1, 1, 0, 1, 1, 0, 1, 0, 1, 0]",109,58,51,5,5,0.08620689655172414,0.09803921568627451
"[0, 1, 0, 0, 1, 0, 0, 0, 0, 1, 1, 1, 0, 1, 1]",118,57,61,6,6,0.10526315789473684,0.09836065573770492
"[0, 0, 0, 1, 1, 0, 1, 1, 0, 0, 1, 1, 1, 0, 1]",126,64,62,5,5,0.078125,0.08064516129032258
"[1, 0, 0, 0, 0, 1, 0, 0, 1, 1, 1, 0, 1, 0, 1]",96,46,50,7,5,0.15217391304347827,0.1
"[0, 1, 1, 0, 1, 0, 0, 1, 0, 1, 0, 0, 1, 0, 0]",140,88,52,12,1,0.13636363636363635,0.019230769230769232
"[0, 1, 1, 1, 0, 0, 0, 1, 1, 1, 0, 0, 0, 1, 0]",116,66,50,6,3,0.09090909090909091,0.06
"[0, 0, 0, 1, 0, 0, 1, 0, 1, 1, 1, 1, 0, 1, 0]",97,59,38,5,3,0.0847457627118644,0.07894736842105263
"[0, 1, 1, 1, 1, 1, 0, 0, 0, 0, 0, 1, 1, 0, 1]",149,75,74,8,7,0.10666666666666667,0.0945945945945946
"[0, 1, 0, 0, 0, 0, 1, 1, 0, 1, 1, 1, 1, 0, 1]",106,58,48,5,5,0.08620689655172414,0.10416666666666667
"[1, 1, 1, 1, 0, 0, 1, 0, 0, 0, 1, 0, 1, 0, 0]",131,54,77,6,3,0.1111111111111111,0.03896103896103896
"[1, 1, 0, 0, 1, 1, 1, 0, 1, 0, 0, 1, 1, 0, 1]",171,86,85,7,13,0.08139534883720931,0.15294117647058825
"[1, 0, 0, 0, 1, 0, 1, 1, 0, 0, 1, 0, 0, 1, 1]",133,66,67,5,4,0.07575757575757576,0.05970149253731343
"[1, 0, 0, 1, 1, 1, 0, 0, 1, 0, 0, 0, 1, 1, 0]",122,65,57,7,4,0.1076923076923077,0.07017543859649122
"[0, 0, 0, 0, 1, 1, 1, 0, 1, 1, 1, 0, 1, 0, 1]",136,67,69,6,9,0.08955223880597014,0.13043478260869565
"[1, 0, 0, 0, 1, 0, 0, 0, 1, 0, 1, 0, 1, 0, 1]",127,82,45,8,3,0.0975609756097561,0.06666666666666667
"[1, 0, 0, 1, 0, 1, 0, 0, 0, 1, 0, 1, 1, 1, 1]",128,53,75,11,9,0.20754716981132076,0.12
"[1, 0, 0, 0, 0, 0, 0, 1, 0, 1, 1, 0, 1, 1, 0]",135,68,67,9,11,0.1323529411764706,0.16417910447761194
"[1, 0, 0, 1, 1, 1, 0, 0, 0, 0, 1, 1, 1, 0, 0]",160,84,76,14,7,0.16666666666666666,0.09210526315789473
"[1, 1, 0, 1, 0, 0, 1, 0, 0, 0, 0, 0, 1, 1, 0]",189,105,84,11,10,0.10476190476190476,0.11904761904761904
"[1, 1, 1, 0, 1, 0, 1, 1, 0, 1, 0, 1, 0, 0, 1]",116,45,71,6,8,0.13333333333333333,0.11267605633802817
"[1, 0, 1, 1, 0, 1, 0, 0, 0, 0, 0, 1, 0, 1, 1]",111,49,62,7,6,0.14285714285714285,0.0967741935483871
"[1, 1, 1, 0, 0, 0, 1, 0, 0, 1, 1, 0, 1, 1, 1]",186,68,118,7,10,0.10294117647058823,0.0847457627118644
"[0, 0, 1, 0, 0, 1, 0, 1, 0, 1, 1, 0, 0, 1, 0]",136,90,46,6,2,0.06666666666666667,0.043478260869565216
"[1, 1, 1, 0, 0, 0, 1, 1, 0, 1, 1, 0, 0, 1, 0]",111,40,71,7,3,0.175,0.04225352112676056
"[0, 1, 1, 0, 0, 1, 1, 1, 0, 0, 0, 1, 1, 0, 1]",136,77,59,4,6,0.05194805194805195,0.1016949152542373
"[0, 0, 1, 0, 1, 0, 1, 1, 1, 1, 1, 0, 0, 0, 1]",130,59,71,8,6,0.13559322033898305,0.08450704225352113
"[1, 1, 0, 1, 0, 1, 0, 1, 0, 1, 1, 1, 1, 1, 0]",251,90,161,9,15,0.1,0.09316770186335403
"[0, 0, 1, 0, 0, 1, 0, 1, 1, 0, 0, 1, 1, 1, 1]",206,100,106,6,14,0.06,0.1320754716981132
"[0, 1, 0, 0, 1, 1, 0, 1, 0, 1, 1, 0, 1, 0, 0]",111,63,48,7,4,0.1111111111111111,0.08333333333333333
"[1, 0, 0, 0, 1, 0, 1, 0, 1, 0, 0, 0, 1, 1, 0]",164,89,75,13,9,0.14606741573033707,0.12
"[0, 0, 1, 0, 1, 0, 0, 1, 0, 0, 0, 1, 1, 0, 1]",135,78,57,7,5,0.08974358974358974,0.08771929824561403
"[1, 0, 1, 0, 1, 0, 0, 0, 0, 1, 0, 1, 0, 1, 0]",129,82,47,17,3,0.2073170731707317,0.06382978723404255
"[1, 0, 1, 0, 0, 1, 0, 0, 1, 0, 0, 1, 1, 1, 0]",116,58,58,5,4,0.08620689655172414,0.06896551724137931
"[1, 1, 0, 1, 1, 0, 1, 1, 0, 1, 0, 0, 0, 1, 0]",97,50,47,4,8,0.08,0.1702127659574468
"[0, 1, 1, 0, 0, 1, 1, 1, 0, 0, 0, 1, 1, 0, 0]",169,96,73,11,6,0.11458333333333333,0.0821917808219178
"[0, 1, 0, 0, 0, 0, 1, 0, 0, 1, 1, 1, 1, 0, 1]",113,59,54,4,4,0.06779661016949153,0.07407407407407407
"[0, 0, 1, 1, 0, 1, 1, 0, 1, 1, 0, 0, 1, 0, 1]",109,48,61,4,6,0.08333333333333333,0.09836065573770492
"[0, 1, 0, 1, 0, 1, 0, 1, 1, 0, 1, 1, 0, 0, 0]",131,76,55,6,4,0.07894736842105263,0.07272727272727272
"[1, 1, 1, 1, 0, 0, 1, 1, 1, 0, 1, 0, 1, 1, 0]",316,119,197,10,23,0.08403361344537816,0.116751269035533
"[1, 0, 1, 1, 0, 0, 0, 1, 0, 0, 1, 0, 1, 0, 0]",137,80,57,7,3,0.0875,0.05263157894736842
"[1, 1, 1, 0, 0, 0, 1, 1, 1, 1, 1, 0, 0, 0, 1]",190,67,123,5,10,0.07462686567164178,0.08130081300813008
"[1, 0, 0, 1, 0, 1, 1, 0, 1, 1, 0, 0, 0, 1, 1]",153,65,88,6,5,0.09230769230769231,0.056818181818181816
"[0, 1, 1, 0, 1, 0, 1, 1, 1, 0, 1, 0, 1, 1, 0]",140,55,85,7,6,0.12727272727272726,0.07058823529411765
"[0, 0, 0, 1, 1, 1, 0, 0, 1, 0, 1, 1, 0, 1, 1]",113,57,56,3,8,0.05263157894736842,0.14285714285714285
"[1, 0, 1, 0, 0, 0, 0, 1, 1, 1, 0, 0, 1, 0, 0]",149,93,56,6,6,0.06451612903225806,0.10714285714285714
"[0, 1, 1, 0, 0, 1, 1, 1, 0, 1, 0, 0, 1, 0, 1]",131,71,60,6,4,0.08450704225352113,0.06666666666666667
"[1, 0, 1, 0, 1, 1, 1, 0, 0, 0, 1, 0, 1, 1, 1]",141,51,90,10,9,0.19607843137254902,0.1
"[0, 1, 0, 0, 0, 0, 1, 1, 1, 1, 1, 0, 1, 0, 0]",106,53,53,3,3,0.05660377358490566,0.05660377358490566
"[0, 1, 0, 0, 1, 1, 0, 1, 0, 1, 1, 1, 0, 1, 1]",141,58,83,4,7,0.06896551724137931,0.08433734939759036
"[1, 1, 0, 0, 1, 1, 1, 0, 1, 1, 0, 0, 1, 0, 0]",126,70,56,6,12,0.08571428571428572,0.21428571428571427
"[0, 1, 1, 0, 0, 0, 0, 0, 1, 0, 1, 1, 1, 1, 0]",131,73,58,7,4,0.0958904109589041,0.06896551724137931
"[0, 0, 0, 0, 1, 1, 1, 0, 1, 1, 1, 0, 0, 1, 0]",125,57,68,5,9,0.08771929824561403,0.1323529411764706
"[1, 1, 0, 0, 1, 1, 0, 0, 0, 1, 1, 0, 1, 0, 1]",164,74,90,3,2,0.04054054054054054,0.022222222222222223
"[1, 1, 0, 1, 0, 0, 0, 0, 0, 0, 0, 1, 0, 1, 1]",157,88,69,6,4,0.06818181818181818,0.057971014492753624
"[1, 1, 1, 1, 0, 1, 1, 0, 1, 1, 0, 1, 0, 0, 0]",162,71,91,6,5,0.08450704225352113,0.054945054945054944
"[1, 1, 1, 0, 0, 0, 1, 0, 1, 0, 1, 0, 0, 0, 1]",130,62,68,3,6,0.04838709677419355,0.08823529411764706
"[1, 0, 0, 1, 0, 1, 0, 1, 1, 1, 0, 1, 1, 1, 0]",123,48,75,3,7,0.0625,0.09333333333333334
"[0, 0, 0, 1, 1, 1, 0, 0, 1, 0, 0, 1, 0, 0, 1]",162,107,55,12,2,0.11214953271028037,0.03636363636363636
"[1, 0, 0, 0, 1, 1, 1, 1, 1, 0, 0, 0, 1, 1, 1]",226,85,141,5,11,0.058823529411764705,0.07801418439716312
"[1, 0, 1, 0, 1, 0, 0, 0, 0, 1, 1, 0, 1, 1, 0]",132,68,64,5,7,0.07352941176470588,0.109375
"[0, 1, 0, 1, 1, 1, 1, 0, 0, 0, 1, 0, 0, 1, 0]",112,69,43,10,3,0.14492753623188406,0.06976744186046512
"[1, 0, 1, 0, 0, 1, 0, 1, 1, 1, 1, 0, 0, 0, 1]",97,44,53,5,5,0.11363636363636363,0.09433962264150944
"[0, 0, 0, 0, 1, 0, 1, 1, 0, 1, 1, 0, 1, 1, 0]",109,65,44,3,4,0.046153846153846156,0.09090909090909091
"[0, 0, 1, 1, 0, 0, 0, 1, 1, 1, 0, 1, 1, 0, 1]",137,74,63,5,5,0.06756756756756757,0.07936507936507936
"[0, 1, 0, 0, 0, 0, 0, 1, 0, 1, 1, 1, 1, 0, 1]",114,57,57,3,7,0.05263157894736842,0.12280701754385964
"[1, 0, 1, 0, 0, 1, 0, 1, 1, 1, 0, 0, 1, 0, 1]",97,52,45,4,3,0.07692307692307693,0.06666666666666667
"[1, 1, 0, 0, 1, 1, 1, 0, 1, 0, 1, 1, 0, 0, 0]",159,75,84,5,9,0.06666666666666667,0.10714285714285714
"[1, 1, 1, 0, 0, 0, 0, 1, 1, 0, 1, 0, 1, 1, 0]",167,62,105,5,12,0.08064516129032258,0.11428571428571428
"[0, 1, 0, 1, 1, 1, 1, 0, 0, 0, 0, 1, 1, 1, 0]",140,69,71,8,4,0.11594202898550725,0.056338028169014086
"[0, 1, 0, 1, 1, 0, 0, 1, 1, 0, 0, 0, 1, 1, 0]",135,73,62,9,10,0.1232876712328767,0.16129032258064516
"[1, 1, 0, 1, 0, 1, 1, 0, 1, 0, 0, 1, 0, 1, 0]",89,44,45,9,4,0.20454545454545456,0.08888888888888889
"[1, 0, 1, 0, 0, 1, 1, 0, 1, 0, 0, 1, 0, 0, 0]",135,79,56,13,5,0.16455696202531644,0.08928571428571429
"[1, 0, 1, 1, 1, 1, 1, 0, 0, 1, 1, 1, 0, 0, 0]",205,82,123,8,9,0.0975609756097561,0.07317073170731707
"[1, 0, 0, 1, 1, 0, 0, 1, 0, 0, 1, 0, 0, 0, 1]",145,67,78,6,6,0.08955223880597014,0.07692307692307693
"[1, 1, 1, 0, 1, 0, 0, 1, 0, 1, 1, 0, 1, 0, 1]",122,48,74,2,5,0.041666666666666664,0.06756756756756757
"[1, 0, 1, 0, 0, 0, 1, 0, 0, 1, 1, 0, 1, 1, 0]",99,46,53,3,8,0.06521739130434782,0.1509433962264151
"[1, 0, 1, 0, 0, 1, 1, 0, 1, 1, 1, 1, 0, 1, 0]",135,53,82,10,5,0.18867924528301888,0.06097560975609756
"[0, 1, 0, 1, 0, 0, 1, 1, 1, 0, 0, 1, 0, 1, 1]",117,47,70,5,6,0.10638297872340426,0.08571428571428572
"[0, 1, 1, 1, 1, 1, 0, 1, 0, 0, 1, 0, 1, 1, 0]",127,46,81,4,10,0.08695652173913043,0.12345679012345678
"[0, 1, 1, 0, 1, 0, 1, 0, 1, 1, 0, 0, 1, 1, 0]",136,71,65,6,6,0.08450704225352113,0.09230769230769231
"[0, 0, 0, 1, 0, 1, 1, 1, 0, 1, 0, 1, 1, 0, 1]",86,38,48,3,3,0.07894736842105263,0.0625
"[1, 1, 1, 1, 0, 1, 0, 1, 0, 0, 0, 1, 0, 1, 1]",175,66,109,6,9,0.09090909090909091,0.08256880733944955
"[0, 0, 1, 0, 1, 0, 0, 0, 1, 1, 0, 1, 1, 1, 0]",120,69,51,9,9,0.13043478260869565,0.17647058823529413
"[1, 0, 0, 0, 0, 1, 0, 0, 0, 1, 1, 0, 1, 1, 1]",154,58,96,4,11,0.06896551724137931,0.11458333333333333
"[0, 1, 0, 1, 0, 1, 1, 1, 0, 0, 1, 0, 0, 0, 0]",160,94,66,10,10,0.10638297872340426,0.15151515151515152
"[0, 1, 1, 1, 1, 0, 0, 0, 0, 0, 1, 0, 0, 0, 0]",421,321,100,27,10,0.08411214953271028,0.1
"[1, 0, 1, 0, 1, 1, 1, 0, 0, 1, 0, 1, 0, 0, 0]",127,65,62,7,5,0.1076923076923077,0.08064516129032258
"[0, 1, 1, 1, 1, 0, 0, 0, 1, 1, 0, 1, 0, 1, 0]",128,71,57,8,7,0.11267605633802817,0.12280701754385964
"[0, 0, 0, 1, 1, 0, 1, 1, 0, 0, 0, 1, 1, 1, 0]",126,69,57,5,2,0.07246376811594203,0.03508771929824561
"[0, 0, 0, 0, 1, 0, 0, 1, 0, 0, 1, 1, 1, 1, 1]",228,124,104,7,10,0.056451612903225805,0.09615384615384616
"[0, 1, 0, 1, 0, 0, 1, 0, 0, 1, 0, 1, 0, 0, 1]",126,82,44,11,8,0.13414634146341464,0.18181818181818182
"[0, 0, 1, 1, 0, 1, 0, 1, 0, 1, 0, 0, 1, 0, 0]",125,71,54,6,6,0.08450704225352113,0.1111111111111111
"[1, 0, 0, 1, 1, 1, 0, 0, 1, 0, 0, 0, 0, 0, 1]",164,80,84,6,10,0.075,0.11904761904761904
"[0, 0, 1, 0, 0, 1, 0, 0, 0, 0, 1, 1, 1, 0, 1]",134,75,59,6,4,0.08,0.06779661016949153
"[0, 1, 1, 1, 0, 1, 0, 0, 1, 1, 1, 1, 0, 1, 0]",132,61,71,4,4,0.06557377049180328,0.056338028169014086
"[1, 1, 0, 1, 1, 0, 1, 0, 0, 0, 0, 0, 1, 0, 1]",104,62,42,3,1,0.04838709677419355,0.023809523809523808
"[0, 1, 0, 0, 1, 1, 0, 1, 1, 0, 0, 0, 1, 1, 0]",120,73,47,9,7,0.1232876712328767,0.14893617021276595
"[0, 0, 1, 0, 0, 1, 0, 1, 1, 1, 1, 0, 0, 1, 0]",143,68,75,7,6,0.10294117647058823,0.08
"[1, 0, 0, 1, 1, 0, 1, 0, 1, 0, 1, 0, 0, 1, 0]",105,46,59,6,4,0.13043478260869565,0.06779661016949153
"[0, 0, 1, 0, 0, 1, 0, 1, 1, 0, 1, 1, 0, 0, 1]",113,62,51,7,7,0.11290322580645161,0.13725490196078433
"[1, 0, 1, 0, 0, 0, 1, 0, 0, 1, 0, 1, 1, 0, 1]",110,57,53,5,7,0.08771929824561403,0.1320754716981132
"[1, 0, 1, 0, 0, 1, 0, 1, 1, 0, 0, 0, 1, 0, 0]",155,84,71,6,8,0.07142857142857142,0.11267605633802817
"[1, 1, 0, 1, 0, 1, 1, 1, 1, 1, 0, 0, 1, 0, 0]",139,60,79,7,8,0.11666666666666667,0.10126582278481013
"[0, 1, 0, 0, 1, 0, 0, 1, 0, 1, 1, 1, 0, 0, 1]",127,78,49,9,4,0.11538461538461539,0.08163265306122448
"[1, 1, 0, 0, 0, 1, 1, 0, 1, 0, 0, 0, 1, 1, 1]",169,61,108,4,15,0.06557377049180328,0.1388888888888889
"[1, 0, 1, 1, 1, 0, 0, 0, 1, 1, 1, 0, 1, 0, 1]",152,59,93,0,10,0.0,0.10752688172043011
"[1, 0, 0, 1, 1, 0, 1, 1, 1, 0, 1, 0, 1, 1, 0]",164,70,94,10,15,0.14285714285714285,0.1595744680851064
"[0, 1, 1, 0, 1, 0, 0, 1, 1, 0, 1, 1, 1, 0, 1]",134,48,86,1,7,0.020833333333333332,0.08139534883720931
"[0, 1, 0, 1, 1, 1, 0, 1, 1, 1, 0, 0, 1, 0, 1]",137,66,71,7,10,0.10606060606060606,0.14084507042253522
"[0, 1, 0, 0, 0, 0, 1, 1, 1, 0, 1, 1, 1, 1, 1]",218,86,132,7,11,0.08139534883720931,0.08333333333333333
"[0, 0, 0, 1, 1, 1, 1, 0, 1, 0, 1, 0, 0, 1, 1]",173,108,65,7,8,0.06481481481481481,0.12307692307692308
"[0, 0, 0, 1, 1, 0, 1, 0, 1, 1, 1, 0, 0, 1, 0]",123,70,53,10,6,0.14285714285714285,0.11320754716981132
"[1, 1, 0, 1, 0, 1, 0, 0, 0, 0, 0, 1, 1, 0, 1]",119,65,54,7,2,0.1076923076923077,0.037037037037037035
"[0, 0, 0, 1, 1, 0, 1, 0, 0, 0, 1, 1, 1, 0, 0]",170,110,60,7,5,0.06363636363636363,0.08333333333333333
"[0, 0, 0, 1, 1, 0, 1, 0, 1, 0, 1, 0, 1, 0, 0]",139,83,56,4,2,0.04819277108433735,0.03571428571428571
"[1, 0, 1, 1, 1, 0, 1, 1, 0, 0, 0, 1, 1, 0, 0]",152,80,72,5,4,0.0625,0.05555555555555555
"[1, 0, 0, 1, 1, 0, 1, 0, 1, 0, 0, 1, 0, 0, 1]",108,54,54,5,7,0.09259259259259259,0.12962962962962962
"[1, 1, 0, 1, 0, 0, 1, 1, 0, 1, 1, 0, 0, 1, 0]",109,51,58,6,6,0.11764705882352941,0.10344827586206896
"[1, 1, 0, 1, 1, 0, 0, 1, 1, 0, 0, 0, 1, 0, 0]",118,56,62,5,3,0.08928571428571429,0.04838709677419355
"[1, 0, 0, 0, 1, 0, 0, 1, 0, 1, 1, 1, 0, 0, 1]",101,46,55,6,7,0.13043478260869565,0.12727272727272726
"[1, 0, 0, 0, 1, 1, 1, 0, 0, 1, 1, 1, 1, 0, 1]",157,75,82,6,8,0.08,0.0975609756097561
"[1, 0, 1, 0, 1, 1, 0, 0, 0, 1, 0, 1, 0, 0, 0]",131,90,41,11,5,0.12222222222222222,0.12195121951219512
"[0, 0, 1, 1, 0, 1, 0, 1, 1, 0, 0, 0, 1, 0, 1]",119,66,53,7,4,0.10606060606060606,0.07547169811320754
"[0, 0, 0, 1, 0, 0, 1, 1, 0, 1, 0, 1, 1, 1, 0]",110,59,51,8,2,0.13559322033898305,0.0392156862745098
"[0, 0, 0, 1, 1, 0, 1, 1, 1, 0, 1, 0, 1, 1, 0]",79,45,34,4,2,0.08888888888888889,0.058823529411764705
"[1, 0, 1, 1, 0, 1, 0, 0, 0, 1, 0, 1, 1, 0, 0]",128,70,58,3,6,0.04285714285714286,0.10344827586206896
"[1, 0, 0, 1, 0, 0, 0, 0, 1, 1, 1, 0, 1, 0, 1]",122,61,61,5,5,0.08196721311475409,0.08196721311475409
"[0, 1, 0, 1, 1, 0, 1, 1, 0, 0, 0, 1, 1, 0, 1]",104,51,53,2,6,0.0392156862745098,0.11320754716981132
"[1, 1, 1, 0, 0, 1, 0, 0, 1, 0, 1, 1, 0, 1, 0]",98,42,56,6,9,0.14285714285714285,0.16071428571428573
"[0, 0, 1, 0, 1, 1, 0, 1, 0, 1, 1, 1, 0, 1, 0]",95,55,40,10,2,0.18181818181818182,0.05
"[0, 0, 1, 1, 0, 1, 1, 1, 1, 0, 1, 0, 0, 0, 1]",116,55,61,3,7,0.05454545454545454,0.11475409836065574
"[0, 0, 1, 1, 1, 1, 0, 1, 1, 0, 1, 0, 0, 0, 0]",164,80,84,10,7,0.125,0.08333333333333333
"[1, 0, 0, 1, 0, 0, 1, 0, 1, 0, 1, 0, 1, 1, 0]",115,60,55,7,6,0.11666666666666667,0.10909090909090909
"[0, 1, 0, 0, 0, 1, 1, 1, 1, 0, 0, 0, 0, 0, 1]",208,130,78,9,7,0.06923076923076923,0.08974358974358974
"[1, 0, 0, 0, 1, 1, 0, 0, 0, 0, 0, 1, 1, 1, 0]",161,75,86,3,10,0.04,0.11627906976744186
"[0, 1, 1, 1, 1, 0, 1, 1, 0, 0, 0, 1, 1, 0, 0]",171,92,79,11,9,0.11956521739130435,0.11392405063291139
"[0, 1, 1, 0, 1, 0, 1, 1, 0, 0, 1, 0, 0, 0, 1]",124,61,63,3,9,0.04918032786885246,0.14285714285714285
"[0, 1, 0, 1, 1, 0, 1, 0, 0, 0, 1, 0, 1, 1, 0]",111,62,49,7,1,0.11290322580645161,0.02040816326530612
"[1, 1, 1, 1, 0, 1, 0, 0, 1, 0, 0, 1, 0, 1, 0]",114,57,57,3,11,0.05263157894736842,0.19298245614035087
"[0, 0, 0, 0, 1, 1, 0, 0, 1, 1, 0, 1, 1, 1, 0]",182,94,88,8,15,0.0851063829787234,0.17045454545454544
"[0, 0, 0, 1, 1, 1, 1, 0, 1, 1, 0, 1, 0, 0, 0]",137,77,60,8,4,0.1038961038961039,0.06666666666666667
"[0, 1, 0, 1, 0, 1, 1, 0, 1, 1, 1, 0, 1, 1, 0]",136,57,79,7,7,0.12280701754385964,0.08860759493670886
"[0, 1, 1, 1, 1, 1, 0, 0, 0, 1, 0, 1, 0, 0, 1]",119,58,61,6,7,0.10344827586206896,0.11475409836065574
"[0, 0, 1, 1, 0, 1, 1, 1, 0, 1, 0, 1, 0, 0, 1]",101,47,54,6,2,0.1276595744680851,0.037037037037037035
"[1, 1, 0, 1, 0, 1, 0, 0, 1, 1, 0, 1, 0, 1, 1]",147,54,93,4,4,0.07407407407407407,0.043010752688172046
"[0, 0, 1, 0, 0, 1, 0, 1, 0, 1, 0, 1, 1, 1, 1]",129,72,57,9,1,0.125,0.017543859649122806
"[1, 1, 1, 0, 1, 0, 1, 0, 1, 0, 1, 0, 0, 0, 0]",117,62,55,2,8,0.03225806451612903,0.14545454545454545
"[0, 0, 0, 1, 1, 1, 1, 0, 1, 0, 1, 1, 0, 1, 0]",103,58,45,7,2,0.1206896551724138,0.044444444444444446
"[0, 0, 1, 0, 1, 1, 0, 0, 0, 1, 1, 0, 1, 0, 1]",103,50,53,2,3,0.04,0.05660377358490566
"[0, 0, 1, 1, 1, 0, 1, 0, 0, 1, 1, 1, 0, 0, 1]",131,62,69,4,6,0.06451612903225806,0.08695652173913043
"[0, 1, 1, 1, 1, 1, 1, 1, 1, 1, 1, 0, 0, 0, 0]",2331,1569,762,142,63,0.09050350541746335,0.08267716535433071
"[1, 0, 1, 0, 1, 1, 1, 1, 0, 0, 1, 1, 0, 0, 0]",268,113,155,10,20,0.08849557522123894,0.12903225806451613
"[0, 0, 0, 1, 1, 0, 0, 0, 0, 1, 1, 0, 1, 0, 1]",280,215,65,28,1,0.13023255813953488,0.015384615384615385
"[0, 1, 1, 0, 0, 1, 0, 0, 0, 0, 1, 1, 0, 0, 0]",387,267,120,31,13,0.11610486891385768,0.10833333333333334
"[0, 0, 0, 1, 1, 0, 1, 0, 0, 0, 1, 1, 0, 0, 1]",212,133,79,12,7,0.09022556390977443,0.08860759493670886
"[1, 0, 0, 0, 1, 1, 0, 1, 0, 0, 0, 1, 1, 0, 0]",210,121,89,13,7,0.10743801652892562,0.07865168539325842
"[1, 0, 0, 0, 1, 1, 0, 1, 1, 1, 0, 0, 0, 1, 1]",136,64,72,4,9,0.0625,0.125
"[0, 0, 1, 1, 1, 1, 1, 1, 1, 1, 1, 1, 1, 1, 0]",5906,1602,4304,141,409,0.08801498127340825,0.09502788104089219
"[1, 0, 0, 1, 1, 1, 1, 1, 1, 0, 0, 1, 1, 1, 1]",4866,652,4214,59,407,0.09049079754601227,0.0965828191741813
"[1, 0, 1, 1, 1, 1, 1, 0, 1, 0, 1, 1, 1, 0, 1]",456,136,320,13,24,0.09558823529411764,0.075
"[1, 1, 0, 1, 1, 1, 1, 1, 0, 1, 0, 1, 1, 1, 0]",468,137,331,9,38,0.06569343065693431,0.1148036253776435
"[1, 0, 1, 0, 1, 1, 1, 1, 0, 1, 1, 0, 1, 1, 0]",214,66,148,6,10,0.09090909090909091,0.06756756756756757
"[1, 0, 1, 1, 1, 1, 1, 1, 1, 1, 1, 1, 1, 0, 1]",7245,1287,5958,136,537,0.10567210567210568,0.09013091641490432
"[1, 0, 0, 1, 1, 0, 1, 0, 1, 1, 1, 1, 0, 1, 1]",259,79,180,6,13,0.0759493670886076,0.07222222222222222
"[1, 1, 1, 1, 1, 1, 1, 1, 0, 0, 1, 1, 0, 1, 0]",902,265,637,29,69,0.10943396226415095,0.10832025117739404
"[0, 0, 0, 0, 0, 0, 0, 0, 0, 0, 1, 1, 1, 1, 1]",4170,2869,1301,297,133,0.10352039037992332,0.10222905457340507
"[1, 0, 1, 1, 1, 1, 1, 0, 1, 1, 1, 1, 1, 1, 1]",8337,1534,6803,136,632,0.08865710560625815,0.09290019109216523
"[1, 1, 1, 1, 0, 1, 1, 1, 1, 1, 0, 1, 1, 1, 1]",7600,1375,6225,122,622,0.08872727272727272,0.09991967871485943
"[1, 1, 1, 1, 1, 1, 1, 0, 1, 1, 1, 1, 1, 0, 1]",7100,1256,5844,130,544,0.1035031847133758,0.09308692676249145
"[1, 1, 0, 1, 1, 0, 1, 1, 1, 1, 1, 1, 1, 1, 1]",9096,1672,7424,155,651,0.09270334928229665,0.08768857758620689
"[1, 1, 0, 1, 1, 0, 0, 0, 1, 0, 1, 0, 0, 0, 0]",176,108,68,10,6,0.09259259259259259,0.08823529411764706
"[1, 1, 0, 0, 1, 0, 1, 0, 0, 0, 0, 0, 0, 1, 1]",307,178,129,15,11,0.08426966292134831,0.08527131782945736
"[1, 0, 1, 1, 0, 0, 1, 0, 1, 0, 0, 0, 0, 0, 0]",299,192,107,13,7,0.06770833333333333,0.06542056074766354
"[0, 0, 0, 0, 0, 0, 0, 0, 0, 0, 0, 1, 1, 1, 1]",9301,7945,1356,748,149,0.09414726242920075,0.10988200589970501
"[0, 0, 0, 0, 0, 0, 0, 0, 0, 0, 0, 0, 0, 0, 1]",103043,91552,11491,8644,1153,0.0944162880111849,0.10033939604908189
"[1, 0, 0, 0, 0, 0, 0, 0, 0, 0, 0, 1, 1, 0, 0]",6571,3058,3513,299,307,0.09777632439502944,0.08738969541702249
"[0, 0, 1, 0, 0, 0, 0, 0, 0, 0, 0, 0, 0, 1, 1]",4584,3558,1026,344,108,0.09668353007307476,0.10526315789473684
"[0, 0, 1, 0, 0, 0, 0, 0, 0, 0, 0, 0, 0, 0, 0]",65831,57329,8502,5437,848,0.09483856337979034,0.09974123735591625
"[1, 1, 1, 1, 1, 1, 1, 1, 0, 0, 1, 1, 1, 1, 1]",30976,5387,25589,505,2463,0.09374419899758678,0.09625229590839814
"[1, 1, 1, 1, 1, 1, 0, 1, 1, 1, 1, 1, 1, 1, 1]",62266,7374,54892,657,5298,0.08909682668836452,0.09651679661881513
"[1, 1, 1, 1, 1, 1, 1, 1, 1, 1, 1, 1, 1, 0, 1]",60238,6845,53393,577,5169,0.08429510591672754,0.09681044331653962
"[0, 0, 1, 1, 1, 1, 0, 0, 0, 1, 1, 1, 1, 0, 0]",246,113,133,12,10,0.10619469026548672,0.07518796992481203
"[0, 0, 0, 1, 1, 1, 1, 0, 0, 0, 1, 1, 1, 1, 0]",191,108,83,7,10,0.06481481481481481,0.12048192771084337
"[0, 1, 1, 0, 1, 1, 1, 1, 0, 0, 1, 0, 0, 0, 1]",126,61,65,6,7,0.09836065573770492,0.1076923076923077
"[1, 1, 1, 1, 0, 1, 1, 0, 1, 1, 1, 1, 0, 0, 1]",740,194,546,17,55,0.08762886597938144,0.10073260073260074
"[0, 0, 0, 0, 1, 1, 1, 1, 0, 1, 1, 0, 1, 1, 1]",328,156,172,19,14,0.12179487179487179,0.08139534883720931
"[1, 1, 1, 1, 1, 1, 1, 1, 0, 1, 1, 1, 0, 1, 0]",1717,429,1288,47,133,0.10955710955710955,0.10326086956521739
"[0, 1, 1, 1, 1, 1, 1, 1, 1, 0, 1, 1, 1, 0, 1]",1754,534,1220,49,107,0.09176029962546817,0.08770491803278689
"[1, 1, 1, 1, 0, 1, 0, 0, 0, 1, 1, 1, 1, 1, 1]",942,280,662,27,60,0.09642857142857143,0.09063444108761329
"[1, 0, 1, 1, 0, 1, 1, 1, 1, 0, 1, 1, 1, 1, 1]",1768,431,1337,41,119,0.0951276102088167,0.08900523560209424
"[1, 1, 1, 1, 1, 0, 1, 1, 1, 0, 1, 1, 0, 1, 1]",1645,388,1257,34,115,0.08762886597938144,0.09148766905330151
"[1, 0, 1, 1, 1, 1, 1, 1, 1, 1, 1, 1, 1, 1, 1]",69930,9184,60746,934,5731,0.101698606271777,0.09434366048793336
"[1, 0, 1, 0, 1, 1, 1, 0, 1, 1, 0, 1, 0, 1, 1]",251,83,168,9,13,0.10843373493975904,0.07738095238095238
"[1, 1, 0, 1, 1, 1, 1, 0, 0, 0, 1, 1, 0, 1, 1]",254,99,155,15,13,0.15151515151515152,0.08387096774193549
"[0, 1, 0, 0, 1, 0, 1, 1, 1, 1, 1, 0, 1, 1, 1]",267,98,169,15,21,0.15306122448979592,0.1242603550295858
"[0, 0, 0, 1, 0, 1, 0, 0, 0, 1, 1, 1, 0, 1, 0]",141,92,49,10,2,0.10869565217391304,0.04081632653061224
"[0, 0, 1, 0, 1, 0, 1, 1, 0, 1, 0, 0, 0, 1, 1]",133,73,60,8,4,0.1095890410958904,0.06666666666666667
"[1, 0, 0, 0, 0, 1, 0, 1, 0, 1, 1, 0, 1, 0, 0]",140,76,64,10,6,0.13157894736842105,0.09375
"[1, 1, 0, 0, 0, 0, 1, 1, 1, 1, 1, 0, 1, 0, 0]",231,88,143,6,15,0.06818181818181818,0.1048951048951049
"[0, 0, 1, 1, 0, 0, 0, 0, 1, 1, 1, 1, 1, 0, 1]",403,172,231,14,21,0.08139534883720931,0.09090909090909091
"[1, 1, 1, 1, 1, 0, 0, 0, 1, 0, 0, 1, 1, 0, 0]",188,94,94,12,11,0.1276595744680851,0.11702127659574468
"[0, 0, 0, 1, 1, 1, 1, 1, 0, 0, 0, 1, 0, 0, 1]",177,106,71,10,10,0.09433962264150944,0.14084507042253522
"[1, 0, 0, 0, 1, 0, 0, 0, 0, 0, 1, 1, 1, 1, 1]",262,130,132,11,15,0.08461538461538462,0.11363636363636363
"[0, 0, 0, 1, 1, 1, 0, 0, 0, 0, 0, 0, 0, 0, 1]",969,685,284,68,24,0.09927007299270073,0.08450704225352113
"[1, 1, 1, 1, 0, 1, 1, 0, 1, 0, 0, 0, 1, 1, 1]",334,108,226,14,17,0.12962962962962962,0.0752212389380531
"[1, 1, 1, 1, 1, 1, 0, 1, 1, 0, 1, 0, 0, 0, 1]",262,96,166,9,11,0.09375,0.06626506024096386
"[0, 1, 1, 0, 0, 0, 0, 0, 1, 1, 1, 1, 1, 1, 1]",528,257,271,26,35,0.10116731517509728,0.12915129151291513
"[0, 0, 0, 0, 0, 0, 0, 0, 1, 0, 0, 1, 1, 1, 0]",724,515,209,48,15,0.09320388349514563,0.07177033492822966
"[1, 1, 0, 0, 0, 0, 0, 0, 0, 0, 0, 0, 0, 1, 0]",2735,2064,671,176,68,0.08527131782945736,0.10134128166915052
"[1, 0, 1, 1, 0, 0, 0, 0, 0, 0, 0, 0, 0, 0, 0]",3138,2291,847,194,82,0.08467917939764295,0.09681227863046045
"[0, 0, 1, 0, 1, 1, 1, 1, 1, 1, 0, 1, 0, 0, 0]",135,65,70,3,8,0.046153846153846156,0.11428571428571428
"[1, 0, 0, 0, 1, 0, 1, 1, 1, 1, 1, 1, 0, 1, 0]",141,51,90,5,7,0.09803921568627451,0.07777777777777778
"[1, 0, 1, 1, 0, 0, 1, 1, 1, 1, 0, 0, 1, 1, 1]",834,311,523,40,47,0.12861736334405144,0.08986615678776291
"[1, 0, 0, 0, 0, 0, 0, 0, 0, 1, 0, 1, 1, 0, 0]",670,415,255,45,30,0.10843373493975904,0.11764705882352941
"[0, 1, 0, 0, 0, 0, 0, 0, 0, 0, 1, 0, 1, 1, 0]",560,381,179,33,19,0.08661417322834646,0.10614525139664804
"[1, 0, 1, 0, 0, 0, 0, 0, 0, 0, 0, 1, 0, 1, 1]",306,208,98,25,10,0.1201923076923077,0.10204081632653061
"[0, 0, 0, 1, 1, 1, 1, 1, 1, 0, 0, 1, 0, 0, 0]",259,185,74,25,6,0.13513513513513514,0.08108108108108109
"[0, 0, 1, 1, 1, 1, 0, 0, 0, 0, 1, 1, 0, 0, 0]",1970,1215,755,105,72,0.08641975308641975,0.09536423841059603
"[0, 1, 1, 0, 0, 1, 1, 0, 0, 1, 1, 1, 1, 0, 0]",1521,1197,324,129,23,0.10776942355889724,0.07098765432098765
"[1, 1, 1, 0, 1, 1, 0, 1, 1, 1, 1, 1, 1, 1, 1]",8852,1613,7239,186,697,0.1153130812151271,0.09628401712943777
"[1, 1, 0, 1, 1, 1, 1, 0, 1, 1, 0, 1, 1, 1, 1]",1739,415,1324,53,127,0.12771084337349398,0.09592145015105741
"[1, 0, 0, 1, 1, 1, 1, 1, 1, 1, 0, 1, 1, 1, 1]",2795,469,2326,63,199,0.13432835820895522,0.08555460017196904
"[1, 0, 1, 1, 1, 1, 0, 0, 1, 1, 1, 1, 0, 1, 1]",643,189,454,16,48,0.08465608465608465,0.10572687224669604
"[1, 1, 0, 1, 1, 1, 1, 0, 0, 1, 1, 1, 1, 0, 1]",631,190,441,23,49,0.12105263157894737,0.1111111111111111
"[1, 1, 1, 0, 1, 1, 1, 1, 1, 0, 1, 1, 0, 1, 1]",1577,357,1220,36,113,0.10084033613445378,0.09262295081967213
"[0, 1, 1, 1, 1, 1, 1, 1, 1, 0, 1, 0, 1, 1, 1]",2035,724,1311,67,134,0.0925414364640884,0.10221205186880244
"[0, 1, 0, 1, 0, 1, 0, 0, 1, 1, 1, 0, 0, 0, 0]",188,111,77,13,16,0.11711711711711711,0.2077922077922078
"[0, 0, 0, 1, 0, 0, 1, 0, 0, 0, 0, 0, 0, 1, 0]",1556,1201,355,105,45,0.08742714404662781,0.1267605633802817
"[1, 1, 1, 1, 1, 0, 1, 0, 1, 1, 0, 0, 0, 0, 0]",227,91,136,8,17,0.08791208791208792,0.125
"[0, 0, 0, 1, 1, 1, 1, 1, 1, 1, 0, 1, 0, 1, 1]",382,200,182,18,18,0.09,0.0989010989010989
"[0, 0, 0, 0, 0, 1, 0, 0, 0, 0, 1, 1, 1, 0, 1]",242,159,83,15,10,0.09433962264150944,0.12048192771084337
"[0, 1, 1, 0, 0, 0, 0, 0, 1, 0, 0, 0, 0, 1, 1]",489,361,128,34,18,0.09418282548476455,0.140625
"[0, 0, 1, 1, 0, 0, 0, 0, 0, 1, 0, 0, 0, 0, 1]",759,538,221,43,20,0.07992565055762081,0.09049773755656108
"[0, 0, 1, 0, 0, 0, 0, 1, 1, 0, 0, 1, 0, 0, 1]",264,165,99,14,10,0.08484848484848485,0.10101010101010101
"[0, 0, 1, 0, 1, 0, 1, 0, 0, 0, 0, 1, 0, 0, 0]",525,373,152,50,14,0.13404825737265416,0.09210526315789473
"[1, 1, 1, 0, 0, 0, 0, 0, 0, 0, 0, 0, 0, 0, 0]",7090,2929,4161,279,401,0.09525435302150904,0.09637106464792117
"[0, 1, 0, 0, 0, 0, 0, 0, 0, 0, 0, 0, 0, 1, 0]",7166,5872,1294,576,118,0.09809264305177112,0.09119010819165378
"[0, 1, 1, 1, 0, 0, 0, 0, 0, 0, 1, 0, 0, 0, 0]",617,426,191,42,14,0.09859154929577464,0.07329842931937172
"[0, 1, 0, 0, 0, 0, 0, 0, 0, 1, 1, 1, 0, 0, 0]",710,484,226,41,21,0.08471074380165289,0.09292035398230089
"[1, 0, 1, 0, 0, 0, 0, 0, 0, 0, 1, 1, 1, 0, 0]",323,204,119,19,9,0.09313725490196079,0.07563025210084033
"[0, 0, 0, 1, 0, 0, 0, 1, 0, 0, 0, 1, 1, 0, 0]",689,492,197,33,23,0.06707317073170732,0.116751269035533
"[1, 0, 0, 1, 0, 0, 0, 0, 1, 0, 0, 0, 1, 0, 0]",517,359,158,22,15,0.06128133704735376,0.0949367088607595
"[0, 1, 1, 0, 0, 1, 1, 1, 1, 1, 1, 1, 1, 0, 0]",2022,1440,582,130,51,0.09027777777777778,0.08762886597938144
"[1, 1, 1, 1, 1, 1, 1, 1, 1, 1, 0, 1, 1, 0, 0]",2617,623,1994,51,195,0.08186195826645265,0.09779338014042126
"[1, 0, 1, 1, 1, 1, 1, 1, 1, 0, 1, 1, 1, 1, 1]",7636,1368,6268,133,617,0.09722222222222222,0.09843650287172942
"[1, 1, 1, 1, 1, 0, 1, 1, 0, 0, 1, 0, 1, 1, 1]",586,155,431,14,48,0.09032258064516129,0.11136890951276102
"[1, 0, 1, 0, 1, 0, 0, 0, 0, 0, 0, 0, 0, 0, 0]",2333,1714,619,181,58,0.10560093348891482,0.09369951534733441
"[0, 0, 1, 1, 0, 0, 0, 0, 1, 1, 1, 1, 0, 1, 0]",335,172,163,13,8,0.0755813953488372,0.049079754601226995
"[1, 0, 0, 0, 1, 1, 0, 1, 0, 1, 1, 0, 0, 0, 0]",179,99,80,10,7,0.10101010101010101,0.0875
"[0, 1, 0, 0, 0, 1, 1, 0, 1, 0, 1, 1, 0, 0, 0]",164,96,68,12,9,0.125,0.1323529411764706
"[1, 1, 0, 0, 1, 1, 1, 1, 1, 0, 1, 1, 1, 1, 1]",2700,661,2039,64,200,0.09682299546142209,0.0980872976949485
"[1, 1, 1, 0, 0, 1, 1, 1, 1, 1, 0, 1, 1, 1, 1]",2686,459,2227,48,201,0.10457516339869281,0.09025594970812753
"[1, 1, 1, 1, 1, 1, 0, 0, 1, 1, 1, 1, 1, 0, 1]",2758,636,2122,48,222,0.07547169811320754,0.10461828463713478
"[1, 1, 0, 1, 1, 1, 1, 1, 1, 0, 1, 1, 1, 1, 1]",7613,1347,6266,136,552,0.10096510764662213,0.08809447813597192
"[1, 1, 1, 1, 1, 1, 0, 1, 1, 1, 1, 1, 1, 0, 1]",6855,1190,5665,125,545,0.10504201680672269,0.09620476610767872
"[1, 0, 1, 1, 1, 0, 1, 1, 1, 1, 1, 1, 1, 1, 0]",1852,481,1371,46,122,0.09563409563409564,0.08898614150255288
"[0, 0, 0, 1, 0, 1, 0, 0, 0, 0, 0, 1, 0, 0, 1]",535,375,160,29,21,0.07733333333333334,0.13125
"[0, 0, 0, 0, 1, 0, 1, 1, 0, 0, 1, 0, 0, 0, 0]",603,420,183,34,14,0.08095238095238096,0.07650273224043716
"[1, 0, 0, 0, 0, 1, 0, 1, 1, 0, 0, 1, 0, 0, 0]",274,167,107,15,7,0.08982035928143713,0.06542056074766354
"[0, 0, 1, 1, 0, 1, 0, 1, 1, 0, 0, 0, 1, 1, 1]",150,74,76,11,10,0.14864864864864866,0.13157894736842105
"[1, 1, 0, 0, 1, 1, 0, 1, 0, 1, 1, 0, 0, 0, 1]",126,55,71,7,8,0.12727272727272726,0.11267605633802817
"[0, 1, 0, 0, 1, 0, 0, 1, 1, 1, 0, 0, 1, 1, 0]",167,94,73,5,9,0.05319148936170213,0.1232876712328767
"[1, 1, 1, 1, 1, 1, 0, 0, 0, 0, 1, 0, 0, 1, 0]",213,87,126,6,9,0.06896551724137931,0.07142857142857142
"[1, 0, 0, 1, 1, 0, 1, 1, 1, 0, 1, 1, 0, 1, 0]",122,50,72,5,7,0.1,0.09722222222222222
"[1, 0, 0, 0, 0, 0, 0, 0, 0, 0, 0, 1, 0, 0, 0]",7818,5833,1985,554,202,0.09497685582033259,0.1017632241813602
"[0, 0, 1, 1, 0, 1, 1, 1, 1, 1, 1, 1, 1, 1, 0]",715,254,461,25,32,0.0984251968503937,0.06941431670281996
"[1, 0, 0, 0, 0, 0, 0, 0, 0, 1, 0, 0, 0, 1, 1]",975,536,439,55,52,0.10261194029850747,0.11845102505694761
"[0, 1, 1, 0, 0, 0, 0, 1, 0, 0, 0, 0, 0, 0, 0]",2301,1838,463,163,50,0.08868335146898804,0.1079913606911447
"[1, 0, 1, 0, 1, 0, 1, 1, 1, 0, 0, 0, 1, 1, 0]",114,56,58,6,6,0.10714285714285714,0.10344827586206896
"[1, 0, 1, 1, 0, 1, 0, 1, 0, 1, 1, 1, 0, 0, 0]",128,61,67,7,6,0.11475409836065574,0.08955223880597014
"[1, 1, 0, 1, 1, 1, 1, 1, 1, 1, 0, 0, 1, 1, 0]",926,290,636,26,50,0.0896551724137931,0.07861635220125786
"[1, 1, 0, 0, 0, 0, 0, 0, 0, 0, 0, 0, 1, 0, 1]",1123,760,363,83,38,0.10921052631578948,0.1046831955922865
"[0, 1, 1, 0, 0, 0, 0, 0, 0, 0, 0, 0, 0, 1, 0]",2729,2300,429,219,41,0.09521739130434782,0.09557109557109557
"[0, 1, 0, 0, 1, 0, 0, 0, 0, 1, 1, 0, 0, 1, 1]",333,192,141,21,15,0.109375,0.10638297872340426
"[0, 1, 1, 1, 1, 1, 0, 1, 1, 1, 1, 1, 0, 0, 0]",353,131,222,10,28,0.07633587786259542,0.12612612612612611
"[1, 0, 1, 1, 1, 1, 1, 0, 1, 1, 1, 1, 1, 0, 0]",729,223,506,17,44,0.07623318385650224,0.08695652173913043
"[1, 0, 0, 1, 0, 0, 1, 1, 0, 1, 1, 1, 1, 1, 0]",157,71,86,6,8,0.08450704225352113,0.09302325581395349
"[0, 0, 0, 1, 1, 1, 0, 1, 1, 1, 0, 1, 1, 1, 1]",334,149,185,14,15,0.09395973154362416,0.08108108108108109
"[1, 1, 1, 0, 1, 1, 1, 0, 0, 0, 1, 1, 1, 1, 1]",791,210,581,25,47,0.11904761904761904,0.08089500860585198
"[1, 0, 0, 0, 0, 1, 1, 0, 1, 1, 1, 1, 1, 0, 0]",175,64,111,10,14,0.15625,0.12612612612612611
"[1, 1, 1, 1, 1, 0, 0, 0, 0, 1, 1, 0, 1, 1, 1]",774,172,602,22,71,0.12790697674418605,0.11794019933554817
"[1, 0, 0, 1, 0, 0, 0, 0, 0, 1, 1, 0, 0, 1, 1]",339,198,141,21,18,0.10606060606060606,0.1276595744680851
"[1, 0, 0, 0, 0, 1, 1, 0, 0, 0, 0, 1, 1, 0, 0]",2171,623,1548,56,148,0.0898876404494382,0.09560723514211886
"[0, 0, 1, 0, 0, 0, 0, 0, 1, 1, 0, 0, 0, 0, 0]",2962,2278,684,215,72,0.09438103599648814,0.10526315789473684
"[0, 1, 0, 0, 1, 0, 0, 1, 0, 0, 0, 0, 0, 1, 1]",347,236,111,19,11,0.08050847457627118,0.0990990990990991
"[0, 1, 0, 1, 0, 0, 1, 0, 0, 1, 0, 0, 0, 0, 0]",558,399,159,36,21,0.09022556390977443,0.1320754716981132
"[0, 1, 1, 0, 1, 0, 1, 0, 1, 0, 0, 0, 0, 0, 0]",296,207,89,14,3,0.06763285024154589,0.033707865168539325
"[1, 0, 1, 1, 0, 1, 0, 1, 0, 1, 0, 0, 0, 0, 0]",146,84,62,6,3,0.07142857142857142,0.04838709677419355
"[0, 0, 1, 1, 1, 0, 0, 0, 0, 1, 0, 0, 1, 1, 1]",199,123,76,11,6,0.08943089430894309,0.07894736842105263
"[0, 0, 1, 1, 1, 1, 0, 0, 1, 1, 1, 1, 0, 0, 1]",1945,850,1095,84,97,0.0988235294117647,0.08858447488584476
"[1, 0, 0, 1, 1, 1, 1, 0, 0, 1, 1, 1, 1, 0, 0]",1856,296,1560,29,146,0.09797297297297297,0.09358974358974359
"[1, 0, 1, 1, 1, 1, 1, 1, 1, 1, 1, 0, 0, 1, 1]",3520,842,2678,96,244,0.11401425178147269,0.09111277072442121
"[0, 1, 0, 1, 0, 1, 1, 1, 0, 1, 1, 0, 1, 1, 1]",246,96,150,10,11,0.10416666666666667,0.07333333333333333
"[1, 1, 1, 1, 0, 1, 0, 1, 1, 0, 1, 1, 1, 1, 1]",1879,471,1408,46,137,0.09766454352441614,0.09730113636363637
"[0, 0, 1, 1, 1, 0, 0, 1, 0, 1, 1, 1, 1, 1, 1]",344,125,219,15,23,0.12,0.1050228310502283
"[1, 1, 1, 1, 1, 0, 0, 1, 1, 0, 1, 1, 1, 0, 0]",368,103,265,8,22,0.07766990291262135,0.0830188679245283
"[0, 0, 1, 1, 1, 1, 1, 0, 0, 1, 1, 0, 1, 1, 1]",382,143,239,10,18,0.06993006993006994,0.07531380753138076
"[1, 0, 0, 1, 1, 1, 1, 1, 0, 0, 1, 1, 0, 1, 1]",322,92,230,6,19,0.06521739130434782,0.08260869565217391
"[1, 0, 1, 1, 0, 0, 1, 1, 1, 1, 1, 0, 0, 1, 1]",425,155,270,13,18,0.08387096774193549,0.06666666666666667
"[0, 1, 0, 1, 1, 1, 0, 1, 1, 0, 0, 1, 1, 1, 1]",336,128,208,11,17,0.0859375,0.08173076923076923
"[1, 1, 1, 1, 0, 0, 1, 1, 0, 1, 0, 1, 1, 1, 0]",300,97,203,7,17,0.07216494845360824,0.08374384236453201
"[0, 0, 1, 0, 0, 0, 0, 0, 0, 0, 1, 0, 0, 0, 0]",7060,5760,1300,558,127,0.096875,0.09769230769230769
"[0, 0, 0, 1, 0, 0, 0, 0, 0, 0, 0, 1, 0, 0, 0]",6801,5605,1196,549,124,0.09794826048171276,0.10367892976588629
"[0, 0, 1, 0, 1, 0, 0, 0, 0, 0, 0, 0, 1, 0, 0]",1626,1202,424,124,37,0.10316139767054909,0.08726415094339622
"[1, 1, 0, 1, 0, 0, 0, 0, 0, 0, 0, 1, 0, 0, 0]",541,365,176,44,17,0.12054794520547946,0.09659090909090909
"[0, 1, 0, 0, 1, 0, 1, 1, 0, 1, 0, 0, 0, 0, 0]",280,166,114,15,10,0.09036144578313253,0.08771929824561403
"[1, 1, 1, 1, 0, 0, 0, 0, 1, 1, 1, 1, 1, 1, 1]",5973,1710,4263,133,403,0.07777777777777778,0.09453436547032606
"[0, 1, 0, 1, 1, 1, 1, 1, 0, 0, 0, 1, 1, 1, 1]",364,147,217,15,21,0.10204081632653061,0.0967741935483871
"[0, 0, 1, 0, 1, 1, 1, 1, 1, 0, 0, 0, 1, 1, 1]",236,100,136,5,14,0.05,0.10294117647058823
"[0, 0, 1, 1, 0, 0, 1, 1, 0, 0, 0, 0, 1, 1, 0]",1877,1143,734,99,62,0.08661417322834646,0.08446866485013624
"[0, 0, 0, 0, 0, 0, 1, 1, 1, 0, 0, 0, 1, 0, 0]",688,468,220,39,16,0.08333333333333333,0.07272727272727272
"[0, 0, 0, 0, 0, 0, 0, 0, 1, 1, 1, 0, 0, 0, 1]",987,747,240,67,17,0.08969210174029452,0.07083333333333333
"[0, 0, 0, 1, 1, 1, 1, 1, 1, 1, 0, 1, 1, 1, 1]",1028,489,539,41,60,0.08384458077709611,0.11131725417439703
"[1, 1, 1, 1, 1, 1, 0, 0, 0, 0, 0, 0, 1, 1, 1]",2749,1082,1667,104,164,0.09611829944547134,0.09838032393521295
"[1, 0, 1, 0, 1, 1, 1, 1, 0, 1, 0, 1, 1, 1, 1]",594,175,419,18,40,0.10285714285714286,0.0954653937947494
"[1, 0, 0, 1, 1, 1, 1, 1, 1, 0, 1, 1, 1, 1, 1]",2780,481,2299,43,249,0.0893970893970894,0.10830795998260113
"[0, 1, 0, 1, 1, 1, 1, 1, 1, 1, 1, 1, 1, 0, 1]",1746,455,1291,39,117,0.08571428571428572,0.0906274206041828
"[1, 1, 1, 0, 1, 0, 1, 1, 1, 1, 1, 1, 1, 1, 1]",9683,1746,7937,168,744,0.09621993127147767,0.0937381882323296
"[0, 0, 1, 0, 0, 1, 0, 0, 0, 0, 0, 0, 0, 0, 1]",1942,1453,489,150,43,0.10323468685478321,0.08793456032719836
"[1, 1, 0, 0, 0, 0, 0, 1, 0, 0, 1, 0, 0, 0, 0]",613,417,196,39,16,0.09352517985611511,0.08163265306122448
"[0, 0, 0, 0, 1, 1, 0, 0, 0, 1, 1, 0, 1, 0, 0]",321,221,100,32,7,0.14479638009049775,0.07
"[1, 0, 0, 0, 0, 1, 1, 0, 0, 0, 1, 1, 0, 1, 0]",167,90,77,7,3,0.07777777777777778,0.03896103896103896
"[0, 1, 0, 0, 0, 0, 1, 1, 0, 0, 0, 1, 1, 0, 1]",165,100,65,12,4,0.12,0.06153846153846154
"[0, 0, 0, 1, 0, 0, 1, 0, 0, 1, 0, 0, 0, 0, 0]",1727,1334,393,133,38,0.09970014992503748,0.09669211195928754
"[1, 0, 0, 0, 1, 0, 0, 0, 0, 0, 1, 0, 0, 1, 0]",501,351,150,41,11,0.1168091168091168,0.07333333333333333
"[0, 1, 0, 0, 0, 1, 0, 0, 0, 0, 0, 1, 0, 0, 1]",528,390,138,35,16,0.08974358974358974,0.11594202898550725
"[0, 0, 1, 0, 0, 0, 1, 0, 0, 0, 0, 0, 1, 0, 0]",1532,1164,368,110,33,0.09450171821305842,0.08967391304347826
"[0, 1, 1, 1, 0, 0, 1, 1, 1, 1, 1, 1, 1, 1, 1]",3618,1046,2572,96,241,0.09177820267686425,0.093701399688958
"[1, 0, 0, 0, 0, 0, 0, 1, 1, 1, 1, 1, 1, 0, 0]",1681,366,1315,39,124,0.10655737704918032,0.09429657794676806
"[1, 0, 1, 1, 0, 1, 1, 0, 0, 0, 0, 0, 0, 1, 1]",284,143,141,11,11,0.07692307692307693,0.07801418439716312
"[0, 0, 0, 0, 1, 1, 1, 0, 1, 1, 1, 1, 1, 1, 1]",542,198,344,23,28,0.11616161616161616,0.08139534883720931
"[0, 0, 0, 0, 0, 1, 1, 1, 0, 1, 1, 1, 1, 1, 1]",339,190,149,26,12,0.1368421052631579,0.08053691275167785
"[0, 0, 1, 0, 0, 1, 1, 1, 1, 1, 0, 1, 1, 0, 1]",141,63,78,3,12,0.047619047619047616,0.15384615384615385
"[0, 1, 1, 0, 1, 1, 1, 0, 1, 1, 0, 0, 1, 0, 0]",108,54,54,2,3,0.037037037037037035,0.05555555555555555
"[0, 1, 0, 1, 0, 0, 1, 0, 0, 0, 0, 0, 0, 0, 1]",566,384,182,37,13,0.09635416666666667,0.07142857142857142
"[1, 0, 1, 0, 0, 0, 0, 0, 0, 0, 1, 0, 1, 0, 0]",526,362,164,34,19,0.09392265193370165,0.11585365853658537
"[0, 1, 1, 0, 1, 0, 1, 1, 0, 1, 0, 0, 0, 0, 0]",164,102,62,7,5,0.06862745098039216,0.08064516129032258
"[1, 1, 0, 0, 0, 0, 0, 1, 0, 1, 1, 0, 0, 0, 0]",370,236,134,12,15,0.05084745762711865,0.11194029850746269
"[1, 1, 1, 0, 0, 0, 0, 0, 1, 0, 1, 1, 0, 0, 0]",197,92,105,8,6,0.08695652173913043,0.05714285714285714
"[0, 1, 0, 0, 0, 1, 0, 0, 1, 0, 0, 0, 0, 1, 0]",473,359,114,36,17,0.10027855153203342,0.14912280701754385
"[0, 0, 0, 1, 1, 1, 0, 0, 1, 0, 0, 0, 0, 0, 0]",744,531,213,67,19,0.12617702448210924,0.0892018779342723
"[0, 1, 0, 1, 0, 0, 0, 1, 0, 0, 0, 0, 1, 1, 1]",277,183,94,24,15,0.13114754098360656,0.1595744680851064
"[0, 1, 0, 1, 0, 0, 0, 1, 0, 0, 0, 0, 0, 0, 1]",580,398,182,29,17,0.0728643216080402,0.09340659340659341
"[1, 0, 1, 1, 0, 0, 1, 0, 1, 0, 0, 0, 1, 0, 0]",136,79,57,7,9,0.08860759493670886,0.15789473684210525
"[1, 1, 0, 1, 1, 1, 1, 1, 1, 1, 0, 0, 1, 1, 1]",3159,725,2434,71,209,0.09793103448275862,0.08586688578471652
"[0, 1, 0, 0, 1, 0, 1, 0, 0, 0, 0, 0, 0, 0, 0]",2006,1513,493,153,47,0.10112359550561797,0.09533468559837728
"[1, 1, 0, 1, 0, 0, 1, 1, 1, 0, 0, 1, 0, 0, 1]",97,38,59,0,8,0.0,0.13559322033898305
"[0, 1, 1, 1, 0, 1, 0, 0, 1, 1, 1, 0, 0, 1, 0]",112,56,56,7,4,0.125,0.07142857142857142
"[1, 0, 1, 1, 0, 0, 0, 0, 1, 0, 0, 0, 1, 0, 0]",228,142,86,17,8,0.11971830985915492,0.09302325581395349
"[0, 0, 0, 0, 1, 1, 0, 0, 1, 1, 0, 0, 0, 0, 0]",4870,3529,1341,327,118,0.09266081042788325,0.08799403430275914
"[0, 0, 0, 0, 0, 0, 1, 0, 0, 0, 0, 0, 0, 1, 0]",6788,5505,1283,540,134,0.09809264305177112,0.1044427123928293
"[0, 0, 0, 0, 1, 0, 0, 0, 1, 1, 0, 0, 0, 0, 0]",2573,1968,605,196,59,0.09959349593495935,0.09752066115702479
"[0, 0, 0, 0, 0, 0, 0, 0, 0, 0, 1, 0, 1, 1, 0]",2224,1724,500,158,43,0.09164733178654293,0.086
"[1, 1, 0, 0, 1, 0, 0, 0, 0, 0, 0, 0, 0, 0, 0]",2686,1959,727,163,65,0.08320571720265442,0.08940852819807428
"[0, 0, 0, 0, 0, 0, 0, 1, 0, 1, 0, 0, 1, 1, 0]",686,482,204,49,16,0.1016597510373444,0.0784313725490196
"[0, 0, 1, 1, 0, 1, 1, 1, 0, 0, 1, 1, 1, 1, 0]",262,106,156,14,18,0.1320754716981132,0.11538461538461539
"[0, 1, 0, 0, 0, 0, 1, 1, 0, 1, 1, 1, 0, 0, 1]",140,67,73,6,5,0.08955223880597014,0.0684931506849315
"[1, 0, 0, 0, 1, 0, 0, 0, 0, 1, 1, 0, 1, 1, 1]",161,93,68,9,5,0.0967741935483871,0.07352941176470588
"[1, 0, 1, 1, 0, 0, 1, 0, 0, 1, 0, 1, 1, 1, 1]",178,67,111,11,10,0.16417910447761194,0.09009009009009009
"[1, 1, 1, 0, 1, 0, 0, 0, 1, 1, 1, 1, 0, 1, 1]",257,84,173,6,12,0.07142857142857142,0.06936416184971098
"[0, 1, 1, 1, 0, 1, 0, 0, 0, 1, 1, 1, 1, 0, 1]",145,62,83,6,10,0.0967741935483871,0.12048192771084337
"[1, 1, 1, 1, 0, 1, 0, 1, 0, 0, 1, 0, 0, 1, 1]",167,64,103,8,7,0.125,0.06796116504854369
"[0, 0, 1, 1, 1, 1, 1, 0, 1, 0, 1, 0, 0, 1, 0]",104,58,46,14,5,0.2413793103448276,0.10869565217391304
"[1, 1, 1, 1, 1, 0, 1, 1, 0, 0, 0, 0, 0, 1, 1]",256,90,166,7,17,0.07777777777777778,0.10240963855421686
"[0, 0, 1, 1, 1, 1, 1, 0, 1, 1, 0, 0, 0, 0, 0]",197,116,81,17,4,0.14655172413793102,0.04938271604938271
"[0, 1, 0, 1, 0, 0, 0, 0, 1, 1, 1, 1, 1, 0, 1]",127,57,70,2,7,0.03508771929824561,0.1
"[1, 0, 0, 1, 0, 1, 0, 1, 1, 1, 0, 0, 0, 0, 1]",144,76,68,10,11,0.13157894736842105,0.16176470588235295
"[0, 1, 1, 1, 0, 1, 1, 0, 1, 0, 1, 0, 0, 0, 1]",117,60,57,4,7,0.06666666666666667,0.12280701754385964
"[1, 0, 0, 1, 1, 1, 0, 1, 1, 0, 1, 0, 1, 0, 0]",130,67,63,10,5,0.14925373134328357,0.07936507936507936
"[0, 1, 0, 0, 0, 1, 1, 1, 1, 1, 0, 1, 1, 1, 1]",271,105,166,14,16,0.13333333333333333,0.0963855421686747
"[1, 1, 0, 1, 0, 1, 0, 0, 0, 1, 0, 0, 1, 0, 0]",136,75,61,7,12,0.09333333333333334,0.19672131147540983
"[0, 0, 0, 1, 0, 0, 0, 0, 1, 0, 0, 0, 0, 0, 0]",7861,6414,1447,607,141,0.09463673214842531,0.09744298548721493
"[0, 0, 1, 1, 0, 1, 0, 0, 0, 0, 0, 0, 0, 0, 1]",715,495,220,47,20,0.09494949494949495,0.09090909090909091
"[1, 1, 0, 0, 0, 0, 1, 1, 0, 0, 0, 0, 0, 1, 1]",749,454,295,44,28,0.09691629955947137,0.09491525423728814
"[1, 1, 1, 1, 0, 1, 1, 1, 0, 0, 0, 1, 0, 0, 1]",170,74,96,10,13,0.13513513513513514,0.13541666666666666
"[1, 1, 1, 1, 1, 1, 1, 1, 0, 0, 1, 0, 1, 1, 1]",2620,597,2023,51,180,0.08542713567839195,0.08897676717745921
"[1, 1, 1, 1, 0, 1, 1, 1, 0, 0, 0, 1, 0, 0, 0]",134,67,67,8,6,0.11940298507462686,0.08955223880597014
"[0, 1, 1, 1, 1, 0, 1, 1, 1, 1, 0, 0, 1, 1, 1]",916,304,612,25,68,0.08223684210526316,0.1111111111111111
"[0, 1, 1, 1, 1, 1, 1, 0, 1, 1, 1, 0, 1, 1, 1]",1790,546,1244,57,119,0.1043956043956044,0.09565916398713827
"[0, 1, 1, 1, 1, 1, 1, 1, 1, 1, 1, 0, 1, 0, 1]",1917,675,1242,55,125,0.08148148148148149,0.10064412238325282
"[1, 1, 1, 0, 1, 0, 1, 1, 1, 1, 1, 1, 1, 1, 0]",1860,436,1424,38,141,0.0871559633027523,0.09901685393258428
"[1, 1, 1, 1, 1, 0, 1, 1, 0, 1, 1, 1, 1, 1, 1]",8405,1455,6950,146,648,0.10034364261168385,0.09323741007194244
"[0, 1, 1, 0, 0, 1, 1, 0, 0, 0, 0, 1, 1, 1, 1]",1824,1447,377,136,43,0.09398756046993781,0.11405835543766578
"[0, 1, 1, 0, 0, 0, 0, 0, 1, 1, 1, 0, 0, 1, 1]",186,111,75,6,8,0.05405405405405406,0.10666666666666667
"[0, 0, 0, 0, 0, 1, 0, 0, 0, 1, 1, 0, 0, 1, 1]",579,388,191,37,15,0.09536082474226804,0.07853403141361257
"[1, 0, 1, 0, 0, 0, 0, 0, 1, 0, 0, 0, 1, 1, 0]",287,175,112,11,12,0.06285714285714286,0.10714285714285714
"[1, 1, 0, 1, 0, 1, 0, 1, 1, 1, 0, 0, 1, 0, 1]",150,64,86,8,5,0.125,0.05813953488372093
"[0, 1, 0, 0, 1, 0, 1, 0, 0, 0, 0, 1, 1, 0, 0]",360,228,132,25,14,0.10964912280701754,0.10606060606060606
"[0, 1, 1, 0, 0, 1, 1, 1, 1, 0, 0, 0, 0, 0, 1]",468,362,106,36,11,0.09944751381215469,0.10377358490566038
"[0, 1, 0, 1, 0, 1, 0, 0, 1, 1, 1, 0, 0, 0, 1]",100,60,40,4,5,0.06666666666666667,0.125
"[0, 1, 0, 0, 1, 0, 1, 0, 1, 0, 0, 1, 1, 1, 0]",97,50,47,6,5,0.12,0.10638297872340426
"[1, 0, 0, 0, 0, 0, 0, 1, 1, 1, 1, 0, 0, 0, 0]",2401,692,1709,56,146,0.08092485549132948,0.08543007606787595
"[1, 1, 0, 0, 1, 0, 0, 0, 0, 1, 0, 0, 0, 0, 1]",299,204,95,19,20,0.09313725490196079,0.21052631578947367
"[0, 0, 0, 1, 0, 0, 1, 1, 1, 1, 0, 0, 0, 1, 1]",171,102,69,10,7,0.09803921568627451,0.10144927536231885
"[0, 1, 1, 0, 0, 0, 1, 0, 0, 1, 1, 1, 1, 0, 0]",201,102,99,7,10,0.06862745098039216,0.10101010101010101
"[0, 0, 1, 1, 0, 1, 1, 1, 1, 1, 0, 0, 1, 1, 0]",221,94,127,4,12,0.0425531914893617,0.09448818897637795
"[1, 1, 1, 0, 0, 0, 1, 1, 0, 1, 1, 1, 1, 1, 0]",271,87,184,7,14,0.08045977011494253,0.07608695652173914
"[0, 0, 1, 1, 0, 0, 0, 0, 0, 0, 0, 1, 1, 1, 0]",424,274,150,22,20,0.08029197080291971,0.13333333333333333
"[1, 1, 0, 0, 1, 1, 0, 0, 0, 1, 0, 0, 0, 0, 1]",245,153,92,13,7,0.08496732026143791,0.07608695652173914
"[0, 1, 1, 1, 0, 1, 1, 0, 1, 0, 0, 0, 1, 1, 1]",185,78,107,7,14,0.08974358974358974,0.1308411214953271
"[0, 1, 1, 1, 0, 1, 0, 1, 0, 0, 0, 1, 0, 1, 1]",118,55,63,6,6,0.10909090909090909,0.09523809523809523
"[1, 1, 1, 0, 0, 0, 1, 0, 0, 0, 1, 1, 1, 1, 1]",250,89,161,10,22,0.11235955056179775,0.13664596273291926
"[1, 1, 0, 0, 0, 1, 1, 1, 1, 0, 0, 0, 0, 0, 0]",570,318,252,30,22,0.09433962264150944,0.0873015873015873
"[0, 1, 1, 1, 0, 0, 0, 1, 1, 1, 1, 0, 0, 0, 0]",286,157,129,19,12,0.12101910828025478,0.09302325581395349
"[1, 1, 0, 1, 1, 0, 1, 1, 1, 0, 0, 0, 1, 1, 1]",319,97,222,9,23,0.09278350515463918,0.1036036036036036
"[1, 0, 1, 1, 1, 0, 0, 1, 1, 0, 1, 1, 1, 1, 1]",672,199,473,22,50,0.11055276381909548,0.10570824524312897
"[1, 0, 1, 0, 0, 1, 0, 0, 1, 1, 1, 0, 1, 1, 1]",159,69,90,10,11,0.14492753623188406,0.12222222222222222
"[0, 0, 1, 1, 1, 1, 0, 0, 1, 1, 0, 0, 0, 0, 0]",2030,1212,818,103,68,0.08498349834983498,0.08312958435207823
"[0, 1, 0, 0, 1, 0, 0, 0, 0, 0, 1, 0, 1, 1, 1]",210,132,78,11,5,0.08333333333333333,0.0641025641025641
"[0, 0, 0, 0, 0, 0, 0, 0, 0, 1, 1, 0, 0, 0, 1]",3565,2953,612,296,59,0.10023704707077548,0.09640522875816994
"[1, 0, 0, 0, 1, 0, 1, 1, 0, 0, 0, 0, 0, 1, 0]",230,150,80,19,11,0.12666666666666668,0.1375
"[0, 0, 0, 0, 1, 1, 1, 1, 1, 1, 0, 0, 0, 1, 0]",371,216,155,23,12,0.10648148148148148,0.07741935483870968
"[0, 0, 0, 0, 0, 1, 1, 1, 1, 1, 1, 0, 0, 0, 1]",554,419,135,48,16,0.11455847255369929,0.11851851851851852
"[0, 1, 1, 1, 1, 0, 0, 0, 0, 0, 0, 1, 0, 0, 0]",533,417,116,38,11,0.09112709832134293,0.09482758620689655
"[0, 1, 1, 0, 0, 0, 1, 0, 0, 1, 0, 0, 0, 0, 0]",652,455,197,46,17,0.1010989010989011,0.08629441624365482
"[1, 0, 1, 1, 1, 1, 1, 1, 0, 0, 0, 0, 0, 0, 1]",475,203,272,12,23,0.059113300492610835,0.08455882352941177
"[0, 0, 1, 0, 1, 0, 1, 0, 1, 1, 0, 1, 1, 1, 0]",101,47,54,5,4,0.10638297872340426,0.07407407407407407
"[0, 1, 0, 0, 1, 0, 1, 0, 1, 0, 1, 1, 0, 1, 1]",117,66,51,4,3,0.06060606060606061,0.058823529411764705
"[0, 1, 0, 0, 0, 1, 0, 0, 1, 0, 1, 0, 1, 0, 1]",137,88,49,11,2,0.125,0.04081632653061224
"[0, 1, 0, 0, 1, 1, 1, 1, 1, 0, 1, 0, 0, 0, 1]",127,65,62,7,8,0.1076923076923077,0.12903225806451613
"[0, 0, 1, 0, 0, 0, 1, 0, 0, 1, 1, 0, 0, 0, 0]",815,580,235,57,33,0.09827586206896552,0.14042553191489363
"[0, 0, 0, 1, 1, 0, 1, 1, 1, 0, 0, 0, 0, 1, 1]",212,121,91,9,10,0.0743801652892562,0.10989010989010989
"[0, 1, 0, 0, 0, 1, 1, 0, 1, 1, 1, 0, 0, 0, 0]",179,96,83,6,7,0.0625,0.08433734939759036
"[0, 1, 0, 1, 1, 0, 1, 1, 0, 1, 0, 1, 0, 0, 0]",99,47,52,3,2,0.06382978723404255,0.038461538461538464
"[1, 0, 1, 0, 0, 1, 0, 0, 1, 1, 1, 0, 1, 0, 1]",79,41,38,3,4,0.07317073170731707,0.10526315789473684
"[0, 0, 1, 0, 1, 0, 0, 0, 0, 0, 1, 0, 1, 0, 0]",507,340,167,35,14,0.10294117647058823,0.08383233532934131
"[0, 1, 1, 0, 0, 1, 1, 0, 0, 0, 0, 0, 0, 1, 1]",2203,1852,351,163,24,0.08801295896328294,0.06837606837606838
"[0, 0, 1, 1, 0, 0, 0, 0, 0, 0, 0, 1, 0, 1, 1]",629,431,198,41,20,0.0951276102088167,0.10101010101010101
"[1, 0, 1, 0, 0, 1, 1, 0, 0, 0, 0, 0, 0, 0, 1]",366,232,134,17,10,0.07327586206896551,0.07462686567164178
"[1, 1, 1, 0, 1, 1, 0, 0, 0, 0, 0, 1, 0, 1, 0]",102,46,56,5,4,0.10869565217391304,0.07142857142857142
"[0, 0, 1, 1, 1, 0, 1, 0, 0, 1, 1, 1, 1, 1, 1]",473,188,285,22,25,0.11702127659574468,0.08771929824561403
"[0, 0, 0, 0, 1, 1, 0, 0, 0, 1, 1, 1, 1, 0, 0]",371,220,151,17,18,0.07727272727272727,0.11920529801324503
"[0, 1, 0, 0, 1, 0, 0, 1, 0, 0, 1, 1, 0, 0, 1]",168,100,68,15,7,0.15,0.10294117647058823
"[1, 1, 1, 1, 0, 1, 0, 0, 1, 0, 0, 1, 0, 0, 1]",116,55,61,5,8,0.09090909090909091,0.13114754098360656
"[0, 0, 1, 1, 1, 1, 0, 0, 1, 1, 1, 0, 0, 1, 1]",428,191,237,17,18,0.08900523560209424,0.0759493670886076
"[0, 1, 0, 0, 1, 0, 1, 1, 1, 0, 0, 1, 0, 1, 0]",116,66,50,4,4,0.06060606060606061,0.08
"[0, 0, 1, 0, 0, 1, 0, 1, 1, 1, 0, 0, 1, 0, 1]",104,62,42,6,4,0.0967741935483871,0.09523809523809523
"[0, 0, 0, 1, 0, 0, 1, 0, 1, 1, 1, 0, 0, 1, 0]",150,103,47,16,4,0.1553398058252427,0.0851063829787234
"[0, 0, 1, 0, 0, 0, 0, 0, 1, 1, 0, 0, 1, 0, 0]",568,422,146,38,6,0.09004739336492891,0.0410958904109589
"[1, 0, 0, 1, 0, 0, 1, 0, 0, 0, 1, 0, 1, 1, 0]",140,80,60,9,3,0.1125,0.05
"[1, 1, 1, 0, 0, 1, 0, 1, 0, 0, 0, 0, 0, 0, 0]",427,239,188,19,13,0.0794979079497908,0.06914893617021277
"[1, 0, 0, 1, 1, 1, 0, 0, 0, 0, 0, 0, 0, 0, 0]",1180,729,451,78,41,0.10699588477366255,0.09090909090909091
"[0, 0, 0, 0, 0, 1, 1, 1, 1, 0, 0, 0, 0, 1, 1]",2386,2001,385,186,43,0.09295352323838081,0.11168831168831168
"[0, 1, 1, 0, 0, 1, 0, 1, 0, 1, 0, 1, 1, 0, 1]",104,57,47,6,5,0.10526315789473684,0.10638297872340426
"[1, 0, 0, 0, 0, 0, 0, 0, 1, 0, 1, 1, 0, 0, 1]",280,170,110,17,13,0.1,0.11818181818181818
"[0, 0, 0, 0, 0, 0, 0, 1, 0, 1, 1, 1, 0, 0, 0]",780,573,207,56,23,0.09773123909249563,0.1111111111111111
"[1, 0, 1, 0, 0, 0, 1, 0, 1, 0, 1, 1, 0, 1, 1]",122,64,58,7,4,0.109375,0.06896551724137931
"[1, 0, 1, 0, 1, 0, 0, 0, 0, 1, 0, 1, 0, 0, 0]",252,157,95,14,7,0.08917197452229299,0.07368421052631578
"[0, 0, 1, 0, 1, 1, 0, 0, 0, 1, 0, 1, 0, 1, 0]",110,69,41,7,4,0.10144927536231885,0.0975609756097561
"[0, 0, 1, 0, 1, 0, 0, 1, 1, 0, 0, 0, 1, 1, 0]",188,115,73,13,5,0.11304347826086956,0.0684931506849315
"[0, 0, 1, 0, 1, 0, 0, 0, 1, 0, 1, 0, 0, 1, 1]",151,89,62,13,2,0.14606741573033707,0.03225806451612903
"[1, 0, 0, 1, 0, 0, 0, 1, 0, 0, 0, 0, 0, 1, 0]",514,383,131,37,13,0.09660574412532637,0.09923664122137404
"[0, 1, 1, 1, 0, 0, 1, 0, 0, 0, 1, 0, 0, 0, 0]",255,153,102,16,16,0.10457516339869281,0.1568627450980392
"[1, 1, 1, 0, 0, 1, 1, 1, 1, 1, 0, 0, 1, 1, 1]",1309,276,1033,24,95,0.08695652173913043,0.09196515004840271
"[1, 0, 1, 1, 1, 0, 0, 1, 1, 1, 1, 1, 0, 0, 1]",323,120,203,13,17,0.10833333333333334,0.08374384236453201
"[0, 1, 0, 1, 1, 1, 0, 0, 1, 1, 1, 1, 1, 0, 0]",193,82,111,8,17,0.0975609756097561,0.15315315315315314
"[0, 1, 0, 0, 0, 0, 1, 1, 1, 1, 0, 1, 0, 1, 1]",123,54,69,4,8,0.07407407407407407,0.11594202898550725
"[1, 0, 1, 1, 1, 1, 0, 0, 0, 1, 0, 1, 1, 0, 0]",104,47,57,5,10,0.10638297872340426,0.17543859649122806
"[0, 1, 1, 0, 0, 1, 0, 1, 1, 1, 0, 1, 0, 1, 1]",167,82,85,3,4,0.036585365853658534,0.047058823529411764
"[1, 0, 1, 1, 0, 1, 0, 1, 1, 0, 0, 1, 0, 1, 1]",144,64,80,6,10,0.09375,0.125
"[0, 0, 1, 1, 1, 0, 1, 0, 1, 0, 1, 1, 0, 1, 0]",93,46,47,6,5,0.13043478260869565,0.10638297872340426
"[0, 0, 1, 1, 0, 0, 0, 1, 1, 1, 0, 1, 0, 1, 0]",107,56,51,2,6,0.03571428571428571,0.11764705882352941
"[1, 1, 1, 1, 0, 0, 1, 1, 0, 0, 0, 1, 1, 1, 0]",249,111,138,8,19,0.07207207207207207,0.13768115942028986
"[1, 1, 1, 0, 1, 1, 1, 0, 1, 1, 0, 1, 1, 0, 1]",486,135,351,9,24,0.06666666666666667,0.06837606837606838
"[1, 0, 1, 0, 0, 1, 1, 0, 0, 0, 1, 0, 0, 0, 0]",279,166,113,11,10,0.06626506024096386,0.08849557522123894
"[0, 1, 0, 0, 0, 0, 0, 1, 0, 0, 0, 0, 1, 0, 1]",510,338,172,37,17,0.10946745562130178,0.09883720930232558
"[1, 0, 0, 0, 1, 0, 0, 0, 1, 0, 0, 0, 0, 0, 1]",542,377,165,42,18,0.11140583554376658,0.10909090909090909
"[1, 0, 0, 0, 0, 1, 0, 1, 1, 0, 0, 0, 0, 0, 0]",808,536,272,54,25,0.10074626865671642,0.09191176470588236
"[0, 0, 0, 0, 1, 0, 1, 0, 1, 0, 1, 0, 1, 1, 0]",175,103,72,6,10,0.05825242718446602,0.1388888888888889
"[0, 0, 1, 1, 1, 0, 0, 0, 1, 0, 0, 0, 0, 1, 0]",238,158,80,10,9,0.06329113924050633,0.1125
"[0, 0, 0, 0, 0, 1, 1, 0, 1, 0, 0, 0, 0, 0, 1]",693,510,183,53,21,0.10392156862745099,0.11475409836065574
"[1, 1, 1, 1, 1, 1, 1, 0, 1, 1, 0, 0, 0, 0, 1]",484,133,351,11,33,0.08270676691729323,0.09401709401709402
"[0, 0, 1, 1, 1, 1, 1, 1, 1, 0, 1, 1, 0, 0, 0]",221,88,133,4,17,0.045454545454545456,0.12781954887218044
"[0, 1, 1, 0, 1, 1, 0, 1, 1, 0, 1, 1, 1, 0, 0]",179,87,92,9,2,0.10344827586206896,0.021739130434782608
"[1, 0, 0, 1, 1, 0, 1, 1, 0, 1, 1, 0, 1, 1, 1]",294,88,206,9,21,0.10227272727272728,0.10194174757281553
"[0, 0, 1, 0, 1, 1, 0, 0, 1, 1, 0, 1, 1, 0, 1]",114,60,54,7,4,0.11666666666666667,0.07407407407407407
"[1, 0, 0, 0, 0, 0, 0, 0, 1, 1, 0, 0, 1, 1, 0]",863,536,327,47,31,0.08768656716417911,0.09480122324159021
"[1, 0, 0, 0, 0, 1, 1, 0, 0, 1, 1, 0, 0, 0, 0]",2172,609,1563,68,145,0.1116584564860427,0.0927703134996801
"[1, 0, 0, 0, 0, 0, 1, 1, 1, 0, 0, 0, 0, 0, 0]",785,502,283,57,27,0.11354581673306773,0.09540636042402827
"[1, 1, 0, 0, 1, 0, 1, 1, 1, 1, 1, 1, 0, 1, 0]",257,79,178,3,16,0.0379746835443038,0.0898876404494382
"[1, 1, 1, 0, 0, 1, 1, 1, 1, 0, 0, 0, 0, 1, 1]",2152,372,1780,36,179,0.0967741935483871,0.10056179775280899
"[0, 0, 1, 1, 0, 0, 1, 0, 0, 0, 0, 0, 0, 1, 0]",603,413,190,28,18,0.06779661016949153,0.09473684210526316
"[1, 0, 0, 1, 1, 1, 1, 1, 0, 0, 1, 1, 0, 0, 1]",383,129,254,9,26,0.06976744186046512,0.10236220472440945
"[1, 0, 1, 1, 1, 1, 1, 1, 0, 1, 1, 1, 1, 0, 1]",1545,396,1149,34,122,0.08585858585858586,0.1061792863359443
"[1, 1, 1, 1, 1, 0, 1, 1, 1, 1, 1, 0, 0, 1, 1]",2783,638,2145,64,205,0.10031347962382445,0.09557109557109557
"[1, 1, 1, 1, 1, 1, 1, 1, 0, 0, 1, 0, 1, 0, 1]",756,217,539,11,51,0.05069124423963134,0.09461966604823747
"[0, 1, 0, 1, 1, 0, 1, 1, 1, 1, 1, 1, 1, 1, 1]",2261,597,1664,49,158,0.08207705192629816,0.09495192307692307
"[0, 1, 1, 1, 0, 1, 0, 1, 1, 0, 1, 1, 1, 1, 1]",632,211,421,15,34,0.07109004739336493,0.08076009501187649
"[1, 1, 1, 1, 1, 0, 1, 1, 1, 0, 0, 0, 0, 0, 1]",233,92,141,12,12,0.13043478260869565,0.0851063829787234
"[1, 0, 1, 0, 0, 0, 1, 0, 0, 0, 0, 0, 1, 1, 0]",303,188,115,19,6,0.10106382978723404,0.05217391304347826
"[0, 0, 1, 1, 1, 1, 0, 1, 0, 0, 1, 0, 1, 0, 0]",92,52,40,6,5,0.11538461538461539,0.125
"[1, 0, 1, 1, 1, 0, 1, 0, 1, 1, 1, 1, 0, 1, 0]",230,92,138,13,19,0.14130434782608695,0.13768115942028986
"[1, 1, 0, 1, 1, 1, 1, 1, 1, 1, 0, 1, 0, 1, 1]",1578,369,1209,30,110,0.08130081300813008,0.09098428453267163
"[1, 0, 1, 1, 0, 1, 1, 1, 1, 1, 1, 1, 0, 1, 0]",504,128,376,9,31,0.0703125,0.08244680851063829
"[1, 1, 1, 1, 0, 1, 1, 1, 1, 1, 0, 0, 0, 0, 0]",348,130,218,13,30,0.1,0.13761467889908258
"[0, 1, 1, 0, 1, 1, 1, 0, 1, 1, 1, 1, 0, 0, 1]",354,140,214,14,16,0.1,0.07476635514018691
"[1, 0, 0, 1, 1, 1, 1, 1, 1, 0, 1, 1, 0, 1, 1]",776,170,606,16,66,0.09411764705882353,0.10891089108910891
"[0, 0, 1, 1, 1, 0, 0, 0, 0, 0, 0, 1, 1, 0, 0]",743,447,296,37,29,0.08277404921700224,0.09797297297297297
"[1, 1, 1, 0, 0, 0, 0, 1, 1, 0, 0, 1, 1, 0, 0]",1531,343,1188,40,103,0.11661807580174927,0.0867003367003367
"[0, 1, 0, 0, 0, 1, 0, 0, 1, 0, 0, 1, 0, 0, 0]",495,337,158,24,22,0.0712166172106825,0.13924050632911392
"[0, 1, 1, 0, 0, 0, 1, 0, 1, 0, 1, 0, 1, 1, 0]",117,71,46,7,5,0.09859154929577464,0.10869565217391304
"[0, 0, 0, 1, 1, 0, 0, 1, 0, 0, 1, 1, 0, 1, 0]",148,91,57,5,4,0.054945054945054944,0.07017543859649122
"[1, 0, 0, 0, 1, 0, 0, 0, 0, 0, 0, 0, 0, 1, 1]",1166,788,378,83,29,0.10532994923857868,0.07671957671957672
"[1, 1, 0, 0, 0, 0, 1, 1, 0, 0, 0, 1, 0, 0, 0]",432,279,153,29,14,0.1039426523297491,0.0915032679738562
"[1, 0, 1, 0, 1, 0, 0, 0, 1, 1, 0, 0, 0, 0, 1]",245,153,92,5,10,0.032679738562091505,0.10869565217391304
"[0, 0, 0, 1, 1, 0, 0, 1, 1, 1, 0, 1, 1, 0, 1]",170,107,63,8,9,0.07476635514018691,0.14285714285714285
"[1, 0, 0, 1, 1, 1, 1, 0, 0, 1, 1, 1, 0, 1, 1]",541,110,431,7,44,0.06363636363636363,0.10208816705336426
"[1, 1, 0, 0, 1, 1, 1, 1, 0, 0, 1, 1, 1, 0, 1]",618,228,390,29,37,0.12719298245614036,0.09487179487179487
"[1, 0, 1, 0, 1, 0, 1, 0, 0, 0, 0, 1, 1, 0, 0]",222,128,94,8,8,0.0625,0.0851063829787234
"[0, 1, 1, 1, 0, 0, 1, 0, 1, 0, 1, 0, 1, 0, 0]",114,54,60,1,5,0.018518518518518517,0.08333333333333333
"[1, 0, 0, 1, 1, 1, 0, 0, 1, 0, 1, 0, 1, 0, 1]",113,42,71,6,7,0.14285714285714285,0.09859154929577464
"[0, 0, 1, 1, 1, 0, 1, 1, 1, 0, 1, 1, 1, 0, 1]",254,92,162,5,14,0.05434782608695652,0.08641975308641975
"[0, 1, 1, 0, 0, 1, 1, 1, 0, 1, 0, 0, 1, 0, 0]",134,83,51,8,5,0.0963855421686747,0.09803921568627451
"[1, 0, 1, 0, 1, 0, 0, 0, 0, 1, 1, 1, 1, 1, 1]",359,142,217,10,21,0.07042253521126761,0.0967741935483871
"[1, 1, 1, 1, 1, 0, 0, 1, 0, 1, 0, 1, 0, 0, 0]",140,54,86,5,12,0.09259259259259259,0.13953488372093023
"[0, 0, 0, 0, 0, 0, 1, 0, 1, 0, 0, 0, 0, 1, 0]",1549,1194,355,121,32,0.10134003350083752,0.09014084507042254
"[0, 1, 1, 0, 0, 0, 0, 0, 0, 1, 0, 1, 0, 0, 0]",706,558,148,60,11,0.10752688172043011,0.07432432432432433
"[1, 1, 0, 0, 0, 0, 1, 1, 0, 0, 1, 1, 1, 1, 0]",1509,746,763,54,66,0.07238605898123325,0.08650065530799476
"[1, 0, 0, 1, 0, 1, 1, 1, 0, 0, 1, 1, 0, 0, 0]",200,106,94,12,5,0.11320754716981132,0.05319148936170213
"[0, 1, 0, 1, 0, 1, 1, 0, 1, 0, 1, 1, 1, 1, 0]",171,75,96,5,5,0.06666666666666667,0.052083333333333336
"[0, 0, 1, 1, 0, 0, 0, 1, 1, 1, 1, 1, 1, 0, 0]",318,171,147,17,19,0.09941520467836257,0.1292517006802721
"[1, 1, 1, 1, 0, 1, 0, 0, 1, 1, 1, 1, 1, 0, 1]",578,157,421,10,43,0.06369426751592357,0.1021377672209026
"[0, 0, 1, 1, 1, 0, 1, 1, 1, 1, 0, 1, 0, 0, 1]",137,54,83,10,5,0.18518518518518517,0.060240963855421686
"[0, 1, 0, 1, 0, 0, 0, 0, 0, 0, 1, 1, 0, 0, 1]",463,296,167,24,20,0.08108108108108109,0.11976047904191617
"[1, 0, 1, 0, 0, 0, 0, 1, 1, 1, 0, 1, 0, 1, 0]",99,48,51,4,4,0.08333333333333333,0.0784313725490196
"[0, 1, 0, 1, 0, 0, 0, 0, 1, 1, 1, 0, 1, 0, 1]",111,48,63,3,8,0.0625,0.12698412698412698
"[0, 0, 0, 1, 0, 0, 0, 1, 1, 1, 1, 0, 1, 0, 0]",169,100,69,13,11,0.13,0.15942028985507245
"[1, 0, 0, 0, 1, 0, 0, 0, 1, 1, 1, 1, 0, 1, 0]",114,52,62,3,6,0.057692307692307696,0.0967741935483871
"[0, 1, 0, 0, 0, 0, 1, 1, 0, 1, 0, 0, 0, 1, 0]",232,156,76,16,5,0.10256410256410256,0.06578947368421052
"[0, 0, 1, 0, 1, 0, 1, 0, 1, 1, 0, 1, 0, 0, 0]",128,74,54,5,2,0.06756756756756757,0.037037037037037035
"[1, 0, 0, 0, 1, 1, 0, 0, 0, 0, 0, 0, 1, 0, 0]",641,423,218,35,13,0.08274231678486997,0.05963302752293578
"[0, 0, 0, 0, 0, 1, 1, 0, 0, 0, 1, 1, 0, 0, 1]",460,339,121,30,12,0.08849557522123894,0.09917355371900827
"[0, 0, 1, 1, 1, 1, 1, 1, 1, 1, 1, 0, 1, 1, 1]",2965,751,2214,67,213,0.08921438082556592,0.09620596205962059
"[0, 0, 1, 0, 1, 0, 1, 0, 1, 0, 0, 1, 1, 1, 1]",171,84,87,6,9,0.07142857142857142,0.10344827586206896
"[1, 1, 1, 1, 1, 1, 1, 1, 0, 1, 0, 0, 1, 0, 1]",598,183,415,16,38,0.08743169398907104,0.09156626506024096
"[1, 0, 1, 0, 1, 0, 1, 0, 0, 1, 1, 1, 0, 0, 1]",117,50,67,7,5,0.14,0.07462686567164178
"[1, 1, 0, 0, 1, 1, 0, 1, 0, 1, 0, 1, 0, 0, 1]",132,66,66,5,4,0.07575757575757576,0.06060606060606061
"[0, 1, 0, 1, 1, 1, 0, 0, 1, 1, 1, 0, 0, 1, 1]",191,85,106,10,14,0.11764705882352941,0.1320754716981132
"[1, 1, 0, 1, 1, 0, 0, 0, 0, 0, 0, 0, 1, 1, 1]",286,149,137,14,15,0.09395973154362416,0.10948905109489052
"[0, 1, 0, 1, 0, 0, 0, 0, 0, 0, 0, 0, 1, 0, 0]",1657,1229,428,118,42,0.09601301871440195,0.09813084112149532
"[0, 1, 1, 0, 0, 1, 1, 1, 0, 1, 1, 1, 1, 1, 1]",839,372,467,25,38,0.06720430107526881,0.08137044967880086
"[0, 0, 1, 1, 1, 1, 0, 1, 0, 0, 1, 0, 0, 0, 1]",135,67,68,8,4,0.11940298507462686,0.058823529411764705
"[1, 1, 1, 0, 1, 1, 1, 1, 0, 0, 1, 1, 1, 0, 0]",309,104,205,9,29,0.08653846153846154,0.14146341463414633
"[1, 1, 1, 0, 1, 0, 0, 1, 0, 0, 1, 1, 0, 0, 0]",156,71,85,4,10,0.056338028169014086,0.11764705882352941
"[1, 1, 0, 0, 0, 0, 0, 1, 0, 0, 0, 1, 1, 1, 1]",269,155,114,15,20,0.0967741935483871,0.17543859649122806
"[0, 0, 0, 1, 0, 0, 0, 1, 0, 1, 0, 1, 0, 0, 0]",569,397,172,45,21,0.11335012594458438,0.12209302325581395
"[0, 1, 1, 0, 0, 0, 1, 0, 0, 0, 1, 0, 1, 0, 1]",151,95,56,10,5,0.10526315789473684,0.08928571428571429
"[0, 1, 1, 1, 1, 1, 1, 1, 0, 1, 1, 1, 1, 0, 1]",1570,454,1116,41,87,0.09030837004405286,0.07795698924731183
"[1, 1, 0, 0, 0, 1, 0, 0, 0, 0, 0, 1, 1, 1, 1]",282,151,131,19,13,0.12582781456953643,0.09923664122137404
"[1, 0, 1, 0, 1, 1, 1, 1, 1, 0, 0, 0, 1, 0, 0]",129,63,66,6,6,0.09523809523809523,0.09090909090909091
"[1, 1, 1, 1, 0, 1, 0, 1, 1, 1, 1, 1, 0, 0, 0]",356,129,227,10,17,0.07751937984496124,0.07488986784140969
"[1, 1, 1, 0, 0, 1, 1, 1, 1, 1, 1, 1, 0, 0, 1]",1289,263,1026,24,99,0.09125475285171103,0.09649122807017543
"[0, 0, 1, 1, 0, 0, 1, 1, 0, 0, 1, 0, 0, 0, 0]",486,305,181,27,13,0.08852459016393442,0.0718232044198895
"[1, 0, 1, 1, 1, 0, 1, 0, 1, 0, 0, 1, 0, 0, 1]",114,57,57,7,4,0.12280701754385964,0.07017543859649122
"[0, 1, 1, 0, 0, 1, 1, 0, 1, 1, 1, 0, 0, 0, 1]",139,69,70,3,3,0.043478260869565216,0.04285714285714286
"[1, 0, 0, 0, 1, 0, 0, 1, 1, 0, 0, 1, 1, 0, 1]",130,83,47,9,3,0.10843373493975904,0.06382978723404255
"[0, 0, 0, 1, 0, 1, 1, 1, 0, 1, 0, 1, 0, 1, 0]",95,53,42,6,4,0.11320754716981132,0.09523809523809523
"[0, 0, 1, 1, 0, 1, 1, 1, 0, 1, 0, 0, 0, 1, 0]",95,41,54,6,1,0.14634146341463414,0.018518518518518517
"[0, 0, 0, 1, 0, 0, 1, 1, 0, 0, 0, 0, 1, 0, 0]",609,435,174,40,22,0.09195402298850575,0.12643678160919541
"[1, 0, 0, 0, 0, 0, 1, 0, 1, 0, 0, 0, 1, 0, 0]",494,347,147,34,15,0.09798270893371758,0.10204081632653061
"[1, 0, 0, 0, 0, 0, 1, 0, 0, 0, 0, 0, 1, 0, 0]",1535,1163,372,114,35,0.09802235597592433,0.09408602150537634
"[1, 0, 1, 0, 1, 1, 0, 1, 0, 1, 1, 0, 0, 1, 1]",189,74,115,3,10,0.04054054054054054,0.08695652173913043
"[0, 1, 1, 1, 1, 0, 0, 0, 0, 1, 0, 1, 1, 1, 1]",354,224,130,23,17,0.10267857142857142,0.13076923076923078
"[0, 1, 1, 0, 0, 1, 1, 0, 1, 1, 1, 1, 1, 1, 0]",319,134,185,16,21,0.11940298507462686,0.11351351351351352
"[0, 1, 0, 1, 0, 1, 1, 0, 0, 1, 1, 0, 1, 1, 1]",165,81,84,14,6,0.1728395061728395,0.07142857142857142
"[1, 1, 1, 0, 1, 0, 0, 0, 0, 0, 1, 0, 1, 0, 1]",123,70,53,8,4,0.11428571428571428,0.07547169811320754
"[0, 1, 1, 1, 0, 1, 0, 1, 1, 1, 1, 0, 0, 1, 0]",143,55,88,8,9,0.14545454545454545,0.10227272727272728
"[0, 0, 0, 0, 1, 0, 1, 0, 0, 0, 0, 0, 1, 0, 0]",1587,1231,356,99,38,0.08042242079610074,0.10674157303370786
"[1, 1, 1, 0, 1, 1, 1, 0, 0, 0, 0, 0, 1, 0, 1]",133,62,71,8,6,0.12903225806451613,0.08450704225352113
"[1, 1, 0, 0, 0, 0, 1, 1, 1, 0, 1, 0, 0, 0, 0]",237,132,105,10,11,0.07575757575757576,0.10476190476190476
"[0, 0, 0, 0, 0, 1, 0, 0, 1, 0, 0, 0, 0, 1, 0]",1458,1143,315,107,19,0.09361329833770779,0.06031746031746032
"[1, 0, 1, 0, 0, 0, 0, 0, 1, 1, 0, 0, 1, 0, 0]",244,158,86,13,5,0.08227848101265822,0.05813953488372093
"[0, 0, 0, 0, 1, 0, 0, 1, 0, 1, 0, 0, 0, 0, 0]",1810,1362,448,122,36,0.08957415565345081,0.08035714285714286
"[0, 1, 1, 0, 1, 0, 0, 0, 1, 1, 1, 1, 0, 1, 1]",171,65,106,4,7,0.06153846153846154,0.0660377358490566
"[0, 0, 1, 1, 0, 1, 0, 0, 0, 1, 1, 1, 1, 0, 1]",112,53,59,4,2,0.07547169811320754,0.03389830508474576
"[1, 1, 1, 0, 1, 0, 0, 1, 0, 1, 0, 0, 1, 0, 0]",99,60,39,3,4,0.05,0.10256410256410256
"[0, 1, 1, 1, 1, 1, 1, 1, 0, 1, 0, 0, 1, 0, 1]",275,116,159,11,16,0.09482758620689655,0.10062893081761007
"[1, 0, 1, 0, 1, 0, 1, 1, 0, 0, 0, 1, 0, 1, 1]",126,68,58,4,5,0.058823529411764705,0.08620689655172414
"[0, 1, 1, 0, 1, 0, 0, 1, 0, 1, 0, 1, 0, 1, 1]",105,49,56,6,2,0.12244897959183673,0.03571428571428571
"[0, 0, 1, 1, 1, 1, 1, 1, 0, 0, 0, 0, 1, 0, 0]",363,192,171,21,12,0.109375,0.07017543859649122
"[0, 0, 0, 1, 1, 1, 1, 1, 1, 0, 1, 0, 0, 0, 0]",202,144,58,17,5,0.11805555555555555,0.08620689655172414
"[1, 0, 0, 0, 0, 0, 0, 1, 1, 1, 1, 1, 1, 0, 1]",436,93,343,12,35,0.12903225806451613,0.10204081632653061
"[1, 1, 0, 1, 1, 0, 1, 0, 0, 1, 1, 1, 1, 1, 1]",813,236,577,26,60,0.11016949152542373,0.10398613518197573
"[0, 0, 1, 1, 1, 0, 0, 1, 1, 1, 1, 0, 0, 1, 1]",523,216,307,24,29,0.1111111111111111,0.09446254071661238
"[1, 1, 0, 1, 0, 0, 0, 1, 1, 1, 0, 0, 1, 1, 1]",211,84,127,6,11,0.07142857142857142,0.08661417322834646
"[1, 0, 0, 0, 1, 1, 1, 1, 1, 1, 0, 1, 0, 0, 0]",126,44,82,4,5,0.09090909090909091,0.06097560975609756
"[0, 0, 0, 1, 0, 1, 1, 1, 1, 0, 1, 0, 1, 1, 1]",205,93,112,8,10,0.08602150537634409,0.08928571428571429
"[1, 1, 0, 1, 0, 1, 0, 1, 1, 1, 1, 0, 1, 0, 0]",127,54,73,6,17,0.1111111111111111,0.2328767123287671
"[0, 0, 1, 1, 1, 0, 0, 1, 1, 0, 0, 0, 0, 0, 0]",763,467,296,41,31,0.08779443254817987,0.10472972972972973
"[0, 0, 1, 0, 0, 0, 0, 0, 1, 1, 0, 1, 0, 1, 0]",240,161,79,14,8,0.08695652173913043,0.10126582278481013
"[1, 1, 0, 1, 1, 1, 0, 0, 1, 0, 0, 0, 0, 0, 1]",124,66,58,6,5,0.09090909090909091,0.08620689655172414
"[1, 1, 1, 1, 0, 1, 1, 1, 0, 0, 1, 0, 0, 0, 0]",169,73,96,4,9,0.0547945205479452,0.09375
"[0, 1, 0, 1, 1, 0, 1, 1, 1, 1, 0, 1, 1, 0, 1]",220,91,129,17,15,0.18681318681318682,0.11627906976744186
"[0, 1, 0, 1, 0, 1, 0, 1, 1, 0, 1, 1, 1, 1, 0]",145,66,79,6,10,0.09090909090909091,0.12658227848101267
"[1, 1, 1, 0, 1, 0, 0, 1, 1, 1, 1, 1, 1, 1, 0]",654,210,444,19,40,0.09047619047619047,0.09009009009009009
"[0, 1, 1, 1, 1, 0, 1, 1, 1, 0, 1, 1, 1, 1, 1]",1852,494,1358,52,130,0.10526315789473684,0.09572901325478646
"[0, 1, 1, 1, 0, 1, 1, 0, 1, 1, 0, 1, 1, 0, 1]",210,76,134,2,8,0.02631578947368421,0.05970149253731343
"[1, 0, 0, 1, 1, 1, 1, 0, 1, 1, 1, 1, 1, 1, 1]",2591,532,2059,45,199,0.08458646616541353,0.09664885866925692
"[0, 0, 0, 0, 1, 1, 0, 0, 0, 0, 0, 0, 1, 0, 0]",2784,2157,627,206,68,0.09550301344459898,0.10845295055821372
"[1, 0, 0, 0, 1, 0, 1, 0, 1, 1, 1, 1, 1, 1, 0]",186,70,116,6,10,0.08571428571428572,0.08620689655172414
"[1, 1, 0, 1, 1, 1, 0, 0, 1, 0, 1, 1, 1, 0, 1]",218,79,139,8,15,0.10126582278481013,0.1079136690647482
"[1, 1, 1, 0, 1, 1, 1, 0, 1, 1, 1, 0, 0, 1, 0]",208,70,138,8,9,0.11428571428571428,0.06521739130434782
"[1, 1, 0, 0, 0, 1, 1, 1, 0, 1, 0, 0, 0, 1, 0]",107,56,51,5,6,0.08928571428571429,0.11764705882352941
"[0, 0, 0, 0, 1, 1, 0, 1, 1, 0, 0, 1, 1, 0, 0]",286,173,113,17,7,0.09826589595375723,0.061946902654867256
"[1, 1, 1, 0, 0, 0, 1, 1, 0, 0, 1, 0, 0, 1, 0]",104,54,50,6,5,0.1111111111111111,0.1
"[0, 0, 0, 0, 0, 1, 1, 1, 0, 0, 1, 0, 0, 0, 1]",318,212,106,22,7,0.10377358490566038,0.0660377358490566
"[1, 0, 0, 0, 0, 0, 1, 1, 0, 1, 0, 1, 1, 1, 1]",179,76,103,10,10,0.13157894736842105,0.0970873786407767
"[0, 1, 0, 0, 0, 0, 0, 1, 1, 0, 1, 0, 1, 1, 1]",156,80,76,12,8,0.15,0.10526315789473684
"[0, 0, 1, 0, 0, 0, 0, 0, 1, 1, 0, 1, 0, 1, 1]",177,101,76,9,7,0.0891089108910891,0.09210526315789473
"[0, 0, 0, 0, 0, 1, 0, 0, 0, 0, 0, 1, 1, 0, 1]",616,444,172,35,19,0.07882882882882883,0.11046511627906977
"[1, 1, 1, 1, 0, 0, 0, 0, 0, 0, 1, 1, 1, 1, 0]",1601,742,859,79,90,0.10646900269541779,0.10477299185098952
"[1, 0, 1, 0, 1, 1, 0, 0, 0, 1, 0, 1, 0, 0, 1]",115,69,46,3,4,0.043478260869565216,0.08695652173913043
"[0, 0, 1, 0, 0, 1, 1, 1, 1, 1, 0, 0, 1, 0, 1]",122,65,57,7,4,0.1076923076923077,0.07017543859649122
"[0, 1, 1, 1, 1, 1, 0, 0, 0, 0, 1, 1, 0, 0, 0]",442,240,202,24,22,0.1,0.10891089108910891
"[1, 0, 1, 0, 1, 0, 0, 1, 1, 1, 1, 1, 0, 0, 0]",155,76,79,9,9,0.11842105263157894,0.11392405063291139
"[1, 0, 0, 1, 1, 0, 0, 1, 0, 0, 0, 0, 1, 0, 0]",262,160,102,16,13,0.1,0.12745098039215685
"[0, 0, 0, 1, 0, 0, 1, 1, 1, 0, 0, 0, 0, 0, 0]",862,629,233,54,12,0.08585055643879173,0.05150214592274678
"[0, 0, 1, 1, 1, 1, 0, 0, 1, 1, 0, 0, 1, 1, 1]",2248,938,1310,101,131,0.10767590618336886,0.1
"[0, 1, 1, 0, 0, 1, 1, 0, 0, 1, 1, 0, 0, 1, 1]",1603,1261,342,126,30,0.0999206978588422,0.08771929824561403
"[0, 0, 1, 1, 0, 0, 1, 1, 0, 0, 1, 1, 0, 0, 1]",1525,797,728,102,49,0.12797992471769135,0.0673076923076923
"[1, 1, 1, 1, 0, 0, 0, 1, 0, 0, 0, 0, 1, 0, 0]",160,91,69,9,6,0.0989010989010989,0.08695652173913043
"[1, 1, 0, 1, 1, 1, 1, 1, 0, 0, 1, 1, 1, 1, 0]",959,302,657,22,62,0.0728476821192053,0.0943683409436834
"[0, 0, 1, 0, 0, 1, 0, 0, 0, 1, 0, 0, 0, 0, 0]",1754,1336,418,125,38,0.09356287425149701,0.09090909090909091
"[1, 0, 1, 0, 1, 0, 1, 1, 1, 1, 1, 1, 0, 1, 1]",495,160,335,10,39,0.0625,0.11641791044776119
"[1, 1, 0, 1, 1, 1, 1, 1, 1, 0, 1, 0, 1, 0, 1]",532,142,390,13,37,0.09154929577464789,0.09487179487179487
"[1, 1, 1, 0, 1, 1, 1, 1, 1, 1, 0, 1, 0, 1, 0]",562,183,379,16,31,0.08743169398907104,0.08179419525065963
"[1, 1, 1, 0, 1, 1, 0, 1, 0, 1, 1, 1, 1, 1, 0]",593,180,413,21,30,0.11666666666666667,0.07263922518159806
"[1, 1, 0, 0, 0, 0, 0, 0, 0, 1, 1, 1, 1, 0, 0]",590,333,257,26,14,0.07807807807807808,0.054474708171206226
"[1, 1, 1, 0, 0, 0, 0, 0, 0, 0, 1, 1, 1, 1, 0]",346,151,195,15,17,0.09933774834437085,0.08717948717948718
"[0, 0, 0, 1, 0, 0, 0, 1, 0, 0, 0, 0, 0, 0, 0]",8064,6627,1437,621,133,0.09370755998189226,0.09255393180236604
"[1, 1, 1, 0, 1, 0, 1, 0, 0, 0, 0, 0, 1, 0, 1]",108,60,48,1,4,0.016666666666666666,0.08333333333333333
"[1, 1, 1, 1, 0, 1, 1, 1, 0, 1, 1, 1, 1, 0, 0]",707,197,510,16,45,0.08121827411167512,0.08823529411764706
"[0, 1, 1, 0, 0, 1, 1, 0, 1, 1, 0, 1, 1, 1, 1]",358,176,182,14,11,0.07954545454545454,0.06043956043956044
"[1, 0, 1, 1, 0, 0, 1, 1, 0, 1, 1, 0, 1, 1, 1]",262,106,156,8,17,0.07547169811320754,0.10897435897435898
"[1, 1, 1, 1, 0, 1, 1, 1, 1, 0, 0, 0, 1, 1, 1]",755,192,563,18,65,0.09375,0.11545293072824156
"[1, 0, 0, 1, 0, 1, 0, 1, 0, 1, 0, 0, 0, 0, 0]",278,186,92,16,6,0.08602150537634409,0.06521739130434782
"[0, 1, 1, 1, 1, 1, 0, 1, 0, 1, 0, 1, 1, 0, 1]",224,92,132,6,10,0.06521739130434782,0.07575757575757576
"[1, 1, 1, 1, 1, 1, 0, 0, 1, 1, 1, 1, 1, 0, 0]",1317,377,940,41,94,0.10875331564986737,0.1
"[1, 0, 0, 1, 1, 0, 0, 1, 0, 0, 0, 1, 1, 1, 1]",234,90,144,7,8,0.07777777777777778,0.05555555555555555
"[0, 1, 1, 0, 1, 1, 0, 1, 1, 0, 1, 0, 1, 0, 0]",97,36,61,5,6,0.1388888888888889,0.09836065573770492
"[0, 1, 0, 1, 0, 1, 0, 0, 0, 0, 0, 0, 1, 1, 0]",340,229,111,21,11,0.09170305676855896,0.0990990990990991
"[0, 0, 1, 0, 0, 0, 0, 1, 0, 0, 0, 0, 0, 0, 1]",1816,1433,383,138,31,0.09630146545708304,0.08093994778067885
"[1, 1, 0, 1, 1, 0, 1, 1, 1, 1, 1, 1, 1, 0, 1]",1539,347,1192,23,120,0.06628242074927954,0.10067114093959731
"[0, 1, 1, 1, 1, 1, 1, 1, 1, 1, 0, 0, 0, 0, 1]",1017,434,583,49,53,0.11290322580645161,0.09090909090909091
"[0, 0, 1, 0, 0, 1, 0, 0, 0, 0, 1, 1, 0, 0, 0]",810,593,217,69,28,0.1163575042158516,0.12903225806451613
"[0, 0, 0, 1, 0, 0, 0, 1, 1, 1, 0, 0, 0, 0, 1]",303,199,104,18,8,0.09045226130653267,0.07692307692307693
"[0, 0, 0, 0, 1, 0, 0, 0, 1, 1, 1, 0, 0, 0, 0]",716,509,207,59,17,0.11591355599214145,0.0821256038647343
"[1, 0, 0, 0, 1, 1, 1, 0, 0, 0, 0, 0, 0, 1, 0]",251,159,92,15,10,0.09433962264150944,0.10869565217391304
"[0, 0, 1, 0, 1, 0, 1, 1, 0, 0, 0, 1, 0, 1, 0]",139,78,61,6,8,0.07692307692307693,0.13114754098360656
"[1, 0, 1, 0, 1, 0, 1, 0, 0, 0, 1, 0, 1, 0, 1]",99,60,39,6,5,0.1,0.1282051282051282
"[1, 1, 0, 0, 1, 0, 1, 0, 0, 1, 0, 0, 1, 1, 0]",131,65,66,7,2,0.1076923076923077,0.030303030303030304
"[0, 0, 1, 1, 0, 0, 1, 0, 1, 0, 0, 1, 0, 0, 1]",166,98,68,6,2,0.061224489795918366,0.029411764705882353
"[1, 0, 1, 1, 1, 0, 0, 1, 1, 0, 0, 1, 0, 1, 0]",127,69,58,3,4,0.043478260869565216,0.06896551724137931
"[1, 1, 1, 1, 0, 1, 1, 0, 1, 1, 1, 1, 1, 0, 0]",699,201,498,21,42,0.1044776119402985,0.08433734939759036
"[0, 0, 1, 1, 1, 1, 0, 1, 1, 0, 0, 1, 1, 0, 1]",161,60,101,5,14,0.08333333333333333,0.13861386138613863
"[0, 0, 0, 0, 1, 1, 0, 0, 1, 1, 0, 1, 1, 0, 0]",306,164,142,17,12,0.10365853658536585,0.08450704225352113
"[1, 0, 1, 1, 1, 1, 0, 0, 0, 1, 0, 0, 1, 0, 1]",112,49,63,6,5,0.12244897959183673,0.07936507936507936
"[1, 1, 1, 1, 0, 0, 1, 1, 1, 0, 1, 1, 0, 1, 1]",713,221,492,21,49,0.09502262443438914,0.09959349593495935
"[1, 0, 1, 1, 1, 1, 1, 1, 0, 0, 1, 1, 1, 0, 1]",592,170,422,20,45,0.11764705882352941,0.1066350710900474
"[1, 1, 0, 1, 1, 1, 1, 1, 1, 0, 0, 1, 1, 1, 0]",600,186,414,13,41,0.06989247311827956,0.09903381642512077
"[0, 1, 1, 0, 0, 0, 1, 0, 1, 0, 0, 1, 1, 1, 0]",132,67,65,6,7,0.08955223880597014,0.1076923076923077
"[1, 0, 1, 1, 1, 1, 1, 0, 1, 0, 1, 1, 1, 0, 0]",264,102,162,12,15,0.11764705882352941,0.09259259259259259
"[1, 1, 1, 0, 1, 1, 1, 1, 1, 0, 1, 0, 1, 1, 1]",1601,350,1251,41,109,0.11714285714285715,0.08713029576338929
"[0, 0, 1, 0, 1, 0, 0, 0, 0, 1, 1, 1, 0, 0, 1]",164,99,65,8,6,0.08080808080808081,0.09230769230769231
"[1, 1, 0, 1, 1, 0, 1, 0, 1, 1, 0, 0, 1, 0, 1]",143,49,94,6,10,0.12244897959183673,0.10638297872340426
"[0, 0, 0, 1, 0, 0, 0, 0, 0, 1, 1, 1, 1, 0, 0]",694,471,223,44,19,0.09341825902335456,0.08520179372197309
"[1, 1, 0, 0, 0, 1, 1, 1, 0, 0, 1, 0, 1, 1, 1]",171,79,92,7,9,0.08860759493670886,0.09782608695652174
"[0, 0, 0, 1, 0, 1, 0, 0, 0, 0, 0, 0, 0, 1, 1]",1004,772,232,66,18,0.08549222797927461,0.07758620689655173
"[1, 0, 0, 0, 1, 0, 1, 0, 0, 0, 0, 0, 0, 0, 1]",574,371,203,35,21,0.09433962264150944,0.10344827586206896
"[1, 0, 1, 0, 0, 1, 1, 1, 0, 1, 1, 1, 0, 0, 0]",129,64,65,7,10,0.109375,0.15384615384615385
"[1, 1, 1, 0, 1, 1, 1, 1, 1, 0, 1, 1, 1, 0, 0]",660,187,473,16,38,0.0855614973262032,0.080338266384778
"[0, 1, 1, 0, 0, 1, 0, 1, 1, 1, 0, 0, 1, 0, 1]",129,68,61,8,6,0.11764705882352941,0.09836065573770492
"[0, 1, 0, 1, 0, 1, 1, 0, 0, 1, 0, 1, 1, 1, 0]",123,66,57,4,6,0.06060606060606061,0.10526315789473684
"[1, 1, 0, 0, 0, 0, 1, 1, 1, 0, 1, 1, 1, 0, 0]",186,81,105,13,7,0.16049382716049382,0.06666666666666667
"[0, 0, 0, 1, 1, 0, 0, 0, 0, 1, 1, 1, 0, 1, 1]",313,235,78,24,9,0.10212765957446808,0.11538461538461539
"[0, 0, 0, 0, 1, 1, 0, 0, 1, 1, 0, 1, 0, 1, 1]",322,183,139,20,13,0.1092896174863388,0.09352517985611511
"[0, 0, 1, 1, 0, 1, 0, 1, 1, 0, 1, 1, 1, 1, 1]",344,131,213,11,21,0.08396946564885496,0.09859154929577464
"[1, 0, 1, 0, 1, 0, 1, 0, 1, 1, 1, 1, 0, 0, 0]",149,72,77,6,6,0.08333333333333333,0.07792207792207792
"[0, 1, 1, 1, 0, 1, 0, 1, 0, 0, 0, 1, 1, 1, 1]",205,97,108,10,10,0.10309278350515463,0.09259259259259259
"[1, 1, 1, 0, 1, 0, 1, 1, 1, 0, 1, 0, 1, 0, 0]",142,54,88,5,10,0.09259259259259259,0.11363636363636363
"[1, 1, 1, 1, 0, 1, 0, 1, 1, 1, 0, 1, 0, 1, 0]",224,67,157,3,16,0.04477611940298507,0.10191082802547771
"[1, 0, 0, 0, 1, 1, 1, 1, 0, 1, 1, 0, 1, 1, 1]",318,109,209,6,21,0.05504587155963303,0.10047846889952153
"[1, 1, 1, 1, 1, 0, 0, 0, 1, 1, 1, 1, 0, 1, 1]",701,181,520,22,57,0.12154696132596685,0.10961538461538461
"[1, 1, 0, 0, 0, 1, 1, 1, 0, 1, 0, 0, 0, 1, 1]",160,70,90,4,17,0.05714285714285714,0.18888888888888888
"[1, 1, 0, 1, 0, 1, 0, 0, 1, 1, 1, 0, 0, 0, 1]",98,38,60,3,7,0.07894736842105263,0.11666666666666667
"[0, 0, 1, 1, 0, 1, 1, 0, 0, 0, 0, 0, 0, 0, 0]",1018,705,313,62,37,0.08794326241134752,0.1182108626198083
"[0, 1, 0, 0, 0, 1, 0, 1, 1, 0, 0, 0, 0, 0, 0]",722,500,222,38,22,0.076,0.0990990990990991
"[1, 1, 1, 1, 1, 0, 0, 1, 0, 0, 0, 0, 0, 1, 0]",137,58,79,3,9,0.05172413793103448,0.11392405063291139
"[0, 1, 0, 1, 0, 0, 0, 1, 1, 1, 1, 1, 0, 0, 1]",155,73,82,9,11,0.1232876712328767,0.13414634146341464
"[1, 0, 0, 1, 1, 0, 1, 1, 0, 0, 1, 1, 1, 0, 1]",160,54,106,6,8,0.1111111111111111,0.07547169811320754
"[0, 1, 1, 1, 1, 0, 0, 1, 1, 0, 1, 1, 0, 0, 1]",240,138,102,12,12,0.08695652173913043,0.11764705882352941
"[1, 0, 0, 1, 0, 1, 0, 1, 0, 0, 1, 0, 0, 0, 0]",245,159,86,9,7,0.05660377358490566,0.08139534883720931
"[0, 1, 1, 1, 1, 1, 0, 0, 0, 0, 0, 0, 1, 0, 0]",218,139,79,11,7,0.07913669064748201,0.08860759493670886
"[0, 0, 1, 1, 1, 1, 1, 0, 0, 0, 0, 0, 0, 1, 0]",220,146,74,17,10,0.11643835616438356,0.13513513513513514
"[0, 0, 0, 1, 1, 1, 1, 1, 0, 0, 0, 0, 0, 0, 1]",423,267,156,33,7,0.12359550561797752,0.04487179487179487
"[1, 1, 1, 0, 1, 0, 0, 1, 0, 1, 1, 1, 1, 1, 1]",656,210,446,13,51,0.06190476190476191,0.11434977578475336
"[1, 0, 0, 1, 1, 1, 1, 0, 0, 0, 1, 0, 0, 0, 0]",244,112,132,18,11,0.16071428571428573,0.08333333333333333
"[0, 1, 1, 0, 1, 0, 0, 1, 1, 1, 1, 0, 0, 0, 1]",148,67,81,9,6,0.13432835820895522,0.07407407407407407
"[1, 0, 0, 1, 0, 1, 0, 1, 1, 1, 1, 1, 0, 1, 0]",112,43,69,5,10,0.11627906976744186,0.14492753623188406
"[1, 1, 0, 0, 0, 1, 0, 1, 1, 0, 0, 0, 1, 0, 1]",112,57,55,8,3,0.14035087719298245,0.05454545454545454
"[1, 1, 1, 1, 1, 0, 0, 1, 1, 0, 0, 0, 1, 1, 0]",305,89,216,9,20,0.10112359550561797,0.09259259259259259
"[1, 0, 1, 1, 1, 0, 1, 1, 1, 0, 1, 1, 1, 1, 0]",538,171,367,18,36,0.10526315789473684,0.09809264305177112
"[0, 1, 1, 0, 0, 0, 1, 0, 1, 0, 1, 1, 1, 1, 1]",200,90,110,10,12,0.1111111111111111,0.10909090909090909
"[1, 1, 0, 0, 0, 1, 1, 0, 0, 0, 1, 0, 1, 0, 1]",110,52,58,10,8,0.19230769230769232,0.13793103448275862
"[0, 0, 1, 0, 1, 1, 0, 1, 0, 0, 0, 0, 1, 1, 0]",161,95,66,10,3,0.10526315789473684,0.045454545454545456
"[0, 1, 1, 1, 0, 1, 1, 1, 0, 0, 0, 1, 0, 0, 0]",122,66,56,7,4,0.10606060606060606,0.07142857142857142
"[1, 0, 0, 0, 0, 1, 1, 1, 0, 0, 0, 0, 0, 0, 1]",422,226,196,17,23,0.0752212389380531,0.11734693877551021
"[0, 1, 1, 0, 1, 1, 0, 0, 0, 0, 1, 0, 1, 1, 0]",99,45,54,5,8,0.1111111111111111,0.14814814814814814
"[0, 0, 1, 1, 0, 0, 1, 1, 0, 0, 0, 1, 1, 1, 1]",405,203,202,17,19,0.08374384236453201,0.09405940594059406
"[1, 0, 0, 1, 1, 1, 0, 1, 0, 1, 1, 1, 0, 0, 0]",118,57,61,4,6,0.07017543859649122,0.09836065573770492
"[0, 1, 0, 1, 1, 0, 0, 0, 0, 1, 0, 0, 0, 0, 0]",647,456,191,46,19,0.10087719298245613,0.09947643979057591
"[0, 0, 1, 1, 0, 0, 0, 0, 1, 0, 1, 1, 0, 0, 0]",349,227,122,23,12,0.1013215859030837,0.09836065573770492
"[0, 1, 1, 0, 1, 1, 0, 1, 0, 0, 0, 0, 1, 0, 1]",119,62,57,3,3,0.04838709677419355,0.05263157894736842
"[1, 0, 0, 1, 0, 0, 1, 1, 1, 1, 1, 1, 1, 1, 0]",425,167,258,18,20,0.10778443113772455,0.07751937984496124
"[0, 1, 0, 1, 0, 1, 1, 0, 1, 1, 1, 1, 0, 0, 1]",193,87,106,9,12,0.10344827586206896,0.11320754716981132
"[0, 0, 0, 1, 0, 0, 1, 0, 1, 0, 1, 1, 0, 1, 1]",100,56,44,6,7,0.10714285714285714,0.1590909090909091
"[0, 1, 0, 0, 0, 1, 0, 0, 1, 0, 1, 0, 1, 1, 0]",146,80,66,13,10,0.1625,0.15151515151515152
"[1, 1, 1, 1, 0, 1, 0, 0, 1, 0, 0, 1, 1, 0, 1]",175,85,90,8,11,0.09411764705882353,0.12222222222222222
"[1, 0, 0, 1, 1, 1, 1, 1, 1, 0, 1, 0, 0, 1, 0]",159,55,104,8,6,0.14545454545454545,0.057692307692307696
"[1, 1, 0, 1, 0, 1, 1, 0, 1, 1, 0, 0, 1, 1, 1]",341,136,205,10,13,0.07352941176470588,0.06341463414634146
"[0, 1, 0, 1, 1, 1, 1, 1, 1, 0, 1, 0, 1, 1, 0]",237,91,146,9,18,0.0989010989010989,0.1232876712328767
"[1, 1, 0, 0, 0, 0, 0, 0, 0, 1, 1, 0, 0, 0, 1]",417,285,132,31,15,0.10877192982456141,0.11363636363636363
"[0, 1, 0, 1, 0, 0, 1, 0, 1, 0, 0, 0, 1, 0, 0]",227,148,79,14,8,0.0945945945945946,0.10126582278481013
"[1, 1, 1, 1, 1, 0, 1, 0, 1, 0, 0, 1, 0, 1, 0]",147,59,88,4,7,0.06779661016949153,0.07954545454545454
"[1, 1, 0, 1, 1, 1, 1, 1, 1, 1, 0, 1, 1, 0, 0]",654,204,450,19,41,0.09313725490196079,0.09111111111111111
"[1, 1, 1, 1, 0, 1, 1, 0, 0, 0, 1, 1, 0, 0, 1]",215,82,133,6,13,0.07317073170731707,0.09774436090225563
"[0, 0, 0, 0, 1, 1, 1, 1, 1, 1, 1, 0, 0, 1, 1]",588,261,327,31,29,0.11877394636015326,0.08868501529051988
"[1, 1, 1, 0, 1, 1, 0, 1, 0, 1, 0, 0, 0, 0, 1]",127,64,63,6,6,0.09375,0.09523809523809523
"[0, 1, 0, 1, 1, 0, 0, 1, 0, 1, 1, 0, 1, 1, 1]",165,59,106,10,11,0.1694915254237288,0.10377358490566038
"[1, 1, 1, 1, 0, 0, 1, 0, 1, 1, 0, 0, 1, 0, 1]",168,60,108,7,16,0.11666666666666667,0.14814814814814814
"[1, 1, 0, 1, 1, 0, 1, 1, 1, 1, 1, 0, 0, 1, 0]",259,93,166,11,9,0.11827956989247312,0.05421686746987952
"[1, 0, 0, 0, 1, 1, 1, 1, 1, 1, 0, 1, 1, 1, 0]",253,84,169,9,15,0.10714285714285714,0.08875739644970414
"[0, 0, 1, 1, 1, 0, 0, 0, 1, 0, 0, 0, 0, 0, 1]",301,181,120,20,11,0.11049723756906077,0.09166666666666666
"[1, 1, 0, 0, 1, 1, 1, 0, 0, 0, 1, 0, 0, 0, 0]",217,129,88,10,13,0.07751937984496124,0.14772727272727273
"[0, 1, 1, 1, 0, 0, 1, 1, 1, 0, 0, 0, 1, 0, 0]",114,76,38,5,6,0.06578947368421052,0.15789473684210525
"[1, 1, 1, 0, 1, 1, 1, 1, 1, 1, 0, 1, 0, 0, 0]",237,67,170,3,22,0.04477611940298507,0.12941176470588237
"[0, 1, 1, 0, 0, 1, 1, 0, 0, 1, 0, 0, 1, 0, 0]",201,136,65,13,8,0.09558823529411764,0.12307692307692308
"[0, 1, 1, 1, 0, 0, 1, 1, 0, 0, 0, 1, 0, 0, 1]",121,66,55,5,6,0.07575757575757576,0.10909090909090909
"[1, 1, 0, 0, 1, 0, 1, 0, 0, 0, 1, 0, 1, 0, 1]",109,48,61,6,11,0.125,0.18032786885245902
"[0, 1, 0, 1, 0, 0, 0, 1, 1, 1, 0, 1, 1, 0, 1]",113,48,65,3,7,0.0625,0.1076923076923077
"[0, 1, 0, 1, 0, 0, 1, 1, 1, 1, 1, 1, 1, 1, 0]",411,154,257,15,26,0.09740259740259741,0.10116731517509728
"[0, 0, 0, 1, 1, 1, 1, 0, 0, 0, 0, 1, 0, 1, 0]",286,214,72,15,8,0.07009345794392523,0.1111111111111111
"[0, 0, 1, 0, 1, 1, 0, 0, 0, 0, 1, 1, 1, 1, 0]",268,153,115,11,11,0.0718954248366013,0.09565217391304348
"[0, 0, 0, 0, 1, 1, 0, 0, 1, 1, 0, 1, 0, 0, 0]",407,264,143,24,14,0.09090909090909091,0.0979020979020979
"[1, 1, 1, 0, 1, 1, 0, 1, 1, 0, 0, 1, 1, 0, 1]",237,90,147,6,11,0.06666666666666667,0.07482993197278912
"[0, 1, 1, 1, 1, 1, 0, 1, 0, 1, 1, 0, 0, 1, 1]",316,151,165,20,16,0.13245033112582782,0.09696969696969697
"[1, 0, 1, 1, 1, 1, 0, 1, 0, 0, 0, 0, 1, 1, 1]",217,90,127,11,15,0.12222222222222222,0.11811023622047244
"[1, 0, 0, 0, 1, 1, 0, 0, 1, 0, 1, 1, 1, 1, 0]",136,59,77,8,8,0.13559322033898305,0.1038961038961039
"[1, 1, 0, 1, 1, 0, 0, 0, 1, 1, 0, 0, 1, 0, 1]",100,46,54,2,5,0.043478260869565216,0.09259259259259259
"[1, 1, 1, 0, 1, 0, 0, 0, 1, 1, 1, 1, 1, 0, 1]",242,73,169,10,14,0.136986301369863,0.08284023668639054
"[1, 1, 1, 1, 0, 1, 0, 0, 0, 1, 1, 1, 1, 1, 0]",275,98,177,11,15,0.11224489795918367,0.0847457627118644
"[1, 1, 1, 0, 0, 1, 1, 0, 0, 0, 1, 0, 1, 0, 1]",157,52,105,3,10,0.057692307692307696,0.09523809523809523
"[1, 1, 0, 1, 1, 1, 1, 0, 0, 1, 1, 0, 0, 0, 1]",188,77,111,10,11,0.12987012987012986,0.0990990990990991
"[0, 1, 1, 0, 0, 0, 1, 1, 0, 0, 1, 0, 0, 0, 0]",292,196,96,22,11,0.11224489795918367,0.11458333333333333
"[0, 0, 0, 0, 0, 1, 0, 0, 1, 1, 0, 0, 0, 1, 1]",399,254,145,35,10,0.1377952755905512,0.06896551724137931
"[1, 0, 1, 1, 1, 1, 0, 0, 1, 0, 0, 0, 0, 1, 1]",167,70,97,11,7,0.15714285714285714,0.07216494845360824
"[1, 1, 1, 1, 1, 0, 1, 0, 0, 1, 0, 1, 0, 1, 1]",249,86,163,8,16,0.09302325581395349,0.09815950920245399
"[0, 1, 1, 1, 1, 1, 0, 1, 0, 0, 1, 0, 1, 0, 1]",144,69,75,7,8,0.10144927536231885,0.10666666666666667
"[0, 0, 0, 0, 1, 1, 1, 0, 1, 1, 0, 0, 1, 1, 1]",255,134,121,15,15,0.11194029850746269,0.12396694214876033
"[0, 0, 1, 1, 0, 0, 1, 1, 0, 0, 0, 0, 1, 0, 0]",624,391,233,35,24,0.08951406649616368,0.10300429184549356
"[0, 0, 1, 1, 0, 0, 0, 0, 1, 1, 1, 1, 0, 0, 0]",1983,1213,770,124,83,0.10222588623248145,0.10779220779220779
"[0, 0, 0, 1, 1, 0, 0, 0, 0, 1, 1, 1, 1, 0, 0]",1961,1613,348,163,27,0.10105393676379418,0.07758620689655173
"[0, 1, 1, 0, 0, 0, 1, 1, 0, 0, 0, 0, 0, 0, 0]",1138,829,309,68,37,0.08202653799758745,0.11974110032362459
"[1, 1, 0, 1, 0, 0, 1, 1, 0, 1, 1, 0, 1, 1, 1]",273,90,183,8,9,0.08888888888888889,0.04918032786885246
"[0, 0, 0, 1, 1, 1, 1, 0, 1, 1, 1, 0, 0, 0, 1]",143,73,70,8,5,0.1095890410958904,0.07142857142857142
"[0, 0, 0, 0, 0, 1, 1, 1, 1, 0, 1, 1, 1, 0, 0]",187,105,82,9,8,0.08571428571428572,0.0975609756097561
"[0, 1, 0, 0, 1, 1, 1, 0, 1, 1, 0, 1, 1, 1, 1]",270,108,162,12,12,0.1111111111111111,0.07407407407407407
"[1, 0, 1, 1, 0, 0, 0, 0, 1, 1, 0, 0, 1, 1, 1]",492,223,269,28,26,0.12556053811659193,0.09665427509293681
"[0, 1, 1, 0, 1, 1, 0, 0, 0, 0, 1, 1, 0, 0, 1]",283,157,126,14,8,0.08917197452229299,0.06349206349206349
"[0, 0, 1, 0, 1, 0, 1, 1, 0, 1, 0, 0, 0, 0, 0]",283,189,94,19,8,0.10052910052910052,0.0851063829787234
"[0, 0, 1, 1, 1, 0, 0, 0, 0, 0, 1, 0, 0, 1, 0]",237,150,87,16,5,0.10666666666666667,0.05747126436781609
"[0, 1, 1, 1, 0, 0, 0, 1, 0, 0, 1, 1, 0, 0, 0]",183,113,70,13,6,0.11504424778761062,0.08571428571428572
"[0, 0, 1, 1, 1, 0, 0, 0, 1, 0, 0, 1, 1, 0, 0]",178,103,75,5,6,0.04854368932038835,0.08
"[1, 0, 0, 1, 1, 1, 1, 1, 1, 1, 1, 1, 0, 0, 1]",1512,344,1168,43,102,0.125,0.08732876712328767
"[0, 0, 1, 0, 0, 1, 0, 1, 0, 0, 0, 1, 1, 0, 0]",308,219,89,23,9,0.1050228310502283,0.10112359550561797
"[1, 0, 0, 0, 1, 0, 0, 1, 0, 1, 0, 0, 0, 1, 1]",199,114,85,14,6,0.12280701754385964,0.07058823529411765
"[0, 1, 0, 0, 0, 1, 0, 0, 1, 0, 1, 0, 0, 0, 1]",262,173,89,17,7,0.09826589595375723,0.07865168539325842
"[1, 1, 0, 0, 0, 0, 1, 1, 0, 1, 0, 0, 0, 0, 1]",240,146,94,13,8,0.08904109589041095,0.0851063829787234
"[0, 1, 1, 1, 1, 0, 0, 0, 0, 1, 1, 0, 1, 0, 0]",210,153,57,14,4,0.0915032679738562,0.07017543859649122
"[0, 1, 0, 1, 1, 0, 0, 0, 0, 1, 1, 0, 0, 1, 1]",408,231,177,25,19,0.10822510822510822,0.10734463276836158
"[0, 1, 1, 0, 1, 1, 0, 0, 0, 0, 1, 1, 1, 1, 0]",284,139,145,14,11,0.10071942446043165,0.07586206896551724
"[0, 0, 0, 1, 1, 0, 1, 1, 0, 0, 0, 0, 1, 1, 1]",285,166,119,15,9,0.09036144578313253,0.07563025210084033
"[1, 1, 0, 1, 0, 0, 0, 0, 1, 1, 0, 1, 1, 0, 0]",127,74,53,8,6,0.10810810810810811,0.11320754716981132
"[0, 1, 1, 0, 1, 0, 0, 0, 0, 1, 1, 0, 1, 1, 0]",115,53,62,7,7,0.1320754716981132,0.11290322580645161
"[0, 1, 1, 1, 0, 1, 1, 0, 1, 0, 0, 0, 0, 1, 1]",170,88,82,11,7,0.125,0.08536585365853659
"[0, 1, 0, 1, 1, 1, 1, 1, 0, 1, 0, 0, 1, 1, 1]",285,122,163,6,12,0.04918032786885246,0.0736196319018405
"[1, 1, 0, 0, 0, 0, 1, 0, 0, 0, 0, 1, 0, 0, 0]",650,473,177,33,16,0.06976744186046512,0.0903954802259887
"[1, 1, 0, 1, 0, 1, 1, 0, 0, 0, 0, 1, 1, 1, 0]",135,63,72,8,9,0.12698412698412698,0.125
"[0, 1, 1, 0, 1, 0, 1, 0, 1, 1, 1, 1, 1, 0, 1]",226,87,139,9,18,0.10344827586206896,0.12949640287769784
"[1, 0, 1, 0, 1, 0, 0, 0, 0, 0, 0, 1, 0, 0, 0]",535,401,134,40,12,0.09975062344139651,0.08955223880597014
"[0, 0, 0, 1, 1, 0, 0, 0, 0, 0, 0, 1, 0, 0, 1]",955,744,211,62,16,0.08333333333333333,0.07582938388625593
"[1, 0, 1, 0, 1, 0, 0, 0, 0, 1, 0, 0, 1, 0, 0]",220,141,79,15,2,0.10638297872340426,0.02531645569620253
"[0, 1, 0, 1, 1, 0, 0, 0, 0, 0, 1, 1, 1, 0, 1]",135,74,61,5,6,0.06756756756756757,0.09836065573770492
"[0, 0, 0, 0, 0, 1, 1, 0, 0, 0, 0, 1, 0, 0, 1]",989,775,214,71,17,0.09161290322580645,0.0794392523364486
"[1, 1, 0, 0, 0, 1, 0, 1, 0, 1, 0, 0, 0, 0, 0]",275,193,82,26,7,0.13471502590673576,0.08536585365853659
"[0, 1, 0, 1, 1, 1, 0, 0, 0, 1, 0, 1, 0, 1, 0]",117,56,61,3,4,0.05357142857142857,0.06557377049180328
"[0, 0, 1, 1, 0, 1, 0, 1, 1, 1, 0, 0, 0, 1, 0]",127,62,65,9,4,0.14516129032258066,0.06153846153846154
"[1, 0, 1, 0, 0, 0, 1, 1, 0, 1, 0, 1, 1, 1, 0]",103,44,59,6,6,0.13636363636363635,0.1016949152542373
"[0, 1, 1, 1, 1, 0, 1, 0, 1, 1, 1, 1, 1, 1, 0]",551,182,369,21,37,0.11538461538461539,0.1002710027100271
"[0, 0, 0, 1, 1, 0, 0, 0, 0, 1, 1, 0, 1, 0, 0]",459,350,109,30,10,0.08571428571428572,0.09174311926605505
"[0, 1, 0, 0, 0, 0, 0, 0, 0, 1, 1, 1, 0, 1, 0]",254,153,101,19,5,0.12418300653594772,0.04950495049504951
"[1, 0, 1, 0, 0, 1, 1, 0, 0, 0, 0, 0, 1, 0, 0]",265,176,89,18,7,0.10227272727272728,0.07865168539325842
"[1, 0, 1, 1, 1, 0, 0, 0, 1, 0, 0, 0, 0, 1, 1]",154,92,62,7,2,0.07608695652173914,0.03225806451612903
"[1, 0, 1, 1, 1, 1, 1, 0, 1, 0, 1, 1, 0, 1, 1]",500,130,370,17,35,0.13076923076923078,0.0945945945945946
"[0, 0, 1, 1, 0, 1, 1, 1, 1, 0, 0, 0, 1, 1, 1]",238,107,131,13,16,0.12149532710280374,0.12213740458015267
"[0, 1, 1, 1, 0, 0, 1, 1, 0, 1, 1, 1, 1, 0, 0]",175,63,112,6,10,0.09523809523809523,0.08928571428571429
"[0, 1, 0, 1, 1, 1, 0, 0, 1, 1, 0, 1, 1, 1, 1]",286,97,189,11,23,0.1134020618556701,0.12169312169312169
"[1, 1, 1, 0, 1, 1, 0, 1, 1, 0, 0, 1, 0, 0, 0]",138,57,81,5,10,0.08771929824561403,0.12345679012345678
"[1, 1, 1, 1, 1, 0, 1, 1, 0, 1, 1, 0, 0, 1, 0]",265,84,181,7,17,0.08333333333333333,0.09392265193370165
"[0, 0, 0, 0, 0, 1, 0, 1, 1, 1, 0, 0, 1, 0, 1]",149,89,60,6,5,0.06741573033707865,0.08333333333333333
"[1, 1, 0, 0, 0, 0, 0, 1, 0, 1, 1, 1, 0, 0, 1]",146,80,66,9,6,0.1125,0.09090909090909091
"[1, 0, 0, 0, 0, 0, 1, 0, 1, 1, 0, 1, 1, 1, 1]",183,80,103,6,14,0.075,0.13592233009708737
"[1, 1, 1, 0, 0, 0, 0, 0, 1, 0, 1, 1, 0, 1, 1]",150,47,103,5,10,0.10638297872340426,0.0970873786407767
"[1, 1, 1, 0, 0, 0, 1, 1, 0, 0, 0, 0, 1, 1, 1]",368,146,222,13,19,0.08904109589041095,0.08558558558558559
"[0, 0, 0, 1, 1, 1, 0, 0, 1, 1, 1, 0, 0, 1, 0]",141,82,59,11,9,0.13414634146341464,0.15254237288135594
"[0, 0, 0, 0, 1, 1, 0, 0, 0, 1, 0, 1, 1, 1, 1]",321,169,152,6,10,0.03550295857988166,0.06578947368421052
"[1, 1, 0, 1, 1, 0, 0, 1, 1, 1, 1, 0, 0, 1, 1]",775,280,495,21,55,0.075,0.1111111111111111
"[0, 1, 1, 1, 0, 1, 0, 1, 0, 1, 1, 1, 1, 1, 1]",641,222,419,20,51,0.09009009009009009,0.12171837708830549
"[1, 0, 1, 1, 1, 0, 0, 1, 0, 1, 1, 0, 1, 1, 0]",153,64,89,5,6,0.078125,0.06741573033707865
"[1, 1, 1, 1, 0, 1, 1, 1, 0, 0, 1, 0, 1, 1, 0]",234,76,158,9,13,0.11842105263157894,0.08227848101265822
"[1, 1, 1, 1, 1, 1, 0, 1, 1, 1, 0, 0, 1, 0, 1]",588,169,419,18,38,0.10650887573964497,0.09069212410501193
"[1, 1, 0, 0, 0, 0, 1, 0, 1, 0, 0, 1, 1, 0, 1]",126,63,63,6,4,0.09523809523809523,0.06349206349206349
"[1, 1, 0, 0, 1, 1, 1, 0, 0, 0, 0, 0, 0, 1, 0]",192,111,81,12,6,0.10810810810810811,0.07407407407407407
"[0, 0, 1, 1, 0, 0, 0, 1, 1, 1, 1, 0, 0, 0, 0]",415,242,173,29,15,0.11983471074380166,0.08670520231213873
"[1, 1, 0, 0, 0, 0, 0, 1, 1, 0, 0, 0, 1, 1, 1]",279,150,129,14,15,0.09333333333333334,0.11627906976744186
"[0, 1, 1, 0, 0, 0, 0, 0, 1, 1, 0, 0, 0, 1, 1]",261,173,88,21,10,0.12138728323699421,0.11363636363636363
"[0, 1, 0, 0, 1, 0, 1, 0, 1, 1, 0, 0, 0, 0, 0]",329,219,110,32,6,0.1461187214611872,0.05454545454545454
"[0, 1, 1, 1, 0, 0, 0, 1, 1, 0, 0, 0, 1, 1, 1]",172,89,83,9,10,0.10112359550561797,0.12048192771084337
"[1, 0, 0, 0, 1, 1, 1, 0, 1, 0, 0, 0, 0, 0, 0]",315,172,143,17,10,0.09883720930232558,0.06993006993006994
"[0, 1, 1, 0, 1, 1, 0, 1, 1, 1, 1, 1, 1, 1, 0]",592,189,403,17,45,0.08994708994708994,0.11166253101736973
"[1, 1, 0, 1, 1, 1, 0, 0, 0, 0, 1, 1, 0, 1, 1]",193,83,110,6,8,0.07228915662650602,0.07272727272727272
"[1, 1, 1, 0, 1, 1, 0, 1, 1, 1, 0, 0, 0, 0, 1]",237,81,156,4,11,0.04938271604938271,0.07051282051282051
"[1, 0, 0, 0, 0, 0, 1, 0, 0, 1, 1, 0, 0, 0, 0]",836,559,277,52,18,0.09302325581395349,0.06498194945848375
"[1, 0, 1, 0, 1, 0, 1, 0, 0, 1, 0, 0, 1, 0, 0]",141,95,46,8,2,0.08421052631578947,0.043478260869565216
"[0, 1, 0, 1, 0, 1, 0, 1, 0, 0, 1, 0, 0, 1, 0]",148,90,58,10,5,0.1111111111111111,0.08620689655172414
"[0, 0, 0, 0, 1, 0, 1, 0, 1, 0, 1, 0, 0, 1, 0]",231,153,78,11,5,0.0718954248366013,0.0641025641025641
"[1, 0, 1, 1, 0, 1, 0, 0, 0, 0, 0, 0, 0, 0, 1]",326,205,121,16,11,0.07804878048780488,0.09090909090909091
"[1, 1, 1, 1, 0, 1, 0, 1, 1, 1, 0, 1, 1, 0, 0]",298,109,189,8,16,0.07339449541284404,0.08465608465608465
"[1, 1, 0, 0, 0, 0, 0, 1, 0, 0, 1, 1, 0, 0, 1]",235,133,102,13,13,0.09774436090225563,0.12745098039215685
"[0, 1, 1, 1, 1, 0, 0, 1, 1, 1, 0, 0, 0, 0, 0]",259,158,101,19,5,0.12025316455696203,0.04950495049504951
"[1, 0, 1, 1, 1, 1, 0, 0, 1, 1, 1, 0, 0, 0, 0]",194,94,100,12,8,0.1276595744680851,0.08
"[1, 1, 0, 0, 1, 0, 0, 0, 0, 1, 1, 1, 1, 0, 0]",299,171,128,13,14,0.07602339181286549,0.109375
"[0, 0, 1, 1, 1, 0, 0, 1, 1, 1, 1, 1, 0, 0, 1]",245,103,142,12,16,0.11650485436893204,0.11267605633802817
"[1, 1, 1, 1, 0, 1, 0, 1, 1, 1, 1, 0, 0, 1, 1]",887,240,647,27,52,0.1125,0.080370942812983
"[1, 0, 1, 1, 1, 0, 1, 1, 1, 1, 0, 1, 0, 1, 1]",525,145,380,21,36,0.14482758620689656,0.09473684210526316
"[0, 0, 1, 1, 0, 0, 0, 0, 1, 0, 0, 0, 1, 0, 0]",594,427,167,34,11,0.07962529274004684,0.0658682634730539
"[0, 1, 1, 0, 0, 0, 0, 1, 0, 1, 0, 1, 0, 0, 1]",181,113,68,10,1,0.08849557522123894,0.014705882352941176
"[1, 0, 0, 1, 0, 1, 0, 1, 1, 1, 1, 0, 1, 1, 0]",143,57,86,8,7,0.14035087719298245,0.08139534883720931
"[0, 1, 1, 0, 1, 0, 0, 0, 0, 1, 1, 1, 1, 0, 0]",252,133,119,10,17,0.07518796992481203,0.14285714285714285
"[1, 0, 1, 0, 0, 0, 1, 0, 1, 1, 0, 1, 0, 0, 0]",143,84,59,8,5,0.09523809523809523,0.0847457627118644
"[0, 1, 0, 0, 1, 1, 1, 0, 0, 0, 0, 0, 0, 0, 0]",991,701,290,66,23,0.09415121255349501,0.07931034482758621
"[1, 1, 0, 0, 1, 0, 0, 0, 0, 1, 1, 0, 1, 0, 0]",180,100,80,4,6,0.04,0.075
"[1, 1, 1, 1, 0, 0, 1, 0, 0, 0, 0, 1, 1, 0, 1]",153,67,86,6,10,0.08955223880597014,0.11627906976744186
"[1, 0, 1, 0, 0, 1, 0, 1, 0, 1, 1, 0, 0, 1, 1]",120,58,62,5,7,0.08620689655172414,0.11290322580645161
"[0, 0, 0, 1, 1, 0, 0, 0, 1, 1, 0, 0, 0, 0, 1]",474,327,147,24,12,0.07339449541284404,0.08163265306122448
"[0, 0, 0, 0, 1, 1, 0, 0, 0, 1, 1, 0, 0, 0, 0]",1052,762,290,70,22,0.09186351706036745,0.07586206896551724
"[0, 1, 1, 0, 0, 0, 0, 1, 1, 0, 0, 0, 1, 1, 0]",310,233,77,13,7,0.055793991416309016,0.09090909090909091
"[1, 1, 1, 0, 0, 1, 1, 1, 0, 1, 0, 0, 1, 1, 1]",379,116,263,9,20,0.07758620689655173,0.07604562737642585
"[0, 1, 0, 1, 1, 0, 1, 1, 1, 1, 1, 1, 1, 1, 0]",660,198,462,22,43,0.1111111111111111,0.09307359307359307
"[0, 0, 1, 0, 1, 1, 0, 1, 0, 1, 1, 0, 1, 1, 1]",161,70,91,5,9,0.07142857142857142,0.0989010989010989
"[0, 1, 0, 1, 0, 1, 1, 1, 1, 1, 1, 0, 1, 0, 1]",232,88,144,6,17,0.06818181818181818,0.11805555555555555
"[1, 1, 1, 1, 1, 1, 1, 1, 1, 0, 1, 0, 0, 0, 0]",485,139,346,14,35,0.10071942446043165,0.10115606936416185
"[0, 0, 1, 1, 0, 0, 0, 1, 1, 1, 0, 0, 0, 0, 1]",229,137,92,16,11,0.11678832116788321,0.11956521739130435
"[1, 0, 0, 1, 0, 1, 0, 0, 1, 1, 1, 1, 1, 0, 0]",155,62,93,5,9,0.08064516129032258,0.0967741935483871
"[1, 1, 1, 0, 0, 0, 1, 0, 0, 1, 1, 0, 0, 1, 0]",119,55,64,5,7,0.09090909090909091,0.109375
"[0, 0, 0, 1, 1, 1, 1, 0, 0, 0, 0, 0, 1, 1, 0]",366,262,104,20,13,0.07633587786259542,0.125
"[0, 1, 0, 1, 0, 1, 0, 1, 1, 0, 1, 1, 1, 0, 1]",96,50,46,4,2,0.08,0.043478260869565216
"[1, 1, 1, 0, 0, 0, 1, 1, 1, 1, 0, 1, 0, 1, 0]",178,58,120,4,13,0.06896551724137931,0.10833333333333334
"[0, 1, 1, 0, 0, 0, 1, 1, 1, 0, 0, 0, 1, 1, 1]",180,112,68,8,4,0.07142857142857142,0.058823529411764705
"[0, 0, 0, 1, 0, 1, 1, 1, 1, 0, 0, 1, 0, 1, 1]",122,67,55,5,7,0.07462686567164178,0.12727272727272726
"[0, 1, 1, 1, 1, 0, 0, 1, 1, 0, 0, 1, 1, 0, 0]",1508,1166,342,126,38,0.10806174957118353,0.1111111111111111
"[1, 1, 0, 0, 0, 0, 1, 0, 1, 0, 0, 1, 1, 1, 1]",246,107,139,16,12,0.14953271028037382,0.08633093525179857
"[0, 0, 1, 1, 0, 0, 1, 1, 0, 0, 0, 0, 1, 0, 1]",425,258,167,27,9,0.10465116279069768,0.05389221556886228
"[1, 0, 0, 0, 0, 1, 0, 0, 1, 1, 0, 0, 1, 1, 0]",264,137,127,14,8,0.10218978102189781,0.06299212598425197
"[1, 0, 1, 0, 1, 1, 0, 1, 0, 0, 1, 1, 1, 0, 1]",129,55,74,5,7,0.09090909090909091,0.0945945945945946
"[1, 1, 1, 0, 1, 1, 0, 1, 0, 1, 1, 0, 1, 0, 0]",151,64,87,5,9,0.078125,0.10344827586206896
"[0, 1, 0, 1, 0, 0, 0, 0, 1, 0, 0, 1, 1, 0, 1]",153,88,65,6,5,0.06818181818181818,0.07692307692307693
"[0, 0, 0, 0, 0, 0, 0, 0, 1, 0, 0, 1, 1, 1, 1]",1132,868,264,79,35,0.09101382488479262,0.13257575757575757
"[1, 0, 1, 1, 1, 1, 0, 1, 1, 0, 0, 1, 1, 1, 0]",256,88,168,7,12,0.07954545454545454,0.07142857142857142
"[1, 0, 1, 1, 1, 0, 0, 0, 1, 0, 0, 1, 1, 0, 1]",105,50,55,7,8,0.14,0.14545454545454545
"[0, 1, 1, 0, 0, 1, 1, 1, 0, 0, 1, 0, 1, 1, 1]",217,121,96,8,5,0.06611570247933884,0.052083333333333336
"[0, 1, 0, 0, 1, 1, 0, 0, 0, 1, 1, 1, 1, 0, 1]",106,57,49,5,5,0.08771929824561403,0.10204081632653061
"[1, 0, 0, 1, 0, 1, 1, 0, 1, 0, 1, 1, 1, 0, 0]",109,59,50,6,7,0.1016949152542373,0.14
"[1, 1, 0, 1, 1, 0, 1, 0, 0, 1, 1, 0, 1, 0, 1]",153,68,85,2,8,0.029411764705882353,0.09411764705882353
"[1, 0, 1, 0, 1, 1, 1, 0, 0, 0, 0, 1, 1, 0, 0]",285,128,157,9,22,0.0703125,0.14012738853503184
"[1, 0, 1, 1, 1, 1, 0, 0, 0, 1, 0, 1, 0, 1, 1]",176,69,107,3,16,0.043478260869565216,0.14953271028037382
"[1, 1, 0, 1, 1, 0, 0, 0, 0, 1, 1, 0, 0, 1, 0]",140,79,61,10,7,0.12658227848101267,0.11475409836065574
"[1, 1, 1, 1, 0, 1, 0, 1, 0, 0, 0, 0, 1, 1, 0]",185,81,104,9,7,0.1111111111111111,0.0673076923076923
"[1, 0, 0, 1, 1, 0, 0, 1, 0, 0, 0, 1, 0, 1, 1]",129,53,76,5,4,0.09433962264150944,0.05263157894736842
"[1, 1, 1, 1, 1, 1, 1, 0, 0, 1, 0, 0, 0, 1, 1]",427,128,299,12,32,0.09375,0.10702341137123746
"[1, 1, 1, 0, 1, 1, 1, 1, 1, 1, 0, 0, 0, 1, 1]",720,207,513,29,48,0.14009661835748793,0.0935672514619883
"[1, 0, 0, 1, 1, 1, 0, 1, 1, 0, 0, 0, 1, 1, 1]",200,65,135,8,21,0.12307692307692308,0.15555555555555556
"[0, 0, 1, 0, 0, 1, 1, 1, 0, 1, 1, 0, 0, 0, 1]",101,49,52,5,5,0.10204081632653061,0.09615384615384616
"[0, 0, 0, 1, 1, 0, 1, 0, 0, 1, 0, 0, 0, 1, 0]",257,178,79,14,7,0.07865168539325842,0.08860759493670886
"[1, 0, 1, 1, 0, 0, 1, 0, 1, 1, 0, 0, 1, 1, 1]",207,74,133,10,10,0.13513513513513514,0.07518796992481203
"[0, 0, 1, 1, 1, 1, 0, 1, 0, 0, 1, 0, 1, 1, 1]",231,94,137,8,11,0.0851063829787234,0.08029197080291971
"[0, 0, 1, 1, 0, 0, 1, 1, 0, 0, 0, 1, 0, 1, 1]",306,183,123,18,8,0.09836065573770492,0.06504065040650407
"[0, 1, 0, 0, 1, 0, 1, 1, 1, 1, 0, 0, 1, 0, 1]",123,61,62,1,8,0.01639344262295082,0.12903225806451613
"[1, 0, 1, 1, 0, 0, 0, 0, 0, 0, 0, 1, 1, 1, 0]",185,102,83,7,4,0.06862745098039216,0.04819277108433735
"[1, 1, 1, 0, 0, 0, 1, 1, 1, 0, 0, 1, 0, 0, 0]",140,70,70,7,10,0.1,0.14285714285714285
"[0, 0, 0, 0, 0, 0, 0, 0, 1, 0, 1, 1, 0, 1, 0]",571,409,162,32,16,0.07823960880195599,0.09876543209876543
"[1, 0, 0, 1, 0, 0, 1, 0, 1, 0, 1, 0, 0, 0, 0]",243,155,88,18,8,0.11612903225806452,0.09090909090909091
"[0, 0, 1, 0, 1, 0, 1, 0, 0, 0, 0, 1, 1, 0, 0]",367,242,125,30,6,0.12396694214876033,0.048
"[0, 1, 0, 1, 0, 0, 1, 1, 0, 1, 1, 1, 0, 0, 1]",111,48,63,6,5,0.125,0.07936507936507936
"[1, 1, 1, 0, 0, 1, 0, 1, 0, 0, 1, 1, 0, 1, 1]",157,53,104,6,8,0.11320754716981132,0.07692307692307693
"[1, 1, 1, 1, 1, 0, 0, 1, 0, 1, 0, 0, 1, 1, 0]",186,63,123,4,11,0.06349206349206349,0.08943089430894309
"[0, 0, 1, 0, 1, 1, 1, 1, 1, 0, 0, 1, 0, 1, 0]",106,66,40,7,2,0.10606060606060606,0.05
"[0, 0, 0, 0, 1, 0, 0, 1, 0, 1, 1, 1, 0, 0, 0]",320,212,108,28,13,0.1320754716981132,0.12037037037037036
"[0, 0, 1, 1, 1, 1, 1, 1, 0, 1, 1, 0, 0, 1, 0]",176,76,100,5,9,0.06578947368421052,0.09
"[0, 1, 1, 0, 0, 0, 0, 0, 1, 1, 1, 1, 1, 1, 0]",337,189,148,19,17,0.10052910052910052,0.11486486486486487
"[1, 0, 0, 1, 1, 0, 0, 0, 0, 0, 1, 1, 1, 1, 1]",423,131,292,11,27,0.08396946564885496,0.09246575342465753
"[1, 1, 1, 1, 1, 0, 1, 1, 0, 1, 0, 1, 0, 1, 0]",246,91,155,6,13,0.06593406593406594,0.08387096774193549
"[0, 0, 0, 1, 1, 1, 0, 0, 0, 0, 1, 0, 0, 0, 1]",284,193,91,14,9,0.07253886010362694,0.0989010989010989
"[0, 0, 0, 0, 0, 0, 0, 1, 0, 0, 0, 1, 1, 1, 0]",622,453,169,49,13,0.10816777041942605,0.07692307692307693
"[1, 0, 0, 1, 1, 1, 1, 1, 0, 0, 1, 1, 1, 0, 1]",283,86,197,6,22,0.06976744186046512,0.1116751269035533
"[1, 0, 0, 1, 1, 0, 0, 0, 0, 0, 0, 0, 1, 1, 1]",793,279,514,32,53,0.11469534050179211,0.10311284046692606
"[0, 1, 1, 0, 0, 0, 0, 1, 1, 1, 1, 1, 1, 1, 0]",434,272,162,21,16,0.07720588235294118,0.09876543209876543
"[0, 0, 0, 0, 1, 0, 1, 1, 1, 0, 0, 1, 1, 1, 1]",245,138,107,19,6,0.13768115942028986,0.056074766355140186
"[1, 1, 1, 1, 0, 1, 1, 1, 1, 0, 1, 0, 1, 1, 0]",490,151,339,18,33,0.11920529801324503,0.09734513274336283
"[0, 1, 1, 1, 1, 0, 0, 1, 0, 1, 1, 0, 0, 0, 0]",182,100,82,10,8,0.1,0.0975609756097561
"[0, 1, 0, 1, 1, 1, 1, 0, 0, 1, 0, 1, 1, 0, 0]",122,65,57,6,2,0.09230769230769231,0.03508771929824561
"[1, 0, 0, 0, 1, 0, 1, 1, 0, 1, 0, 0, 1, 0, 1]",113,53,60,5,7,0.09433962264150944,0.11666666666666667
"[0, 0, 0, 0, 0, 0, 0, 1, 0, 0, 0, 1, 0, 1, 1]",843,641,202,61,18,0.09516380655226209,0.0891089108910891
"[1, 1, 1, 1, 1, 0, 1, 1, 1, 1, 0, 1, 0, 0, 1]",609,171,438,17,36,0.09941520467836257,0.0821917808219178
"[0, 0, 1, 1, 0, 1, 1, 0, 0, 0, 1, 1, 0, 1, 0]",126,74,52,7,9,0.0945945945945946,0.17307692307692307
"[1, 1, 1, 0, 1, 0, 0, 0, 1, 1, 0, 0, 0, 1, 0]",105,45,60,3,9,0.06666666666666667,0.15
"[1, 0, 1, 1, 1, 1, 1, 1, 1, 1, 0, 0, 1, 0, 0]",306,109,197,14,27,0.12844036697247707,0.13705583756345177
"[0, 0, 1, 1, 1, 1, 1, 1, 1, 0, 0, 1, 0, 0, 1]",219,79,140,6,14,0.0759493670886076,0.1
"[1, 0, 1, 0, 1, 0, 0, 1, 1, 1, 1, 1, 0, 0, 1]",175,75,100,6,8,0.08,0.08
"[0, 1, 0, 1, 1, 1, 0, 1, 1, 0, 1, 0, 1, 0, 1]",118,53,65,4,6,0.07547169811320754,0.09230769230769231
"[0, 1, 1, 0, 1, 1, 1, 0, 1, 1, 1, 0, 1, 0, 1]",219,79,140,5,8,0.06329113924050633,0.05714285714285714
"[0, 0, 1, 0, 1, 0, 0, 0, 0, 1, 0, 0, 0, 1, 1]",295,203,92,13,6,0.06403940886699508,0.06521739130434782
"[0, 0, 0, 1, 0, 0, 0, 0, 0, 1, 1, 1, 0, 0, 1]",311,195,116,25,10,0.1282051282051282,0.08620689655172414
"[0, 1, 0, 1, 1, 1, 1, 0, 0, 1, 0, 0, 1, 1, 0]",143,66,77,5,10,0.07575757575757576,0.12987012987012986
"[0, 1, 1, 1, 0, 0, 1, 0, 1, 1, 1, 1, 0, 0, 1]",178,79,99,4,12,0.05063291139240506,0.12121212121212122
"[1, 0, 1, 0, 0, 0, 1, 1, 1, 1, 1, 1, 1, 0, 0]",254,107,147,11,8,0.102803738317757,0.05442176870748299
"[0, 1, 1, 1, 0, 1, 1, 1, 0, 1, 0, 0, 0, 0, 1]",132,60,72,2,6,0.03333333333333333,0.08333333333333333
"[1, 1, 1, 0, 0, 0, 0, 0, 1, 1, 1, 0, 0, 1, 1]",203,83,120,11,11,0.13253012048192772,0.09166666666666666
"[1, 0, 0, 0, 0, 0, 1, 1, 0, 0, 0, 0, 1, 1, 1]",644,341,303,36,28,0.10557184750733138,0.0924092409240924
"[1, 1, 0, 0, 0, 0, 1, 0, 1, 1, 0, 1, 1, 1, 1]",232,104,128,7,7,0.0673076923076923,0.0546875
"[0, 0, 0, 0, 1, 0, 0, 0, 1, 0, 1, 0, 1, 1, 1]",255,164,91,12,10,0.07317073170731707,0.10989010989010989
"[0, 1, 0, 1, 0, 0, 0, 0, 1, 0, 0, 0, 1, 0, 1]",255,154,101,16,9,0.1038961038961039,0.0891089108910891
"[0, 0, 1, 1, 1, 0, 1, 1, 1, 0, 1, 0, 1, 0, 0]",116,63,53,5,5,0.07936507936507936,0.09433962264150944
"[0, 0, 0, 1, 1, 1, 0, 1, 1, 1, 0, 1, 0, 1, 0]",130,60,70,7,9,0.11666666666666667,0.12857142857142856
"[1, 1, 1, 0, 1, 0, 1, 1, 0, 0, 0, 1, 1, 1, 0]",153,67,86,5,5,0.07462686567164178,0.05813953488372093
"[1, 1, 0, 0, 1, 1, 1, 1, 0, 1, 0, 1, 1, 0, 0]",198,83,115,10,13,0.12048192771084337,0.11304347826086956
"[1, 0, 0, 1, 1, 0, 0, 0, 1, 0, 1, 1, 0, 1, 0]",112,43,69,5,9,0.11627906976744186,0.13043478260869565
"[0, 1, 0, 0, 1, 0, 1, 0, 0, 1, 1, 0, 1, 0, 1]",112,62,50,5,4,0.08064516129032258,0.08
"[0, 1, 1, 1, 0, 1, 1, 1, 0, 0, 0, 0, 0, 1, 0]",123,68,55,7,3,0.10294117647058823,0.05454545454545454
"[0, 1, 1, 1, 1, 1, 0, 0, 1, 1, 0, 0, 1, 1, 1]",938,360,578,37,61,0.10277777777777777,0.10553633217993079
"[0, 0, 1, 1, 0, 1, 1, 1, 1, 0, 1, 1, 1, 0, 1]",253,104,149,11,13,0.10576923076923077,0.087248322147651
"[0, 1, 0, 0, 0, 1, 0, 0, 1, 1, 0, 1, 1, 1, 1]",127,67,60,9,2,0.13432835820895522,0.03333333333333333
"[1, 1, 1, 1, 1, 1, 1, 0, 1, 0, 0, 0, 1, 1, 1]",906,250,656,13,62,0.052,0.09451219512195122
"[1, 1, 1, 0, 1, 0, 1, 1, 0, 1, 0, 0, 0, 0, 1]",112,58,54,1,3,0.017241379310344827,0.05555555555555555
"[0, 1, 1, 1, 0, 1, 1, 1, 0, 0, 1, 1, 1, 0, 0]",186,85,101,11,11,0.12941176470588237,0.10891089108910891
"[0, 0, 0, 0, 0, 1, 0, 0, 0, 0, 0, 1, 0, 1, 1]",785,593,192,54,14,0.09106239460370995,0.07291666666666667
"[1, 0, 0, 0, 1, 0, 0, 1, 1, 1, 1, 1, 0, 1, 1]",165,75,90,7,8,0.09333333333333334,0.08888888888888889
"[1, 0, 0, 1, 0, 1, 0, 0, 0, 1, 1, 0, 0, 0, 1]",151,77,74,10,6,0.12987012987012986,0.08108108108108109
"[0, 1, 0, 0, 1, 0, 1, 0, 0, 0, 1, 1, 0, 0, 0]",304,203,101,21,4,0.10344827586206896,0.039603960396039604
"[1, 1, 0, 0, 0, 1, 1, 1, 0, 1, 1, 0, 0, 1, 0]",93,45,48,4,4,0.08888888888888889,0.08333333333333333
"[1, 0, 0, 1, 0, 1, 1, 1, 1, 1, 0, 1, 1, 0, 1]",221,76,145,6,15,0.07894736842105263,0.10344827586206896
"[1, 1, 0, 0, 1, 0, 1, 1, 1, 1, 1, 0, 1, 1, 0]",226,89,137,8,18,0.0898876404494382,0.13138686131386862
"[0, 0, 0, 1, 1, 0, 0, 1, 1, 1, 0, 1, 1, 0, 0]",169,110,59,12,6,0.10909090909090909,0.1016949152542373
"[1, 0, 0, 0, 0, 0, 1, 1, 0, 0, 1, 1, 1, 0, 1]",172,89,83,5,4,0.056179775280898875,0.04819277108433735
"[0, 0, 0, 1, 1, 0, 1, 1, 0, 0, 0, 1, 0, 0, 0]",270,190,80,13,12,0.06842105263157895,0.15
"[1, 1, 1, 1, 0, 1, 0, 1, 1, 0, 1, 0, 0, 1, 1]",266,87,179,6,16,0.06896551724137931,0.0893854748603352
"[1, 0, 1, 1, 0, 0, 1, 1, 0, 0, 1, 1, 1, 1, 1]",829,294,535,27,48,0.09183673469387756,0.08971962616822429
"[1, 1, 0, 1, 0, 1, 0, 1, 1, 0, 0, 1, 1, 0, 0]",197,83,114,5,10,0.060240963855421686,0.08771929824561403
"[0, 0, 0, 0, 1, 0, 0, 1, 0, 0, 1, 0, 1, 0, 0]",530,382,148,36,15,0.09424083769633508,0.10135135135135136
"[0, 1, 1, 0, 1, 1, 1, 1, 0, 1, 1, 1, 0, 0, 1]",272,98,174,11,22,0.11224489795918367,0.12643678160919541
"[0, 1, 1, 0, 0, 0, 1, 1, 0, 1, 1, 1, 1, 0, 1]",183,79,104,5,8,0.06329113924050633,0.07692307692307693
"[0, 0, 1, 1, 0, 1, 1, 0, 0, 0, 1, 1, 0, 1, 1]",134,66,68,7,6,0.10606060606060606,0.08823529411764706
"[0, 0, 0, 0, 1, 1, 1, 0, 0, 1, 0, 0, 0, 1, 1]",224,142,82,13,5,0.09154929577464789,0.06097560975609756
"[1, 0, 0, 1, 0, 0, 1, 0, 1, 0, 0, 0, 0, 1, 1]",208,134,74,11,6,0.08208955223880597,0.08108108108108109
"[0, 0, 1, 0, 0, 1, 0, 0, 1, 0, 1, 0, 0, 0, 0]",532,388,144,44,21,0.1134020618556701,0.14583333333333334
"[0, 1, 0, 0, 1, 1, 1, 0, 0, 0, 1, 0, 0, 0, 0]",251,175,76,19,7,0.10857142857142857,0.09210526315789473
"[1, 1, 1, 0, 1, 1, 1, 1, 1, 0, 1, 1, 0, 0, 0]",319,104,215,6,16,0.057692307692307696,0.07441860465116279
"[0, 1, 0, 1, 1, 0, 0, 1, 0, 0, 0, 1, 0, 1, 1]",116,67,49,6,2,0.08955223880597014,0.04081632653061224
"[0, 1, 0, 1, 0, 0, 1, 1, 0, 0, 1, 1, 0, 0, 0]",329,203,126,13,8,0.06403940886699508,0.06349206349206349
"[1, 0, 0, 0, 1, 0, 0, 0, 0, 0, 0, 1, 1, 1, 1]",463,267,196,37,10,0.13857677902621723,0.05102040816326531
"[1, 1, 0, 0, 1, 0, 0, 0, 1, 0, 1, 1, 0, 0, 0]",176,98,78,7,10,0.07142857142857142,0.1282051282051282
"[1, 1, 1, 1, 0, 0, 1, 0, 0, 0, 1, 0, 1, 1, 0]",123,66,57,7,8,0.10606060606060606,0.14035087719298245
"[0, 0, 0, 0, 1, 0, 0, 0, 0, 1, 1, 1, 0, 1, 1]",165,99,66,7,6,0.0707070707070707,0.09090909090909091
"[0, 1, 0, 0, 0, 1, 1, 1, 0, 0, 1, 0, 1, 0, 0]",150,94,56,8,4,0.0851063829787234,0.07142857142857142
"[0, 1, 1, 1, 0, 1, 1, 1, 0, 1, 1, 0, 0, 1, 1]",299,103,196,11,24,0.10679611650485436,0.12244897959183673
"[1, 1, 1, 0, 1, 1, 1, 1, 0, 1, 1, 0, 1, 1, 0]",493,134,359,11,36,0.08208955223880597,0.10027855153203342
"[1, 1, 1, 1, 1, 0, 1, 1, 0, 1, 1, 1, 1, 0, 1]",1574,349,1225,38,124,0.10888252148997135,0.10122448979591837
"[1, 0, 1, 1, 0, 1, 0, 1, 0, 1, 0, 1, 1, 0, 0]",118,47,71,5,7,0.10638297872340426,0.09859154929577464
"[0, 1, 1, 1, 1, 0, 1, 0, 1, 0, 0, 0, 0, 1, 1]",184,111,73,12,10,0.10810810810810811,0.136986301369863
"[1, 0, 1, 1, 0, 0, 1, 1, 0, 0, 0, 0, 1, 0, 1]",127,62,65,5,5,0.08064516129032258,0.07692307692307693
"[0, 0, 0, 1, 1, 0, 1, 1, 1, 0, 1, 1, 0, 0, 1]",140,70,70,11,4,0.15714285714285714,0.05714285714285714
"[0, 0, 0, 0, 0, 1, 1, 0, 0, 0, 1, 1, 1, 1, 1]",427,310,117,30,9,0.0967741935483871,0.07692307692307693
"[0, 1, 1, 0, 0, 0, 0, 0, 0, 1, 1, 0, 0, 0, 1]",706,582,124,51,8,0.08762886597938144,0.06451612903225806
"[1, 0, 1, 1, 0, 0, 1, 1, 0, 0, 0, 0, 0, 0, 1]",459,249,210,18,15,0.07228915662650602,0.07142857142857142
"[1, 0, 0, 1, 1, 0, 0, 1, 1, 1, 1, 0, 1, 1, 1]",756,129,627,13,66,0.10077519379844961,0.10526315789473684
"[0, 0, 1, 1, 1, 1, 1, 1, 1, 0, 0, 1, 1, 0, 0]",574,249,325,26,38,0.10441767068273092,0.11692307692307692
"[0, 1, 1, 1, 1, 0, 1, 1, 1, 1, 1, 0, 1, 1, 1]",1756,495,1261,47,124,0.09494949494949495,0.09833465503568596
"[0, 1, 1, 1, 1, 1, 1, 0, 1, 1, 0, 1, 0, 1, 1]",553,214,339,25,39,0.11682242990654206,0.11504424778761062
"[0, 0, 1, 1, 1, 1, 1, 1, 0, 1, 1, 0, 1, 0, 1]",303,107,196,9,17,0.08411214953271028,0.08673469387755102
"[1, 1, 1, 0, 1, 0, 1, 0, 0, 1, 1, 1, 1, 1, 1]",862,242,620,30,57,0.12396694214876033,0.09193548387096774
"[0, 0, 0, 0, 1, 1, 0, 0, 0, 1, 0, 0, 1, 1, 0]",336,229,107,34,14,0.14847161572052403,0.1308411214953271
"[1, 1, 1, 1, 1, 0, 0, 1, 0, 1, 1, 1, 0, 1, 1]",610,160,450,21,29,0.13125,0.06444444444444444
"[1, 0, 0, 0, 0, 1, 1, 0, 1, 1, 1, 1, 1, 1, 0]",228,75,153,5,12,0.06666666666666667,0.0784313725490196
"[0, 0, 1, 0, 1, 1, 0, 1, 0, 1, 0, 1, 1, 1, 0]",103,42,61,5,2,0.11904761904761904,0.03278688524590164
"[0, 0, 1, 1, 1, 0, 0, 1, 0, 0, 1, 1, 0, 0, 0]",201,117,84,13,12,0.1111111111111111,0.14285714285714285
"[1, 1, 0, 0, 0, 0, 0, 0, 0, 0, 1, 1, 1, 0, 0]",590,370,220,35,15,0.0945945945945946,0.06818181818181818
"[0, 1, 1, 0, 0, 1, 1, 0, 1, 0, 1, 1, 0, 1, 0]",114,66,48,6,3,0.09090909090909091,0.0625
"[0, 1, 0, 0, 0, 0, 1, 1, 0, 0, 1, 1, 0, 1, 0]",168,94,74,9,7,0.09574468085106383,0.0945945945945946
"[0, 1, 0, 1, 0, 0, 0, 1, 0, 0, 0, 0, 1, 0, 0]",496,374,122,37,12,0.09893048128342247,0.09836065573770492
"[1, 0, 0, 1, 0, 1, 0, 0, 0, 1, 0, 0, 0, 0, 1]",280,190,90,17,6,0.08947368421052632,0.06666666666666667
"[1, 0, 0, 0, 0, 0, 1, 1, 1, 0, 0, 1, 0, 1, 1]",129,61,68,7,8,0.11475409836065574,0.11764705882352941
"[0, 1, 1, 1, 1, 1, 1, 0, 1, 1, 0, 0, 1, 1, 0]",356,156,200,9,17,0.057692307692307696,0.085
"[1, 0, 0, 0, 0, 1, 0, 0, 1, 0, 0, 1, 1, 1, 1]",204,97,107,9,8,0.09278350515463918,0.07476635514018691
"[1, 0, 1, 0, 0, 1, 1, 1, 0, 1, 1, 1, 0, 1, 0]",118,55,63,7,8,0.12727272727272726,0.12698412698412698
"[1, 0, 1, 0, 0, 0, 1, 1, 1, 1, 0, 0, 0, 0, 1]",250,128,122,10,16,0.078125,0.13114754098360656
"[0, 0, 1, 0, 0, 0, 1, 1, 1, 0, 0, 1, 0, 0, 1]",157,97,60,10,2,0.10309278350515463,0.03333333333333333
"[1, 0, 0, 0, 0, 1, 0, 0, 0, 1, 1, 1, 0, 0, 1]",163,79,84,11,6,0.13924050632911392,0.07142857142857142
"[0, 1, 1, 1, 1, 0, 0, 0, 1, 1, 0, 1, 0, 0, 1]",110,62,48,9,5,0.14516129032258066,0.10416666666666667
"[1, 1, 1, 1, 1, 0, 0, 0, 1, 0, 1, 0, 1, 1, 1]",353,101,252,16,22,0.15841584158415842,0.0873015873015873
"[1, 1, 1, 1, 1, 1, 0, 0, 0, 1, 0, 1, 0, 1, 1]",346,106,240,8,15,0.07547169811320754,0.0625
"[1, 1, 1, 0, 1, 0, 1, 1, 1, 1, 0, 1, 1, 0, 1]",471,123,348,15,37,0.12195121951219512,0.10632183908045977
"[1, 0, 0, 1, 1, 1, 0, 0, 1, 1, 0, 0, 1, 1, 0]",297,126,171,10,21,0.07936507936507936,0.12280701754385964
"[0, 1, 1, 1, 1, 1, 1, 1, 0, 0, 1, 1, 1, 0, 0]",365,154,211,10,21,0.06493506493506493,0.0995260663507109
"[1, 1, 1, 1, 0, 1, 0, 1, 1, 0, 1, 0, 0, 1, 0]",125,55,70,8,4,0.14545454545454545,0.05714285714285714
"[0, 1, 1, 1, 1, 1, 0, 0, 1, 0, 1, 1, 1, 1, 1]",666,224,442,21,43,0.09375,0.09728506787330317
"[0, 1, 0, 1, 0, 1, 1, 0, 1, 1, 1, 0, 0, 1, 0]",129,62,67,6,5,0.0967741935483871,0.07462686567164178
"[1, 1, 1, 1, 1, 0, 0, 0, 0, 0, 0, 0, 0, 1, 0]",467,153,314,13,28,0.08496732026143791,0.08917197452229299
"[1, 0, 0, 1, 0, 0, 1, 1, 1, 1, 1, 1, 0, 0, 1]",342,135,207,7,18,0.05185185185185185,0.08695652173913043
"[0, 1, 0, 0, 0, 0, 1, 0, 1, 1, 0, 1, 1, 0, 0]",145,87,58,8,2,0.09195402298850575,0.034482758620689655
"[0, 0, 1, 0, 0, 0, 0, 1, 0, 1, 1, 0, 1, 1, 0]",134,84,50,6,4,0.07142857142857142,0.08
"[0, 0, 0, 1, 0, 0, 0, 0, 1, 0, 1, 1, 0, 1, 1]",160,102,58,9,5,0.08823529411764706,0.08620689655172414
"[0, 1, 0, 0, 1, 0, 1, 0, 0, 0, 0, 1, 0, 0, 0]",475,351,124,33,13,0.09401709401709402,0.10483870967741936
"[1, 0, 0, 1, 0, 1, 0, 0, 1, 0, 0, 1, 0, 1, 0]",137,78,59,8,3,0.10256410256410256,0.05084745762711865
"[1, 0, 1, 1, 0, 0, 1, 1, 1, 1, 0, 1, 0, 1, 1]",253,99,154,9,16,0.09090909090909091,0.1038961038961039
"[0, 1, 0, 1, 1, 0, 0, 1, 1, 1, 1, 0, 1, 0, 1]",160,75,85,8,8,0.10666666666666667,0.09411764705882353
"[0, 1, 1, 0, 1, 1, 1, 1, 1, 1, 1, 1, 0, 1, 0]",531,157,374,20,36,0.12738853503184713,0.0962566844919786
"[0, 0, 0, 1, 1, 0, 0, 0, 0, 0, 0, 0, 1, 0, 1]",952,755,197,65,23,0.08609271523178808,0.116751269035533
"[1, 0, 1, 0, 1, 0, 0, 0, 0, 0, 0, 0, 1, 1, 0]",361,227,134,18,12,0.07929515418502203,0.08955223880597014
"[0, 0, 1, 1, 0, 0, 0, 0, 0, 0, 1, 1, 1, 0, 1]",434,251,183,17,19,0.06772908366533864,0.10382513661202186
"[0, 1, 0, 1, 0, 0, 1, 0, 1, 0, 0, 0, 0, 1, 0]",177,114,63,9,8,0.07894736842105263,0.12698412698412698
"[0, 0, 1, 0, 0, 0, 1, 1, 0, 1, 1, 0, 1, 1, 0]",93,44,49,3,4,0.06818181818181818,0.08163265306122448
"[1, 0, 0, 0, 1, 0, 0, 1, 0, 0, 1, 0, 0, 1, 0]",213,128,85,23,8,0.1796875,0.09411764705882353
"[0, 1, 0, 1, 0, 1, 0, 0, 1, 0, 0, 0, 1, 1, 0]",155,99,56,15,7,0.15151515151515152,0.125
"[0, 0, 0, 0, 0, 1, 0, 1, 0, 1, 0, 0, 1, 0, 0]",498,359,139,29,13,0.0807799442896936,0.09352517985611511
"[1, 1, 0, 0, 0, 1, 0, 1, 0, 0, 0, 1, 1, 1, 1]",194,81,113,4,9,0.04938271604938271,0.07964601769911504
"[0, 0, 0, 1, 0, 1, 1, 1, 0, 1, 0, 0, 0, 0, 0]",301,184,117,19,8,0.10326086956521739,0.06837606837606838
"[0, 0, 0, 1, 0, 1, 1, 0, 1, 1, 0, 1, 0, 0, 0]",153,82,71,6,6,0.07317073170731707,0.08450704225352113
"[1, 1, 1, 0, 1, 1, 1, 0, 0, 1, 1, 0, 1, 1, 0]",254,89,165,7,17,0.07865168539325842,0.10303030303030303
"[0, 0, 1, 1, 1, 1, 1, 0, 1, 1, 0, 1, 1, 1, 0]",267,107,160,10,21,0.09345794392523364,0.13125
"[1, 1, 1, 0, 1, 1, 0, 1, 0, 1, 1, 1, 0, 1, 0]",218,62,156,7,11,0.11290322580645161,0.07051282051282051
"[1, 0, 0, 1, 1, 0, 1, 1, 1, 1, 0, 1, 1, 1, 1]",671,183,488,16,48,0.08743169398907104,0.09836065573770492
"[0, 0, 1, 1, 1, 1, 1, 1, 0, 0, 0, 0, 0, 0, 1]",1694,930,764,91,70,0.0978494623655914,0.09162303664921466
"[1, 1, 1, 0, 0, 1, 0, 0, 1, 1, 1, 1, 1, 1, 0]",377,139,238,13,18,0.09352517985611511,0.07563025210084033
"[1, 0, 0, 0, 1, 0, 1, 0, 0, 0, 0, 1, 1, 1, 1]",219,111,108,13,11,0.11711711711711711,0.10185185185185185
"[0, 0, 0, 0, 0, 1, 0, 1, 0, 1, 0, 0, 0, 1, 0]",523,383,140,31,22,0.08093994778067885,0.15714285714285714
"[0, 0, 0, 0, 0, 0, 0, 1, 0, 1, 0, 1, 1, 0, 1]",282,206,76,21,4,0.10194174757281553,0.05263157894736842
"[0, 1, 0, 0, 1, 0, 0, 0, 1, 0, 0, 0, 0, 1, 1]",325,215,110,25,14,0.11627906976744186,0.12727272727272726
"[0, 1, 0, 0, 1, 0, 1, 0, 1, 0, 0, 1, 0, 0, 0]",238,143,95,13,11,0.09090909090909091,0.11578947368421053
"[1, 0, 1, 0, 0, 0, 1, 1, 1, 1, 1, 0, 0, 0, 0]",205,115,90,10,11,0.08695652173913043,0.12222222222222222
"[1, 0, 1, 0, 0, 1, 1, 0, 1, 1, 0, 1, 0, 1, 1]",149,56,93,2,14,0.03571428571428571,0.15053763440860216
"[1, 0, 1, 0, 1, 0, 0, 0, 0, 0, 1, 0, 0, 1, 0]",226,138,88,12,8,0.08695652173913043,0.09090909090909091
"[0, 0, 1, 1, 0, 1, 0, 0, 0, 1, 1, 1, 1, 0, 0]",188,107,81,8,12,0.07476635514018691,0.14814814814814814
"[0, 0, 0, 1, 0, 1, 1, 1, 0, 0, 0, 0, 1, 1, 1]",294,170,124,19,15,0.11176470588235295,0.12096774193548387
"[1, 0, 1, 0, 1, 1, 1, 0, 0, 0, 1, 0, 0, 1, 0]",102,46,56,3,3,0.06521739130434782,0.05357142857142857
"[0, 0, 1, 0, 1, 0, 1, 1, 1, 0, 0, 0, 1, 0, 0]",140,86,54,11,5,0.12790697674418605,0.09259259259259259
"[0, 0, 1, 0, 1, 0, 0, 0, 0, 1, 1, 1, 0, 1, 0]",155,89,66,4,4,0.0449438202247191,0.06060606060606061
"[0, 1, 0, 1, 1, 1, 1, 0, 0, 0, 0, 0, 1, 1, 1]",216,104,112,3,23,0.028846153846153848,0.20535714285714285
"[1, 0, 0, 0, 0, 1, 1, 0, 0, 1, 0, 1, 1, 1, 1]",284,81,203,7,16,0.08641975308641975,0.07881773399014778
"[0, 0, 0, 1, 0, 0, 0, 0, 0, 1, 0, 0, 1, 1, 1]",478,352,126,45,12,0.1278409090909091,0.09523809523809523
"[0, 0, 0, 0, 1, 0, 0, 0, 0, 0, 1, 0, 0, 1, 1]",837,611,226,66,27,0.10801963993453355,0.11946902654867257
"[0, 1, 1, 1, 0, 1, 0, 0, 1, 1, 0, 0, 0, 0, 1]",198,91,107,9,11,0.0989010989010989,0.102803738317757
"[1, 1, 0, 1, 0, 1, 1, 0, 1, 1, 0, 0, 0, 1, 1]",173,73,100,5,11,0.0684931506849315,0.11
"[0, 0, 1, 1, 0, 1, 1, 0, 0, 1, 1, 0, 1, 1, 1]",184,83,101,7,6,0.08433734939759036,0.0594059405940594
"[1, 0, 0, 1, 1, 0, 1, 1, 0, 0, 1, 1, 0, 1, 1]",157,56,101,3,9,0.05357142857142857,0.0891089108910891
"[1, 1, 0, 0, 1, 1, 0, 1, 1, 0, 0, 1, 1, 0, 1]",166,68,98,6,3,0.08823529411764706,0.030612244897959183
"[0, 0, 1, 1, 1, 0, 0, 0, 1, 0, 1, 1, 1, 1, 1]",244,103,141,11,11,0.10679611650485436,0.07801418439716312
"[0, 1, 1, 1, 1, 1, 1, 1, 0, 0, 0, 1, 0, 1, 1]",328,131,197,12,19,0.0916030534351145,0.09644670050761421
"[0, 0, 1, 1, 1, 1, 1, 1, 1, 0, 0, 0, 1, 0, 1]",224,96,128,8,15,0.08333333333333333,0.1171875
"[1, 1, 1, 0, 0, 1, 1, 0, 1, 1, 1, 1, 1, 1, 0]",666,178,488,16,48,0.0898876404494382,0.09836065573770492
"[0, 0, 0, 0, 0, 1, 0, 1, 1, 0, 0, 0, 0, 1, 0]",557,390,167,26,12,0.06666666666666667,0.0718562874251497
"[1, 1, 1, 1, 0, 1, 0, 0, 0, 1, 1, 1, 1, 0, 1]",263,90,173,10,15,0.1111111111111111,0.08670520231213873
"[0, 0, 1, 1, 0, 0, 0, 0, 1, 1, 1, 1, 0, 1, 1]",452,201,251,22,22,0.10945273631840796,0.08764940239043825
"[0, 1, 0, 1, 1, 0, 1, 1, 0, 0, 0, 0, 1, 0, 1]",112,71,41,9,5,0.1267605633802817,0.12195121951219512
"[1, 1, 0, 0, 1, 0, 0, 1, 0, 1, 0, 0, 1, 0, 1]",113,66,47,5,4,0.07575757575757576,0.0851063829787234
"[1, 1, 0, 1, 1, 0, 1, 0, 1, 1, 1, 0, 1, 1, 0]",230,77,153,11,9,0.14285714285714285,0.058823529411764705
"[1, 0, 0, 0, 0, 0, 1, 1, 0, 0, 0, 0, 1, 1, 0]",806,493,313,40,33,0.08113590263691683,0.10543130990415335
"[1, 1, 1, 1, 0, 0, 0, 1, 1, 1, 0, 1, 1, 0, 0]",188,74,114,9,11,0.12162162162162163,0.09649122807017543
"[1, 1, 0, 1, 0, 0, 0, 0, 0, 1, 1, 0, 0, 0, 0]",478,284,194,26,23,0.09154929577464789,0.11855670103092783
"[0, 1, 1, 1, 1, 1, 1, 1, 0, 1, 0, 0, 0, 0, 0]",219,126,93,13,12,0.10317460317460317,0.12903225806451613
"[0, 0, 0, 0, 0, 0, 1, 0, 1, 0, 0, 0, 1, 1, 1]",648,464,184,42,22,0.09051724137931035,0.11956521739130435
"[1, 1, 0, 0, 1, 1, 1, 1, 1, 1, 1, 1, 0, 1, 0]",943,276,667,28,65,0.10144927536231885,0.09745127436281859
"[0, 0, 1, 1, 1, 1, 1, 1, 0, 0, 0, 1, 0, 0, 0]",227,144,83,12,8,0.08333333333333333,0.0963855421686747
"[1, 1, 0, 0, 0, 1, 0, 0, 1, 0, 0, 1, 1, 1, 1]",193,84,109,4,8,0.047619047619047616,0.07339449541284404
"[1, 0, 0, 1, 1, 1, 0, 1, 0, 0, 0, 1, 0, 0, 0]",157,80,77,7,4,0.0875,0.05194805194805195
"[1, 1, 0, 1, 1, 1, 1, 0, 0, 0, 0, 1, 1, 1, 1]",901,320,581,25,62,0.078125,0.10671256454388985
"[1, 1, 0, 0, 0, 1, 0, 0, 1, 0, 0, 1, 1, 0, 1]",136,75,61,7,6,0.09333333333333334,0.09836065573770492
"[1, 1, 0, 1, 0, 0, 0, 1, 1, 0, 1, 1, 1, 0, 1]",132,58,74,7,7,0.1206896551724138,0.0945945945945946
"[1, 0, 1, 0, 0, 1, 0, 1, 0, 1, 0, 1, 1, 1, 1]",167,72,95,12,3,0.16666666666666666,0.031578947368421054
"[1, 1, 0, 0, 1, 0, 0, 0, 0, 1, 1, 0, 0, 0, 1]",196,107,89,10,5,0.09345794392523364,0.056179775280898875
"[1, 0, 0, 0, 0, 1, 1, 1, 0, 1, 0, 1, 0, 0, 1]",99,50,49,7,11,0.14,0.22448979591836735
"[0, 1, 0, 0, 1, 0, 1, 0, 0, 0, 0, 1, 0, 1, 1]",144,74,70,5,5,0.06756756756756757,0.07142857142857142
"[1, 0, 0, 1, 0, 1, 1, 1, 0, 0, 0, 1, 1, 1, 1]",208,75,133,5,8,0.06666666666666667,0.06015037593984962
"[1, 0, 1, 0, 0, 1, 0, 1, 1, 1, 0, 0, 0, 1, 1]",117,52,65,5,8,0.09615384615384616,0.12307692307692308
"[1, 1, 0, 1, 1, 0, 0, 0, 0, 0, 1, 1, 1, 1, 1]",339,138,201,8,21,0.057971014492753624,0.1044776119402985
"[0, 1, 1, 1, 1, 1, 1, 0, 0, 0, 0, 0, 1, 1, 0]",266,176,90,20,12,0.11363636363636363,0.13333333333333333
"[1, 1, 0, 1, 1, 0, 0, 1, 0, 0, 1, 0, 1, 0, 1]",112,46,66,4,6,0.08695652173913043,0.09090909090909091
"[1, 0, 0, 1, 0, 1, 0, 1, 1, 1, 0, 1, 1, 0, 0]",122,51,71,3,7,0.058823529411764705,0.09859154929577464
"[1, 1, 0, 0, 1, 0, 1, 0, 1, 1, 1, 0, 1, 1, 0]",149,46,103,5,10,0.10869565217391304,0.0970873786407767
"[0, 0, 1, 0, 0, 1, 1, 1, 1, 1, 0, 0, 1, 0, 0]",102,56,46,9,6,0.16071428571428573,0.13043478260869565
"[1, 1, 0, 1, 0, 0, 1, 0, 1, 0, 1, 0, 0, 0, 1]",121,67,54,5,6,0.07462686567164178,0.1111111111111111
"[0, 1, 1, 1, 1, 0, 1, 1, 1, 1, 0, 1, 0, 1, 0]",221,77,144,12,14,0.15584415584415584,0.09722222222222222
"[0, 1, 1, 1, 0, 0, 1, 1, 0, 0, 0, 1, 1, 0, 1]",120,57,63,2,5,0.03508771929824561,0.07936507936507936
"[0, 1, 1, 0, 0, 0, 0, 1, 1, 1, 1, 1, 1, 0, 1]",443,303,140,21,20,0.06930693069306931,0.14285714285714285
"[0, 0, 1, 0, 1, 0, 0, 1, 1, 1, 0, 1, 1, 0, 1]",90,43,47,5,4,0.11627906976744186,0.0851063829787234
"[0, 0, 0, 1, 1, 0, 1, 0, 1, 0, 0, 1, 1, 0, 0]",239,143,96,9,8,0.06293706293706294,0.08333333333333333
"[1, 0, 0, 1, 0, 0, 1, 0, 0, 1, 1, 0, 1, 1, 0]",120,55,65,5,8,0.09090909090909091,0.12307692307692308
"[0, 1, 1, 0, 0, 1, 1, 0, 0, 0, 1, 1, 0, 0, 0]",283,199,84,18,9,0.09045226130653267,0.10714285714285714
"[0, 0, 1, 1, 0, 1, 1, 0, 1, 0, 0, 0, 0, 0, 1]",159,95,64,7,6,0.07368421052631578,0.09375
"[1, 0, 0, 0, 0, 1, 1, 1, 1, 0, 0, 0, 0, 1, 1]",1696,360,1336,34,125,0.09444444444444444,0.09356287425149701
"[1, 1, 1, 0, 1, 0, 1, 0, 0, 1, 1, 0, 0, 0, 0]",202,92,110,9,17,0.09782608695652174,0.15454545454545454
"[1, 0, 0, 0, 1, 0, 0, 0, 0, 0, 0, 0, 1, 0, 1]",549,379,170,27,17,0.0712401055408971,0.1
"[1, 1, 0, 0, 0, 1, 0, 0, 0, 0, 0, 0, 0, 1, 0]",509,343,166,39,16,0.11370262390670553,0.0963855421686747
"[1, 1, 0, 1, 1, 0, 0, 0, 1, 0, 0, 0, 0, 0, 0]",304,192,112,24,7,0.125,0.0625
"[0, 0, 0, 0, 0, 1, 0, 0, 0, 1, 1, 0, 0, 1, 0]",523,356,167,37,21,0.10393258426966293,0.12574850299401197
"[1, 0, 0, 1, 1, 1, 1, 0, 1, 0, 1, 0, 1, 0, 0]",146,57,89,5,8,0.08771929824561403,0.0898876404494382
"[0, 1, 0, 1, 0, 1, 0, 0, 1, 1, 0, 0, 0, 0, 0]",408,266,142,38,13,0.14285714285714285,0.09154929577464789
"[0, 0, 1, 0, 0, 1, 1, 1, 1, 1, 0, 0, 0, 1, 0]",127,70,57,10,4,0.14285714285714285,0.07017543859649122
"[0, 0, 1, 1, 1, 1, 1, 0, 1, 1, 0, 1, 1, 0, 0]",189,77,112,5,12,0.06493506493506493,0.10714285714285714
"[0, 1, 0, 0, 0, 1, 1, 1, 1, 1, 0, 1, 1, 0, 1]",155,65,90,5,10,0.07692307692307693,0.1111111111111111
"[1, 0, 1, 0, 1, 1, 0, 1, 0, 0, 0, 1, 1, 1, 1]",174,68,106,10,4,0.14705882352941177,0.03773584905660377
"[0, 0, 0, 1, 1, 1, 1, 1, 1, 0, 0, 0, 1, 1, 1]",622,434,188,47,23,0.10829493087557604,0.12234042553191489
"[0, 0, 1, 0, 1, 1, 1, 0, 1, 1, 1, 1, 1, 0, 0]",207,85,122,10,8,0.11764705882352941,0.06557377049180328
"[0, 0, 0, 1, 0, 1, 1, 0, 1, 1, 0, 0, 1, 1, 0]",129,71,58,7,2,0.09859154929577464,0.034482758620689655
"[1, 1, 1, 0, 1, 0, 0, 0, 0, 1, 1, 1, 0, 1, 1]",162,68,94,6,18,0.08823529411764706,0.19148936170212766
"[0, 0, 1, 1, 1, 0, 0, 0, 1, 0, 1, 0, 0, 0, 0]",278,178,100,13,11,0.07303370786516854,0.11
"[1, 0, 1, 1, 0, 1, 1, 0, 0, 1, 0, 0, 0, 1, 1]",131,59,72,3,5,0.05084745762711865,0.06944444444444445
"[1, 1, 1, 0, 1, 1, 0, 0, 1, 0, 1, 1, 1, 0, 0]",133,55,78,8,8,0.14545454545454545,0.10256410256410256
"[1, 0, 0, 0, 0, 0, 0, 0, 1, 1, 0, 1, 0, 0, 0]",628,435,193,43,18,0.09885057471264368,0.09326424870466321
"[0, 0, 1, 1, 1, 1, 0, 1, 0, 1, 1, 1, 0, 1, 0]",154,76,78,6,5,0.07894736842105263,0.0641025641025641
"[1, 0, 0, 1, 1, 1, 1, 0, 1, 0, 1, 1, 1, 0, 1]",261,74,187,8,13,0.10810810810810811,0.06951871657754011
"[1, 1, 1, 1, 1, 0, 0, 1, 0, 1, 1, 1, 0, 1, 0]",245,87,158,11,11,0.12643678160919541,0.06962025316455696
"[1, 0, 0, 1, 1, 1, 0, 0, 0, 0, 1, 0, 1, 1, 0]",131,69,62,5,6,0.07246376811594203,0.0967741935483871
"[0, 0, 0, 1, 1, 1, 0, 1, 0, 1, 0, 1, 1, 1, 0]",110,53,57,4,6,0.07547169811320754,0.10526315789473684
"[1, 1, 1, 1, 0, 1, 0, 0, 1, 0, 0, 0, 0, 0, 1]",133,76,57,4,6,0.05263157894736842,0.10526315789473684
"[0, 0, 1, 1, 0, 0, 1, 0, 0, 1, 0, 0, 0, 0, 1]",306,193,113,16,10,0.08290155440414508,0.08849557522123894
"[1, 0, 0, 1, 1, 0, 1, 0, 1, 1, 1, 0, 1, 0, 1]",153,63,90,9,7,0.14285714285714285,0.07777777777777778
"[1, 1, 0, 0, 1, 1, 0, 1, 1, 0, 1, 1, 1, 0, 0]",179,68,111,7,5,0.10294117647058823,0.04504504504504504
"[1, 1, 1, 0, 0, 0, 1, 1, 0, 0, 1, 0, 1, 0, 0]",118,62,56,6,7,0.0967741935483871,0.125
"[0, 0, 1, 1, 0, 0, 0, 0, 1, 0, 0, 0, 1, 1, 0]",325,206,119,20,7,0.0970873786407767,0.058823529411764705
"[0, 1, 0, 1, 0, 0, 0, 1, 0, 0, 1, 0, 0, 0, 0]",516,335,181,37,17,0.11044776119402985,0.09392265193370165
"[0, 0, 0, 0, 1, 0, 1, 0, 0, 0, 1, 0, 0, 1, 0]",477,319,158,35,11,0.109717868338558,0.06962025316455696
"[1, 0, 0, 0, 0, 0, 1, 0, 1, 0, 0, 0, 0, 1, 0]",530,356,174,35,17,0.09831460674157304,0.09770114942528736
"[1, 0, 1, 0, 1, 0, 0, 1, 0, 1, 0, 1, 1, 0, 0]",133,75,58,7,3,0.09333333333333334,0.05172413793103448
"[0, 0, 0, 0, 0, 1, 0, 1, 0, 1, 0, 0, 1, 0, 1]",257,163,94,14,9,0.08588957055214724,0.09574468085106383
"[0, 1, 0, 1, 0, 0, 1, 1, 0, 0, 1, 1, 1, 1, 1]",332,153,179,12,19,0.0784313725490196,0.10614525139664804
"[1, 1, 0, 1, 0, 1, 0, 0, 1, 1, 0, 0, 1, 1, 1]",265,117,148,11,16,0.09401709401709402,0.10810810810810811
"[1, 1, 1, 1, 1, 1, 0, 1, 0, 1, 0, 0, 1, 1, 0]",303,111,192,13,28,0.11711711711711711,0.14583333333333334
"[0, 0, 1, 0, 0, 0, 0, 1, 0, 0, 1, 1, 0, 0, 0]",695,501,194,54,15,0.10778443113772455,0.07731958762886598
"[1, 1, 0, 0, 0, 0, 1, 0, 0, 0, 0, 1, 1, 1, 1]",320,179,141,23,22,0.12849162011173185,0.15602836879432624
"[1, 0, 0, 1, 0, 0, 1, 0, 1, 1, 0, 0, 1, 0, 0]",130,74,56,6,8,0.08108108108108109,0.14285714285714285
"[1, 0, 1, 1, 1, 0, 1, 1, 0, 1, 1, 1, 1, 0, 0]",300,105,195,10,12,0.09523809523809523,0.06153846153846154
"[1, 1, 0, 0, 1, 0, 0, 1, 1, 1, 1, 1, 1, 1, 1]",1122,357,765,32,71,0.0896358543417367,0.09281045751633987
"[1, 0, 0, 0, 1, 1, 0, 1, 1, 1, 1, 1, 0, 1, 1]",264,100,164,11,17,0.11,0.10365853658536585
"[1, 1, 0, 0, 0, 0, 0, 0, 1, 0, 1, 0, 0, 0, 1]",300,190,110,22,14,0.11578947368421053,0.12727272727272726
"[0, 0, 0, 0, 1, 0, 0, 0, 0, 1, 1, 0, 1, 1, 1]",245,146,99,10,10,0.0684931506849315,0.10101010101010101
"[0, 0, 1, 0, 1, 1, 1, 1, 1, 1, 0, 1, 0, 1, 0]",132,57,75,1,13,0.017543859649122806,0.17333333333333334
"[0, 1, 0, 1, 1, 1, 0, 1, 1, 1, 1, 0, 1, 0, 0]",138,55,83,4,9,0.07272727272727272,0.10843373493975904
"[0, 1, 0, 1, 1, 1, 1, 0, 1, 0, 1, 1, 1, 0, 1]",206,73,133,11,7,0.1506849315068493,0.05263157894736842
"[1, 0, 1, 0, 1, 1, 1, 1, 0, 1, 0, 1, 1, 1, 0]",240,88,152,8,16,0.09090909090909091,0.10526315789473684
"[0, 0, 1, 0, 1, 0, 1, 1, 0, 1, 0, 1, 1, 0, 0]",104,53,51,5,5,0.09433962264150944,0.09803921568627451
"[1, 1, 0, 0, 0, 0, 1, 1, 1, 0, 1, 0, 1, 1, 1]",332,153,179,15,13,0.09803921568627451,0.07262569832402235
"[1, 0, 1, 1, 1, 1, 0, 0, 0, 0, 1, 1, 1, 0, 1]",180,74,106,9,12,0.12162162162162163,0.11320754716981132
"[0, 0, 0, 1, 1, 1, 0, 0, 0, 0, 0, 1, 0, 1, 1]",186,125,61,5,3,0.04,0.04918032786885246
"[0, 0, 1, 0, 1, 1, 0, 0, 1, 0, 1, 0, 1, 0, 0]",138,80,58,8,6,0.1,0.10344827586206896
"[1, 1, 1, 1, 1, 1, 1, 1, 0, 0, 0, 1, 1, 1, 0]",871,261,610,25,72,0.09578544061302682,0.1180327868852459
"[0, 1, 0, 1, 1, 0, 0, 1, 1, 0, 0, 0, 0, 1, 0]",164,92,72,10,9,0.10869565217391304,0.125
"[0, 1, 0, 1, 0, 0, 0, 1, 0, 0, 0, 1, 0, 1, 1]",151,85,66,7,9,0.08235294117647059,0.13636363636363635
"[0, 0, 0, 0, 0, 1, 1, 1, 1, 0, 0, 1, 1, 1, 0]",359,260,99,24,9,0.09230769230769231,0.09090909090909091
"[0, 1, 0, 0, 1, 0, 0, 0, 1, 1, 1, 1, 0, 0, 0]",275,157,118,15,14,0.09554140127388536,0.11864406779661017
"[1, 1, 0, 0, 0, 1, 1, 0, 0, 1, 0, 0, 1, 0, 1]",127,80,47,7,7,0.0875,0.14893617021276595
"[1, 1, 1, 1, 0, 0, 0, 0, 1, 0, 1, 1, 1, 0, 0]",173,75,98,1,7,0.013333333333333334,0.07142857142857142
"[1, 1, 0, 1, 1, 1, 0, 1, 1, 0, 0, 1, 1, 1, 0]",232,82,150,10,16,0.12195121951219512,0.10666666666666667
"[1, 0, 1, 1, 1, 0, 0, 0, 1, 0, 0, 0, 0, 0, 0]",301,187,114,18,11,0.0962566844919786,0.09649122807017543
"[1, 1, 0, 0, 0, 0, 0, 1, 1, 1, 0, 0, 1, 0, 1]",147,79,68,10,5,0.12658227848101267,0.07352941176470588
"[0, 0, 1, 0, 1, 0, 1, 1, 0, 1, 1, 0, 0, 1, 1]",169,83,86,7,6,0.08433734939759036,0.06976744186046512
"[0, 1, 0, 1, 1, 0, 0, 0, 0, 1, 1, 0, 1, 1, 1]",148,72,76,7,10,0.09722222222222222,0.13157894736842105
"[1, 0, 1, 0, 1, 0, 1, 1, 0, 0, 0, 0, 1, 1, 0]",180,98,82,5,9,0.05102040816326531,0.10975609756097561
"[1, 0, 0, 0, 0, 1, 1, 0, 1, 0, 1, 0, 1, 1, 0]",122,55,67,5,7,0.09090909090909091,0.1044776119402985
"[1, 1, 0, 0, 0, 0, 1, 1, 0, 1, 0, 1, 0, 1, 1]",191,92,99,2,6,0.021739130434782608,0.06060606060606061
"[0, 1, 0, 0, 1, 1, 1, 0, 0, 0, 0, 1, 1, 0, 1]",149,75,74,6,5,0.08,0.06756756756756757
"[1, 0, 1, 0, 1, 0, 0, 1, 1, 1, 0, 0, 0, 0, 1]",156,87,69,11,5,0.12643678160919541,0.07246376811594203
"[1, 0, 0, 1, 1, 1, 1, 1, 1, 0, 1, 1, 0, 0, 1]",395,101,294,9,21,0.0891089108910891,0.07142857142857142
"[0, 0, 0, 1, 0, 0, 1, 1, 1, 1, 0, 1, 1, 1, 0]",126,61,65,3,7,0.04918032786885246,0.1076923076923077
"[0, 1, 0, 1, 1, 1, 1, 1, 1, 1, 0, 1, 1, 1, 0]",525,164,361,19,41,0.11585365853658537,0.11357340720221606
"[1, 1, 0, 0, 1, 0, 1, 1, 1, 1, 1, 1, 1, 0, 1]",482,148,334,14,35,0.0945945945945946,0.10479041916167664
"[0, 0, 1, 1, 1, 1, 1, 0, 1, 1, 1, 0, 0, 1, 0]",157,67,90,4,10,0.05970149253731343,0.1111111111111111
"[1, 1, 0, 0, 0, 0, 1, 0, 1, 1, 1, 0, 0, 0, 0]",244,132,112,8,9,0.06060606060606061,0.08035714285714286
"[1, 1, 0, 0, 0, 0, 0, 0, 1, 1, 1, 0, 1, 0, 1]",234,119,115,10,14,0.08403361344537816,0.12173913043478261
"[1, 0, 1, 1, 0, 1, 1, 1, 0, 0, 1, 0, 1, 1, 0]",161,55,106,5,12,0.09090909090909091,0.11320754716981132
"[0, 1, 1, 1, 0, 1, 1, 0, 1, 1, 0, 1, 1, 1, 0]",234,84,150,10,13,0.11904761904761904,0.08666666666666667
"[0, 1, 1, 0, 1, 1, 1, 0, 1, 0, 0, 0, 1, 1, 1]",182,83,99,2,16,0.024096385542168676,0.16161616161616163
"[0, 0, 0, 1, 1, 1, 0, 0, 0, 0, 0, 0, 0, 1, 0]",642,473,169,42,9,0.08879492600422834,0.05325443786982249
"[1, 0, 0, 1, 0, 1, 0, 1, 0, 1, 1, 1, 1, 1, 1]",323,102,221,8,20,0.0784313725490196,0.09049773755656108
"[0, 0, 1, 1, 1, 1, 0, 1, 1, 0, 0, 1, 0, 1, 1]",178,73,105,5,13,0.0684931506849315,0.12380952380952381
"[0, 0, 1, 0, 1, 0, 0, 1, 0, 0, 0, 1, 1, 0, 0]",276,171,105,13,11,0.07602339181286549,0.10476190476190476
"[0, 0, 0, 0, 1, 0, 1, 0, 0, 1, 0, 0, 0, 1, 1]",311,202,109,25,12,0.12376237623762376,0.11009174311926606
"[1, 1, 0, 0, 0, 0, 0, 1, 0, 0, 0, 0, 0, 0, 1]",747,513,234,59,26,0.11500974658869395,0.1111111111111111
"[0, 0, 0, 0, 0, 1, 0, 0, 1, 1, 0, 1, 0, 0, 1]",264,181,83,16,7,0.08839779005524862,0.08433734939759036
"[0, 1, 1, 0, 1, 0, 1, 1, 0, 0, 1, 1, 0, 0, 1]",178,88,90,10,9,0.11363636363636363,0.1
"[0, 0, 1, 1, 0, 1, 1, 1, 1, 1, 1, 0, 1, 0, 0]",168,68,100,7,7,0.10294117647058823,0.07
"[0, 1, 1, 0, 1, 0, 1, 0, 1, 0, 1, 0, 0, 1, 1]",123,54,69,2,9,0.037037037037037035,0.13043478260869565
"[0, 0, 1, 0, 0, 0, 1, 0, 1, 1, 0, 0, 0, 1, 1]",177,100,77,8,7,0.08,0.09090909090909091
"[1, 1, 0, 0, 1, 0, 0, 1, 0, 1, 0, 0, 0, 0, 1]",157,87,70,5,6,0.05747126436781609,0.08571428571428572
"[0, 1, 1, 1, 0, 1, 0, 0, 0, 0, 0, 0, 1, 1, 1]",241,142,99,17,7,0.11971830985915492,0.0707070707070707
"[0, 0, 0, 1, 1, 1, 0, 1, 0, 0, 0, 0, 0, 0, 1]",336,224,112,23,14,0.10267857142857142,0.125
"[0, 0, 1, 1, 1, 0, 1, 0, 1, 1, 0, 1, 0, 1, 1]",168,78,90,7,8,0.08974358974358974,0.08888888888888889
"[1, 1, 0, 0, 1, 1, 1, 0, 1, 0, 1, 1, 0, 1, 0]",159,80,79,5,9,0.0625,0.11392405063291139
"[1, 1, 0, 1, 0, 0, 0, 1, 1, 0, 0, 1, 0, 1, 1]",116,54,62,3,11,0.05555555555555555,0.1774193548387097
"[1, 0, 1, 0, 0, 1, 0, 0, 0, 0, 0, 1, 1, 0, 0]",347,219,128,23,11,0.1050228310502283,0.0859375
"[0, 0, 0, 1, 0, 1, 0, 0, 1, 1, 0, 1, 1, 0, 0]",156,96,60,4,7,0.041666666666666664,0.11666666666666667
"[1, 1, 0, 1, 0, 1, 1, 1, 1, 0, 0, 0, 1, 1, 1]",343,133,210,6,20,0.045112781954887216,0.09523809523809523
"[1, 1, 0, 0, 0, 1, 1, 1, 1, 1, 1, 0, 1, 0, 1]",274,87,187,10,22,0.11494252873563218,0.11764705882352941
"[1, 1, 1, 0, 0, 0, 1, 0, 1, 0, 1, 0, 1, 1, 0]",113,50,63,6,10,0.12,0.15873015873015872
"[1, 0, 0, 1, 1, 1, 0, 0, 1, 0, 0, 1, 1, 1, 0]",145,58,87,4,11,0.06896551724137931,0.12643678160919541
"[1, 1, 0, 1, 1, 0, 0, 0, 0, 1, 1, 0, 1, 0, 0]",122,66,56,5,6,0.07575757575757576,0.10714285714285714
"[1, 1, 0, 1, 1, 1, 1, 1, 0, 1, 1, 1, 0, 0, 0]",277,79,198,11,21,0.13924050632911392,0.10606060606060606
"[0, 0, 1, 1, 0, 1, 0, 1, 1, 1, 0, 0, 0, 1, 1]",149,69,80,5,8,0.07246376811594203,0.1
"[1, 1, 0, 0, 0, 0, 0, 1, 1, 0, 1, 0, 1, 1, 1]",185,88,97,7,14,0.07954545454545454,0.14432989690721648
"[0, 0, 0, 0, 0, 1, 0, 0, 1, 0, 1, 1, 1, 0, 0]",323,213,110,29,9,0.13615023474178403,0.08181818181818182
"[1, 0, 1, 1, 1, 0, 0, 1, 0, 0, 0, 0, 0, 0, 0]",353,211,142,19,15,0.09004739336492891,0.1056338028169014
"[1, 0, 1, 0, 1, 0, 0, 0, 1, 1, 0, 0, 1, 0, 1]",89,52,37,7,4,0.1346153846153846,0.10810810810810811
"[0, 1, 1, 0, 1, 0, 1, 0, 1, 0, 0, 0, 1, 1, 0]",103,52,51,4,2,0.07692307692307693,0.0392156862745098
"[1, 0, 0, 1, 1, 0, 1, 0, 1, 0, 1, 0, 1, 0, 0]",107,49,58,3,6,0.061224489795918366,0.10344827586206896
"[0, 0, 1, 0, 0, 1, 1, 0, 1, 0, 1, 0, 1, 0, 1]",104,49,55,3,5,0.061224489795918366,0.09090909090909091
"[0, 0, 1, 1, 0, 1, 1, 1, 0, 0, 1, 0, 1, 1, 1]",171,71,100,7,15,0.09859154929577464,0.15
"[0, 1, 1, 0, 1, 0, 0, 1, 0, 1, 0, 0, 0, 0, 1]",149,92,57,7,7,0.07608695652173914,0.12280701754385964
"[1, 0, 0, 1, 0, 1, 0, 0, 1, 1, 1, 0, 1, 0, 1]",104,38,66,5,8,0.13157894736842105,0.12121212121212122
"[1, 0, 0, 1, 0, 1, 0, 0, 1, 0, 1, 0, 0, 1, 1]",125,54,71,3,9,0.05555555555555555,0.1267605633802817
"[0, 1, 1, 1, 1, 1, 0, 0, 0, 0, 0, 1, 1, 0, 0]",232,117,115,4,12,0.03418803418803419,0.10434782608695652
"[1, 1, 1, 0, 1, 1, 1, 1, 1, 0, 0, 0, 0, 0, 1]",232,88,144,8,15,0.09090909090909091,0.10416666666666667
"[0, 0, 0, 0, 1, 0, 1, 1, 0, 1, 0, 0, 1, 0, 0]",238,174,64,7,5,0.040229885057471264,0.078125
"[0, 0, 1, 1, 1, 1, 1, 1, 1, 0, 0, 0, 0, 0, 0]",548,280,268,26,23,0.09285714285714286,0.08582089552238806
"[1, 0, 1, 1, 1, 1, 0, 1, 0, 0, 1, 0, 0, 0, 1]",111,55,56,3,9,0.05454545454545454,0.16071428571428573
"[0, 1, 1, 0, 1, 1, 0, 0, 0, 0, 1, 1, 0, 0, 0]",296,177,119,17,11,0.096045197740113,0.09243697478991597
"[1, 0, 0, 0, 1, 0, 1, 0, 1, 1, 0, 0, 0, 1, 1]",129,57,72,3,6,0.05263157894736842,0.08333333333333333
"[0, 0, 1, 1, 1, 0, 0, 1, 1, 0, 0, 0, 1, 0, 0]",166,91,75,8,12,0.08791208791208792,0.16
"[1, 0, 0, 1, 1, 0, 0, 0, 1, 1, 0, 1, 1, 0, 0]",148,76,72,5,4,0.06578947368421052,0.05555555555555555
"[0, 0, 0, 1, 0, 1, 1, 0, 0, 1, 0, 0, 0, 1, 1]",214,133,81,16,6,0.12030075187969924,0.07407407407407407
"[1, 1, 1, 0, 0, 0, 0, 0, 0, 0, 1, 1, 0, 1, 0]",197,107,90,11,9,0.102803738317757,0.1
"[1, 1, 1, 1, 1, 0, 0, 0, 1, 0, 1, 1, 1, 0, 0]",204,67,137,9,11,0.13432835820895522,0.08029197080291971
"[0, 0, 0, 0, 1, 0, 1, 1, 0, 0, 0, 0, 0, 1, 0]",593,412,181,38,12,0.09223300970873786,0.06629834254143646
"[0, 1, 1, 0, 0, 0, 1, 1, 1, 0, 0, 1, 1, 0, 0]",190,104,86,15,6,0.14423076923076922,0.06976744186046512
"[1, 0, 0, 1, 0, 0, 1, 1, 0, 0, 0, 1, 1, 1, 0]",129,68,61,5,4,0.07352941176470588,0.06557377049180328
"[0, 1, 1, 0, 1, 0, 1, 1, 0, 1, 0, 0, 1, 0, 1]",111,55,56,4,3,0.07272727272727272,0.05357142857142857
"[0, 1, 1, 1, 0, 1, 0, 1, 0, 0, 1, 0, 1, 1, 1]",155,68,87,6,13,0.08823529411764706,0.14942528735632185
"[0, 1, 1, 1, 1, 1, 0, 0, 1, 1, 1, 0, 1, 0, 1]",240,109,131,10,17,0.09174311926605505,0.1297709923664122
"[0, 0, 1, 0, 1, 1, 0, 1, 1, 0, 1, 1, 0, 1, 1]",151,61,90,5,10,0.08196721311475409,0.1111111111111111
"[1, 0, 1, 1, 0, 1, 1, 1, 0, 0, 1, 1, 1, 0, 0]",181,83,98,9,7,0.10843373493975904,0.07142857142857142
"[0, 1, 0, 1, 1, 0, 1, 1, 1, 0, 0, 1, 1, 1, 0]",172,80,92,6,6,0.075,0.06521739130434782
"[0, 1, 0, 0, 1, 1, 1, 1, 0, 0, 1, 1, 0, 1, 0]",151,72,79,5,5,0.06944444444444445,0.06329113924050633
"[1, 0, 1, 1, 0, 1, 0, 0, 1, 1, 1, 1, 0, 0, 1]",235,105,130,7,8,0.06666666666666667,0.06153846153846154
"[0, 0, 1, 1, 1, 1, 0, 1, 1, 1, 1, 1, 0, 1, 1]",654,200,454,23,44,0.115,0.09691629955947137
"[1, 1, 1, 0, 1, 1, 1, 0, 1, 1, 0, 1, 0, 1, 0]",202,64,138,6,13,0.09375,0.09420289855072464
"[1, 1, 0, 0, 1, 0, 1, 1, 1, 0, 0, 0, 1, 1, 1]",214,82,132,4,17,0.04878048780487805,0.12878787878787878
"[1, 1, 1, 1, 0, 1, 0, 0, 0, 0, 1, 0, 1, 0, 1]",91,44,47,2,4,0.045454545454545456,0.0851063829787234
"[0, 0, 1, 1, 0, 0, 0, 1, 1, 1, 1, 0, 0, 1, 1]",352,180,172,26,19,0.14444444444444443,0.11046511627906977
"[0, 1, 0, 1, 0, 0, 0, 1, 0, 1, 1, 0, 1, 1, 1]",129,59,70,10,2,0.1694915254237288,0.02857142857142857
"[0, 0, 1, 1, 1, 1, 0, 0, 0, 0, 0, 1, 0, 0, 0]",479,316,163,33,24,0.10443037974683544,0.147239263803681
"[1, 0, 0, 0, 0, 0, 1, 0, 1, 1, 0, 0, 1, 1, 0]",211,114,97,7,10,0.06140350877192982,0.10309278350515463
"[0, 0, 1, 1, 0, 1, 0, 1, 1, 0, 0, 1, 1, 1, 1]",283,133,150,11,11,0.08270676691729323,0.07333333333333333
"[1, 1, 0, 1, 0, 1, 0, 0, 0, 0, 0, 0, 0, 1, 1]",254,160,94,18,9,0.1125,0.09574468085106383
"[0, 1, 0, 0, 1, 0, 0, 1, 1, 1, 0, 0, 1, 0, 0]",131,70,61,4,7,0.05714285714285714,0.11475409836065574
"[1, 1, 0, 1, 1, 1, 0, 1, 0, 0, 1, 1, 1, 1, 1]",686,217,469,14,29,0.06451612903225806,0.06183368869936034
"[0, 1, 0, 1, 1, 1, 0, 1, 1, 0, 1, 1, 0, 1, 1]",249,86,163,9,22,0.10465116279069768,0.13496932515337423
"[1, 1, 0, 0, 0, 1, 0, 1, 0, 0, 0, 0, 0, 0, 1]",311,196,115,19,15,0.09693877551020408,0.13043478260869565
"[0, 0, 1, 0, 0, 0, 0, 1, 0, 1, 1, 1, 1, 0, 1]",101,55,46,8,7,0.14545454545454545,0.15217391304347827
"[0, 0, 0, 1, 0, 0, 0, 0, 1, 0, 1, 1, 1, 1, 0]",176,102,74,6,11,0.058823529411764705,0.14864864864864866
"[0, 0, 0, 0, 1, 0, 0, 0, 0, 1, 0, 1, 1, 1, 1]",259,157,102,18,11,0.11464968152866242,0.10784313725490197
"[1, 0, 1, 1, 1, 0, 1, 1, 1, 1, 0, 0, 1, 1, 0]",353,128,225,9,12,0.0703125,0.05333333333333334
"[0, 1, 0, 1, 1, 1, 0, 1, 1, 1, 1, 0, 0, 1, 1]",356,127,229,16,25,0.12598425196850394,0.1091703056768559
"[0, 0, 1, 0, 1, 1, 1, 0, 1, 1, 1, 1, 0, 0, 1]",177,88,89,13,12,0.14772727272727273,0.1348314606741573
"[1, 0, 0, 1, 0, 1, 1, 0, 0, 0, 1, 0, 1, 1, 1]",126,50,76,5,8,0.1,0.10526315789473684
"[1, 1, 1, 0, 0, 1, 1, 0, 1, 1, 0, 1, 0, 0, 0]",118,53,65,7,5,0.1320754716981132,0.07692307692307693
"[1, 1, 1, 1, 0, 1, 0, 1, 0, 1, 0, 1, 1, 0, 0]",161,74,87,6,6,0.08108108108108109,0.06896551724137931
"[0, 0, 0, 1, 1, 0, 1, 1, 0, 0, 1, 0, 1, 0, 0]",154,94,60,6,7,0.06382978723404255,0.11666666666666667
"[1, 0, 0, 0, 0, 0, 0, 0, 1, 1, 0, 1, 1, 1, 0]",173,91,82,4,6,0.04395604395604396,0.07317073170731707
"[1, 1, 0, 1, 0, 1, 1, 1, 0, 0, 1, 1, 1, 0, 0]",178,76,102,4,15,0.05263157894736842,0.14705882352941177
"[1, 0, 0, 0, 1, 1, 0, 1, 1, 0, 1, 1, 1, 1, 0]",173,67,106,7,15,0.1044776119402985,0.14150943396226415
"[1, 0, 0, 0, 0, 1, 1, 1, 0, 0, 0, 1, 1, 0, 1]",118,55,63,4,5,0.07272727272727272,0.07936507936507936
"[1, 1, 0, 1, 1, 1, 0, 1, 0, 1, 0, 0, 0, 0, 0]",151,80,71,3,11,0.0375,0.15492957746478872
"[0, 1, 1, 0, 1, 1, 1, 0, 1, 0, 1, 0, 0, 0, 0]",143,86,57,6,5,0.06976744186046512,0.08771929824561403
"[0, 1, 1, 1, 1, 0, 0, 0, 0, 0, 1, 0, 1, 1, 1]",300,192,108,18,12,0.09375,0.1111111111111111
"[0, 0, 0, 0, 1, 1, 1, 1, 0, 0, 1, 0, 1, 1, 0]",216,113,103,6,9,0.05309734513274336,0.08737864077669903
"[1, 1, 0, 1, 0, 0, 1, 0, 1, 0, 1, 1, 1, 0, 1]",150,59,91,5,7,0.0847457627118644,0.07692307692307693
"[1, 0, 0, 0, 1, 0, 1, 1, 0, 1, 0, 0, 0, 0, 0]",255,153,102,19,9,0.12418300653594772,0.08823529411764706
"[1, 1, 1, 0, 0, 1, 0, 1, 1, 1, 0, 1, 1, 1, 0]",228,90,138,7,12,0.07777777777777778,0.08695652173913043
"[0, 1, 0, 0, 0, 0, 1, 1, 1, 0, 0, 1, 0, 1, 1]",123,74,49,6,3,0.08108108108108109,0.061224489795918366
"[0, 1, 1, 1, 0, 1, 0, 0, 0, 0, 1, 1, 1, 0, 0]",144,74,70,6,8,0.08108108108108109,0.11428571428571428
"[1, 0, 1, 0, 1, 0, 0, 0, 1, 0, 1, 0, 1, 1, 1]",126,60,66,7,3,0.11666666666666667,0.045454545454545456
"[1, 1, 0, 1, 0, 0, 1, 1, 1, 1, 0, 0, 1, 0, 1]",156,65,91,3,9,0.046153846153846156,0.0989010989010989
"[0, 1, 0, 0, 1, 0, 0, 0, 0, 1, 1, 1, 1, 1, 1]",326,180,146,22,23,0.12222222222222222,0.15753424657534246
"[1, 1, 1, 0, 1, 0, 0, 0, 1, 0, 0, 1, 0, 0, 1]",101,53,48,5,3,0.09433962264150944,0.0625
"[1, 0, 0, 1, 1, 0, 0, 1, 0, 1, 1, 1, 1, 1, 1]",446,105,341,5,36,0.047619047619047616,0.10557184750733138
"[0, 0, 1, 1, 0, 1, 1, 0, 1, 0, 1, 0, 0, 1, 0]",101,48,53,4,2,0.08333333333333333,0.03773584905660377
"[0, 1, 1, 1, 1, 1, 0, 1, 1, 1, 1, 0, 0, 0, 0]",302,127,175,9,21,0.07086614173228346,0.12
"[1, 0, 1, 1, 0, 0, 1, 1, 0, 0, 1, 1, 0, 0, 1]",439,186,253,17,21,0.0913978494623656,0.08300395256916997
"[0, 0, 1, 0, 0, 0, 0, 0, 1, 0, 1, 1, 0, 1, 0]",222,139,83,22,7,0.15827338129496402,0.08433734939759036
"[0, 1, 0, 1, 0, 0, 0, 1, 0, 1, 0, 0, 1, 0, 1]",123,79,44,4,5,0.05063291139240506,0.11363636363636363
"[0, 0, 0, 0, 1, 1, 0, 1, 1, 0, 1, 1, 1, 1, 0]",155,84,71,5,3,0.05952380952380952,0.04225352112676056
"[0, 1, 1, 1, 0, 1, 1, 1, 1, 1, 0, 0, 1, 1, 1]",864,272,592,24,54,0.08823529411764706,0.09121621621621621
"[0, 0, 1, 1, 0, 1, 0, 0, 1, 0, 0, 0, 0, 1, 0]",251,163,88,15,7,0.09202453987730061,0.07954545454545454
"[1, 0, 0, 1, 0, 0, 0, 1, 1, 0, 0, 1, 1, 0, 0]",341,201,140,17,10,0.0845771144278607,0.07142857142857142
"[1, 0, 0, 1, 0, 0, 0, 1, 0, 0, 1, 0, 0, 0, 1]",237,152,85,14,6,0.09210526315789473,0.07058823529411765
"[0, 0, 0, 1, 1, 1, 1, 1, 0, 1, 0, 0, 0, 0, 0]",218,137,81,11,12,0.08029197080291971,0.14814814814814814
"[1, 0, 1, 1, 1, 1, 1, 0, 0, 0, 0, 0, 0, 0, 0]",538,296,242,33,28,0.11148648648648649,0.11570247933884298
"[1, 1, 1, 1, 1, 1, 1, 0, 0, 0, 0, 1, 0, 1, 1]",562,145,417,14,42,0.09655172413793103,0.10071942446043165
"[0, 0, 1, 0, 1, 1, 1, 0, 1, 1, 0, 1, 1, 1, 1]",261,100,161,5,11,0.05,0.06832298136645963
"[0, 1, 0, 0, 1, 0, 1, 1, 1, 0, 1, 1, 0, 1, 1]",136,59,77,10,5,0.1694915254237288,0.06493506493506493
"[1, 1, 1, 1, 1, 1, 1, 1, 0, 0, 1, 0, 0, 0, 0]",338,123,215,13,20,0.10569105691056911,0.09302325581395349
"[1, 0, 1, 1, 1, 0, 1, 0, 1, 1, 0, 0, 0, 0, 1]",162,87,75,8,2,0.09195402298850575,0.02666666666666667
"[1, 0, 0, 0, 0, 0, 1, 1, 1, 1, 0, 0, 0, 1, 0]",185,99,86,7,6,0.0707070707070707,0.06976744186046512
"[1, 1, 1, 1, 1, 0, 0, 0, 0, 1, 0, 1, 0, 0, 0]",182,66,116,10,11,0.15151515151515152,0.09482758620689655
"[1, 1, 0, 0, 0, 0, 0, 0, 0, 1, 1, 1, 1, 1, 0]",221,105,116,10,13,0.09523809523809523,0.11206896551724138
"[0, 0, 0, 1, 1, 1, 0, 0, 1, 1, 1, 0, 1, 1, 0]",156,76,80,7,8,0.09210526315789473,0.1
"[0, 0, 0, 0, 1, 1, 1, 0, 0, 1, 1, 1, 0, 1, 1]",185,93,92,9,13,0.0967741935483871,0.14130434782608695
"[0, 0, 1, 0, 1, 1, 1, 0, 1, 0, 1, 0, 0, 0, 0]",151,95,56,9,4,0.09473684210526316,0.07142857142857142
"[1, 1, 0, 0, 0, 1, 1, 1, 0, 0, 0, 0, 0, 1, 0]",163,91,72,9,11,0.0989010989010989,0.1527777777777778
"[1, 1, 1, 0, 0, 0, 0, 1, 1, 1, 0, 0, 0, 0, 0]",345,160,185,20,17,0.125,0.0918918918918919
"[1, 0, 0, 0, 0, 0, 1, 1, 1, 1, 1, 1, 0, 0, 1]",450,190,260,13,31,0.06842105263157895,0.11923076923076924
"[0, 1, 0, 0, 1, 1, 0, 1, 1, 0, 1, 0, 0, 0, 1]",95,50,45,8,7,0.16,0.15555555555555556
"[0, 1, 0, 0, 1, 0, 1, 0, 1, 1, 1, 0, 1, 0, 0]",92,50,42,5,2,0.1,0.047619047619047616
"[0, 0, 1, 0, 0, 0, 1, 0, 1, 0, 1, 1, 0, 1, 0]",123,68,55,2,4,0.029411764705882353,0.07272727272727272
"[1, 1, 1, 0, 0, 1, 1, 0, 0, 1, 0, 0, 1, 0, 1]",138,44,94,5,4,0.11363636363636363,0.0425531914893617
"[0, 1, 0, 0, 0, 0, 0, 0, 0, 0, 0, 1, 1, 0, 1]",630,453,177,45,13,0.09933774834437085,0.07344632768361582
"[0, 0, 1, 0, 0, 1, 1, 0, 1, 1, 0, 0, 1, 0, 1]",103,51,52,2,4,0.0392156862745098,0.07692307692307693
"[1, 0, 0, 0, 0, 1, 0, 1, 0, 0, 1, 0, 0, 1, 1]",184,102,82,8,5,0.0784313725490196,0.06097560975609756
"[1, 0, 1, 0, 0, 0, 0, 1, 0, 1, 0, 0, 1, 0, 0]",203,127,76,10,5,0.07874015748031496,0.06578947368421052
"[0, 0, 1, 0, 1, 1, 1, 1, 1, 1, 1, 1, 0, 1, 1]",584,159,425,16,41,0.10062893081761007,0.09647058823529411
"[0, 0, 0, 0, 1, 0, 1, 1, 0, 1, 0, 1, 1, 0, 0]",152,92,60,6,4,0.06521739130434782,0.06666666666666667
"[1, 1, 1, 1, 1, 0, 0, 1, 0, 1, 0, 0, 0, 0, 1]",155,57,98,5,10,0.08771929824561403,0.10204081632653061
"[0, 0, 0, 1, 0, 1, 0, 1, 1, 1, 0, 1, 1, 0, 0]",114,69,45,6,6,0.08695652173913043,0.13333333333333333
"[0, 1, 0, 1, 0, 1, 1, 1, 1, 0, 1, 0, 1, 0, 1]",155,70,85,5,8,0.07142857142857142,0.09411764705882353
"[0, 1, 0, 1, 0, 1, 0, 1, 0, 1, 1, 1, 1, 0, 1]",164,72,92,7,11,0.09722222222222222,0.11956521739130435
"[0, 1, 0, 1, 1, 0, 1, 1, 0, 0, 0, 0, 1, 0, 0]",157,88,69,7,7,0.07954545454545454,0.10144927536231885
"[1, 0, 1, 1, 1, 0, 1, 0, 1, 0, 0, 0, 1, 1, 0]",115,54,61,3,7,0.05555555555555555,0.11475409836065574
"[0, 1, 0, 1, 1, 1, 0, 0, 0, 0, 0, 1, 0, 1, 0]",149,91,58,3,4,0.03296703296703297,0.06896551724137931
"[0, 0, 1, 1, 0, 0, 1, 0, 1, 1, 1, 0, 0, 0, 0]",213,109,104,15,10,0.13761467889908258,0.09615384615384616
"[1, 1, 1, 0, 1, 0, 0, 1, 1, 0, 0, 1, 0, 1, 1]",144,54,90,4,11,0.07407407407407407,0.12222222222222222
"[1, 0, 0, 0, 0, 0, 1, 1, 0, 0, 1, 0, 1, 0, 1]",161,91,70,6,6,0.06593406593406594,0.08571428571428572
"[0, 0, 0, 1, 0, 0, 0, 0, 0, 0, 0, 1, 1, 1, 0]",649,467,182,50,22,0.10706638115631692,0.12087912087912088
"[0, 1, 1, 1, 0, 0, 1, 1, 0, 1, 0, 0, 1, 1, 1]",180,75,105,7,7,0.09333333333333334,0.06666666666666667
"[0, 1, 0, 0, 1, 1, 0, 1, 1, 1, 1, 0, 1, 0, 0]",101,44,57,4,8,0.09090909090909091,0.14035087719298245
"[1, 1, 0, 1, 1, 0, 1, 0, 0, 0, 0, 0, 0, 0, 0]",363,227,136,16,11,0.07048458149779736,0.08088235294117647
"[1, 1, 1, 0, 1, 1, 0, 1, 1, 0, 1, 0, 0, 0, 0]",120,57,63,4,6,0.07017543859649122,0.09523809523809523
"[1, 0, 0, 1, 1, 0, 1, 0, 1, 0, 0, 1, 0, 0, 0]",142,77,65,5,3,0.06493506493506493,0.046153846153846156
"[1, 1, 1, 0, 1, 0, 0, 1, 1, 1, 0, 1, 0, 1, 0]",136,58,78,3,8,0.05172413793103448,0.10256410256410256
"[0, 0, 0, 1, 1, 1, 0, 1, 1, 1, 1, 0, 1, 1, 1]",313,144,169,15,9,0.10416666666666667,0.05325443786982249
"[1, 0, 0, 0, 0, 0, 1, 0, 0, 1, 0, 1, 1, 0, 0]",277,174,103,25,10,0.14367816091954022,0.0970873786407767
"[1, 0, 1, 0, 0, 1, 0, 0, 1, 0, 1, 0, 0, 0, 1]",131,73,58,7,5,0.0958904109589041,0.08620689655172414
"[0, 0, 1, 1, 0, 1, 0, 0, 1, 0, 0, 1, 0, 1, 0]",146,90,56,7,5,0.07777777777777778,0.08928571428571429
"[0, 0, 1, 1, 0, 0, 1, 0, 0, 0, 1, 1, 0, 1, 0]",152,91,61,10,4,0.10989010989010989,0.06557377049180328
"[0, 1, 1, 0, 0, 0, 0, 0, 0, 1, 0, 1, 1, 0, 0]",334,248,86,20,7,0.08064516129032258,0.08139534883720931
"[0, 0, 1, 1, 0, 1, 0, 0, 1, 0, 0, 1, 0, 1, 1]",124,69,55,7,5,0.10144927536231885,0.09090909090909091
"[1, 1, 0, 1, 1, 0, 1, 1, 0, 0, 1, 1, 1, 0, 1]",258,96,162,7,13,0.07291666666666667,0.08024691358024691
"[1, 1, 1, 1, 0, 1, 0, 0, 0, 0, 0, 1, 0, 0, 0]",178,106,72,11,7,0.10377358490566038,0.09722222222222222
"[1, 1, 0, 0, 1, 1, 1, 0, 1, 0, 1, 1, 1, 1, 0]",306,102,204,11,17,0.10784313725490197,0.08333333333333333
"[0, 1, 1, 0, 0, 1, 1, 1, 1, 0, 1, 0, 0, 1, 1]",256,142,114,12,10,0.08450704225352113,0.08771929824561403
"[1, 1, 1, 0, 1, 1, 0, 0, 1, 1, 1, 1, 0, 1, 0]",254,73,181,3,21,0.0410958904109589,0.11602209944751381
"[0, 1, 0, 0, 0, 1, 1, 1, 1, 0, 0, 1, 1, 1, 1]",487,209,278,16,27,0.07655502392344497,0.09712230215827339
"[1, 0, 1, 0, 1, 1, 1, 0, 1, 0, 0, 0, 1, 1, 0]",99,43,56,9,10,0.20930232558139536,0.17857142857142858
"[0, 0, 0, 1, 1, 0, 1, 1, 1, 1, 0, 0, 0, 1, 0]",121,64,57,6,2,0.09375,0.03508771929824561
"[0, 1, 1, 0, 0, 1, 1, 0, 0, 0, 1, 0, 1, 0, 1]",156,102,54,13,5,0.12745098039215685,0.09259259259259259
"[1, 0, 0, 0, 0, 0, 1, 1, 0, 0, 0, 1, 1, 0, 0]",366,231,135,23,13,0.09956709956709957,0.0962962962962963
"[0, 0, 1, 1, 1, 1, 1, 0, 0, 1, 1, 0, 0, 0, 0]",460,237,223,26,16,0.10970464135021098,0.07174887892376682
"[1, 0, 0, 0, 0, 1, 0, 0, 0, 1, 1, 0, 0, 0, 1]",297,188,109,19,5,0.10106382978723404,0.045871559633027525
"[1, 0, 0, 0, 0, 0, 0, 1, 0, 1, 0, 1, 0, 0, 1]",236,142,94,19,6,0.13380281690140844,0.06382978723404255
"[0, 1, 1, 0, 1, 1, 1, 1, 0, 0, 0, 0, 0, 0, 1]",278,145,133,14,9,0.09655172413793103,0.06766917293233082
"[0, 1, 0, 0, 1, 1, 1, 0, 0, 1, 1, 1, 1, 1, 0]",189,83,106,7,10,0.08433734939759036,0.09433962264150944
"[0, 1, 1, 0, 0, 1, 0, 1, 0, 0, 1, 1, 1, 0, 1]",117,61,56,7,6,0.11475409836065574,0.10714285714285714
"[0, 0, 1, 1, 0, 0, 1, 0, 1, 0, 0, 1, 1, 1, 0]",139,79,60,11,8,0.13924050632911392,0.13333333333333333
"[1, 1, 1, 0, 1, 1, 1, 1, 1, 0, 0, 1, 1, 1, 0]",558,164,394,19,33,0.11585365853658537,0.08375634517766498
"[1, 0, 0, 0, 1, 1, 1, 1, 0, 1, 1, 0, 1, 1, 0]",130,56,74,7,7,0.125,0.0945945945945946
"[1, 0, 0, 1, 0, 0, 0, 1, 0, 1, 0, 1, 0, 1, 0]",122,75,47,2,4,0.02666666666666667,0.0851063829787234
"[0, 0, 1, 1, 1, 1, 1, 1, 0, 1, 0, 1, 0, 1, 0]",170,77,93,10,10,0.12987012987012986,0.10752688172043011
"[1, 0, 1, 1, 1, 0, 1, 1, 1, 0, 1, 1, 0, 1, 1]",541,156,385,13,28,0.08333333333333333,0.07272727272727272
"[0, 0, 1, 0, 1, 0, 1, 1, 0, 1, 0, 0, 1, 1, 1]",141,74,67,8,3,0.10810810810810811,0.04477611940298507
"[1, 0, 1, 0, 0, 1, 1, 1, 1, 1, 0, 1, 0, 1, 0]",147,65,82,4,11,0.06153846153846154,0.13414634146341464
"[1, 1, 0, 0, 1, 1, 0, 0, 0, 0, 1, 0, 1, 1, 1]",428,202,226,21,15,0.10396039603960396,0.06637168141592921
"[1, 1, 1, 0, 0, 1, 0, 1, 1, 0, 0, 0, 0, 0, 1]",146,70,76,9,10,0.12857142857142856,0.13157894736842105
"[0, 0, 1, 0, 1, 0, 1, 1, 1, 1, 1, 0, 1, 1, 1]",272,97,175,8,17,0.08247422680412371,0.09714285714285714
"[1, 0, 1, 1, 0, 1, 0, 1, 1, 1, 1, 0, 1, 0, 1]",219,79,140,7,17,0.08860759493670886,0.12142857142857143
"[1, 0, 1, 1, 0, 0, 1, 1, 1, 1, 0, 1, 1, 0, 1]",260,97,163,6,13,0.061855670103092786,0.07975460122699386
"[1, 1, 1, 0, 0, 1, 0, 1, 0, 0, 1, 1, 1, 1, 0]",216,88,128,7,11,0.07954545454545454,0.0859375
"[0, 1, 0, 0, 1, 1, 1, 1, 0, 1, 0, 1, 1, 1, 1]",281,98,183,10,17,0.10204081632653061,0.09289617486338798
"[0, 1, 1, 0, 0, 1, 1, 0, 0, 1, 1, 0, 1, 1, 0]",199,128,71,11,10,0.0859375,0.14084507042253522
"[0, 0, 1, 1, 1, 0, 1, 1, 1, 0, 0, 0, 1, 0, 1]",105,51,54,4,3,0.0784313725490196,0.05555555555555555
"[0, 0, 1, 0, 0, 0, 0, 0, 0, 0, 1, 1, 1, 0, 0]",675,493,182,55,14,0.11156186612576065,0.07692307692307693
"[1, 1, 0, 1, 1, 0, 0, 1, 0, 1, 1, 0, 1, 0, 1]",131,54,77,4,3,0.07407407407407407,0.03896103896103896
"[0, 0, 1, 1, 0, 1, 1, 0, 0, 1, 0, 1, 1, 1, 1]",203,83,120,8,14,0.0963855421686747,0.11666666666666667
"[0, 1, 0, 1, 1, 1, 1, 1, 1, 0, 0, 0, 0, 1, 1]",502,226,276,24,23,0.10619469026548672,0.08333333333333333
"[1, 1, 0, 1, 0, 1, 1, 1, 1, 1, 1, 0, 0, 0, 0]",366,147,219,20,21,0.1360544217687075,0.0958904109589041
"[0, 0, 0, 0, 1, 1, 1, 1, 0, 1, 1, 1, 0, 0, 1]",191,92,99,5,9,0.05434782608695652,0.09090909090909091
"[1, 1, 1, 1, 1, 0, 1, 1, 1, 1, 0, 1, 0, 1, 0]",508,138,370,21,28,0.15217391304347827,0.07567567567567568
"[0, 1, 1, 0, 0, 1, 0, 0, 0, 1, 1, 1, 1, 1, 0]",147,71,76,3,7,0.04225352112676056,0.09210526315789473
"[0, 0, 1, 0, 0, 1, 1, 1, 1, 0, 1, 0, 0, 1, 1]",135,66,69,4,4,0.06060606060606061,0.057971014492753624
"[0, 1, 1, 0, 1, 0, 1, 0, 0, 0, 1, 0, 1, 0, 0]",136,75,61,6,7,0.08,0.11475409836065574
"[1, 0, 1, 1, 1, 0, 0, 0, 0, 1, 1, 0, 0, 1, 1]",487,211,276,18,22,0.08530805687203792,0.07971014492753623
"[1, 1, 0, 1, 0, 0, 0, 0, 0, 1, 1, 1, 1, 1, 0]",153,63,90,4,7,0.06349206349206349,0.07777777777777778
"[1, 1, 1, 1, 0, 1, 0, 0, 0, 0, 0, 1, 1, 1, 1]",330,122,208,8,25,0.06557377049180328,0.1201923076923077
"[0, 1, 0, 1, 1, 1, 1, 0, 0, 1, 1, 0, 1, 1, 1]",321,134,187,4,19,0.029850746268656716,0.10160427807486631
"[1, 1, 0, 0, 1, 1, 0, 1, 0, 1, 1, 1, 1, 1, 0]",276,95,181,10,19,0.10526315789473684,0.10497237569060773
"[0, 1, 1, 0, 1, 0, 0, 1, 0, 1, 1, 0, 1, 1, 1]",141,56,85,3,8,0.05357142857142857,0.09411764705882353
"[1, 1, 0, 0, 1, 1, 0, 1, 0, 0, 1, 0, 1, 1, 0]",135,56,79,4,9,0.07142857142857142,0.11392405063291139
"[1, 1, 1, 0, 0, 0, 0, 1, 0, 1, 0, 1, 0, 1, 1]",165,67,98,5,6,0.07462686567164178,0.061224489795918366
"[1, 1, 0, 0, 0, 1, 1, 1, 0, 0, 0, 0, 1, 0, 1]",133,65,68,5,5,0.07692307692307693,0.07352941176470588
"[0, 1, 0, 0, 1, 0, 0, 1, 0, 1, 1, 0, 0, 0, 0]",294,194,100,17,8,0.08762886597938144,0.08
"[0, 0, 1, 0, 0, 0, 1, 0, 0, 0, 1, 1, 0, 1, 1]",152,83,69,12,3,0.14457831325301204,0.043478260869565216
"[0, 1, 0, 0, 1, 1, 0, 0, 0, 0, 0, 1, 0, 0, 1]",284,184,100,16,10,0.08695652173913043,0.1
"[1, 0, 0, 0, 0, 1, 0, 0, 1, 0, 1, 0, 0, 1, 0]",235,152,83,19,7,0.125,0.08433734939759036
"[0, 1, 0, 1, 1, 0, 1, 0, 0, 1, 0, 1, 1, 0, 0]",130,73,57,10,7,0.136986301369863,0.12280701754385964
"[1, 1, 0, 1, 0, 1, 0, 0, 0, 0, 0, 0, 1, 0, 0]",239,141,98,16,7,0.11347517730496454,0.07142857142857142
"[0, 1, 0, 1, 1, 1, 1, 0, 1, 0, 1, 0, 0, 0, 0]",123,59,64,4,7,0.06779661016949153,0.109375
"[1, 0, 0, 1, 0, 1, 1, 0, 0, 0, 1, 1, 1, 0, 1]",111,47,64,5,4,0.10638297872340426,0.0625
"[1, 1, 1, 0, 0, 0, 0, 0, 0, 0, 1, 0, 1, 1, 1]",359,116,243,14,15,0.1206896551724138,0.06172839506172839
"[0, 1, 0, 1, 0, 1, 0, 0, 0, 1, 1, 0, 1, 1, 1]",137,67,70,10,5,0.14925373134328357,0.07142857142857142
"[1, 0, 1, 0, 1, 0, 1, 0, 1, 0, 0, 0, 1, 1, 0]",112,71,41,3,4,0.04225352112676056,0.0975609756097561
"[1, 0, 0, 1, 0, 0, 1, 1, 1, 1, 0, 1, 0, 1, 0]",113,58,55,6,7,0.10344827586206896,0.12727272727272726
"[0, 1, 0, 1, 1, 0, 1, 1, 0, 0, 0, 1, 0, 0, 1]",118,59,59,2,5,0.03389830508474576,0.0847457627118644
"[0, 0, 1, 0, 1, 0, 1, 1, 0, 1, 1, 0, 0, 0, 1]",99,49,50,2,5,0.04081632653061224,0.1
"[1, 1, 1, 0, 1, 0, 1, 0, 0, 1, 0, 0, 0, 0, 1]",129,64,65,7,4,0.109375,0.06153846153846154
"[0, 0, 0, 1, 0, 0, 0, 1, 0, 0, 1, 1, 0, 1, 1]",152,86,66,11,6,0.12790697674418605,0.09090909090909091
"[0, 1, 0, 1, 1, 1, 0, 0, 1, 1, 0, 1, 0, 0, 0]",111,64,47,5,4,0.078125,0.0851063829787234
"[1, 1, 1, 1, 0, 0, 1, 0, 1, 0, 1, 1, 0, 0, 0]",156,83,73,12,4,0.14457831325301204,0.0547945205479452
"[1, 0, 0, 1, 1, 1, 1, 1, 0, 0, 1, 0, 1, 0, 1]",167,59,108,7,8,0.11864406779661017,0.07407407407407407
"[1, 1, 1, 1, 0, 0, 1, 0, 1, 1, 1, 0, 1, 1, 1]",633,187,446,15,38,0.08021390374331551,0.08520179372197309
"[0, 0, 1, 1, 1, 1, 1, 0, 1, 0, 0, 1, 1, 1, 1]",444,166,278,20,24,0.12048192771084337,0.08633093525179857
"[1, 1, 1, 0, 0, 1, 1, 0, 0, 0, 0, 0, 1, 1, 0]",284,104,180,15,16,0.14423076923076922,0.08888888888888889
"[0, 0, 1, 0, 0, 1, 0, 1, 1, 1, 1, 1, 1, 0, 0]",189,100,89,8,8,0.08,0.0898876404494382
"[1, 0, 0, 1, 1, 1, 1, 1, 0, 1, 0, 1, 1, 0, 1]",231,60,171,9,16,0.15,0.0935672514619883
"[1, 0, 1, 0, 1, 0, 0, 0, 1, 1, 1, 0, 0, 1, 1]",146,69,77,8,6,0.11594202898550725,0.07792207792207792
"[1, 0, 1, 0, 0, 1, 0, 1, 1, 1, 0, 1, 0, 1, 1]",146,51,95,2,7,0.0392156862745098,0.07368421052631578
"[0, 0, 0, 1, 1, 1, 1, 0, 1, 1, 0, 0, 1, 1, 1]",316,188,128,15,13,0.0797872340425532,0.1015625
"[1, 0, 1, 0, 0, 1, 1, 1, 0, 1, 0, 1, 1, 0, 0]",120,58,62,4,5,0.06896551724137931,0.08064516129032258
"[0, 1, 1, 0, 1, 0, 0, 1, 0, 1, 0, 0, 1, 1, 0]",131,68,63,7,7,0.10294117647058823,0.1111111111111111
"[0, 0, 1, 1, 1, 0, 0, 0, 1, 0, 1, 1, 1, 0, 0]",142,67,75,7,7,0.1044776119402985,0.09333333333333334
"[1, 1, 1, 0, 0, 0, 0, 1, 1, 1, 0, 0, 0, 1, 0]",142,56,86,9,13,0.16071428571428573,0.1511627906976744
"[1, 1, 1, 1, 0, 1, 1, 0, 1, 0, 1, 0, 1, 0, 0]",157,55,102,4,10,0.07272727272727272,0.09803921568627451
"[1, 0, 1, 0, 1, 1, 1, 1, 0, 1, 1, 0, 1, 0, 0]",136,56,80,6,8,0.10714285714285714,0.1
"[1, 0, 0, 1, 0, 0, 0, 0, 0, 1, 0, 0, 0, 1, 0]",484,342,142,35,16,0.1023391812865497,0.11267605633802817
"[1, 0, 0, 0, 0, 0, 0, 0, 1, 1, 1, 1, 0, 0, 1]",546,290,256,26,25,0.0896551724137931,0.09765625
"[0, 1, 0, 1, 0, 0, 1, 1, 1, 0, 0, 1, 0, 0, 1]",118,68,50,8,2,0.11764705882352941,0.04
"[1, 1, 1, 0, 0, 1, 1, 1, 1, 0, 0, 0, 0, 1, 0]",328,84,244,11,18,0.13095238095238096,0.07377049180327869
"[0, 0, 0, 1, 1, 1, 0, 0, 1, 1, 1, 0, 0, 1, 1]",205,107,98,18,10,0.16822429906542055,0.10204081632653061
"[1, 1, 0, 1, 1, 0, 1, 1, 0, 0, 1, 1, 1, 1, 0]",346,129,217,10,22,0.07751937984496124,0.10138248847926268
"[0, 1, 0, 0, 0, 0, 1, 1, 1, 0, 1, 1, 0, 1, 1]",111,58,53,4,10,0.06896551724137931,0.18867924528301888
"[1, 0, 1, 1, 0, 1, 0, 0, 0, 0, 1, 1, 1, 0, 1]",112,50,62,2,8,0.04,0.12903225806451613
"[0, 1, 0, 1, 0, 1, 1, 0, 1, 0, 0, 0, 0, 1, 1]",148,79,69,7,5,0.08860759493670886,0.07246376811594203
"[0, 0, 1, 0, 1, 1, 0, 0, 0, 0, 1, 1, 0, 0, 0]",531,350,181,27,21,0.07714285714285714,0.11602209944751381
"[1, 1, 0, 1, 1, 0, 1, 0, 1, 0, 0, 1, 0, 1, 0]",97,45,52,2,6,0.044444444444444446,0.11538461538461539
"[0, 1, 0, 1, 0, 1, 1, 1, 0, 1, 1, 0, 1, 1, 0]",149,67,82,7,7,0.1044776119402985,0.08536585365853659
"[1, 0, 1, 1, 0, 1, 0, 1, 0, 1, 1, 1, 0, 1, 1]",229,78,151,5,8,0.0641025641025641,0.052980132450331126
"[0, 0, 1, 1, 0, 0, 0, 0, 0, 1, 0, 1, 1, 0, 0]",333,209,124,20,10,0.09569377990430622,0.08064516129032258
"[1, 1, 0, 0, 1, 1, 0, 1, 1, 1, 0, 0, 0, 0, 0]",173,93,80,8,13,0.08602150537634409,0.1625
"[1, 0, 0, 0, 1, 0, 0, 0, 1, 0, 1, 0, 1, 1, 0]",141,80,61,3,4,0.0375,0.06557377049180328
"[0, 1, 0, 1, 1, 1, 1, 0, 0, 1, 0, 0, 0, 0, 0]",198,119,79,10,9,0.08403361344537816,0.11392405063291139
"[1, 0, 1, 1, 1, 1, 0, 1, 0, 0, 1, 0, 0, 1, 0]",98,43,55,4,7,0.09302325581395349,0.12727272727272726
"[0, 1, 0, 0, 1, 0, 1, 0, 1, 1, 0, 1, 1, 1, 0]",101,52,49,3,5,0.057692307692307696,0.10204081632653061
"[0, 1, 1, 0, 1, 1, 1, 0, 0, 0, 0, 1, 1, 1, 1]",375,165,210,16,12,0.09696969696969697,0.05714285714285714
"[0, 1, 1, 1, 0, 1, 0, 1, 1, 1, 1, 1, 0, 0, 0]",191,69,122,6,10,0.08695652173913043,0.08196721311475409
"[0, 1, 1, 0, 1, 0, 0, 0, 0, 0, 1, 1, 0, 0, 0]",372,243,129,18,9,0.07407407407407407,0.06976744186046512
"[0, 0, 1, 1, 0, 1, 0, 0, 0, 0, 0, 1, 1, 0, 0]",377,254,123,24,10,0.09448818897637795,0.08130081300813008
"[0, 0, 1, 1, 1, 0, 0, 1, 0, 0, 1, 0, 0, 1, 0]",178,97,81,6,8,0.061855670103092786,0.09876543209876543
"[1, 0, 0, 1, 0, 0, 0, 1, 0, 1, 1, 1, 0, 1, 1]",111,60,51,2,10,0.03333333333333333,0.19607843137254902
"[1, 1, 1, 0, 0, 1, 1, 1, 1, 0, 1, 0, 1, 0, 0]",224,81,143,6,13,0.07407407407407407,0.09090909090909091
"[0, 1, 0, 0, 1, 0, 1, 0, 0, 1, 1, 0, 1, 0, 0]",132,66,66,9,5,0.13636363636363635,0.07575757575757576
"[1, 0, 0, 0, 1, 1, 0, 0, 1, 0, 0, 1, 1, 0, 0]",176,108,68,9,7,0.08333333333333333,0.10294117647058823
"[0, 1, 0, 0, 0, 1, 1, 0, 0, 0, 0, 1, 1, 1, 0]",179,96,83,10,5,0.10416666666666667,0.060240963855421686
"[1, 0, 0, 1, 0, 1, 1, 1, 0, 0, 0, 1, 0, 0, 0]",145,87,58,9,3,0.10344827586206896,0.05172413793103448
"[0, 0, 1, 1, 1, 1, 1, 0, 0, 1, 0, 0, 0, 1, 1]",179,88,91,11,7,0.125,0.07692307692307693
"[0, 1, 0, 0, 0, 1, 1, 1, 0, 0, 1, 1, 0, 0, 1]",191,99,92,14,12,0.1414141414141414,0.13043478260869565
"[0, 0, 1, 1, 0, 0, 1, 0, 0, 0, 1, 0, 1, 1, 0]",164,109,55,10,4,0.09174311926605505,0.07272727272727272
"[1, 1, 0, 1, 0, 1, 1, 0, 1, 1, 0, 0, 0, 0, 0]",176,93,83,10,10,0.10752688172043011,0.12048192771084337
"[0, 1, 1, 0, 0, 0, 1, 1, 0, 0, 0, 0, 0, 0, 1]",496,327,169,28,15,0.0856269113149847,0.08875739644970414
"[1, 0, 0, 1, 0, 1, 1, 0, 0, 0, 1, 1, 0, 0, 0]",189,105,84,10,6,0.09523809523809523,0.07142857142857142
"[0, 1, 1, 1, 0, 0, 1, 0, 0, 1, 1, 1, 0, 0, 1]",126,66,60,8,9,0.12121212121212122,0.15
"[0, 0, 1, 1, 1, 1, 0, 1, 0, 0, 0, 1, 0, 1, 1]",131,56,75,6,11,0.10714285714285714,0.14666666666666667
"[0, 0, 0, 0, 1, 1, 1, 0, 1, 0, 0, 1, 1, 1, 0]",139,73,66,7,3,0.0958904109589041,0.045454545454545456
"[0, 0, 1, 1, 1, 1, 0, 0, 1, 0, 0, 1, 1, 1, 0]",153,69,84,10,3,0.14492753623188406,0.03571428571428571
"[1, 0, 0, 0, 1, 0, 0, 1, 1, 1, 0, 0, 0, 0, 1]",185,114,71,11,8,0.09649122807017543,0.11267605633802817
"[0, 1, 1, 0, 0, 1, 0, 0, 0, 0, 0, 1, 1, 0, 1]",154,100,54,11,3,0.11,0.05555555555555555
"[1, 1, 0, 0, 0, 1, 0, 1, 0, 0, 1, 1, 1, 0, 1]",119,58,61,4,8,0.06896551724137931,0.13114754098360656
"[0, 1, 0, 0, 1, 0, 0, 1, 1, 0, 0, 0, 0, 0, 1]",270,177,93,19,8,0.10734463276836158,0.08602150537634409
"[0, 0, 1, 0, 1, 0, 0, 0, 0, 1, 0, 1, 0, 0, 1]",222,140,82,13,7,0.09285714285714286,0.08536585365853659
"[1, 0, 1, 1, 1, 0, 0, 0, 0, 1, 1, 1, 0, 1, 0]",125,56,69,6,4,0.10714285714285714,0.057971014492753624
"[1, 0, 0, 0, 0, 0, 1, 1, 0, 1, 1, 0, 0, 0, 1]",178,90,88,9,8,0.1,0.09090909090909091
"[0, 1, 0, 1, 1, 0, 1, 1, 0, 1, 1, 1, 1, 1, 0]",234,103,131,9,13,0.08737864077669903,0.09923664122137404
"[1, 0, 0, 1, 1, 0, 1, 0, 1, 1, 0, 1, 1, 0, 1]",124,47,77,4,7,0.0851063829787234,0.09090909090909091
"[0, 0, 1, 1, 0, 1, 1, 0, 1, 1, 1, 0, 1, 1, 0]",146,67,79,6,8,0.08955223880597014,0.10126582278481013
"[1, 1, 0, 1, 0, 1, 0, 0, 0, 0, 0, 1, 1, 1, 1]",222,106,116,11,8,0.10377358490566038,0.06896551724137931
"[1, 0, 1, 0, 1, 0, 1, 1, 0, 1, 0, 1, 0, 0, 0]",107,63,44,4,3,0.06349206349206349,0.06818181818181818
"[0, 1, 1, 0, 0, 1, 1, 1, 0, 1, 0, 1, 1, 0, 0]",167,77,90,7,8,0.09090909090909091,0.08888888888888889
"[1, 0, 0, 1, 1, 0, 0, 1, 1, 1, 0, 1, 0, 1, 1]",235,58,177,4,19,0.06896551724137931,0.10734463276836158
"[1, 0, 1, 1, 0, 1, 0, 0, 0, 0, 1, 1, 0, 1, 0]",95,50,45,3,5,0.06,0.1111111111111111
"[0, 1, 0, 1, 1, 0, 1, 0, 0, 0, 0, 1, 1, 0, 1]",96,47,49,6,7,0.1276595744680851,0.14285714285714285
"[0, 1, 1, 1, 1, 0, 0, 1, 0, 0, 1, 1, 0, 0, 0]",161,92,69,11,8,0.11956521739130435,0.11594202898550725
"[1, 1, 1, 0, 0, 1, 1, 1, 1, 1, 0, 0, 1, 0, 1]",336,92,244,10,16,0.10869565217391304,0.06557377049180328
"[0, 1, 0, 0, 0, 0, 1, 1, 0, 1, 1, 1, 0, 0, 0]",166,110,56,14,3,0.12727272727272726,0.05357142857142857
"[1, 1, 1, 0, 1, 1, 0, 0, 0, 0, 0, 1, 0, 0, 0]",163,89,74,10,5,0.11235955056179775,0.06756756756756757
"[0, 1, 1, 0, 0, 1, 0, 0, 0, 0, 0, 1, 0, 0, 0]",545,389,156,38,14,0.09768637532133675,0.08974358974358974
"[0, 1, 0, 0, 0, 0, 1, 0, 0, 0, 1, 1, 1, 0, 1]",136,82,54,10,4,0.12195121951219512,0.07407407407407407
"[1, 0, 0, 1, 1, 0, 0, 1, 1, 0, 0, 0, 0, 0, 1]",500,158,342,15,28,0.0949367088607595,0.08187134502923976
"[0, 1, 0, 0, 1, 1, 1, 0, 0, 0, 1, 0, 0, 1, 1]",122,72,50,9,8,0.125,0.16
"[1, 0, 0, 1, 1, 0, 0, 1, 0, 0, 1, 0, 0, 1, 0]",133,60,73,2,8,0.03333333333333333,0.1095890410958904
"[0, 0, 1, 1, 1, 0, 0, 0, 1, 0, 0, 1, 1, 1, 1]",196,96,100,6,12,0.0625,0.12
"[1, 0, 1, 0, 0, 0, 0, 1, 1, 1, 1, 0, 0, 0, 1]",173,78,95,7,6,0.08974358974358974,0.06315789473684211
"[1, 0, 0, 0, 1, 0, 0, 0, 1, 0, 1, 1, 0, 0, 0]",253,160,93,13,9,0.08125,0.0967741935483871
"[1, 0, 1, 1, 0, 0, 0, 0, 1, 0, 1, 0, 1, 1, 1]",123,58,65,2,7,0.034482758620689655,0.1076923076923077
"[0, 0, 1, 1, 1, 0, 1, 1, 1, 0, 1, 0, 1, 1, 1]",276,116,160,14,20,0.1206896551724138,0.125
"[0, 1, 0, 0, 1, 0, 1, 1, 0, 0, 0, 1, 1, 0, 0]",173,106,67,7,6,0.0660377358490566,0.08955223880597014
"[1, 1, 0, 1, 1, 0, 1, 0, 0, 1, 0, 0, 1, 0, 1]",112,55,57,2,7,0.03636363636363636,0.12280701754385964
"[1, 0, 0, 0, 0, 0, 1, 0, 0, 0, 0, 1, 0, 0, 1]",562,381,181,26,20,0.06824146981627296,0.11049723756906077
"[1, 1, 1, 0, 0, 1, 0, 1, 1, 1, 0, 0, 1, 1, 1]",383,138,245,10,21,0.07246376811594203,0.08571428571428572
"[0, 1, 0, 0, 0, 1, 1, 1, 0, 0, 1, 0, 1, 1, 1]",127,66,61,7,3,0.10606060606060606,0.04918032786885246
"[0, 0, 1, 0, 0, 0, 0, 0, 1, 0, 1, 1, 0, 1, 1]",167,114,53,14,3,0.12280701754385964,0.05660377358490566
"[0, 0, 1, 1, 0, 0, 0, 1, 0, 1, 0, 0, 0, 0, 0]",690,467,223,48,24,0.10278372591006424,0.10762331838565023
"[1, 0, 0, 0, 1, 0, 1, 0, 0, 0, 0, 1, 0, 0, 1]",267,166,101,11,11,0.06626506024096386,0.10891089108910891
"[1, 0, 1, 1, 0, 0, 1, 0, 1, 0, 0, 0, 1, 0, 1]",98,56,42,5,2,0.08928571428571429,0.047619047619047616
"[0, 0, 0, 1, 0, 1, 0, 1, 0, 0, 1, 1, 0, 1, 0]",135,75,60,4,7,0.05333333333333334,0.11666666666666667
"[0, 1, 1, 0, 0, 0, 0, 0, 0, 1, 0, 1, 0, 1, 0]",257,189,68,23,8,0.12169312169312169,0.11764705882352941
"[1, 0, 0, 1, 0, 1, 0, 1, 0, 0, 0, 1, 0, 1, 0]",118,73,45,6,4,0.0821917808219178,0.08888888888888889
"[0, 1, 1, 1, 1, 0, 1, 0, 1, 1, 0, 0, 1, 1, 0]",194,89,105,5,8,0.056179775280898875,0.0761904761904762
"[1, 1, 1, 1, 1, 1, 1, 0, 0, 0, 1, 0, 0, 0, 0]",228,99,129,15,5,0.15151515151515152,0.03875968992248062
"[1, 0, 1, 0, 0, 0, 0, 1, 1, 1, 1, 1, 1, 0, 0]",437,199,238,21,25,0.10552763819095477,0.10504201680672269
"[1, 1, 0, 1, 1, 0, 1, 0, 1, 1, 1, 0, 0, 0, 0]",152,75,77,7,9,0.09333333333333334,0.11688311688311688
"[0, 0, 1, 0, 1, 1, 1, 0, 1, 1, 0, 1, 0, 1, 1]",133,62,71,4,3,0.06451612903225806,0.04225352112676056
"[1, 0, 1, 1, 0, 1, 1, 0, 0, 0, 1, 0, 0, 1, 0]",122,61,61,5,4,0.08196721311475409,0.06557377049180328
"[1, 1, 0, 1, 1, 1, 0, 1, 0, 0, 1, 1, 1, 0, 1]",221,69,152,8,14,0.11594202898550725,0.09210526315789473
"[1, 1, 1, 1, 0, 0, 1, 0, 0, 1, 1, 0, 0, 0, 1]",136,55,81,4,9,0.07272727272727272,0.1111111111111111
"[0, 1, 0, 0, 0, 1, 1, 0, 1, 0, 0, 1, 1, 1, 1]",168,81,87,9,9,0.1111111111111111,0.10344827586206896
"[1, 1, 1, 0, 0, 1, 0, 0, 1, 0, 1, 1, 0, 0, 0]",142,76,66,12,8,0.15789473684210525,0.12121212121212122
"[1, 1, 1, 1, 0, 0, 0, 1, 0, 0, 0, 1, 0, 1, 0]",125,66,59,3,3,0.045454545454545456,0.05084745762711865
"[1, 1, 0, 0, 1, 0, 1, 1, 0, 1, 0, 1, 1, 1, 1]",289,106,183,8,23,0.07547169811320754,0.12568306010928962
"[0, 0, 0, 0, 1, 0, 0, 0, 0, 1, 1, 1, 1, 0, 0]",655,446,209,34,14,0.07623318385650224,0.06698564593301436
"[0, 0, 1, 0, 0, 1, 1, 1, 0, 1, 0, 1, 0, 1, 1]",99,49,50,4,4,0.08163265306122448,0.08
"[1, 1, 1, 1, 0, 1, 0, 0, 0, 1, 1, 0, 1, 1, 1]",304,95,209,10,15,0.10526315789473684,0.07177033492822966
"[1, 0, 1, 1, 1, 1, 0, 1, 0, 0, 1, 1, 1, 0, 1]",232,82,150,10,17,0.12195121951219512,0.11333333333333333
"[0, 1, 1, 1, 0, 0, 0, 0, 1, 1, 1, 1, 0, 1, 0]",123,63,60,4,9,0.06349206349206349,0.15
"[0, 1, 0, 0, 0, 0, 1, 0, 1, 0, 1, 1, 0, 0, 0]",295,210,85,19,13,0.09047619047619047,0.15294117647058825
"[0, 1, 0, 0, 1, 0, 0, 1, 0, 1, 0, 1, 0, 0, 0]",223,139,84,12,6,0.08633093525179857,0.07142857142857142
"[1, 1, 1, 1, 1, 0, 1, 1, 1, 0, 1, 1, 0, 0, 1]",676,198,478,16,42,0.08080808080808081,0.08786610878661087
"[1, 0, 1, 1, 0, 1, 1, 0, 0, 1, 0, 1, 1, 0, 1]",114,49,65,3,5,0.061224489795918366,0.07692307692307693
"[0, 0, 1, 0, 1, 1, 1, 1, 0, 0, 0, 1, 0, 0, 1]",127,74,53,8,5,0.10810810810810811,0.09433962264150944
"[1, 0, 0, 0, 0, 1, 0, 1, 1, 1, 1, 0, 0, 0, 1]",151,75,76,8,6,0.10666666666666667,0.07894736842105263
"[1, 0, 0, 1, 1, 0, 0, 1, 0, 1, 1, 0, 0, 0, 1]",159,68,91,8,10,0.11764705882352941,0.10989010989010989
"[0, 0, 0, 0, 1, 0, 1, 0, 0, 0, 1, 0, 1, 1, 0]",266,174,92,14,9,0.08045977011494253,0.09782608695652174
"[0, 0, 0, 0, 1, 1, 1, 0, 1, 0, 0, 0, 0, 1, 1]",267,159,108,15,11,0.09433962264150944,0.10185185185185185
"[1, 1, 1, 1, 0, 1, 1, 0, 0, 0, 0, 0, 1, 0, 1]",121,47,74,4,7,0.0851063829787234,0.0945945945945946
"[1, 0, 0, 0, 0, 0, 1, 1, 1, 1, 1, 0, 1, 0, 0]",127,60,67,7,7,0.11666666666666667,0.1044776119402985
"[0, 1, 1, 0, 1, 1, 1, 1, 0, 0, 0, 0, 0, 1, 1]",185,81,104,6,11,0.07407407407407407,0.10576923076923077
"[0, 0, 0, 0, 1, 1, 1, 1, 0, 0, 1, 0, 0, 1, 1]",306,193,113,19,11,0.09844559585492228,0.09734513274336283
"[0, 0, 0, 1, 1, 0, 0, 1, 0, 1, 0, 0, 1, 0, 1]",160,104,56,5,4,0.04807692307692308,0.07142857142857142
"[1, 0, 0, 1, 0, 0, 1, 0, 0, 1, 0, 0, 1, 0, 0]",242,157,85,14,8,0.08917197452229299,0.09411764705882353
"[1, 1, 1, 1, 1, 0, 0, 1, 0, 0, 0, 0, 1, 0, 1]",130,57,73,3,2,0.05263157894736842,0.0273972602739726
"[0, 1, 0, 1, 1, 0, 1, 0, 1, 0, 1, 0, 0, 0, 1]",90,50,40,2,6,0.04,0.15
"[0, 1, 0, 1, 1, 1, 1, 1, 0, 0, 0, 1, 0, 0, 1]",134,64,70,8,8,0.125,0.11428571428571428
"[1, 0, 1, 0, 0, 0, 0, 1, 0, 1, 0, 0, 0, 1, 1]",174,84,90,5,13,0.05952380952380952,0.14444444444444443
"[0, 1, 0, 0, 0, 0, 1, 1, 0, 1, 0, 0, 0, 0, 1]",249,161,88,18,9,0.11180124223602485,0.10227272727272728
"[0, 1, 1, 0, 1, 1, 1, 0, 0, 0, 1, 0, 0, 0, 1]",105,52,53,12,2,0.23076923076923078,0.03773584905660377
"[1, 0, 0, 1, 1, 0, 1, 1, 1, 0, 0, 0, 1, 0, 0]",115,49,66,5,7,0.10204081632653061,0.10606060606060606
"[1, 0, 1, 1, 0, 1, 0, 0, 1, 1, 0, 1, 1, 1, 0]",150,54,96,6,6,0.1111111111111111,0.0625
"[0, 0, 1, 1, 1, 1, 0, 0, 1, 0, 1, 1, 0, 1, 0]",150,66,84,8,4,0.12121212121212122,0.047619047619047616
"[0, 0, 1, 1, 0, 1, 1, 1, 0, 1, 0, 1, 1, 1, 0]",134,53,81,2,10,0.03773584905660377,0.12345679012345678
"[0, 0, 0, 0, 1, 1, 0, 1, 1, 1, 0, 1, 0, 1, 1]",141,64,77,6,1,0.09375,0.012987012987012988
"[1, 0, 0, 0, 0, 1, 1, 0, 1, 1, 1, 0, 1, 0, 1]",126,53,73,6,5,0.11320754716981132,0.0684931506849315
"[0, 1, 0, 1, 0, 1, 1, 1, 1, 1, 0, 0, 1, 1, 1]",373,130,243,7,28,0.05384615384615385,0.11522633744855967
"[1, 1, 0, 0, 0, 1, 0, 0, 0, 1, 0, 1, 1, 1, 0]",105,61,44,8,3,0.13114754098360656,0.06818181818181818
"[1, 1, 0, 0, 1, 1, 1, 0, 0, 0, 0, 1, 1, 1, 1]",473,211,262,19,14,0.09004739336492891,0.05343511450381679
"[0, 1, 0, 0, 0, 0, 0, 0, 1, 0, 1, 1, 1, 0, 0]",276,189,87,10,11,0.05291005291005291,0.12643678160919541
"[0, 0, 1, 0, 0, 0, 0, 0, 0, 1, 0, 1, 1, 1, 0]",261,173,88,10,7,0.057803468208092484,0.07954545454545454
"[0, 0, 1, 0, 1, 1, 1, 0, 0, 0, 1, 1, 0, 0, 0]",183,114,69,12,3,0.10526315789473684,0.043478260869565216
"[0, 1, 0, 0, 0, 1, 1, 0, 1, 0, 0, 1, 1, 1, 0]",100,51,49,7,4,0.13725490196078433,0.08163265306122448
"[0, 1, 1, 0, 0, 0, 1, 0, 1, 0, 0, 1, 0, 0, 0]",272,186,86,19,6,0.10215053763440861,0.06976744186046512
"[1, 0, 1, 1, 1, 0, 0, 0, 0, 0, 1, 0, 1, 1, 0]",106,51,55,5,2,0.09803921568627451,0.03636363636363636
"[0, 0, 1, 0, 1, 1, 1, 0, 1, 0, 0, 1, 0, 0, 1]",103,56,47,4,5,0.07142857142857142,0.10638297872340426
"[0, 0, 0, 0, 0, 1, 0, 0, 0, 1, 1, 0, 1, 1, 1]",296,201,95,19,10,0.0945273631840796,0.10526315789473684
"[0, 1, 1, 0, 1, 1, 1, 1, 0, 1, 0, 1, 1, 0, 1]",221,75,146,8,14,0.10666666666666667,0.0958904109589041
"[0, 1, 1, 1, 0, 1, 0, 0, 1, 0, 0, 1, 1, 0, 0]",137,72,65,6,2,0.08333333333333333,0.03076923076923077
"[0, 1, 1, 1, 0, 0, 0, 0, 1, 1, 0, 0, 1, 1, 0]",448,237,211,24,17,0.10126582278481013,0.08056872037914692
"[1, 1, 0, 1, 0, 1, 1, 0, 0, 1, 1, 0, 0, 0, 1]",136,61,75,7,5,0.11475409836065574,0.06666666666666667
"[0, 1, 1, 1, 0, 0, 1, 0, 1, 1, 0, 1, 1, 1, 0]",139,55,84,5,6,0.09090909090909091,0.07142857142857142
"[0, 0, 0, 0, 1, 1, 0, 1, 1, 1, 0, 0, 1, 0, 1]",130,55,75,9,7,0.16363636363636364,0.09333333333333334
"[0, 1, 0, 0, 0, 0, 1, 1, 0, 1, 0, 0, 1, 0, 1]",145,83,62,8,10,0.0963855421686747,0.16129032258064516
"[0, 1, 0, 1, 1, 0, 1, 1, 0, 0, 1, 1, 1, 1, 0]",227,83,144,8,11,0.0963855421686747,0.0763888888888889
"[1, 0, 1, 1, 0, 1, 0, 1, 1, 0, 1, 0, 1, 1, 0]",140,67,73,6,5,0.08955223880597014,0.0684931506849315
"[0, 1, 0, 0, 0, 1, 1, 0, 0, 1, 1, 1, 1, 0, 1]",170,82,88,6,9,0.07317073170731707,0.10227272727272728
"[1, 0, 1, 0, 0, 0, 0, 0, 1, 0, 1, 0, 0, 0, 0]",562,386,176,41,14,0.10621761658031088,0.07954545454545454
"[1, 0, 0, 0, 1, 0, 0, 1, 1, 1, 0, 0, 1, 1, 0]",173,91,82,6,8,0.06593406593406594,0.0975609756097561
"[0, 1, 1, 0, 1, 0, 1, 0, 0, 0, 1, 0, 0, 0, 0]",263,161,102,17,13,0.10559006211180125,0.12745098039215685
"[1, 1, 0, 0, 0, 0, 0, 0, 1, 0, 1, 1, 0, 0, 0]",356,222,134,20,12,0.09009009009009009,0.08955223880597014
"[1, 1, 0, 1, 0, 0, 1, 1, 1, 0, 0, 0, 1, 1, 0]",113,61,52,10,6,0.16393442622950818,0.11538461538461539
"[0, 1, 0, 1, 0, 0, 1, 0, 1, 0, 0, 1, 0, 1, 1]",101,55,46,12,3,0.21818181818181817,0.06521739130434782
"[1, 1, 1, 0, 0, 1, 1, 1, 0, 0, 0, 0, 1, 0, 1]",130,53,77,4,4,0.07547169811320754,0.05194805194805195
"[0, 1, 1, 1, 1, 1, 0, 1, 0, 0, 0, 0, 1, 0, 1]",123,67,56,5,5,0.07462686567164178,0.08928571428571429
"[0, 0, 1, 0, 0, 0, 1, 1, 1, 1, 1, 0, 1, 0, 0]",117,63,54,5,6,0.07936507936507936,0.1111111111111111
"[1, 0, 1, 1, 0, 0, 0, 1, 0, 1, 1, 0, 0, 1, 0]",103,58,45,5,3,0.08620689655172414,0.06666666666666667
"[1, 1, 1, 1, 0, 0, 0, 1, 0, 1, 1, 1, 0, 0, 0]",150,64,86,9,9,0.140625,0.10465116279069768
"[1, 0, 1, 0, 1, 1, 1, 0, 1, 0, 0, 0, 0, 1, 0]",89,51,38,6,3,0.11764705882352941,0.07894736842105263
"[0, 1, 0, 0, 1, 0, 0, 0, 0, 0, 1, 0, 1, 0, 1]",232,147,85,12,8,0.08163265306122448,0.09411764705882353
"[0, 0, 1, 1, 0, 0, 1, 0, 0, 1, 0, 0, 0, 1, 1]",188,122,66,8,5,0.06557377049180328,0.07575757575757576
"[1, 0, 0, 1, 1, 1, 1, 1, 0, 1, 1, 0, 0, 0, 1]",169,62,107,6,8,0.0967741935483871,0.07476635514018691
"[0, 1, 0, 0, 1, 1, 1, 1, 1, 0, 1, 1, 0, 0, 0]",133,66,67,7,8,0.10606060606060606,0.11940298507462686
"[0, 1, 1, 1, 0, 0, 1, 1, 1, 0, 1, 0, 1, 0, 1]",149,70,79,10,9,0.14285714285714285,0.11392405063291139
"[0, 0, 1, 1, 1, 1, 1, 0, 0, 1, 1, 0, 0, 1, 1]",565,260,305,23,25,0.08846153846153847,0.08196721311475409
"[0, 1, 1, 0, 1, 0, 1, 1, 1, 0, 0, 1, 1, 1, 1]",414,194,220,17,20,0.08762886597938144,0.09090909090909091
"[1, 1, 1, 0, 0, 0, 1, 1, 0, 0, 0, 0, 1, 1, 0]",298,141,157,20,16,0.14184397163120568,0.10191082802547771
"[0, 0, 0, 1, 1, 0, 0, 1, 1, 0, 1, 0, 1, 0, 1]",171,105,66,13,4,0.12380952380952381,0.06060606060606061
"[1, 0, 1, 0, 0, 0, 1, 1, 0, 0, 1, 0, 1, 0, 0]",123,71,52,6,5,0.08450704225352113,0.09615384615384616
"[1, 1, 1, 0, 1, 1, 1, 0, 1, 0, 0, 1, 0, 0, 0]",104,43,61,5,6,0.11627906976744186,0.09836065573770492
"[0, 1, 0, 0, 0, 0, 1, 0, 1, 1, 1, 0, 1, 1, 0]",114,63,51,10,7,0.15873015873015872,0.13725490196078433
"[0, 1, 0, 1, 0, 0, 1, 1, 1, 1, 0, 0, 1, 0, 1]",113,54,59,5,5,0.09259259259259259,0.0847457627118644
"[0, 1, 0, 0, 0, 1, 1, 0, 1, 1, 0, 1, 1, 0, 1]",101,46,55,4,7,0.08695652173913043,0.12727272727272726
"[1, 1, 0, 1, 1, 0, 0, 0, 0, 1, 0, 0, 1, 0, 0]",145,89,56,0,2,0.0,0.03571428571428571
"[1, 0, 0, 0, 1, 0, 0, 1, 1, 1, 0, 0, 1, 0, 1]",108,56,52,12,3,0.21428571428571427,0.057692307692307696
"[0, 1, 1, 1, 0, 1, 1, 1, 0, 1, 0, 0, 0, 1, 0]",89,45,44,9,5,0.2,0.11363636363636363
"[0, 1, 0, 0, 1, 1, 0, 0, 0, 1, 1, 1, 0, 1, 1]",122,55,67,5,6,0.09090909090909091,0.08955223880597014
"[0, 0, 1, 0, 0, 0, 1, 0, 0, 1, 0, 1, 0, 1, 1]",152,82,70,9,5,0.10975609756097561,0.07142857142857142
"[1, 1, 0, 1, 1, 1, 0, 0, 0, 0, 0, 0, 0, 1, 0]",170,100,70,5,8,0.05,0.11428571428571428
"[0, 0, 1, 0, 0, 0, 1, 1, 1, 1, 0, 0, 0, 0, 1]",325,176,149,7,7,0.03977272727272727,0.04697986577181208
"[1, 1, 0, 1, 0, 0, 0, 1, 0, 1, 1, 0, 1, 1, 0]",106,45,61,2,4,0.044444444444444446,0.06557377049180328
"[0, 0, 1, 1, 1, 0, 1, 0, 0, 0, 1, 0, 1, 1, 0]",112,63,49,3,8,0.047619047619047616,0.16326530612244897
"[1, 1, 0, 1, 1, 1, 1, 0, 0, 1, 0, 1, 0, 1, 1]",287,113,174,11,26,0.09734513274336283,0.14942528735632185
"[0, 1, 0, 0, 1, 0, 1, 1, 0, 1, 1, 0, 1, 1, 1]",163,80,83,5,12,0.0625,0.14457831325301204
"[1, 1, 1, 1, 1, 0, 0, 0, 0, 0, 0, 1, 0, 1, 1]",321,95,226,12,21,0.12631578947368421,0.09292035398230089
"[0, 1, 0, 1, 0, 0, 1, 0, 1, 1, 1, 0, 0, 1, 1]",144,68,76,10,5,0.14705882352941177,0.06578947368421052
"[1, 0, 0, 1, 0, 1, 0, 0, 0, 1, 1, 0, 0, 1, 1]",220,119,101,6,5,0.05042016806722689,0.04950495049504951
"[0, 0, 0, 1, 1, 0, 0, 1, 0, 1, 1, 1, 1, 1, 1]",283,164,119,26,18,0.15853658536585366,0.15126050420168066
"[0, 0, 1, 1, 0, 1, 0, 0, 1, 0, 0, 0, 1, 0, 1]",144,88,56,10,5,0.11363636363636363,0.08928571428571429
"[0, 0, 1, 0, 1, 1, 0, 0, 1, 0, 1, 1, 1, 0, 1]",124,59,65,2,11,0.03389830508474576,0.16923076923076924
"[0, 1, 0, 0, 1, 1, 0, 1, 1, 0, 1, 0, 0, 1, 1]",136,64,72,3,4,0.046875,0.05555555555555555
"[0, 0, 1, 0, 0, 1, 1, 0, 1, 1, 0, 1, 0, 0, 1]",106,57,49,5,6,0.08771929824561403,0.12244897959183673
"[0, 0, 0, 0, 0, 1, 1, 0, 1, 1, 0, 0, 1, 0, 0]",296,193,103,21,6,0.10880829015544041,0.05825242718446602
"[0, 1, 0, 1, 0, 0, 0, 0, 0, 1, 0, 1, 1, 1, 1]",167,99,68,10,8,0.10101010101010101,0.11764705882352941
"[1, 1, 0, 1, 0, 0, 1, 1, 0, 0, 0, 1, 0, 1, 1]",117,55,62,10,6,0.18181818181818182,0.0967741935483871
"[0, 0, 0, 1, 0, 1, 0, 1, 0, 1, 0, 1, 0, 1, 1]",133,84,49,5,6,0.05952380952380952,0.12244897959183673
"[1, 0, 1, 0, 0, 0, 1, 0, 1, 0, 1, 0, 1, 0, 1]",96,41,55,8,5,0.1951219512195122,0.09090909090909091
"[1, 1, 0, 1, 1, 1, 1, 0, 1, 1, 0, 1, 0, 0, 1]",234,101,133,9,11,0.0891089108910891,0.08270676691729323
"[0, 0, 1, 1, 1, 0, 0, 1, 1, 1, 0, 1, 1, 1, 1]",333,124,209,9,21,0.07258064516129033,0.10047846889952153
"[1, 1, 0, 1, 0, 0, 0, 1, 1, 0, 0, 1, 0, 1, 0]",106,59,47,4,3,0.06779661016949153,0.06382978723404255
"[0, 0, 0, 1, 1, 0, 0, 0, 1, 1, 0, 1, 1, 0, 1]",140,77,63,9,8,0.11688311688311688,0.12698412698412698
"[1, 0, 1, 1, 1, 0, 1, 0, 0, 1, 0, 0, 1, 1, 1]",159,68,91,6,12,0.08823529411764706,0.13186813186813187
"[1, 0, 1, 0, 1, 1, 1, 0, 1, 0, 0, 0, 1, 1, 1]",168,63,105,8,8,0.12698412698412698,0.0761904761904762
"[0, 1, 0, 1, 0, 1, 0, 1, 1, 1, 1, 0, 0, 1, 1]",225,86,139,4,12,0.046511627906976744,0.08633093525179857
"[1, 1, 1, 0, 1, 0, 1, 0, 0, 0, 0, 1, 0, 1, 1]",124,50,74,4,10,0.08,0.13513513513513514
"[0, 1, 1, 0, 0, 0, 1, 0, 0, 1, 1, 0, 0, 1, 0]",131,71,60,11,5,0.15492957746478872,0.08333333333333333
"[0, 1, 1, 1, 0, 1, 0, 0, 1, 1, 0, 0, 1, 1, 0]",194,92,102,3,11,0.03260869565217391,0.10784313725490197
"[1, 0, 0, 0, 0, 1, 1, 1, 0, 1, 0, 0, 1, 1, 0]",121,58,63,4,6,0.06896551724137931,0.09523809523809523
"[0, 0, 1, 1, 0, 1, 0, 1, 0, 0, 1, 0, 1, 1, 0]",118,72,46,8,3,0.1111111111111111,0.06521739130434782
"[1, 0, 0, 0, 1, 1, 1, 0, 1, 1, 1, 1, 1, 0, 1]",233,80,153,10,14,0.125,0.0915032679738562
"[1, 0, 0, 0, 0, 0, 1, 0, 0, 0, 1, 0, 1, 1, 0]",241,143,98,16,9,0.11188811188811189,0.09183673469387756
"[0, 1, 1, 0, 1, 0, 1, 1, 0, 1, 0, 1, 0, 0, 0]",98,54,44,5,3,0.09259259259259259,0.06818181818181818
"[1, 0, 1, 1, 1, 0, 0, 0, 1, 1, 0, 1, 0, 1, 1]",152,61,91,11,6,0.18032786885245902,0.06593406593406594
"[0, 1, 1, 0, 0, 1, 0, 1, 0, 0, 1, 1, 0, 1, 0]",100,49,51,4,5,0.08163265306122448,0.09803921568627451
"[0, 1, 1, 1, 0, 0, 0, 1, 1, 0, 0, 1, 0, 1, 0]",111,58,53,5,6,0.08620689655172414,0.11320754716981132
"[0, 0, 0, 0, 0, 0, 1, 1, 0, 1, 0, 1, 0, 1, 1]",237,141,96,16,7,0.11347517730496454,0.07291666666666667
"[1, 0, 0, 1, 0, 1, 0, 0, 0, 1, 1, 1, 0, 1, 1]",127,63,64,7,7,0.1111111111111111,0.109375
"[1, 1, 0, 0, 1, 1, 0, 1, 1, 0, 1, 0, 0, 1, 0]",126,57,69,6,2,0.10526315789473684,0.028985507246376812
"[1, 0, 1, 1, 1, 1, 0, 1, 0, 1, 1, 0, 0, 0, 0]",164,75,89,8,6,0.10666666666666667,0.06741573033707865
"[1, 0, 0, 1, 0, 0, 0, 0, 1, 1, 1, 0, 0, 0, 0]",329,216,113,24,10,0.1111111111111111,0.08849557522123894
"[1, 0, 1, 1, 1, 0, 1, 1, 0, 1, 1, 0, 0, 0, 1]",141,60,81,8,12,0.13333333333333333,0.14814814814814814
"[0, 0, 0, 0, 1, 0, 1, 0, 0, 0, 0, 0, 1, 0, 1]",534,379,155,29,15,0.07651715039577836,0.0967741935483871
"[0, 0, 1, 1, 1, 1, 1, 1, 0, 0, 1, 0, 1, 0, 0]",193,107,86,13,10,0.12149532710280374,0.11627906976744186
"[1, 0, 0, 0, 1, 1, 1, 1, 1, 1, 0, 0, 1, 0, 1]",199,78,121,9,8,0.11538461538461539,0.06611570247933884
"[0, 1, 0, 1, 0, 1, 0, 0, 0, 0, 0, 0, 1, 0, 1]",237,164,73,16,5,0.0975609756097561,0.0684931506849315
"[0, 0, 0, 0, 1, 1, 0, 1, 1, 0, 1, 1, 0, 0, 0]",203,112,91,10,8,0.08928571428571429,0.08791208791208792
"[0, 1, 1, 0, 1, 0, 0, 0, 0, 1, 1, 1, 0, 1, 0]",108,56,52,3,3,0.05357142857142857,0.057692307692307696
"[0, 0, 1, 1, 0, 1, 0, 0, 0, 0, 1, 1, 1, 0, 1]",110,62,48,4,6,0.06451612903225806,0.125
"[0, 0, 0, 1, 1, 1, 0, 1, 1, 1, 1, 0, 0, 0, 0]",225,118,107,8,16,0.06779661016949153,0.14953271028037382
"[0, 1, 1, 1, 0, 0, 1, 0, 1, 1, 0, 0, 1, 0, 0]",106,54,52,5,2,0.09259259259259259,0.038461538461538464
"[0, 1, 1, 1, 1, 1, 0, 1, 1, 0, 0, 0, 0, 0, 0]",251,129,122,8,8,0.06201550387596899,0.06557377049180328
"[1, 0, 0, 1, 0, 1, 1, 1, 0, 0, 0, 1, 1, 1, 0]",125,59,66,1,9,0.01694915254237288,0.13636363636363635
"[1, 0, 1, 0, 1, 0, 1, 0, 0, 0, 1, 0, 0, 0, 0]",250,153,97,12,11,0.0784313725490196,0.1134020618556701
"[0, 1, 0, 1, 0, 0, 1, 1, 0, 1, 1, 0, 0, 0, 0]",185,109,76,5,4,0.045871559633027525,0.05263157894736842
"[1, 1, 0, 0, 1, 0, 1, 0, 0, 1, 1, 0, 1, 1, 0]",105,46,59,7,6,0.15217391304347827,0.1016949152542373
"[1, 1, 0, 0, 1, 1, 0, 0, 1, 0, 1, 0, 0, 1, 1]",200,96,104,12,13,0.125,0.125
"[1, 0, 0, 1, 1, 1, 0, 0, 0, 0, 0, 1, 1, 1, 0]",141,77,64,10,10,0.12987012987012986,0.15625
"[1, 0, 1, 1, 1, 1, 1, 0, 0, 0, 0, 0, 0, 1, 1]",475,215,260,19,23,0.08837209302325581,0.08846153846153847
"[1, 0, 1, 1, 1, 0, 1, 0, 0, 0, 1, 0, 1, 1, 0]",112,56,56,5,5,0.08928571428571429,0.08928571428571429
"[0, 1, 1, 0, 0, 1, 0, 1, 1, 1, 0, 1, 0, 0, 0]",132,74,58,10,6,0.13513513513513514,0.10344827586206896
"[0, 1, 0, 0, 1, 0, 0, 1, 1, 0, 0, 1, 1, 1, 0]",126,66,60,3,6,0.045454545454545456,0.1
"[1, 1, 1, 0, 1, 0, 0, 1, 1, 1, 0, 1, 0, 0, 1]",149,67,82,8,8,0.11940298507462686,0.0975609756097561
"[1, 1, 0, 1, 1, 0, 0, 1, 1, 0, 1, 0, 0, 1, 0]",119,56,63,4,7,0.07142857142857142,0.1111111111111111
"[0, 1, 0, 1, 1, 1, 0, 1, 1, 0, 0, 1, 1, 0, 1]",138,61,77,4,7,0.06557377049180328,0.09090909090909091
"[1, 1, 1, 0, 0, 0, 1, 0, 1, 1, 0, 1, 1, 1, 0]",169,59,110,5,5,0.0847457627118644,0.045454545454545456
"[1, 1, 0, 1, 1, 0, 0, 0, 1, 0, 1, 0, 1, 1, 0]",125,64,61,5,5,0.078125,0.08196721311475409
"[0, 0, 0, 1, 1, 0, 1, 1, 1, 0, 1, 1, 0, 1, 1]",164,79,85,5,7,0.06329113924050633,0.08235294117647059
"[1, 1, 1, 0, 1, 1, 0, 0, 1, 0, 1, 0, 0, 0, 0]",128,64,64,5,1,0.078125,0.015625
"[0, 1, 0, 1, 0, 0, 0, 1, 1, 0, 0, 1, 0, 0, 0]",252,177,75,24,5,0.13559322033898305,0.06666666666666667
"[0, 1, 1, 1, 0, 0, 1, 0, 1, 0, 0, 1, 0, 0, 1]",118,57,61,7,5,0.12280701754385964,0.08196721311475409
"[0, 0, 1, 1, 1, 0, 1, 1, 1, 0, 0, 1, 0, 1, 0]",114,52,62,3,9,0.057692307692307696,0.14516129032258066
"[1, 0, 0, 0, 0, 0, 1, 1, 1, 1, 0, 0, 0, 1, 1]",196,97,99,13,18,0.13402061855670103,0.18181818181818182
"[1, 1, 0, 1, 1, 1, 1, 1, 1, 0, 0, 1, 0, 1, 0]",255,94,161,7,21,0.07446808510638298,0.13043478260869565
"[0, 1, 0, 0, 1, 0, 0, 1, 1, 1, 0, 0, 0, 0, 1]",180,104,76,12,5,0.11538461538461539,0.06578947368421052
"[0, 0, 0, 1, 1, 1, 1, 1, 0, 0, 0, 0, 0, 1, 0]",192,119,73,7,5,0.058823529411764705,0.0684931506849315
"[1, 1, 0, 0, 0, 0, 1, 1, 0, 0, 1, 0, 1, 1, 1]",383,193,190,19,21,0.09844559585492228,0.11052631578947368
"[1, 0, 1, 1, 1, 0, 0, 1, 0, 1, 0, 0, 1, 0, 1]",113,52,61,5,11,0.09615384615384616,0.18032786885245902
"[1, 0, 1, 1, 0, 1, 0, 1, 1, 1, 1, 0, 1, 1, 0]",236,90,146,9,17,0.1,0.11643835616438356
"[0, 1, 1, 1, 1, 1, 0, 1, 1, 0, 1, 1, 0, 1, 0]",223,86,137,6,9,0.06976744186046512,0.06569343065693431
"[1, 0, 1, 1, 1, 1, 1, 0, 0, 0, 0, 1, 0, 0, 1]",136,75,61,9,6,0.12,0.09836065573770492
"[1, 0, 1, 0, 1, 0, 0, 0, 1, 1, 0, 1, 1, 0, 1]",93,40,53,5,4,0.125,0.07547169811320754
"[1, 0, 0, 1, 1, 1, 0, 1, 1, 0, 0, 1, 1, 1, 1]",427,135,292,11,20,0.08148148148148149,0.0684931506849315
"[1, 0, 0, 1, 1, 1, 1, 0, 1, 1, 0, 1, 1, 0, 0]",204,56,148,5,16,0.08928571428571429,0.10810810810810811
"[1, 1, 1, 0, 0, 0, 1, 1, 0, 0, 1, 1, 0, 0, 0]",276,123,153,16,12,0.13008130081300814,0.0784313725490196
"[0, 0, 1, 1, 0, 1, 1, 1, 0, 0, 0, 1, 1, 0, 0]",155,66,89,7,8,0.10606060606060606,0.0898876404494382
"[0, 1, 1, 1, 1, 0, 0, 1, 0, 1, 1, 0, 1, 1, 0]",155,76,79,8,5,0.10526315789473684,0.06329113924050633
"[0, 1, 0, 1, 1, 0, 1, 0, 1, 1, 0, 1, 0, 0, 1]",110,52,58,6,8,0.11538461538461539,0.13793103448275862
"[0, 1, 1, 0, 0, 1, 0, 1, 1, 0, 1, 0, 1, 1, 0]",108,60,48,7,5,0.11666666666666667,0.10416666666666667
"[1, 0, 0, 0, 1, 0, 0, 1, 1, 0, 0, 1, 0, 1, 1]",133,70,63,7,6,0.1,0.09523809523809523
"[1, 1, 0, 0, 1, 0, 0, 1, 1, 0, 0, 1, 0, 1, 1]",102,59,43,3,5,0.05084745762711865,0.11627906976744186
"[1, 0, 1, 1, 1, 1, 0, 0, 0, 0, 0, 1, 1, 1, 0]",135,57,78,6,7,0.10526315789473684,0.08974358974358974
"[1, 1, 0, 1, 1, 1, 1, 0, 0, 0, 0, 0, 0, 1, 1]",478,209,269,18,28,0.0861244019138756,0.10408921933085502
"[0, 0, 1, 0, 0, 0, 0, 0, 1, 0, 0, 0, 1, 1, 1]",478,340,138,32,18,0.09411764705882353,0.13043478260869565
"[0, 0, 1, 1, 1, 0, 1, 0, 1, 1, 1, 1, 0, 0, 0]",180,83,97,10,8,0.12048192771084337,0.08247422680412371
"[0, 0, 0, 1, 1, 1, 0, 1, 0, 1, 1, 1, 1, 0, 0]",178,94,84,9,9,0.09574468085106383,0.10714285714285714
"[1, 1, 0, 0, 0, 0, 0, 1, 1, 0, 0, 0, 1, 1, 0]",199,117,82,14,7,0.11965811965811966,0.08536585365853659
"[1, 1, 1, 0, 0, 0, 1, 1, 1, 0, 1, 0, 1, 1, 0]",146,53,93,6,11,0.11320754716981132,0.11827956989247312
"[0, 0, 1, 0, 0, 1, 1, 0, 1, 0, 1, 0, 0, 1, 1]",127,70,57,3,4,0.04285714285714286,0.07017543859649122
"[0, 0, 1, 1, 0, 0, 0, 0, 0, 1, 0, 0, 1, 1, 0]",342,217,125,29,15,0.1336405529953917,0.12
"[0, 0, 1, 0, 0, 1, 1, 1, 0, 1, 1, 0, 0, 1, 1]",146,75,71,8,6,0.10666666666666667,0.08450704225352113
"[0, 1, 1, 0, 1, 0, 1, 0, 1, 1, 0, 1, 0, 1, 0]",92,46,46,7,5,0.15217391304347827,0.10869565217391304
"[1, 1, 1, 1, 0, 0, 0, 0, 0, 1, 0, 0, 0, 1, 1]",219,121,98,15,5,0.12396694214876033,0.05102040816326531
"[1, 0, 0, 0, 0, 1, 1, 1, 0, 1, 0, 0, 1, 1, 1]",241,83,158,10,8,0.12048192771084337,0.05063291139240506
"[1, 1, 1, 0, 0, 1, 1, 0, 1, 1, 1, 0, 1, 0, 1]",268,83,185,15,11,0.18072289156626506,0.05945945945945946
"[0, 0, 1, 1, 1, 1, 1, 0, 1, 0, 0, 1, 1, 0, 1]",148,66,82,7,6,0.10606060606060606,0.07317073170731707
"[1, 0, 0, 0, 1, 1, 1, 0, 1, 1, 1, 0, 0, 1, 1]",192,57,135,2,14,0.03508771929824561,0.1037037037037037
"[0, 1, 0, 0, 0, 1, 1, 1, 0, 1, 1, 1, 0, 0, 1]",86,36,50,1,5,0.027777777777777776,0.1
"[0, 0, 1, 1, 1, 1, 0, 0, 1, 1, 1, 1, 1, 0, 1]",711,236,475,33,41,0.13983050847457626,0.0863157894736842
"[0, 1, 0, 0, 0, 0, 1, 1, 1, 1, 1, 1, 1, 0, 1]",204,84,120,9,7,0.10714285714285714,0.058333333333333334
"[0, 1, 1, 1, 1, 0, 0, 0, 0, 1, 1, 1, 0, 0, 0]",269,180,89,16,8,0.08888888888888889,0.0898876404494382
"[0, 0, 0, 1, 0, 0, 1, 0, 1, 0, 0, 1, 1, 0, 0]",328,210,118,17,13,0.08095238095238096,0.11016949152542373
"[0, 1, 0, 1, 0, 1, 1, 0, 0, 1, 0, 0, 0, 0, 0]",272,173,99,13,10,0.07514450867052024,0.10101010101010101
"[0, 0, 0, 0, 1, 1, 0, 1, 1, 1, 1, 0, 0, 0, 0]",283,178,105,17,14,0.09550561797752809,0.13333333333333333
"[0, 0, 0, 1, 0, 1, 1, 1, 0, 1, 1, 1, 1, 0, 1]",131,66,65,11,6,0.16666666666666666,0.09230769230769231
"[0, 0, 0, 0, 1, 0, 1, 1, 1, 0, 1, 1, 1, 1, 0]",136,55,81,6,8,0.10909090909090909,0.09876543209876543
"[0, 1, 0, 1, 0, 0, 1, 1, 1, 1, 0, 0, 0, 0, 1]",271,137,134,20,7,0.145985401459854,0.05223880597014925
"[0, 0, 0, 0, 1, 1, 1, 0, 1, 0, 0, 0, 1, 0, 1]",146,88,58,6,1,0.06818181818181818,0.017241379310344827
"[0, 0, 1, 1, 1, 0, 1, 0, 0, 0, 0, 1, 1, 1, 0]",134,68,66,5,9,0.07352941176470588,0.13636363636363635
"[0, 1, 1, 0, 1, 0, 0, 1, 1, 0, 1, 0, 1, 0, 0]",110,57,53,4,2,0.07017543859649122,0.03773584905660377
"[1, 1, 1, 1, 0, 1, 1, 1, 1, 1, 0, 1, 0, 0, 1]",628,188,440,19,43,0.10106382978723404,0.09772727272727273
"[1, 0, 1, 1, 0, 0, 1, 0, 0, 1, 1, 1, 0, 1, 0]",110,53,57,6,6,0.11320754716981132,0.10526315789473684
"[0, 1, 0, 0, 0, 1, 0, 0, 1, 0, 0, 0, 0, 0, 1]",514,361,153,29,17,0.08033240997229917,0.1111111111111111
"[0, 0, 1, 1, 1, 1, 0, 0, 1, 0, 0, 1, 0, 1, 0]",150,71,79,7,6,0.09859154929577464,0.0759493670886076
"[1, 0, 0, 1, 1, 1, 1, 0, 0, 1, 0, 0, 1, 0, 1]",142,47,95,6,6,0.1276595744680851,0.06315789473684211
"[0, 0, 0, 1, 1, 1, 1, 0, 1, 1, 1, 0, 1, 1, 0]",163,77,86,11,8,0.14285714285714285,0.09302325581395349
"[0, 1, 0, 0, 1, 0, 1, 0, 1, 1, 1, 0, 0, 1, 0]",113,58,55,6,6,0.10344827586206896,0.10909090909090909
"[1, 0, 1, 1, 0, 0, 1, 1, 1, 0, 0, 0, 1, 1, 1]",218,91,127,8,9,0.08791208791208792,0.07086614173228346
"[1, 1, 0, 0, 1, 1, 1, 0, 1, 1, 1, 1, 1, 0, 0]",359,119,240,10,15,0.08403361344537816,0.0625
"[1, 1, 0, 0, 0, 0, 1, 1, 1, 0, 0, 0, 1, 0, 0]",189,107,82,8,13,0.07476635514018691,0.15853658536585366
"[1, 1, 1, 0, 0, 1, 0, 1, 0, 1, 0, 0, 0, 1, 1]",144,59,85,4,10,0.06779661016949153,0.11764705882352941
"[1, 1, 0, 0, 0, 1, 0, 0, 1, 1, 1, 0, 0, 1, 1]",193,91,102,7,10,0.07692307692307693,0.09803921568627451
"[0, 0, 1, 1, 1, 1, 0, 0, 1, 0, 0, 0, 0, 1, 0]",190,117,73,13,7,0.1111111111111111,0.0958904109589041
"[0, 0, 1, 0, 1, 1, 1, 0, 1, 0, 0, 0, 1, 1, 1]",140,71,69,7,7,0.09859154929577464,0.10144927536231885
"[0, 0, 1, 0, 1, 1, 1, 0, 1, 0, 1, 0, 1, 0, 1]",114,55,59,3,7,0.05454545454545454,0.11864406779661017
"[0, 0, 0, 1, 0, 0, 0, 1, 1, 0, 1, 0, 1, 1, 0]",134,81,53,9,2,0.1111111111111111,0.03773584905660377
"[1, 0, 0, 0, 1, 1, 1, 1, 0, 1, 1, 0, 0, 0, 1]",122,57,65,7,8,0.12280701754385964,0.12307692307692308
"[0, 1, 1, 0, 1, 1, 0, 0, 0, 1, 1, 1, 1, 0, 0]",219,117,102,16,12,0.13675213675213677,0.11764705882352941
"[0, 1, 0, 1, 0, 0, 1, 1, 0, 0, 0, 1, 0, 0, 1]",136,89,47,9,6,0.10112359550561797,0.1276595744680851
"[1, 1, 0, 0, 1, 1, 0, 1, 1, 0, 1, 1, 1, 1, 0]",285,100,185,5,20,0.05,0.10810810810810811
"[1, 1, 0, 1, 0, 0, 1, 0, 1, 0, 0, 1, 1, 1, 0]",89,43,46,0,4,0.0,0.08695652173913043
"[0, 1, 0, 1, 0, 1, 0, 0, 0, 0, 1, 1, 0, 1, 0]",164,99,65,14,9,0.1414141414141414,0.13846153846153847
"[0, 0, 1, 0, 1, 0, 1, 0, 0, 0, 0, 1, 1, 0, 1]",172,96,76,10,14,0.10416666666666667,0.18421052631578946
"[0, 0, 1, 1, 0, 1, 1, 1, 0, 1, 0, 1, 0, 1, 0]",119,58,61,9,4,0.15517241379310345,0.06557377049180328
"[1, 0, 1, 1, 0, 0, 0, 0, 1, 1, 1, 0, 1, 1, 1]",186,68,118,12,14,0.17647058823529413,0.11864406779661017
"[0, 0, 0, 0, 1, 1, 0, 1, 1, 1, 1, 0, 1, 0, 1]",130,56,74,8,7,0.14285714285714285,0.0945945945945946
"[1, 0, 0, 0, 0, 1, 1, 0, 1, 0, 1, 1, 1, 1, 1]",302,76,226,9,25,0.11842105263157894,0.11061946902654868
"[0, 1, 0, 1, 1, 1, 1, 0, 0, 0, 0, 1, 0, 0, 0]",178,106,72,7,6,0.0660377358490566,0.08333333333333333
"[0, 1, 1, 0, 0, 1, 1, 1, 0, 0, 0, 1, 1, 1, 0]",129,69,60,7,6,0.10144927536231885,0.1
"[1, 0, 1, 1, 0, 1, 1, 0, 1, 1, 0, 1, 0, 0, 1]",143,59,84,8,6,0.13559322033898305,0.07142857142857142
"[0, 0, 0, 1, 0, 1, 0, 1, 1, 0, 0, 1, 0, 1, 1]",125,77,48,8,3,0.1038961038961039,0.0625
"[0, 0, 0, 0, 0, 1, 0, 1, 0, 1, 1, 0, 0, 0, 1]",263,180,83,14,8,0.07777777777777778,0.0963855421686747
"[1, 1, 0, 0, 0, 0, 0, 0, 0, 1, 0, 1, 1, 1, 1]",353,189,164,18,13,0.09523809523809523,0.07926829268292683
"[1, 0, 1, 0, 1, 0, 1, 0, 0, 1, 0, 0, 0, 0, 1]",127,70,57,4,5,0.05714285714285714,0.08771929824561403
"[1, 1, 0, 1, 0, 1, 0, 0, 1, 0, 0, 1, 1, 1, 1]",186,80,106,9,7,0.1125,0.0660377358490566
"[0, 0, 0, 1, 0, 1, 1, 1, 1, 0, 1, 0, 1, 0, 0]",110,54,56,4,6,0.07407407407407407,0.10714285714285714
"[1, 1, 1, 0, 0, 1, 0, 0, 0, 1, 1, 1, 1, 1, 0]",197,80,117,10,14,0.125,0.11965811965811966
"[0, 0, 1, 1, 0, 1, 1, 1, 0, 1, 1, 0, 1, 1, 1]",271,108,163,9,12,0.08333333333333333,0.0736196319018405
"[1, 0, 0, 1, 1, 1, 1, 0, 1, 1, 0, 1, 0, 0, 0]",156,66,90,5,11,0.07575757575757576,0.12222222222222222
"[0, 0, 0, 1, 1, 0, 1, 0, 1, 1, 1, 0, 0, 1, 1]",170,93,77,7,8,0.07526881720430108,0.1038961038961039
"[1, 1, 1, 0, 0, 0, 1, 1, 0, 1, 0, 1, 1, 1, 0]",142,54,88,2,7,0.037037037037037035,0.07954545454545454
"[1, 1, 0, 0, 0, 1, 1, 1, 0, 1, 1, 1, 0, 0, 0]",137,63,74,11,3,0.1746031746031746,0.04054054054054054
"[1, 0, 1, 0, 0, 0, 1, 1, 1, 1, 0, 0, 1, 1, 0]",252,110,142,6,17,0.05454545454545454,0.11971830985915492
"[1, 0, 1, 1, 0, 0, 1, 0, 1, 0, 0, 1, 1, 0, 1]",104,50,54,3,5,0.06,0.09259259259259259
"[1, 0, 0, 0, 0, 1, 0, 0, 1, 1, 0, 1, 1, 1, 0]",109,53,56,3,7,0.05660377358490566,0.125
"[0, 1, 1, 0, 1, 1, 1, 1, 0, 0, 0, 0, 0, 1, 0]",126,63,63,5,4,0.07936507936507936,0.06349206349206349
"[1, 0, 1, 1, 1, 1, 0, 0, 0, 1, 0, 0, 1, 1, 1]",182,83,99,11,12,0.13253012048192772,0.12121212121212122
"[1, 0, 1, 1, 1, 0, 1, 1, 0, 0, 1, 1, 1, 1, 0]",290,99,191,11,16,0.1111111111111111,0.08376963350785341
"[0, 0, 1, 0, 1, 1, 1, 1, 1, 0, 1, 0, 0, 1, 0]",109,52,57,6,3,0.11538461538461539,0.05263157894736842
"[0, 1, 1, 0, 1, 1, 0, 0, 1, 1, 0, 1, 0, 1, 1]",168,78,90,9,13,0.11538461538461539,0.14444444444444443
"[1, 0, 1, 0, 1, 0, 0, 0, 0, 1, 1, 1, 1, 0, 1]",117,52,65,1,5,0.019230769230769232,0.07692307692307693
"[1, 1, 0, 0, 1, 1, 0, 1, 0, 1, 0, 1, 1, 0, 0]",161,87,74,16,4,0.1839080459770115,0.05405405405405406
"[0, 1, 1, 0, 0, 1, 1, 0, 1, 0, 1, 1, 1, 0, 0]",167,80,87,8,6,0.1,0.06896551724137931
"[1, 0, 0, 0, 1, 1, 0, 1, 1, 0, 1, 0, 0, 1, 0]",98,49,49,5,3,0.10204081632653061,0.061224489795918366
"[1, 1, 1, 0, 0, 0, 1, 1, 0, 0, 1, 0, 1, 0, 1]",116,52,64,3,4,0.057692307692307696,0.0625
"[0, 0, 1, 1, 1, 0, 0, 1, 0, 1, 1, 1, 0, 1, 0]",88,40,48,4,3,0.1,0.0625
"[0, 1, 1, 0, 0, 0, 0, 1, 0, 1, 0, 0, 1, 0, 1]",149,102,47,10,5,0.09803921568627451,0.10638297872340426
"[0, 1, 1, 0, 1, 0, 0, 1, 0, 0, 0, 1, 1, 0, 0]",173,86,87,12,5,0.13953488372093023,0.05747126436781609
"[1, 0, 0, 0, 0, 1, 0, 0, 0, 0, 0, 1, 0, 0, 1]",572,365,207,45,15,0.1232876712328767,0.07246376811594203
"[1, 1, 1, 0, 1, 1, 1, 0, 1, 0, 1, 1, 1, 0, 0]",288,91,197,10,16,0.10989010989010989,0.08121827411167512
"[0, 1, 1, 1, 0, 1, 0, 1, 0, 0, 1, 0, 0, 1, 0]",88,44,44,2,7,0.045454545454545456,0.1590909090909091
"[1, 1, 0, 0, 0, 1, 1, 0, 0, 0, 1, 1, 1, 0, 1]",126,58,68,4,5,0.06896551724137931,0.07352941176470588
"[0, 1, 1, 0, 0, 0, 1, 1, 0, 0, 0, 1, 1, 1, 0]",131,76,55,10,8,0.13157894736842105,0.14545454545454545
"[1, 0, 0, 1, 0, 0, 0, 0, 1, 0, 1, 1, 1, 1, 0]",119,63,56,8,9,0.12698412698412698,0.16071428571428573
"[0, 1, 1, 1, 1, 0, 0, 1, 0, 0, 0, 0, 1, 0, 1]",129,79,50,9,4,0.11392405063291139,0.08
"[1, 1, 1, 1, 0, 1, 1, 1, 1, 1, 1, 0, 0, 1, 0]",550,155,395,18,33,0.11612903225806452,0.08354430379746836
"[1, 1, 1, 0, 1, 0, 1, 1, 0, 1, 1, 0, 1, 0, 1]",225,77,148,7,15,0.09090909090909091,0.10135135135135136
"[0, 1, 0, 1, 1, 1, 1, 1, 1, 0, 1, 0, 0, 1, 1]",277,98,179,8,17,0.08163265306122448,0.09497206703910614
"[0, 0, 0, 0, 1, 1, 0, 1, 0, 1, 0, 1, 0, 1, 1]",162,88,74,12,6,0.13636363636363635,0.08108108108108109
"[0, 0, 1, 0, 1, 1, 1, 1, 1, 1, 0, 1, 1, 1, 0]",229,84,145,7,18,0.08333333333333333,0.12413793103448276
"[1, 1, 0, 0, 0, 0, 1, 1, 1, 0, 0, 1, 0, 0, 0]",213,115,98,12,9,0.10434782608695652,0.09183673469387756
"[1, 0, 1, 0, 0, 0, 1, 1, 1, 1, 0, 1, 0, 0, 0]",133,75,58,4,5,0.05333333333333334,0.08620689655172414
"[0, 0, 1, 0, 0, 0, 1, 0, 1, 1, 0, 1, 1, 1, 1]",169,88,81,8,7,0.09090909090909091,0.08641975308641975
"[1, 1, 1, 1, 0, 1, 1, 0, 0, 0, 1, 0, 0, 0, 0]",119,59,60,7,7,0.11864406779661017,0.11666666666666667
"[1, 1, 0, 0, 1, 0, 1, 1, 1, 0, 1, 0, 0, 0, 0]",135,75,60,7,6,0.09333333333333334,0.1
"[1, 0, 0, 0, 1, 0, 1, 1, 0, 1, 0, 0, 0, 1, 1]",164,71,93,8,11,0.11267605633802817,0.11827956989247312
"[1, 1, 0, 1, 0, 1, 0, 0, 0, 0, 0, 0, 0, 1, 0]",255,169,86,15,7,0.08875739644970414,0.08139534883720931
"[1, 1, 1, 1, 1, 0, 1, 0, 1, 1, 0, 1, 0, 1, 1]",569,141,428,12,39,0.0851063829787234,0.0911214953271028
"[0, 1, 1, 0, 0, 1, 1, 0, 0, 0, 1, 1, 0, 0, 1]",211,141,70,12,8,0.0851063829787234,0.11428571428571428
"[0, 0, 1, 0, 0, 0, 1, 0, 1, 1, 0, 0, 1, 1, 0]",235,136,99,15,10,0.11029411764705882,0.10101010101010101
"[0, 0, 0, 0, 1, 1, 1, 0, 1, 1, 1, 1, 1, 0, 0]",206,101,105,6,9,0.0594059405940594,0.08571428571428572
"[1, 0, 1, 1, 0, 0, 0, 0, 0, 1, 1, 1, 0, 0, 1]",143,77,66,4,4,0.05194805194805195,0.06060606060606061
"[1, 1, 0, 0, 0, 0, 0, 1, 0, 1, 0, 0, 1, 1, 1]",244,130,114,14,14,0.1076923076923077,0.12280701754385964
"[0, 0, 1, 0, 1, 1, 1, 0, 0, 0, 1, 1, 1, 1, 0]",152,77,75,7,6,0.09090909090909091,0.08
"[0, 0, 1, 0, 0, 0, 1, 1, 1, 1, 1, 0, 0, 1, 1]",221,110,111,11,13,0.1,0.11711711711711711
"[1, 1, 1, 1, 1, 0, 1, 1, 1, 0, 0, 0, 1, 0, 1]",266,86,180,6,20,0.06976744186046512,0.1111111111111111
"[0, 0, 0, 0, 1, 0, 0, 0, 1, 0, 0, 1, 1, 1, 1]",314,197,117,16,9,0.08121827411167512,0.07692307692307693
"[0, 0, 1, 1, 0, 1, 1, 0, 0, 1, 0, 0, 0, 1, 0]",136,86,50,11,5,0.12790697674418605,0.1
"[0, 0, 1, 0, 1, 1, 1, 1, 1, 1, 1, 0, 1, 0, 1]",229,92,137,15,13,0.16304347826086957,0.0948905109489051
"[1, 0, 0, 1, 1, 1, 0, 1, 1, 0, 0, 1, 0, 1, 0]",129,69,60,10,4,0.14492753623188406,0.06666666666666667
"[1, 1, 0, 1, 1, 0, 0, 0, 1, 0, 1, 1, 0, 0, 0]",130,70,60,5,1,0.07142857142857142,0.016666666666666666
"[1, 0, 1, 0, 0, 1, 0, 0, 1, 1, 1, 0, 1, 1, 0]",115,57,58,2,3,0.03508771929824561,0.05172413793103448
"[0, 0, 1, 0, 1, 0, 1, 0, 0, 1, 0, 0, 1, 1, 1]",168,87,81,5,6,0.05747126436781609,0.07407407407407407
"[0, 0, 0, 0, 0, 1, 0, 1, 0, 1, 0, 0, 1, 1, 1]",288,185,103,15,12,0.08108108108108109,0.11650485436893204
"[0, 0, 1, 0, 0, 0, 1, 1, 1, 1, 1, 0, 1, 1, 0]",128,64,64,2,6,0.03125,0.09375
"[0, 1, 1, 0, 0, 1, 1, 1, 0, 1, 1, 1, 1, 0, 1]",257,118,139,12,18,0.1016949152542373,0.12949640287769784
"[1, 1, 0, 1, 0, 0, 0, 0, 1, 0, 0, 0, 1, 0, 1]",143,80,63,7,5,0.0875,0.07936507936507936
"[0, 0, 0, 1, 0, 1, 0, 0, 0, 0, 0, 1, 0, 1, 1]",309,206,103,20,7,0.0970873786407767,0.06796116504854369
"[0, 0, 1, 1, 1, 1, 0, 0, 0, 1, 0, 1, 1, 1, 1]",368,147,221,12,20,0.08163265306122448,0.09049773755656108
"[0, 1, 0, 0, 0, 0, 0, 1, 1, 1, 0, 1, 1, 0, 0]",152,86,66,5,2,0.05813953488372093,0.030303030303030304
"[1, 1, 1, 1, 0, 0, 0, 1, 0, 0, 0, 0, 0, 1, 0]",174,98,76,10,10,0.10204081632653061,0.13157894736842105
"[0, 0, 0, 0, 1, 1, 1, 0, 1, 1, 1, 0, 0, 0, 1]",142,87,55,4,1,0.04597701149425287,0.01818181818181818
"[1, 0, 1, 0, 1, 1, 1, 1, 0, 1, 0, 0, 0, 1, 0]",114,43,71,4,4,0.09302325581395349,0.056338028169014086
"[0, 1, 1, 1, 1, 0, 0, 1, 0, 0, 0, 1, 0, 1, 0]",94,51,43,8,6,0.1568627450980392,0.13953488372093023
"[0, 0, 0, 0, 1, 1, 1, 1, 0, 0, 1, 0, 0, 0, 1]",276,177,99,22,7,0.12429378531073447,0.0707070707070707
"[1, 1, 1, 1, 0, 1, 0, 1, 0, 1, 0, 0, 0, 0, 0]",145,79,66,6,5,0.0759493670886076,0.07575757575757576
"[1, 0, 1, 1, 1, 1, 1, 1, 1, 1, 0, 1, 1, 0, 0]",597,170,427,14,37,0.08235294117647059,0.08665105386416862
"[0, 0, 0, 1, 0, 1, 0, 1, 0, 0, 0, 1, 1, 1, 1]",185,97,88,13,15,0.13402061855670103,0.17045454545454544
"[0, 0, 0, 0, 1, 0, 0, 1, 0, 1, 1, 1, 0, 1, 0]",133,77,56,11,6,0.14285714285714285,0.10714285714285714
"[1, 0, 1, 1, 1, 0, 1, 1, 0, 0, 1, 0, 0, 0, 1]",120,59,61,7,2,0.11864406779661017,0.03278688524590164
"[0, 0, 0, 0, 1, 0, 0, 0, 1, 0, 1, 1, 1, 0, 1]",130,72,58,5,4,0.06944444444444445,0.06896551724137931
"[1, 1, 0, 0, 1, 0, 1, 0, 1, 0, 1, 0, 0, 1, 0]",107,55,52,7,2,0.12727272727272726,0.038461538461538464
"[0, 1, 1, 0, 0, 1, 0, 1, 1, 0, 1, 0, 0, 0, 0]",157,90,67,5,5,0.05555555555555555,0.07462686567164178
"[1, 1, 1, 0, 0, 0, 0, 1, 0, 1, 1, 1, 1, 1, 1]",511,116,395,8,40,0.06896551724137931,0.10126582278481013
"[1, 1, 1, 1, 0, 0, 0, 1, 1, 0, 0, 1, 1, 0, 0]",327,162,165,18,16,0.1111111111111111,0.09696969696969697
"[1, 0, 1, 0, 1, 0, 1, 0, 0, 1, 1, 0, 0, 1, 1]",167,76,91,5,7,0.06578947368421052,0.07692307692307693
"[1, 1, 0, 1, 0, 1, 1, 0, 1, 1, 0, 0, 1, 1, 0]",172,74,98,8,15,0.10810810810810811,0.15306122448979592
"[1, 1, 1, 1, 0, 0, 0, 1, 0, 0, 1, 1, 1, 0, 0]",152,64,88,3,10,0.046875,0.11363636363636363
"[0, 0, 0, 1, 1, 1, 0, 0, 0, 1, 0, 1, 1, 1, 1]",197,111,86,10,8,0.09009009009009009,0.09302325581395349
"[0, 1, 0, 1, 1, 1, 1, 0, 0, 0, 1, 1, 1, 1, 0]",194,81,113,10,12,0.12345679012345678,0.10619469026548672
"[0, 0, 1, 0, 0, 0, 1, 0, 1, 1, 0, 0, 1, 1, 1]",206,118,88,10,11,0.0847457627118644,0.125
"[1, 1, 1, 0, 0, 1, 0, 0, 1, 1, 0, 1, 0, 0, 1]",107,51,56,2,3,0.0392156862745098,0.05357142857142857
"[0, 1, 0, 0, 0, 0, 1, 1, 1, 0, 0, 1, 0, 0, 1]",154,97,57,12,6,0.12371134020618557,0.10526315789473684
"[0, 1, 0, 1, 0, 1, 1, 1, 0, 1, 1, 1, 0, 1, 1]",230,79,151,9,17,0.11392405063291139,0.11258278145695365
"[1, 1, 0, 0, 1, 1, 0, 1, 1, 0, 0, 0, 1, 1, 0]",146,71,75,10,12,0.14084507042253522,0.16
"[1, 0, 1, 1, 0, 0, 0, 1, 0, 1, 1, 0, 0, 1, 1]",159,75,84,2,6,0.02666666666666667,0.07142857142857142
"[0, 0, 0, 1, 1, 0, 0, 1, 1, 1, 0, 0, 1, 0, 0]",211,145,66,15,6,0.10344827586206896,0.09090909090909091
"[1, 0, 0, 1, 0, 1, 1, 1, 1, 0, 1, 1, 0, 1, 0]",145,65,80,9,7,0.13846153846153847,0.0875
"[1, 0, 0, 1, 1, 0, 1, 1, 0, 0, 0, 1, 0, 0, 1]",107,52,55,1,5,0.019230769230769232,0.09090909090909091
"[1, 1, 1, 1, 0, 0, 0, 1, 0, 0, 1, 1, 0, 1, 1]",178,63,115,6,10,0.09523809523809523,0.08695652173913043
"[0, 0, 1, 0, 1, 0, 0, 0, 0, 0, 1, 1, 0, 1, 1]",158,112,46,8,7,0.07142857142857142,0.15217391304347827
"[1, 0, 0, 0, 1, 1, 0, 0, 0, 1, 0, 1, 0, 0, 0]",241,143,98,15,7,0.1048951048951049,0.07142857142857142
"[1, 0, 1, 0, 1, 0, 1, 1, 0, 0, 0, 1, 1, 1, 1]",210,93,117,6,9,0.06451612903225806,0.07692307692307693
"[1, 1, 1, 1, 1, 0, 1, 0, 0, 1, 1, 1, 0, 0, 1]",285,110,175,11,16,0.1,0.09142857142857143
"[1, 0, 0, 1, 0, 0, 0, 0, 1, 0, 1, 0, 1, 1, 1]",160,89,71,12,6,0.1348314606741573,0.08450704225352113
"[1, 1, 0, 0, 1, 0, 0, 0, 1, 1, 1, 0, 0, 0, 1]",139,73,66,8,8,0.1095890410958904,0.12121212121212122
"[0, 1, 0, 1, 0, 1, 1, 1, 0, 0, 0, 1, 1, 0, 1]",86,37,49,4,3,0.10810810810810811,0.061224489795918366
"[1, 1, 0, 1, 0, 1, 1, 1, 1, 1, 1, 0, 0, 1, 0]",258,87,171,5,15,0.05747126436781609,0.08771929824561403
"[0, 1, 1, 1, 0, 0, 1, 0, 1, 1, 0, 0, 1, 1, 0]",150,78,72,10,8,0.1282051282051282,0.1111111111111111
"[0, 1, 0, 0, 1, 0, 1, 0, 0, 1, 0, 1, 0, 1, 0]",133,83,50,10,8,0.12048192771084337,0.16
"[1, 1, 0, 1, 1, 0, 0, 1, 1, 0, 0, 0, 1, 1, 0]",147,59,88,9,6,0.15254237288135594,0.06818181818181818
"[1, 0, 1, 1, 0, 0, 0, 1, 0, 1, 0, 1, 0, 0, 1]",103,48,55,5,5,0.10416666666666667,0.09090909090909091
"[1, 0, 1, 0, 0, 0, 1, 0, 1, 0, 1, 0, 1, 1, 0]",115,56,59,6,7,0.10714285714285714,0.11864406779661017
"[0, 0, 1, 1, 1, 0, 1, 0, 1, 0, 1, 0, 0, 1, 0]",106,60,46,5,3,0.08333333333333333,0.06521739130434782
"[0, 0, 0, 0, 1, 1, 1, 0, 1, 0, 1, 0, 1, 0, 0]",155,96,59,12,6,0.125,0.1016949152542373
"[0, 0, 1, 0, 1, 1, 1, 1, 1, 1, 0, 0, 0, 0, 1]",286,128,158,16,20,0.125,0.12658227848101267
"[1, 1, 0, 0, 1, 1, 1, 1, 0, 1, 0, 0, 0, 0, 1]",188,81,107,8,14,0.09876543209876543,0.1308411214953271
"[0, 1, 1, 1, 1, 0, 0, 1, 0, 0, 0, 1, 0, 0, 1]",118,76,42,7,5,0.09210526315789473,0.11904761904761904
"[0, 1, 1, 0, 1, 0, 0, 0, 1, 1, 0, 0, 1, 1, 1]",237,128,109,15,11,0.1171875,0.10091743119266056
"[1, 0, 1, 0, 0, 0, 1, 0, 0, 1, 0, 1, 0, 0, 1]",153,105,48,14,6,0.13333333333333333,0.125
"[0, 1, 1, 0, 1, 1, 0, 1, 1, 0, 0, 1, 0, 0, 0]",121,54,67,7,4,0.12962962962962962,0.05970149253731343
"[1, 0, 1, 0, 0, 1, 1, 1, 1, 1, 0, 0, 0, 1, 0]",123,55,68,8,7,0.14545454545454545,0.10294117647058823
"[1, 1, 1, 0, 1, 0, 0, 1, 1, 1, 1, 1, 0, 0, 0]",228,97,131,13,11,0.13402061855670103,0.08396946564885496
"[0, 1, 0, 1, 0, 1, 0, 0, 1, 0, 0, 1, 0, 1, 0]",123,66,57,8,3,0.12121212121212122,0.05263157894736842
"[1, 0, 0, 1, 0, 0, 1, 0, 0, 1, 1, 1, 1, 0, 1]",129,53,76,3,7,0.05660377358490566,0.09210526315789473
"[0, 1, 1, 1, 0, 0, 1, 0, 0, 1, 0, 0, 1, 0, 0]",151,104,47,10,4,0.09615384615384616,0.0851063829787234
"[0, 0, 0, 1, 1, 0, 1, 1, 1, 0, 0, 1, 0, 0, 1]",108,64,44,11,6,0.171875,0.13636363636363635
"[0, 1, 1, 1, 1, 0, 0, 0, 1, 0, 0, 1, 0, 0, 0]",186,118,68,15,9,0.1271186440677966,0.1323529411764706
"[0, 0, 1, 0, 1, 1, 1, 0, 1, 0, 0, 0, 1, 1, 0]",118,63,55,5,3,0.07936507936507936,0.05454545454545454
"[0, 1, 1, 1, 1, 0, 0, 1, 0, 1, 1, 1, 0, 1, 0]",145,69,76,5,5,0.07246376811594203,0.06578947368421052
"[1, 0, 1, 1, 0, 0, 0, 1, 1, 1, 1, 0, 1, 0, 0]",107,49,58,4,6,0.08163265306122448,0.10344827586206896
"[1, 1, 0, 1, 0, 0, 1, 0, 1, 1, 1, 1, 0, 0, 1]",196,73,123,8,18,0.1095890410958904,0.14634146341463414
"[1, 1, 1, 0, 1, 0, 0, 1, 0, 1, 0, 0, 0, 1, 1]",142,62,80,7,6,0.11290322580645161,0.075
"[1, 1, 1, 0, 0, 0, 1, 0, 0, 0, 0, 1, 0, 1, 0]",135,77,58,8,2,0.1038961038961039,0.034482758620689655
"[1, 0, 0, 0, 1, 0, 0, 1, 1, 1, 1, 0, 1, 0, 1]",121,60,61,8,5,0.13333333333333333,0.08196721311475409
"[1, 0, 0, 0, 0, 1, 0, 0, 1, 1, 0, 0, 1, 0, 1]",147,88,59,8,10,0.09090909090909091,0.1694915254237288
"[0, 1, 0, 0, 0, 1, 0, 1, 1, 1, 0, 1, 0, 1, 1]",116,53,63,5,2,0.09433962264150944,0.031746031746031744
"[1, 0, 1, 0, 1, 1, 0, 0, 1, 1, 0, 1, 0, 1, 0]",115,59,56,4,4,0.06779661016949153,0.07142857142857142
"[0, 1, 1, 0, 0, 1, 1, 0, 0, 0, 1, 0, 0, 1, 0]",188,127,61,15,7,0.11811023622047244,0.11475409836065574
"[0, 0, 1, 1, 1, 0, 0, 1, 1, 1, 0, 0, 0, 0, 0]",219,130,89,15,11,0.11538461538461539,0.12359550561797752
"[1, 0, 1, 1, 0, 0, 1, 1, 0, 1, 1, 1, 0, 0, 1]",158,58,100,4,8,0.06896551724137931,0.08
"[1, 0, 0, 0, 0, 1, 1, 0, 1, 0, 1, 1, 0, 1, 1]",142,50,92,9,7,0.18,0.07608695652173914
"[1, 1, 0, 1, 0, 0, 0, 1, 0, 0, 0, 0, 0, 1, 0]",204,136,68,16,3,0.11764705882352941,0.04411764705882353
"[1, 0, 1, 0, 1, 1, 1, 0, 1, 0, 0, 1, 0, 0, 0]",111,52,59,3,8,0.057692307692307696,0.13559322033898305
"[1, 0, 1, 1, 1, 1, 1, 0, 0, 0, 0, 0, 1, 1, 1]",278,108,170,10,15,0.09259259259259259,0.08823529411764706
"[0, 0, 0, 0, 1, 0, 1, 1, 0, 1, 0, 0, 1, 1, 0]",150,86,64,8,5,0.09302325581395349,0.078125
"[1, 0, 0, 0, 1, 0, 0, 1, 0, 0, 1, 0, 1, 1, 0]",138,82,56,4,6,0.04878048780487805,0.10714285714285714
"[0, 1, 1, 0, 1, 1, 0, 1, 1, 0, 1, 0, 1, 0, 1]",139,68,71,6,10,0.08823529411764706,0.14084507042253522
"[0, 0, 0, 1, 0, 1, 1, 0, 1, 1, 0, 1, 1, 0, 1]",116,49,67,2,5,0.04081632653061224,0.07462686567164178
"[0, 1, 1, 0, 1, 1, 0, 1, 0, 0, 0, 0, 1, 1, 0]",151,90,61,7,3,0.07777777777777778,0.04918032786885246
"[0, 0, 0, 1, 0, 1, 1, 0, 0, 0, 1, 1, 0, 0, 1]",193,108,85,20,12,0.18518518518518517,0.1411764705882353
"[1, 0, 1, 1, 0, 1, 1, 1, 0, 0, 1, 0, 0, 0, 1]",110,56,54,8,7,0.14285714285714285,0.12962962962962962
"[0, 0, 1, 0, 1, 1, 0, 1, 0, 1, 1, 0, 0, 0, 1]",115,54,61,2,6,0.037037037037037035,0.09836065573770492
"[0, 0, 1, 1, 1, 1, 0, 1, 1, 0, 1, 0, 0, 1, 0]",119,56,63,5,6,0.08928571428571429,0.09523809523809523
"[1, 1, 0, 0, 0, 1, 1, 1, 0, 0, 0, 1, 1, 0, 1]",133,63,70,9,6,0.14285714285714285,0.08571428571428572
"[0, 0, 1, 0, 0, 1, 0, 0, 1, 1, 1, 0, 1, 0, 1]",99,41,58,6,6,0.14634146341463414,0.10344827586206896
"[0, 0, 0, 1, 1, 1, 1, 1, 1, 0, 1, 1, 0, 0, 0]",212,128,84,15,11,0.1171875,0.13095238095238096
"[1, 0, 1, 1, 0, 0, 1, 0, 1, 1, 1, 1, 1, 1, 0]",265,96,169,6,12,0.0625,0.07100591715976332
"[1, 1, 0, 0, 1, 0, 1, 0, 1, 1, 0, 1, 1, 1, 1]",315,117,198,12,22,0.10256410256410256,0.1111111111111111
"[0, 1, 1, 1, 0, 1, 0, 0, 1, 0, 0, 0, 0, 1, 1]",157,99,58,9,2,0.09090909090909091,0.034482758620689655
"[1, 0, 0, 0, 1, 0, 0, 0, 0, 1, 1, 1, 1, 1, 0]",160,94,66,12,5,0.1276595744680851,0.07575757575757576
"[1, 1, 1, 1, 0, 0, 0, 1, 0, 1, 0, 0, 1, 1, 0]",146,68,78,5,5,0.07352941176470588,0.0641025641025641
"[1, 0, 0, 1, 0, 1, 1, 0, 1, 1, 0, 0, 1, 1, 0]",131,62,69,5,8,0.08064516129032258,0.11594202898550725
"[0, 0, 1, 1, 0, 1, 1, 0, 0, 0, 0, 1, 0, 1, 0]",142,91,51,13,5,0.14285714285714285,0.09803921568627451
"[1, 0, 0, 1, 1, 1, 1, 1, 0, 0, 1, 1, 0, 1, 0]",185,69,116,7,11,0.10144927536231885,0.09482758620689655
"[0, 1, 0, 0, 0, 1, 1, 1, 0, 0, 0, 1, 1, 0, 0]",175,104,71,8,4,0.07692307692307693,0.056338028169014086
"[0, 1, 1, 0, 1, 1, 0, 0, 1, 0, 0, 1, 1, 0, 0]",140,78,62,4,2,0.05128205128205128,0.03225806451612903
"[1, 1, 0, 1, 1, 0, 1, 0, 1, 1, 1, 0, 0, 0, 1]",140,50,90,1,12,0.02,0.13333333333333333
"[0, 1, 0, 1, 0, 1, 0, 1, 1, 1, 0, 1, 1, 1, 0]",135,62,73,2,1,0.03225806451612903,0.0136986301369863
"[1, 0, 0, 0, 0, 0, 1, 0, 1, 0, 1, 1, 1, 1, 0]",126,56,70,3,11,0.05357142857142857,0.15714285714285714
"[1, 0, 1, 0, 1, 0, 1, 0, 0, 1, 0, 1, 0, 1, 0]",126,60,66,3,4,0.05,0.06060606060606061
"[0, 0, 0, 0, 1, 1, 0, 0, 1, 1, 0, 1, 1, 0, 1]",227,133,94,10,7,0.07518796992481203,0.07446808510638298
"[1, 0, 0, 0, 0, 1, 0, 0, 0, 1, 1, 1, 0, 0, 0]",290,192,98,23,13,0.11979166666666667,0.1326530612244898
"[0, 0, 0, 1, 0, 1, 0, 1, 1, 0, 0, 1, 0, 0, 1]",126,73,53,9,5,0.1232876712328767,0.09433962264150944
"[1, 0, 0, 0, 0, 1, 1, 1, 0, 1, 1, 0, 0, 0, 0]",217,102,115,15,11,0.14705882352941177,0.09565217391304348
"[1, 0, 1, 1, 1, 0, 1, 0, 1, 1, 0, 0, 1, 1, 1]",301,110,191,9,14,0.08181818181818182,0.07329842931937172
"[1, 0, 0, 1, 1, 0, 1, 1, 0, 0, 0, 1, 1, 0, 0]",155,78,77,6,14,0.07692307692307693,0.18181818181818182
"[1, 0, 1, 1, 1, 1, 1, 1, 0, 0, 0, 0, 0, 1, 1]",269,104,165,6,16,0.057692307692307696,0.09696969696969697
"[1, 0, 0, 0, 0, 0, 1, 0, 1, 1, 0, 1, 1, 0, 1]",107,53,54,7,2,0.1320754716981132,0.037037037037037035
"[1, 1, 1, 0, 1, 1, 0, 0, 0, 1, 1, 0, 0, 0, 0]",241,103,138,12,12,0.11650485436893204,0.08695652173913043
"[0, 0, 1, 1, 1, 0, 0, 0, 1, 1, 0, 0, 1, 0, 1]",128,75,53,10,3,0.13333333333333333,0.05660377358490566
"[0, 1, 0, 0, 0, 0, 0, 1, 0, 1, 0, 1, 0, 0, 1]",243,149,94,13,9,0.087248322147651,0.09574468085106383
"[0, 0, 1, 1, 1, 0, 1, 0, 1, 0, 0, 0, 0, 0, 1]",166,91,75,7,7,0.07692307692307693,0.09333333333333334
"[1, 0, 0, 1, 1, 1, 0, 1, 0, 1, 0, 0, 0, 0, 0]",174,95,79,9,10,0.09473684210526316,0.12658227848101267
"[0, 0, 0, 0, 0, 1, 0, 1, 0, 0, 1, 0, 1, 1, 0]",277,164,113,19,8,0.11585365853658537,0.07079646017699115
"[1, 1, 1, 1, 1, 0, 0, 1, 0, 1, 1, 0, 0, 0, 1]",160,63,97,4,12,0.06349206349206349,0.12371134020618557
"[0, 0, 1, 0, 0, 1, 0, 1, 1, 0, 1, 1, 1, 0, 0]",130,78,52,5,4,0.0641025641025641,0.07692307692307693
"[0, 0, 1, 0, 0, 1, 0, 0, 1, 0, 1, 1, 0, 1, 1]",110,68,42,6,3,0.08823529411764706,0.07142857142857142
"[1, 1, 0, 0, 1, 0, 0, 1, 1, 1, 0, 1, 0, 1, 1]",179,73,106,9,9,0.1232876712328767,0.08490566037735849
"[1, 1, 0, 1, 1, 0, 1, 1, 0, 0, 1, 0, 1, 0, 0]",112,52,60,6,2,0.11538461538461539,0.03333333333333333
"[0, 0, 0, 1, 0, 0, 1, 1, 1, 1, 0, 1, 0, 1, 1]",131,64,67,2,11,0.03125,0.16417910447761194
"[1, 0, 1, 1, 1, 0, 1, 0, 1, 1, 0, 0, 0, 1, 1]",163,63,100,7,13,0.1111111111111111,0.13
"[0, 0, 1, 1, 0, 1, 0, 1, 1, 1, 1, 0, 0, 0, 0]",205,113,92,18,7,0.1592920353982301,0.07608695652173914
"[0, 0, 0, 1, 0, 1, 1, 1, 1, 0, 0, 0, 1, 0, 1]",112,59,53,7,4,0.11864406779661017,0.07547169811320754
"[1, 1, 0, 0, 1, 1, 0, 1, 0, 0, 0, 0, 0, 1, 0]",134,77,57,10,3,0.12987012987012986,0.05263157894736842
"[1, 0, 1, 0, 1, 1, 0, 0, 1, 1, 0, 0, 0, 0, 0]",343,181,162,18,17,0.09944751381215469,0.10493827160493827
"[0, 0, 0, 1, 0, 1, 0, 1, 1, 0, 0, 1, 1, 0, 0]",261,145,116,8,14,0.05517241379310345,0.1206896551724138
"[0, 1, 0, 0, 1, 1, 0, 0, 0, 1, 1, 0, 1, 0, 1]",96,42,54,5,4,0.11904761904761904,0.07407407407407407
"[0, 0, 1, 0, 0, 0, 1, 1, 1, 0, 1, 0, 1, 0, 0]",157,99,58,11,4,0.1111111111111111,0.06896551724137931
"[0, 0, 1, 1, 0, 1, 0, 0, 0, 1, 1, 0, 1, 0, 1]",108,60,48,10,7,0.16666666666666666,0.14583333333333334
"[1, 0, 1, 1, 1, 0, 0, 1, 0, 1, 1, 1, 0, 0, 0]",131,61,70,3,9,0.04918032786885246,0.12857142857142856
"[0, 0, 0, 1, 1, 1, 0, 1, 0, 1, 1, 0, 0, 0, 1]",135,68,67,9,4,0.1323529411764706,0.05970149253731343
"[1, 0, 1, 0, 1, 0, 0, 0, 1, 0, 0, 0, 1, 0, 0]",238,149,89,12,13,0.08053691275167785,0.14606741573033707
"[0, 1, 0, 0, 0, 1, 0, 0, 0, 1, 1, 1, 1, 0, 0]",252,152,100,15,5,0.09868421052631579,0.05
"[0, 0, 1, 0, 0, 0, 1, 1, 1, 0, 0, 1, 0, 1, 1]",125,64,61,5,5,0.078125,0.08196721311475409
"[1, 0, 0, 1, 1, 1, 0, 0, 0, 1, 0, 1, 0, 0, 1]",103,49,54,0,5,0.0,0.09259259259259259
"[0, 0, 0, 1, 1, 0, 0, 1, 0, 0, 1, 1, 1, 0, 0]",215,153,62,19,7,0.12418300653594772,0.11290322580645161
"[0, 0, 1, 0, 0, 0, 0, 1, 1, 1, 0, 1, 0, 1, 1]",141,71,70,11,6,0.15492957746478872,0.08571428571428572
"[1, 0, 0, 1, 1, 0, 0, 0, 1, 1, 0, 0, 1, 1, 1]",289,115,174,13,17,0.11304347826086956,0.09770114942528736
"[0, 0, 1, 1, 1, 0, 1, 1, 0, 0, 1, 1, 0, 0, 1]",189,92,97,14,14,0.15217391304347827,0.14432989690721648
"[1, 0, 1, 0, 0, 1, 0, 1, 0, 0, 0, 1, 1, 1, 1]",150,63,87,7,6,0.1111111111111111,0.06896551724137931
"[0, 1, 0, 1, 0, 1, 1, 1, 1, 0, 0, 0, 0, 0, 1]",136,76,60,11,6,0.14473684210526316,0.1
"[0, 1, 1, 0, 1, 1, 0, 0, 1, 1, 1, 1, 0, 1, 1]",272,104,168,6,14,0.057692307692307696,0.08333333333333333
"[1, 1, 1, 0, 0, 1, 1, 0, 1, 1, 1, 0, 1, 0, 0]",154,54,100,7,5,0.12962962962962962,0.05
"[0, 1, 1, 0, 0, 0, 1, 0, 0, 1, 1, 0, 1, 1, 0]",118,74,44,5,5,0.06756756756756757,0.11363636363636363
"[1, 0, 1, 1, 1, 0, 1, 0, 1, 1, 0, 1, 0, 0, 0]",104,44,60,7,5,0.1590909090909091,0.08333333333333333
"[0, 1, 0, 1, 0, 1, 0, 0, 0, 1, 1, 1, 0, 1, 1]",112,50,62,6,10,0.12,0.16129032258064516
"[1, 0, 1, 0, 1, 1, 0, 1, 1, 0, 0, 1, 1, 0, 1]",151,62,89,11,14,0.1774193548387097,0.15730337078651685
"[0, 1, 1, 1, 0, 1, 1, 1, 0, 0, 0, 0, 1, 0, 0]",109,60,49,6,5,0.1,0.10204081632653061
"[0, 1, 1, 0, 1, 0, 1, 0, 1, 0, 1, 1, 1, 0, 1]",150,61,89,4,13,0.06557377049180328,0.14606741573033707
"[1, 1, 0, 0, 1, 0, 1, 1, 1, 0, 1, 0, 1, 0, 0]",102,46,56,1,5,0.021739130434782608,0.08928571428571429
"[0, 0, 1, 0, 1, 0, 0, 1, 1, 1, 1, 0, 0, 1, 1]",314,158,156,15,17,0.0949367088607595,0.10897435897435898
"[0, 1, 1, 1, 0, 1, 0, 1, 0, 0, 1, 1, 1, 0, 1]",137,52,85,9,9,0.17307692307692307,0.10588235294117647
"[0, 1, 0, 1, 0, 0, 1, 1, 1, 1, 1, 1, 1, 0, 1]",282,89,193,9,23,0.10112359550561797,0.11917098445595854
"[1, 1, 1, 0, 1, 1, 0, 0, 0, 1, 0, 1, 0, 1, 1]",170,67,103,9,15,0.13432835820895522,0.14563106796116504
"[1, 1, 1, 1, 1, 0, 1, 1, 0, 0, 0, 1, 0, 1, 0]",155,63,92,8,12,0.12698412698412698,0.13043478260869565
"[0, 1, 0, 0, 0, 1, 1, 1, 0, 1, 1, 0, 0, 1, 0]",102,49,53,5,6,0.10204081632653061,0.11320754716981132
"[1, 1, 1, 0, 1, 0, 0, 0, 1, 1, 0, 1, 0, 0, 0]",116,57,59,10,6,0.17543859649122806,0.1016949152542373
"[0, 0, 1, 0, 0, 0, 0, 1, 1, 0, 1, 1, 1, 1, 0]",130,65,65,5,9,0.07692307692307693,0.13846153846153847
"[1, 1, 0, 0, 0, 1, 1, 0, 1, 1, 1, 0, 0, 0, 1]",128,49,79,5,10,0.10204081632653061,0.12658227848101267
"[1, 1, 0, 0, 0, 1, 0, 1, 1, 0, 0, 1, 1, 1, 1]",297,122,175,12,21,0.09836065573770492,0.12
"[0, 0, 0, 0, 1, 1, 0, 1, 1, 0, 0, 1, 1, 0, 1]",135,78,57,8,1,0.10256410256410256,0.017543859649122806
"[0, 0, 1, 0, 0, 0, 0, 0, 0, 1, 1, 0, 1, 0, 1]",277,184,93,22,9,0.11956521739130435,0.0967741935483871
"[0, 1, 0, 0, 0, 1, 1, 0, 1, 1, 1, 0, 1, 0, 1]",86,42,44,3,5,0.07142857142857142,0.11363636363636363
"[0, 1, 1, 0, 1, 0, 0, 1, 1, 0, 1, 0, 0, 0, 0]",165,87,78,7,5,0.08045977011494253,0.0641025641025641
"[0, 1, 0, 1, 1, 1, 1, 0, 1, 1, 0, 1, 0, 1, 0]",104,50,54,8,5,0.16,0.09259259259259259
"[1, 1, 0, 0, 1, 1, 0, 0, 1, 1, 0, 0, 0, 1, 0]",311,171,140,19,14,0.1111111111111111,0.1
"[1, 0, 1, 1, 0, 1, 0, 1, 1, 0, 0, 1, 0, 0, 0]",129,71,58,10,13,0.14084507042253522,0.22413793103448276
"[0, 0, 0, 1, 0, 0, 0, 0, 0, 0, 1, 0, 1, 1, 0]",558,395,163,22,15,0.05569620253164557,0.09202453987730061
"[0, 0, 1, 0, 1, 0, 1, 0, 1, 1, 1, 0, 1, 0, 0]",99,56,43,4,4,0.07142857142857142,0.09302325581395349
"[0, 0, 0, 0, 1, 0, 1, 0, 1, 0, 1, 1, 1, 0, 1]",108,51,57,3,5,0.058823529411764705,0.08771929824561403
"[0, 0, 0, 1, 0, 1, 1, 1, 1, 0, 1, 0, 0, 1, 1]",117,52,65,6,2,0.11538461538461539,0.03076923076923077
"[1, 1, 1, 0, 0, 0, 1, 0, 1, 1, 1, 1, 0, 1, 0]",154,62,92,6,6,0.0967741935483871,0.06521739130434782
"[0, 1, 0, 1, 1, 0, 0, 1, 1, 0, 0, 0, 0, 0, 1]",228,137,91,9,11,0.06569343065693431,0.12087912087912088
"[0, 0, 1, 1, 0, 1, 1, 1, 0, 0, 0, 0, 0, 1, 1]",184,107,77,9,10,0.08411214953271028,0.12987012987012986
"[0, 0, 1, 0, 0, 1, 1, 0, 1, 1, 1, 0, 0, 0, 0]",169,107,62,7,4,0.06542056074766354,0.06451612903225806
"[1, 0, 0, 1, 1, 0, 1, 0, 0, 1, 1, 1, 1, 0, 0]",196,93,103,10,9,0.10752688172043011,0.08737864077669903
"[1, 1, 1, 0, 1, 0, 1, 1, 0, 0, 1, 0, 1, 1, 1]",293,114,179,11,16,0.09649122807017543,0.0893854748603352
"[0, 1, 1, 0, 1, 1, 0, 0, 1, 1, 1, 0, 1, 1, 1]",285,118,167,10,15,0.0847457627118644,0.08982035928143713
"[1, 0, 0, 0, 1, 1, 1, 0, 0, 0, 0, 0, 1, 1, 0]",182,101,81,8,6,0.07920792079207921,0.07407407407407407
"[0, 1, 0, 0, 0, 1, 1, 1, 0, 0, 0, 0, 0, 1, 1]",200,112,88,14,7,0.125,0.07954545454545454
"[1, 1, 1, 0, 0, 1, 1, 1, 0, 0, 0, 1, 0, 1, 0]",112,47,65,5,7,0.10638297872340426,0.1076923076923077
"[1, 0, 0, 0, 0, 1, 0, 1, 1, 1, 1, 1, 0, 1, 1]",172,64,108,10,10,0.15625,0.09259259259259259
"[1, 1, 1, 0, 1, 1, 0, 0, 0, 0, 1, 1, 1, 0, 1]",172,62,110,3,8,0.04838709677419355,0.07272727272727272
"[0, 0, 0, 0, 0, 1, 0, 1, 1, 1, 1, 0, 1, 1, 0]",124,69,55,4,8,0.057971014492753624,0.14545454545454545
"[1, 0, 0, 1, 1, 0, 0, 1, 1, 0, 0, 1, 0, 1, 0]",193,72,121,5,7,0.06944444444444445,0.05785123966942149
"[1, 1, 0, 0, 1, 1, 1, 0, 0, 0, 0, 1, 0, 1, 0]",123,66,57,9,5,0.13636363636363635,0.08771929824561403
"[1, 1, 0, 1, 0, 0, 0, 1, 1, 1, 0, 1, 1, 0, 0]",111,55,56,5,3,0.09090909090909091,0.05357142857142857
"[1, 1, 0, 0, 1, 0, 1, 1, 0, 0, 0, 1, 0, 0, 1]",109,56,53,8,4,0.14285714285714285,0.07547169811320754
"[1, 0, 1, 1, 1, 1, 0, 1, 1, 1, 1, 0, 0, 0, 0]",291,98,193,9,20,0.09183673469387756,0.10362694300518134
"[0, 0, 1, 0, 1, 0, 0, 1, 0, 1, 1, 1, 0, 0, 1]",121,61,60,8,6,0.13114754098360656,0.1
"[1, 1, 1, 0, 0, 1, 0, 0, 0, 1, 0, 1, 0, 0, 1]",129,69,60,5,5,0.07246376811594203,0.08333333333333333
"[1, 1, 0, 1, 0, 1, 1, 1, 0, 0, 0, 1, 1, 0, 1]",131,49,82,2,10,0.04081632653061224,0.12195121951219512
"[1, 0, 0, 0, 1, 1, 0, 0, 1, 1, 0, 0, 0, 1, 0]",196,119,77,4,5,0.03361344537815126,0.06493506493506493
"[1, 0, 1, 0, 1, 0, 0, 0, 1, 0, 0, 1, 1, 1, 0]",136,65,71,2,7,0.03076923076923077,0.09859154929577464
"[0, 0, 0, 1, 0, 1, 1, 1, 1, 0, 0, 1, 0, 0, 0]",155,96,59,12,5,0.125,0.0847457627118644
"[1, 1, 0, 1, 0, 1, 0, 1, 0, 0, 0, 1, 0, 0, 0]",151,95,56,9,1,0.09473684210526316,0.017857142857142856
"[0, 0, 0, 1, 1, 1, 1, 0, 1, 0, 1, 0, 1, 0, 0]",140,77,63,6,5,0.07792207792207792,0.07936507936507936
"[1, 0, 0, 1, 1, 1, 1, 0, 1, 0, 1, 0, 0, 0, 1]",123,47,76,5,8,0.10638297872340426,0.10526315789473684
"[0, 1, 1, 0, 1, 0, 0, 0, 1, 1, 1, 0, 1, 1, 1]",151,64,87,8,4,0.125,0.04597701149425287
"[1, 0, 0, 0, 1, 0, 0, 1, 1, 0, 1, 1, 0, 1, 0]",92,41,51,6,5,0.14634146341463414,0.09803921568627451
"[0, 1, 0, 0, 0, 1, 1, 1, 1, 0, 0, 1, 0, 0, 1]",137,65,72,9,5,0.13846153846153847,0.06944444444444445
"[1, 1, 1, 0, 0, 0, 0, 1, 0, 0, 0, 1, 1, 1, 0]",125,55,70,8,5,0.14545454545454545,0.07142857142857142
"[0, 1, 1, 1, 1, 0, 1, 1, 1, 0, 0, 0, 0, 1, 0]",134,67,67,3,6,0.04477611940298507,0.08955223880597014
"[0, 0, 0, 1, 1, 1, 1, 1, 0, 0, 0, 0, 0, 1, 1]",223,152,71,13,8,0.08552631578947369,0.11267605633802817
"[0, 0, 0, 1, 1, 1, 1, 1, 1, 1, 0, 0, 0, 1, 0]",191,100,91,2,10,0.02,0.10989010989010989
"[0, 0, 1, 1, 0, 1, 1, 0, 0, 0, 0, 0, 1, 0, 1]",146,85,61,9,3,0.10588235294117647,0.04918032786885246
"[1, 0, 1, 0, 1, 1, 1, 1, 0, 0, 1, 0, 0, 0, 1]",99,52,47,6,4,0.11538461538461539,0.0851063829787234
"[0, 1, 0, 0, 1, 1, 0, 1, 1, 1, 1, 1, 1, 0, 0]",211,84,127,12,15,0.14285714285714285,0.11811023622047244
"[0, 1, 1, 1, 0, 1, 0, 0, 0, 0, 0, 0, 1, 0, 0]",232,154,78,14,9,0.09090909090909091,0.11538461538461539
"[0, 0, 0, 1, 1, 0, 0, 0, 1, 1, 0, 1, 0, 1, 0]",140,91,49,14,6,0.15384615384615385,0.12244897959183673
"[0, 0, 0, 1, 1, 0, 1, 0, 1, 1, 0, 0, 0, 1, 1]",142,81,61,8,6,0.09876543209876543,0.09836065573770492
"[0, 1, 1, 0, 0, 0, 1, 1, 0, 1, 0, 1, 1, 0, 0]",120,62,58,7,9,0.11290322580645161,0.15517241379310345
"[1, 1, 0, 1, 0, 0, 1, 0, 0, 0, 0, 0, 1, 1, 1]",180,97,83,4,8,0.041237113402061855,0.0963855421686747
"[0, 1, 1, 1, 0, 1, 0, 1, 1, 1, 0, 1, 0, 1, 0]",120,55,65,4,7,0.07272727272727272,0.1076923076923077
"[1, 0, 0, 1, 1, 0, 0, 1, 0, 1, 0, 1, 0, 0, 1]",148,70,78,4,5,0.05714285714285714,0.0641025641025641
"[0, 0, 1, 0, 1, 0, 0, 0, 1, 0, 1, 1, 1, 1, 1]",150,80,70,9,6,0.1125,0.08571428571428572
"[1, 0, 0, 0, 1, 1, 0, 1, 1, 1, 0, 0, 1, 0, 0]",107,58,49,5,4,0.08620689655172414,0.08163265306122448
"[0, 0, 1, 0, 1, 1, 1, 0, 0, 1, 0, 1, 1, 1, 0]",113,61,52,5,3,0.08196721311475409,0.057692307692307696
"[0, 0, 0, 1, 1, 1, 1, 0, 0, 0, 1, 1, 0, 1, 0]",137,87,50,8,9,0.09195402298850575,0.18
"[1, 0, 0, 0, 1, 0, 0, 1, 1, 0, 1, 1, 0, 1, 1]",114,55,59,4,10,0.07272727272727272,0.1694915254237288
"[0, 0, 1, 0, 0, 0, 0, 1, 0, 0, 1, 1, 1, 0, 1]",108,66,42,6,2,0.09090909090909091,0.047619047619047616
"[0, 0, 1, 0, 1, 1, 0, 0, 1, 0, 1, 0, 0, 1, 1]",118,68,50,6,1,0.08823529411764706,0.02
"[0, 1, 1, 1, 1, 0, 0, 1, 0, 0, 0, 0, 0, 0, 1]",253,159,94,15,12,0.09433962264150944,0.1276595744680851
"[0, 1, 1, 1, 0, 1, 1, 1, 1, 0, 0, 1, 0, 0, 0]",140,62,78,7,8,0.11290322580645161,0.10256410256410256
"[0, 1, 1, 0, 1, 1, 0, 0, 0, 1, 1, 1, 1, 0, 1]",163,63,100,5,13,0.07936507936507936,0.13
"[1, 0, 0, 1, 1, 0, 0, 1, 1, 0, 1, 1, 0, 0, 1]",179,63,116,4,11,0.06349206349206349,0.09482758620689655
"[0, 0, 1, 0, 1, 1, 0, 0, 1, 0, 0, 1, 0, 1, 0]",117,72,45,7,3,0.09722222222222222,0.06666666666666667
"[0, 0, 0, 1, 1, 0, 1, 0, 1, 0, 1, 0, 0, 1, 0]",125,75,50,4,5,0.05333333333333334,0.1
"[1, 1, 0, 0, 0, 0, 1, 0, 1, 0, 0, 1, 0, 1, 1]",147,74,73,6,6,0.08108108108108109,0.0821917808219178
"[1, 0, 0, 0, 1, 0, 1, 1, 0, 1, 0, 1, 0, 1, 0]",95,51,44,4,3,0.0784313725490196,0.06818181818181818
"[1, 1, 0, 1, 0, 0, 1, 1, 0, 1, 0, 0, 0, 1, 1]",125,56,69,9,4,0.16071428571428573,0.057971014492753624
"[1, 1, 1, 0, 1, 0, 0, 1, 1, 0, 1, 0, 0, 0, 1]",120,59,61,2,5,0.03389830508474576,0.08196721311475409
"[1, 0, 1, 1, 1, 1, 0, 1, 1, 0, 0, 0, 1, 0, 1]",154,66,88,8,4,0.12121212121212122,0.045454545454545456
"[1, 0, 0, 0, 0, 1, 1, 1, 0, 0, 0, 0, 1, 0, 1]",161,91,70,6,4,0.06593406593406594,0.05714285714285714
"[0, 0, 0, 0, 0, 1, 1, 1, 0, 0, 1, 0, 1, 1, 1]",251,179,72,16,11,0.0893854748603352,0.1527777777777778
"[0, 0, 1, 0, 0, 0, 1, 0, 1, 0, 1, 1, 1, 1, 1]",159,92,67,8,9,0.08695652173913043,0.13432835820895522
"[0, 1, 0, 0, 1, 0, 1, 0, 0, 1, 0, 0, 0, 1, 0]",210,132,78,13,6,0.09848484848484848,0.07692307692307693
"[0, 1, 1, 0, 1, 0, 0, 1, 0, 1, 0, 1, 0, 0, 1]",96,53,43,2,3,0.03773584905660377,0.06976744186046512
"[1, 0, 0, 1, 1, 0, 1, 0, 1, 1, 0, 0, 1, 0, 1]",118,47,71,2,12,0.0425531914893617,0.16901408450704225
"[0, 1, 0, 0, 1, 1, 0, 1, 1, 1, 1, 1, 1, 1, 0]",242,93,149,12,12,0.12903225806451613,0.08053691275167785
"[0, 0, 1, 0, 0, 1, 0, 1, 1, 0, 0, 1, 0, 1, 1]",117,55,62,3,12,0.05454545454545454,0.1935483870967742
"[0, 0, 0, 1, 0, 1, 0, 1, 0, 1, 1, 1, 1, 0, 0]",127,73,54,3,3,0.0410958904109589,0.05555555555555555
"[0, 1, 0, 1, 1, 0, 0, 0, 1, 0, 1, 1, 1, 0, 0]",135,68,67,13,4,0.19117647058823528,0.05970149253731343
"[1, 1, 0, 0, 0, 1, 1, 0, 0, 1, 1, 0, 1, 0, 0]",135,80,55,9,2,0.1125,0.03636363636363636
"[1, 1, 1, 1, 1, 0, 0, 1, 0, 0, 1, 0, 1, 0, 1]",165,59,106,6,7,0.1016949152542373,0.0660377358490566
"[0, 0, 0, 0, 0, 1, 0, 0, 1, 1, 1, 1, 1, 0, 0]",279,189,90,16,9,0.08465608465608465,0.1
"[1, 0, 0, 0, 1, 0, 1, 0, 0, 0, 1, 1, 0, 1, 1]",107,51,56,3,3,0.058823529411764705,0.05357142857142857
"[0, 0, 1, 1, 0, 0, 1, 0, 1, 0, 0, 0, 1, 0, 0]",250,158,92,15,12,0.0949367088607595,0.13043478260869565
"[0, 1, 0, 1, 0, 0, 1, 1, 1, 1, 1, 0, 0, 0, 1]",126,67,59,8,9,0.11940298507462686,0.15254237288135594
"[0, 1, 0, 1, 0, 1, 1, 0, 1, 0, 1, 0, 1, 1, 0]",85,50,35,6,4,0.12,0.11428571428571428
"[1, 0, 0, 0, 1, 0, 0, 0, 0, 1, 0, 1, 0, 0, 1]",215,144,71,21,5,0.14583333333333334,0.07042253521126761
"[1, 0, 0, 0, 0, 1, 1, 0, 1, 0, 0, 0, 1, 0, 1]",144,81,63,13,6,0.16049382716049382,0.09523809523809523
"[1, 1, 0, 1, 0, 0, 1, 1, 0, 1, 0, 1, 0, 1, 1]",142,54,88,2,12,0.037037037037037035,0.13636363636363635
"[1, 0, 0, 1, 0, 0, 1, 1, 0, 1, 0, 0, 0, 0, 1]",156,94,62,6,6,0.06382978723404255,0.0967741935483871
"[0, 1, 0, 1, 1, 1, 1, 1, 1, 0, 1, 1, 0, 0, 0]",155,69,86,5,8,0.07246376811594203,0.09302325581395349
"[1, 0, 1, 0, 1, 0, 1, 1, 0, 0, 0, 1, 1, 1, 0]",118,57,61,12,1,0.21052631578947367,0.01639344262295082
"[0, 0, 0, 1, 0, 1, 0, 1, 0, 0, 0, 1, 0, 1, 1]",168,100,68,12,4,0.12,0.058823529411764705
"[1, 0, 0, 1, 0, 1, 0, 1, 0, 1, 1, 1, 0, 1, 0]",93,47,46,3,4,0.06382978723404255,0.08695652173913043
"[1, 1, 1, 0, 0, 1, 0, 1, 1, 0, 1, 1, 0, 1, 0]",125,52,73,2,5,0.038461538461538464,0.0684931506849315
"[0, 1, 0, 1, 0, 1, 0, 0, 0, 0, 1, 0, 1, 0, 1]",133,97,36,15,8,0.15463917525773196,0.2222222222222222
"[0, 0, 1, 1, 1, 0, 1, 0, 0, 1, 0, 1, 1, 0, 1]",89,39,50,3,4,0.07692307692307693,0.08
"[0, 1, 0, 0, 1, 1, 0, 0, 0, 0, 1, 0, 1, 1, 1]",178,102,76,7,9,0.06862745098039216,0.11842105263157894
"[1, 1, 1, 0, 0, 0, 1, 0, 1, 1, 0, 0, 0, 1, 0]",109,53,56,4,7,0.07547169811320754,0.125
"[1, 1, 0, 1, 0, 0, 1, 0, 0, 0, 0, 1, 1, 1, 0]",132,72,60,8,7,0.1111111111111111,0.11666666666666667
"[0, 0, 1, 1, 0, 1, 1, 1, 0, 0, 0, 1, 1, 1, 0]",121,52,69,7,10,0.1346153846153846,0.14492753623188406
"[1, 0, 0, 1, 0, 0, 1, 0, 1, 1, 0, 1, 0, 1, 1]",128,63,65,8,5,0.12698412698412698,0.07692307692307693
"[1, 0, 1, 0, 0, 1, 1, 0, 1, 1, 0, 0, 0, 1, 1]",115,51,64,8,8,0.1568627450980392,0.125
"[1, 1, 1, 1, 0, 0, 0, 1, 0, 1, 0, 1, 1, 1, 0]",169,86,83,8,8,0.09302325581395349,0.0963855421686747
"[1, 0, 1, 0, 0, 1, 1, 0, 0, 1, 1, 0, 1, 0, 1]",113,62,51,6,9,0.0967741935483871,0.17647058823529413
"[1, 0, 1, 1, 1, 0, 1, 0, 1, 0, 1, 1, 0, 1, 0]",121,50,71,7,4,0.14,0.056338028169014086
"[1, 0, 1, 1, 0, 1, 1, 0, 0, 0, 1, 1, 1, 0, 0]",109,58,51,4,4,0.06896551724137931,0.0784313725490196
"[0, 0, 1, 0, 1, 0, 0, 1, 0, 0, 0, 1, 0, 0, 1]",237,151,86,11,11,0.0728476821192053,0.12790697674418605
"[1, 1, 1, 1, 1, 1, 0, 1, 0, 0, 1, 1, 0, 0, 0]",226,81,145,8,11,0.09876543209876543,0.07586206896551724
"[0, 0, 1, 1, 1, 1, 0, 1, 0, 0, 1, 1, 1, 0, 0]",135,46,89,2,5,0.043478260869565216,0.056179775280898875
"[1, 0, 0, 0, 1, 0, 0, 1, 0, 0, 0, 1, 0, 1, 1]",149,87,62,11,8,0.12643678160919541,0.12903225806451613
"[0, 0, 1, 1, 1, 1, 0, 1, 0, 0, 0, 0, 0, 1, 0]",183,115,68,10,6,0.08695652173913043,0.08823529411764706
"[1, 0, 0, 1, 1, 0, 0, 0, 1, 0, 0, 1, 1, 0, 0]",198,99,99,6,7,0.06060606060606061,0.0707070707070707
"[0, 1, 1, 1, 0, 0, 0, 0, 1, 0, 1, 0, 1, 1, 0]",121,61,60,8,7,0.13114754098360656,0.11666666666666667
"[0, 1, 0, 1, 1, 0, 1, 0, 1, 1, 0, 1, 1, 0, 1]",110,43,67,3,7,0.06976744186046512,0.1044776119402985
"[0, 1, 0, 1, 0, 0, 1, 0, 0, 0, 1, 0, 0, 1, 1]",158,92,66,7,9,0.07608695652173914,0.13636363636363635
"[1, 0, 1, 0, 0, 1, 1, 1, 0, 0, 1, 1, 0, 0, 0]",199,117,82,11,6,0.09401709401709402,0.07317073170731707
"[0, 0, 1, 0, 1, 0, 0, 1, 1, 1, 0, 0, 1, 1, 0]",146,72,74,8,7,0.1111111111111111,0.0945945945945946
"[0, 0, 1, 0, 0, 0, 1, 0, 0, 1, 0, 1, 0, 0, 1]",239,157,82,19,12,0.12101910828025478,0.14634146341463414
"[1, 1, 0, 1, 1, 1, 1, 0, 1, 1, 0, 1, 0, 0, 0]",163,62,101,7,10,0.11290322580645161,0.09900990099009901
"[0, 1, 1, 0, 1, 1, 1, 0, 0, 1, 0, 1, 0, 0, 1]",129,69,60,4,6,0.057971014492753624,0.1
"[1, 1, 0, 0, 1, 1, 0, 0, 0, 1, 0, 1, 1, 1, 1]",338,148,190,21,7,0.14189189189189189,0.03684210526315789
"[0, 0, 1, 1, 1, 1, 1, 1, 0, 1, 1, 1, 0, 1, 0]",272,101,171,9,11,0.0891089108910891,0.06432748538011696
"[0, 0, 1, 1, 0, 1, 0, 0, 1, 0, 1, 1, 0, 0, 0]",186,115,71,4,11,0.034782608695652174,0.15492957746478872
"[1, 1, 1, 1, 0, 1, 0, 0, 0, 1, 0, 1, 1, 0, 1]",122,51,71,8,3,0.1568627450980392,0.04225352112676056
"[0, 0, 0, 0, 0, 1, 0, 1, 1, 1, 1, 0, 0, 1, 1]",271,164,107,17,9,0.10365853658536585,0.08411214953271028
"[0, 0, 0, 0, 0, 0, 1, 0, 1, 1, 1, 1, 0, 0, 1]",250,146,104,16,11,0.1095890410958904,0.10576923076923077
"[0, 1, 1, 1, 0, 0, 1, 1, 0, 1, 1, 0, 0, 0, 0]",177,95,82,10,9,0.10526315789473684,0.10975609756097561
"[0, 1, 1, 1, 1, 0, 1, 1, 0, 1, 1, 0, 1, 0, 0]",127,50,77,5,8,0.1,0.1038961038961039
"[0, 0, 0, 1, 0, 1, 1, 0, 0, 0, 1, 1, 1, 1, 0]",159,87,72,7,6,0.08045977011494253,0.08333333333333333
"[1, 1, 1, 1, 1, 0, 0, 1, 0, 1, 1, 0, 1, 0, 1]",252,82,170,7,20,0.08536585365853659,0.11764705882352941
"[0, 1, 0, 0, 0, 1, 1, 0, 1, 1, 1, 1, 0, 1, 1]",150,67,83,10,2,0.14925373134328357,0.024096385542168676
"[0, 0, 1, 1, 1, 0, 1, 1, 1, 0, 1, 1, 0, 0, 0]",127,56,71,5,5,0.08928571428571429,0.07042253521126761
"[1, 1, 1, 0, 0, 1, 0, 1, 0, 1, 0, 1, 1, 0, 0]",133,62,71,7,6,0.11290322580645161,0.08450704225352113
"[1, 1, 1, 1, 0, 1, 0, 1, 1, 1, 0, 1, 0, 0, 0]",139,49,90,8,8,0.16326530612244897,0.08888888888888889
"[0, 1, 1, 1, 0, 0, 1, 0, 0, 1, 1, 1, 0, 1, 0]",110,50,60,3,5,0.06,0.08333333333333333
"[1, 1, 0, 0, 1, 1, 1, 0, 0, 1, 1, 0, 1, 0, 0]",126,63,63,9,8,0.14285714285714285,0.12698412698412698
"[0, 0, 1, 1, 1, 1, 1, 0, 0, 0, 1, 1, 0, 0, 1]",173,81,92,5,10,0.06172839506172839,0.10869565217391304
"[1, 0, 1, 0, 0, 0, 1, 0, 0, 1, 1, 0, 1, 0, 1]",97,54,43,5,4,0.09259259259259259,0.09302325581395349
"[1, 0, 1, 0, 1, 0, 0, 0, 1, 0, 0, 1, 1, 0, 1]",99,53,46,3,3,0.05660377358490566,0.06521739130434782
"[1, 1, 0, 1, 1, 0, 0, 0, 1, 0, 0, 0, 1, 1, 0]",116,61,55,4,5,0.06557377049180328,0.09090909090909091
"[0, 0, 0, 1, 0, 1, 1, 0, 1, 0, 0, 0, 1, 1, 1]",178,90,88,10,9,0.1111111111111111,0.10227272727272728
"[1, 0, 1, 0, 0, 0, 0, 1, 0, 1, 1, 0, 0, 1, 1]",150,84,66,9,10,0.10714285714285714,0.15151515151515152
"[0, 0, 0, 0, 0, 0, 1, 1, 0, 1, 1, 0, 1, 1, 0]",208,120,88,13,10,0.10833333333333334,0.11363636363636363
"[1, 0, 1, 1, 0, 1, 1, 1, 0, 1, 0, 0, 1, 0, 1]",136,50,86,6,6,0.12,0.06976744186046512
"[0, 1, 0, 1, 1, 0, 1, 1, 1, 0, 1, 0, 0, 1, 0]",92,35,57,3,8,0.08571428571428572,0.14035087719298245
"[0, 1, 0, 0, 0, 1, 1, 1, 1, 1, 0, 0, 1, 1, 0]",179,86,93,13,16,0.1511627906976744,0.17204301075268819
"[1, 0, 1, 0, 1, 1, 1, 1, 0, 0, 1, 0, 0, 1, 0]",119,59,60,5,4,0.0847457627118644,0.06666666666666667
"[1, 0, 1, 1, 0, 1, 0, 0, 1, 0, 1, 1, 1, 1, 0]",157,66,91,6,6,0.09090909090909091,0.06593406593406594
"[1, 1, 0, 0, 0, 1, 1, 0, 0, 1, 1, 0, 0, 1, 0]",125,58,67,11,5,0.1896551724137931,0.07462686567164178
"[1, 0, 1, 1, 0, 0, 1, 1, 0, 1, 0, 0, 1, 0, 0]",127,64,63,7,5,0.109375,0.07936507936507936
"[0, 0, 1, 1, 1, 0, 1, 0, 1, 1, 1, 0, 1, 1, 1]",288,117,171,10,21,0.08547008547008547,0.12280701754385964
"[1, 1, 0, 0, 0, 0, 1, 1, 1, 0, 0, 1, 1, 0, 1]",158,67,91,7,7,0.1044776119402985,0.07692307692307693
"[1, 0, 0, 1, 1, 0, 1, 0, 0, 0, 1, 0, 1, 0, 0]",147,86,61,9,9,0.10465116279069768,0.14754098360655737
"[0, 1, 0, 0, 1, 0, 1, 1, 1, 1, 1, 0, 1, 0, 1]",140,52,88,5,9,0.09615384615384616,0.10227272727272728
"[1, 1, 0, 0, 0, 0, 1, 0, 0, 1, 1, 1, 1, 0, 0]",232,121,111,7,20,0.05785123966942149,0.18018018018018017
"[1, 1, 0, 0, 0, 0, 0, 1, 0, 1, 1, 1, 1, 1, 0]",167,76,91,10,8,0.13157894736842105,0.08791208791208792
"[1, 0, 1, 1, 0, 0, 0, 0, 0, 1, 1, 0, 1, 0, 0]",136,70,66,12,5,0.17142857142857143,0.07575757575757576
"[0, 0, 1, 1, 0, 1, 1, 1, 0, 0, 1, 0, 0, 0, 0]",154,96,58,11,3,0.11458333333333333,0.05172413793103448
"[1, 1, 0, 1, 0, 0, 1, 1, 0, 0, 1, 1, 0, 1, 1]",173,74,99,9,11,0.12162162162162163,0.1111111111111111
"[0, 0, 1, 1, 1, 1, 0, 0, 0, 1, 0, 1, 1, 0, 1]",155,75,80,9,8,0.12,0.1
"[0, 0, 1, 0, 0, 0, 1, 1, 0, 1, 1, 1, 0, 1, 1]",113,63,50,9,7,0.14285714285714285,0.14
"[1, 0, 1, 1, 0, 0, 1, 0, 0, 1, 1, 1, 0, 0, 0]",127,74,53,8,6,0.10810810810810811,0.11320754716981132
"[0, 1, 1, 0, 0, 1, 0, 0, 1, 1, 1, 0, 1, 0, 1]",117,64,53,9,5,0.140625,0.09433962264150944
"[0, 1, 1, 1, 1, 0, 1, 0, 1, 0, 1, 1, 0, 0, 0]",143,76,67,5,6,0.06578947368421052,0.08955223880597014
"[0, 0, 1, 1, 1, 1, 0, 1, 0, 0, 0, 0, 0, 0, 1]",226,144,82,9,6,0.0625,0.07317073170731707
"[0, 1, 0, 0, 0, 1, 1, 1, 0, 1, 1, 1, 0, 0, 0]",112,53,59,6,7,0.11320754716981132,0.11864406779661017
"[1, 1, 0, 0, 1, 0, 1, 0, 0, 1, 0, 1, 1, 0, 1]",117,40,77,4,9,0.1,0.11688311688311688
"[0, 1, 1, 0, 1, 1, 0, 0, 1, 0, 1, 0, 1, 0, 0]",128,73,55,6,0,0.0821917808219178,0.0
"[1, 0, 1, 1, 1, 1, 1, 0, 1, 0, 1, 1, 0, 0, 0]",173,68,105,6,8,0.08823529411764706,0.0761904761904762
"[0, 1, 0, 1, 1, 0, 0, 1, 0, 1, 1, 0, 1, 0, 0]",114,65,49,7,4,0.1076923076923077,0.08163265306122448
"[0, 0, 0, 0, 1, 0, 0, 1, 1, 0, 1, 1, 1, 0, 0]",159,97,62,5,6,0.05154639175257732,0.0967741935483871
"[1, 0, 1, 0, 0, 1, 0, 0, 1, 1, 0, 1, 0, 0, 1]",128,75,53,5,4,0.06666666666666667,0.07547169811320754
"[0, 0, 1, 0, 1, 0, 1, 0, 0, 1, 0, 0, 1, 1, 0]",158,100,58,6,9,0.06,0.15517241379310345
"[0, 1, 0, 0, 0, 1, 1, 1, 1, 0, 0, 0, 1, 1, 0]",120,64,56,8,5,0.125,0.08928571428571429
"[0, 0, 1, 1, 1, 1, 1, 0, 1, 1, 1, 1, 1, 0, 0]",384,132,252,19,29,0.14393939393939395,0.11507936507936507
"[1, 1, 0, 1, 1, 1, 0, 0, 0, 1, 1, 1, 0, 1, 1]",277,98,179,14,18,0.14285714285714285,0.1005586592178771
"[1, 1, 0, 0, 1, 0, 1, 1, 0, 1, 0, 0, 1, 0, 0]",121,58,63,4,8,0.06896551724137931,0.12698412698412698
"[0, 1, 1, 0, 0, 1, 1, 0, 0, 1, 0, 1, 0, 0, 0]",224,167,57,18,6,0.10778443113772455,0.10526315789473684
"[1, 1, 1, 0, 0, 1, 1, 0, 1, 0, 0, 1, 1, 1, 0]",124,50,74,1,5,0.02,0.06756756756756757
"[0, 0, 1, 1, 1, 1, 1, 0, 0, 0, 0, 1, 1, 0, 1]",196,95,101,7,9,0.07368421052631578,0.0891089108910891
"[1, 1, 0, 0, 0, 1, 1, 0, 0, 0, 1, 0, 1, 0, 0]",152,86,66,9,6,0.10465116279069768,0.09090909090909091
"[0, 1, 1, 0, 1, 1, 0, 1, 1, 0, 1, 1, 0, 1, 0]",151,56,95,8,10,0.14285714285714285,0.10526315789473684
"[1, 0, 1, 1, 0, 1, 0, 0, 0, 1, 1, 1, 0, 1, 1]",133,60,73,5,10,0.08333333333333333,0.136986301369863
"[1, 0, 1, 1, 1, 0, 0, 0, 0, 0, 1, 0, 0, 1, 0]",154,90,64,14,12,0.15555555555555556,0.1875
"[1, 0, 1, 0, 1, 0, 0, 1, 1, 0, 1, 0, 1, 0, 0]",106,53,53,2,5,0.03773584905660377,0.09433962264150944
"[1, 1, 1, 0, 1, 0, 0, 0, 0, 1, 0, 1, 1, 1, 0]",114,55,59,3,8,0.05454545454545454,0.13559322033898305
"[0, 1, 0, 0, 1, 1, 0, 1, 0, 0, 1, 0, 0, 0, 1]",148,98,50,8,5,0.08163265306122448,0.1
"[1, 1, 1, 0, 0, 0, 1, 0, 1, 0, 1, 0, 1, 1, 1]",183,64,119,7,8,0.109375,0.06722689075630252
"[0, 1, 1, 0, 1, 0, 0, 0, 1, 0, 1, 1, 1, 0, 0]",126,71,55,1,14,0.014084507042253521,0.2545454545454545
"[0, 1, 1, 1, 1, 1, 0, 0, 0, 0, 1, 0, 1, 1, 0]",129,58,71,5,9,0.08620689655172414,0.1267605633802817
"[0, 0, 0, 0, 1, 1, 1, 1, 1, 0, 1, 1, 1, 0, 1]",228,91,137,9,13,0.0989010989010989,0.0948905109489051
"[1, 0, 0, 1, 0, 1, 1, 0, 1, 0, 0, 0, 1, 0, 1]",111,59,52,4,11,0.06779661016949153,0.21153846153846154
"[0, 0, 1, 1, 0, 0, 1, 1, 1, 0, 1, 1, 1, 0, 1]",192,81,111,14,8,0.1728395061728395,0.07207207207207207
"[1, 1, 0, 1, 0, 0, 0, 0, 1, 0, 0, 0, 1, 1, 1]",171,89,82,8,10,0.0898876404494382,0.12195121951219512
"[0, 0, 0, 1, 0, 1, 1, 0, 1, 1, 0, 1, 1, 1, 0]",107,47,60,5,6,0.10638297872340426,0.1
"[0, 0, 1, 0, 0, 1, 0, 0, 1, 0, 1, 0, 1, 1, 0]",139,83,56,5,3,0.060240963855421686,0.05357142857142857
"[0, 1, 1, 0, 1, 0, 0, 0, 1, 1, 0, 1, 1, 0, 1]",110,58,52,10,4,0.1724137931034483,0.07692307692307693
"[1, 1, 1, 1, 0, 0, 0, 0, 1, 0, 1, 1, 0, 0, 1]",189,74,115,8,11,0.10810810810810811,0.09565217391304348
"[1, 0, 1, 1, 1, 1, 0, 0, 0, 0, 1, 0, 1, 1, 0]",119,58,61,3,6,0.05172413793103448,0.09836065573770492
"[1, 1, 1, 0, 1, 0, 1, 1, 0, 0, 0, 1, 1, 0, 1]",136,57,79,5,7,0.08771929824561403,0.08860759493670886
"[0, 1, 0, 1, 0, 1, 1, 0, 1, 1, 0, 1, 0, 0, 1]",114,62,52,3,5,0.04838709677419355,0.09615384615384616
"[0, 0, 0, 0, 0, 1, 1, 1, 0, 1, 1, 0, 0, 0, 1]",204,139,65,18,4,0.12949640287769784,0.06153846153846154
"[1, 1, 0, 1, 0, 0, 0, 0, 0, 0, 1, 0, 1, 1, 1]",165,85,80,8,11,0.09411764705882353,0.1375
"[0, 1, 1, 0, 1, 1, 1, 1, 0, 0, 0, 1, 0, 0, 1]",111,49,62,5,7,0.10204081632653061,0.11290322580645161
"[1, 0, 1, 1, 0, 1, 1, 0, 0, 0, 1, 0, 1, 1, 1]",153,60,93,8,12,0.13333333333333333,0.12903225806451613
"[1, 1, 0, 0, 0, 0, 1, 0, 1, 1, 1, 0, 0, 1, 1]",172,77,95,8,7,0.1038961038961039,0.07368421052631578
"[1, 0, 0, 1, 1, 0, 1, 1, 0, 1, 0, 1, 1, 1, 0]",140,65,75,9,2,0.13846153846153847,0.02666666666666667
"[1, 0, 1, 0, 1, 0, 1, 1, 0, 0, 0, 0, 0, 1, 0]",142,80,62,9,6,0.1125,0.0967741935483871
"[0, 1, 1, 0, 0, 1, 0, 1, 1, 1, 1, 1, 0, 0, 1]",197,92,105,4,9,0.043478260869565216,0.08571428571428572
"[1, 1, 1, 1, 0, 1, 0, 0, 0, 0, 0, 0, 1, 0, 1]",121,68,53,10,8,0.14705882352941177,0.1509433962264151
"[1, 0, 1, 1, 0, 0, 0, 1, 0, 0, 0, 1, 0, 0, 1]",144,85,59,5,7,0.058823529411764705,0.11864406779661017
"[1, 0, 1, 1, 0, 1, 1, 1, 0, 0, 0, 1, 0, 1, 0]",105,46,59,7,7,0.15217391304347827,0.11864406779661017
"[0, 0, 1, 0, 1, 1, 1, 0, 0, 1, 0, 0, 0, 1, 0]",136,78,58,13,5,0.16666666666666666,0.08620689655172414
"[0, 1, 1, 1, 0, 1, 0, 1, 1, 1, 0, 0, 1, 1, 1]",341,128,213,19,22,0.1484375,0.10328638497652583
"[1, 1, 1, 0, 1, 1, 0, 0, 1, 1, 0, 1, 1, 0, 0]",150,56,94,5,7,0.08928571428571429,0.07446808510638298
"[1, 0, 1, 0, 1, 1, 1, 0, 0, 1, 1, 1, 0, 0, 1]",162,61,101,6,13,0.09836065573770492,0.12871287128712872
"[0, 1, 0, 0, 1, 0, 1, 0, 1, 0, 0, 0, 1, 0, 0]",231,145,86,13,8,0.0896551724137931,0.09302325581395349
"[0, 0, 1, 0, 0, 1, 0, 1, 1, 1, 1, 1, 1, 1, 0]",190,82,108,14,12,0.17073170731707318,0.1111111111111111
"[0, 0, 0, 0, 1, 1, 1, 0, 1, 1, 0, 0, 0, 1, 1]",175,107,68,10,5,0.09345794392523364,0.07352941176470588
"[1, 0, 1, 1, 0, 0, 0, 1, 1, 0, 0, 1, 1, 1, 0]",134,60,74,8,7,0.13333333333333333,0.0945945945945946
"[1, 0, 1, 0, 0, 0, 0, 1, 0, 1, 0, 1, 0, 0, 1]",119,69,50,8,2,0.11594202898550725,0.04
"[0, 1, 1, 1, 0, 0, 0, 1, 0, 0, 1, 0, 1, 0, 1]",103,68,35,7,6,0.10294117647058823,0.17142857142857143
"[1, 1, 0, 0, 1, 0, 1, 1, 1, 0, 1, 0, 0, 1, 0]",112,60,52,6,8,0.1,0.15384615384615385
"[0, 0, 1, 0, 1, 0, 0, 1, 0, 0, 0, 1, 0, 1, 1]",156,89,67,7,9,0.07865168539325842,0.13432835820895522
"[1, 0, 0, 0, 1, 0, 0, 1, 0, 0, 0, 1, 1, 1, 0]",150,83,67,8,8,0.0963855421686747,0.11940298507462686
"[1, 1, 0, 0, 1, 0, 0, 1, 1, 0, 1, 1, 1, 0, 0]",104,50,54,4,0,0.08,0.0
"[0, 0, 0, 1, 1, 1, 0, 1, 1, 1, 0, 0, 1, 0, 1]",109,66,43,4,5,0.06060606060606061,0.11627906976744186
"[0, 1, 0, 0, 0, 1, 0, 0, 1, 1, 0, 1, 0, 1, 1]",100,56,44,4,1,0.07142857142857142,0.022727272727272728
"[1, 1, 1, 0, 1, 0, 1, 0, 1, 1, 1, 0, 0, 0, 1]",148,61,87,8,11,0.13114754098360656,0.12643678160919541
"[0, 1, 0, 1, 1, 1, 1, 1, 1, 0, 1, 0, 1, 0, 1]",211,79,132,9,15,0.11392405063291139,0.11363636363636363
"[0, 0, 1, 1, 0, 1, 1, 1, 0, 1, 1, 0, 1, 0, 1]",120,50,70,5,6,0.1,0.08571428571428572
"[0, 0, 1, 1, 0, 1, 1, 0, 1, 0, 0, 1, 0, 1, 0]",105,54,51,3,6,0.05555555555555555,0.11764705882352941
"[1, 1, 0, 1, 0, 0, 1, 1, 0, 0, 0, 1, 0, 0, 1]",146,74,72,9,7,0.12162162162162163,0.09722222222222222
"[0, 1, 1, 0, 0, 1, 1, 1, 0, 1, 1, 1, 0, 0, 1]",202,96,106,8,5,0.08333333333333333,0.04716981132075472
"[0, 0, 0, 1, 0, 1, 0, 0, 1, 1, 1, 1, 1, 0, 1]",118,59,59,7,2,0.11864406779661017,0.03389830508474576
"[0, 0, 1, 1, 0, 1, 0, 1, 1, 1, 0, 0, 1, 0, 1]",100,48,52,2,3,0.041666666666666664,0.057692307692307696
"[1, 0, 1, 0, 0, 0, 1, 0, 1, 1, 0, 0, 0, 1, 1]",133,73,60,8,2,0.1095890410958904,0.03333333333333333
"[0, 1, 1, 0, 1, 0, 0, 0, 1, 0, 1, 1, 0, 0, 0]",167,93,74,10,7,0.10752688172043011,0.0945945945945946
"[1, 0, 0, 0, 0, 1, 1, 1, 0, 1, 0, 1, 0, 1, 0]",108,58,50,5,6,0.08620689655172414,0.12
"[1, 1, 1, 1, 0, 1, 0, 0, 0, 0, 1, 0, 0, 0, 0]",181,112,69,9,8,0.08035714285714286,0.11594202898550725
"[1, 1, 1, 1, 1, 1, 0, 1, 0, 0, 0, 0, 1, 0, 0]",146,61,85,2,13,0.03278688524590164,0.15294117647058825
"[1, 0, 0, 0, 0, 0, 1, 1, 1, 0, 1, 0, 1, 0, 0]",135,78,57,11,4,0.14102564102564102,0.07017543859649122
"[1, 0, 0, 1, 1, 1, 0, 1, 1, 0, 1, 0, 0, 0, 1]",100,51,49,0,4,0.0,0.08163265306122448
"[1, 0, 1, 1, 1, 0, 1, 0, 0, 1, 0, 1, 0, 1, 0]",106,50,56,4,7,0.08,0.125
"[0, 1, 1, 0, 1, 0, 0, 0, 0, 1, 1, 1, 0, 0, 1]",124,64,60,5,5,0.078125,0.08333333333333333
"[1, 1, 0, 1, 1, 0, 1, 1, 1, 0, 1, 1, 0, 0, 0]",170,82,88,7,13,0.08536585365853659,0.14772727272727273
"[0, 1, 0, 0, 1, 0, 1, 1, 0, 1, 0, 1, 1, 0, 0]",115,61,54,9,7,0.14754098360655737,0.12962962962962962
"[1, 0, 1, 0, 0, 1, 0, 1, 1, 0, 1, 0, 1, 1, 0]",93,48,45,4,8,0.08333333333333333,0.17777777777777778
"[0, 1, 0, 1, 1, 0, 1, 0, 0, 1, 0, 1, 1, 1, 0]",96,41,55,3,6,0.07317073170731707,0.10909090909090909
"[1, 1, 0, 1, 0, 0, 0, 1, 0, 1, 0, 0, 0, 1, 1]",124,72,52,12,2,0.16666666666666666,0.038461538461538464
"[1, 0, 1, 0, 0, 1, 1, 0, 0, 0, 1, 1, 0, 0, 0]",179,105,74,9,12,0.08571428571428572,0.16216216216216217
"[1, 1, 0, 1, 1, 1, 0, 0, 1, 0, 1, 1, 0, 0, 0]",117,60,57,7,4,0.11666666666666667,0.07017543859649122
"[1, 0, 1, 0, 0, 0, 0, 1, 1, 0, 1, 0, 0, 0, 1]",141,72,69,10,9,0.1388888888888889,0.13043478260869565
"[1, 1, 1, 1, 0, 0, 1, 1, 0, 1, 0, 0, 1, 0, 1]",186,86,100,4,8,0.046511627906976744,0.08
"[0, 1, 1, 0, 1, 0, 1, 1, 0, 0, 1, 0, 0, 1, 0]",92,49,43,5,5,0.10204081632653061,0.11627906976744186
"[0, 1, 0, 0, 1, 0, 1, 1, 1, 0, 0, 0, 1, 0, 1]",118,69,49,8,6,0.11594202898550725,0.12244897959183673
"[0, 1, 1, 0, 1, 1, 0, 0, 1, 1, 1, 1, 0, 1, 0]",158,64,94,3,6,0.046875,0.06382978723404255
"[1, 0, 1, 0, 0, 1, 0, 1, 0, 1, 0, 1, 0, 1, 0]",92,49,43,5,6,0.10204081632653061,0.13953488372093023
"[0, 0, 1, 0, 1, 0, 0, 0, 0, 0, 1, 0, 1, 1, 1]",233,145,88,9,7,0.06206896551724138,0.07954545454545454
"[1, 1, 1, 0, 1, 1, 0, 0, 1, 0, 0, 0, 0, 1, 0]",99,57,42,8,2,0.14035087719298245,0.047619047619047616
"[1, 1, 0, 1, 1, 1, 1, 0, 0, 0, 1, 0, 1, 0, 0]",134,69,65,6,11,0.08695652173913043,0.16923076923076924
"[0, 1, 0, 0, 1, 0, 0, 1, 0, 1, 0, 0, 1, 0, 0]",223,144,79,6,11,0.041666666666666664,0.13924050632911392
"[1, 1, 1, 0, 1, 0, 0, 1, 1, 1, 0, 1, 0, 0, 0]",125,55,70,2,9,0.03636363636363636,0.12857142857142856
"[1, 0, 1, 0, 0, 0, 1, 1, 1, 0, 0, 0, 1, 1, 1]",149,77,72,3,9,0.03896103896103896,0.125
"[0, 0, 1, 1, 0, 0, 1, 1, 0, 1, 1, 1, 0, 1, 1]",212,74,138,5,11,0.06756756756756757,0.07971014492753623
"[1, 1, 1, 0, 1, 0, 0, 1, 1, 0, 1, 0, 0, 1, 0]",121,52,69,9,4,0.17307692307692307,0.057971014492753624
"[1, 1, 0, 1, 1, 0, 1, 1, 1, 0, 0, 0, 0, 0, 0]",230,112,118,10,10,0.08928571428571429,0.0847457627118644
"[0, 0, 1, 1, 1, 0, 1, 1, 0, 0, 1, 0, 1, 1, 1]",178,83,95,7,10,0.08433734939759036,0.10526315789473684
"[1, 0, 0, 0, 1, 0, 1, 0, 0, 0, 1, 1, 0, 1, 0]",122,70,52,9,4,0.12857142857142856,0.07692307692307693
"[0, 1, 0, 1, 0, 1, 1, 0, 0, 1, 0, 0, 0, 1, 0]",121,67,54,9,2,0.13432835820895522,0.037037037037037035
"[0, 1, 0, 0, 1, 1, 0, 0, 1, 0, 0, 1, 1, 0, 1]",107,62,45,9,5,0.14516129032258066,0.1111111111111111
"[1, 1, 0, 0, 1, 0, 0, 1, 1, 0, 1, 0, 1, 0, 0]",109,57,52,3,6,0.05263157894736842,0.11538461538461539
"[1, 0, 0, 0, 0, 1, 1, 1, 0, 1, 0, 0, 1, 0, 1]",133,57,76,6,5,0.10526315789473684,0.06578947368421052
"[1, 1, 0, 0, 0, 1, 1, 1, 0, 0, 1, 0, 1, 0, 0]",115,60,55,6,5,0.1,0.09090909090909091
"[0, 1, 0, 1, 1, 1, 0, 0, 1, 0, 0, 1, 1, 0, 1]",117,51,66,3,7,0.058823529411764705,0.10606060606060606
"[1, 0, 0, 0, 1, 1, 1, 0, 1, 0, 0, 0, 0, 1, 0]",109,71,38,5,4,0.07042253521126761,0.10526315789473684
"[1, 1, 1, 1, 0, 0, 0, 1, 1, 0, 1, 0, 1, 0, 0]",139,61,78,5,4,0.08196721311475409,0.05128205128205128
"[0, 1, 0, 1, 1, 1, 1, 0, 1, 1, 0, 1, 1, 0, 0]",148,66,82,5,11,0.07575757575757576,0.13414634146341464
"[0, 1, 0, 0, 1, 0, 1, 1, 1, 1, 1, 0, 0, 0, 1]",127,57,70,5,7,0.08771929824561403,0.1
"[1, 0, 1, 0, 1, 0, 1, 0, 0, 0, 1, 1, 0, 1, 0]",103,54,49,5,6,0.09259259259259259,0.12244897959183673
"[0, 1, 0, 1, 1, 1, 0, 0, 0, 0, 1, 0, 1, 1, 1]",137,61,76,4,5,0.06557377049180328,0.06578947368421052
"[1, 0, 1, 1, 0, 0, 1, 1, 0, 1, 0, 1, 0, 0, 0]",124,65,59,3,5,0.046153846153846156,0.0847457627118644
"[1, 0, 1, 1, 1, 0, 0, 0, 1, 0, 1, 1, 0, 0, 0]",116,59,57,5,9,0.0847457627118644,0.15789473684210525
"[0, 0, 0, 1, 1, 1, 0, 0, 1, 0, 1, 0, 0, 1, 0]",139,83,56,7,5,0.08433734939759036,0.08928571428571429
"[0, 1, 1, 1, 0, 0, 0, 1, 0, 0, 1, 1, 1, 0, 1]",98,53,45,3,2,0.05660377358490566,0.044444444444444446
"[0, 0, 0, 0, 1, 1, 1, 1, 0, 1, 0, 1, 0, 0, 1]",158,86,72,6,8,0.06976744186046512,0.1111111111111111
"[1, 1, 1, 0, 0, 1, 0, 1, 0, 0, 0, 0, 1, 0, 1]",110,56,54,6,4,0.10714285714285714,0.07407407407407407
"[1, 1, 1, 0, 1, 0, 0, 1, 0, 0, 0, 1, 1, 0, 1]",88,43,45,5,7,0.11627906976744186,0.15555555555555556
"[1, 0, 0, 0, 1, 0, 1, 0, 0, 1, 1, 0, 1, 0, 1]",122,61,61,5,5,0.08196721311475409,0.08196721311475409
"[0, 1, 1, 0, 0, 0, 1, 1, 0, 1, 0, 0, 1, 0, 1]",115,64,51,10,5,0.15625,0.09803921568627451
"[1, 0, 0, 1, 0, 0, 0, 0, 0, 1, 0, 1, 1, 1, 0]",161,96,65,6,12,0.0625,0.18461538461538463
"[0, 1, 0, 1, 1, 0, 1, 1, 0, 0, 0, 1, 0, 1, 1]",115,52,63,5,4,0.09615384615384616,0.06349206349206349
"[1, 0, 0, 1, 0, 0, 1, 0, 1, 0, 0, 1, 1, 0, 1]",106,60,46,7,2,0.11666666666666667,0.043478260869565216
"[0, 1, 0, 1, 1, 0, 1, 1, 1, 0, 1, 0, 1, 1, 0]",131,55,76,9,5,0.16363636363636364,0.06578947368421052
"[0, 1, 0, 1, 0, 1, 1, 0, 1, 0, 0, 1, 0, 1, 0]",98,52,46,4,4,0.07692307692307693,0.08695652173913043
"[0, 1, 0, 0, 1, 1, 0, 1, 0, 1, 0, 1, 1, 1, 0]",90,50,40,4,2,0.08,0.05
"[1, 1, 0, 0, 0, 1, 1, 0, 1, 1, 0, 1, 0, 1, 0]",127,63,64,11,2,0.1746031746031746,0.03125
"[1, 1, 0, 1, 1, 1, 0, 1, 0, 0, 1, 0, 0, 0, 0]",116,69,47,6,6,0.08695652173913043,0.1276595744680851
"[1, 0, 1, 0, 0, 0, 1, 0, 1, 1, 0, 0, 0, 1, 0]",126,71,55,5,1,0.07042253521126761,0.01818181818181818
"[1, 1, 0, 0, 1, 0, 0, 0, 1, 1, 1, 0, 0, 1, 0]",120,53,67,2,10,0.03773584905660377,0.14925373134328357
"[1, 1, 0, 1, 0, 0, 1, 0, 0, 1, 0, 1, 0, 1, 1]",115,55,60,5,8,0.09090909090909091,0.13333333333333333
"[0, 1, 1, 0, 0, 0, 1, 1, 0, 0, 1, 0, 1, 0, 1]",110,68,42,11,5,0.16176470588235295,0.11904761904761904
"[1, 1, 1, 1, 0, 0, 0, 1, 0, 0, 0, 1, 0, 1, 1]",134,63,71,5,7,0.07936507936507936,0.09859154929577464
"[1, 1, 1, 1, 1, 0, 0, 0, 1, 0, 0, 0, 1, 0, 1]",129,56,73,5,10,0.08928571428571429,0.136986301369863
"[0, 1, 1, 1, 0, 1, 0, 1, 1, 0, 1, 0, 0, 0, 0]",117,59,58,7,6,0.11864406779661017,0.10344827586206896
"[1, 0, 1, 0, 1, 1, 0, 1, 1, 0, 1, 1, 1, 0, 0]",147,71,76,5,7,0.07042253521126761,0.09210526315789473
"[1, 1, 1, 1, 0, 0, 1, 0, 0, 0, 1, 1, 0, 0, 0]",175,94,81,8,5,0.0851063829787234,0.06172839506172839
"[1, 0, 1, 1, 0, 0, 0, 1, 1, 0, 1, 0, 1, 0, 1]",98,45,53,0,3,0.0,0.05660377358490566
"[0, 1, 0, 1, 1, 1, 1, 0, 0, 0, 1, 0, 0, 0, 1]",131,73,58,5,8,0.0684931506849315,0.13793103448275862
"[0, 0, 1, 1, 1, 0, 1, 0, 0, 1, 0, 0, 1, 0, 0]",146,87,59,2,4,0.022988505747126436,0.06779661016949153
"[1, 0, 1, 0, 0, 1, 1, 1, 0, 1, 0, 0, 1, 0, 0]",94,38,56,2,8,0.05263157894736842,0.14285714285714285
"[0, 1, 0, 0, 1, 0, 0, 1, 0, 1, 0, 1, 0, 1, 1]",115,67,48,10,3,0.14925373134328357,0.0625
"[0, 1, 0, 1, 0, 0, 0, 1, 0, 1, 1, 1, 0, 1, 1]",108,61,47,3,8,0.04918032786885246,0.1702127659574468
"[0, 1, 0, 0, 1, 1, 0, 1, 0, 0, 1, 1, 0, 1, 0]",85,52,33,7,1,0.1346153846153846,0.030303030303030304
"[0, 0, 1, 0, 0, 1, 0, 1, 0, 1, 1, 0, 1, 1, 0]",87,46,41,1,3,0.021739130434782608,0.07317073170731707
"[1, 1, 0, 1, 1, 0, 1, 1, 0, 1, 0, 0, 1, 1, 0]",144,71,73,7,11,0.09859154929577464,0.1506849315068493
"[1, 0, 1, 0, 0, 1, 1, 0, 0, 1, 0, 0, 1, 1, 0]",120,62,58,5,2,0.08064516129032258,0.034482758620689655
"[1, 0, 1, 0, 1, 0, 0, 0, 0, 0, 1, 1, 1, 0, 1]",109,62,47,2,3,0.03225806451612903,0.06382978723404255
"[0, 1, 0, 1, 1, 1, 0, 1, 0, 0, 1, 0, 1, 0, 1]",86,46,40,3,4,0.06521739130434782,0.1
"[1, 0, 1, 1, 1, 1, 0, 0, 0, 1, 0, 0, 0, 1, 0]",127,70,57,5,7,0.07142857142857142,0.12280701754385964
"[0, 1, 0, 0, 0, 1, 0, 1, 0, 1, 0, 1, 1, 0, 1]",102,49,53,4,5,0.08163265306122448,0.09433962264150944
"[1, 1, 1, 0, 0, 0, 0, 0, 0, 0, 1, 1, 1, 0, 0]",244,119,125,10,16,0.08403361344537816,0.128
"[1, 1, 1, 1, 1, 1, 1, 1, 0, 0, 0, 0, 0, 0, 0]",1899,865,1034,78,78,0.09017341040462427,0.07543520309477757
"[0, 0, 1, 1, 0, 1, 0, 1, 1, 1, 1, 0, 0, 1, 1]",262,118,144,15,10,0.1271186440677966,0.06944444444444445
"[1, 1, 0, 1, 0, 1, 0, 0, 0, 0, 1, 1, 0, 0, 0]",243,129,114,18,11,0.13953488372093023,0.09649122807017543
"[1, 0, 0, 0, 0, 1, 1, 0, 1, 0, 1, 0, 0, 0, 0]",287,166,121,14,8,0.08433734939759036,0.06611570247933884
"[0, 0, 1, 1, 0, 0, 0, 0, 1, 1, 0, 1, 0, 1, 0]",239,126,113,12,8,0.09523809523809523,0.07079646017699115
"[0, 0, 1, 0, 0, 0, 0, 1, 1, 0, 0, 0, 0, 1, 1]",828,522,306,52,26,0.09961685823754789,0.08496732026143791
"[1, 0, 0, 1, 0, 0, 0, 0, 1, 1, 0, 0, 0, 0, 1]",477,289,188,28,17,0.09688581314878893,0.09042553191489362
"[0, 0, 1, 1, 0, 1, 0, 0, 0, 1, 1, 0, 0, 1, 0]",157,90,67,7,6,0.07777777777777778,0.08955223880597014
"[1, 0, 1, 1, 1, 0, 0, 0, 1, 1, 0, 1, 0, 0, 0]",102,48,54,8,4,0.16666666666666666,0.07407407407407407
"[0, 0, 1, 0, 0, 0, 1, 1, 0, 1, 1, 1, 0, 0, 0]",156,98,58,8,6,0.08163265306122448,0.10344827586206896
"[1, 1, 1, 1, 1, 0, 0, 1, 1, 1, 1, 1, 1, 1, 1]",30273,3112,27161,293,2641,0.09415167095115681,0.09723500607488679
"[1, 1, 1, 1, 1, 1, 0, 0, 1, 1, 1, 1, 1, 1, 1]",30942,5497,25445,504,2441,0.09168637438602874,0.09593240322263706
"[0, 1, 1, 0, 1, 1, 0, 1, 1, 1, 1, 1, 0, 1, 0]",230,80,150,8,13,0.1,0.08666666666666667
"[0, 0, 0, 0, 0, 0, 0, 1, 1, 1, 1, 1, 1, 1, 1]",2263,1757,506,174,44,0.09903244166192374,0.08695652173913043
"[1, 1, 1, 1, 1, 1, 1, 1, 1, 0, 1, 1, 1, 1, 1]",61297,7099,54198,674,5149,0.09494294971122694,0.09500350566441566
"[1, 0, 1, 1, 1, 1, 1, 1, 1, 1, 1, 1, 0, 1, 1]",7211,1378,5833,122,541,0.08853410740203194,0.092748157037545
"[0, 1, 0, 1, 0, 0, 0, 0, 1, 1, 0, 0, 1, 0, 0]",246,143,103,17,4,0.11888111888111888,0.038834951456310676
"[0, 0, 0, 0, 0, 0, 1, 1, 0, 1, 1, 0, 0, 0, 1]",341,213,128,20,13,0.09389671361502347,0.1015625
"[1, 0, 0, 1, 0, 1, 0, 0, 0, 0, 0, 0, 1, 1, 0]",363,216,147,23,10,0.10648148148148148,0.06802721088435375
"[0, 0, 0, 0, 1, 0, 1, 1, 0, 0, 1, 0, 1, 0, 0]",223,149,74,14,5,0.09395973154362416,0.06756756756756757
"[1, 0, 0, 0, 0, 1, 0, 1, 1, 0, 0, 1, 0, 1, 0]",118,61,57,5,8,0.08196721311475409,0.14035087719298245
"[0, 0, 0, 0, 0, 0, 0, 0, 0, 0, 0, 0, 0, 0, 0]",1205496,1132140,73356,108277,7076,0.09563923189711519,0.09646109384372104
"[0, 0, 0, 0, 0, 1, 0, 0, 0, 0, 0, 0, 0, 0, 0]",60143,52840,7303,5012,739,0.09485238455715367,0.10119129125017116
"[0, 0, 0, 1, 0, 0, 0, 0, 0, 0, 0, 0, 0, 0, 0]",63634,55655,7979,5116,756,0.09192345701194861,0.0947487153778669
"[1, 1, 0, 1, 1, 0, 1, 1, 1, 1, 0, 0, 1, 0, 0]",143,54,89,3,14,0.05555555555555555,0.15730337078651685
"[0, 0, 0, 0, 0, 1, 1, 1, 1, 0, 1, 1, 0, 1, 1]",234,151,83,11,9,0.0728476821192053,0.10843373493975904
"[1, 1, 1, 1, 1, 1, 0, 1, 1, 1, 0, 1, 0, 1, 1]",1762,395,1367,36,157,0.09113924050632911,0.11485003657644477
"[0, 0, 1, 1, 1, 1, 1, 1, 1, 1, 0, 1, 1, 1, 0]",785,248,537,21,60,0.0846774193548387,0.11173184357541899
"[1, 1, 1, 1, 1, 0, 1, 0, 0, 0, 1, 1, 1, 1, 1]",865,235,630,19,65,0.08085106382978724,0.10317460317460317
"[1, 1, 1, 0, 1, 1, 0, 1, 1, 1, 1, 0, 1, 1, 1]",1721,376,1345,40,151,0.10638297872340426,0.11226765799256505
"[0, 1, 0, 1, 1, 0, 1, 1, 1, 0, 1, 1, 1, 1, 0]",236,80,156,6,18,0.075,0.11538461538461539
"[1, 0, 1, 1, 1, 1, 1, 1, 1, 1, 1, 0, 1, 0, 1]",1582,384,1198,52,113,0.13541666666666666,0.09432387312186978
"[1, 1, 1, 1, 0, 1, 0, 0, 1, 0, 1, 1, 1, 1, 1]",643,178,465,19,44,0.10674157303370786,0.09462365591397849
"[1, 1, 0, 1, 0, 0, 1, 1, 1, 0, 1, 1, 0, 0, 1]",172,67,105,7,12,0.1044776119402985,0.11428571428571428
"[1, 0, 0, 0, 1, 1, 0, 0, 1, 1, 0, 0, 0, 0, 0]",801,502,299,46,38,0.09163346613545817,0.12709030100334448
"[0, 0, 1, 0, 0, 0, 0, 1, 0, 1, 0, 1, 1, 0, 1]",140,86,54,11,6,0.12790697674418605,0.1111111111111111
"[1, 1, 0, 1, 1, 1, 0, 1, 1, 1, 1, 1, 1, 1, 1]",8536,1570,6966,151,628,0.09617834394904459,0.09015216767154752
"[1, 1, 1, 0, 1, 1, 1, 0, 1, 1, 1, 1, 1, 1, 1]",8258,1435,6823,135,614,0.09407665505226481,0.08998974058332113
"[1, 1, 1, 1, 0, 0, 0, 1, 0, 0, 1, 1, 0, 0, 0]",196,105,91,10,5,0.09523809523809523,0.054945054945054944
"[0, 0, 1, 1, 1, 1, 1, 0, 0, 0, 1, 0, 0, 1, 1]",207,109,98,8,7,0.07339449541284404,0.07142857142857142
"[0, 0, 0, 0, 1, 0, 0, 0, 1, 0, 0, 0, 0, 0, 1]",1707,1301,406,122,42,0.09377401998462721,0.10344827586206896
"[0, 0, 0, 0, 0, 0, 1, 0, 0, 0, 1, 0, 0, 0, 0]",7502,6206,1296,615,122,0.09909764743796326,0.0941358024691358
"[0, 1, 0, 0, 0, 0, 1, 1, 1, 0, 0, 0, 0, 0, 0]",804,561,243,61,28,0.10873440285204991,0.11522633744855967
"[0, 0, 0, 0, 1, 0, 0, 0, 0, 1, 1, 1, 0, 0, 0]",641,468,173,44,13,0.09401709401709402,0.07514450867052024
"[0, 1, 0, 0, 1, 0, 0, 0, 0, 0, 0, 0, 0, 0, 1]",1922,1461,461,145,32,0.09924709103353867,0.06941431670281996
"[0, 0, 0, 0, 0, 0, 0, 0, 0, 0, 0, 1, 0, 1, 0]",8352,6970,1382,694,122,0.09956958393113342,0.08827785817655572
"[1, 1, 0, 1, 0, 1, 1, 0, 0, 0, 0, 0, 1, 1, 1]",206,95,111,5,8,0.05263157894736842,0.07207207207207207
"[0, 0, 1, 1, 0, 1, 0, 1, 1, 0, 0, 0, 0, 0, 1]",186,105,81,7,12,0.06666666666666667,0.14814814814814814
"[1, 0, 0, 1, 1, 0, 1, 0, 1, 1, 0, 0, 0, 0, 0]",201,115,86,12,8,0.10434782608695652,0.09302325581395349
"[0, 1, 0, 1, 1, 1, 1, 1, 1, 1, 1, 1, 1, 1, 1]",10981,2247,8734,236,857,0.105028927458834,0.0981222807419281
"[1, 1, 1, 1, 0, 0, 0, 1, 0, 1, 1, 1, 1, 1, 1]",897,280,617,34,71,0.12142857142857143,0.11507293354943274
"[0, 0, 1, 0, 1, 0, 1, 1, 1, 1, 1, 1, 0, 0, 0]",202,105,97,7,14,0.06666666666666667,0.14432989690721648
"[0, 1, 0, 1, 1, 0, 0, 1, 0, 1, 0, 1, 1, 1, 1]",185,78,107,11,11,0.14102564102564102,0.102803738317757
"[0, 0, 0, 1, 1, 0, 0, 0, 0, 0, 0, 0, 0, 1, 1]",5562,4907,655,445,70,0.09068677399633177,0.10687022900763359
"[0, 0, 0, 0, 0, 0, 1, 0, 0, 1, 1, 1, 0, 1, 0]",242,155,87,16,5,0.1032258064516129,0.05747126436781609
"[1, 1, 0, 1, 0, 1, 1, 0, 0, 0, 0, 0, 0, 0, 0]",480,277,203,26,23,0.09386281588447654,0.11330049261083744
"[1, 1, 1, 0, 1, 0, 1, 1, 0, 0, 0, 0, 0, 0, 0]",282,154,128,13,16,0.08441558441558442,0.125
"[1, 1, 1, 1, 1, 0, 1, 0, 0, 0, 1, 1, 1, 0, 1]",236,71,165,4,14,0.056338028169014086,0.08484848484848485
"[1, 1, 1, 1, 1, 1, 0, 1, 0, 0, 0, 1, 1, 1, 0]",294,102,192,10,20,0.09803921568627451,0.10416666666666667
"[1, 1, 1, 1, 1, 0, 0, 1, 0, 0, 0, 0, 0, 0, 1]",244,105,139,11,10,0.10476190476190476,0.07194244604316546
"[0, 0, 0, 0, 0, 0, 0, 1, 1, 1, 1, 1, 1, 0, 0]",2378,1984,394,175,38,0.08820564516129033,0.09644670050761421
"[1, 0, 0, 0, 0, 1, 1, 0, 0, 0, 0, 1, 1, 1, 1]",1798,367,1431,38,132,0.10354223433242507,0.09224318658280922
"[1, 0, 0, 0, 0, 1, 0, 1, 1, 1, 0, 0, 1, 1, 0]",146,72,74,11,11,0.1527777777777778,0.14864864864864866
"[1, 0, 1, 1, 1, 0, 0, 0, 0, 1, 0, 1, 0, 0, 0]",155,92,63,9,4,0.09782608695652174,0.06349206349206349
"[1, 1, 0, 1, 1, 1, 0, 1, 1, 1, 1, 0, 1, 1, 0]",531,149,382,11,40,0.0738255033557047,0.10471204188481675
"[1, 1, 0, 1, 1, 0, 1, 1, 1, 0, 1, 1, 1, 1, 0]",552,154,398,12,41,0.07792207792207792,0.10301507537688442
"[1, 1, 1, 1, 1, 0, 1, 1, 0, 1, 1, 1, 0, 1, 1]",1550,377,1173,32,106,0.08488063660477453,0.09036658141517477
"[1, 1, 1, 1, 0, 0, 1, 1, 1, 1, 1, 1, 1, 0, 1]",2968,717,2251,75,200,0.10460251046025104,0.0888494002665482
"[1, 1, 0, 1, 1, 1, 1, 1, 1, 0, 0, 1, 1, 1, 1]",3720,904,2816,81,273,0.08960176991150443,0.09694602272727272
"[1, 1, 1, 1, 0, 0, 1, 1, 1, 1, 0, 1, 1, 1, 1]",3060,710,2350,71,216,0.1,0.09191489361702128
"[1, 1, 0, 1, 1, 1, 1, 1, 0, 1, 1, 0, 1, 1, 1]",1647,386,1261,35,138,0.09067357512953368,0.10943695479777954
"[0, 0, 0, 1, 0, 1, 0, 0, 1, 1, 0, 0, 1, 0, 1]",149,88,61,6,3,0.06818181818181818,0.04918032786885246
"[0, 1, 1, 1, 0, 0, 0, 0, 0, 0, 1, 1, 1, 1, 1]",589,303,286,24,25,0.07920792079207921,0.08741258741258741
"[0, 0, 0, 0, 1, 1, 1, 0, 1, 0, 1, 0, 0, 0, 1]",188,114,74,6,5,0.05263157894736842,0.06756756756756757
"[1, 1, 0, 1, 0, 0, 1, 1, 0, 0, 0, 0, 0, 0, 0]",487,290,197,27,21,0.09310344827586207,0.1065989847715736
"[1, 0, 0, 1, 1, 1, 0, 1, 0, 0, 1, 1, 0, 0, 0]",183,80,103,5,10,0.0625,0.0970873786407767
"[1, 0, 0, 0, 0, 1, 1, 0, 0, 1, 0, 0, 1, 1, 1]",318,108,210,12,21,0.1111111111111111,0.1
"[0, 0, 1, 1, 0, 0, 0, 0, 0, 0, 0, 0, 1, 0, 0]",2817,2158,659,215,59,0.09962928637627433,0.08952959028831563
"[1, 0, 0, 0, 1, 1, 0, 0, 0, 0, 0, 0, 0, 0, 1]",1119,730,389,68,50,0.09315068493150686,0.12853470437017994
"[1, 1, 1, 1, 1, 0, 0, 1, 1, 1, 0, 1, 1, 1, 1]",2605,468,2137,47,220,0.10042735042735043,0.10294805802526907
"[1, 1, 1, 1, 0, 1, 1, 0, 0, 1, 1, 1, 1, 1, 1]",3061,756,2305,76,226,0.10052910052910052,0.09804772234273319
"[1, 1, 1, 1, 0, 1, 1, 1, 0, 0, 1, 1, 1, 1, 1]",2718,630,2088,68,212,0.10793650793650794,0.10153256704980843
"[1, 1, 1, 1, 1, 1, 0, 1, 1, 1, 0, 0, 1, 1, 1]",2557,590,1967,60,176,0.1016949152542373,0.08947635993899339
"[0, 0, 0, 0, 1, 1, 1, 1, 0, 1, 0, 1, 0, 0, 0]",217,120,97,16,7,0.13333333333333333,0.07216494845360824
"[0, 0, 0, 0, 1, 1, 0, 0, 0, 0, 1, 1, 1, 1, 0]",1894,1152,742,111,66,0.09635416666666667,0.0889487870619946
"[1, 0, 1, 1, 0, 0, 0, 0, 1, 1, 0, 0, 0, 0, 1]",419,239,180,13,13,0.05439330543933055,0.07222222222222222
"[1, 1, 1, 1, 1, 0, 1, 1, 1, 1, 0, 1, 1, 1, 1]",7774,1348,6426,125,570,0.09272997032640949,0.08870214752567694
"[0, 1, 0, 1, 1, 1, 0, 1, 0, 0, 0, 0, 0, 0, 0]",344,230,114,16,12,0.06956521739130435,0.10526315789473684
"[0, 1, 0, 1, 0, 0, 0, 0, 0, 1, 0, 0, 1, 0, 0]",505,338,167,37,10,0.10946745562130178,0.059880239520958084
"[1, 0, 0, 0, 1, 0, 1, 0, 0, 0, 0, 0, 1, 0, 0]",518,367,151,39,15,0.10626702997275204,0.09933774834437085
"[0, 0, 1, 0, 0, 1, 0, 0, 1, 0, 0, 1, 1, 1, 0]",148,92,56,5,7,0.05434782608695652,0.125
"[1, 1, 1, 0, 1, 1, 0, 1, 0, 0, 1, 1, 1, 0, 1]",242,80,162,6,15,0.075,0.09259259259259259
"[0, 1, 0, 0, 1, 1, 0, 1, 1, 1, 0, 1, 1, 0, 1]",123,52,71,5,7,0.09615384615384616,0.09859154929577464
"[0, 0, 1, 1, 0, 0, 0, 0, 1, 1, 0, 0, 1, 0, 0]",586,390,196,33,17,0.08461538461538462,0.08673469387755102
"[0, 0, 0, 0, 0, 0, 1, 1, 0, 0, 0, 0, 1, 1, 0]",4636,3346,1290,307,113,0.0917513448894202,0.08759689922480621
"[0, 1, 1, 0, 1, 0, 0, 0, 1, 0, 0, 0, 0, 0, 0]",635,452,183,44,17,0.09734513274336283,0.09289617486338798
"[0, 0, 0, 1, 0, 0, 0, 1, 1, 0, 1, 0, 0, 0, 1]",221,153,68,15,9,0.09803921568627451,0.1323529411764706
"[0, 0, 0, 0, 1, 0, 0, 0, 0, 0, 0, 0, 1, 1, 1]",2229,1796,433,183,35,0.10189309576837416,0.08083140877598152
"[0, 0, 0, 0, 0, 0, 1, 0, 0, 0, 0, 1, 1, 0, 0]",2688,2112,576,191,57,0.09043560606060606,0.09895833333333333
"[0, 1, 1, 0, 1, 0, 1, 0, 1, 1, 1, 0, 0, 0, 1]",114,52,62,4,5,0.07692307692307693,0.08064516129032258
"[1, 1, 1, 0, 0, 1, 1, 1, 1, 0, 1, 1, 1, 1, 1]",2679,428,2251,42,203,0.09813084112149532,0.09018214127054643
"[1, 1, 1, 1, 1, 0, 1, 1, 1, 1, 1, 1, 1, 0, 0]",2833,613,2220,60,166,0.09787928221859707,0.07477477477477477
"[1, 1, 0, 0, 0, 0, 1, 1, 0, 0, 0, 0, 0, 0, 0]",4444,3106,1338,288,132,0.0927237604636188,0.09865470852017937
"[1, 0, 1, 1, 1, 1, 1, 0, 0, 0, 1, 0, 0, 1, 0]",116,55,61,11,1,0.2,0.01639344262295082
"[0, 0, 1, 1, 0, 1, 1, 1, 1, 1, 0, 1, 1, 1, 1]",657,202,455,16,44,0.07920792079207921,0.0967032967032967
"[1, 0, 0, 1, 1, 0, 1, 1, 1, 1, 1, 0, 1, 1, 1]",638,171,467,13,49,0.07602339181286549,0.10492505353319058
"[0, 0, 1, 0, 0, 1, 0, 0, 1, 0, 0, 1, 1, 0, 1]",142,83,59,17,4,0.20481927710843373,0.06779661016949153
"[0, 1, 0, 0, 0, 1, 0, 0, 1, 0, 0, 1, 0, 0, 1]",204,144,60,9,11,0.0625,0.18333333333333332
"[0, 0, 1, 0, 0, 0, 1, 0, 0, 1, 0, 0, 1, 0, 0]",474,323,151,25,11,0.07739938080495357,0.0728476821192053
"[1, 1, 1, 1, 1, 0, 1, 1, 0, 0, 0, 1, 1, 1, 0]",254,84,170,5,12,0.05952380952380952,0.07058823529411765
"[0, 0, 1, 0, 0, 1, 1, 1, 1, 1, 0, 0, 1, 1, 1]",288,124,164,11,12,0.08870967741935484,0.07317073170731707
"[1, 0, 0, 1, 0, 0, 1, 1, 1, 1, 1, 0, 0, 1, 1]",266,108,158,8,12,0.07407407407407407,0.0759493670886076
"[0, 1, 0, 0, 1, 0, 0, 1, 1, 1, 1, 1, 0, 0, 1]",149,59,90,5,6,0.0847457627118644,0.06666666666666667
"[1, 1, 1, 1, 1, 1, 0, 1, 0, 0, 1, 0, 0, 1, 1]",322,126,196,9,25,0.07142857142857142,0.12755102040816327
"[1, 1, 1, 1, 1, 1, 1, 0, 1, 0, 0, 1, 0, 0, 1]",273,70,203,7,26,0.1,0.12807881773399016
"[0, 0, 1, 1, 0, 0, 1, 0, 0, 0, 0, 0, 1, 1, 0]",359,242,117,20,19,0.08264462809917356,0.1623931623931624
"[1, 0, 0, 0, 0, 0, 1, 1, 0, 0, 0, 0, 0, 1, 0]",626,406,220,48,15,0.11822660098522167,0.06818181818181818
"[0, 0, 0, 0, 1, 0, 1, 0, 0, 1, 0, 1, 0, 0, 1]",247,166,81,17,10,0.10240963855421686,0.12345679012345678
"[0, 1, 0, 0, 0, 0, 1, 0, 0, 0, 0, 0, 0, 0, 0]",8330,6844,1486,632,149,0.09234365867913501,0.10026917900403769
"[1, 1, 1, 0, 0, 0, 0, 1, 0, 0, 1, 1, 1, 1, 1]",321,101,220,6,21,0.0594059405940594,0.09545454545454546
"[0, 1, 1, 1, 1, 1, 1, 1, 0, 1, 1, 1, 0, 1, 0]",548,177,371,17,38,0.096045197740113,0.10242587601078167
"[1, 1, 0, 1, 1, 1, 1, 1, 1, 1, 0, 1, 1, 1, 0]",1620,346,1274,33,122,0.0953757225433526,0.09576138147566719
"[1, 1, 1, 1, 1, 0, 0, 1, 1, 1, 1, 0, 0, 1, 1]",5084,708,4376,59,405,0.08333333333333333,0.09255027422303473
"[1, 1, 0, 1, 1, 1, 0, 1, 1, 1, 0, 1, 1, 1, 1]",1667,360,1307,38,108,0.10555555555555556,0.08263198163733741
"[0, 1, 1, 1, 0, 1, 0, 0, 1, 0, 1, 1, 1, 0, 0]",139,68,71,8,9,0.11764705882352941,0.1267605633802817
"[0, 0, 0, 0, 1, 1, 1, 0, 1, 0, 0, 1, 0, 1, 1]",143,73,70,11,6,0.1506849315068493,0.08571428571428572
"[0, 0, 0, 0, 0, 0, 0, 0, 0, 0, 1, 1, 1, 0, 1]",1135,805,330,68,32,0.084472049689441,0.09696969696969697
"[1, 0, 0, 1, 0, 1, 1, 1, 1, 0, 1, 1, 1, 1, 1]",655,187,468,21,51,0.11229946524064172,0.10897435897435898
"[0, 1, 1, 1, 1, 1, 0, 1, 1, 1, 0, 1, 0, 1, 0]",239,96,143,9,20,0.09375,0.13986013986013987
"[1, 0, 1, 0, 1, 0, 0, 0, 1, 0, 0, 1, 1, 1, 1]",162,80,82,5,5,0.0625,0.06097560975609756
"[1, 1, 1, 0, 1, 0, 1, 0, 0, 0, 1, 0, 0, 1, 1]",132,58,74,6,10,0.10344827586206896,0.13513513513513514
"[1, 1, 1, 0, 0, 1, 1, 0, 1, 1, 1, 0, 0, 1, 1]",357,102,255,7,25,0.06862745098039216,0.09803921568627451
"[1, 1, 1, 0, 1, 1, 0, 0, 1, 1, 1, 1, 1, 0, 0]",389,126,263,19,22,0.15079365079365079,0.08365019011406843
"[0, 1, 1, 1, 0, 1, 1, 0, 0, 1, 1, 1, 1, 1, 0]",277,100,177,6,18,0.06,0.1016949152542373
"[0, 1, 1, 1, 1, 1, 1, 1, 1, 1, 0, 0, 1, 1, 0]",1271,499,772,42,76,0.0841683366733467,0.09844559585492228
"[1, 0, 1, 0, 0, 0, 0, 1, 0, 0, 0, 0, 0, 1, 1]",337,204,133,17,17,0.08333333333333333,0.12781954887218044
"[1, 1, 1, 1, 1, 1, 1, 0, 0, 0, 0, 1, 1, 1, 1]",5946,876,5070,86,520,0.09817351598173515,0.10256410256410256
"[1, 1, 1, 1, 1, 0, 1, 0, 1, 1, 1, 1, 1, 0, 1]",1593,340,1253,26,114,0.07647058823529412,0.09098164405426976
"[0, 0, 0, 0, 0, 0, 1, 1, 0, 0, 1, 1, 0, 0, 0]",5045,3611,1434,326,127,0.09027970091387427,0.08856345885634588
"[0, 0, 1, 1, 1, 0, 0, 0, 1, 0, 0, 0, 0, 0, 0]",723,516,207,36,19,0.06976744186046512,0.09178743961352658
"[0, 0, 0, 1, 0, 1, 0, 0, 0, 0, 0, 0, 0, 0, 0]",9108,7394,1714,671,182,0.09074925615363809,0.10618436406067679
"[1, 0, 0, 0, 1, 0, 1, 0, 0, 0, 0, 0, 0, 0, 0]",2158,1572,586,121,72,0.07697201017811704,0.12286689419795221
"[0, 0, 0, 0, 0, 0, 0, 1, 0, 0, 0, 0, 1, 0, 1]",1745,1370,375,130,24,0.0948905109489051,0.064
"[0, 0, 0, 1, 1, 0, 0, 1, 1, 1, 1, 1, 1, 1, 1]",2588,1937,651,213,61,0.109963861641714,0.09370199692780339
"[1, 0, 1, 0, 0, 1, 1, 0, 0, 1, 1, 0, 0, 0, 0]",474,257,217,26,22,0.10116731517509728,0.10138248847926268
"[1, 1, 1, 1, 1, 0, 1, 0, 1, 1, 1, 1, 0, 1, 0]",524,144,380,17,31,0.11805555555555555,0.08157894736842106
"[1, 1, 1, 0, 1, 0, 0, 0, 0, 1, 1, 1, 1, 0, 1]",154,52,102,4,6,0.07692307692307693,0.058823529411764705
"[1, 1, 0, 0, 1, 1, 1, 0, 0, 0, 0, 0, 0, 0, 0]",656,407,249,33,25,0.08108108108108109,0.10040160642570281
"[1, 1, 0, 1, 0, 1, 1, 1, 0, 0, 0, 1, 0, 0, 0]",131,66,65,7,5,0.10606060606060606,0.07692307692307693
"[1, 1, 0, 1, 1, 1, 1, 1, 0, 0, 0, 0, 1, 1, 0]",366,140,226,11,27,0.07857142857142857,0.11946902654867257
"[0, 1, 1, 1, 0, 0, 1, 1, 1, 1, 1, 1, 1, 1, 0]",1085,348,737,47,60,0.13505747126436782,0.0814111261872456
"[0, 0, 0, 1, 1, 0, 0, 0, 0, 0, 0, 0, 0, 0, 1]",4047,3418,629,315,54,0.09215915740198946,0.08585055643879173
"[0, 0, 1, 1, 0, 1, 0, 0, 1, 1, 0, 0, 0, 0, 0]",419,273,146,26,11,0.09523809523809523,0.07534246575342465
"[0, 0, 0, 1, 1, 0, 1, 0, 0, 1, 1, 0, 0, 0, 0]",401,272,129,31,9,0.11397058823529412,0.06976744186046512
"[1, 1, 0, 0, 0, 1, 1, 0, 1, 0, 0, 1, 1, 0, 0]",145,87,58,10,1,0.11494252873563218,0.017241379310344827
"[0, 0, 0, 1, 1, 1, 1, 0, 0, 0, 0, 1, 0, 0, 0]",528,420,108,32,9,0.0761904761904762,0.08333333333333333
"[0, 0, 0, 0, 0, 0, 0, 1, 0, 0, 1, 0, 0, 1, 0]",1576,1245,331,134,23,0.10763052208835341,0.06948640483383686
"[1, 0, 0, 1, 1, 0, 0, 0, 1, 0, 0, 0, 0, 0, 0]",783,504,279,54,33,0.10714285714285714,0.11827956989247312
"[1, 1, 1, 1, 1, 0, 1, 1, 0, 0, 0, 1, 1, 1, 1]",855,234,621,19,56,0.0811965811965812,0.09017713365539452
"[0, 1, 0, 1, 1, 1, 0, 0, 1, 1, 1, 1, 1, 1, 1]",1055,329,726,31,58,0.09422492401215805,0.07988980716253444
"[1, 0, 1, 1, 0, 1, 0, 1, 1, 1, 1, 1, 1, 1, 0]",576,165,411,22,38,0.13333333333333333,0.09245742092457421
"[1, 1, 1, 0, 1, 1, 0, 1, 1, 0, 0, 0, 0, 0, 0]",226,111,115,14,11,0.12612612612612611,0.09565217391304348
"[0, 0, 0, 0, 1, 1, 1, 0, 1, 1, 0, 1, 1, 0, 0]",129,75,54,7,5,0.09333333333333334,0.09259259259259259
"[1, 1, 1, 0, 1, 1, 0, 1, 0, 1, 1, 0, 0, 1, 1]",299,104,195,8,18,0.07692307692307693,0.09230769230769231
"[0, 1, 1, 1, 1, 0, 0, 1, 0, 0, 1, 1, 1, 1, 1]",442,226,216,22,24,0.09734513274336283,0.1111111111111111
"[0, 1, 1, 1, 0, 0, 1, 0, 0, 0, 1, 1, 1, 1, 0]",162,74,88,10,7,0.13513513513513514,0.07954545454545454
"[1, 1, 0, 0, 0, 0, 1, 1, 1, 0, 0, 1, 1, 0, 0]",244,136,108,9,7,0.0661764705882353,0.06481481481481481
"[0, 0, 0, 1, 0, 0, 0, 0, 1, 0, 0, 0, 1, 0, 0]",1524,1159,365,105,35,0.090595340811044,0.0958904109589041
"[0, 0, 0, 0, 0, 0, 1, 0, 0, 0, 0, 1, 0, 0, 0]",7097,5895,1202,576,92,0.09770992366412214,0.07653910149750416
"[1, 1, 1, 1, 1, 1, 1, 1, 1, 0, 0, 0, 0, 1, 1]",5793,884,4909,91,478,0.10294117647058823,0.0973721735587696
"[1, 0, 1, 0, 1, 1, 1, 1, 1, 1, 1, 1, 1, 1, 1]",10210,1837,8373,189,745,0.10288513881328253,0.08897647199331184
"[0, 0, 1, 0, 0, 1, 0, 0, 0, 0, 1, 0, 1, 1, 0]",217,145,72,18,10,0.12413793103448276,0.1388888888888889
"[1, 0, 0, 0, 0, 0, 1, 0, 0, 0, 1, 0, 0, 1, 0]",455,309,146,20,20,0.06472491909385113,0.136986301369863
"[0, 0, 0, 0, 0, 1, 0, 0, 0, 1, 0, 0, 0, 1, 1]",850,625,225,61,22,0.0976,0.09777777777777778
"[1, 0, 0, 1, 0, 0, 0, 0, 0, 0, 1, 0, 0, 0, 1]",555,387,168,35,15,0.09043927648578812,0.08928571428571429
"[1, 0, 0, 0, 0, 1, 1, 1, 0, 0, 1, 0, 0, 0, 0]",338,200,138,33,10,0.165,0.07246376811594203
"[0, 0, 1, 0, 1, 0, 0, 0, 1, 0, 0, 0, 0, 0, 0]",1694,1299,395,133,39,0.10238645111624327,0.09873417721518987
"[0, 0, 0, 0, 1, 1, 0, 1, 1, 0, 0, 1, 0, 1, 1]",161,90,71,9,8,0.1,0.11267605633802817
"[1, 1, 1, 0, 0, 0, 0, 1, 1, 0, 1, 1, 0, 0, 1]",186,71,115,4,13,0.056338028169014086,0.11304347826086956
"[0, 1, 1, 1, 1, 1, 1, 1, 0, 0, 1, 1, 1, 1, 1]",4010,1266,2744,122,257,0.09636650868878358,0.09365889212827988
"[0, 1, 1, 1, 0, 1, 1, 1, 1, 1, 1, 1, 0, 0, 1]",838,255,583,15,57,0.058823529411764705,0.09777015437392796
"[1, 1, 1, 1, 1, 0, 1, 1, 1, 1, 1, 1, 0, 0, 1]",2856,596,2260,44,184,0.0738255033557047,0.08141592920353982
"[0, 1, 0, 0, 1, 1, 1, 0, 0, 1, 0, 0, 1, 1, 1]",135,62,73,8,8,0.12903225806451613,0.1095890410958904
"[0, 0, 0, 1, 1, 1, 1, 0, 1, 0, 0, 0, 0, 0, 0]",419,282,137,19,15,0.0673758865248227,0.10948905109489052
"[0, 0, 0, 0, 1, 1, 0, 1, 0, 0, 0, 0, 0, 0, 1]",745,515,230,63,14,0.12233009708737864,0.06086956521739131
"[0, 1, 0, 1, 1, 0, 1, 0, 1, 1, 0, 0, 0, 0, 1]",129,67,62,11,7,0.16417910447761194,0.11290322580645161
"[0, 0, 1, 0, 0, 1, 0, 0, 0, 0, 0, 0, 0, 1, 0]",1556,1201,355,122,40,0.1015820149875104,0.11267605633802817
"[0, 0, 0, 1, 0, 1, 1, 0, 1, 1, 0, 0, 1, 0, 0]",132,67,65,9,7,0.13432835820895522,0.1076923076923077
"[0, 0, 1, 0, 1, 1, 1, 1, 0, 0, 0, 1, 0, 0, 0]",175,104,71,6,8,0.057692307692307696,0.11267605633802817
"[1, 1, 1, 1, 0, 1, 1, 0, 0, 1, 0, 0, 1, 0, 1]",149,55,94,9,14,0.16363636363636364,0.14893617021276595
"[0, 0, 1, 0, 0, 1, 1, 1, 0, 1, 0, 0, 0, 1, 1]",147,62,85,4,3,0.06451612903225806,0.03529411764705882
"[1, 0, 0, 1, 0, 0, 1, 1, 1, 0, 1, 0, 0, 0, 1]",150,85,65,10,5,0.11764705882352941,0.07692307692307693
"[0, 0, 0, 0, 1, 1, 1, 1, 1, 0, 1, 0, 1, 0, 0]",142,82,60,6,0,0.07317073170731707,0.0
"[0, 0, 0, 1, 0, 1, 0, 1, 0, 0, 1, 1, 1, 0, 1]",123,61,62,10,6,0.16393442622950818,0.0967741935483871
"[0, 0, 1, 1, 0, 1, 0, 0, 1, 0, 0, 0, 1, 1, 1]",197,121,76,11,9,0.09090909090909091,0.11842105263157894
"[1, 1, 0, 1, 0, 1, 1, 1, 1, 1, 0, 1, 0, 1, 0]",229,84,145,8,13,0.09523809523809523,0.0896551724137931
"[0, 1, 1, 1, 1, 1, 1, 0, 0, 1, 0, 0, 0, 1, 1]",264,161,103,15,13,0.09316770186335403,0.1262135922330097
"[0, 0, 0, 0, 0, 0, 0, 0, 1, 0, 0, 1, 1, 0, 0]",2499,1940,559,193,48,0.09948453608247422,0.08586762075134168
"[1, 0, 0, 0, 1, 0, 0, 1, 0, 0, 0, 1, 1, 0, 0]",291,198,93,18,7,0.09090909090909091,0.07526881720430108
"[0, 0, 1, 0, 0, 0, 0, 0, 0, 0, 0, 1, 1, 0, 1]",610,422,188,42,20,0.0995260663507109,0.10638297872340426
"[0, 0, 0, 1, 0, 0, 0, 0, 0, 0, 0, 0, 1, 1, 0]",3157,2437,720,240,65,0.09848173984407058,0.09027777777777778
"[0, 0, 0, 0, 1, 0, 0, 0, 0, 0, 0, 0, 0, 1, 1]",4157,3319,838,282,72,0.08496535100934016,0.08591885441527446
"[1, 1, 0, 0, 0, 0, 0, 0, 1, 0, 0, 0, 1, 1, 1]",504,324,180,27,14,0.08333333333333333,0.07777777777777778
"[1, 1, 1, 0, 0, 1, 0, 1, 1, 1, 1, 1, 1, 0, 0]",418,140,278,12,21,0.08571428571428572,0.07553956834532374
"[0, 0, 1, 0, 0, 0, 1, 1, 1, 0, 1, 0, 1, 1, 1]",131,72,59,3,4,0.041666666666666664,0.06779661016949153
"[1, 1, 1, 1, 1, 0, 0, 1, 0, 0, 1, 0, 1, 1, 1]",371,109,262,5,31,0.045871559633027525,0.1183206106870229
"[1, 1, 1, 0, 1, 1, 1, 1, 1, 0, 1, 1, 1, 1, 0]",1670,409,1261,41,102,0.10024449877750612,0.08088818398096749
"[1, 1, 0, 1, 0, 1, 1, 1, 1, 1, 1, 1, 1, 0, 1]",1572,394,1178,40,117,0.10152284263959391,0.09932088285229201
"[1, 1, 1, 1, 0, 0, 1, 1, 1, 1, 1, 1, 0, 1, 0]",923,288,635,30,68,0.10416666666666667,0.10708661417322834
"[0, 0, 1, 0, 0, 0, 1, 1, 0, 0, 1, 1, 0, 0, 0]",629,413,216,51,15,0.1234866828087167,0.06944444444444445
"[0, 0, 0, 0, 1, 0, 0, 0, 1, 1, 0, 0, 1, 1, 0]",504,341,163,39,10,0.11436950146627566,0.06134969325153374
"[1, 1, 0, 1, 1, 1, 0, 0, 0, 1, 1, 0, 0, 1, 0]",117,47,70,5,6,0.10638297872340426,0.08571428571428572
"[0, 1, 1, 0, 0, 0, 0, 0, 0, 1, 1, 1, 1, 0, 0]",1980,1641,339,130,36,0.07921998781230957,0.10619469026548672
"[1, 1, 0, 0, 0, 0, 0, 1, 0, 1, 0, 1, 1, 1, 0]",127,70,57,5,6,0.07142857142857142,0.10526315789473684
"[1, 0, 0, 0, 0, 1, 1, 0, 0, 1, 1, 1, 0, 0, 1]",255,94,161,10,11,0.10638297872340426,0.06832298136645963
"[0, 0, 0, 0, 1, 0, 0, 0, 0, 1, 1, 0, 0, 1, 1]",706,502,204,37,12,0.07370517928286853,0.058823529411764705
"[0, 1, 1, 1, 1, 1, 0, 0, 1, 1, 0, 0, 0, 1, 0]",145,85,60,8,8,0.09411764705882353,0.13333333333333333
"[0, 1, 1, 1, 1, 0, 0, 0, 1, 1, 0, 1, 1, 1, 1]",346,177,169,15,19,0.0847457627118644,0.11242603550295859
"[1, 0, 1, 0, 0, 0, 0, 0, 0, 1, 1, 0, 0, 0, 0]",1209,814,395,83,39,0.10196560196560196,0.09873417721518987
"[0, 0, 1, 1, 1, 0, 1, 0, 0, 1, 1, 0, 1, 0, 1]",108,40,68,6,5,0.15,0.07352941176470588
"[0, 1, 0, 0, 1, 0, 0, 1, 0, 0, 1, 0, 0, 0, 1]",247,152,95,16,11,0.10526315789473684,0.11578947368421053
"[1, 0, 1, 0, 0, 1, 0, 0, 1, 0, 0, 1, 0, 0, 0]",248,156,92,23,10,0.14743589743589744,0.10869565217391304
"[1, 0, 1, 1, 0, 1, 1, 1, 0, 0, 0, 1, 1, 1, 1]",320,117,203,10,20,0.08547008547008547,0.09852216748768473
"[0, 0, 1, 1, 0, 1, 1, 1, 1, 1, 0, 1, 1, 0, 1]",217,73,144,11,12,0.1506849315068493,0.08333333333333333
"[0, 0, 0, 0, 0, 1, 1, 1, 1, 0, 0, 1, 1, 0, 0]",2115,1753,362,162,41,0.09241300627495722,0.1132596685082873
"[0, 0, 0, 1, 0, 1, 1, 1, 1, 0, 0, 0, 0, 0, 0]",562,360,202,30,21,0.08333333333333333,0.10396039603960396
"[1, 0, 0, 0, 1, 0, 1, 0, 0, 1, 0, 0, 0, 0, 0]",592,391,201,44,22,0.11253196930946291,0.10945273631840796
"[0, 0, 0, 1, 0, 0, 0, 1, 0, 1, 0, 0, 1, 0, 0]",494,337,157,36,16,0.10682492581602374,0.10191082802547771
"[0, 1, 0, 0, 1, 0, 0, 1, 1, 1, 0, 0, 0, 0, 0]",326,216,110,22,12,0.10185185185185185,0.10909090909090909
"[0, 0, 1, 0, 0, 1, 0, 0, 1, 1, 1, 0, 0, 0, 0]",311,200,111,22,6,0.11,0.05405405405405406
"[0, 0, 1, 1, 0, 0, 0, 1, 0, 0, 1, 0, 0, 1, 1]",229,136,93,20,8,0.14705882352941177,0.08602150537634409
"[1, 1, 0, 0, 0, 1, 0, 1, 1, 0, 0, 0, 0, 0, 1]",175,104,71,12,9,0.11538461538461539,0.1267605633802817
"[1, 1, 1, 1, 1, 0, 0, 0, 1, 0, 1, 1, 0, 0, 0]",149,63,86,4,3,0.06349206349206349,0.03488372093023256
"[0, 1, 0, 0, 0, 0, 0, 0, 1, 0, 1, 1, 1, 1, 0]",180,102,78,12,3,0.11764705882352941,0.038461538461538464
"[0, 1, 0, 1, 0, 0, 0, 0, 0, 0, 1, 0, 0, 0, 1]",577,427,150,45,11,0.1053864168618267,0.07333333333333333
"[0, 0, 0, 0, 1, 0, 1, 1, 0, 0, 0, 1, 0, 0, 0]",580,414,166,34,21,0.0821256038647343,0.12650602409638553
"[1, 1, 1, 1, 1, 0, 0, 0, 0, 0, 0, 1, 1, 0, 0]",1618,344,1274,30,100,0.0872093023255814,0.07849293563579278
"[1, 1, 1, 0, 1, 0, 0, 0, 1, 0, 0, 1, 0, 1, 0]",118,67,51,7,2,0.1044776119402985,0.0392156862745098
"[0, 0, 0, 1, 1, 1, 1, 0, 1, 1, 0, 0, 0, 0, 1]",173,100,73,16,8,0.16,0.1095890410958904
"[0, 0, 0, 1, 0, 0, 0, 0, 0, 0, 0, 1, 0, 1, 0]",1544,1178,366,112,26,0.09507640067911714,0.07103825136612021
"[0, 0, 1, 1, 0, 0, 0, 1, 1, 0, 0, 0, 1, 1, 1]",267,159,108,15,9,0.09433962264150944,0.08333333333333333
"[0, 0, 0, 0, 0, 0, 1, 1, 0, 0, 0, 0, 1, 0, 1]",1076,758,318,83,22,0.10949868073878628,0.06918238993710692
"[0, 1, 0, 0, 0, 0, 0, 1, 0, 1, 0, 0, 1, 0, 0]",483,334,149,36,17,0.10778443113772455,0.11409395973154363
"[0, 1, 0, 1, 0, 0, 1, 0, 0, 0, 0, 0, 1, 1, 1]",250,170,80,17,8,0.1,0.1
"[0, 0, 1, 1, 0, 0, 1, 1, 0, 0, 0, 0, 0, 0, 1]",2367,1505,862,164,71,0.10897009966777409,0.08236658932714618
"[0, 0, 0, 1, 0, 0, 0, 1, 0, 0, 0, 0, 1, 1, 0]",734,559,175,41,17,0.07334525939177101,0.09714285714285714
"[1, 1, 1, 1, 0, 0, 0, 0, 1, 0, 0, 0, 1, 0, 0]",198,112,86,14,10,0.125,0.11627906976744186
"[1, 1, 0, 1, 1, 0, 0, 0, 0, 0, 1, 0, 1, 0, 0]",146,91,55,6,5,0.06593406593406594,0.09090909090909091
"[0, 1, 1, 1, 0, 1, 1, 0, 0, 0, 0, 0, 1, 0, 1]",112,64,48,4,3,0.0625,0.0625
"[0, 1, 0, 0, 0, 0, 1, 1, 0, 1, 1, 0, 0, 0, 0]",295,193,102,21,14,0.10880829015544041,0.13725490196078433
"[1, 0, 0, 1, 0, 0, 0, 0, 1, 1, 0, 1, 1, 0, 0]",157,84,73,8,5,0.09523809523809523,0.0684931506849315
"[0, 0, 1, 1, 1, 1, 1, 1, 0, 1, 1, 1, 0, 0, 0]",212,89,123,5,14,0.056179775280898875,0.11382113821138211
"[0, 1, 1, 1, 1, 0, 0, 1, 0, 1, 1, 1, 0, 0, 0]",154,77,77,9,6,0.11688311688311688,0.07792207792207792
"[0, 1, 1, 0, 0, 0, 1, 1, 1, 1, 0, 0, 1, 0, 1]",137,66,71,7,7,0.10606060606060606,0.09859154929577464
"[1, 1, 0, 1, 0, 0, 0, 1, 1, 1, 1, 0, 0, 1, 1]",364,133,231,9,27,0.06766917293233082,0.11688311688311688
"[1, 0, 1, 0, 0, 0, 0, 0, 1, 1, 1, 0, 1, 0, 0]",152,94,58,13,4,0.13829787234042554,0.06896551724137931
"[1, 0, 0, 0, 0, 0, 1, 1, 0, 0, 1, 0, 0, 0, 0]",638,444,194,46,18,0.1036036036036036,0.09278350515463918
"[1, 0, 0, 1, 0, 0, 0, 0, 0, 0, 1, 0, 0, 0, 0]",1652,1244,408,119,37,0.09565916398713827,0.09068627450980392
"[0, 0, 0, 1, 1, 0, 0, 1, 0, 1, 1, 0, 1, 0, 0]",156,103,53,7,6,0.06796116504854369,0.11320754716981132
"[1, 0, 0, 1, 0, 0, 1, 1, 0, 1, 0, 1, 0, 0, 0]",148,92,56,9,6,0.09782608695652174,0.10714285714285714
"[1, 1, 1, 0, 0, 1, 0, 1, 0, 1, 0, 0, 0, 1, 0]",100,51,49,5,2,0.09803921568627451,0.04081632653061224
"[1, 1, 1, 1, 1, 0, 0, 0, 0, 0, 0, 0, 1, 1, 0]",369,126,243,12,18,0.09523809523809523,0.07407407407407407
"[0, 0, 0, 1, 0, 0, 1, 0, 0, 0, 1, 1, 1, 1, 1]",194,116,78,18,4,0.15517241379310345,0.05128205128205128
"[1, 0, 0, 0, 1, 0, 0, 1, 0, 0, 0, 1, 1, 1, 1]",171,89,82,5,6,0.056179775280898875,0.07317073170731707
"[0, 1, 1, 0, 1, 0, 0, 0, 0, 1, 0, 1, 1, 1, 0]",106,51,55,4,5,0.0784313725490196,0.09090909090909091
"[0, 1, 0, 0, 0, 1, 0, 1, 1, 0, 1, 0, 0, 0, 0]",231,148,83,13,4,0.08783783783783784,0.04819277108433735
"[1, 0, 1, 0, 0, 0, 0, 0, 0, 0, 0, 1, 1, 0, 0]",1242,843,399,76,31,0.09015421115065243,0.07769423558897243
"[1, 0, 0, 0, 0, 1, 1, 0, 1, 1, 0, 0, 1, 1, 1]",241,92,149,4,18,0.043478260869565216,0.12080536912751678
"[0, 1, 0, 1, 1, 0, 1, 1, 1, 0, 0, 0, 0, 0, 1]",123,62,61,10,5,0.16129032258064516,0.08196721311475409
"[1, 0, 1, 1, 0, 0, 1, 0, 1, 0, 1, 0, 1, 1, 0]",102,50,52,4,7,0.08,0.1346153846153846
"[0, 0, 1, 1, 0, 0, 0, 0, 0, 0, 0, 0, 0, 1, 0]",2713,2050,663,189,61,0.09219512195121951,0.09200603318250378
"[0, 0, 1, 0, 1, 0, 0, 0, 1, 0, 1, 0, 1, 1, 0]",132,76,56,8,10,0.10526315789473684,0.17857142857142858
"[0, 0, 0, 1, 0, 1, 0, 0, 0, 1, 0, 1, 0, 1, 1]",162,108,54,8,2,0.07407407407407407,0.037037037037037035
"[0, 1, 0, 1, 0, 0, 0, 0, 1, 0, 1, 0, 0, 0, 1]",222,133,89,13,5,0.09774436090225563,0.056179775280898875
"[0, 0, 0, 0, 1, 0, 1, 1, 0, 0, 0, 1, 0, 1, 0]",230,154,76,17,6,0.11038961038961038,0.07894736842105263
"[1, 0, 0, 0, 0, 1, 0, 0, 0, 0, 1, 0, 1, 1, 0]",243,149,94,15,9,0.10067114093959731,0.09574468085106383
"[0, 0, 0, 1, 0, 0, 0, 1, 0, 0, 0, 1, 0, 1, 0]",499,354,145,31,17,0.08757062146892655,0.11724137931034483
"[0, 1, 1, 0, 1, 1, 0, 0, 1, 0, 1, 1, 1, 0, 0]",127,64,63,6,7,0.09375,0.1111111111111111
"[1, 0, 1, 0, 1, 1, 0, 1, 1, 0, 1, 1, 0, 0, 1]",134,46,88,4,6,0.08695652173913043,0.06818181818181818
"[1, 0, 1, 0, 0, 0, 0, 1, 1, 1, 1, 0, 1, 0, 1]",126,54,72,7,3,0.12962962962962962,0.041666666666666664
"[0, 1, 1, 0, 1, 0, 0, 0, 0, 1, 1, 1, 1, 0, 1]",116,57,59,4,5,0.07017543859649122,0.0847457627118644
"[0, 0, 0, 1, 0, 1, 1, 0, 0, 0, 1, 1, 1, 1, 1]",177,95,82,12,11,0.12631578947368421,0.13414634146341464
"[0, 0, 0, 1, 1, 1, 0, 1, 0, 1, 0, 1, 1, 0, 1]",123,61,62,6,6,0.09836065573770492,0.0967741935483871
"[1, 1, 0, 0, 0, 1, 0, 0, 0, 0, 1, 1, 1, 1, 0]",228,129,99,10,7,0.07751937984496124,0.0707070707070707
"[1, 1, 0, 0, 0, 1, 0, 0, 0, 1, 0, 0, 0, 0, 0]",599,432,167,51,9,0.11805555555555555,0.05389221556886228
"[0, 1, 0, 0, 0, 0, 1, 0, 0, 1, 0, 0, 0, 0, 0]",1669,1270,399,129,25,0.1015748031496063,0.06265664160401002
"[1, 0, 0, 1, 0, 0, 1, 0, 0, 0, 0, 1, 0, 0, 1]",236,151,85,15,13,0.09933774834437085,0.15294117647058825
"[0, 0, 0, 1, 0, 0, 0, 0, 1, 0, 0, 1, 0, 0, 1]",523,365,158,34,16,0.09315068493150686,0.10126582278481013
"[1, 1, 0, 0, 0, 1, 0, 0, 0, 0, 1, 0, 0, 1, 0]",253,174,79,20,7,0.11494252873563218,0.08860759493670886
"[0, 0, 0, 0, 1, 1, 0, 1, 0, 0, 0, 0, 0, 1, 1]",449,305,144,28,11,0.09180327868852459,0.0763888888888889
"[1, 1, 1, 0, 1, 1, 0, 0, 0, 0, 1, 1, 0, 0, 0]",297,157,140,16,11,0.10191082802547771,0.07857142857142857
"[1, 0, 0, 0, 0, 1, 1, 1, 1, 1, 1, 1, 0, 1, 1]",617,131,486,12,41,0.0916030534351145,0.08436213991769548
"[1, 1, 1, 0, 1, 1, 0, 1, 1, 0, 1, 1, 0, 1, 1]",517,162,355,12,32,0.07407407407407407,0.09014084507042254
"[0, 0, 1, 1, 0, 1, 1, 0, 1, 1, 0, 1, 1, 1, 1]",299,105,194,12,17,0.11428571428571428,0.08762886597938144
"[1, 1, 0, 0, 1, 1, 0, 0, 0, 0, 0, 0, 0, 1, 1]",802,469,333,49,27,0.1044776119402985,0.08108108108108109
"[0, 1, 0, 0, 0, 0, 1, 1, 0, 0, 1, 1, 0, 0, 0]",730,486,244,43,24,0.08847736625514403,0.09836065573770492
"[0, 1, 1, 1, 0, 0, 0, 0, 0, 0, 0, 0, 0, 1, 0]",713,530,183,56,12,0.10566037735849057,0.06557377049180328
"[0, 0, 0, 0, 0, 0, 0, 1, 0, 0, 0, 0, 0, 1, 1]",4029,3345,684,300,65,0.08968609865470852,0.09502923976608187
"[0, 1, 1, 1, 1, 0, 0, 0, 0, 1, 1, 1, 1, 0, 1]",448,297,151,34,17,0.11447811447811448,0.11258278145695365
"[1, 0, 1, 0, 0, 0, 1, 1, 0, 0, 0, 0, 1, 1, 0]",362,216,146,22,21,0.10185185185185185,0.14383561643835616
"[0, 0, 0, 1, 0, 1, 0, 0, 0, 1, 1, 0, 0, 0, 0]",807,566,241,47,19,0.08303886925795052,0.07883817427385892
"[0, 1, 0, 1, 1, 0, 1, 1, 1, 1, 1, 1, 0, 1, 1]",520,151,369,14,31,0.09271523178807947,0.08401084010840108
"[1, 1, 0, 1, 1, 1, 1, 1, 1, 0, 1, 0, 1, 1, 0]",520,155,365,20,33,0.12903225806451613,0.09041095890410959
"[0, 1, 1, 1, 1, 0, 1, 1, 1, 1, 0, 1, 1, 1, 1]",1717,502,1215,46,117,0.09163346613545817,0.0962962962962963
"[1, 1, 1, 1, 0, 0, 1, 0, 1, 0, 1, 0, 1, 0, 1]",158,74,84,6,12,0.08108108108108109,0.14285714285714285
"[0, 1, 1, 0, 1, 1, 1, 1, 1, 1, 1, 1, 1, 0, 1]",1682,404,1278,31,107,0.07673267326732673,0.0837245696400626
"[1, 1, 1, 1, 1, 1, 0, 1, 0, 1, 0, 1, 1, 1, 0]",546,179,367,17,25,0.09497206703910614,0.0681198910081744
"[1, 1, 1, 1, 0, 1, 0, 0, 1, 1, 1, 1, 1, 1, 1]",2653,619,2034,69,190,0.11147011308562198,0.09341199606686332
"[0, 1, 0, 0, 0, 0, 1, 0, 0, 0, 0, 0, 1, 1, 1]",481,318,163,24,8,0.07547169811320754,0.049079754601226995
"[0, 0, 1, 1, 0, 0, 0, 1, 0, 1, 1, 1, 0, 0, 0]",199,126,73,15,7,0.11904761904761904,0.0958904109589041
"[1, 0, 0, 0, 0, 1, 1, 1, 1, 1, 1, 0, 1, 1, 1]",754,140,614,11,65,0.07857142857142857,0.10586319218241043
"[1, 1, 1, 0, 1, 1, 1, 0, 0, 0, 0, 0, 1, 1, 1]",274,109,165,16,15,0.14678899082568808,0.09090909090909091
"[0, 0, 1, 1, 1, 1, 0, 1, 1, 1, 1, 0, 1, 1, 1]",727,205,522,21,53,0.1024390243902439,0.10153256704980843
"[1, 1, 1, 0, 0, 1, 1, 0, 0, 1, 1, 0, 0, 0, 1]",391,88,303,11,29,0.125,0.09570957095709572
"[1, 1, 1, 1, 0, 0, 1, 1, 0, 0, 1, 1, 0, 0, 0]",1521,738,783,76,76,0.10298102981029811,0.0970625798212005
"[0, 0, 1, 1, 0, 1, 1, 1, 1, 1, 1, 0, 1, 1, 1]",678,204,474,21,39,0.10294117647058823,0.08227848101265822
"[0, 0, 0, 0, 0, 1, 1, 0, 1, 1, 1, 1, 1, 1, 0]",209,125,84,11,12,0.088,0.14285714285714285
"[0, 0, 1, 1, 0, 0, 1, 0, 0, 1, 1, 1, 1, 0, 1]",146,73,73,7,3,0.0958904109589041,0.0410958904109589
"[1, 0, 0, 1, 1, 0, 0, 1, 0, 0, 1, 1, 1, 1, 0]",172,67,105,8,12,0.11940298507462686,0.11428571428571428
"[0, 1, 0, 0, 1, 1, 1, 0, 0, 1, 1, 0, 0, 1, 0]",126,62,64,8,8,0.12903225806451613,0.125
"[1, 0, 1, 0, 1, 0, 1, 1, 1, 1, 1, 0, 1, 1, 1]",568,153,415,21,39,0.13725490196078433,0.09397590361445783
"[1, 1, 1, 0, 1, 0, 1, 0, 1, 1, 1, 1, 1, 0, 1]",510,150,360,14,31,0.09333333333333334,0.08611111111111111
"[0, 0, 1, 1, 1, 1, 0, 1, 0, 0, 1, 1, 0, 0, 1]",183,88,95,6,9,0.06818181818181818,0.09473684210526316
"[0, 0, 0, 0, 0, 1, 1, 1, 1, 0, 1, 0, 0, 1, 1]",241,171,70,12,5,0.07017543859649122,0.07142857142857142
"[0, 1, 1, 1, 1, 0, 1, 1, 1, 1, 1, 0, 0, 0, 0]",302,142,160,13,14,0.09154929577464789,0.0875
"[0, 1, 1, 0, 1, 1, 0, 0, 0, 1, 0, 1, 0, 1, 0]",105,59,46,6,2,0.1016949152542373,0.043478260869565216
"[0, 0, 0, 0, 1, 1, 0, 0, 1, 0, 0, 1, 1, 0, 1]",194,117,77,9,8,0.07692307692307693,0.1038961038961039
"[1, 1, 1, 0, 0, 1, 1, 1, 1, 0, 1, 0, 0, 0, 1]",216,64,152,5,15,0.078125,0.09868421052631579
"[1, 0, 0, 1, 1, 1, 1, 0, 0, 1, 1, 1, 1, 0, 1]",674,100,574,10,55,0.1,0.09581881533101046
"[1, 0, 1, 0, 1, 0, 0, 0, 0, 0, 0, 0, 0, 1, 1]",552,344,208,30,29,0.0872093023255814,0.13942307692307693
"[1, 0, 1, 1, 0, 0, 1, 1, 1, 0, 0, 1, 0, 1, 0]",112,50,62,6,9,0.12,0.14516129032258066
"[0, 1, 1, 1, 0, 1, 1, 1, 0, 1, 1, 0, 1, 0, 1]",215,82,133,5,14,0.06097560975609756,0.10526315789473684
"[1, 0, 0, 1, 1, 1, 0, 1, 0, 0, 1, 0, 0, 0, 1]",118,60,58,4,7,0.06666666666666667,0.1206896551724138
"[1, 0, 0, 1, 1, 1, 1, 0, 0, 1, 0, 1, 1, 1, 1]",488,126,362,14,38,0.1111111111111111,0.10497237569060773
"[1, 1, 1, 0, 0, 1, 1, 0, 0, 1, 1, 1, 1, 0, 0]",1921,350,1571,34,152,0.09714285714285714,0.0967536600891152
"[0, 1, 0, 0, 0, 0, 1, 1, 1, 1, 1, 1, 1, 1, 1]",817,318,499,36,50,0.11320754716981132,0.10020040080160321
"[1, 1, 1, 1, 1, 1, 0, 0, 1, 0, 1, 0, 1, 0, 0]",197,80,117,12,4,0.15,0.03418803418803419
"[0, 0, 0, 0, 1, 0, 1, 0, 0, 0, 0, 1, 0, 0, 0]",1649,1259,390,108,34,0.0857823669579031,0.08717948717948718
"[1, 0, 0, 1, 1, 0, 0, 0, 0, 0, 0, 1, 0, 1, 0]",361,153,208,15,21,0.09803921568627451,0.10096153846153846
"[1, 1, 0, 0, 0, 0, 1, 0, 0, 0, 0, 0, 0, 0, 0]",2426,1845,581,168,46,0.0910569105691057,0.07917383820998279
"[1, 1, 1, 1, 0, 0, 0, 0, 1, 1, 0, 0, 1, 0, 1]",351,163,188,7,21,0.04294478527607362,0.11170212765957446
"[1, 0, 0, 1, 0, 1, 1, 1, 1, 0, 0, 0, 0, 1, 1]",298,125,173,11,12,0.088,0.06936416184971098
"[1, 1, 0, 1, 0, 0, 0, 0, 0, 0, 0, 0, 1, 1, 1]",446,240,206,17,16,0.07083333333333333,0.07766990291262135
"[0, 1, 0, 1, 1, 0, 1, 0, 0, 0, 0, 0, 0, 0, 0]",750,507,243,35,23,0.06903353057199212,0.09465020576131687
"[0, 1, 0, 1, 0, 1, 1, 0, 1, 0, 0, 0, 0, 0, 0]",298,196,102,15,8,0.07653061224489796,0.0784313725490196
"[0, 0, 1, 1, 0, 0, 1, 0, 1, 0, 1, 0, 1, 1, 0]",130,68,62,5,6,0.07352941176470588,0.0967741935483871
"[1, 1, 0, 0, 1, 0, 0, 0, 1, 0, 0, 0, 1, 1, 0]",156,97,59,14,2,0.14432989690721648,0.03389830508474576
"[0, 0, 0, 1, 1, 0, 0, 0, 1, 1, 0, 0, 1, 0, 0]",297,190,107,24,9,0.12631578947368421,0.08411214953271028
"[0, 0, 0, 0, 0, 0, 0, 0, 1, 1, 0, 0, 0, 1, 1]",2233,1663,570,147,59,0.08839446782922429,0.10350877192982456
"[1, 1, 1, 1, 1, 1, 1, 1, 0, 1, 1, 1, 1, 0, 0]",2569,565,2004,48,187,0.08495575221238938,0.09331337325349301
"[0, 1, 0, 0, 1, 0, 1, 0, 1, 0, 1, 0, 0, 1, 1]",125,63,62,6,8,0.09523809523809523,0.12903225806451613
"[1, 0, 1, 0, 0, 1, 1, 1, 0, 0, 1, 1, 1, 0, 0]",124,60,64,9,8,0.15,0.125
"[1, 1, 0, 1, 0, 1, 0, 1, 0, 0, 1, 1, 1, 0, 0]",112,53,59,5,7,0.09433962264150944,0.11864406779661017
"[1, 1, 0, 0, 0, 1, 0, 0, 0, 0, 0, 1, 0, 1, 1]",173,101,72,5,6,0.04950495049504951,0.08333333333333333
"[0, 1, 1, 1, 0, 0, 0, 0, 1, 1, 0, 0, 0, 1, 0]",170,104,66,14,6,0.1346153846153846,0.09090909090909091
"[1, 0, 1, 1, 0, 1, 0, 0, 1, 1, 1, 1, 1, 0, 1]",216,84,132,4,7,0.047619047619047616,0.05303030303030303
"[0, 0, 0, 1, 1, 0, 1, 0, 1, 1, 0, 1, 0, 0, 1]",121,65,56,5,9,0.07692307692307693,0.16071428571428573
"[0, 1, 1, 1, 1, 0, 0, 0, 1, 1, 0, 1, 0, 1, 1]",191,98,93,7,11,0.07142857142857142,0.11827956989247312
"[1, 1, 0, 0, 0, 0, 0, 0, 1, 0, 1, 0, 1, 1, 1]",289,162,127,16,14,0.09876543209876543,0.11023622047244094
"[0, 1, 0, 0, 0, 0, 1, 0, 0, 0, 0, 1, 0, 0, 0]",1576,1216,360,135,36,0.11101973684210527,0.1
"[1, 0, 0, 0, 0, 0, 0, 0, 0, 1, 0, 0, 1, 0, 1]",628,372,256,31,24,0.08333333333333333,0.09375
"[0, 1, 0, 1, 1, 1, 1, 1, 1, 1, 1, 1, 1, 1, 0]",2074,554,1520,54,153,0.09747292418772563,0.1006578947368421
"[1, 1, 0, 1, 1, 0, 0, 0, 1, 1, 1, 1, 1, 0, 1]",274,89,185,5,18,0.056179775280898875,0.0972972972972973
"[1, 1, 1, 1, 0, 1, 0, 0, 1, 0, 0, 0, 1, 1, 1]",171,76,95,10,13,0.13157894736842105,0.1368421052631579
"[1, 0, 0, 1, 1, 1, 1, 0, 1, 0, 0, 1, 0, 0, 0]",148,72,76,6,7,0.08333333333333333,0.09210526315789473
"[1, 1, 0, 1, 1, 1, 1, 0, 0, 1, 1, 1, 0, 0, 1]",299,106,193,3,18,0.02830188679245283,0.09326424870466321
"[1, 1, 1, 1, 1, 0, 1, 0, 1, 0, 1, 1, 1, 0, 0]",308,110,198,10,12,0.09090909090909091,0.06060606060606061
"[1, 1, 1, 1, 1, 0, 1, 0, 0, 1, 0, 0, 1, 1, 0]",174,74,100,10,13,0.13513513513513514,0.13
"[0, 0, 1, 1, 1, 0, 1, 0, 1, 1, 1, 1, 1, 1, 0]",292,119,173,17,11,0.14285714285714285,0.06358381502890173
"[0, 0, 0, 0, 1, 1, 1, 0, 1, 0, 1, 1, 1, 1, 1]",280,108,172,13,19,0.12037037037037036,0.11046511627906977
"[0, 0, 0, 0, 0, 0, 1, 1, 1, 0, 1, 0, 1, 1, 1]",335,185,150,11,15,0.05945945945945946,0.1
"[1, 0, 0, 0, 1, 0, 1, 0, 1, 0, 0, 0, 0, 0, 0]",621,422,199,54,23,0.12796208530805686,0.11557788944723618
"[0, 0, 1, 0, 0, 0, 1, 0, 1, 0, 1, 0, 0, 0, 0]",565,418,147,43,19,0.10287081339712918,0.1292517006802721
"[1, 1, 1, 1, 1, 1, 0, 0, 0, 0, 0, 1, 1, 1, 1]",959,329,630,27,39,0.08206686930091185,0.06190476190476191
"[1, 1, 1, 0, 1, 0, 1, 1, 1, 1, 1, 0, 0, 0, 1]",265,97,168,9,12,0.09278350515463918,0.07142857142857142
"[0, 0, 1, 1, 1, 0, 1, 1, 1, 1, 1, 1, 0, 1, 0]",265,79,186,6,13,0.0759493670886076,0.06989247311827956
"[1, 0, 1, 0, 0, 1, 0, 0, 1, 1, 0, 0, 1, 1, 0]",199,98,101,10,14,0.10204081632653061,0.13861386138613863
"[1, 1, 0, 1, 1, 1, 0, 0, 0, 1, 0, 1, 0, 1, 1]",143,60,83,7,10,0.11666666666666667,0.12048192771084337
"[0, 1, 0, 0, 1, 1, 0, 0, 1, 1, 0, 1, 1, 1, 0]",97,53,44,4,2,0.07547169811320754,0.045454545454545456
"[0, 1, 0, 1, 1, 1, 0, 1, 0, 1, 0, 1, 0, 0, 0]",97,42,55,4,7,0.09523809523809523,0.12727272727272726
"[1, 0, 0, 0, 1, 0, 0, 1, 1, 1, 1, 1, 1, 0, 0]",296,138,158,17,17,0.12318840579710146,0.10759493670886076
"[0, 1, 1, 1, 1, 1, 1, 1, 0, 1, 0, 1, 1, 1, 1]",1982,684,1298,63,103,0.09210526315789473,0.07935285053929121
"[1, 1, 1, 1, 1, 0, 1, 0, 1, 0, 0, 1, 1, 1, 1]",806,206,600,23,51,0.11165048543689321,0.085
"[0, 0, 0, 0, 1, 0, 0, 0, 0, 1, 1, 1, 1, 0, 1]",178,101,77,2,9,0.019801980198019802,0.11688311688311688
"[1, 1, 0, 0, 0, 0, 0, 1, 0, 1, 0, 0, 0, 1, 0]",230,146,84,14,5,0.0958904109589041,0.05952380952380952
"[1, 1, 0, 1, 1, 0, 0, 0, 0, 1, 0, 0, 0, 0, 0]",270,192,78,15,5,0.078125,0.0641025641025641
"[1, 1, 1, 0, 1, 1, 0, 0, 0, 0, 1, 0, 0, 0, 0]",130,70,60,10,7,0.14285714285714285,0.11666666666666667
"[1, 1, 1, 1, 0, 0, 0, 0, 1, 0, 1, 1, 1, 1, 1]",573,204,369,20,38,0.09803921568627451,0.10298102981029811
"[1, 0, 1, 0, 1, 0, 0, 0, 0, 0, 1, 1, 0, 0, 0]",362,235,127,26,17,0.11063829787234042,0.13385826771653545
"[0, 0, 0, 0, 0, 1, 0, 1, 0, 1, 0, 0, 0, 0, 0]",1776,1375,401,139,41,0.10109090909090909,0.10224438902743142
"[0, 1, 0, 1, 1, 0, 0, 0, 1, 0, 1, 0, 0, 0, 1]",140,85,55,4,6,0.047058823529411764,0.10909090909090909
"[0, 1, 0, 1, 1, 0, 0, 1, 1, 0, 1, 1, 1, 1, 1]",314,130,184,8,19,0.06153846153846154,0.10326086956521739
"[1, 1, 0, 1, 1, 1, 0, 1, 0, 1, 1, 1, 1, 0, 0]",308,104,204,16,21,0.15384615384615385,0.10294117647058823
"[0, 0, 0, 0, 0, 1, 0, 0, 0, 0, 0, 1, 0, 1, 0]",1585,1230,355,121,32,0.0983739837398374,0.09014084507042254
"[1, 0, 0, 0, 0, 1, 1, 0, 1, 0, 0, 0, 0, 0, 0]",714,438,276,40,22,0.091324200913242,0.07971014492753623
"[1, 1, 0, 1, 1, 1, 0, 0, 0, 0, 0, 1, 0, 1, 0]",110,57,53,5,2,0.08771929824561403,0.03773584905660377
"[1, 0, 1, 0, 0, 0, 0, 0, 0, 0, 1, 0, 0, 1, 1]",321,212,109,20,13,0.09433962264150944,0.11926605504587157
"[1, 0, 0, 0, 0, 1, 1, 1, 0, 1, 0, 0, 0, 0, 0]",358,204,154,18,13,0.08823529411764706,0.08441558441558442
"[0, 0, 1, 0, 0, 1, 0, 1, 0, 0, 0, 0, 0, 1, 1]",347,226,121,25,14,0.11061946902654868,0.11570247933884298
"[0, 0, 0, 1, 0, 0, 1, 0, 1, 0, 0, 0, 0, 0, 1]",571,403,168,34,13,0.08436724565756824,0.07738095238095238
"[0, 0, 0, 0, 0, 1, 0, 0, 0, 0, 1, 0, 0, 1, 0]",1500,1158,342,138,35,0.11917098445595854,0.1023391812865497
"[1, 1, 1, 1, 1, 0, 1, 0, 0, 1, 0, 1, 0, 0, 1]",163,55,108,7,10,0.12727272727272726,0.09259259259259259
"[0, 1, 0, 0, 1, 1, 0, 1, 0, 0, 1, 0, 1, 0, 1]",97,55,42,2,2,0.03636363636363636,0.047619047619047616
"[0, 0, 1, 0, 0, 1, 1, 0, 1, 0, 0, 1, 0, 1, 0]",132,79,53,9,3,0.11392405063291139,0.05660377358490566
"[0, 0, 1, 1, 0, 0, 1, 0, 0, 1, 0, 0, 1, 1, 0]",191,115,76,13,7,0.11304347826086956,0.09210526315789473
"[0, 0, 1, 0, 0, 1, 1, 0, 0, 1, 0, 0, 1, 0, 0]",235,144,91,13,8,0.09027777777777778,0.08791208791208792
"[1, 1, 0, 0, 1, 0, 0, 0, 0, 0, 0, 1, 1, 1, 1]",394,202,192,21,13,0.10396039603960396,0.06770833333333333
"[0, 1, 0, 0, 1, 1, 0, 0, 1, 0, 0, 0, 0, 0, 0]",664,464,200,48,21,0.10344827586206896,0.105
"[0, 0, 1, 0, 1, 0, 0, 1, 1, 0, 0, 1, 0, 0, 0]",252,163,89,15,5,0.09202453987730061,0.056179775280898875
"[0, 0, 0, 1, 0, 1, 0, 0, 1, 1, 0, 0, 1, 0, 0]",234,158,76,15,4,0.0949367088607595,0.05263157894736842
"[1, 1, 1, 1, 1, 0, 1, 1, 0, 1, 0, 0, 1, 1, 1]",678,176,502,18,43,0.10227272727272728,0.08565737051792828
"[0, 1, 0, 0, 0, 1, 1, 1, 0, 0, 1, 1, 1, 1, 0]",194,87,107,9,8,0.10344827586206896,0.07476635514018691
"[1, 1, 1, 1, 1, 0, 0, 0, 1, 1, 1, 1, 1, 1, 0]",929,247,682,20,77,0.08097165991902834,0.11290322580645161
"[0, 1, 0, 0, 0, 1, 0, 1, 1, 1, 1, 0, 1, 0, 1]",124,56,68,3,7,0.05357142857142857,0.10294117647058823
"[1, 1, 1, 1, 1, 0, 0, 1, 1, 0, 1, 0, 1, 0, 1]",303,109,194,8,12,0.07339449541284404,0.061855670103092786
"[1, 1, 1, 1, 0, 1, 1, 1, 1, 1, 0, 0, 1, 1, 0]",861,226,635,16,63,0.07079646017699115,0.09921259842519685
"[0, 0, 1, 1, 1, 0, 0, 1, 1, 1, 1, 1, 0, 0, 0]",207,100,107,4,9,0.04,0.08411214953271028
"[1, 0, 0, 1, 1, 0, 0, 1, 1, 1, 0, 0, 1, 1, 1]",377,95,282,5,27,0.05263157894736842,0.09574468085106383
"[1, 1, 0, 1, 1, 1, 1, 0, 0, 1, 1, 0, 0, 1, 1]",844,298,546,38,53,0.12751677852348994,0.09706959706959707
"[1, 1, 1, 0, 0, 1, 1, 0, 0, 0, 0, 0, 0, 1, 1]",1747,343,1404,23,118,0.06705539358600583,0.08404558404558404
"[0, 1, 1, 1, 0, 0, 1, 1, 0, 0, 0, 0, 0, 0, 1]",472,267,205,26,15,0.09737827715355805,0.07317073170731707
"[0, 1, 1, 0, 1, 0, 1, 0, 1, 1, 1, 0, 1, 1, 0]",133,50,83,3,8,0.06,0.0963855421686747
"[0, 0, 0, 0, 0, 1, 1, 0, 1, 0, 1, 0, 1, 1, 1]",206,140,66,16,4,0.11428571428571428,0.06060606060606061
"[1, 0, 0, 1, 0, 0, 0, 0, 0, 1, 1, 0, 1, 0, 1]",147,99,48,12,5,0.12121212121212122,0.10416666666666667
"[1, 1, 0, 1, 0, 1, 0, 1, 1, 0, 1, 1, 1, 1, 1]",580,165,415,12,32,0.07272727272727272,0.07710843373493977
"[0, 0, 1, 1, 1, 1, 1, 1, 1, 1, 1, 0, 0, 1, 1]",1903,634,1269,56,128,0.08832807570977919,0.1008668242710796
"[1, 0, 1, 1, 1, 0, 0, 0, 0, 1, 1, 1, 1, 1, 1]",849,310,539,40,57,0.12903225806451613,0.10575139146567718
"[0, 1, 1, 1, 1, 0, 0, 0, 1, 0, 1, 0, 1, 1, 1]",260,140,120,8,12,0.05714285714285714,0.1
"[1, 1, 0, 0, 1, 1, 1, 1, 0, 0, 0, 1, 0, 1, 0]",205,88,117,10,9,0.11363636363636363,0.07692307692307693
"[1, 0, 1, 1, 0, 0, 1, 1, 1, 1, 0, 0, 0, 1, 0]",145,65,80,7,7,0.1076923076923077,0.0875
"[1, 0, 1, 0, 1, 0, 1, 1, 0, 0, 1, 1, 1, 1, 0]",214,82,132,7,16,0.08536585365853659,0.12121212121212122
"[1, 0, 0, 0, 0, 0, 0, 0, 0, 1, 1, 0, 1, 1, 0]",397,179,218,24,10,0.1340782122905028,0.045871559633027525
"[0, 1, 1, 0, 0, 0, 0, 0, 0, 0, 0, 1, 1, 0, 1]",636,499,137,39,19,0.0781563126252505,0.1386861313868613
"[0, 0, 0, 1, 1, 0, 0, 1, 0, 0, 1, 0, 0, 0, 0]",659,472,187,59,17,0.125,0.09090909090909091
"[0, 0, 1, 1, 0, 0, 0, 0, 1, 1, 1, 0, 0, 0, 1]",275,162,113,15,9,0.09259259259259259,0.07964601769911504
"[1, 1, 0, 1, 1, 0, 1, 0, 0, 0, 0, 0, 0, 1, 1]",229,110,119,13,16,0.11818181818181818,0.13445378151260504
"[0, 0, 1, 1, 0, 1, 1, 0, 1, 0, 0, 0, 0, 0, 0]",327,210,117,16,9,0.0761904761904762,0.07692307692307693
"[1, 0, 0, 1, 0, 0, 1, 1, 0, 1, 1, 0, 1, 0, 0]",94,46,48,4,7,0.08695652173913043,0.14583333333333334
"[1, 0, 0, 1, 0, 0, 0, 1, 0, 0, 0, 0, 0, 0, 0]",1901,1451,450,140,49,0.09648518263266713,0.10888888888888888
"[1, 1, 0, 0, 1, 0, 0, 0, 1, 0, 0, 0, 0, 0, 0]",625,444,181,42,16,0.0945945945945946,0.08839779005524862
"[0, 1, 0, 0, 1, 0, 1, 0, 0, 1, 1, 0, 0, 1, 1]",193,104,89,11,9,0.10576923076923077,0.10112359550561797
"[0, 1, 0, 0, 1, 0, 0, 1, 0, 1, 0, 0, 1, 1, 0]",128,82,46,5,4,0.06097560975609756,0.08695652173913043
"[0, 0, 0, 1, 0, 0, 0, 0, 0, 1, 1, 0, 1, 0, 1]",257,182,75,15,8,0.08241758241758242,0.10666666666666667
"[0, 0, 0, 0, 1, 0, 0, 0, 0, 0, 1, 1, 0, 1, 0]",561,401,160,30,18,0.07481296758104738,0.1125
"[0, 1, 1, 1, 1, 1, 0, 0, 1, 0, 1, 1, 0, 1, 1]",230,87,143,5,14,0.05747126436781609,0.0979020979020979
"[1, 1, 1, 1, 1, 0, 0, 0, 0, 1, 1, 0, 0, 0, 1]",407,90,317,6,22,0.06666666666666667,0.0694006309148265
"[0, 1, 1, 1, 1, 0, 1, 0, 1, 0, 0, 1, 1, 1, 1]",339,159,180,19,21,0.11949685534591195,0.11666666666666667
"[0, 1, 0, 0, 0, 1, 0, 0, 1, 0, 1, 1, 0, 1, 1]",108,60,48,7,6,0.11666666666666667,0.125
"[1, 0, 1, 0, 0, 0, 0, 1, 0, 0, 0, 0, 0, 0, 0]",1854,1418,436,126,39,0.08885754583921016,0.08944954128440367
"[0, 0, 0, 0, 0, 1, 0, 0, 0, 1, 0, 1, 0, 0, 0]",1684,1272,412,119,41,0.09355345911949685,0.09951456310679611
"[0, 0, 1, 0, 0, 0, 1, 0, 0, 1, 1, 1, 0, 0, 0]",311,214,97,18,12,0.08411214953271028,0.12371134020618557
"[0, 0, 0, 0, 0, 0, 1, 0, 0, 0, 1, 1, 0, 0, 1]",727,543,184,56,18,0.10313075506445672,0.09782608695652174
"[1, 0, 0, 0, 0, 1, 1, 1, 1, 1, 0, 0, 1, 1, 1]",449,125,324,16,24,0.128,0.07407407407407407
"[0, 1, 1, 1, 1, 1, 0, 0, 0, 1, 0, 0, 0, 0, 1]",126,71,55,3,4,0.04225352112676056,0.07272727272727272
"[1, 0, 1, 1, 1, 1, 1, 0, 0, 1, 1, 1, 1, 0, 0]",764,267,497,21,58,0.07865168539325842,0.11670020120724346
"[1, 1, 0, 1, 1, 1, 1, 0, 1, 0, 0, 0, 0, 1, 0]",94,41,53,2,7,0.04878048780487805,0.1320754716981132
"[0, 1, 0, 1, 1, 1, 1, 0, 1, 0, 0, 0, 0, 0, 0]",203,126,77,12,7,0.09523809523809523,0.09090909090909091
"[1, 0, 1, 0, 1, 0, 1, 1, 1, 1, 0, 1, 0, 0, 0]",109,54,55,4,8,0.07407407407407407,0.14545454545454545
"[1, 1, 1, 1, 0, 1, 1, 1, 0, 1, 1, 0, 1, 0, 1]",521,160,361,15,41,0.09375,0.11357340720221606
"[0, 1, 1, 1, 1, 0, 1, 1, 1, 1, 1, 1, 0, 1, 0]",530,158,372,14,33,0.08860759493670886,0.08870967741935484
"[1, 1, 1, 1, 1, 1, 0, 0, 0, 0, 1, 0, 1, 0, 1]",299,117,182,10,19,0.08547008547008547,0.1043956043956044
"[0, 1, 1, 1, 1, 1, 1, 1, 0, 0, 0, 0, 1, 0, 1]",234,104,130,12,15,0.11538461538461539,0.11538461538461539
"[0, 1, 1, 1, 0, 0, 0, 0, 0, 0, 0, 1, 1, 1, 1]",384,207,177,18,12,0.08695652173913043,0.06779661016949153
"[0, 1, 0, 0, 0, 1, 0, 1, 0, 0, 0, 1, 0, 0, 0]",487,355,132,33,8,0.09295774647887324,0.06060606060606061
"[0, 0, 0, 1, 0, 0, 1, 0, 0, 0, 1, 0, 1, 0, 0]",517,369,148,37,17,0.1002710027100271,0.11486486486486487
"[1, 0, 1, 1, 0, 0, 1, 0, 0, 0, 0, 1, 0, 0, 1]",133,73,60,11,4,0.1506849315068493,0.06666666666666667
"[0, 1, 0, 0, 0, 1, 0, 0, 0, 0, 1, 1, 1, 1, 0]",283,165,118,17,12,0.10303030303030303,0.1016949152542373
"[0, 1, 1, 0, 1, 0, 0, 0, 1, 0, 0, 0, 1, 0, 0]",213,137,76,11,5,0.08029197080291971,0.06578947368421052
"[0, 1, 0, 1, 0, 1, 1, 0, 1, 0, 0, 0, 1, 0, 0]",122,75,47,11,5,0.14666666666666667,0.10638297872340426
"[0, 1, 1, 1, 1, 0, 1, 0, 1, 0, 0, 0, 0, 0, 1]",119,69,50,3,2,0.043478260869565216,0.04
"[1, 1, 1, 0, 0, 0, 0, 0, 1, 1, 1, 1, 0, 1, 0]",158,67,91,3,7,0.04477611940298507,0.07692307692307693
"[1, 0, 0, 1, 1, 0, 1, 1, 0, 1, 1, 1, 1, 1, 1]",807,210,597,21,65,0.1,0.10887772194304858
"[1, 1, 0, 1, 1, 0, 0, 1, 1, 0, 1, 1, 0, 1, 1]",223,77,146,9,14,0.11688311688311688,0.0958904109589041
"[0, 0, 1, 0, 1, 0, 0, 1, 0, 1, 0, 1, 0, 1, 0]",139,87,52,12,7,0.13793103448275862,0.1346153846153846
"[0, 1, 1, 1, 1, 1, 1, 0, 0, 0, 1, 0, 1, 0, 0]",168,105,63,11,8,0.10476190476190476,0.12698412698412698
"[0, 1, 1, 0, 1, 1, 1, 1, 1, 1, 0, 0, 0, 1, 0]",169,67,102,6,3,0.08955223880597014,0.029411764705882353
"[0, 1, 0, 1, 0, 1, 1, 0, 1, 1, 1, 1, 1, 1, 0]",284,106,178,7,16,0.0660377358490566,0.0898876404494382
"[1, 0, 1, 0, 1, 1, 0, 0, 0, 1, 1, 0, 1, 1, 0]",124,43,81,4,2,0.09302325581395349,0.024691358024691357
"[0, 1, 0, 0, 1, 1, 0, 1, 0, 1, 1, 0, 0, 0, 1]",110,52,58,4,2,0.07692307692307693,0.034482758620689655
"[0, 1, 1, 1, 0, 1, 0, 0, 1, 1, 0, 1, 0, 1, 1]",159,60,99,2,9,0.03333333333333333,0.09090909090909091
"[1, 1, 0, 1, 0, 1, 0, 0, 0, 0, 1, 1, 1, 1, 0]",196,95,101,9,9,0.09473684210526316,0.0891089108910891
"[1, 1, 1, 1, 1, 1, 0, 0, 0, 0, 1, 1, 1, 1, 0]",2288,809,1479,68,157,0.08405438813349815,0.10615280594996619
"[0, 0, 1, 1, 0, 0, 0, 0, 1, 0, 1, 1, 1, 1, 0]",188,88,100,4,9,0.045454545454545456,0.09
"[0, 1, 1, 1, 0, 0, 0, 0, 0, 0, 1, 1, 0, 1, 1]",177,102,75,9,10,0.08823529411764706,0.13333333333333333
"[0, 0, 0, 1, 0, 1, 0, 1, 0, 1, 1, 1, 0, 0, 0]",161,90,71,8,7,0.08888888888888889,0.09859154929577464
"[1, 0, 0, 0, 1, 0, 1, 0, 1, 0, 1, 1, 1, 0, 0]",121,61,60,7,3,0.11475409836065574,0.05
"[1, 1, 0, 1, 0, 1, 0, 1, 0, 0, 0, 1, 0, 1, 0]",90,43,47,5,5,0.11627906976744186,0.10638297872340426
"[1, 1, 1, 1, 1, 0, 1, 1, 1, 1, 0, 1, 1, 0, 0]",696,189,507,18,48,0.09523809523809523,0.09467455621301775
"[1, 0, 1, 1, 0, 0, 1, 1, 0, 1, 1, 1, 0, 0, 0]",137,67,70,7,9,0.1044776119402985,0.12857142857142856
"[1, 1, 0, 0, 0, 0, 0, 0, 1, 0, 0, 0, 0, 1, 1]",576,392,184,43,19,0.1096938775510204,0.10326086956521739
"[1, 1, 1, 1, 0, 0, 1, 0, 1, 0, 1, 1, 1, 1, 1]",782,229,553,29,56,0.12663755458515283,0.10126582278481013
"[1, 1, 0, 1, 1, 0, 1, 0, 1, 0, 0, 1, 1, 1, 1]",307,100,207,8,22,0.08,0.10628019323671498
"[0, 1, 1, 1, 1, 0, 0, 0, 1, 0, 0, 1, 0, 1, 1]",146,83,63,10,5,0.12048192771084337,0.07936507936507936
"[1, 1, 0, 0, 0, 0, 1, 1, 0, 0, 0, 0, 1, 1, 0]",1832,1039,793,110,74,0.10587102983638114,0.09331651954602774
"[1, 0, 0, 0, 0, 0, 0, 0, 1, 0, 1, 0, 0, 0, 0]",1753,1251,502,125,40,0.09992006394884093,0.0796812749003984
"[0, 0, 1, 0, 1, 1, 1, 1, 0, 0, 1, 1, 1, 1, 1]",534,194,340,20,31,0.10309278350515463,0.09117647058823529
"[1, 1, 1, 0, 1, 1, 1, 1, 1, 1, 0, 1, 1, 0, 0]",616,151,465,20,58,0.13245033112582782,0.12473118279569892
"[1, 1, 1, 1, 0, 1, 1, 1, 1, 1, 1, 0, 1, 1, 0]",1585,376,1209,44,95,0.11702127659574468,0.07857733664185278
"[1, 0, 1, 0, 1, 1, 0, 0, 1, 1, 1, 1, 1, 1, 1]",1055,359,696,39,68,0.10863509749303621,0.09770114942528736
"[1, 0, 0, 1, 1, 1, 0, 0, 0, 0, 1, 0, 0, 1, 1]",147,73,74,7,7,0.0958904109589041,0.0945945945945946
"[1, 1, 0, 0, 0, 1, 0, 1, 0, 0, 1, 1, 1, 0, 0]",146,79,67,3,7,0.0379746835443038,0.1044776119402985
"[1, 1, 0, 0, 0, 0, 1, 1, 0, 0, 0, 1, 0, 1, 0]",247,154,93,10,10,0.06493506493506493,0.10752688172043011
"[0, 1, 1, 0, 0, 0, 0, 1, 1, 0, 0, 0, 1, 0, 1]",313,244,69,26,8,0.10655737704918032,0.11594202898550725
"[0, 0, 0, 0, 0, 0, 0, 1, 1, 0, 0, 1, 0, 1, 0]",777,604,173,43,10,0.07119205298013245,0.057803468208092484
"[1, 1, 1, 1, 1, 0, 1, 0, 1, 1, 1, 0, 0, 1, 0]",218,76,142,6,15,0.07894736842105263,0.1056338028169014
"[0, 1, 1, 0, 1, 1, 1, 1, 0, 1, 1, 1, 1, 1, 1]",1918,515,1403,55,133,0.10679611650485436,0.0947968638631504
"[0, 1, 1, 1, 1, 1, 1, 0, 0, 1, 0, 1, 1, 1, 1]",786,352,434,25,35,0.07102272727272728,0.08064516129032258
"[1, 1, 0, 1, 0, 1, 1, 0, 0, 0, 0, 1, 1, 1, 1]",370,135,235,11,18,0.08148148148148149,0.07659574468085106
"[1, 1, 1, 1, 1, 0, 1, 1, 0, 0, 1, 0, 0, 1, 1]",316,121,195,8,25,0.06611570247933884,0.1282051282051282
"[0, 0, 1, 1, 1, 1, 1, 0, 1, 1, 0, 0, 1, 0, 0]",139,73,66,8,8,0.1095890410958904,0.12121212121212122
"[0, 1, 1, 1, 1, 1, 1, 1, 0, 0, 0, 0, 1, 1, 0]",542,239,303,25,26,0.10460251046025104,0.0858085808580858
"[0, 0, 1, 0, 0, 0, 0, 0, 1, 1, 1, 1, 0, 0, 0]",688,467,221,46,15,0.09850107066381156,0.06787330316742081
"[1, 0, 0, 0, 1, 1, 0, 0, 1, 1, 0, 0, 0, 1, 1]",193,107,86,10,7,0.09345794392523364,0.08139534883720931
"[1, 0, 1, 0, 1, 0, 0, 0, 1, 1, 0, 0, 1, 1, 0]",176,98,78,11,9,0.11224489795918367,0.11538461538461539
"[1, 0, 0, 1, 1, 1, 0, 1, 1, 1, 0, 0, 0, 0, 1]",156,67,89,6,10,0.08955223880597014,0.11235955056179775
"[1, 1, 1, 1, 1, 1, 0, 0, 0, 0, 0, 1, 1, 0, 1]",307,101,206,10,18,0.09900990099009901,0.08737864077669903
"[0, 0, 1, 0, 1, 1, 0, 0, 0, 0, 0, 0, 0, 0, 1]",891,581,310,68,27,0.11703958691910499,0.08709677419354839
"[0, 1, 1, 1, 0, 1, 1, 1, 0, 0, 1, 0, 0, 1, 0]",120,54,66,7,6,0.12962962962962962,0.09090909090909091
"[1, 0, 1, 0, 1, 1, 1, 0, 1, 1, 1, 0, 0, 1, 0]",132,53,79,5,8,0.09433962264150944,0.10126582278481013
"[0, 0, 1, 1, 0, 1, 1, 1, 0, 1, 0, 1, 0, 1, 1]",160,67,93,6,7,0.08955223880597014,0.07526881720430108
"[1, 0, 1, 0, 0, 1, 1, 0, 1, 1, 1, 0, 1, 0, 1]",139,53,86,5,10,0.09433962264150944,0.11627906976744186
"[0, 1, 0, 1, 0, 1, 0, 1, 1, 0, 0, 1, 0, 1, 1]",112,54,58,5,5,0.09259259259259259,0.08620689655172414
"[1, 1, 1, 1, 1, 0, 1, 1, 1, 1, 0, 1, 1, 0, 1]",1569,381,1188,35,104,0.09186351706036745,0.08754208754208755
"[1, 0, 1, 1, 1, 1, 0, 0, 0, 0, 1, 0, 1, 1, 1]",196,80,116,5,8,0.0625,0.06896551724137931
"[1, 0, 0, 1, 0, 1, 1, 1, 1, 0, 0, 0, 0, 1, 0]",119,57,62,5,7,0.08771929824561403,0.11290322580645161
"[0, 0, 0, 1, 1, 0, 1, 0, 1, 1, 0, 1, 1, 1, 1]",198,100,98,8,12,0.08,0.12244897959183673
"[0, 1, 0, 1, 0, 1, 0, 1, 1, 1, 1, 0, 0, 0, 1]",108,50,58,2,4,0.04,0.06896551724137931
"[1, 1, 0, 1, 1, 0, 1, 1, 1, 0, 1, 0, 0, 1, 1]",286,85,201,7,21,0.08235294117647059,0.1044776119402985
"[0, 1, 1, 1, 1, 0, 1, 1, 0, 1, 1, 1, 0, 1, 0]",262,98,164,4,22,0.04081632653061224,0.13414634146341464
"[0, 0, 1, 1, 1, 1, 0, 1, 1, 0, 1, 1, 1, 0, 1]",282,112,170,12,11,0.10714285714285714,0.06470588235294118
"[0, 1, 1, 0, 1, 1, 0, 0, 1, 1, 1, 0, 1, 0, 1]",159,69,90,5,7,0.07246376811594203,0.07777777777777778
"[0, 0, 0, 1, 0, 1, 0, 0, 0, 0, 1, 1, 1, 1, 0]",301,198,103,11,14,0.05555555555555555,0.13592233009708737
"[1, 0, 1, 0, 0, 1, 0, 0, 0, 0, 1, 0, 1, 0, 0]",236,152,84,13,9,0.08552631578947369,0.10714285714285714
"[0, 0, 0, 0, 1, 0, 1, 1, 0, 0, 1, 0, 1, 1, 1]",176,92,84,11,10,0.11956521739130435,0.11904761904761904
"[1, 0, 0, 1, 0, 1, 1, 1, 1, 1, 1, 1, 1, 1, 1]",2615,648,1967,66,213,0.10185185185185185,0.10828673106253177
"[1, 1, 1, 1, 1, 0, 1, 0, 0, 1, 0, 1, 1, 1, 1]",646,194,452,24,45,0.12371134020618557,0.09955752212389381
"[1, 1, 0, 0, 1, 1, 0, 0, 0, 0, 0, 1, 0, 1, 1]",296,154,142,8,9,0.05194805194805195,0.06338028169014084
"[0, 0, 1, 1, 0, 1, 0, 0, 1, 1, 1, 1, 0, 0, 0]",209,112,97,14,2,0.125,0.020618556701030927
"[0, 1, 1, 0, 0, 0, 1, 1, 0, 0, 0, 1, 0, 1, 1]",143,82,61,6,10,0.07317073170731707,0.16393442622950818
"[1, 1, 1, 1, 0, 0, 1, 1, 0, 0, 0, 1, 1, 0, 0]",275,141,134,10,11,0.07092198581560284,0.08208955223880597
"[1, 1, 1, 1, 1, 1, 0, 0, 1, 1, 0, 0, 0, 1, 1]",748,269,479,25,48,0.09293680297397769,0.10020876826722339
"[0, 1, 0, 0, 0, 1, 1, 1, 1, 1, 1, 1, 1, 0, 0]",466,186,280,18,25,0.0967741935483871,0.08928571428571429
"[1, 0, 1, 1, 1, 1, 0, 0, 1, 1, 0, 0, 0, 0, 0]",457,246,211,32,17,0.13008130081300814,0.08056872037914692
"[1, 1, 0, 1, 0, 0, 1, 1, 1, 0, 0, 0, 0, 0, 1]",130,65,65,4,5,0.06153846153846154,0.07692307692307693
"[1, 1, 1, 0, 1, 1, 1, 1, 0, 0, 1, 1, 1, 1, 0]",919,256,663,29,59,0.11328125,0.0889894419306184
"[1, 1, 0, 1, 1, 1, 1, 1, 0, 0, 0, 1, 1, 0, 0]",201,81,120,10,13,0.12345679012345678,0.10833333333333334
"[1, 1, 1, 0, 1, 1, 1, 1, 1, 0, 0, 0, 1, 1, 0]",277,92,185,12,17,0.13043478260869565,0.0918918918918919
"[0, 0, 1, 1, 0, 0, 1, 1, 0, 0, 1, 1, 0, 0, 0]",1913,1173,740,105,82,0.08951406649616368,0.11081081081081082
"[0, 1, 1, 0, 0, 1, 0, 0, 0, 0, 0, 0, 0, 1, 1]",488,343,145,32,18,0.09329446064139942,0.12413793103448276
"[0, 0, 1, 1, 0, 0, 1, 0, 0, 0, 0, 0, 0, 0, 1]",709,504,205,41,25,0.08134920634920635,0.12195121951219512
"[1, 1, 0, 1, 1, 1, 0, 0, 0, 1, 0, 0, 0, 0, 0]",177,103,74,7,5,0.06796116504854369,0.06756756756756757
"[1, 1, 0, 0, 0, 0, 0, 0, 1, 1, 0, 1, 1, 0, 0]",286,167,119,15,9,0.08982035928143713,0.07563025210084033
"[1, 1, 0, 0, 1, 1, 1, 0, 0, 0, 0, 0, 0, 1, 1]",398,209,189,13,17,0.06220095693779904,0.08994708994708994
"[0, 1, 0, 1, 1, 0, 1, 1, 0, 0, 1, 1, 1, 0, 0]",121,65,56,6,5,0.09230769230769231,0.08928571428571429
"[0, 0, 0, 1, 1, 0, 1, 1, 0, 0, 0, 0, 1, 0, 1]",154,88,66,10,7,0.11363636363636363,0.10606060606060606
"[1, 1, 1, 0, 0, 0, 0, 1, 0, 0, 0, 0, 0, 0, 1]",347,191,156,18,18,0.09424083769633508,0.11538461538461539
"[0, 0, 1, 1, 0, 0, 0, 1, 1, 1, 1, 0, 1, 0, 0]",138,75,63,8,5,0.10666666666666667,0.07936507936507936
"[1, 0, 1, 1, 0, 0, 0, 0, 1, 0, 0, 0, 0, 0, 1]",301,203,98,16,12,0.07881773399014778,0.12244897959183673
"[1, 0, 0, 0, 0, 1, 0, 1, 1, 1, 1, 0, 1, 1, 0]",121,60,61,5,4,0.08333333333333333,0.06557377049180328
"[0, 1, 0, 0, 1, 0, 0, 0, 1, 1, 0, 0, 1, 0, 0]",225,156,69,14,9,0.08974358974358974,0.13043478260869565
"[1, 1, 1, 0, 1, 0, 0, 1, 0, 0, 1, 0, 0, 0, 1]",112,53,59,8,6,0.1509433962264151,0.1016949152542373
"[1, 0, 0, 0, 1, 0, 0, 1, 0, 1, 0, 1, 1, 0, 1]",90,46,44,4,4,0.08695652173913043,0.09090909090909091
"[0, 0, 0, 1, 1, 1, 0, 1, 1, 1, 0, 1, 0, 1, 1]",193,85,108,4,12,0.047058823529411764,0.1111111111111111
"[0, 0, 1, 1, 0, 1, 1, 1, 0, 1, 1, 0, 0, 0, 0]",162,77,85,5,10,0.06493506493506493,0.11764705882352941
"[0, 1, 1, 0, 0, 1, 1, 1, 1, 1, 1, 0, 1, 0, 0]",255,153,102,13,9,0.08496732026143791,0.08823529411764706
"[0, 1, 1, 1, 1, 1, 1, 0, 1, 0, 1, 0, 0, 1, 0]",159,76,83,10,9,0.13157894736842105,0.10843373493975904
"[1, 0, 0, 0, 0, 1, 1, 0, 0, 1, 0, 0, 0, 0, 1]",340,172,168,23,10,0.13372093023255813,0.05952380952380952
"[0, 1, 1, 1, 0, 1, 1, 0, 1, 1, 1, 0, 0, 1, 1]",325,116,209,11,21,0.09482758620689655,0.10047846889952153
"[1, 0, 1, 1, 0, 1, 1, 1, 1, 1, 0, 0, 1, 0, 1]",241,76,165,9,12,0.11842105263157894,0.07272727272727272
"[1, 1, 0, 0, 0, 1, 1, 1, 1, 0, 1, 0, 0, 1, 1]",184,68,116,9,2,0.1323529411764706,0.017241379310344827
"[0, 0, 1, 1, 0, 1, 0, 0, 0, 0, 1, 0, 0, 0, 0]",528,379,149,27,13,0.0712401055408971,0.087248322147651
"[1, 1, 0, 1, 0, 0, 0, 0, 0, 1, 0, 0, 0, 1, 0]",232,148,84,16,4,0.10810810810810811,0.047619047619047616
"[0, 0, 1, 0, 1, 0, 1, 1, 0, 1, 0, 1, 0, 1, 0]",91,46,45,6,2,0.13043478260869565,0.044444444444444446
"[1, 0, 1, 1, 0, 0, 0, 0, 0, 0, 1, 1, 0, 1, 1]",170,89,81,7,8,0.07865168539325842,0.09876543209876543
"[0, 0, 1, 0, 1, 1, 0, 0, 0, 0, 0, 0, 1, 1, 0]",523,324,199,34,23,0.10493827160493827,0.11557788944723618
"[1, 0, 1, 1, 1, 0, 0, 1, 1, 1, 0, 0, 0, 1, 0]",102,38,64,4,6,0.10526315789473684,0.09375
"[1, 0, 1, 0, 1, 1, 1, 0, 0, 1, 1, 1, 0, 0, 0]",144,66,78,5,6,0.07575757575757576,0.07692307692307693
"[0, 0, 1, 0, 0, 1, 0, 1, 0, 0, 0, 0, 0, 0, 0]",1948,1506,442,161,49,0.10690571049136786,0.11085972850678733
"[1, 0, 1, 0, 1, 1, 1, 0, 0, 1, 1, 0, 0, 0, 1]",117,50,67,5,7,0.1,0.1044776119402985
"[1, 1, 0, 1, 1, 0, 1, 0, 1, 0, 1, 1, 1, 1, 0]",240,88,152,6,12,0.06818181818181818,0.07894736842105263
"[0, 0, 0, 0, 0, 1, 1, 0, 0, 0, 0, 1, 0, 0, 0]",2390,1962,428,192,32,0.09785932721712538,0.07476635514018691
"[0, 0, 0, 0, 0, 1, 0, 1, 1, 1, 0, 1, 1, 0, 0]",189,112,77,8,7,0.07142857142857142,0.09090909090909091
"[0, 0, 0, 0, 0, 0, 1, 0, 1, 1, 0, 0, 0, 0, 1]",760,555,205,43,15,0.07747747747747748,0.07317073170731707
"[0, 0, 1, 1, 0, 1, 0, 0, 0, 1, 0, 0, 1, 1, 1]",174,98,76,6,7,0.061224489795918366,0.09210526315789473
"[1, 0, 0, 1, 1, 0, 1, 0, 0, 0, 1, 0, 0, 1, 1]",124,54,70,7,8,0.12962962962962962,0.11428571428571428
"[0, 0, 1, 1, 0, 0, 0, 0, 0, 0, 1, 1, 0, 0, 1]",2307,1451,856,152,69,0.10475534114403859,0.08060747663551401
"[1, 1, 0, 1, 1, 0, 0, 1, 1, 0, 1, 1, 1, 0, 1]",229,86,143,8,11,0.09302325581395349,0.07692307692307693
"[1, 0, 1, 1, 0, 1, 1, 0, 0, 1, 1, 0, 1, 1, 1]",296,108,188,12,15,0.1111111111111111,0.0797872340425532
"[1, 0, 1, 0, 0, 0, 0, 1, 1, 1, 1, 1, 0, 1, 0]",109,56,53,3,7,0.05357142857142857,0.1320754716981132
"[1, 1, 1, 1, 0, 1, 0, 0, 0, 0, 1, 1, 1, 1, 1]",526,187,339,23,28,0.12299465240641712,0.08259587020648967
"[0, 0, 1, 1, 0, 0, 1, 1, 1, 1, 1, 1, 0, 0, 1]",1921,831,1090,75,112,0.09025270758122744,0.10275229357798166
"[0, 0, 0, 1, 1, 1, 0, 1, 1, 1, 1, 0, 0, 1, 1]",287,149,138,8,14,0.053691275167785234,0.10144927536231885
"[0, 1, 1, 0, 1, 0, 0, 1, 0, 0, 0, 0, 0, 0, 0]",718,531,187,54,17,0.1016949152542373,0.09090909090909091
"[0, 0, 1, 1, 0, 0, 0, 0, 0, 1, 0, 1, 0, 0, 1]",329,204,125,21,8,0.10294117647058823,0.064
"[0, 0, 1, 1, 0, 0, 0, 1, 1, 1, 0, 1, 1, 1, 1]",262,119,143,12,13,0.10084033613445378,0.09090909090909091
"[1, 0, 0, 1, 0, 0, 0, 0, 1, 1, 1, 0, 0, 1, 1]",149,75,74,4,8,0.05333333333333334,0.10810810810810811
"[0, 1, 1, 1, 1, 0, 0, 1, 0, 0, 0, 0, 1, 1, 1]",265,169,96,17,11,0.10059171597633136,0.11458333333333333
"[1, 1, 0, 1, 1, 1, 1, 1, 1, 1, 0, 0, 0, 1, 1]",722,193,529,15,39,0.07772020725388601,0.07372400756143667
"[1, 1, 1, 1, 1, 1, 1, 0, 1, 1, 0, 1, 1, 0, 1]",1601,349,1252,36,94,0.10315186246418338,0.07507987220447285
"[1, 0, 1, 1, 1, 1, 1, 0, 1, 0, 0, 1, 0, 1, 0]",124,48,76,6,8,0.125,0.10526315789473684
"[1, 1, 1, 0, 0, 0, 0, 0, 0, 1, 1, 1, 0, 1, 1]",369,98,271,7,24,0.07142857142857142,0.08856088560885608
"[0, 1, 1, 0, 0, 0, 0, 1, 0, 0, 0, 1, 0, 0, 0]",545,402,143,30,15,0.07462686567164178,0.1048951048951049
"[0, 0, 1, 1, 0, 0, 0, 1, 0, 0, 0, 0, 1, 1, 0]",335,205,130,20,10,0.0975609756097561,0.07692307692307693
"[0, 1, 0, 0, 1, 0, 0, 1, 1, 0, 0, 0, 1, 1, 0]",168,101,67,6,9,0.0594059405940594,0.13432835820895522
"[0, 0, 0, 1, 0, 0, 1, 0, 0, 1, 1, 0, 0, 0, 1]",281,183,98,18,10,0.09836065573770492,0.10204081632653061
"[0, 1, 0, 0, 0, 0, 0, 1, 0, 0, 0, 0, 0, 0, 1]",1769,1326,443,114,37,0.08597285067873303,0.0835214446952596
"[1, 0, 1, 0, 0, 1, 0, 1, 0, 0, 1, 0, 0, 0, 0]",209,126,83,10,4,0.07936507936507936,0.04819277108433735
"[1, 1, 0, 1, 0, 0, 1, 0, 1, 0, 0, 1, 0, 0, 0]",138,89,49,7,2,0.07865168539325842,0.04081632653061224
"[0, 0, 0, 1, 1, 1, 1, 0, 1, 0, 0, 1, 0, 1, 0]",109,59,50,9,2,0.15254237288135594,0.04
"[0, 0, 1, 1, 0, 0, 1, 1, 1, 0, 1, 1, 0, 1, 1]",211,102,109,8,6,0.0784313725490196,0.05504587155963303
"[1, 1, 1, 0, 1, 1, 0, 0, 0, 0, 0, 0, 1, 1, 1]",374,154,220,12,20,0.07792207792207792,0.09090909090909091
"[0, 0, 1, 1, 1, 1, 1, 1, 0, 1, 1, 0, 0, 0, 0]",235,131,104,16,6,0.12213740458015267,0.057692307692307696
"[0, 0, 0, 1, 0, 0, 0, 1, 0, 1, 1, 1, 1, 0, 0]",178,107,71,5,6,0.04672897196261682,0.08450704225352113
"[1, 0, 0, 0, 1, 0, 0, 1, 1, 1, 0, 1, 1, 0, 1]",97,40,57,3,5,0.075,0.08771929824561403
"[1, 1, 1, 1, 0, 0, 0, 1, 0, 0, 1, 1, 1, 0, 1]",161,59,102,10,15,0.1694915254237288,0.14705882352941177
"[0, 0, 0, 0, 1, 1, 0, 1, 0, 0, 0, 0, 1, 1, 0]",345,211,134,17,11,0.08056872037914692,0.08208955223880597
"[1, 1, 0, 0, 0, 0, 1, 1, 1, 0, 0, 1, 1, 1, 0]",176,85,91,5,9,0.058823529411764705,0.0989010989010989
"[1, 0, 1, 1, 1, 1, 1, 1, 1, 1, 0, 0, 0, 0, 0]",571,252,319,24,26,0.09523809523809523,0.08150470219435736
"[1, 1, 0, 0, 0, 0, 0, 0, 0, 1, 0, 0, 1, 1, 0]",374,240,134,20,11,0.08333333333333333,0.08208955223880597
"[1, 1, 0, 0, 1, 0, 0, 0, 0, 0, 0, 1, 1, 0, 0]",504,296,208,31,28,0.10472972972972973,0.1346153846153846
"[0, 0, 0, 1, 1, 0, 0, 1, 0, 1, 0, 1, 1, 0, 1]",123,78,45,9,3,0.11538461538461539,0.06666666666666667
"[0, 0, 0, 1, 0, 0, 1, 0, 1, 0, 0, 0, 1, 1, 0]",298,191,107,15,11,0.07853403141361257,0.102803738317757
"[0, 1, 1, 0, 1, 1, 0, 0, 1, 0, 0, 1, 0, 0, 0]",148,82,66,3,6,0.036585365853658534,0.09090909090909091
"[1, 0, 1, 1, 1, 1, 0, 0, 0, 0, 1, 0, 1, 0, 1]",115,59,56,5,5,0.0847457627118644,0.08928571428571429
"[1, 0, 1, 0, 1, 0, 0, 1, 0, 1, 1, 0, 0, 1, 0]",113,53,60,6,4,0.11320754716981132,0.06666666666666667
"[1, 1, 0, 0, 1, 1, 1, 1, 0, 1, 1, 1, 0, 1, 0]",269,94,175,15,17,0.1595744680851064,0.09714285714285714
"[0, 1, 1, 0, 0, 0, 0, 0, 1, 1, 0, 1, 1, 0, 1]",149,89,60,5,4,0.056179775280898875,0.06666666666666667
"[1, 0, 0, 0, 0, 1, 1, 1, 1, 0, 0, 1, 1, 0, 0]",1493,317,1176,26,137,0.08201892744479496,0.11649659863945579
"[0, 1, 1, 0, 0, 0, 0, 1, 1, 1, 1, 0, 0, 1, 1]",1611,1257,354,125,26,0.09944311853619729,0.07344632768361582
"[0, 1, 1, 1, 1, 1, 0, 1, 0, 0, 1, 1, 1, 1, 1]",794,282,512,27,50,0.09574468085106383,0.09765625
"[1, 0, 0, 1, 0, 1, 1, 0, 0, 0, 0, 0, 0, 1, 1]",377,216,161,26,17,0.12037037037037036,0.10559006211180125
"[0, 1, 0, 0, 0, 0, 0, 0, 1, 1, 1, 0, 0, 0, 0]",732,522,210,40,16,0.07662835249042145,0.0761904761904762
"[0, 1, 0, 1, 0, 1, 0, 0, 0, 0, 0, 0, 1, 0, 0]",541,393,148,37,7,0.09414758269720101,0.0472972972972973
"[1, 0, 1, 1, 0, 0, 0, 0, 0, 0, 1, 1, 0, 0, 1]",472,246,226,26,26,0.10569105691056911,0.11504424778761062
"[0, 1, 1, 0, 1, 1, 0, 0, 0, 0, 0, 0, 1, 1, 0]",329,203,126,20,6,0.09852216748768473,0.047619047619047616
"[0, 1, 1, 1, 0, 0, 0, 1, 0, 1, 0, 1, 0, 0, 0]",142,90,52,4,3,0.044444444444444446,0.057692307692307696
"[0, 0, 1, 0, 0, 0, 1, 0, 0, 0, 1, 1, 1, 1, 1]",210,124,86,10,8,0.08064516129032258,0.09302325581395349
"[1, 1, 0, 0, 0, 0, 1, 1, 0, 1, 0, 0, 0, 0, 0]",391,254,137,22,12,0.08661417322834646,0.08759124087591241
"[0, 1, 0, 1, 0, 1, 0, 1, 1, 1, 1, 1, 0, 1, 0]",132,66,66,3,4,0.045454545454545456,0.06060606060606061
"[1, 0, 1, 0, 1, 1, 1, 1, 1, 1, 0, 0, 1, 1, 1]",1044,296,748,28,59,0.0945945945945946,0.07887700534759358
"[1, 0, 0, 1, 0, 1, 1, 0, 1, 1, 1, 1, 1, 1, 0]",269,98,171,9,20,0.09183673469387756,0.11695906432748537
"[1, 1, 1, 0, 0, 1, 0, 1, 1, 0, 1, 1, 1, 1, 1]",676,206,470,26,35,0.1262135922330097,0.07446808510638298
"[1, 1, 1, 1, 0, 0, 1, 0, 1, 1, 1, 0, 0, 0, 0]",194,81,113,8,11,0.09876543209876543,0.09734513274336283
"[1, 1, 1, 1, 1, 0, 0, 1, 0, 1, 1, 1, 0, 0, 0]",230,100,130,9,15,0.09,0.11538461538461539
"[0, 1, 1, 1, 1, 1, 1, 0, 0, 0, 0, 0, 1, 0, 1]",217,149,68,17,6,0.11409395973154363,0.08823529411764706
"[1, 0, 0, 0, 0, 1, 1, 1, 1, 1, 1, 0, 0, 0, 0]",1641,372,1269,40,139,0.10752688172043011,0.1095350669818755
"[0, 1, 0, 1, 1, 1, 1, 0, 0, 0, 1, 1, 0, 0, 0]",191,95,96,3,13,0.031578947368421054,0.13541666666666666
"[0, 0, 1, 0, 0, 0, 1, 1, 1, 0, 0, 1, 1, 1, 0]",138,79,59,8,5,0.10126582278481013,0.0847457627118644
"[0, 0, 0, 1, 0, 0, 0, 1, 1, 1, 0, 0, 1, 1, 1]",208,112,96,9,11,0.08035714285714286,0.11458333333333333
"[1, 0, 0, 0, 1, 1, 0, 0, 0, 0, 0, 1, 0, 0, 0]",595,429,166,43,12,0.10023310023310024,0.07228915662650602
"[0, 0, 1, 0, 0, 0, 1, 1, 0, 0, 0, 0, 0, 1, 0]",525,380,145,34,21,0.08947368421052632,0.14482758620689656
"[1, 0, 0, 0, 0, 1, 0, 0, 0, 1, 1, 0, 0, 0, 0]",819,546,273,56,21,0.10256410256410256,0.07692307692307693
"[1, 1, 0, 0, 0, 0, 1, 0, 0, 0, 1, 1, 0, 0, 0]",375,239,136,17,11,0.07112970711297072,0.08088235294117647
"[1, 1, 0, 0, 1, 0, 0, 1, 1, 1, 1, 0, 1, 1, 0]",169,74,95,9,6,0.12162162162162163,0.06315789473684211
"[1, 0, 1, 1, 1, 0, 0, 1, 0, 0, 1, 1, 1, 1, 0]",170,80,90,5,7,0.0625,0.07777777777777778
"[0, 1, 1, 1, 0, 0, 1, 0, 1, 1, 1, 0, 1, 1, 1]",268,98,170,7,14,0.07142857142857142,0.08235294117647059
"[0, 1, 1, 1, 1, 1, 0, 1, 0, 0, 0, 0, 0, 1, 1]",191,99,92,10,13,0.10101010101010101,0.14130434782608695
"[1, 1, 1, 0, 1, 1, 1, 1, 1, 0, 1, 0, 0, 0, 0]",177,78,99,6,7,0.07692307692307693,0.0707070707070707
"[1, 0, 1, 1, 1, 0, 1, 0, 1, 0, 1, 1, 1, 1, 1]",554,173,381,14,43,0.08092485549132948,0.11286089238845144
"[1, 1, 0, 1, 1, 1, 0, 0, 1, 1, 1, 1, 0, 0, 1]",599,204,395,24,37,0.11764705882352941,0.09367088607594937
"[0, 0, 0, 0, 1, 0, 1, 0, 0, 1, 1, 0, 1, 0, 1]",134,74,60,9,3,0.12162162162162163,0.05
"[1, 0, 0, 1, 1, 1, 0, 0, 0, 0, 0, 0, 1, 0, 0]",294,175,119,18,9,0.10285714285714286,0.07563025210084033
"[0, 0, 0, 0, 0, 0, 1, 0, 0, 1, 0, 0, 0, 1, 0]",1552,1177,375,112,32,0.0951571792693288,0.08533333333333333
"[0, 0, 0, 0, 0, 0, 0, 1, 0, 0, 1, 0, 0, 0, 1]",1824,1423,401,133,36,0.09346451159522136,0.08977556109725686
"[0, 0, 0, 1, 1, 0, 0, 0, 0, 1, 1, 1, 0, 1, 0]",280,200,80,18,10,0.09,0.125
"[0, 0, 0, 1, 1, 0, 0, 0, 0, 0, 1, 1, 0, 0, 0]",1079,827,252,83,20,0.1003627569528416,0.07936507936507936
"[1, 0, 0, 1, 0, 1, 0, 1, 1, 0, 0, 0, 0, 0, 0]",365,224,141,16,13,0.07142857142857142,0.09219858156028368
"[1, 1, 1, 0, 0, 0, 0, 1, 1, 0, 1, 1, 0, 1, 1]",273,86,187,4,17,0.046511627906976744,0.09090909090909091
"[1, 0, 0, 1, 1, 1, 1, 0, 1, 1, 1, 0, 1, 1, 0]",253,86,167,13,15,0.1511627906976744,0.08982035928143713
"[1, 0, 1, 0, 1, 0, 1, 1, 1, 0, 0, 0, 0, 1, 1]",210,91,119,7,8,0.07692307692307693,0.06722689075630252
"[0, 0, 0, 1, 0, 0, 1, 1, 0, 0, 0, 0, 0, 1, 1]",394,262,132,23,16,0.08778625954198473,0.12121212121212122
"[1, 0, 0, 0, 0, 0, 0, 0, 0, 1, 1, 1, 0, 0, 1]",425,189,236,13,17,0.06878306878306878,0.07203389830508475
"[1, 1, 1, 1, 0, 1, 1, 0, 0, 0, 0, 1, 1, 1, 1]",684,216,468,23,50,0.10648148148148148,0.10683760683760683
"[1, 1, 1, 0, 1, 1, 0, 0, 0, 1, 1, 0, 1, 1, 1]",275,99,176,13,17,0.13131313131313133,0.09659090909090909
"[0, 1, 1, 0, 1, 1, 1, 1, 1, 0, 1, 1, 0, 0, 0]",169,71,98,12,11,0.16901408450704225,0.11224489795918367
"[0, 1, 1, 0, 1, 0, 1, 1, 1, 0, 1, 1, 1, 1, 1]",596,216,380,14,46,0.06481481481481481,0.12105263157894737
"[0, 1, 1, 0, 1, 1, 0, 1, 0, 1, 1, 1, 0, 1, 1]",237,93,144,7,10,0.07526881720430108,0.06944444444444445
"[0, 0, 1, 1, 1, 0, 0, 0, 0, 0, 1, 0, 0, 1, 1]",217,134,83,9,7,0.06716417910447761,0.08433734939759036
"[0, 1, 0, 1, 1, 1, 1, 0, 0, 1, 1, 1, 0, 0, 0]",156,83,73,8,10,0.0963855421686747,0.136986301369863
"[0, 0, 1, 1, 1, 1, 1, 0, 0, 1, 0, 0, 0, 0, 1]",153,100,53,10,4,0.1,0.07547169811320754
"[1, 0, 1, 1, 0, 0, 1, 1, 1, 0, 0, 1, 1, 1, 1]",396,159,237,20,24,0.12578616352201258,0.10126582278481013
"[0, 1, 1, 1, 1, 0, 1, 1, 1, 0, 1, 1, 1, 0, 1]",514,183,331,18,38,0.09836065573770492,0.1148036253776435
"[0, 0, 1, 1, 0, 0, 1, 0, 1, 1, 0, 1, 1, 1, 1]",217,96,121,15,13,0.15625,0.10743801652892562
"[0, 1, 1, 1, 1, 0, 1, 0, 1, 1, 1, 1, 0, 0, 1]",309,132,177,16,20,0.12121212121212122,0.11299435028248588
"[0, 1, 1, 1, 0, 1, 1, 1, 1, 0, 1, 0, 1, 1, 1]",586,177,409,12,45,0.06779661016949153,0.1100244498777506
"[1, 1, 0, 1, 1, 1, 0, 1, 0, 1, 1, 1, 0, 1, 1]",504,147,357,16,35,0.10884353741496598,0.09803921568627451
"[0, 1, 0, 1, 0, 1, 1, 1, 1, 0, 1, 1, 0, 0, 0]",138,57,81,3,4,0.05263157894736842,0.04938271604938271
"[0, 0, 1, 0, 1, 1, 0, 1, 0, 0, 0, 0, 1, 1, 1]",180,86,94,8,8,0.09302325581395349,0.0851063829787234
"[1, 0, 1, 0, 0, 0, 1, 1, 0, 1, 0, 1, 0, 1, 0]",102,46,56,3,5,0.06521739130434782,0.08928571428571429
"[1, 1, 1, 0, 0, 1, 0, 0, 0, 0, 1, 1, 0, 1, 0]",125,52,73,3,7,0.057692307692307696,0.0958904109589041
"[0, 1, 1, 0, 0, 1, 1, 1, 1, 0, 0, 1, 0, 0, 0]",229,165,64,18,5,0.10909090909090909,0.078125
"[1, 1, 0, 0, 0, 1, 1, 0, 0, 0, 0, 1, 1, 0, 0]",518,275,243,23,21,0.08363636363636363,0.08641975308641975
"[0, 1, 0, 1, 1, 0, 0, 1, 0, 0, 0, 0, 0, 0, 0]",682,479,203,50,10,0.10438413361169102,0.04926108374384237
"[1, 0, 1, 1, 0, 0, 0, 0, 0, 0, 0, 0, 0, 1, 0]",596,413,183,44,20,0.10653753026634383,0.1092896174863388
"[1, 0, 1, 1, 0, 1, 0, 1, 1, 0, 1, 1, 1, 1, 1]",584,180,404,17,37,0.09444444444444444,0.09158415841584158
"[0, 0, 1, 1, 0, 1, 0, 0, 0, 1, 0, 1, 0, 0, 0]",248,164,84,22,6,0.13414634146341464,0.07142857142857142
"[1, 1, 0, 0, 0, 1, 1, 0, 1, 0, 0, 0, 1, 0, 1]",104,58,46,3,4,0.05172413793103448,0.08695652173913043
"[0, 0, 0, 1, 0, 1, 1, 1, 1, 0, 1, 1, 1, 1, 1]",336,130,206,5,22,0.038461538461538464,0.10679611650485436
"[0, 0, 0, 0, 1, 0, 1, 1, 1, 1, 0, 1, 1, 1, 1]",211,88,123,8,9,0.09090909090909091,0.07317073170731707
"[1, 0, 0, 0, 1, 0, 1, 0, 0, 0, 0, 1, 0, 0, 0]",554,379,175,41,19,0.10817941952506596,0.10857142857142857
"[0, 0, 0, 0, 0, 0, 1, 1, 0, 0, 0, 1, 1, 1, 0]",409,279,130,23,18,0.08243727598566308,0.13846153846153847
"[0, 0, 1, 1, 1, 1, 1, 0, 0, 0, 0, 0, 0, 0, 0]",912,585,327,49,29,0.08376068376068375,0.08868501529051988
"[1, 0, 1, 1, 0, 1, 1, 1, 0, 1, 1, 1, 0, 0, 0]",139,60,79,4,10,0.06666666666666667,0.12658227848101267
"[1, 1, 1, 0, 1, 1, 0, 1, 1, 0, 1, 1, 1, 0, 1]",489,155,334,16,34,0.1032258064516129,0.10179640718562874
"[0, 0, 0, 1, 1, 1, 0, 0, 1, 0, 0, 1, 1, 1, 1]",189,104,85,8,11,0.07692307692307693,0.12941176470588237
"[0, 0, 0, 1, 0, 0, 1, 1, 0, 0, 1, 0, 0, 1, 1]",196,134,62,7,2,0.05223880597014925,0.03225806451612903
"[0, 0, 0, 1, 1, 0, 1, 1, 0, 1, 0, 1, 0, 0, 0]",164,91,73,11,8,0.12087912087912088,0.1095890410958904
"[0, 0, 1, 1, 1, 1, 0, 0, 0, 0, 0, 1, 1, 0, 1]",226,128,98,12,7,0.09375,0.07142857142857142
"[0, 0, 0, 1, 1, 1, 0, 0, 1, 1, 0, 0, 1, 0, 0]",171,107,64,15,6,0.14018691588785046,0.09375
"[0, 0, 0, 0, 1, 0, 0, 0, 0, 0, 0, 1, 1, 1, 0]",625,450,175,39,17,0.08666666666666667,0.09714285714285714
"[0, 0, 0, 1, 0, 0, 0, 1, 1, 1, 0, 0, 0, 0, 0]",739,535,204,57,19,0.10654205607476636,0.09313725490196079
"[0, 0, 1, 1, 1, 0, 0, 0, 0, 1, 0, 0, 1, 1, 0]",205,134,71,10,7,0.07462686567164178,0.09859154929577464
"[1, 0, 1, 1, 0, 1, 1, 1, 1, 0, 1, 1, 0, 1, 0]",231,79,152,7,16,0.08860759493670886,0.10526315789473684
"[1, 0, 0, 0, 1, 1, 1, 1, 1, 1, 0, 0, 1, 1, 0]",413,185,228,26,23,0.14054054054054055,0.10087719298245613
"[0, 0, 0, 1, 1, 1, 0, 0, 0, 1, 1, 1, 1, 1, 1]",435,209,226,21,18,0.10047846889952153,0.07964601769911504
"[0, 0, 0, 0, 0, 1, 0, 0, 1, 0, 0, 0, 0, 0, 1]",1821,1426,395,133,49,0.09326788218793829,0.1240506329113924
"[1, 1, 1, 0, 1, 0, 0, 1, 0, 0, 1, 0, 0, 0, 0]",151,90,61,9,3,0.1,0.04918032786885246
"[1, 0, 0, 1, 1, 1, 0, 1, 1, 1, 1, 1, 1, 0, 0]",391,125,266,11,20,0.088,0.07518796992481203
"[1, 1, 1, 0, 1, 1, 0, 0, 1, 1, 1, 0, 1, 1, 1]",622,183,439,13,29,0.07103825136612021,0.06605922551252848
"[0, 1, 1, 0, 1, 1, 1, 1, 0, 1, 1, 0, 0, 1, 1]",361,119,242,11,29,0.09243697478991597,0.11983471074380166
"[1, 0, 0, 0, 1, 0, 0, 1, 1, 0, 1, 0, 1, 1, 1]",132,52,80,4,8,0.07692307692307693,0.1
"[0, 0, 1, 1, 1, 1, 1, 1, 1, 1, 0, 0, 0, 1, 1]",781,303,478,33,33,0.10891089108910891,0.06903765690376569
"[0, 0, 0, 0, 0, 1, 1, 1, 1, 1, 1, 0, 1, 1, 0]",247,177,70,17,3,0.096045197740113,0.04285714285714286
"[0, 1, 0, 1, 1, 0, 1, 0, 1, 1, 1, 0, 0, 0, 1]",105,45,60,6,4,0.13333333333333333,0.06666666666666667
"[1, 0, 0, 1, 1, 1, 1, 1, 0, 1, 0, 1, 1, 1, 0]",288,100,188,10,14,0.1,0.07446808510638298
"[1, 0, 0, 1, 1, 0, 0, 1, 1, 1, 1, 1, 0, 1, 0]",260,56,204,6,23,0.10714285714285714,0.11274509803921569
"[0, 1, 1, 0, 1, 0, 0, 1, 1, 0, 1, 0, 1, 1, 1]",153,53,100,4,5,0.07547169811320754,0.05
"[0, 1, 1, 0, 1, 1, 0, 1, 0, 0, 1, 1, 0, 1, 0]",105,52,53,2,3,0.038461538461538464,0.05660377358490566
"[0, 1, 0, 1, 1, 0, 1, 1, 0, 1, 0, 0, 1, 1, 0]",117,52,65,2,6,0.038461538461538464,0.09230769230769231
"[0, 0, 1, 1, 1, 1, 1, 1, 0, 1, 0, 1, 1, 0, 1]",305,111,194,3,21,0.02702702702702703,0.10824742268041238
"[1, 0, 1, 1, 0, 1, 1, 1, 0, 1, 0, 1, 1, 1, 0]",240,85,155,8,18,0.09411764705882353,0.11612903225806452
"[1, 1, 0, 1, 1, 0, 1, 1, 1, 0, 1, 0, 1, 1, 1]",537,149,388,18,47,0.12080536912751678,0.1211340206185567
"[0, 1, 0, 1, 0, 1, 0, 1, 1, 1, 1, 1, 1, 0, 0]",204,87,117,6,12,0.06896551724137931,0.10256410256410256
"[1, 0, 1, 0, 0, 1, 1, 0, 1, 0, 1, 0, 1, 0, 1]",84,45,39,2,4,0.044444444444444446,0.10256410256410256
"[1, 0, 1, 1, 0, 1, 0, 0, 1, 1, 0, 1, 0, 1, 0]",106,47,59,5,4,0.10638297872340426,0.06779661016949153
"[0, 0, 0, 1, 0, 1, 0, 1, 1, 1, 1, 0, 0, 0, 0]",265,166,99,22,11,0.13253012048192772,0.1111111111111111
"[1, 0, 0, 1, 1, 0, 1, 1, 0, 0, 0, 0, 1, 1, 0]",207,100,107,7,9,0.07,0.08411214953271028
"[1, 1, 0, 1, 1, 0, 1, 0, 0, 1, 1, 0, 1, 1, 0]",158,70,88,8,5,0.11428571428571428,0.056818181818181816
"[1, 1, 0, 0, 1, 1, 0, 0, 1, 0, 0, 0, 1, 0, 1]",136,71,65,4,4,0.056338028169014086,0.06153846153846154
"[0, 1, 1, 1, 1, 0, 0, 1, 1, 0, 0, 1, 0, 0, 0]",271,185,86,12,6,0.06486486486486487,0.06976744186046512
"[1, 1, 0, 1, 0, 1, 0, 1, 1, 0, 0, 1, 0, 0, 0]",102,48,54,3,7,0.0625,0.12962962962962962
"[1, 0, 0, 1, 0, 1, 1, 0, 0, 0, 0, 0, 0, 0, 1]",324,215,109,26,10,0.12093023255813953,0.09174311926605505
"[0, 0, 0, 1, 0, 0, 1, 0, 1, 1, 0, 0, 0, 0, 0]",726,489,237,49,23,0.10020449897750511,0.0970464135021097
"[0, 1, 1, 0, 0, 0, 0, 1, 1, 1, 0, 1, 1, 1, 1]",323,215,108,28,17,0.13023255813953488,0.1574074074074074
"[1, 0, 0, 0, 1, 0, 0, 0, 1, 0, 0, 1, 0, 0, 1]",210,143,67,13,7,0.09090909090909091,0.1044776119402985
"[1, 0, 0, 1, 0, 0, 0, 1, 0, 0, 1, 1, 1, 0, 1]",97,55,42,6,4,0.10909090909090909,0.09523809523809523
"[0, 0, 1, 0, 1, 1, 0, 0, 1, 1, 1, 1, 1, 0, 0]",170,87,83,10,7,0.11494252873563218,0.08433734939759036
"[1, 0, 0, 0, 1, 0, 1, 1, 0, 1, 1, 0, 1, 1, 1]",172,59,113,8,9,0.13559322033898305,0.07964601769911504
"[0, 1, 1, 0, 1, 0, 0, 1, 0, 0, 0, 0, 0, 1, 0]",224,145,79,12,6,0.08275862068965517,0.0759493670886076
"[0, 1, 0, 0, 1, 0, 1, 1, 0, 1, 0, 1, 0, 1, 0]",95,58,37,10,1,0.1724137931034483,0.02702702702702703
"[0, 1, 0, 0, 1, 0, 0, 1, 0, 1, 1, 0, 1, 0, 1]",117,70,47,6,1,0.08571428571428572,0.02127659574468085
"[0, 1, 0, 1, 0, 0, 1, 0, 0, 1, 0, 1, 1, 0, 1]",114,59,55,5,8,0.0847457627118644,0.14545454545454545
"[0, 1, 1, 1, 1, 0, 0, 1, 0, 1, 0, 0, 1, 0, 0]",140,82,58,6,5,0.07317073170731707,0.08620689655172414
"[1, 0, 0, 0, 1, 0, 1, 0, 1, 0, 0, 1, 0, 1, 1]",105,56,49,5,4,0.08928571428571429,0.08163265306122448
"[1, 0, 1, 0, 0, 0, 0, 1, 0, 0, 1, 1, 1, 0, 0]",140,85,55,9,5,0.10588235294117647,0.09090909090909091
"[0, 1, 0, 1, 0, 0, 0, 0, 1, 0, 0, 1, 1, 1, 0]",139,81,58,0,7,0.0,0.1206896551724138
"[0, 0, 1, 0, 1, 0, 1, 0, 1, 0, 0, 0, 0, 1, 0]",210,144,66,19,9,0.13194444444444445,0.13636363636363635
"[1, 1, 0, 0, 0, 0, 0, 0, 0, 1, 1, 1, 0, 0, 0]",405,266,139,20,12,0.07518796992481203,0.08633093525179857
"[1, 0, 0, 0, 1, 1, 1, 0, 0, 1, 0, 0, 0, 0, 0]",303,202,101,21,13,0.10396039603960396,0.12871287128712872
"[0, 0, 1, 0, 0, 0, 0, 0, 0, 0, 0, 0, 1, 0, 1]",1709,1298,411,125,31,0.0963020030816641,0.07542579075425791
"[1, 0, 0, 1, 0, 1, 0, 0, 1, 1, 0, 1, 1, 1, 0]",110,55,55,3,5,0.05454545454545454,0.09090909090909091
"[1, 1, 1, 1, 0, 0, 1, 0, 1, 0, 0, 1, 1, 0, 1]",158,64,94,7,5,0.109375,0.05319148936170213
"[1, 0, 1, 0, 0, 0, 1, 0, 1, 1, 1, 1, 1, 0, 0]",138,64,74,5,9,0.078125,0.12162162162162163
"[1, 0, 1, 1, 0, 0, 1, 0, 0, 1, 0, 1, 0, 0, 1]",111,61,50,4,1,0.06557377049180328,0.02
"[1, 1, 1, 1, 1, 0, 1, 1, 0, 0, 1, 0, 0, 1, 0]",148,59,89,7,8,0.11864406779661017,0.0898876404494382
"[0, 0, 0, 0, 1, 0, 1, 1, 0, 1, 0, 1, 0, 1, 1]",126,60,66,3,7,0.05,0.10606060606060606
"[0, 0, 0, 0, 1, 0, 0, 1, 1, 0, 1, 0, 1, 1, 1]",160,87,73,6,6,0.06896551724137931,0.0821917808219178
"[1, 0, 0, 0, 1, 0, 0, 0, 0, 0, 1, 1, 0, 0, 0]",806,539,267,51,20,0.09461966604823747,0.0749063670411985
"[0, 1, 0, 0, 0, 1, 0, 0, 0, 0, 0, 1, 1, 0, 0]",759,537,222,43,24,0.08007448789571694,0.10810810810810811
"[1, 1, 1, 1, 1, 0, 1, 1, 0, 1, 0, 0, 1, 0, 0]",144,49,95,5,10,0.10204081632653061,0.10526315789473684
"[1, 1, 0, 1, 1, 1, 1, 1, 1, 0, 1, 1, 0, 1, 0]",486,132,354,11,31,0.08333333333333333,0.08757062146892655
"[1, 0, 0, 1, 1, 0, 1, 1, 0, 0, 1, 1, 0, 1, 0]",120,51,69,4,7,0.0784313725490196,0.10144927536231885
"[1, 0, 0, 0, 0, 1, 1, 1, 1, 1, 1, 1, 0, 0, 0]",320,117,203,6,28,0.05128205128205128,0.13793103448275862
"[1, 0, 0, 1, 1, 1, 1, 1, 1, 0, 1, 0, 0, 0, 0]",207,74,133,7,14,0.0945945945945946,0.10526315789473684
"[0, 1, 1, 1, 1, 1, 1, 1, 0, 0, 1, 0, 0, 1, 1]",353,150,203,22,19,0.14666666666666667,0.09359605911330049
"[1, 0, 1, 1, 1, 1, 1, 1, 1, 0, 0, 1, 0, 0, 1]",290,111,179,8,18,0.07207207207207207,0.1005586592178771
"[1, 0, 0, 1, 1, 1, 1, 0, 1, 1, 1, 0, 1, 1, 1]",718,167,551,16,58,0.09580838323353294,0.10526315789473684
"[0, 1, 0, 1, 1, 0, 0, 1, 1, 1, 1, 0, 1, 1, 1]",306,114,192,12,19,0.10526315789473684,0.09895833333333333
"[1, 0, 1, 1, 1, 0, 0, 1, 1, 1, 1, 0, 0, 0, 0]",444,179,265,20,30,0.11173184357541899,0.11320754716981132
"[0, 0, 1, 0, 0, 0, 0, 0, 1, 1, 0, 1, 0, 0, 0]",557,385,172,32,16,0.08311688311688312,0.09302325581395349
"[0, 0, 1, 0, 1, 1, 1, 0, 1, 0, 0, 1, 0, 1, 1]",112,47,65,9,12,0.19148936170212766,0.18461538461538463
"[0, 0, 0, 1, 0, 0, 1, 0, 1, 0, 0, 0, 1, 0, 1]",241,154,87,19,9,0.12337662337662338,0.10344827586206896
"[0, 1, 0, 0, 1, 0, 0, 0, 0, 1, 0, 1, 0, 1, 0]",233,159,74,14,10,0.0880503144654088,0.13513513513513514
"[0, 1, 0, 0, 0, 1, 0, 1, 1, 0, 1, 0, 0, 1, 0]",135,81,54,15,2,0.18518518518518517,0.037037037037037035
"[0, 0, 0, 1, 0, 1, 0, 0, 0, 1, 0, 0, 1, 0, 1]",231,147,84,17,6,0.11564625850340136,0.07142857142857142
"[0, 0, 1, 0, 1, 0, 1, 0, 0, 0, 0, 1, 0, 1, 1]",176,100,76,13,9,0.13,0.11842105263157894
"[1, 1, 0, 1, 0, 1, 0, 0, 1, 0, 1, 0, 1, 0, 0]",121,69,52,4,2,0.057971014492753624,0.038461538461538464
"[0, 0, 0, 1, 1, 0, 1, 0, 1, 0, 0, 1, 0, 1, 0]",149,95,54,8,5,0.08421052631578947,0.09259259259259259
"[1, 0, 0, 0, 0, 1, 1, 0, 1, 1, 0, 0, 0, 1, 1]",202,86,116,7,10,0.08139534883720931,0.08620689655172414
"[0, 1, 1, 1, 1, 1, 0, 0, 1, 0, 0, 1, 1, 1, 1]",359,163,196,15,24,0.09202453987730061,0.12244897959183673
"[0, 0, 1, 1, 1, 1, 1, 1, 0, 0, 1, 1, 1, 0, 0]",404,185,219,10,18,0.05405405405405406,0.0821917808219178
"[0, 0, 1, 0, 0, 0, 0, 0, 1, 1, 1, 0, 0, 1, 0]",218,142,76,18,8,0.1267605633802817,0.10526315789473684
"[0, 0, 1, 1, 0, 1, 1, 1, 1, 0, 1, 0, 1, 1, 1]",268,91,177,14,14,0.15384615384615385,0.07909604519774012
"[0, 0, 1, 0, 1, 1, 0, 1, 1, 1, 1, 1, 1, 0, 1]",233,88,145,7,14,0.07954545454545454,0.09655172413793103
"[0, 1, 1, 0, 0, 0, 1, 0, 0, 0, 1, 1, 0, 1, 0]",121,71,50,5,8,0.07042253521126761,0.16
"[1, 0, 0, 0, 0, 0, 1, 1, 1, 0, 0, 1, 1, 1, 1]",294,142,152,12,15,0.08450704225352113,0.09868421052631579
"[1, 1, 1, 1, 0, 1, 1, 0, 0, 0, 1, 0, 1, 1, 1]",290,108,182,14,18,0.12962962962962962,0.0989010989010989
"[1, 1, 1, 1, 0, 0, 1, 1, 1, 1, 0, 1, 1, 0, 0]",423,155,268,12,39,0.07741935483870968,0.1455223880597015
"[0, 0, 1, 1, 0, 1, 1, 1, 1, 0, 0, 1, 1, 1, 1]",559,213,346,13,30,0.06103286384976526,0.08670520231213873
"[0, 1, 0, 1, 1, 0, 0, 0, 0, 0, 0, 1, 0, 0, 1]",279,177,102,14,12,0.07909604519774012,0.11764705882352941
"[1, 0, 0, 1, 0, 0, 1, 1, 0, 0, 1, 0, 1, 1, 0]",124,72,52,4,3,0.05555555555555555,0.057692307692307696
"[0, 0, 0, 0, 0, 1, 0, 0, 1, 0, 0, 1, 1, 0, 0]",752,532,220,48,21,0.09022556390977443,0.09545454545454546
"[0, 0, 0, 0, 0, 0, 0, 1, 0, 0, 1, 0, 0, 1, 1]",963,721,242,70,14,0.0970873786407767,0.05785123966942149
"[0, 1, 1, 0, 1, 1, 0, 0, 1, 1, 0, 0, 0, 1, 0]",108,50,58,3,5,0.06,0.08620689655172414
"[0, 0, 0, 0, 0, 1, 1, 1, 0, 0, 1, 1, 0, 0, 0]",526,372,154,44,12,0.11827956989247312,0.07792207792207792
"[0, 1, 0, 1, 1, 1, 1, 1, 0, 1, 0, 1, 1, 1, 1]",580,170,410,20,28,0.11764705882352941,0.06829268292682927
"[1, 0, 1, 0, 0, 1, 0, 1, 0, 0, 1, 1, 0, 1, 0]",114,52,62,5,9,0.09615384615384616,0.14516129032258066
"[0, 1, 0, 1, 1, 0, 1, 1, 1, 1, 1, 0, 0, 1, 1]",369,142,227,10,25,0.07042253521126761,0.11013215859030837
"[1, 0, 0, 1, 0, 1, 1, 1, 1, 1, 0, 1, 0, 0, 0]",118,57,61,5,2,0.08771929824561403,0.03278688524590164
"[0, 1, 1, 1, 1, 1, 0, 1, 0, 1, 1, 1, 1, 0, 0]",354,146,208,13,26,0.08904109589041095,0.125
"[1, 1, 0, 1, 1, 0, 1, 0, 0, 0, 1, 1, 1, 0, 0]",134,64,70,4,7,0.0625,0.1
"[1, 0, 1, 1, 1, 1, 1, 0, 1, 1, 0, 1, 0, 0, 0]",151,60,91,3,10,0.05,0.10989010989010989
"[0, 1, 1, 1, 0, 0, 1, 1, 1, 0, 1, 1, 1, 1, 0]",255,99,156,14,18,0.1414141414141414,0.11538461538461539
"[0, 0, 0, 1, 1, 0, 0, 0, 0, 1, 1, 0, 1, 1, 1]",500,396,104,37,9,0.09343434343434344,0.08653846153846154
"[0, 0, 0, 0, 1, 1, 0, 0, 0, 0, 1, 1, 0, 1, 1]",574,330,244,34,19,0.10303030303030303,0.0778688524590164
"[1, 1, 0, 1, 1, 1, 0, 0, 1, 0, 0, 0, 1, 1, 0]",127,51,76,6,5,0.11764705882352941,0.06578947368421052
"[1, 0, 0, 0, 0, 0, 1, 1, 1, 0, 1, 0, 1, 1, 0]",122,60,62,3,9,0.05,0.14516129032258066
"[0, 1, 1, 1, 1, 1, 0, 0, 0, 0, 1, 1, 1, 0, 0]",173,77,96,8,8,0.1038961038961039,0.08333333333333333
"[1, 0, 1, 0, 1, 1, 1, 0, 1, 1, 1, 1, 1, 0, 0]",281,118,163,16,13,0.13559322033898305,0.07975460122699386
"[0, 0, 0, 1, 0, 1, 0, 1, 1, 1, 1, 0, 0, 1, 1]",184,92,92,10,12,0.10869565217391304,0.13043478260869565
"[1, 1, 0, 1, 0, 0, 0, 1, 0, 1, 0, 1, 1, 1, 1]",144,55,89,6,7,0.10909090909090909,0.07865168539325842
"[1, 0, 1, 1, 1, 0, 1, 1, 1, 0, 0, 1, 1, 1, 0]",245,91,154,11,14,0.12087912087912088,0.09090909090909091
"[1, 0, 0, 0, 0, 0, 1, 0, 1, 1, 1, 0, 1, 1, 1]",177,73,104,6,9,0.0821917808219178,0.08653846153846154
"[0, 1, 0, 1, 0, 0, 1, 0, 1, 0, 0, 0, 1, 1, 0]",138,81,57,6,2,0.07407407407407407,0.03508771929824561
"[1, 1, 0, 0, 1, 0, 0, 0, 1, 0, 1, 0, 1, 0, 0]",132,72,60,7,6,0.09722222222222222,0.1
"[0, 0, 1, 1, 1, 1, 1, 1, 1, 1, 1, 0, 0, 0, 1]",586,255,331,34,32,0.13333333333333333,0.09667673716012085
"[0, 0, 1, 1, 0, 1, 1, 1, 1, 0, 1, 1, 1, 0, 0]",156,70,86,5,7,0.07142857142857142,0.08139534883720931
"[1, 0, 0, 0, 1, 1, 0, 1, 1, 1, 1, 0, 1, 1, 1]",304,95,209,7,15,0.07368421052631578,0.07177033492822966
"[0, 1, 0, 0, 0, 1, 1, 0, 1, 1, 0, 0, 0, 1, 1]",151,76,75,9,6,0.11842105263157894,0.08
"[0, 0, 0, 1, 1, 1, 0, 0, 1, 0, 0, 0, 1, 1, 0]",188,129,59,13,8,0.10077519379844961,0.13559322033898305
"[1, 1, 0, 0, 1, 1, 1, 1, 0, 1, 1, 0, 1, 1, 0]",306,100,206,8,22,0.08,0.10679611650485436
"[0, 1, 1, 0, 0, 0, 1, 1, 1, 1, 1, 1, 0, 1, 1]",321,109,212,8,26,0.07339449541284404,0.12264150943396226
"[0, 1, 1, 1, 1, 1, 0, 1, 1, 0, 0, 0, 1, 1, 1]",325,134,191,10,16,0.07462686567164178,0.08376963350785341
"[1, 1, 1, 0, 1, 1, 0, 1, 1, 0, 0, 1, 0, 1, 1]",246,84,162,8,8,0.09523809523809523,0.04938271604938271
"[0, 1, 0, 0, 1, 1, 1, 1, 1, 0, 1, 1, 1, 1, 1]",661,213,448,17,44,0.07981220657276995,0.09821428571428571
"[1, 0, 0, 1, 0, 0, 1, 1, 1, 1, 1, 0, 1, 1, 1]",313,101,212,8,27,0.07920792079207921,0.12735849056603774
"[0, 1, 1, 0, 0, 1, 0, 0, 0, 1, 0, 1, 1, 1, 0]",103,46,57,0,3,0.0,0.05263157894736842
"[1, 0, 1, 1, 0, 0, 1, 0, 0, 0, 1, 0, 1, 1, 1]",134,65,69,7,7,0.1076923076923077,0.10144927536231885
"[0, 0, 0, 1, 0, 1, 0, 0, 1, 1, 0, 0, 1, 1, 0]",279,170,109,15,18,0.08823529411764706,0.1651376146788991
"[1, 0, 0, 1, 0, 0, 0, 0, 0, 1, 0, 0, 0, 1, 1]",302,196,106,21,10,0.10714285714285714,0.09433962264150944
"[1, 1, 1, 0, 0, 1, 0, 0, 0, 1, 0, 1, 1, 0, 0]",138,76,62,7,5,0.09210526315789473,0.08064516129032258
"[1, 0, 0, 1, 1, 1, 1, 1, 0, 0, 1, 0, 0, 0, 1]",138,48,90,7,5,0.14583333333333334,0.05555555555555555
"[0, 1, 0, 1, 0, 0, 1, 1, 1, 1, 1, 0, 0, 1, 0]",102,45,57,0,7,0.0,0.12280701754385964
"[1, 1, 1, 1, 1, 1, 0, 1, 0, 0, 1, 1, 0, 1, 0]",237,92,145,14,14,0.15217391304347827,0.09655172413793103
"[0, 1, 1, 1, 1, 1, 1, 0, 1, 0, 0, 1, 1, 0, 1]",286,103,183,6,17,0.05825242718446602,0.09289617486338798
"[1, 0, 1, 0, 0, 1, 0, 0, 1, 0, 0, 1, 1, 0, 0]",177,98,79,13,5,0.1326530612244898,0.06329113924050633
"[0, 1, 1, 0, 1, 0, 0, 1, 0, 0, 1, 0, 0, 1, 1]",142,74,68,9,5,0.12162162162162163,0.07352941176470588
"[1, 1, 0, 0, 1, 1, 0, 0, 0, 1, 1, 1, 1, 1, 1]",645,223,422,23,49,0.1031390134529148,0.11611374407582939
"[0, 0, 1, 0, 0, 0, 0, 1, 1, 1, 0, 1, 1, 0, 0]",156,105,51,18,5,0.17142857142857143,0.09803921568627451
"[1, 0, 1, 1, 1, 0, 1, 1, 1, 0, 1, 1, 0, 0, 1]",263,99,164,7,24,0.0707070707070707,0.14634146341463414
"[1, 0, 0, 0, 1, 1, 0, 1, 0, 1, 0, 0, 0, 0, 1]",179,112,67,5,3,0.044642857142857144,0.04477611940298507
"[1, 0, 0, 1, 0, 1, 1, 0, 1, 0, 0, 1, 1, 1, 1]",188,81,107,9,12,0.1111111111111111,0.11214953271028037
"[0, 1, 0, 0, 1, 0, 1, 1, 0, 1, 0, 0, 1, 1, 1]",140,64,76,5,7,0.078125,0.09210526315789473
"[0, 1, 0, 1, 0, 1, 0, 0, 1, 0, 0, 1, 0, 1, 1]",110,55,55,3,6,0.05454545454545454,0.10909090909090909
"[0, 0, 1, 1, 0, 0, 0, 1, 1, 0, 1, 1, 1, 0, 1]",121,59,62,2,7,0.03389830508474576,0.11290322580645161
"[1, 1, 0, 0, 1, 1, 0, 0, 1, 1, 1, 1, 0, 1, 1]",840,295,545,35,44,0.11864406779661017,0.08073394495412844
"[1, 0, 0, 0, 1, 0, 1, 0, 0, 1, 1, 0, 1, 1, 1]",132,44,88,5,11,0.11363636363636363,0.125
"[0, 1, 1, 1, 0, 1, 0, 1, 0, 0, 1, 1, 1, 1, 1]",324,132,192,12,25,0.09090909090909091,0.13020833333333334
"[0, 0, 0, 0, 1, 1, 0, 1, 1, 1, 1, 1, 1, 0, 0]",264,126,138,14,14,0.1111111111111111,0.10144927536231885
"[0, 0, 1, 1, 0, 0, 1, 0, 1, 1, 0, 1, 0, 1, 0]",114,59,55,2,3,0.03389830508474576,0.05454545454545454
"[1, 0, 0, 0, 1, 1, 1, 0, 0, 0, 0, 1, 1, 0, 0]",350,197,153,26,18,0.1319796954314721,0.11764705882352941
"[0, 0, 1, 0, 0, 0, 0, 1, 0, 0, 0, 1, 1, 0, 0]",691,515,176,48,14,0.09320388349514563,0.07954545454545454
"[1, 1, 0, 0, 1, 0, 0, 0, 1, 0, 1, 1, 1, 1, 0]",125,56,69,2,5,0.03571428571428571,0.07246376811594203
"[1, 1, 0, 0, 1, 1, 0, 1, 0, 1, 1, 0, 1, 0, 0]",128,63,65,6,5,0.09523809523809523,0.07692307692307693
"[0, 0, 1, 0, 0, 1, 1, 0, 0, 1, 0, 0, 0, 0, 1]",276,184,92,20,13,0.10869565217391304,0.14130434782608695
"[0, 0, 0, 1, 1, 1, 1, 0, 0, 1, 1, 1, 1, 0, 1]",456,303,153,32,15,0.10561056105610561,0.09803921568627451
"[1, 0, 1, 1, 1, 1, 0, 1, 0, 0, 1, 0, 0, 0, 0]",138,75,63,6,6,0.08,0.09523809523809523
"[0, 1, 1, 0, 0, 0, 0, 0, 1, 1, 1, 0, 0, 0, 0]",386,254,132,21,11,0.08267716535433071,0.08333333333333333
"[0, 0, 0, 0, 1, 0, 0, 1, 0, 0, 1, 1, 1, 1, 0]",223,144,79,12,7,0.08333333333333333,0.08860759493670886
"[0, 0, 0, 1, 1, 0, 0, 0, 0, 1, 0, 0, 1, 0, 0]",685,523,162,58,16,0.11089866156787763,0.09876543209876543
"[0, 1, 0, 0, 1, 1, 1, 1, 1, 1, 1, 1, 1, 0, 0]",541,221,320,23,28,0.10407239819004525,0.0875
"[1, 1, 0, 1, 0, 0, 1, 1, 1, 0, 1, 1, 1, 0, 1]",209,69,140,9,13,0.13043478260869565,0.09285714285714286
"[0, 0, 0, 1, 1, 1, 1, 0, 1, 0, 0, 1, 0, 0, 1]",141,84,57,6,7,0.07142857142857142,0.12280701754385964
"[1, 1, 1, 0, 1, 1, 1, 0, 0, 0, 1, 1, 1, 1, 0]",303,128,175,15,15,0.1171875,0.08571428571428572
"[1, 1, 1, 0, 0, 1, 0, 1, 0, 1, 1, 0, 0, 0, 1]",135,63,72,9,7,0.14285714285714285,0.09722222222222222
"[1, 0, 1, 1, 0, 0, 1, 0, 0, 1, 0, 0, 0, 0, 0]",264,160,104,14,10,0.0875,0.09615384615384616
"[0, 1, 0, 1, 0, 0, 1, 0, 0, 1, 1, 0, 1, 1, 1]",104,54,50,4,8,0.07407407407407407,0.16
"[0, 1, 1, 1, 1, 1, 1, 1, 1, 1, 0, 0, 0, 1, 0]",322,159,163,12,11,0.07547169811320754,0.06748466257668712
"[0, 1, 0, 0, 1, 0, 1, 1, 0, 0, 0, 1, 0, 0, 0]",258,167,91,17,8,0.10179640718562874,0.08791208791208792
"[1, 0, 1, 0, 0, 1, 1, 0, 0, 1, 1, 1, 1, 0, 0]",396,193,203,28,16,0.14507772020725387,0.07881773399014778
"[1, 0, 0, 0, 1, 1, 0, 0, 0, 0, 0, 1, 0, 1, 0]",233,147,86,19,7,0.1292517006802721,0.08139534883720931
"[1, 1, 0, 1, 1, 0, 0, 0, 1, 1, 0, 0, 0, 0, 0]",252,125,127,14,15,0.112,0.11811023622047244
"[1, 0, 1, 1, 0, 1, 1, 0, 0, 1, 0, 1, 0, 0, 0]",109,61,48,10,7,0.16393442622950818,0.14583333333333334
"[1, 0, 1, 0, 1, 1, 1, 1, 0, 1, 1, 0, 1, 1, 1]",566,189,377,16,32,0.08465608465608465,0.08488063660477453
"[0, 1, 0, 0, 1, 0, 1, 1, 1, 1, 1, 1, 1, 0, 1]",233,95,138,11,21,0.11578947368421053,0.15217391304347827
"[1, 1, 1, 1, 1, 0, 1, 1, 1, 1, 1, 0, 0, 1, 0]",539,152,387,13,40,0.08552631578947369,0.10335917312661498
"[0, 1, 1, 0, 0, 0, 0, 0, 1, 1, 0, 0, 0, 0, 0]",1178,858,320,70,30,0.08158508158508158,0.09375
"[0, 1, 1, 1, 0, 0, 1, 0, 1, 0, 1, 1, 1, 1, 0]",169,78,91,8,10,0.10256410256410256,0.10989010989010989
"[0, 0, 1, 0, 1, 1, 1, 1, 1, 1, 1, 0, 0, 1, 0]",192,75,117,8,15,0.10666666666666667,0.1282051282051282
"[0, 1, 0, 1, 1, 0, 0, 1, 0, 0, 0, 1, 1, 1, 0]",112,65,47,14,9,0.2153846153846154,0.19148936170212766
"[0, 0, 1, 0, 0, 1, 0, 1, 0, 0, 0, 0, 1, 0, 0]",484,343,141,35,13,0.10204081632653061,0.09219858156028368
"[0, 1, 0, 0, 1, 0, 0, 0, 0, 1, 1, 0, 1, 0, 0]",257,143,114,16,7,0.11188811188811189,0.06140350877192982
"[1, 0, 1, 0, 1, 1, 0, 0, 1, 1, 1, 1, 0, 1, 0]",149,60,89,6,9,0.1,0.10112359550561797
"[1, 1, 0, 0, 1, 0, 0, 1, 1, 0, 1, 1, 1, 1, 1]",302,113,189,12,18,0.10619469026548672,0.09523809523809523
"[0, 1, 1, 0, 0, 1, 0, 0, 1, 1, 0, 1, 1, 1, 1]",194,107,87,11,11,0.102803738317757,0.12643678160919541
"[1, 1, 0, 0, 1, 0, 0, 0, 0, 0, 0, 0, 1, 0, 1]",273,166,107,13,6,0.0783132530120482,0.056074766355140186
"[1, 0, 1, 0, 0, 0, 1, 1, 1, 1, 0, 0, 0, 0, 0]",338,190,148,15,14,0.07894736842105263,0.0945945945945946
"[0, 0, 1, 0, 1, 0, 0, 0, 1, 1, 1, 1, 0, 0, 0]",258,156,102,20,7,0.1282051282051282,0.06862745098039216
"[0, 0, 1, 0, 1, 1, 0, 1, 1, 0, 1, 0, 0, 0, 0]",171,93,78,5,6,0.053763440860215055,0.07692307692307693
"[1, 0, 0, 0, 1, 1, 0, 1, 1, 1, 1, 1, 0, 0, 0]",151,65,86,6,7,0.09230769230769231,0.08139534883720931
"[1, 0, 1, 0, 0, 1, 0, 0, 1, 0, 1, 1, 1, 1, 0]",116,46,70,6,14,0.13043478260869565,0.2
"[1, 1, 0, 0, 1, 1, 0, 1, 1, 1, 1, 0, 1, 1, 1]",697,227,470,25,49,0.11013215859030837,0.10425531914893617
"[1, 0, 0, 1, 1, 1, 1, 0, 0, 1, 1, 0, 1, 1, 1]",717,138,579,15,51,0.10869565217391304,0.08808290155440414
"[1, 0, 1, 1, 0, 1, 1, 0, 0, 0, 0, 1, 1, 1, 0]",120,62,58,2,8,0.03225806451612903,0.13793103448275862
"[1, 1, 1, 1, 0, 0, 1, 0, 0, 1, 1, 1, 1, 1, 1]",1021,293,728,28,72,0.09556313993174062,0.0989010989010989
"[1, 1, 1, 1, 0, 1, 0, 0, 0, 1, 0, 1, 1, 1, 1]",302,117,185,15,14,0.1282051282051282,0.07567567567567568
"[0, 1, 1, 0, 1, 1, 0, 1, 0, 1, 1, 1, 0, 1, 0]",116,43,73,4,7,0.09302325581395349,0.0958904109589041
"[0, 0, 1, 0, 1, 0, 0, 0, 0, 1, 1, 1, 1, 1, 1]",323,171,152,16,15,0.0935672514619883,0.09868421052631579
"[1, 1, 0, 1, 0, 1, 0, 0, 0, 1, 0, 0, 0, 1, 0]",146,84,62,12,6,0.14285714285714285,0.0967741935483871
"[0, 1, 1, 0, 1, 0, 1, 0, 0, 0, 1, 0, 0, 0, 1]",149,96,53,15,2,0.15625,0.03773584905660377
"[1, 0, 0, 0, 0, 0, 0, 0, 0, 1, 0, 1, 0, 1, 1]",388,190,198,17,19,0.08947368421052632,0.09595959595959595
"[0, 0, 0, 1, 0, 0, 0, 0, 0, 0, 1, 1, 1, 1, 1]",554,353,201,37,24,0.1048158640226629,0.11940298507462686
"[0, 0, 1, 1, 0, 1, 0, 0, 0, 1, 1, 1, 1, 1, 0]",131,70,61,12,8,0.17142857142857143,0.13114754098360656
"[1, 0, 1, 0, 1, 1, 1, 1, 0, 0, 1, 1, 0, 1, 0]",132,56,76,4,6,0.07142857142857142,0.07894736842105263
"[0, 0, 0, 1, 1, 1, 1, 0, 0, 1, 1, 0, 1, 0, 0]",240,173,67,24,8,0.13872832369942195,0.11940298507462686
"[0, 0, 1, 1, 1, 1, 1, 0, 0, 0, 0, 0, 0, 1, 1]",565,282,283,24,18,0.0851063829787234,0.0636042402826855
"[0, 0, 0, 0, 1, 0, 0, 1, 1, 0, 0, 0, 0, 1, 0]",594,428,166,43,16,0.10046728971962617,0.0963855421686747
"[1, 0, 0, 0, 1, 0, 1, 1, 1, 0, 0, 0, 0, 1, 1]",206,96,110,11,15,0.11458333333333333,0.13636363636363635
"[1, 1, 0, 0, 1, 0, 0, 1, 0, 0, 1, 0, 0, 0, 0]",270,161,109,15,9,0.09316770186335403,0.08256880733944955
"[0, 1, 1, 1, 1, 0, 0, 0, 1, 0, 1, 0, 1, 1, 0]",130,67,63,9,10,0.13432835820895522,0.15873015873015872
"[0, 0, 0, 0, 1, 1, 1, 1, 0, 0, 0, 1, 0, 1, 0]",263,158,105,19,7,0.12025316455696203,0.06666666666666667
"[1, 1, 1, 0, 0, 1, 0, 0, 0, 0, 0, 0, 0, 0, 0]",970,608,362,56,30,0.09210526315789473,0.08287292817679558
"[0, 0, 1, 0, 1, 1, 1, 1, 0, 0, 0, 0, 0, 1, 1]",185,118,67,14,5,0.11864406779661017,0.07462686567164178
"[0, 1, 0, 0, 0, 0, 1, 1, 0, 0, 1, 0, 1, 1, 1]",184,105,79,12,7,0.11428571428571428,0.08860759493670886
"[1, 1, 0, 0, 1, 0, 1, 0, 0, 0, 1, 1, 1, 1, 1]",273,107,166,11,19,0.102803738317757,0.1144578313253012
"[1, 0, 1, 1, 1, 1, 1, 0, 0, 1, 0, 1, 0, 0, 0]",119,62,57,3,5,0.04838709677419355,0.08771929824561403
"[1, 1, 1, 1, 0, 0, 0, 0, 1, 1, 1, 0, 1, 1, 1]",704,254,450,31,40,0.1220472440944882,0.08888888888888889
"[1, 1, 1, 1, 1, 0, 0, 0, 0, 1, 1, 1, 0, 1, 1]",603,115,488,15,43,0.13043478260869565,0.08811475409836066
"[0, 1, 1, 0, 1, 0, 0, 1, 1, 1, 0, 0, 1, 1, 1]",201,86,115,10,9,0.11627906976744186,0.0782608695652174
"[1, 0, 0, 0, 1, 1, 1, 0, 1, 0, 1, 1, 0, 1, 1]",147,50,97,3,11,0.06,0.1134020618556701
"[0, 1, 0, 0, 1, 1, 0, 0, 1, 0, 0, 0, 1, 0, 0]",247,159,88,13,5,0.08176100628930817,0.056818181818181816
"[1, 1, 1, 0, 1, 1, 1, 1, 0, 0, 1, 1, 0, 1, 1]",626,184,442,13,45,0.07065217391304347,0.10180995475113122
"[1, 1, 1, 1, 1, 1, 1, 0, 0, 0, 1, 1, 0, 1, 1]",864,187,677,26,61,0.13903743315508021,0.09010339734121123
"[1, 0, 0, 1, 0, 1, 0, 0, 1, 1, 1, 1, 1, 1, 1]",410,143,267,17,28,0.11888111888111888,0.10486891385767791
"[0, 0, 1, 1, 1, 0, 0, 0, 1, 1, 1, 1, 1, 1, 1]",578,266,312,30,36,0.11278195488721804,0.11538461538461539
"[0, 1, 0, 0, 0, 1, 1, 0, 1, 1, 0, 0, 0, 0, 1]",191,107,84,4,6,0.037383177570093455,0.07142857142857142
"[1, 0, 1, 0, 1, 1, 1, 0, 0, 0, 0, 1, 0, 1, 0]",118,61,57,7,6,0.11475409836065574,0.10526315789473684
"[0, 0, 0, 0, 1, 0, 1, 1, 1, 1, 0, 0, 1, 1, 0]",255,142,113,19,11,0.13380281690140844,0.09734513274336283
"[0, 1, 0, 1, 0, 0, 1, 0, 1, 1, 0, 1, 1, 0, 0]",115,61,54,9,6,0.14754098360655737,0.1111111111111111
"[0, 1, 1, 1, 0, 0, 1, 0, 0, 1, 0, 1, 0, 0, 1]",106,69,37,7,5,0.10144927536231885,0.13513513513513514
"[1, 1, 1, 1, 0, 1, 0, 0, 1, 1, 1, 1, 1, 1, 0]",747,235,512,15,53,0.06382978723404255,0.103515625
"[1, 1, 1, 1, 1, 1, 0, 1, 0, 0, 0, 0, 0, 1, 1]",297,114,183,11,27,0.09649122807017543,0.14754098360655737
"[1, 0, 1, 0, 0, 0, 1, 1, 1, 1, 1, 1, 1, 0, 1]",266,92,174,10,16,0.10869565217391304,0.09195402298850575
"[0, 0, 1, 1, 1, 1, 0, 1, 1, 0, 0, 0, 0, 0, 0]",329,191,138,28,15,0.14659685863874344,0.10869565217391304
"[0, 0, 0, 1, 1, 1, 1, 1, 1, 0, 0, 0, 1, 0, 0]",271,198,73,14,8,0.0707070707070707,0.1095890410958904
"[0, 0, 1, 1, 0, 1, 1, 0, 0, 1, 1, 1, 1, 1, 1]",581,241,340,26,25,0.1078838174273859,0.07352941176470588
"[1, 1, 1, 0, 0, 1, 1, 1, 1, 1, 1, 0, 0, 0, 1]",662,154,508,20,37,0.12987012987012986,0.07283464566929133
"[0, 0, 0, 1, 1, 1, 1, 0, 0, 0, 0, 1, 1, 1, 1]",1808,1463,345,147,36,0.10047846889952153,0.10434782608695652
"[1, 0, 0, 0, 1, 1, 0, 1, 1, 1, 0, 1, 1, 1, 0]",124,48,76,4,8,0.08333333333333333,0.10526315789473684
"[0, 1, 0, 1, 1, 1, 1, 1, 0, 0, 1, 1, 0, 0, 0]",292,137,155,10,13,0.072992700729927,0.08387096774193549
"[1, 1, 1, 0, 1, 0, 1, 1, 1, 1, 1, 0, 0, 1, 1]",818,203,615,23,55,0.11330049261083744,0.08943089430894309
"[1, 0, 0, 0, 0, 1, 1, 0, 0, 0, 1, 0, 0, 0, 1]",349,179,170,9,16,0.05027932960893855,0.09411764705882353
"[0, 1, 0, 1, 0, 1, 1, 1, 0, 0, 1, 1, 0, 1, 0]",107,55,52,6,4,0.10909090909090909,0.07692307692307693
"[1, 1, 0, 1, 0, 1, 0, 0, 1, 1, 1, 1, 1, 0, 1]",228,75,153,9,15,0.12,0.09803921568627451
"[0, 1, 1, 1, 1, 1, 0, 1, 0, 1, 0, 0, 1, 1, 1]",293,116,177,10,16,0.08620689655172414,0.0903954802259887
"[0, 1, 0, 0, 1, 0, 1, 1, 1, 0, 0, 0, 1, 1, 1]",145,78,67,7,5,0.08974358974358974,0.07462686567164178
"[0, 1, 1, 1, 1, 1, 0, 0, 1, 0, 1, 0, 0, 1, 0]",118,61,57,4,6,0.06557377049180328,0.10526315789473684
"[0, 1, 1, 0, 0, 1, 0, 0, 1, 0, 1, 0, 1, 1, 1]",149,77,72,15,6,0.19480519480519481,0.08333333333333333
"[1, 1, 0, 0, 1, 0, 1, 1, 0, 0, 1, 0, 1, 0, 1]",111,46,65,7,11,0.15217391304347827,0.16923076923076924
"[0, 1, 1, 0, 0, 1, 0, 0, 1, 1, 1, 1, 1, 0, 0]",163,84,79,6,9,0.07142857142857142,0.11392405063291139
"[0, 0, 1, 1, 0, 1, 0, 0, 1, 0, 1, 0, 1, 0, 0]",126,78,48,7,5,0.08974358974358974,0.10416666666666667
"[0, 0, 1, 0, 0, 0, 1, 1, 0, 1, 0, 0, 1, 0, 1]",120,70,50,3,4,0.04285714285714286,0.08
"[0, 1, 0, 0, 0, 0, 0, 1, 0, 0, 0, 1, 1, 0, 1]",215,135,80,14,13,0.1037037037037037,0.1625
"[0, 0, 0, 0, 0, 0, 1, 0, 0, 1, 0, 1, 0, 0, 0]",1655,1284,371,113,39,0.08800623052959501,0.10512129380053908
"[1, 1, 1, 1, 1, 1, 0, 1, 0, 0, 1, 0, 0, 0, 0]",142,64,78,4,10,0.0625,0.1282051282051282
"[0, 1, 0, 0, 0, 1, 1, 0, 1, 0, 1, 0, 0, 1, 1]",147,81,66,7,7,0.08641975308641975,0.10606060606060606
"[0, 0, 0, 0, 1, 0, 0, 0, 1, 1, 0, 1, 0, 1, 0]",240,159,81,11,12,0.06918238993710692,0.14814814814814814
"[0, 0, 0, 1, 1, 0, 1, 1, 1, 0, 0, 1, 1, 1, 0]",143,77,66,10,10,0.12987012987012986,0.15151515151515152
"[0, 1, 0, 0, 0, 1, 1, 0, 1, 1, 1, 0, 0, 1, 1]",134,68,66,6,4,0.08823529411764706,0.06060606060606061
"[1, 0, 0, 0, 1, 1, 0, 0, 0, 1, 1, 0, 0, 1, 0]",148,90,58,13,6,0.14444444444444443,0.10344827586206896
"[1, 1, 1, 1, 0, 1, 0, 0, 0, 1, 0, 0, 1, 0, 0]",97,56,41,7,4,0.125,0.0975609756097561
"[1, 0, 1, 0, 0, 1, 1, 0, 1, 1, 0, 1, 0, 0, 0]",115,64,51,8,7,0.125,0.13725490196078433
"[0, 1, 1, 0, 0, 1, 0, 1, 0, 1, 0, 0, 0, 0, 1]",167,93,74,8,7,0.08602150537634409,0.0945945945945946
"[0, 0, 1, 1, 0, 0, 1, 0, 1, 0, 1, 0, 0, 0, 0]",301,192,109,17,10,0.08854166666666667,0.09174311926605505
"[0, 1, 0, 1, 0, 0, 0, 1, 1, 0, 0, 0, 0, 1, 0]",240,144,96,13,3,0.09027777777777778,0.03125
"[0, 0, 1, 0, 0, 1, 0, 0, 1, 0, 0, 0, 0, 1, 1]",306,205,101,24,19,0.11707317073170732,0.18811881188118812
"[1, 0, 0, 1, 0, 1, 1, 1, 0, 1, 0, 1, 1, 0, 1]",138,51,87,7,5,0.13725490196078433,0.05747126436781609
"[0, 0, 0, 1, 1, 0, 1, 0, 0, 0, 0, 1, 0, 0, 1]",243,168,75,17,5,0.10119047619047619,0.06666666666666667
"[1, 0, 1, 1, 0, 1, 0, 1, 0, 0, 1, 1, 0, 1, 1]",165,59,106,5,12,0.0847457627118644,0.11320754716981132
"[0, 1, 0, 0, 1, 1, 1, 1, 0, 1, 1, 0, 1, 0, 1]",138,62,76,5,7,0.08064516129032258,0.09210526315789473
"[0, 1, 1, 1, 1, 1, 0, 0, 1, 1, 0, 0, 0, 0, 0]",442,241,201,21,20,0.08713692946058091,0.09950248756218906
"[1, 1, 1, 0, 1, 1, 1, 1, 1, 0, 0, 1, 1, 0, 0]",632,193,439,19,29,0.09844559585492228,0.06605922551252848
"[1, 0, 0, 0, 1, 0, 1, 1, 0, 1, 1, 0, 0, 1, 1]",146,72,74,5,8,0.06944444444444445,0.10810810810810811
"[0, 0, 1, 1, 0, 1, 0, 0, 0, 0, 0, 0, 0, 1, 0]",525,358,167,33,17,0.09217877094972067,0.10179640718562874
"[1, 1, 0, 1, 1, 0, 0, 1, 0, 1, 1, 1, 1, 1, 0]",255,100,155,6,22,0.06,0.14193548387096774
"[0, 1, 1, 1, 1, 1, 1, 0, 1, 0, 0, 0, 0, 1, 1]",229,118,111,11,7,0.09322033898305085,0.06306306306306306
"[0, 0, 1, 0, 0, 1, 1, 1, 0, 0, 1, 1, 0, 0, 0]",276,173,103,21,8,0.12138728323699421,0.07766990291262135
"[1, 0, 0, 1, 1, 1, 0, 0, 0, 1, 0, 1, 0, 0, 0]",155,87,68,9,3,0.10344827586206896,0.04411764705882353
"[0, 1, 1, 0, 1, 1, 0, 1, 0, 1, 0, 1, 0, 1, 0]",95,39,56,4,4,0.10256410256410256,0.07142857142857142
"[1, 0, 1, 0, 1, 1, 0, 1, 1, 0, 1, 0, 1, 0, 1]",120,39,81,4,7,0.10256410256410256,0.08641975308641975
"[1, 0, 1, 1, 0, 1, 0, 1, 1, 0, 1, 1, 0, 1, 0]",110,50,60,7,5,0.14,0.08333333333333333
"[1, 1, 0, 0, 0, 1, 1, 1, 0, 0, 1, 1, 0, 1, 1]",183,74,109,4,11,0.05405405405405406,0.10091743119266056
"[1, 1, 1, 0, 0, 0, 1, 1, 1, 0, 0, 1, 1, 0, 1]",162,62,100,4,9,0.06451612903225806,0.09
"[0, 1, 0, 0, 0, 1, 1, 0, 1, 1, 0, 0, 1, 1, 0]",159,84,75,6,10,0.07142857142857142,0.13333333333333333
"[0, 0, 0, 1, 0, 0, 0, 1, 1, 0, 1, 1, 0, 0, 1]",190,120,70,13,6,0.10833333333333334,0.08571428571428572
"[0, 1, 0, 1, 1, 1, 0, 1, 1, 0, 0, 1, 0, 1, 1]",156,70,86,6,7,0.08571428571428572,0.08139534883720931
"[0, 1, 0, 0, 1, 1, 0, 0, 0, 0, 0, 1, 0, 1, 1]",193,103,90,11,9,0.10679611650485436,0.1
"[0, 0, 0, 0, 1, 0, 1, 1, 0, 0, 0, 1, 1, 0, 0]",298,193,105,11,12,0.05699481865284974,0.11428571428571428
"[1, 1, 0, 0, 0, 0, 1, 0, 1, 1, 0, 0, 0, 1, 1]",170,85,85,4,9,0.047058823529411764,0.10588235294117647
"[0, 0, 0, 1, 0, 0, 0, 1, 1, 1, 0, 1, 0, 0, 1]",120,72,48,7,4,0.09722222222222222,0.08333333333333333
"[0, 1, 1, 1, 0, 0, 1, 0, 1, 1, 1, 0, 0, 1, 1]",214,95,119,5,5,0.05263157894736842,0.04201680672268908
"[1, 0, 1, 0, 0, 0, 1, 0, 0, 0, 0, 0, 1, 0, 1]",240,160,80,16,4,0.1,0.05
"[0, 0, 1, 1, 1, 1, 0, 1, 0, 0, 1, 0, 0, 0, 0]",219,135,84,13,4,0.0962962962962963,0.047619047619047616
"[1, 0, 1, 0, 0, 1, 0, 1, 0, 1, 1, 0, 1, 0, 1]",100,45,55,6,3,0.13333333333333333,0.05454545454545454
"[0, 1, 1, 1, 0, 0, 1, 1, 1, 0, 0, 0, 1, 1, 1]",220,95,125,4,13,0.042105263157894736,0.104
"[0, 0, 1, 0, 1, 0, 0, 1, 1, 1, 0, 0, 1, 1, 1]",185,89,96,11,14,0.12359550561797752,0.14583333333333334
"[1, 0, 0, 0, 1, 0, 1, 0, 0, 1, 1, 1, 0, 0, 1]",132,65,67,7,6,0.1076923076923077,0.08955223880597014
"[1, 0, 1, 1, 1, 1, 0, 0, 1, 1, 0, 1, 0, 0, 1]",152,58,94,2,8,0.034482758620689655,0.0851063829787234
"[1, 0, 0, 1, 0, 0, 1, 0, 1, 1, 1, 0, 0, 0, 1]",112,57,55,6,6,0.10526315789473684,0.10909090909090909
"[0, 1, 1, 0, 1, 1, 0, 1, 1, 1, 0, 0, 1, 1, 0]",155,78,77,14,5,0.1794871794871795,0.06493506493506493
"[0, 1, 0, 0, 0, 1, 1, 0, 0, 1, 1, 0, 1, 1, 0]",138,65,73,4,3,0.06153846153846154,0.0410958904109589
"[0, 0, 0, 0, 0, 0, 1, 0, 1, 0, 1, 0, 0, 0, 1]",583,426,157,37,11,0.08685446009389672,0.07006369426751592
"[0, 1, 1, 0, 1, 1, 0, 1, 0, 1, 1, 0, 1, 1, 1]",247,99,148,11,19,0.1111111111111111,0.12837837837837837
"[1, 1, 0, 1, 0, 1, 1, 0, 1, 1, 0, 1, 0, 1, 1]",228,82,146,2,11,0.024390243902439025,0.07534246575342465
"[0, 1, 0, 0, 1, 1, 0, 1, 1, 1, 0, 1, 1, 1, 1]",271,96,175,6,17,0.0625,0.09714285714285714
"[1, 1, 0, 0, 1, 0, 1, 0, 0, 1, 1, 0, 0, 0, 1]",121,59,62,4,9,0.06779661016949153,0.14516129032258066
"[1, 1, 1, 1, 1, 1, 0, 0, 0, 1, 1, 0, 0, 1, 0]",189,82,107,7,13,0.08536585365853659,0.12149532710280374
"[1, 0, 1, 1, 0, 0, 1, 1, 1, 1, 1, 1, 0, 1, 1]",615,174,441,21,34,0.1206896551724138,0.07709750566893424
"[1, 0, 0, 1, 1, 1, 1, 1, 1, 1, 1, 0, 1, 1, 0]",848,195,653,15,59,0.07692307692307693,0.0903522205206738
"[1, 0, 1, 1, 0, 1, 0, 1, 0, 0, 1, 0, 1, 0, 1]",102,43,59,4,7,0.09302325581395349,0.11864406779661017
"[0, 1, 0, 1, 1, 0, 1, 0, 1, 0, 0, 1, 0, 1, 0]",85,48,37,3,3,0.0625,0.08108108108108109
"[1, 0, 1, 0, 1, 1, 0, 1, 0, 1, 0, 0, 1, 0, 1]",86,31,55,4,4,0.12903225806451613,0.07272727272727272
"[0, 1, 0, 0, 1, 0, 1, 1, 1, 1, 0, 0, 1, 1, 0]",176,84,92,8,16,0.09523809523809523,0.17391304347826086
"[1, 1, 1, 1, 0, 1, 0, 1, 0, 0, 1, 1, 0, 0, 1]",203,66,137,6,14,0.09090909090909091,0.10218978102189781
"[0, 1, 1, 0, 1, 1, 0, 0, 0, 1, 0, 0, 0, 1, 0]",146,92,54,13,4,0.14130434782608695,0.07407407407407407
"[0, 0, 0, 0, 0, 0, 1, 0, 0, 0, 1, 1, 0, 1, 1]",371,236,135,20,13,0.0847457627118644,0.0962962962962963
"[1, 1, 0, 0, 0, 0, 0, 1, 0, 0, 1, 0, 0, 1, 0]",237,147,90,20,9,0.1360544217687075,0.1
"[0, 1, 1, 0, 1, 0, 1, 1, 1, 0, 1, 1, 0, 1, 1]",247,90,157,5,14,0.05555555555555555,0.08917197452229299
"[0, 1, 0, 1, 0, 0, 1, 0, 0, 0, 0, 0, 0, 1, 0]",487,332,155,31,15,0.09337349397590361,0.0967741935483871
"[1, 1, 0, 0, 0, 0, 1, 0, 0, 1, 0, 1, 1, 1, 0]",134,74,60,6,4,0.08108108108108109,0.06666666666666667
"[1, 1, 0, 1, 0, 0, 0, 1, 1, 0, 1, 1, 1, 1, 1]",314,114,200,13,15,0.11403508771929824,0.075
"[0, 1, 0, 1, 1, 0, 1, 1, 0, 1, 0, 1, 1, 0, 0]",104,49,55,4,3,0.08163265306122448,0.05454545454545454
"[1, 1, 1, 0, 0, 1, 0, 0, 1, 0, 0, 0, 1, 0, 1]",132,65,67,7,5,0.1076923076923077,0.07462686567164178
"[0, 1, 1, 0, 1, 0, 1, 1, 1, 1, 0, 1, 0, 1, 1]",262,102,160,15,11,0.14705882352941177,0.06875
"[0, 0, 0, 0, 0, 0, 0, 0, 1, 1, 1, 1, 1, 0, 0]",812,545,267,58,27,0.10642201834862386,0.10112359550561797
"[1, 0, 1, 1, 0, 0, 1, 0, 1, 1, 1, 1, 1, 1, 1]",682,218,464,23,42,0.10550458715596331,0.09051724137931035
"[1, 0, 0, 0, 0, 1, 1, 1, 0, 1, 0, 1, 1, 1, 0]",121,48,73,6,11,0.125,0.1506849315068493
"[0, 0, 1, 0, 1, 0, 0, 0, 0, 1, 0, 1, 1, 1, 0]",167,104,63,8,9,0.07692307692307693,0.14285714285714285
"[0, 0, 1, 0, 1, 1, 1, 0, 1, 0, 0, 1, 1, 0, 0]",128,74,54,9,5,0.12162162162162163,0.09259259259259259
"[0, 1, 1, 0, 0, 0, 1, 1, 1, 1, 0, 0, 0, 0, 0]",412,252,160,26,12,0.10317460317460317,0.075
"[0, 1, 0, 1, 1, 1, 1, 0, 0, 0, 1, 1, 1, 0, 0]",140,60,80,5,8,0.08333333333333333,0.1
"[0, 0, 1, 0, 0, 1, 0, 0, 0, 0, 0, 1, 0, 1, 0]",512,359,153,43,11,0.11977715877437325,0.0718954248366013
"[0, 1, 0, 0, 1, 1, 0, 1, 0, 0, 0, 0, 1, 0, 1]",133,79,54,7,4,0.08860759493670886,0.07407407407407407
"[1, 1, 1, 1, 1, 1, 1, 0, 0, 0, 1, 1, 1, 0, 0]",438,117,321,14,49,0.11965811965811966,0.1526479750778816
"[0, 0, 0, 1, 0, 0, 0, 1, 0, 1, 1, 0, 1, 0, 1]",140,89,51,8,4,0.0898876404494382,0.0784313725490196
"[1, 0, 0, 1, 1, 1, 1, 1, 0, 0, 0, 0, 1, 0, 1]",137,61,76,5,4,0.08196721311475409,0.05263157894736842
"[0, 1, 0, 1, 1, 0, 1, 0, 1, 1, 1, 1, 1, 1, 1]",709,205,504,21,53,0.1024390243902439,0.10515873015873016
"[1, 0, 1, 0, 1, 1, 0, 1, 0, 1, 1, 1, 1, 1, 1]",664,198,466,23,43,0.11616161616161616,0.09227467811158799
"[0, 0, 1, 0, 1, 0, 1, 1, 0, 1, 0, 1, 0, 1, 1]",127,49,78,5,5,0.10204081632653061,0.0641025641025641
"[0, 0, 0, 0, 0, 0, 1, 0, 1, 0, 1, 1, 0, 1, 1]",204,135,69,16,10,0.11851851851851852,0.14492753623188406
"[0, 1, 1, 1, 1, 0, 0, 1, 0, 0, 1, 0, 1, 1, 1]",214,109,105,11,10,0.10091743119266056,0.09523809523809523
"[0, 0, 0, 0, 1, 1, 1, 1, 0, 0, 1, 0, 0, 1, 0]",284,181,103,17,8,0.09392265193370165,0.07766990291262135
"[1, 1, 1, 0, 0, 0, 0, 1, 1, 0, 1, 0, 1, 0, 1]",187,68,119,3,14,0.04411764705882353,0.11764705882352941
"[0, 1, 0, 1, 0, 1, 0, 1, 0, 0, 1, 1, 1, 0, 0]",115,61,54,8,6,0.13114754098360656,0.1111111111111111
"[1, 1, 0, 0, 1, 0, 0, 1, 0, 1, 0, 1, 0, 1, 0]",91,43,48,1,6,0.023255813953488372,0.125
"[0, 1, 0, 0, 1, 1, 1, 1, 0, 1, 1, 1, 0, 0, 1]",162,67,95,4,7,0.05970149253731343,0.07368421052631578
"[1, 0, 0, 0, 1, 0, 0, 1, 1, 1, 1, 0, 1, 1, 1]",188,84,104,8,17,0.09523809523809523,0.16346153846153846
"[0, 1, 0, 1, 1, 0, 1, 1, 1, 0, 0, 1, 1, 1, 1]",353,150,203,13,20,0.08666666666666667,0.09852216748768473
"[0, 1, 1, 0, 0, 0, 0, 1, 0, 1, 1, 1, 0, 0, 0]",179,114,65,14,6,0.12280701754385964,0.09230769230769231
"[1, 0, 0, 0, 0, 0, 0, 1, 1, 1, 0, 1, 0, 1, 1]",233,77,156,9,17,0.11688311688311688,0.10897435897435898
"[1, 1, 0, 1, 1, 0, 0, 0, 0, 0, 0, 1, 1, 1, 0]",147,80,67,5,4,0.0625,0.05970149253731343
"[1, 1, 0, 1, 1, 1, 0, 1, 0, 1, 1, 1, 1, 1, 0]",531,151,380,10,39,0.06622516556291391,0.10263157894736842
"[0, 1, 1, 0, 1, 1, 1, 1, 1, 1, 0, 1, 1, 1, 0]",526,163,363,15,36,0.09202453987730061,0.09917355371900827
"[1, 1, 1, 0, 1, 0, 0, 0, 1, 1, 1, 1, 0, 1, 0]",158,65,93,6,5,0.09230769230769231,0.053763440860215055
"[0, 0, 0, 0, 0, 1, 0, 0, 1, 1, 0, 0, 1, 0, 0]",584,407,177,49,19,0.12039312039312039,0.10734463276836158
"[0, 0, 0, 0, 0, 0, 1, 0, 0, 1, 1, 0, 0, 1, 0]",559,394,165,45,18,0.11421319796954314,0.10909090909090909
"[1, 0, 1, 0, 0, 1, 0, 1, 1, 1, 0, 1, 1, 0, 1]",127,58,69,4,8,0.06896551724137931,0.11594202898550725
"[0, 1, 1, 0, 0, 1, 0, 1, 1, 1, 1, 0, 1, 1, 1]",272,124,148,15,17,0.12096774193548387,0.11486486486486487
"[1, 1, 1, 1, 0, 0, 0, 0, 0, 0, 1, 0, 0, 1, 1]",352,183,169,17,20,0.09289617486338798,0.11834319526627218
"[0, 0, 1, 1, 1, 0, 1, 1, 0, 1, 0, 1, 0, 1, 0]",112,58,54,2,4,0.034482758620689655,0.07407407407407407
"[0, 0, 0, 1, 1, 1, 1, 0, 0, 1, 1, 1, 0, 1, 0]",211,135,76,10,5,0.07407407407407407,0.06578947368421052
"[0, 1, 0, 1, 0, 0, 0, 0, 0, 0, 0, 1, 0, 1, 0]",509,346,163,33,15,0.0953757225433526,0.09202453987730061
"[0, 0, 0, 0, 1, 0, 1, 0, 1, 1, 1, 0, 1, 0, 1]",117,60,57,3,7,0.05,0.12280701754385964
"[0, 1, 1, 0, 0, 0, 0, 1, 0, 1, 0, 1, 1, 1, 0]",143,91,52,6,3,0.06593406593406594,0.057692307692307696
"[0, 0, 0, 1, 0, 0, 0, 0, 1, 0, 0, 0, 1, 1, 1]",481,331,150,34,15,0.1027190332326284,0.1
"[1, 0, 1, 1, 0, 0, 0, 0, 1, 0, 1, 1, 1, 1, 1]",224,85,139,6,17,0.07058823529411765,0.1223021582733813
"[0, 0, 1, 0, 0, 0, 0, 1, 0, 0, 0, 0, 1, 0, 0]",1534,1151,383,120,47,0.10425716768027801,0.1227154046997389
"[1, 1, 1, 1, 0, 0, 1, 0, 0, 1, 0, 0, 0, 0, 1]",141,76,65,7,10,0.09210526315789473,0.15384615384615385
"[0, 1, 1, 1, 1, 0, 0, 1, 0, 0, 1, 0, 0, 0, 0]",193,132,61,12,6,0.09090909090909091,0.09836065573770492
"[1, 0, 1, 1, 0, 0, 0, 0, 1, 0, 1, 0, 0, 1, 0]",119,75,44,10,9,0.13333333333333333,0.20454545454545456
"[1, 1, 1, 0, 1, 0, 1, 1, 0, 1, 0, 1, 1, 1, 0]",230,81,149,3,8,0.037037037037037035,0.053691275167785234
"[0, 0, 1, 0, 1, 1, 0, 0, 1, 1, 1, 0, 1, 0, 1]",129,60,69,2,6,0.03333333333333333,0.08695652173913043
"[0, 1, 0, 0, 0, 1, 1, 0, 0, 1, 1, 0, 1, 1, 1]",139,73,66,4,7,0.0547945205479452,0.10606060606060606
"[1, 0, 1, 0, 1, 0, 0, 1, 0, 0, 0, 0, 0, 1, 1]",190,111,79,7,3,0.06306306306306306,0.0379746835443038
"[0, 1, 0, 0, 1, 1, 0, 1, 1, 0, 0, 1, 1, 0, 0]",170,90,80,12,10,0.13333333333333333,0.125
"[0, 1, 0, 1, 1, 1, 0, 1, 0, 0, 0, 1, 0, 1, 0]",92,53,39,3,6,0.05660377358490566,0.15384615384615385
"[0, 1, 1, 1, 1, 1, 1, 0, 1, 0, 1, 0, 0, 1, 1]",339,151,188,17,15,0.11258278145695365,0.0797872340425532
"[0, 1, 1, 1, 1, 0, 0, 0, 1, 1, 1, 1, 1, 1, 0]",404,168,236,17,19,0.10119047619047619,0.08050847457627118
"[1, 1, 1, 1, 0, 0, 0, 1, 1, 0, 0, 1, 0, 1, 1]",203,92,111,12,12,0.13043478260869565,0.10810810810810811
"[1, 0, 0, 1, 1, 1, 1, 1, 1, 1, 0, 0, 0, 1, 1]",434,122,312,10,34,0.08196721311475409,0.10897435897435898
"[0, 0, 1, 1, 1, 1, 1, 0, 0, 1, 1, 1, 1, 0, 0]",550,224,326,17,26,0.07589285714285714,0.07975460122699386
"[1, 1, 0, 1, 1, 1, 1, 1, 1, 0, 1, 1, 1, 0, 0]",657,194,463,20,46,0.10309278350515463,0.09935205183585313
"[0, 0, 1, 1, 1, 0, 0, 1, 0, 0, 1, 1, 1, 0, 1]",128,59,69,6,9,0.1016949152542373,0.13043478260869565
"[1, 0, 1, 1, 0, 0, 0, 1, 1, 1, 0, 1, 0, 0, 1]",102,46,56,4,7,0.08695652173913043,0.125
"[1, 1, 0, 0, 1, 0, 0, 1, 0, 0, 1, 1, 0, 0, 1]",174,92,82,7,4,0.07608695652173914,0.04878048780487805
"[1, 0, 0, 1, 0, 0, 0, 0, 0, 0, 0, 1, 0, 0, 1]",550,379,171,37,17,0.09762532981530343,0.09941520467836257
"[0, 1, 1, 1, 0, 0, 1, 1, 1, 1, 1, 0, 0, 0, 1]",187,81,106,9,17,0.1111111111111111,0.16037735849056603
"[0, 1, 0, 0, 1, 0, 0, 0, 0, 1, 1, 0, 0, 1, 0]",265,187,78,17,7,0.09090909090909091,0.08974358974358974
"[0, 1, 0, 1, 0, 1, 1, 1, 0, 1, 1, 1, 1, 0, 1]",210,79,131,5,10,0.06329113924050633,0.07633587786259542
"[1, 0, 1, 0, 1, 1, 0, 0, 0, 0, 0, 0, 1, 0, 1]",148,71,77,2,6,0.028169014084507043,0.07792207792207792
"[1, 0, 1, 0, 1, 1, 1, 0, 0, 0, 1, 1, 1, 1, 1]",358,132,226,16,17,0.12121212121212122,0.0752212389380531
"[0, 1, 0, 0, 0, 1, 0, 1, 1, 0, 0, 1, 0, 0, 0]",278,185,93,17,9,0.0918918918918919,0.0967741935483871
"[1, 0, 0, 1, 0, 0, 1, 0, 1, 0, 0, 0, 1, 0, 1]",133,66,67,9,5,0.13636363636363635,0.07462686567164178
"[1, 0, 0, 1, 1, 1, 0, 1, 0, 1, 1, 1, 0, 0, 1]",201,78,123,8,16,0.10256410256410256,0.13008130081300814
"[1, 0, 0, 0, 1, 1, 0, 0, 1, 1, 1, 0, 1, 0, 1]",136,58,78,5,11,0.08620689655172414,0.14102564102564102
"[0, 1, 0, 1, 0, 1, 0, 0, 1, 1, 0, 0, 0, 0, 1]",252,143,109,19,6,0.13286713286713286,0.05504587155963303
"[0, 0, 1, 1, 0, 1, 0, 1, 0, 1, 0, 1, 0, 0, 1]",103,53,50,2,4,0.03773584905660377,0.08
"[0, 0, 1, 1, 1, 0, 0, 0, 0, 0, 1, 1, 0, 0, 0]",392,250,142,23,13,0.092,0.09154929577464789
"[0, 1, 0, 0, 0, 1, 0, 1, 1, 1, 0, 1, 0, 1, 0]",92,50,42,5,4,0.1,0.09523809523809523
"[0, 1, 1, 1, 0, 0, 1, 0, 1, 1, 1, 0, 1, 1, 0]",133,63,70,5,8,0.07936507936507936,0.11428571428571428
"[1, 0, 0, 0, 0, 1, 0, 0, 0, 1, 1, 0, 1, 0, 0]",249,154,95,12,11,0.07792207792207792,0.11578947368421053
"[0, 1, 0, 0, 0, 0, 0, 1, 0, 0, 1, 1, 0, 1, 0]",205,138,67,15,9,0.10869565217391304,0.13432835820895522
"[1, 0, 1, 0, 0, 1, 1, 0, 0, 0, 1, 1, 0, 1, 1]",140,70,70,12,4,0.17142857142857143,0.05714285714285714
"[0, 0, 1, 0, 1, 0, 0, 1, 1, 1, 0, 1, 0, 1, 0]",102,58,44,3,5,0.05172413793103448,0.11363636363636363
"[0, 1, 0, 1, 0, 0, 1, 0, 1, 0, 0, 1, 1, 1, 0]",122,60,62,12,4,0.2,0.06451612903225806
"[0, 1, 1, 0, 1, 1, 1, 1, 1, 1, 1, 1, 0, 0, 1]",1092,361,731,30,68,0.08310249307479224,0.09302325581395349
"[1, 1, 1, 1, 1, 0, 0, 0, 0, 0, 1, 1, 0, 0, 0]",293,119,174,4,17,0.03361344537815126,0.09770114942528736
"[0, 0, 0, 1, 1, 0, 0, 1, 0, 0, 0, 1, 1, 0, 0]",353,248,105,26,12,0.10483870967741936,0.11428571428571428
"[1, 1, 1, 0, 1, 0, 1, 0, 1, 1, 0, 1, 0, 0, 0]",102,41,61,4,6,0.0975609756097561,0.09836065573770492
"[1, 0, 1, 0, 1, 0, 0, 1, 0, 1, 1, 0, 0, 0, 1]",100,49,51,4,8,0.08163265306122448,0.1568627450980392
"[0, 0, 0, 0, 0, 0, 1, 0, 0, 1, 1, 0, 0, 0, 1]",684,491,193,40,25,0.0814663951120163,0.12953367875647667
"[0, 1, 1, 0, 0, 1, 0, 1, 0, 0, 1, 1, 1, 1, 1]",224,114,110,16,14,0.14035087719298245,0.12727272727272726
"[1, 1, 1, 0, 1, 1, 0, 0, 1, 0, 1, 0, 0, 1, 1]",169,76,93,14,6,0.18421052631578946,0.06451612903225806
"[0, 0, 0, 0, 1, 1, 1, 1, 1, 0, 0, 0, 1, 0, 1]",154,82,72,6,7,0.07317073170731707,0.09722222222222222
"[0, 1, 1, 1, 0, 0, 1, 0, 1, 0, 1, 1, 0, 1, 1]",131,56,75,2,10,0.03571428571428571,0.13333333333333333
"[1, 0, 0, 0, 1, 0, 0, 0, 1, 1, 0, 0, 0, 0, 1]",383,226,157,23,19,0.10176991150442478,0.12101910828025478
"[0, 1, 0, 0, 0, 0, 0, 1, 0, 1, 0, 1, 0, 1, 0]",226,146,80,15,7,0.10273972602739725,0.0875
"[0, 1, 0, 1, 1, 0, 1, 1, 1, 1, 0, 0, 1, 1, 0]",221,92,129,8,12,0.08695652173913043,0.09302325581395349
"[1, 0, 0, 1, 0, 0, 1, 0, 1, 1, 1, 1, 1, 0, 1]",140,54,86,4,9,0.07407407407407407,0.10465116279069768
"[0, 1, 1, 0, 1, 0, 1, 0, 0, 1, 1, 1, 0, 1, 1]",163,73,90,9,11,0.1232876712328767,0.12222222222222222
"[0, 0, 0, 0, 0, 1, 1, 0, 1, 0, 1, 0, 0, 1, 1]",262,181,81,18,10,0.09944751381215469,0.12345679012345678
"[0, 0, 0, 0, 0, 0, 1, 1, 0, 1, 0, 1, 0, 0, 1]",347,236,111,24,17,0.1016949152542373,0.15315315315315314
"[1, 0, 0, 1, 1, 1, 1, 0, 1, 1, 0, 0, 0, 1, 1]",227,73,154,4,16,0.0547945205479452,0.1038961038961039
"[1, 1, 1, 1, 1, 1, 0, 0, 0, 1, 0, 1, 1, 1, 0]",352,123,229,12,21,0.0975609756097561,0.09170305676855896
"[0, 1, 0, 0, 1, 1, 0, 0, 0, 1, 1, 1, 1, 1, 0]",163,79,84,7,4,0.08860759493670886,0.047619047619047616
"[1, 0, 0, 1, 1, 0, 0, 1, 0, 0, 0, 0, 0, 1, 1]",244,119,125,13,11,0.1092436974789916,0.088
"[0, 0, 1, 0, 1, 1, 0, 0, 0, 0, 0, 1, 0, 0, 1]",257,175,82,16,10,0.09142857142857143,0.12195121951219512
"[0, 0, 1, 0, 0, 0, 0, 1, 0, 0, 0, 0, 1, 0, 1]",529,379,150,36,17,0.09498680738786279,0.11333333333333333
"[0, 0, 0, 0, 0, 1, 1, 1, 1, 0, 0, 1, 0, 0, 0]",506,372,134,34,13,0.0913978494623656,0.09701492537313433
"[1, 1, 1, 0, 0, 1, 1, 0, 0, 0, 1, 1, 1, 1, 1]",603,156,447,12,45,0.07692307692307693,0.10067114093959731
"[1, 0, 0, 1, 0, 1, 0, 1, 1, 0, 0, 0, 1, 0, 0]",132,83,49,9,4,0.10843373493975904,0.08163265306122448
"[1, 1, 0, 0, 1, 1, 1, 0, 0, 1, 0, 0, 1, 1, 0]",153,70,83,1,7,0.014285714285714285,0.08433734939759036
"[0, 1, 1, 0, 1, 1, 0, 0, 1, 1, 1, 0, 0, 1, 0]",103,52,51,2,3,0.038461538461538464,0.058823529411764705
"[0, 0, 0, 0, 0, 0, 0, 1, 1, 1, 1, 0, 1, 0, 0]",445,348,97,29,10,0.08333333333333333,0.10309278350515463
"[0, 1, 0, 0, 0, 0, 0, 0, 0, 1, 1, 1, 1, 0, 1]",178,106,72,17,5,0.16037735849056603,0.06944444444444445
"[1, 0, 0, 0, 0, 0, 1, 1, 0, 1, 0, 1, 1, 0, 1]",116,61,55,6,3,0.09836065573770492,0.05454545454545454
"[1, 1, 1, 0, 0, 1, 1, 1, 0, 1, 0, 1, 0, 0, 1]",167,61,106,8,11,0.13114754098360656,0.10377358490566038
"[0, 1, 0, 1, 1, 0, 1, 1, 0, 1, 1, 0, 1, 1, 0]",143,72,71,9,7,0.125,0.09859154929577464
"[1, 1, 1, 1, 0, 1, 1, 1, 1, 1, 0, 0, 1, 0, 0]",258,95,163,5,15,0.05263157894736842,0.09202453987730061
"[0, 1, 1, 1, 1, 1, 1, 0, 0, 1, 1, 0, 0, 0, 1]",420,300,120,34,13,0.11333333333333333,0.10833333333333334
"[1, 1, 0, 1, 1, 1, 1, 0, 0, 1, 0, 1, 0, 1, 0]",128,57,71,4,7,0.07017543859649122,0.09859154929577464
"[0, 0, 1, 1, 1, 1, 0, 0, 1, 1, 0, 1, 0, 1, 1]",313,124,189,9,18,0.07258064516129033,0.09523809523809523
"[1, 0, 1, 0, 0, 1, 1, 1, 1, 0, 0, 1, 1, 0, 1]",211,91,120,10,8,0.10989010989010989,0.06666666666666667
"[0, 1, 1, 0, 1, 0, 0, 1, 1, 1, 1, 0, 0, 1, 1]",313,143,170,15,18,0.1048951048951049,0.10588235294117647
"[0, 1, 0, 0, 1, 0, 1, 1, 1, 0, 0, 1, 0, 0, 0]",169,104,65,16,6,0.15384615384615385,0.09230769230769231
"[1, 0, 0, 0, 1, 1, 1, 1, 1, 1, 0, 1, 0, 0, 1]",150,75,75,10,6,0.13333333333333333,0.08
"[1, 0, 1, 1, 1, 0, 1, 1, 0, 1, 0, 1, 0, 0, 1]",136,68,68,6,7,0.08823529411764706,0.10294117647058823
"[1, 1, 1, 0, 0, 1, 0, 1, 1, 1, 0, 0, 0, 1, 1]",190,57,133,9,17,0.15789473684210525,0.12781954887218044
"[0, 1, 1, 1, 0, 0, 0, 1, 1, 1, 1, 1, 1, 0, 1]",284,114,170,9,21,0.07894736842105263,0.12352941176470589
"[1, 0, 0, 1, 1, 1, 0, 0, 0, 1, 1, 1, 1, 1, 1]",472,139,333,19,31,0.1366906474820144,0.09309309309309309
"[0, 0, 0, 1, 1, 1, 1, 0, 0, 1, 0, 1, 0, 0, 0]",229,163,66,14,7,0.08588957055214724,0.10606060606060606
"[0, 1, 1, 1, 1, 0, 1, 0, 0, 0, 0, 1, 0, 0, 0]",172,110,62,11,6,0.1,0.0967741935483871
"[1, 0, 0, 0, 0, 0, 0, 0, 1, 1, 0, 1, 0, 1, 1]",224,106,118,15,9,0.14150943396226415,0.07627118644067797
"[0, 1, 0, 1, 1, 0, 0, 1, 0, 0, 1, 0, 0, 0, 0]",261,165,96,22,14,0.13333333333333333,0.14583333333333334
"[0, 0, 1, 0, 1, 1, 0, 0, 1, 0, 0, 1, 0, 0, 0]",239,151,88,22,7,0.1456953642384106,0.07954545454545454
"[1, 1, 1, 0, 1, 1, 0, 0, 0, 0, 1, 0, 1, 1, 0]",131,54,77,3,9,0.05555555555555555,0.11688311688311688
"[0, 1, 0, 0, 1, 1, 1, 0, 0, 1, 0, 0, 1, 1, 0]",111,70,41,2,4,0.02857142857142857,0.0975609756097561
"[0, 0, 1, 0, 1, 0, 0, 0, 0, 0, 0, 1, 0, 1, 1]",269,198,71,27,2,0.13636363636363635,0.028169014084507043
"[1, 1, 1, 0, 0, 0, 1, 0, 1, 0, 0, 0, 0, 0, 0]",353,215,138,21,13,0.09767441860465116,0.09420289855072464
"[1, 0, 0, 0, 1, 0, 1, 1, 1, 0, 0, 0, 1, 0, 1]",99,51,48,4,7,0.0784313725490196,0.14583333333333334
"[0, 0, 0, 0, 0, 1, 0, 0, 0, 1, 0, 1, 1, 1, 0]",236,156,80,17,5,0.10897435897435898,0.0625
"[0, 1, 1, 1, 1, 0, 0, 1, 1, 1, 1, 0, 0, 1, 0]",375,275,100,16,13,0.05818181818181818,0.13
"[0, 1, 0, 1, 1, 1, 1, 1, 1, 0, 1, 1, 1, 0, 0]",285,97,188,9,18,0.09278350515463918,0.09574468085106383
"[1, 1, 1, 1, 0, 0, 1, 1, 0, 0, 0, 0, 1, 0, 0]",377,223,154,25,13,0.11210762331838565,0.08441558441558442
"[1, 1, 0, 0, 1, 0, 1, 1, 0, 0, 0, 1, 0, 1, 1]",139,70,69,9,5,0.12857142857142856,0.07246376811594203
"[0, 1, 0, 0, 1, 1, 1, 0, 0, 1, 0, 1, 1, 0, 0]",113,70,43,7,6,0.1,0.13953488372093023
"[1, 1, 0, 1, 0, 0, 1, 1, 1, 0, 0, 1, 0, 1, 1]",120,51,69,2,5,0.0392156862745098,0.07246376811594203
"[1, 0, 1, 0, 0, 1, 1, 1, 1, 1, 1, 0, 1, 0, 0]",152,65,87,5,7,0.07692307692307693,0.08045977011494253
"[1, 1, 0, 0, 1, 1, 0, 1, 1, 0, 1, 0, 0, 0, 0]",125,63,62,7,6,0.1111111111111111,0.0967741935483871
"[1, 1, 0, 1, 0, 1, 0, 1, 0, 1, 1, 0, 0, 0, 0]",155,73,82,7,8,0.0958904109589041,0.0975609756097561
"[0, 1, 1, 0, 0, 1, 0, 1, 0, 0, 0, 1, 0, 0, 1]",148,100,48,9,3,0.09,0.0625
"[1, 0, 0, 1, 0, 0, 0, 1, 1, 0, 0, 0, 1, 0, 0]",247,159,88,18,14,0.11320754716981132,0.1590909090909091
"[1, 1, 0, 1, 1, 0, 0, 1, 0, 0, 1, 0, 0, 0, 1]",117,56,61,7,8,0.125,0.13114754098360656
"[0, 0, 0, 0, 0, 1, 0, 1, 0, 0, 1, 1, 1, 0, 0]",279,191,88,10,10,0.05235602094240838,0.11363636363636363
"[0, 0, 0, 0, 1, 1, 1, 0, 0, 0, 1, 1, 0, 1, 1]",167,95,72,7,14,0.07368421052631578,0.19444444444444445
"[0, 1, 0, 1, 1, 0, 0, 1, 0, 0, 1, 0, 0, 0, 1]",141,82,59,14,7,0.17073170731707318,0.11864406779661017
"[0, 0, 0, 0, 1, 0, 1, 1, 0, 0, 1, 0, 1, 1, 0]",139,85,54,3,4,0.03529411764705882,0.07407407407407407
"[0, 1, 1, 1, 1, 0, 0, 1, 0, 1, 1, 0, 0, 1, 1]",230,118,112,10,13,0.0847457627118644,0.11607142857142858
"[0, 1, 0, 0, 0, 0, 1, 0, 0, 1, 0, 0, 1, 0, 1]",230,157,73,14,8,0.08917197452229299,0.1095890410958904
"[0, 1, 0, 1, 1, 1, 0, 1, 1, 1, 0, 1, 1, 0, 0]",162,68,94,3,8,0.04411764705882353,0.0851063829787234
"[1, 0, 0, 0, 0, 1, 1, 1, 0, 0, 1, 0, 1, 1, 1]",197,64,133,6,14,0.09375,0.10526315789473684
"[1, 0, 1, 0, 0, 0, 0, 1, 1, 1, 0, 0, 1, 0, 1]",98,50,48,4,4,0.08,0.08333333333333333
"[0, 1, 0, 1, 1, 0, 1, 1, 1, 0, 1, 0, 0, 0, 0]",127,65,62,4,7,0.06153846153846154,0.11290322580645161
"[0, 0, 1, 1, 1, 1, 0, 0, 1, 0, 1, 1, 1, 1, 0]",229,100,129,11,12,0.11,0.09302325581395349
"[0, 1, 1, 1, 1, 1, 0, 0, 0, 1, 1, 1, 0, 1, 1]",294,104,190,11,15,0.10576923076923077,0.07894736842105263
"[0, 1, 1, 0, 0, 1, 0, 0, 0, 0, 0, 1, 1, 1, 0]",170,114,56,13,5,0.11403508771929824,0.08928571428571429
"[1, 1, 0, 1, 1, 1, 1, 0, 1, 0, 0, 0, 1, 0, 0]",108,54,54,2,6,0.037037037037037035,0.1111111111111111
"[0, 1, 0, 0, 0, 0, 1, 0, 0, 1, 0, 0, 0, 0, 1]",506,367,139,36,12,0.09809264305177112,0.08633093525179857
"[1, 1, 0, 0, 1, 1, 0, 0, 1, 0, 0, 0, 1, 1, 0]",163,82,81,11,8,0.13414634146341464,0.09876543209876543
"[1, 0, 1, 0, 1, 0, 1, 0, 0, 0, 0, 0, 1, 0, 0]",216,140,76,19,9,0.1357142857142857,0.11842105263157894
"[0, 0, 1, 1, 1, 0, 0, 1, 0, 0, 1, 0, 0, 0, 1]",161,96,65,10,3,0.10416666666666667,0.046153846153846156
"[1, 1, 1, 1, 1, 1, 0, 1, 1, 1, 0, 1, 0, 0, 1]",591,159,432,22,35,0.13836477987421383,0.08101851851851852
"[1, 1, 0, 1, 0, 0, 0, 0, 0, 0, 1, 1, 1, 1, 1]",402,193,209,16,25,0.08290155440414508,0.11961722488038277
"[0, 0, 0, 1, 0, 1, 1, 0, 1, 0, 1, 1, 1, 1, 0]",119,55,64,4,10,0.07272727272727272,0.15625
"[0, 1, 0, 1, 0, 1, 1, 1, 1, 1, 1, 0, 1, 1, 0]",221,78,143,12,11,0.15384615384615385,0.07692307692307693
"[1, 0, 0, 0, 1, 0, 1, 0, 0, 1, 0, 1, 1, 1, 1]",152,85,67,6,7,0.07058823529411765,0.1044776119402985
"[0, 0, 1, 0, 0, 1, 0, 1, 0, 0, 0, 1, 0, 1, 0]",225,148,77,19,6,0.12837837837837837,0.07792207792207792
"[0, 0, 0, 0, 0, 1, 0, 0, 1, 0, 1, 0, 0, 0, 1]",537,387,150,38,14,0.09819121447028424,0.09333333333333334
"[1, 1, 0, 1, 0, 0, 0, 0, 0, 0, 0, 1, 1, 0, 1]",172,101,71,8,3,0.07920792079207921,0.04225352112676056
"[1, 0, 0, 1, 1, 0, 1, 1, 1, 1, 0, 0, 0, 0, 0]",207,107,100,7,10,0.06542056074766354,0.1
"[0, 0, 1, 0, 0, 0, 0, 1, 1, 0, 1, 1, 0, 1, 1]",120,74,46,6,2,0.08108108108108109,0.043478260869565216
"[1, 0, 0, 0, 0, 1, 0, 1, 1, 1, 0, 0, 0, 1, 0]",134,80,54,4,7,0.05,0.12962962962962962
"[1, 0, 0, 1, 1, 0, 0, 1, 0, 0, 0, 1, 0, 0, 1]",197,97,100,10,8,0.10309278350515463,0.08
"[0, 0, 1, 1, 1, 0, 0, 0, 0, 0, 1, 0, 1, 0, 0]",284,186,98,17,9,0.0913978494623656,0.09183673469387756
"[0, 1, 0, 0, 0, 1, 1, 1, 0, 0, 0, 0, 0, 1, 0]",263,173,90,25,11,0.14450867052023122,0.12222222222222222
"[0, 1, 1, 0, 0, 1, 1, 0, 1, 0, 0, 0, 1, 1, 1]",204,128,76,16,9,0.125,0.11842105263157894
"[1, 0, 1, 1, 1, 0, 0, 1, 0, 0, 1, 1, 0, 1, 1]",148,62,86,3,7,0.04838709677419355,0.08139534883720931
"[0, 0, 1, 0, 0, 0, 0, 0, 1, 0, 1, 0, 0, 1, 0]",472,313,159,26,11,0.08306709265175719,0.06918238993710692
"[1, 1, 0, 0, 1, 0, 0, 0, 0, 1, 0, 1, 0, 0, 0]",248,149,99,12,14,0.08053691275167785,0.1414141414141414
"[1, 0, 1, 0, 1, 1, 0, 0, 1, 1, 1, 1, 1, 1, 0]",415,147,268,20,28,0.1360544217687075,0.1044776119402985
"[1, 1, 1, 0, 0, 0, 1, 1, 0, 1, 0, 1, 1, 0, 0]",133,48,85,9,2,0.1875,0.023529411764705882
"[0, 1, 0, 0, 1, 1, 1, 1, 1, 0, 1, 1, 1, 1, 0]",270,94,176,9,19,0.09574468085106383,0.10795454545454546
"[0, 0, 0, 0, 0, 0, 1, 1, 0, 1, 1, 0, 1, 0, 1]",183,109,74,12,13,0.11009174311926606,0.17567567567567569
"[0, 0, 1, 0, 1, 1, 1, 1, 1, 0, 0, 0, 0, 0, 0]",370,218,152,17,15,0.0779816513761468,0.09868421052631579
"[1, 0, 0, 1, 1, 0, 1, 0, 1, 0, 1, 1, 1, 1, 1]",331,110,221,17,15,0.15454545454545454,0.06787330316742081
"[1, 1, 0, 1, 1, 0, 1, 1, 1, 1, 0, 0, 0, 1, 1]",279,90,189,11,15,0.12222222222222222,0.07936507936507936
"[1, 1, 0, 0, 0, 1, 1, 1, 1, 0, 0, 0, 1, 0, 0]",143,70,73,6,8,0.08571428571428572,0.1095890410958904
"[0, 0, 1, 0, 0, 1, 1, 1, 1, 1, 0, 1, 0, 0, 1]",109,41,68,4,7,0.0975609756097561,0.10294117647058823
"[0, 0, 0, 0, 1, 0, 1, 0, 1, 0, 1, 1, 1, 0, 0]",164,95,69,7,6,0.07368421052631578,0.08695652173913043
"[0, 0, 1, 0, 1, 0, 0, 1, 1, 0, 0, 0, 0, 1, 0]",260,170,90,13,12,0.07647058823529412,0.13333333333333333
"[0, 0, 0, 1, 1, 1, 1, 0, 0, 1, 1, 1, 0, 1, 1]",354,237,117,15,17,0.06329113924050633,0.1452991452991453
"[1, 0, 1, 1, 1, 0, 0, 0, 0, 0, 1, 1, 1, 1, 1]",332,133,199,9,31,0.06766917293233082,0.15577889447236182
"[0, 0, 0, 1, 0, 1, 1, 0, 1, 1, 1, 0, 0, 0, 0]",189,110,79,10,2,0.09090909090909091,0.02531645569620253
"[1, 0, 1, 0, 0, 0, 1, 1, 0, 1, 1, 0, 0, 0, 1]",115,67,48,5,5,0.07462686567164178,0.10416666666666667
"[1, 0, 0, 0, 0, 1, 0, 1, 0, 0, 0, 0, 0, 0, 1]",667,442,225,49,18,0.11085972850678733,0.08
"[0, 0, 1, 0, 1, 0, 1, 1, 1, 0, 1, 0, 0, 0, 0]",164,100,64,12,5,0.12,0.078125
"[1, 0, 1, 0, 1, 1, 0, 1, 0, 1, 0, 0, 1, 0, 0]",107,64,43,8,4,0.125,0.09302325581395349
"[0, 1, 0, 1, 1, 0, 1, 1, 1, 0, 1, 0, 1, 0, 1]",108,47,61,1,6,0.02127659574468085,0.09836065573770492
"[1, 1, 1, 0, 1, 1, 0, 0, 0, 0, 1, 1, 0, 0, 1]",286,125,161,7,17,0.056,0.10559006211180125
"[0, 0, 1, 1, 1, 1, 0, 1, 0, 1, 0, 1, 1, 1, 1]",378,142,236,10,27,0.07042253521126761,0.11440677966101695
"[1, 1, 0, 0, 1, 1, 0, 1, 1, 1, 0, 0, 1, 1, 0]",182,82,100,4,7,0.04878048780487805,0.07
"[1, 1, 1, 0, 1, 1, 0, 1, 0, 1, 0, 1, 1, 0, 0]",154,57,97,4,8,0.07017543859649122,0.08247422680412371
"[1, 0, 0, 0, 0, 1, 0, 1, 1, 0, 1, 0, 1, 1, 0]",102,52,50,2,2,0.038461538461538464,0.04
"[0, 0, 1, 1, 1, 1, 1, 0, 0, 1, 0, 1, 0, 0, 0]",118,79,39,11,2,0.13924050632911392,0.05128205128205128
"[0, 0, 1, 1, 0, 1, 0, 1, 0, 0, 1, 0, 1, 1, 1]",125,69,56,4,5,0.057971014492753624,0.08928571428571429
"[0, 0, 1, 0, 1, 0, 1, 1, 1, 0, 1, 1, 0, 0, 0]",122,59,63,3,7,0.05084745762711865,0.1111111111111111
"[0, 0, 0, 0, 1, 0, 1, 0, 1, 1, 1, 0, 1, 1, 0]",112,61,51,7,5,0.11475409836065574,0.09803921568627451
"[1, 0, 1, 1, 0, 1, 1, 1, 0, 0, 1, 1, 0, 1, 0]",150,46,104,3,11,0.06521739130434782,0.10576923076923077
"[0, 1, 1, 1, 1, 0, 1, 0, 0, 1, 0, 1, 1, 0, 1]",139,57,82,6,9,0.10526315789473684,0.10975609756097561
"[0, 0, 0, 0, 1, 1, 1, 1, 1, 1, 1, 1, 1, 0, 1]",752,281,471,23,46,0.08185053380782918,0.09766454352441614
"[1, 0, 0, 0, 0, 1, 1, 1, 1, 1, 1, 1, 1, 1, 0]",864,185,679,22,65,0.11891891891891893,0.09572901325478646
"[0, 1, 0, 1, 0, 1, 0, 0, 1, 0, 1, 0, 1, 1, 0]",116,56,60,3,5,0.05357142857142857,0.08333333333333333
"[1, 0, 0, 0, 0, 1, 0, 1, 0, 1, 1, 1, 1, 1, 1]",251,91,160,7,20,0.07692307692307693,0.125
"[0, 1, 0, 0, 1, 1, 1, 1, 1, 1, 0, 0, 1, 0, 0]",145,80,65,7,4,0.0875,0.06153846153846154
"[0, 1, 1, 0, 0, 0, 1, 0, 1, 0, 1, 0, 1, 0, 1]",107,61,46,6,2,0.09836065573770492,0.043478260869565216
"[0, 0, 0, 0, 0, 1, 1, 1, 0, 1, 0, 1, 0, 0, 1]",160,101,59,4,6,0.039603960396039604,0.1016949152542373
"[0, 0, 0, 0, 0, 0, 1, 1, 1, 0, 1, 0, 1, 0, 0]",303,212,91,19,3,0.08962264150943396,0.03296703296703297
"[1, 0, 0, 1, 0, 0, 1, 1, 1, 0, 0, 0, 0, 0, 0]",391,215,176,22,18,0.10232558139534884,0.10227272727272728
"[0, 1, 0, 1, 1, 0, 1, 1, 1, 0, 1, 1, 0, 0, 0]",133,67,66,11,8,0.16417910447761194,0.12121212121212122
"[1, 0, 1, 0, 0, 0, 0, 0, 0, 1, 0, 0, 1, 1, 0]",267,172,95,17,18,0.09883720930232558,0.18947368421052632
"[1, 1, 1, 1, 0, 1, 0, 1, 0, 1, 0, 1, 1, 1, 0]",233,73,160,5,14,0.0684931506849315,0.0875
"[0, 1, 1, 0, 0, 1, 0, 1, 1, 1, 0, 1, 1, 0, 1]",150,64,86,6,12,0.09375,0.13953488372093023
"[1, 1, 0, 1, 1, 0, 0, 1, 0, 1, 1, 1, 0, 1, 1]",227,71,156,5,21,0.07042253521126761,0.1346153846153846
"[1, 0, 0, 1, 1, 0, 0, 1, 0, 1, 1, 1, 0, 1, 1]",184,61,123,3,11,0.04918032786885246,0.08943089430894309
"[1, 0, 0, 0, 0, 0, 1, 1, 0, 0, 1, 1, 0, 0, 1]",457,247,210,27,19,0.10931174089068826,0.09047619047619047
"[1, 1, 1, 1, 0, 0, 0, 0, 0, 1, 1, 0, 0, 1, 1]",414,170,244,17,26,0.1,0.10655737704918032
"[1, 0, 0, 0, 1, 0, 1, 1, 0, 0, 1, 0, 0, 0, 1]",177,114,63,15,7,0.13157894736842105,0.1111111111111111
"[0, 0, 0, 1, 1, 0, 1, 0, 0, 1, 0, 0, 1, 0, 1]",157,105,52,12,5,0.11428571428571428,0.09615384615384616
"[0, 1, 0, 1, 1, 0, 0, 1, 1, 0, 0, 1, 1, 0, 0]",419,238,181,18,17,0.07563025210084033,0.09392265193370165
"[1, 0, 0, 0, 0, 1, 1, 1, 1, 0, 1, 1, 0, 1, 1]",247,62,185,8,12,0.12903225806451613,0.06486486486486487
"[0, 1, 1, 0, 0, 1, 0, 0, 1, 1, 0, 1, 1, 0, 1]",113,51,62,3,2,0.058823529411764705,0.03225806451612903
"[1, 0, 1, 0, 0, 1, 0, 1, 1, 0, 0, 1, 0, 0, 1]",121,60,61,6,8,0.1,0.13114754098360656
"[0, 1, 1, 0, 0, 0, 0, 1, 1, 0, 1, 0, 0, 1, 0]",184,130,54,11,5,0.08461538461538462,0.09259259259259259
"[0, 1, 0, 1, 0, 1, 1, 0, 0, 0, 0, 1, 0, 0, 0]",252,167,85,15,10,0.08982035928143713,0.11764705882352941
"[0, 0, 1, 0, 1, 0, 1, 1, 0, 0, 0, 0, 1, 0, 0]",246,141,105,10,10,0.07092198581560284,0.09523809523809523
"[0, 0, 1, 1, 0, 0, 1, 0, 1, 1, 0, 1, 1, 1, 0]",125,49,76,8,8,0.16326530612244897,0.10526315789473684
"[0, 0, 1, 0, 1, 1, 1, 1, 1, 0, 0, 0, 0, 0, 1]",160,101,59,10,7,0.09900990099009901,0.11864406779661017
"[1, 0, 0, 1, 0, 1, 1, 1, 1, 1, 0, 0, 0, 0, 0]",209,122,87,10,5,0.08196721311475409,0.05747126436781609
"[1, 0, 1, 1, 0, 1, 1, 0, 0, 1, 1, 1, 0, 1, 0]",155,62,93,5,7,0.08064516129032258,0.07526881720430108
"[1, 1, 0, 0, 0, 1, 0, 1, 0, 1, 1, 1, 1, 1, 0]",148,63,85,8,9,0.12698412698412698,0.10588235294117647
"[1, 0, 1, 1, 0, 0, 1, 0, 1, 1, 1, 0, 0, 0, 0]",136,77,59,7,8,0.09090909090909091,0.13559322033898305
"[1, 1, 1, 0, 1, 0, 0, 0, 1, 1, 0, 1, 0, 1, 1]",165,55,110,6,15,0.10909090909090909,0.13636363636363635
"[0, 1, 1, 0, 0, 0, 1, 1, 0, 1, 1, 1, 1, 0, 0]",188,106,82,10,9,0.09433962264150944,0.10975609756097561
"[0, 0, 1, 0, 1, 0, 1, 1, 0, 0, 0, 1, 1, 0, 1]",110,56,54,3,7,0.05357142857142857,0.12962962962962962
"[0, 1, 1, 1, 1, 0, 1, 1, 1, 0, 1, 1, 0, 0, 1]",260,110,150,12,10,0.10909090909090909,0.06666666666666667
"[1, 0, 1, 1, 1, 0, 1, 0, 1, 1, 0, 0, 0, 1, 0]",94,45,49,2,6,0.044444444444444446,0.12244897959183673
"[0, 1, 1, 1, 0, 0, 1, 1, 1, 1, 0, 1, 0, 0, 0]",137,64,73,8,3,0.125,0.0410958904109589
"[0, 0, 1, 1, 0, 0, 0, 1, 1, 1, 1, 1, 0, 0, 1]",184,88,96,13,7,0.14772727272727273,0.07291666666666667
"[0, 0, 1, 0, 0, 0, 1, 1, 0, 0, 0, 1, 1, 1, 1]",210,113,97,16,12,0.1415929203539823,0.12371134020618557
"[0, 1, 1, 1, 0, 0, 1, 1, 0, 0, 1, 0, 0, 0, 1]",129,73,56,3,2,0.0410958904109589,0.03571428571428571
"[1, 1, 0, 1, 1, 1, 1, 0, 0, 0, 0, 0, 0, 1, 0]",138,69,69,5,10,0.07246376811594203,0.14492753623188406
"[0, 0, 1, 1, 0, 0, 1, 1, 0, 0, 1, 0, 1, 1, 0]",200,97,103,9,5,0.09278350515463918,0.04854368932038835
"[0, 1, 1, 0, 1, 1, 0, 1, 1, 1, 1, 1, 1, 0, 0]",376,150,226,16,26,0.10666666666666667,0.11504424778761062
"[1, 1, 1, 1, 1, 0, 1, 1, 1, 0, 1, 0, 0, 0, 1]",293,101,192,5,20,0.04950495049504951,0.10416666666666667
"[1, 0, 0, 0, 1, 0, 1, 0, 1, 0, 1, 0, 1, 0, 1]",100,54,46,5,3,0.09259259259259259,0.06521739130434782
"[0, 1, 0, 0, 0, 1, 0, 1, 0, 1, 0, 1, 0, 1, 0]",123,72,51,7,6,0.09722222222222222,0.11764705882352941
"[1, 1, 1, 0, 1, 0, 0, 0, 1, 1, 0, 1, 0, 1, 0]",138,69,69,5,4,0.07246376811594203,0.057971014492753624
"[1, 0, 1, 1, 0, 1, 1, 1, 1, 1, 0, 0, 0, 1, 1]",285,98,187,9,13,0.09183673469387756,0.06951871657754011
"[0, 1, 0, 0, 1, 0, 0, 0, 1, 1, 1, 0, 0, 0, 1]",147,89,58,8,6,0.0898876404494382,0.10344827586206896
"[1, 0, 0, 1, 0, 1, 1, 0, 0, 0, 0, 0, 1, 1, 1]",195,91,104,5,14,0.054945054945054944,0.1346153846153846
"[1, 0, 1, 1, 1, 1, 1, 1, 0, 1, 1, 1, 1, 0, 0]",738,213,525,19,53,0.0892018779342723,0.10095238095238095
"[0, 0, 1, 0, 0, 1, 1, 0, 1, 1, 0, 0, 1, 0, 0]",136,85,51,9,4,0.10588235294117647,0.0784313725490196
"[0, 1, 0, 1, 0, 1, 0, 1, 0, 0, 0, 1, 0, 1, 0]",127,76,51,10,3,0.13157894736842105,0.058823529411764705
"[1, 0, 1, 0, 1, 0, 1, 0, 1, 1, 0, 1, 0, 0, 0]",119,60,59,4,8,0.06666666666666667,0.13559322033898305
"[0, 1, 0, 0, 0, 1, 1, 1, 1, 1, 0, 0, 1, 0, 1]",106,57,49,6,10,0.10526315789473684,0.20408163265306123
"[0, 1, 1, 1, 1, 0, 1, 0, 0, 1, 0, 1, 0, 1, 0]",118,62,56,5,5,0.08064516129032258,0.08928571428571429
"[1, 0, 1, 1, 0, 0, 1, 1, 0, 0, 0, 0, 0, 1, 1]",222,114,108,12,11,0.10526315789473684,0.10185185185185185
"[1, 0, 0, 0, 0, 0, 0, 1, 0, 0, 1, 1, 1, 0, 1]",157,81,76,9,6,0.1111111111111111,0.07894736842105263
"[0, 1, 0, 0, 1, 0, 1, 1, 1, 1, 1, 1, 0, 1, 0]",138,61,77,5,7,0.08196721311475409,0.09090909090909091
"[0, 1, 1, 1, 0, 1, 0, 0, 1, 0, 1, 1, 1, 1, 1]",304,116,188,11,13,0.09482758620689655,0.06914893617021277
"[0, 0, 1, 0, 1, 0, 1, 0, 0, 1, 1, 1, 0, 1, 0]",110,69,41,8,3,0.11594202898550725,0.07317073170731707
"[1, 1, 1, 0, 0, 1, 0, 0, 1, 1, 0, 0, 0, 0, 1]",215,104,111,5,9,0.04807692307692308,0.08108108108108109
"[1, 1, 0, 1, 1, 0, 0, 1, 1, 0, 1, 0, 0, 0, 0]",108,61,47,5,3,0.08196721311475409,0.06382978723404255
"[1, 0, 0, 1, 1, 0, 1, 1, 0, 1, 1, 0, 0, 1, 0]",107,42,65,4,5,0.09523809523809523,0.07692307692307693
"[1, 1, 1, 1, 1, 0, 0, 0, 0, 1, 1, 0, 1, 1, 0]",310,91,219,7,25,0.07692307692307693,0.1141552511415525
"[0, 1, 0, 0, 0, 0, 0, 1, 0, 0, 1, 1, 1, 1, 0]",215,134,81,13,4,0.09701492537313433,0.04938271604938271
"[1, 0, 1, 0, 0, 0, 0, 0, 1, 1, 1, 1, 1, 0, 0]",183,94,89,5,12,0.05319148936170213,0.1348314606741573
"[0, 1, 1, 0, 0, 1, 1, 0, 1, 1, 1, 0, 1, 1, 1]",316,164,152,22,11,0.13414634146341464,0.07236842105263158
"[1, 0, 0, 0, 0, 1, 1, 0, 0, 0, 1, 1, 1, 0, 0]",209,113,96,9,8,0.07964601769911504,0.08333333333333333
"[1, 0, 1, 0, 1, 1, 1, 1, 0, 0, 1, 1, 0, 1, 1]",282,90,192,7,18,0.07777777777777778,0.09375
"[1, 1, 0, 1, 0, 0, 1, 0, 1, 1, 0, 1, 1, 1, 1]",244,83,161,4,15,0.04819277108433735,0.09316770186335403
"[0, 0, 1, 1, 1, 0, 0, 0, 0, 1, 0, 1, 0, 1, 0]",151,88,63,6,7,0.06818181818181818,0.1111111111111111
"[0, 0, 0, 0, 1, 0, 1, 0, 0, 1, 0, 0, 0, 1, 0]",509,377,132,28,13,0.07427055702917772,0.09848484848484848
"[1, 0, 1, 1, 1, 0, 1, 0, 0, 0, 1, 1, 0, 0, 0]",139,79,60,7,6,0.08860759493670886,0.1
"[0, 0, 0, 1, 0, 1, 1, 0, 1, 1, 1, 0, 0, 0, 1]",110,58,52,4,8,0.06896551724137931,0.15384615384615385
"[0, 0, 0, 0, 0, 0, 1, 0, 0, 1, 1, 0, 1, 0, 1]",256,176,80,15,8,0.08522727272727272,0.1
"[1, 1, 0, 0, 0, 0, 1, 0, 0, 0, 1, 0, 1, 0, 1]",142,87,55,10,7,0.11494252873563218,0.12727272727272726
"[0, 1, 0, 0, 0, 1, 1, 0, 1, 1, 1, 0, 1, 0, 0]",106,53,53,3,5,0.05660377358490566,0.09433962264150944
"[0, 0, 0, 0, 1, 0, 0, 1, 1, 0, 0, 1, 1, 1, 1]",393,240,153,23,15,0.09583333333333334,0.09803921568627451
"[1, 1, 0, 1, 1, 0, 0, 0, 0, 0, 1, 1, 1, 0, 0]",151,83,68,8,7,0.0963855421686747,0.10294117647058823
"[0, 0, 0, 1, 0, 1, 0, 0, 1, 1, 0, 1, 1, 1, 1]",169,93,76,8,8,0.08602150537634409,0.10526315789473684
"[1, 0, 1, 0, 1, 1, 0, 1, 1, 0, 0, 0, 1, 0, 0]",116,66,50,7,4,0.10606060606060606,0.08
"[1, 1, 1, 1, 0, 1, 0, 1, 1, 0, 0, 1, 1, 0, 1]",259,94,165,8,6,0.0851063829787234,0.03636363636363636
"[1, 0, 0, 1, 1, 0, 1, 1, 1, 1, 0, 1, 0, 1, 0]",156,59,97,13,12,0.22033898305084745,0.12371134020618557
"[1, 0, 1, 0, 0, 1, 1, 1, 1, 1, 0, 0, 1, 0, 1]",136,49,87,3,6,0.061224489795918366,0.06896551724137931
"[1, 0, 1, 1, 0, 1, 1, 1, 0, 1, 0, 1, 1, 0, 1]",216,79,137,7,14,0.08860759493670886,0.10218978102189781
"[1, 1, 1, 1, 1, 0, 1, 0, 0, 1, 1, 1, 1, 0, 1]",596,165,431,17,40,0.10303030303030303,0.09280742459396751
"[0, 1, 1, 1, 1, 0, 0, 0, 1, 1, 1, 1, 0, 1, 1]",284,125,159,14,20,0.112,0.12578616352201258
"[0, 0, 0, 1, 0, 0, 1, 0, 1, 1, 1, 1, 1, 1, 0]",167,85,82,5,6,0.058823529411764705,0.07317073170731707
"[0, 1, 0, 0, 0, 1, 0, 1, 0, 0, 0, 0, 0, 1, 1]",311,208,103,19,9,0.09134615384615384,0.08737864077669903
"[1, 1, 0, 0, 0, 1, 0, 1, 0, 0, 0, 1, 0, 1, 0]",124,69,55,7,4,0.10144927536231885,0.07272727272727272
"[1, 0, 1, 0, 1, 1, 0, 1, 1, 0, 1, 0, 0, 0, 0]",125,65,60,6,4,0.09230769230769231,0.06666666666666667
"[1, 1, 1, 1, 0, 1, 0, 0, 0, 1, 0, 1, 0, 0, 1]",131,62,69,7,7,0.11290322580645161,0.10144927536231885
"[1, 0, 0, 0, 0, 1, 0, 1, 1, 0, 0, 1, 1, 0, 0]",230,126,104,11,6,0.0873015873015873,0.057692307692307696
"[0, 0, 1, 1, 1, 1, 0, 1, 1, 0, 0, 1, 1, 1, 0]",166,83,83,8,6,0.0963855421686747,0.07228915662650602
"[1, 1, 1, 1, 0, 1, 0, 1, 0, 0, 1, 1, 1, 0, 1]",235,76,159,7,10,0.09210526315789473,0.06289308176100629
"[1, 1, 0, 1, 1, 1, 1, 1, 0, 1, 0, 1, 0, 0, 1]",243,66,177,6,17,0.09090909090909091,0.096045197740113
"[1, 1, 1, 0, 0, 0, 1, 0, 1, 1, 0, 1, 1, 1, 1]",334,90,244,10,26,0.1111111111111111,0.10655737704918032
"[0, 1, 1, 1, 0, 0, 0, 1, 0, 1, 1, 0, 1, 1, 1]",153,63,90,7,5,0.1111111111111111,0.05555555555555555
"[1, 0, 1, 0, 0, 1, 0, 1, 0, 0, 1, 1, 0, 0, 1]",150,83,67,9,7,0.10843373493975904,0.1044776119402985
"[0, 0, 0, 0, 1, 1, 1, 0, 0, 0, 1, 0, 1, 1, 1]",223,138,85,10,7,0.07246376811594203,0.08235294117647059
"[1, 0, 1, 1, 0, 1, 0, 0, 0, 0, 1, 1, 1, 0, 0]",125,62,63,5,6,0.08064516129032258,0.09523809523809523
"[1, 1, 0, 0, 0, 0, 0, 1, 0, 0, 1, 1, 1, 1, 1]",266,130,136,15,13,0.11538461538461539,0.09558823529411764
"[1, 1, 0, 0, 1, 1, 1, 1, 0, 0, 0, 0, 1, 0, 1]",327,146,181,13,16,0.08904109589041095,0.08839779005524862
"[1, 0, 1, 0, 0, 1, 0, 1, 1, 1, 0, 1, 0, 0, 1]",101,44,57,4,4,0.09090909090909091,0.07017543859649122
"[0, 1, 1, 1, 0, 1, 0, 0, 1, 0, 1, 1, 1, 0, 1]",115,53,62,2,6,0.03773584905660377,0.0967741935483871
"[1, 0, 0, 0, 1, 1, 1, 0, 1, 0, 0, 1, 0, 1, 1]",118,41,77,4,6,0.0975609756097561,0.07792207792207792
"[0, 1, 0, 1, 1, 0, 1, 0, 0, 0, 0, 1, 1, 1, 0]",109,57,52,5,9,0.08771929824561403,0.17307692307692307
"[1, 0, 1, 0, 1, 1, 0, 1, 0, 0, 0, 0, 1, 1, 1]",144,73,71,6,4,0.0821917808219178,0.056338028169014086
"[0, 1, 0, 0, 1, 0, 1, 1, 0, 0, 0, 0, 1, 1, 0]",256,146,110,8,10,0.0547945205479452,0.09090909090909091
"[1, 0, 1, 0, 0, 1, 0, 1, 1, 0, 0, 0, 0, 1, 1]",212,120,92,9,13,0.075,0.14130434782608695
"[1, 0, 1, 1, 0, 1, 0, 1, 0, 0, 1, 0, 1, 0, 0]",86,44,42,1,4,0.022727272727272728,0.09523809523809523
"[1, 1, 1, 0, 1, 1, 0, 1, 1, 0, 1, 0, 1, 0, 0]",151,62,89,7,6,0.11290322580645161,0.06741573033707865
"[0, 1, 1, 0, 0, 0, 0, 0, 1, 0, 1, 1, 0, 0, 0]",330,224,106,26,5,0.11607142857142858,0.04716981132075472
"[0, 1, 1, 0, 1, 1, 1, 0, 0, 0, 0, 0, 0, 1, 0]",162,94,68,10,2,0.10638297872340426,0.029411764705882353
"[0, 0, 0, 0, 1, 1, 1, 1, 1, 0, 0, 1, 0, 0, 1]",181,108,73,10,3,0.09259259259259259,0.0410958904109589
"[0, 0, 0, 0, 0, 0, 1, 1, 1, 1, 1, 0, 0, 1, 0]",281,181,100,18,8,0.09944751381215469,0.08
"[1, 0, 0, 0, 1, 0, 1, 0, 1, 1, 0, 1, 1, 1, 1]",199,82,117,8,12,0.0975609756097561,0.10256410256410256
"[1, 0, 0, 0, 0, 1, 1, 0, 1, 1, 0, 1, 0, 1, 1]",150,46,104,5,9,0.10869565217391304,0.08653846153846154
"[0, 1, 0, 0, 1, 1, 0, 1, 1, 1, 1, 1, 0, 0, 0]",163,79,84,8,6,0.10126582278481013,0.07142857142857142
"[1, 0, 0, 1, 0, 1, 0, 0, 0, 0, 0, 0, 1, 0, 0]",541,364,177,30,17,0.08241758241758242,0.096045197740113
"[1, 1, 1, 0, 0, 1, 0, 1, 0, 0, 0, 0, 0, 0, 1]",209,108,101,9,12,0.08333333333333333,0.1188118811881188
"[1, 1, 0, 1, 0, 1, 0, 1, 1, 1, 1, 1, 1, 1, 0]",615,180,435,13,26,0.07222222222222222,0.059770114942528735
"[1, 0, 0, 0, 1, 0, 0, 0, 0, 0, 0, 1, 1, 0, 1]",265,165,100,22,10,0.13333333333333333,0.1
"[1, 0, 0, 1, 0, 0, 1, 0, 0, 1, 0, 1, 0, 1, 0]",127,72,55,10,4,0.1388888888888889,0.07272727272727272
"[1, 0, 1, 1, 0, 0, 1, 1, 0, 1, 1, 1, 1, 0, 0]",173,77,96,3,8,0.03896103896103896,0.08333333333333333
"[0, 1, 0, 0, 0, 1, 0, 1, 1, 1, 0, 1, 1, 1, 1]",166,75,91,8,9,0.10666666666666667,0.0989010989010989
"[1, 1, 0, 1, 0, 1, 0, 0, 1, 0, 0, 0, 1, 0, 1]",117,64,53,6,4,0.09375,0.07547169811320754
"[0, 1, 1, 0, 0, 0, 1, 1, 0, 0, 1, 0, 0, 1, 1]",163,91,72,12,9,0.13186813186813187,0.125
"[0, 0, 1, 1, 0, 1, 1, 1, 1, 1, 0, 1, 0, 0, 0]",128,51,77,4,11,0.0784313725490196,0.14285714285714285
"[1, 0, 0, 0, 0, 1, 1, 0, 0, 1, 0, 1, 0, 1, 1]",232,82,150,9,16,0.10975609756097561,0.10666666666666667
"[1, 0, 0, 1, 0, 0, 0, 0, 0, 1, 1, 0, 1, 0, 0]",249,154,95,18,8,0.11688311688311688,0.08421052631578947
"[0, 1, 1, 1, 0, 1, 1, 0, 1, 0, 0, 0, 1, 1, 0]",118,59,59,5,6,0.0847457627118644,0.1016949152542373
"[0, 1, 0, 1, 1, 1, 0, 1, 1, 0, 1, 0, 0, 0, 1]",106,44,62,3,8,0.06818181818181818,0.12903225806451613
"[0, 1, 1, 1, 0, 1, 0, 1, 1, 1, 0, 1, 1, 0, 1]",241,85,156,4,11,0.047058823529411764,0.07051282051282051
"[1, 0, 0, 0, 1, 0, 0, 1, 0, 0, 1, 0, 1, 1, 1]",132,66,66,7,7,0.10606060606060606,0.10606060606060606
"[1, 0, 0, 1, 1, 0, 0, 0, 1, 0, 0, 1, 0, 0, 1]",167,90,77,12,7,0.13333333333333333,0.09090909090909091
"[0, 1, 1, 0, 0, 1, 1, 0, 0, 0, 1, 0, 1, 1, 1]",307,224,83,25,9,0.11160714285714286,0.10843373493975904
"[0, 1, 1, 1, 0, 1, 0, 0, 1, 1, 1, 0, 1, 1, 1]",262,107,155,6,19,0.056074766355140186,0.12258064516129032
"[1, 0, 0, 0, 1, 0, 1, 0, 0, 0, 1, 0, 1, 0, 1]",113,70,43,8,4,0.11428571428571428,0.09302325581395349
"[1, 1, 1, 0, 0, 0, 1, 1, 0, 1, 0, 0, 0, 1, 0]",109,48,61,5,8,0.10416666666666667,0.13114754098360656
"[0, 0, 1, 0, 1, 1, 0, 1, 0, 0, 0, 0, 0, 1, 1]",208,135,73,10,7,0.07407407407407407,0.0958904109589041
"[0, 1, 1, 0, 0, 0, 1, 0, 0, 1, 1, 1, 0, 0, 0]",172,107,65,5,5,0.04672897196261682,0.07692307692307693
"[1, 0, 0, 0, 1, 1, 0, 0, 0, 1, 0, 0, 1, 1, 1]",194,95,99,5,9,0.05263157894736842,0.09090909090909091
"[0, 0, 0, 1, 1, 0, 0, 0, 1, 1, 1, 0, 0, 0, 1]",208,136,72,11,6,0.08088235294117647,0.08333333333333333
"[0, 1, 1, 0, 0, 1, 0, 1, 0, 0, 1, 0, 0, 0, 1]",138,85,53,8,8,0.09411764705882353,0.1509433962264151
"[0, 0, 0, 0, 1, 1, 0, 0, 1, 0, 1, 0, 0, 1, 0]",266,168,98,8,6,0.047619047619047616,0.061224489795918366
"[0, 1, 1, 0, 0, 0, 0, 1, 1, 0, 0, 1, 0, 1, 0]",265,198,67,20,8,0.10101010101010101,0.11940298507462686
"[1, 1, 1, 1, 1, 0, 1, 0, 0, 1, 0, 0, 0, 0, 1]",140,68,72,3,4,0.04411764705882353,0.05555555555555555
"[0, 0, 0, 0, 0, 1, 1, 0, 1, 1, 0, 1, 0, 0, 1]",161,106,55,9,3,0.08490566037735849,0.05454545454545454
"[1, 1, 0, 1, 0, 1, 1, 0, 0, 1, 0, 0, 0, 0, 0]",165,92,73,6,10,0.06521739130434782,0.136986301369863
"[1, 0, 0, 0, 0, 0, 1, 1, 0, 0, 1, 0, 0, 0, 1]",261,150,111,10,9,0.06666666666666667,0.08108108108108109
"[0, 1, 0, 1, 0, 0, 1, 0, 0, 1, 0, 0, 1, 1, 0]",142,86,56,7,8,0.08139534883720931,0.14285714285714285
"[0, 1, 0, 0, 0, 0, 1, 0, 0, 0, 0, 0, 1, 0, 1]",513,352,161,36,14,0.10227272727272728,0.08695652173913043
"[1, 0, 0, 0, 0, 1, 1, 1, 0, 1, 0, 1, 1, 0, 0]",176,69,107,13,15,0.18840579710144928,0.14018691588785046
"[0, 1, 0, 1, 0, 1, 0, 1, 0, 0, 0, 0, 0, 1, 0]",211,137,74,21,10,0.15328467153284672,0.13513513513513514
"[0, 0, 1, 0, 0, 1, 1, 0, 1, 1, 1, 0, 1, 0, 1]",118,55,63,6,4,0.10909090909090909,0.06349206349206349
"[0, 1, 1, 0, 1, 1, 0, 0, 0, 1, 1, 0, 0, 1, 0]",106,64,42,5,4,0.078125,0.09523809523809523
"[1, 0, 0, 0, 0, 1, 1, 0, 1, 1, 0, 1, 1, 1, 0]",118,50,68,9,1,0.18,0.014705882352941176
"[0, 1, 1, 1, 0, 1, 0, 0, 0, 1, 0, 1, 1, 1, 0]",132,66,66,12,10,0.18181818181818182,0.15151515151515152
"[0, 1, 1, 1, 0, 0, 1, 1, 1, 0, 1, 0, 0, 0, 1]",135,53,82,4,11,0.07547169811320754,0.13414634146341464
"[1, 1, 0, 0, 1, 0, 0, 1, 1, 0, 0, 0, 0, 1, 1]",308,149,159,14,14,0.09395973154362416,0.0880503144654088
"[1, 0, 0, 0, 1, 1, 1, 1, 0, 0, 1, 0, 0, 1, 1]",167,74,93,5,9,0.06756756756756757,0.0967741935483871
"[1, 0, 1, 1, 0, 0, 1, 1, 0, 0, 0, 0, 0, 1, 0]",193,120,73,6,7,0.05,0.0958904109589041
"[1, 0, 0, 0, 1, 0, 1, 0, 1, 0, 1, 1, 1, 0, 1]",117,63,54,9,3,0.14285714285714285,0.05555555555555555
"[1, 0, 0, 1, 1, 1, 0, 0, 0, 1, 0, 0, 1, 1, 0]",125,52,73,4,4,0.07692307692307693,0.0547945205479452
"[0, 1, 1, 0, 0, 0, 1, 0, 0, 0, 0, 0, 1, 0, 0]",535,394,141,33,13,0.08375634517766498,0.09219858156028368
"[0, 0, 0, 1, 1, 0, 0, 1, 0, 1, 0, 0, 0, 1, 1]",229,163,66,9,5,0.05521472392638037,0.07575757575757576
"[1, 1, 0, 0, 0, 0, 0, 1, 0, 1, 0, 1, 0, 1, 1]",142,74,68,4,2,0.05405405405405406,0.029411764705882353
"[1, 0, 1, 0, 1, 0, 0, 0, 1, 0, 1, 1, 1, 0, 1]",94,45,49,4,1,0.08888888888888889,0.02040816326530612
"[1, 0, 0, 1, 0, 1, 0, 1, 0, 1, 0, 1, 0, 0, 0]",145,80,65,8,12,0.1,0.18461538461538463
"[0, 1, 1, 0, 0, 0, 1, 0, 0, 0, 1, 1, 0, 0, 1]",196,125,71,17,8,0.136,0.11267605633802817
"[0, 1, 1, 0, 0, 1, 0, 1, 1, 1, 1, 0, 0, 0, 1]",112,58,54,5,3,0.08620689655172414,0.05555555555555555
"[1, 0, 0, 1, 1, 1, 1, 1, 0, 0, 1, 1, 1, 1, 0]",513,173,340,19,29,0.10982658959537572,0.08529411764705883
"[0, 0, 1, 0, 0, 0, 1, 1, 0, 0, 1, 0, 0, 1, 1]",181,107,74,10,10,0.09345794392523364,0.13513513513513514
"[0, 0, 1, 1, 1, 0, 0, 0, 1, 1, 0, 1, 1, 0, 0]",141,77,64,5,7,0.06493506493506493,0.109375
"[1, 0, 0, 1, 1, 0, 0, 1, 1, 0, 1, 1, 1, 1, 0]",236,75,161,13,17,0.17333333333333334,0.10559006211180125
"[1, 1, 1, 1, 1, 0, 1, 0, 0, 0, 0, 1, 0, 0, 1]",142,64,78,5,8,0.078125,0.10256410256410256
"[0, 1, 0, 1, 1, 0, 0, 1, 0, 1, 0, 1, 0, 0, 0]",141,81,60,6,9,0.07407407407407407,0.15
"[1, 1, 0, 1, 0, 1, 0, 0, 0, 1, 1, 0, 0, 0, 0]",231,124,107,11,10,0.08870967741935484,0.09345794392523364
"[0, 1, 0, 1, 1, 0, 0, 0, 0, 0, 1, 0, 1, 0, 0]",279,176,103,16,10,0.09090909090909091,0.0970873786407767
"[1, 1, 1, 0, 0, 1, 0, 0, 0, 0, 1, 1, 0, 1, 1]",148,64,84,4,12,0.0625,0.14285714285714285
"[1, 1, 0, 0, 0, 1, 0, 0, 1, 0, 1, 1, 1, 0, 1]",138,73,65,11,7,0.1506849315068493,0.1076923076923077
"[1, 1, 1, 0, 1, 0, 0, 0, 0, 0, 0, 1, 0, 0, 0]",250,157,93,17,8,0.10828025477707007,0.08602150537634409
"[0, 0, 0, 0, 0, 1, 0, 1, 1, 1, 1, 1, 0, 0, 1]",210,117,93,8,10,0.06837606837606838,0.10752688172043011
"[0, 0, 0, 0, 1, 1, 0, 1, 0, 1, 1, 0, 1, 0, 1]",111,64,47,5,3,0.078125,0.06382978723404255
"[0, 1, 1, 0, 0, 0, 0, 1, 1, 1, 1, 0, 0, 0, 1]",412,316,96,34,7,0.10759493670886076,0.07291666666666667
"[1, 0, 0, 0, 1, 0, 0, 0, 1, 0, 0, 1, 1, 1, 0]",162,87,75,7,8,0.08045977011494253,0.10666666666666667
"[0, 1, 0, 0, 0, 0, 1, 1, 0, 0, 0, 1, 1, 0, 0]",296,204,92,22,16,0.10784313725490197,0.17391304347826086
"[0, 0, 1, 0, 0, 0, 1, 0, 1, 1, 1, 1, 0, 1, 0]",105,50,55,3,5,0.06,0.09090909090909091
"[0, 0, 1, 1, 0, 1, 1, 1, 1, 1, 1, 1, 0, 0, 1]",396,145,251,24,22,0.16551724137931034,0.08764940239043825
"[1, 1, 1, 0, 1, 0, 1, 1, 0, 1, 0, 1, 0, 1, 1]",250,96,154,10,20,0.10416666666666667,0.12987012987012986
"[0, 1, 0, 1, 0, 0, 0, 0, 1, 1, 1, 1, 0, 0, 0]",379,235,144,20,12,0.0851063829787234,0.08333333333333333
"[0, 1, 0, 0, 1, 0, 1, 0, 0, 0, 1, 1, 1, 1, 1]",176,92,84,6,6,0.06521739130434782,0.07142857142857142
"[1, 1, 1, 1, 1, 0, 0, 1, 0, 0, 1, 0, 1, 0, 0]",131,46,85,2,7,0.043478260869565216,0.08235294117647059
"[1, 0, 0, 0, 1, 1, 1, 1, 0, 0, 1, 1, 0, 0, 1]",483,213,270,25,20,0.11737089201877934,0.07407407407407407
"[0, 0, 0, 1, 0, 0, 0, 1, 0, 0, 1, 1, 1, 1, 1]",197,114,83,10,11,0.08771929824561403,0.13253012048192772
"[1, 0, 0, 0, 0, 1, 1, 0, 1, 1, 0, 1, 0, 0, 0]",178,91,87,5,7,0.054945054945054944,0.08045977011494253
"[0, 0, 0, 0, 1, 0, 1, 0, 1, 1, 0, 0, 0, 1, 0]",254,156,98,15,10,0.09615384615384616,0.10204081632653061
"[0, 0, 1, 1, 1, 0, 0, 0, 1, 1, 1, 1, 1, 0, 0]",164,76,88,3,8,0.039473684210526314,0.09090909090909091
"[0, 1, 0, 1, 1, 1, 1, 1, 1, 0, 0, 1, 0, 0, 1]",164,75,89,6,2,0.08,0.02247191011235955
"[0, 1, 1, 1, 1, 0, 0, 1, 0, 1, 0, 1, 1, 1, 1]",375,167,208,12,20,0.0718562874251497,0.09615384615384616
"[0, 0, 1, 0, 1, 1, 1, 1, 0, 0, 1, 0, 1, 0, 1]",119,53,66,3,8,0.05660377358490566,0.12121212121212122
"[1, 0, 0, 0, 1, 0, 1, 1, 1, 1, 0, 0, 1, 0, 1]",104,44,60,2,5,0.045454545454545456,0.08333333333333333
"[0, 1, 0, 1, 0, 0, 1, 1, 1, 1, 0, 1, 1, 0, 0]",141,65,76,6,3,0.09230769230769231,0.039473684210526314
"[0, 0, 0, 1, 1, 0, 0, 0, 0, 0, 1, 0, 1, 1, 1]",490,392,98,36,12,0.09183673469387756,0.12244897959183673
"[0, 0, 0, 0, 1, 1, 0, 0, 0, 0, 0, 1, 0, 1, 1]",617,406,211,36,21,0.08866995073891626,0.0995260663507109
"[1, 1, 1, 0, 0, 0, 0, 1, 1, 1, 1, 0, 0, 1, 0]",365,91,274,11,24,0.12087912087912088,0.08759124087591241
"[0, 0, 0, 0, 0, 1, 0, 1, 1, 1, 0, 0, 0, 1, 1]",218,130,88,15,10,0.11538461538461539,0.11363636363636363
"[1, 1, 0, 0, 0, 0, 0, 1, 0, 1, 1, 1, 0, 0, 0]",206,126,80,13,9,0.10317460317460317,0.1125
"[1, 0, 1, 1, 0, 0, 0, 0, 0, 1, 0, 1, 1, 1, 0]",121,68,53,1,9,0.014705882352941176,0.16981132075471697
"[1, 1, 0, 1, 1, 0, 1, 0, 1, 1, 0, 0, 0, 1, 1]",160,64,96,6,13,0.09375,0.13541666666666666
"[0, 0, 0, 0, 1, 1, 1, 1, 1, 0, 1, 1, 0, 1, 0]",153,74,79,10,7,0.13513513513513514,0.08860759493670886
"[0, 1, 1, 1, 1, 0, 0, 1, 0, 0, 1, 1, 1, 0, 0]",151,86,65,5,7,0.05813953488372093,0.1076923076923077
"[1, 1, 0, 1, 1, 1, 0, 1, 1, 0, 0, 1, 0, 1, 0]",139,54,85,5,4,0.09259259259259259,0.047058823529411764
"[1, 1, 1, 0, 0, 1, 1, 0, 1, 1, 0, 1, 1, 1, 0]",263,70,193,9,10,0.12857142857142856,0.05181347150259067
"[0, 0, 1, 1, 0, 0, 1, 0, 1, 0, 0, 1, 0, 1, 1]",149,92,57,6,6,0.06521739130434782,0.10526315789473684
"[1, 0, 0, 1, 0, 0, 1, 0, 0, 1, 0, 1, 1, 0, 0]",162,97,65,8,3,0.08247422680412371,0.046153846153846156
"[1, 1, 0, 0, 0, 1, 0, 0, 1, 1, 1, 1, 0, 0, 1]",231,110,121,14,14,0.12727272727272726,0.11570247933884298
"[1, 1, 0, 0, 1, 0, 0, 0, 0, 1, 0, 1, 1, 1, 1]",167,77,90,10,8,0.12987012987012986,0.08888888888888889
"[1, 0, 1, 1, 0, 1, 0, 1, 0, 1, 0, 0, 0, 1, 1]",112,41,71,4,9,0.0975609756097561,0.1267605633802817
"[0, 1, 0, 1, 0, 1, 0, 1, 1, 0, 1, 0, 1, 0, 1]",109,48,61,4,8,0.08333333333333333,0.13114754098360656
"[1, 1, 0, 0, 1, 0, 1, 0, 0, 0, 1, 0, 0, 1, 0]",135,80,55,9,7,0.1125,0.12727272727272726
"[0, 1, 1, 0, 1, 1, 1, 1, 0, 0, 1, 1, 1, 0, 1]",238,95,143,9,8,0.09473684210526316,0.055944055944055944
"[1, 1, 0, 0, 1, 1, 0, 1, 1, 1, 1, 0, 0, 1, 1]",452,141,311,13,27,0.09219858156028368,0.08681672025723473
"[0, 0, 0, 1, 0, 1, 1, 1, 1, 1, 0, 0, 0, 1, 0]",115,61,54,7,7,0.11475409836065574,0.12962962962962962
"[1, 0, 0, 1, 0, 1, 1, 1, 1, 0, 0, 0, 0, 0, 0]",349,184,165,20,14,0.10869565217391304,0.08484848484848485
"[0, 0, 0, 1, 0, 0, 1, 0, 1, 1, 1, 1, 0, 0, 0]",186,103,83,7,12,0.06796116504854369,0.14457831325301204
"[1, 1, 1, 0, 0, 0, 0, 0, 1, 1, 0, 1, 0, 0, 0]",170,94,76,11,6,0.11702127659574468,0.07894736842105263
"[1, 1, 1, 1, 0, 0, 1, 0, 1, 1, 0, 1, 0, 0, 0]",134,62,72,8,5,0.12903225806451613,0.06944444444444445
"[1, 0, 0, 0, 1, 0, 1, 1, 0, 1, 1, 1, 0, 0, 1]",140,54,86,6,4,0.1111111111111111,0.046511627906976744
"[1, 0, 1, 0, 1, 1, 0, 0, 0, 1, 1, 0, 1, 0, 0]",103,57,46,9,7,0.15789473684210525,0.15217391304347827
"[1, 1, 1, 1, 1, 0, 1, 0, 0, 0, 1, 0, 1, 1, 0]",140,65,75,6,7,0.09230769230769231,0.09333333333333334
"[1, 1, 1, 0, 1, 1, 1, 0, 1, 0, 0, 1, 1, 0, 0]",192,74,118,7,5,0.0945945945945946,0.0423728813559322
"[0, 1, 0, 1, 1, 1, 0, 1, 1, 1, 1, 0, 1, 1, 0]",211,75,136,6,13,0.08,0.09558823529411764
"[1, 1, 0, 0, 1, 1, 1, 1, 0, 1, 1, 0, 0, 0, 0]",241,115,126,7,17,0.06086956521739131,0.1349206349206349
"[1, 1, 1, 1, 1, 0, 0, 1, 0, 1, 1, 0, 0, 1, 1]",394,134,260,10,22,0.07462686567164178,0.08461538461538462
"[1, 1, 0, 1, 0, 0, 0, 1, 1, 0, 1, 0, 0, 1, 1]",121,52,69,4,6,0.07692307692307693,0.08695652173913043
"[0, 0, 1, 0, 1, 1, 0, 1, 0, 0, 0, 1, 1, 0, 1]",120,75,45,8,2,0.10666666666666667,0.044444444444444446
"[0, 0, 0, 1, 1, 0, 0, 0, 1, 0, 1, 0, 0, 1, 0]",240,173,67,15,5,0.08670520231213873,0.07462686567164178
"[1, 1, 0, 0, 0, 1, 0, 0, 0, 0, 1, 1, 0, 1, 0]",135,84,51,8,2,0.09523809523809523,0.0392156862745098
"[0, 0, 1, 1, 0, 1, 1, 1, 1, 0, 0, 1, 1, 0, 0]",302,147,155,11,8,0.07482993197278912,0.05161290322580645
"[1, 0, 1, 1, 0, 1, 1, 1, 0, 0, 0, 0, 0, 1, 0]",105,56,49,10,4,0.17857142857142858,0.08163265306122448
"[0, 1, 0, 1, 1, 1, 0, 1, 0, 0, 1, 0, 0, 1, 0]",100,51,49,6,2,0.11764705882352941,0.04081632653061224
"[1, 1, 1, 0, 1, 1, 1, 0, 1, 0, 1, 0, 1, 0, 0]",139,53,86,7,6,0.1320754716981132,0.06976744186046512
"[1, 0, 1, 1, 0, 0, 0, 0, 1, 1, 0, 1, 1, 0, 1]",122,52,70,2,5,0.038461538461538464,0.07142857142857142
"[1, 0, 0, 0, 1, 1, 1, 1, 1, 1, 0, 0, 0, 0, 0]",533,280,253,21,27,0.075,0.1067193675889328
"[0, 1, 1, 1, 1, 1, 1, 1, 0, 0, 0, 1, 0, 0, 0]",174,99,75,8,5,0.08080808080808081,0.06666666666666667
"[1, 1, 0, 0, 0, 0, 0, 0, 1, 0, 0, 1, 0, 1, 0]",281,182,99,13,6,0.07142857142857142,0.06060606060606061
"[0, 0, 0, 0, 1, 1, 1, 1, 0, 0, 0, 1, 0, 1, 1]",321,188,133,12,10,0.06382978723404255,0.07518796992481203
"[0, 0, 0, 1, 0, 1, 0, 1, 1, 1, 1, 1, 1, 1, 0]",212,89,123,8,12,0.0898876404494382,0.0975609756097561
"[1, 1, 0, 0, 0, 1, 1, 0, 0, 0, 1, 1, 0, 1, 1]",147,62,85,7,9,0.11290322580645161,0.10588235294117647
"[0, 1, 1, 1, 0, 0, 1, 1, 1, 0, 0, 1, 1, 0, 0]",187,95,92,16,9,0.16842105263157894,0.09782608695652174
"[0, 0, 0, 1, 1, 0, 1, 1, 1, 0, 0, 1, 0, 1, 1]",124,69,55,10,4,0.14492753623188406,0.07272727272727272
"[1, 0, 1, 0, 1, 0, 1, 1, 0, 1, 1, 0, 0, 1, 1]",192,82,110,7,4,0.08536585365853659,0.03636363636363636
"[1, 0, 0, 0, 1, 1, 1, 1, 0, 1, 1, 1, 1, 0, 0]",184,69,115,3,8,0.043478260869565216,0.06956521739130435
"[0, 1, 1, 1, 1, 1, 0, 1, 0, 1, 0, 0, 0, 1, 1]",174,68,106,10,9,0.14705882352941177,0.08490566037735849
"[0, 0, 1, 1, 0, 1, 1, 1, 1, 1, 0, 0, 1, 0, 0]",111,57,54,5,5,0.08771929824561403,0.09259259259259259
"[0, 1, 0, 1, 1, 0, 0, 0, 0, 0, 0, 0, 1, 0, 0]",573,381,192,33,12,0.08661417322834646,0.0625
"[0, 1, 0, 1, 1, 1, 0, 1, 1, 1, 1, 1, 1, 0, 0]",358,136,222,16,19,0.11764705882352941,0.08558558558558559
"[0, 0, 1, 1, 1, 0, 0, 1, 1, 0, 0, 0, 0, 1, 0]",176,102,74,7,10,0.06862745098039216,0.13513513513513514
"[0, 0, 1, 1, 0, 0, 1, 0, 0, 0, 1, 0, 0, 1, 1]",239,126,113,12,9,0.09523809523809523,0.07964601769911504
"[1, 1, 0, 0, 0, 0, 1, 1, 1, 1, 0, 1, 1, 0, 1]",266,118,148,9,17,0.07627118644067797,0.11486486486486487
"[0, 0, 1, 1, 1, 0, 1, 0, 0, 0, 1, 1, 1, 1, 1]",275,114,161,12,14,0.10526315789473684,0.08695652173913043
"[0, 0, 1, 0, 0, 1, 0, 1, 1, 0, 1, 1, 1, 1, 1]",185,85,100,7,12,0.08235294117647059,0.12
"[0, 1, 0, 0, 1, 1, 0, 0, 0, 0, 0, 0, 1, 0, 1]",265,170,95,17,7,0.1,0.07368421052631578
"[0, 0, 1, 0, 1, 0, 0, 1, 0, 1, 1, 0, 0, 1, 1]",175,89,86,8,7,0.0898876404494382,0.08139534883720931
"[1, 0, 0, 0, 0, 1, 0, 0, 1, 0, 1, 1, 0, 1, 1]",127,60,67,7,2,0.11666666666666667,0.029850746268656716
"[0, 0, 0, 1, 0, 1, 0, 1, 1, 1, 0, 1, 0, 0, 0]",157,82,75,8,9,0.0975609756097561,0.12
"[1, 0, 1, 0, 0, 1, 0, 0, 0, 0, 0, 1, 0, 1, 0]",248,164,84,26,10,0.15853658536585366,0.11904761904761904
"[0, 1, 0, 0, 1, 0, 0, 0, 1, 1, 1, 1, 1, 0, 0]",161,83,78,12,6,0.14457831325301204,0.07692307692307693
"[0, 1, 1, 0, 0, 1, 0, 0, 1, 0, 0, 0, 1, 1, 1]",180,110,70,5,8,0.045454545454545456,0.11428571428571428
"[1, 1, 0, 1, 0, 1, 0, 1, 1, 1, 1, 1, 0, 1, 0]",219,82,137,10,11,0.12195121951219512,0.08029197080291971
"[0, 0, 1, 0, 0, 1, 1, 1, 1, 0, 0, 0, 0, 1, 0]",178,99,79,6,3,0.06060606060606061,0.0379746835443038
"[1, 0, 0, 1, 1, 1, 0, 0, 1, 1, 1, 1, 0, 0, 1]",377,137,240,10,21,0.072992700729927,0.0875
"[1, 0, 1, 1, 0, 0, 0, 1, 1, 1, 0, 1, 1, 0, 0]",135,62,73,5,6,0.08064516129032258,0.0821917808219178
"[1, 1, 0, 0, 1, 0, 1, 1, 1, 1, 0, 1, 1, 0, 0]",155,56,99,1,7,0.017857142857142856,0.0707070707070707
"[1, 0, 0, 1, 0, 1, 0, 0, 0, 0, 1, 0, 1, 1, 1]",140,65,75,6,13,0.09230769230769231,0.17333333333333334
"[1, 0, 0, 1, 0, 1, 0, 0, 1, 0, 1, 0, 0, 0, 0]",208,135,73,8,7,0.05925925925925926,0.0958904109589041
"[0, 0, 1, 0, 0, 1, 0, 1, 0, 0, 1, 0, 1, 0, 0]",216,149,67,18,11,0.12080536912751678,0.16417910447761194
"[0, 1, 1, 1, 1, 1, 0, 0, 1, 0, 0, 0, 1, 1, 0]",130,68,62,6,7,0.08823529411764706,0.11290322580645161
"[0, 1, 1, 0, 1, 1, 1, 1, 0, 0, 0, 1, 1, 1, 1]",374,151,223,13,24,0.08609271523178808,0.10762331838565023
"[1, 1, 1, 1, 0, 1, 1, 1, 0, 0, 1, 1, 1, 0, 0]",303,95,208,8,24,0.08421052631578947,0.11538461538461539
"[1, 1, 1, 0, 0, 1, 1, 1, 1, 1, 0, 0, 1, 1, 0]",488,160,328,16,25,0.1,0.07621951219512195
"[0, 1, 1, 1, 0, 0, 1, 0, 1, 1, 1, 1, 1, 1, 0]",295,88,207,8,24,0.09090909090909091,0.11594202898550725
"[1, 0, 0, 1, 0, 0, 0, 1, 1, 0, 1, 1, 1, 0, 1]",90,47,43,6,5,0.1276595744680851,0.11627906976744186
"[0, 1, 1, 1, 0, 1, 1, 0, 1, 1, 1, 0, 1, 0, 0]",152,58,94,5,14,0.08620689655172414,0.14893617021276595
"[0, 0, 1, 1, 1, 0, 1, 1, 0, 1, 1, 1, 0, 1, 0]",124,61,63,3,7,0.04918032786885246,0.1111111111111111
"[0, 1, 0, 0, 1, 1, 1, 0, 0, 1, 0, 1, 1, 1, 0]",105,53,52,5,3,0.09433962264150944,0.057692307692307696
"[0, 0, 1, 0, 0, 1, 1, 1, 0, 0, 1, 0, 1, 1, 1]",152,67,85,10,10,0.14925373134328357,0.11764705882352941
"[0, 1, 1, 0, 1, 0, 0, 0, 1, 0, 1, 0, 1, 1, 0]",103,63,40,8,2,0.12698412698412698,0.05
"[0, 1, 1, 1, 1, 0, 0, 0, 0, 1, 1, 0, 1, 1, 1]",463,314,149,39,9,0.12420382165605096,0.06040268456375839
"[0, 0, 0, 0, 1, 1, 0, 1, 1, 1, 0, 0, 0, 1, 1]",154,85,69,10,12,0.11764705882352941,0.17391304347826086
"[0, 1, 1, 1, 0, 1, 0, 0, 1, 0, 1, 0, 1, 1, 1]",164,89,75,13,7,0.14606741573033707,0.09333333333333334
"[0, 0, 1, 1, 1, 1, 0, 1, 1, 1, 1, 0, 0, 1, 0]",146,61,85,8,8,0.13114754098360656,0.09411764705882353
"[0, 1, 1, 0, 1, 0, 0, 0, 0, 1, 0, 1, 0, 0, 1]",139,79,60,4,3,0.05063291139240506,0.05
"[1, 1, 1, 0, 0, 1, 1, 0, 1, 0, 0, 0, 0, 1, 0]",130,63,67,5,9,0.07936507936507936,0.13432835820895522
"[0, 0, 1, 0, 0, 1, 1, 0, 0, 1, 0, 1, 0, 1, 1]",128,74,54,9,5,0.12162162162162163,0.09259259259259259
"[1, 1, 1, 0, 1, 1, 0, 1, 1, 0, 1, 0, 0, 1, 0]",148,72,76,5,7,0.06944444444444445,0.09210526315789473
"[0, 0, 0, 0, 1, 1, 0, 0, 1, 0, 1, 1, 1, 1, 1]",316,163,153,27,17,0.1656441717791411,0.1111111111111111
"[1, 0, 1, 1, 1, 0, 1, 0, 1, 1, 0, 1, 1, 0, 0]",122,42,80,2,5,0.047619047619047616,0.0625
"[0, 0, 0, 1, 0, 1, 0, 0, 0, 1, 1, 1, 0, 0, 0]",272,179,93,22,8,0.12290502793296089,0.08602150537634409
"[1, 0, 1, 1, 0, 1, 0, 1, 0, 0, 1, 0, 1, 1, 1]",164,69,95,4,9,0.057971014492753624,0.09473684210526316
"[1, 0, 0, 0, 1, 0, 1, 1, 0, 0, 1, 1, 0, 1, 0]",114,64,50,9,5,0.140625,0.1
"[1, 0, 0, 1, 1, 1, 1, 1, 0, 1, 0, 0, 0, 1, 1]",232,82,150,6,13,0.07317073170731707,0.08666666666666667
"[0, 1, 0, 0, 0, 1, 0, 0, 1, 1, 1, 1, 1, 0, 1]",121,59,62,9,5,0.15254237288135594,0.08064516129032258
"[1, 1, 1, 0, 1, 1, 0, 0, 0, 0, 0, 0, 0, 0, 1]",356,178,178,14,21,0.07865168539325842,0.11797752808988764
"[0, 0, 1, 0, 1, 1, 1, 0, 1, 1, 1, 1, 0, 1, 0]",129,57,72,12,5,0.21052631578947367,0.06944444444444445
"[0, 0, 1, 0, 0, 1, 1, 0, 1, 0, 0, 1, 1, 1, 1]",175,91,84,4,12,0.04395604395604396,0.14285714285714285
"[1, 1, 0, 1, 1, 1, 1, 0, 1, 1, 1, 0, 1, 0, 0]",262,98,164,14,19,0.14285714285714285,0.11585365853658537
"[1, 0, 1, 0, 0, 0, 0, 0, 1, 0, 0, 1, 0, 1, 0]",199,128,71,12,8,0.09375,0.11267605633802817
"[0, 1, 0, 0, 1, 1, 1, 0, 1, 1, 0, 1, 1, 0, 0]",107,48,59,6,7,0.125,0.11864406779661017
"[0, 0, 1, 0, 1, 1, 1, 0, 0, 0, 1, 1, 0, 1, 1]",116,58,58,5,6,0.08620689655172414,0.10344827586206896
"[0, 0, 1, 0, 1, 0, 1, 1, 1, 1, 1, 1, 0, 1, 1]",251,90,161,12,8,0.13333333333333333,0.049689440993788817
"[0, 1, 1, 1, 0, 1, 1, 0, 0, 0, 1, 0, 0, 1, 1]",128,61,67,6,8,0.09836065573770492,0.11940298507462686
"[0, 0, 0, 1, 1, 0, 1, 1, 0, 0, 0, 1, 1, 1, 1]",226,120,106,12,13,0.1,0.12264150943396226
"[0, 1, 0, 1, 0, 1, 0, 0, 0, 1, 1, 0, 1, 1, 0]",111,58,53,8,6,0.13793103448275862,0.11320754716981132
"[1, 0, 0, 0, 0, 1, 0, 1, 0, 0, 0, 0, 1, 0, 0]",530,387,143,32,15,0.082687338501292,0.1048951048951049
"[0, 1, 0, 1, 1, 1, 0, 1, 0, 1, 1, 1, 0, 0, 1]",145,60,85,6,8,0.1,0.09411764705882353
"[1, 0, 0, 0, 1, 1, 1, 1, 0, 0, 1, 1, 0, 0, 0]",443,238,205,29,24,0.12184873949579832,0.11707317073170732
"[1, 1, 0, 1, 0, 0, 1, 1, 0, 0, 1, 1, 0, 0, 1]",272,122,150,12,13,0.09836065573770492,0.08666666666666667
"[0, 0, 1, 0, 0, 0, 0, 1, 1, 1, 0, 0, 0, 1, 0]",245,151,94,17,4,0.11258278145695365,0.0425531914893617
"[0, 0, 1, 1, 1, 0, 0, 0, 1, 1, 0, 0, 1, 1, 0]",181,93,88,12,5,0.12903225806451613,0.056818181818181816
"[0, 0, 0, 1, 1, 1, 0, 1, 1, 1, 1, 1, 0, 1, 0]",133,65,68,7,8,0.1076923076923077,0.11764705882352941
"[0, 1, 0, 0, 0, 1, 1, 1, 0, 1, 1, 1, 1, 1, 0]",153,69,84,10,8,0.14492753623188406,0.09523809523809523
"[0, 1, 0, 1, 0, 0, 0, 1, 1, 1, 0, 1, 1, 1, 1]",164,86,78,11,7,0.12790697674418605,0.08974358974358974
"[0, 1, 1, 0, 1, 0, 1, 1, 1, 0, 1, 0, 1, 0, 0]",101,53,48,3,4,0.05660377358490566,0.08333333333333333
"[0, 0, 1, 0, 1, 1, 0, 1, 1, 1, 0, 1, 1, 1, 0]",128,47,81,2,4,0.0425531914893617,0.04938271604938271
"[1, 0, 1, 0, 0, 1, 1, 0, 0, 0, 1, 0, 1, 0, 0]",137,87,50,12,4,0.13793103448275862,0.08
"[0, 1, 0, 1, 1, 1, 0, 1, 1, 0, 1, 1, 1, 0, 0]",158,64,94,8,5,0.125,0.05319148936170213
"[1, 1, 1, 1, 0, 0, 0, 1, 1, 1, 1, 0, 0, 0, 0]",357,157,200,21,16,0.1337579617834395,0.08
"[1, 0, 0, 0, 1, 1, 1, 0, 1, 1, 0, 0, 1, 1, 0]",152,65,87,5,11,0.07692307692307693,0.12643678160919541
"[1, 1, 0, 1, 0, 0, 1, 0, 0, 0, 1, 1, 1, 1, 0]",150,68,82,7,3,0.10294117647058823,0.036585365853658534
"[0, 0, 1, 1, 0, 1, 1, 0, 1, 0, 0, 1, 0, 0, 0]",153,84,69,8,12,0.09523809523809523,0.17391304347826086
"[0, 0, 0, 0, 1, 1, 1, 0, 0, 1, 1, 0, 1, 1, 0]",133,70,63,6,7,0.08571428571428572,0.1111111111111111
"[0, 1, 1, 0, 0, 0, 0, 1, 0, 0, 1, 0, 0, 0, 1]",300,204,96,18,14,0.08823529411764706,0.14583333333333334
"[0, 0, 1, 0, 0, 0, 1, 0, 1, 1, 1, 0, 0, 1, 0]",145,69,76,5,3,0.07246376811594203,0.039473684210526314
"[1, 0, 1, 0, 0, 0, 1, 0, 1, 1, 0, 1, 1, 0, 0]",100,53,47,7,2,0.1320754716981132,0.0425531914893617
"[0, 0, 1, 0, 1, 1, 1, 0, 0, 1, 1, 0, 0, 1, 0]",134,65,69,10,3,0.15384615384615385,0.043478260869565216
"[0, 1, 0, 1, 1, 1, 1, 0, 1, 0, 1, 1, 0, 0, 0]",138,62,76,7,7,0.11290322580645161,0.09210526315789473
"[0, 1, 1, 1, 0, 0, 1, 0, 0, 0, 1, 0, 0, 1, 1]",145,87,58,13,11,0.14942528735632185,0.1896551724137931
"[0, 1, 1, 0, 1, 0, 1, 1, 1, 1, 1, 1, 1, 0, 0]",380,150,230,16,25,0.10666666666666667,0.10869565217391304
"[1, 1, 1, 0, 0, 1, 0, 0, 0, 1, 1, 1, 0, 0, 0]",138,78,60,6,4,0.07692307692307693,0.06666666666666667
"[1, 1, 0, 1, 1, 1, 0, 1, 1, 0, 1, 1, 0, 0, 0]",159,72,87,11,7,0.1527777777777778,0.08045977011494253
"[0, 0, 0, 1, 1, 1, 0, 1, 1, 1, 1, 1, 1, 0, 1]",256,110,146,8,11,0.07272727272727272,0.07534246575342465
"[1, 0, 1, 0, 0, 1, 1, 1, 0, 1, 0, 0, 0, 0, 0]",177,100,77,5,7,0.05,0.09090909090909091
"[1, 0, 1, 0, 1, 0, 0, 1, 1, 1, 0, 1, 0, 0, 0]",133,64,69,7,8,0.109375,0.11594202898550725
"[1, 0, 0, 1, 0, 0, 0, 1, 1, 1, 1, 1, 1, 0, 0]",251,110,141,11,11,0.1,0.07801418439716312
"[1, 1, 1, 0, 1, 0, 0, 1, 0, 0, 1, 0, 1, 0, 0]",112,56,56,10,7,0.17857142857142858,0.125
"[0, 1, 0, 0, 1, 1, 0, 0, 0, 0, 0, 1, 1, 0, 1]",167,96,71,9,8,0.09375,0.11267605633802817
"[1, 1, 1, 0, 1, 1, 1, 1, 0, 1, 0, 0, 1, 1, 0]",270,80,190,8,17,0.1,0.08947368421052632
"[1, 0, 0, 0, 0, 0, 0, 1, 1, 0, 1, 0, 0, 1, 0]",282,150,132,8,12,0.05333333333333334,0.09090909090909091
"[1, 1, 0, 0, 0, 1, 1, 1, 0, 1, 1, 1, 1, 1, 0]",261,110,151,9,12,0.08181818181818182,0.07947019867549669
"[0, 1, 0, 1, 1, 1, 0, 0, 0, 1, 1, 1, 0, 1, 1]",156,71,85,8,6,0.11267605633802817,0.07058823529411765
"[1, 1, 1, 1, 1, 1, 0, 1, 0, 0, 1, 1, 1, 1, 0]",719,211,508,20,48,0.0947867298578199,0.09448818897637795
"[0, 1, 0, 1, 0, 0, 1, 0, 0, 0, 0, 1, 0, 1, 1]",149,91,58,7,5,0.07692307692307693,0.08620689655172414
"[1, 0, 1, 1, 1, 0, 1, 0, 1, 1, 1, 1, 1, 0, 0]",292,92,200,12,19,0.13043478260869565,0.095
"[1, 0, 1, 1, 0, 0, 1, 0, 1, 0, 1, 1, 0, 0, 1]",150,69,81,9,13,0.13043478260869565,0.16049382716049382
"[1, 0, 1, 0, 1, 0, 0, 0, 1, 0, 0, 0, 0, 1, 0]",201,138,63,8,4,0.057971014492753624,0.06349206349206349
"[0, 0, 1, 1, 1, 0, 0, 0, 1, 0, 1, 0, 0, 1, 0]",148,94,54,8,4,0.0851063829787234,0.07407407407407407
"[0, 1, 1, 1, 0, 1, 1, 0, 0, 1, 1, 0, 1, 0, 0]",108,53,55,5,10,0.09433962264150944,0.18181818181818182
"[0, 1, 0, 1, 1, 1, 1, 1, 1, 1, 1, 0, 1, 0, 0]",279,100,179,11,14,0.11,0.0782122905027933
"[0, 0, 0, 1, 0, 0, 1, 1, 0, 1, 1, 0, 1, 0, 1]",93,60,33,7,3,0.11666666666666667,0.09090909090909091
"[0, 0, 0, 0, 1, 0, 1, 0, 1, 1, 0, 1, 1, 1, 1]",165,89,76,2,11,0.02247191011235955,0.14473684210526316
"[1, 0, 1, 1, 0, 0, 0, 0, 1, 1, 1, 0, 0, 0, 1]",121,57,64,3,6,0.05263157894736842,0.09375
"[0, 0, 0, 0, 1, 0, 1, 0, 1, 0, 0, 1, 0, 0, 1]",223,141,82,11,6,0.07801418439716312,0.07317073170731707
"[1, 1, 0, 1, 1, 1, 0, 0, 1, 0, 1, 0, 0, 1, 0]",119,57,62,8,5,0.14035087719298245,0.08064516129032258
"[1, 0, 1, 0, 0, 0, 1, 0, 1, 0, 0, 1, 0, 1, 0]",119,59,60,4,5,0.06779661016949153,0.08333333333333333
"[0, 0, 0, 0, 0, 1, 1, 1, 1, 0, 0, 0, 1, 1, 1]",528,416,112,42,16,0.10096153846153846,0.14285714285714285
"[0, 0, 0, 1, 0, 0, 1, 1, 0, 1, 1, 0, 0, 0, 0]",306,178,128,11,22,0.06179775280898876,0.171875
"[1, 1, 1, 0, 0, 0, 1, 1, 0, 1, 1, 1, 1, 0, 0]",214,82,132,14,14,0.17073170731707318,0.10606060606060606
"[0, 1, 1, 1, 1, 1, 0, 0, 0, 0, 0, 1, 0, 0, 0]",204,117,87,14,21,0.11965811965811966,0.2413793103448276
"[1, 0, 1, 1, 1, 0, 1, 1, 0, 0, 1, 1, 0, 1, 1]",237,91,146,11,11,0.12087912087912088,0.07534246575342465
"[1, 0, 1, 1, 1, 1, 1, 0, 1, 1, 1, 1, 0, 1, 0]",478,146,332,7,31,0.04794520547945205,0.09337349397590361
"[0, 1, 1, 0, 1, 1, 1, 0, 1, 0, 0, 1, 1, 1, 1]",329,134,195,11,18,0.08208955223880597,0.09230769230769231
"[1, 1, 1, 0, 0, 0, 0, 1, 1, 0, 1, 1, 1, 0, 1]",204,57,147,6,16,0.10526315789473684,0.10884353741496598
"[1, 1, 0, 1, 1, 1, 0, 1, 1, 1, 0, 0, 0, 0, 1]",193,63,130,4,9,0.06349206349206349,0.06923076923076923
"[1, 0, 0, 1, 0, 1, 1, 0, 1, 0, 0, 1, 1, 0, 0]",162,88,74,3,9,0.03409090909090909,0.12162162162162163
"[0, 1, 0, 0, 1, 0, 1, 1, 0, 1, 0, 0, 1, 1, 0]",142,71,71,4,9,0.056338028169014086,0.1267605633802817
"[1, 0, 1, 0, 0, 0, 1, 1, 1, 1, 1, 0, 1, 0, 1]",144,53,91,7,8,0.1320754716981132,0.08791208791208792
"[0, 1, 0, 0, 0, 1, 1, 0, 1, 1, 0, 1, 1, 1, 1]",175,78,97,8,11,0.10256410256410256,0.1134020618556701
"[0, 1, 1, 0, 0, 1, 1, 1, 1, 0, 1, 0, 1, 0, 0]",177,104,73,15,3,0.14423076923076922,0.0410958904109589
"[1, 0, 0, 1, 0, 0, 0, 1, 0, 1, 0, 0, 1, 0, 0]",254,161,93,14,12,0.08695652173913043,0.12903225806451613
"[0, 0, 0, 1, 1, 0, 0, 1, 0, 0, 1, 1, 1, 1, 0]",205,125,80,9,8,0.072,0.1
"[1, 1, 0, 0, 0, 0, 0, 1, 1, 0, 1, 0, 1, 1, 0]",136,77,59,5,5,0.06493506493506493,0.0847457627118644
"[0, 0, 0, 1, 0, 1, 0, 1, 0, 0, 1, 1, 1, 1, 0]",149,81,68,14,8,0.1728395061728395,0.11764705882352941
"[1, 1, 1, 1, 1, 0, 0, 0, 0, 1, 0, 1, 1, 1, 1]",556,135,421,13,45,0.0962962962962963,0.10688836104513064
"[0, 1, 1, 0, 1, 1, 0, 0, 0, 0, 0, 1, 0, 1, 1]",148,73,75,6,6,0.0821917808219178,0.08
"[1, 1, 0, 0, 1, 0, 1, 1, 0, 1, 1, 0, 0, 0, 0]",170,80,90,4,5,0.05,0.05555555555555555
"[0, 1, 0, 1, 1, 0, 1, 0, 1, 1, 0, 1, 0, 0, 0]",120,73,47,4,3,0.0547945205479452,0.06382978723404255
"[1, 0, 0, 1, 0, 1, 1, 0, 0, 1, 1, 0, 1, 0, 0]",122,66,56,6,3,0.09090909090909091,0.05357142857142857
"[1, 0, 1, 0, 0, 1, 0, 1, 1, 0, 0, 1, 1, 0, 1]",106,51,55,2,5,0.0392156862745098,0.09090909090909091
"[1, 0, 1, 0, 1, 1, 0, 1, 0, 0, 1, 0, 1, 1, 0]",107,55,52,4,7,0.07272727272727272,0.1346153846153846
"[0, 1, 0, 0, 1, 1, 0, 0, 1, 0, 1, 1, 0, 1, 0]",101,61,40,5,4,0.08196721311475409,0.1
"[1, 1, 1, 0, 1, 0, 1, 1, 0, 0, 0, 1, 0, 0, 1]",130,55,75,2,9,0.03636363636363636,0.12
"[1, 0, 0, 1, 1, 1, 1, 0, 0, 0, 1, 1, 0, 1, 0]",152,47,105,2,7,0.0425531914893617,0.06666666666666667
"[1, 0, 0, 1, 0, 0, 1, 1, 1, 1, 0, 0, 0, 1, 1]",163,75,88,6,7,0.08,0.07954545454545454
"[1, 0, 0, 1, 0, 0, 1, 1, 0, 0, 1, 0, 1, 1, 1]",119,63,56,4,2,0.06349206349206349,0.03571428571428571
"[1, 1, 1, 0, 0, 1, 0, 0, 1, 1, 0, 0, 1, 0, 1]",94,45,49,4,2,0.08888888888888889,0.04081632653061224
"[1, 1, 0, 0, 0, 1, 1, 1, 0, 0, 1, 1, 0, 1, 0]",106,50,56,4,12,0.08,0.21428571428571427
"[0, 1, 0, 0, 0, 0, 0, 1, 0, 0, 0, 1, 0, 1, 0]",489,329,160,20,15,0.060790273556231005,0.09375
"[0, 0, 0, 0, 1, 1, 1, 1, 1, 1, 1, 0, 1, 0, 0]",246,122,124,13,10,0.10655737704918032,0.08064516129032258
"[0, 1, 1, 1, 0, 1, 0, 1, 1, 1, 1, 0, 0, 0, 0]",229,123,106,13,11,0.10569105691056911,0.10377358490566038
"[1, 0, 0, 0, 1, 0, 1, 0, 1, 1, 1, 1, 0, 1, 0]",101,48,53,8,9,0.16666666666666666,0.16981132075471697
"[0, 1, 0, 1, 0, 1, 1, 0, 0, 0, 0, 0, 1, 0, 0]",230,154,76,13,6,0.08441558441558442,0.07894736842105263
"[0, 0, 1, 0, 1, 1, 1, 0, 0, 1, 1, 1, 0, 1, 0]",101,47,54,5,4,0.10638297872340426,0.07407407407407407
"[0, 1, 0, 1, 1, 0, 1, 0, 1, 0, 0, 0, 0, 1, 1]",130,68,62,8,3,0.11764705882352941,0.04838709677419355
"[1, 1, 1, 0, 1, 0, 0, 1, 0, 0, 1, 1, 1, 1, 0]",177,67,110,2,15,0.029850746268656716,0.13636363636363635
"[1, 0, 0, 1, 0, 1, 0, 0, 0, 0, 1, 1, 0, 0, 1]",206,121,85,17,12,0.14049586776859505,0.1411764705882353
"[0, 1, 1, 0, 0, 1, 1, 0, 1, 1, 0, 1, 0, 1, 1]",144,70,74,13,12,0.18571428571428572,0.16216216216216217
"[1, 0, 0, 0, 1, 1, 0, 0, 1, 1, 0, 1, 0, 0, 0]",155,88,67,10,5,0.11363636363636363,0.07462686567164178
"[1, 1, 0, 1, 0, 0, 1, 0, 0, 1, 1, 0, 0, 0, 1]",134,68,66,9,9,0.1323529411764706,0.13636363636363635
"[0, 0, 1, 0, 0, 1, 1, 0, 0, 1, 1, 0, 0, 0, 1]",184,100,84,12,15,0.12,0.17857142857142858
"[1, 1, 1, 1, 0, 0, 1, 1, 0, 1, 1, 1, 0, 1, 0]",282,100,182,12,11,0.12,0.06043956043956044
"[0, 1, 0, 0, 1, 1, 0, 1, 1, 1, 0, 0, 1, 0, 0]",92,47,45,2,6,0.0425531914893617,0.13333333333333333
"[0, 0, 1, 0, 0, 0, 1, 1, 1, 0, 1, 1, 1, 0, 0]",88,50,38,4,8,0.08,0.21052631578947367
"[0, 0, 1, 1, 0, 1, 1, 1, 0, 0, 0, 0, 1, 0, 0]",147,80,67,8,4,0.1,0.05970149253731343
"[1, 0, 0, 1, 1, 1, 0, 1, 1, 0, 1, 1, 1, 1, 0]",239,93,146,11,14,0.11827956989247312,0.0958904109589041
"[0, 0, 0, 1, 1, 1, 1, 0, 0, 0, 1, 1, 1, 0, 1]",155,108,47,15,5,0.1388888888888889,0.10638297872340426
"[1, 1, 0, 1, 0, 0, 0, 0, 1, 1, 1, 0, 1, 0, 0]",127,57,70,5,6,0.08771929824561403,0.08571428571428572
"[1, 0, 1, 0, 1, 0, 1, 1, 0, 0, 0, 0, 0, 1, 1]",163,94,69,11,6,0.11702127659574468,0.08695652173913043
"[0, 0, 1, 1, 0, 0, 1, 0, 1, 0, 0, 0, 1, 1, 0]",157,98,59,5,3,0.05102040816326531,0.05084745762711865
"[0, 1, 0, 0, 0, 1, 1, 1, 1, 1, 1, 1, 0, 0, 0]",225,107,118,11,10,0.102803738317757,0.0847457627118644
"[1, 1, 0, 1, 0, 1, 0, 0, 0, 1, 1, 1, 1, 1, 1]",409,157,252,11,28,0.07006369426751592,0.1111111111111111
"[0, 1, 1, 1, 0, 1, 1, 0, 0, 1, 0, 1, 1, 0, 0]",125,62,63,2,3,0.03225806451612903,0.047619047619047616
"[0, 1, 1, 0, 1, 1, 1, 0, 0, 0, 1, 0, 0, 1, 0]",115,62,53,5,3,0.08064516129032258,0.05660377358490566
"[1, 1, 0, 1, 0, 0, 1, 1, 1, 1, 0, 0, 0, 1, 1]",213,89,124,12,14,0.1348314606741573,0.11290322580645161
"[0, 1, 1, 1, 0, 0, 1, 0, 1, 0, 1, 0, 1, 1, 1]",161,79,82,9,6,0.11392405063291139,0.07317073170731707
"[0, 1, 0, 0, 1, 0, 1, 0, 0, 0, 1, 1, 1, 0, 0]",170,110,60,8,7,0.07272727272727272,0.11666666666666667
"[0, 0, 1, 0, 1, 0, 1, 1, 1, 0, 0, 1, 0, 1, 1]",126,65,61,9,6,0.13846153846153847,0.09836065573770492
"[0, 0, 1, 0, 0, 0, 1, 0, 1, 1, 0, 1, 1, 0, 0]",188,120,68,9,10,0.075,0.14705882352941177
"[0, 0, 0, 0, 1, 0, 1, 1, 0, 0, 0, 1, 0, 1, 1]",175,112,63,5,4,0.044642857142857144,0.06349206349206349
"[1, 1, 0, 0, 0, 1, 0, 1, 1, 1, 1, 1, 0, 1, 1]",277,87,190,7,14,0.08045977011494253,0.07368421052631578
"[1, 0, 1, 1, 0, 1, 0, 0, 1, 1, 1, 1, 1, 0, 0]",192,78,114,9,12,0.11538461538461539,0.10526315789473684
"[1, 0, 0, 1, 1, 1, 0, 0, 1, 1, 1, 0, 0, 0, 0]",168,68,100,4,9,0.058823529411764705,0.09
"[1, 0, 1, 1, 1, 0, 1, 0, 0, 0, 0, 0, 0, 0, 1]",194,108,86,14,5,0.12962962962962962,0.05813953488372093
"[1, 0, 1, 0, 1, 1, 0, 0, 1, 0, 0, 1, 0, 0, 0]",153,96,57,5,9,0.052083333333333336,0.15789473684210525
"[0, 0, 0, 0, 1, 0, 0, 0, 1, 1, 1, 1, 0, 1, 0]",157,99,58,12,6,0.12121212121212122,0.10344827586206896
"[1, 1, 1, 1, 1, 1, 0, 0, 1, 0, 0, 0, 0, 1, 0]",137,65,72,3,5,0.046153846153846156,0.06944444444444445
"[1, 1, 1, 1, 1, 0, 1, 0, 0, 0, 1, 0, 1, 0, 0]",125,57,68,6,10,0.10526315789473684,0.14705882352941177
"[1, 0, 0, 0, 1, 1, 1, 1, 1, 0, 0, 1, 0, 1, 1]",145,58,87,6,14,0.10344827586206896,0.16091954022988506
"[1, 1, 0, 1, 0, 1, 0, 0, 1, 0, 1, 1, 0, 0, 0]",128,79,49,6,6,0.0759493670886076,0.12244897959183673
"[1, 1, 0, 1, 1, 0, 1, 1, 1, 1, 0, 0, 0, 0, 1]",299,113,186,11,15,0.09734513274336283,0.08064516129032258
"[1, 0, 0, 1, 1, 0, 0, 1, 1, 0, 1, 1, 1, 0, 1]",196,39,157,5,13,0.1282051282051282,0.08280254777070063
"[1, 0, 1, 0, 1, 1, 1, 0, 0, 1, 1, 0, 0, 1, 1]",332,120,212,5,18,0.041666666666666664,0.08490566037735849
"[1, 1, 0, 0, 1, 1, 1, 1, 0, 1, 0, 1, 0, 0, 0]",192,89,103,15,5,0.16853932584269662,0.04854368932038835
"[1, 1, 0, 0, 1, 0, 0, 0, 1, 0, 1, 1, 0, 1, 0]",90,44,46,6,4,0.13636363636363635,0.08695652173913043
"[1, 0, 1, 1, 0, 1, 0, 0, 1, 0, 0, 1, 1, 0, 1]",109,49,60,13,10,0.2653061224489796,0.16666666666666666
"[0, 1, 0, 1, 1, 0, 1, 0, 1, 0, 1, 1, 1, 0, 0]",123,60,63,11,7,0.18333333333333332,0.1111111111111111
"[1, 1, 0, 0, 1, 1, 0, 0, 1, 0, 1, 1, 0, 1, 0]",133,61,72,6,10,0.09836065573770492,0.1388888888888889
"[0, 1, 1, 0, 1, 1, 1, 1, 1, 1, 0, 1, 0, 1, 0]",222,81,141,9,15,0.1111111111111111,0.10638297872340426
"[0, 1, 0, 0, 0, 1, 0, 1, 0, 1, 1, 0, 0, 1, 0]",116,61,55,7,9,0.11475409836065574,0.16363636363636364
"[0, 1, 1, 0, 0, 0, 1, 0, 0, 1, 1, 1, 0, 1, 0]",105,59,46,7,2,0.11864406779661017,0.043478260869565216
"[1, 0, 1, 1, 0, 0, 0, 1, 0, 0, 1, 1, 1, 0, 1]",102,58,44,6,1,0.10344827586206896,0.022727272727272728
"[1, 0, 0, 0, 0, 1, 1, 0, 1, 1, 0, 0, 1, 0, 0]",178,97,81,6,3,0.061855670103092786,0.037037037037037035
"[1, 1, 1, 0, 1, 0, 1, 0, 1, 0, 0, 1, 1, 0, 0]",141,66,75,8,7,0.12121212121212122,0.09333333333333334
"[1, 0, 1, 0, 1, 0, 0, 1, 0, 0, 1, 1, 1, 1, 0]",134,64,70,7,5,0.109375,0.07142857142857142
"[1, 0, 1, 1, 1, 0, 1, 1, 1, 0, 1, 0, 1, 0, 1]",227,84,143,6,13,0.07142857142857142,0.09090909090909091
"[1, 0, 0, 0, 0, 1, 0, 1, 1, 1, 1, 0, 1, 0, 1]",102,47,55,8,6,0.1702127659574468,0.10909090909090909
"[1, 1, 0, 1, 1, 1, 1, 0, 0, 1, 1, 0, 0, 1, 0]",187,73,114,11,9,0.1506849315068493,0.07894736842105263
"[1, 1, 0, 0, 1, 0, 0, 0, 1, 0, 1, 0, 1, 1, 1]",99,38,61,3,5,0.07894736842105263,0.08196721311475409
"[0, 1, 1, 0, 0, 1, 0, 0, 0, 1, 0, 1, 0, 1, 1]",77,50,27,3,1,0.06,0.037037037037037035
"[1, 1, 1, 0, 1, 0, 1, 1, 0, 1, 0, 1, 1, 1, 1]",597,182,415,19,40,0.1043956043956044,0.0963855421686747
"[1, 1, 0, 0, 0, 1, 1, 0, 1, 0, 1, 1, 1, 0, 0]",133,64,69,5,4,0.078125,0.057971014492753624
"[0, 0, 1, 1, 0, 1, 1, 0, 1, 1, 0, 1, 1, 0, 1]",150,71,79,11,10,0.15492957746478872,0.12658227848101267
"[0, 0, 1, 1, 0, 0, 0, 1, 1, 0, 1, 1, 0, 1, 1]",147,70,77,5,5,0.07142857142857142,0.06493506493506493
"[0, 0, 1, 1, 1, 0, 1, 0, 0, 1, 0, 0, 0, 1, 0]",138,83,55,10,5,0.12048192771084337,0.09090909090909091
"[0, 0, 1, 1, 0, 1, 0, 1, 1, 1, 0, 1, 0, 0, 1]",101,52,49,3,4,0.057692307692307696,0.08163265306122448
"[0, 1, 1, 0, 1, 1, 0, 0, 1, 0, 0, 1, 0, 1, 1]",124,60,64,5,6,0.08333333333333333,0.09375
"[1, 1, 0, 1, 1, 1, 0, 0, 1, 1, 1, 0, 1, 0, 1]",247,87,160,7,15,0.08045977011494253,0.09375
"[0, 1, 0, 0, 0, 0, 0, 0, 1, 1, 1, 1, 1, 0, 0]",256,165,91,15,6,0.09090909090909091,0.06593406593406594
"[1, 0, 0, 0, 1, 1, 1, 0, 0, 0, 0, 1, 1, 0, 1]",119,64,55,6,10,0.09375,0.18181818181818182
"[0, 0, 0, 1, 0, 0, 1, 1, 0, 1, 1, 1, 0, 1, 0]",102,57,45,5,6,0.08771929824561403,0.13333333333333333
"[1, 0, 0, 0, 1, 0, 0, 1, 0, 0, 1, 1, 1, 1, 1]",172,81,91,10,7,0.12345679012345678,0.07692307692307693
"[1, 1, 1, 1, 1, 1, 0, 0, 1, 0, 0, 0, 1, 0, 0]",161,88,73,8,3,0.09090909090909091,0.0410958904109589
"[1, 1, 0, 1, 0, 0, 0, 1, 0, 1, 0, 1, 0, 1, 0]",114,61,53,4,7,0.06557377049180328,0.1320754716981132
"[0, 1, 0, 0, 1, 1, 1, 1, 1, 0, 1, 1, 1, 0, 1]",236,86,150,8,13,0.09302325581395349,0.08666666666666667
"[1, 0, 1, 1, 0, 1, 1, 1, 0, 1, 1, 0, 1, 0, 1]",224,80,144,6,11,0.075,0.0763888888888889
"[0, 0, 0, 1, 0, 1, 1, 1, 1, 1, 0, 1, 0, 0, 1]",130,57,73,2,9,0.03508771929824561,0.1232876712328767
"[0, 1, 1, 0, 1, 0, 1, 0, 1, 0, 1, 0, 0, 0, 0]",176,86,90,8,9,0.09302325581395349,0.1
"[0, 1, 0, 1, 1, 0, 1, 0, 1, 0, 1, 0, 1, 0, 0]",117,73,44,4,5,0.0547945205479452,0.11363636363636363
"[0, 0, 1, 0, 0, 0, 0, 1, 1, 1, 0, 1, 0, 0, 0]",261,174,87,21,6,0.1206896551724138,0.06896551724137931
"[0, 1, 0, 0, 1, 0, 0, 1, 1, 1, 0, 1, 1, 1, 1]",160,64,96,7,9,0.109375,0.09375
"[0, 0, 1, 1, 0, 1, 1, 0, 1, 0, 0, 1, 0, 0, 1]",129,67,62,4,4,0.05970149253731343,0.06451612903225806
"[1, 0, 0, 0, 1, 0, 1, 1, 1, 0, 0, 0, 1, 1, 0]",129,65,64,5,6,0.07692307692307693,0.09375
"[0, 1, 1, 0, 0, 0, 1, 0, 1, 1, 1, 0, 0, 0, 1]",117,66,51,9,6,0.13636363636363635,0.11764705882352941
"[0, 1, 0, 1, 1, 1, 0, 0, 0, 0, 1, 1, 0, 1, 1]",148,68,80,6,2,0.08823529411764706,0.025
"[0, 0, 1, 1, 1, 1, 0, 1, 1, 0, 0, 1, 0, 1, 0]",128,56,72,2,9,0.03571428571428571,0.125
"[0, 1, 0, 0, 1, 1, 1, 1, 0, 1, 1, 0, 0, 1, 0]",116,53,63,5,6,0.09433962264150944,0.09523809523809523
"[0, 0, 1, 1, 1, 1, 0, 0, 1, 0, 1, 0, 0, 1, 1]",200,99,101,7,7,0.0707070707070707,0.06930693069306931
"[1, 0, 0, 1, 1, 1, 1, 0, 0, 1, 0, 1, 0, 0, 1]",177,62,115,11,12,0.1774193548387097,0.10434782608695652
"[0, 0, 0, 1, 1, 0, 0, 0, 1, 1, 1, 0, 1, 1, 1]",210,135,75,15,8,0.1111111111111111,0.10666666666666667
"[0, 0, 1, 0, 0, 1, 0, 1, 1, 1, 1, 0, 1, 0, 0]",94,56,38,2,1,0.03571428571428571,0.02631578947368421
"[0, 1, 1, 1, 0, 1, 0, 1, 1, 0, 1, 1, 0, 1, 0]",143,72,71,5,5,0.06944444444444445,0.07042253521126761
"[0, 0, 0, 1, 1, 0, 1, 0, 1, 0, 1, 0, 1, 1, 1]",181,104,77,9,3,0.08653846153846154,0.03896103896103896
"[1, 1, 0, 1, 0, 0, 0, 0, 0, 1, 0, 1, 0, 0, 1]",156,87,69,6,12,0.06896551724137931,0.17391304347826086
"[0, 1, 1, 0, 1, 1, 1, 0, 1, 0, 0, 0, 0, 0, 1]",123,74,49,8,3,0.10810810810810811,0.061224489795918366
"[1, 0, 1, 0, 0, 1, 1, 0, 0, 1, 1, 1, 1, 1, 0]",185,80,105,8,11,0.1,0.10476190476190476
"[1, 0, 0, 0, 1, 0, 0, 0, 1, 0, 1, 0, 0, 1, 1]",180,106,74,10,8,0.09433962264150944,0.10810810810810811
"[0, 0, 1, 1, 0, 0, 1, 0, 0, 1, 0, 0, 0, 1, 0]",214,132,82,14,7,0.10606060606060606,0.08536585365853659
"[1, 0, 0, 1, 1, 1, 0, 0, 1, 0, 0, 0, 0, 1, 0]",138,82,56,11,5,0.13414634146341464,0.08928571428571429
"[1, 0, 0, 1, 1, 0, 1, 0, 0, 0, 0, 1, 1, 0, 0]",250,129,121,13,13,0.10077519379844961,0.10743801652892562
"[0, 0, 0, 1, 1, 0, 1, 0, 1, 1, 0, 1, 1, 0, 0]",137,75,62,8,4,0.10666666666666667,0.06451612903225806
"[0, 0, 1, 1, 1, 0, 0, 1, 1, 1, 1, 0, 1, 1, 1]",309,116,193,11,13,0.09482758620689655,0.06735751295336788
"[0, 1, 0, 0, 1, 1, 0, 0, 1, 0, 1, 0, 0, 1, 1]",137,79,58,7,9,0.08860759493670886,0.15517241379310345
"[1, 0, 0, 1, 0, 1, 0, 0, 1, 1, 0, 0, 1, 0, 1]",111,53,58,7,7,0.1320754716981132,0.1206896551724138
"[0, 0, 0, 0, 0, 0, 1, 1, 1, 1, 0, 1, 1, 0, 0]",318,201,117,24,11,0.11940298507462686,0.09401709401709402
"[1, 1, 1, 0, 0, 1, 0, 0, 1, 0, 0, 1, 0, 1, 1]",141,66,75,8,6,0.12121212121212122,0.08
"[1, 0, 1, 1, 0, 0, 0, 1, 0, 0, 1, 1, 1, 1, 0]",151,68,83,12,7,0.17647058823529413,0.08433734939759036
"[1, 1, 1, 1, 0, 1, 0, 1, 1, 0, 1, 0, 1, 1, 1]",579,161,418,17,40,0.10559006211180125,0.09569377990430622
"[1, 1, 0, 1, 0, 1, 0, 1, 0, 0, 1, 1, 0, 1, 1]",137,53,84,5,8,0.09433962264150944,0.09523809523809523
"[0, 1, 1, 0, 1, 0, 1, 0, 1, 0, 0, 1, 1, 0, 1]",96,51,45,5,3,0.09803921568627451,0.06666666666666667
"[1, 1, 1, 0, 0, 0, 1, 1, 0, 1, 1, 0, 1, 0, 1]",154,63,91,3,5,0.047619047619047616,0.054945054945054944
"[1, 0, 0, 0, 1, 0, 0, 0, 1, 1, 1, 1, 1, 1, 1]",280,111,169,10,17,0.09009009009009009,0.10059171597633136
"[1, 1, 1, 1, 0, 0, 0, 1, 1, 1, 0, 0, 0, 1, 1]",289,97,192,5,9,0.05154639175257732,0.046875
"[1, 0, 1, 0, 1, 0, 0, 1, 1, 1, 1, 1, 0, 1, 0]",130,56,74,8,13,0.14285714285714285,0.17567567567567569
"[0, 1, 1, 0, 0, 1, 1, 1, 1, 0, 1, 1, 0, 0, 0]",203,112,91,11,11,0.09821428571428571,0.12087912087912088
"[1, 0, 1, 0, 1, 1, 1, 0, 1, 1, 0, 1, 1, 1, 0]",237,79,158,6,11,0.0759493670886076,0.06962025316455696
"[0, 1, 0, 0, 0, 1, 0, 1, 1, 0, 0, 1, 1, 0, 1]",126,69,57,8,6,0.11594202898550725,0.10526315789473684
"[0, 0, 0, 1, 1, 1, 0, 1, 1, 0, 1, 1, 1, 1, 0]",182,73,109,7,12,0.0958904109589041,0.11009174311926606
"[1, 1, 0, 1, 0, 0, 1, 0, 0, 0, 1, 1, 0, 1, 1]",109,58,51,8,3,0.13793103448275862,0.058823529411764705
"[1, 0, 0, 1, 1, 1, 1, 1, 0, 0, 1, 0, 1, 0, 0]",124,59,65,8,3,0.13559322033898305,0.046153846153846156
"[0, 1, 1, 0, 0, 0, 0, 1, 1, 0, 1, 1, 0, 0, 1]",176,109,67,7,6,0.06422018348623854,0.08955223880597014
"[1, 0, 1, 1, 1, 1, 1, 1, 0, 1, 0, 1, 0, 0, 1]",265,83,182,4,14,0.04819277108433735,0.07692307692307693
"[1, 0, 1, 1, 1, 0, 0, 1, 0, 0, 1, 0, 0, 0, 1]",111,53,58,6,5,0.11320754716981132,0.08620689655172414
"[0, 0, 0, 1, 0, 1, 0, 0, 0, 0, 1, 1, 0, 1, 0]",238,161,77,15,12,0.09316770186335403,0.15584415584415584
"[1, 0, 1, 1, 1, 0, 1, 0, 0, 0, 0, 0, 1, 1, 0]",127,65,62,6,4,0.09230769230769231,0.06451612903225806
"[0, 0, 1, 1, 0, 1, 0, 0, 1, 1, 1, 1, 1, 1, 0]",250,116,134,11,9,0.09482758620689655,0.06716417910447761
"[1, 0, 0, 1, 0, 0, 0, 0, 1, 0, 1, 1, 0, 1, 1]",115,50,65,4,5,0.08,0.07692307692307693
"[1, 0, 0, 0, 1, 1, 1, 1, 0, 0, 0, 0, 1, 0, 0]",192,120,72,8,6,0.06666666666666667,0.08333333333333333
"[1, 0, 0, 0, 0, 0, 1, 0, 1, 0, 1, 1, 1, 1, 1]",163,73,90,4,4,0.0547945205479452,0.044444444444444446
"[1, 1, 0, 1, 0, 1, 0, 0, 0, 0, 0, 0, 1, 0, 1]",138,75,63,9,3,0.12,0.047619047619047616
"[1, 0, 0, 1, 0, 1, 1, 0, 1, 0, 1, 1, 1, 1, 0]",156,64,92,2,11,0.03125,0.11956521739130435
"[1, 1, 1, 0, 1, 1, 0, 0, 0, 0, 0, 1, 1, 1, 0]",139,68,71,4,7,0.058823529411764705,0.09859154929577464
"[0, 1, 0, 0, 1, 1, 1, 0, 1, 1, 1, 0, 1, 1, 1]",277,109,168,6,17,0.05504587155963303,0.10119047619047619
"[1, 0, 1, 1, 0, 1, 1, 1, 0, 1, 0, 1, 0, 0, 1]",148,60,88,8,10,0.13333333333333333,0.11363636363636363
"[0, 0, 0, 1, 0, 0, 1, 0, 1, 1, 1, 0, 1, 0, 0]",140,77,63,7,7,0.09090909090909091,0.1111111111111111
"[0, 0, 0, 0, 0, 1, 0, 0, 1, 0, 1, 1, 1, 0, 1]",137,92,45,12,4,0.13043478260869565,0.08888888888888889
"[1, 1, 0, 1, 1, 0, 0, 1, 0, 0, 0, 1, 0, 0, 1]",114,62,52,9,11,0.14516129032258066,0.21153846153846154
"[1, 0, 1, 1, 1, 0, 0, 1, 0, 1, 0, 1, 0, 1, 0]",103,46,57,6,5,0.13043478260869565,0.08771929824561403
"[0, 1, 0, 1, 0, 0, 1, 1, 0, 0, 0, 1, 0, 1, 0]",151,81,70,6,5,0.07407407407407407,0.07142857142857142
"[0, 1, 0, 0, 0, 1, 1, 0, 0, 0, 1, 0, 1, 1, 1]",172,84,88,6,8,0.07142857142857142,0.09090909090909091
"[0, 1, 1, 0, 1, 0, 0, 0, 0, 1, 1, 0, 1, 1, 1]",154,79,75,10,7,0.12658227848101267,0.09333333333333334
"[0, 0, 1, 0, 0, 1, 1, 1, 0, 0, 0, 0, 1, 1, 0]",271,161,110,9,8,0.055900621118012424,0.07272727272727272
"[0, 0, 0, 0, 0, 1, 0, 0, 0, 1, 1, 1, 0, 1, 1]",175,109,66,12,4,0.11009174311926606,0.06060606060606061
"[0, 0, 0, 1, 0, 1, 0, 1, 1, 1, 1, 0, 0, 0, 1]",140,78,62,10,4,0.1282051282051282,0.06451612903225806
"[1, 0, 0, 1, 1, 1, 0, 0, 0, 1, 0, 1, 0, 1, 1]",142,64,78,6,8,0.09375,0.10256410256410256
"[0, 0, 1, 1, 0, 0, 0, 0, 1, 1, 0, 1, 1, 1, 0]",199,104,95,5,14,0.04807692307692308,0.14736842105263157
"[1, 0, 1, 0, 0, 1, 0, 1, 1, 0, 0, 1, 0, 0, 0]",146,84,62,11,9,0.13095238095238096,0.14516129032258066
"[0, 1, 1, 0, 1, 1, 0, 0, 0, 1, 1, 0, 1, 1, 0]",118,54,64,4,8,0.07407407407407407,0.125
"[0, 0, 0, 0, 1, 0, 0, 1, 0, 0, 1, 1, 1, 0, 0]",270,179,91,13,4,0.07262569832402235,0.04395604395604396
"[1, 0, 1, 1, 1, 0, 0, 1, 0, 0, 1, 1, 1, 0, 1]",159,64,95,4,6,0.0625,0.06315789473684211
"[1, 0, 1, 1, 1, 0, 1, 1, 0, 0, 0, 0, 1, 0, 1]",111,46,65,2,7,0.043478260869565216,0.1076923076923077
"[0, 0, 1, 1, 1, 1, 0, 0, 0, 1, 0, 0, 1, 1, 0]",185,107,78,10,10,0.09345794392523364,0.1282051282051282
"[0, 1, 0, 0, 0, 0, 0, 1, 1, 0, 1, 1, 0, 0, 1]",181,121,60,17,9,0.14049586776859505,0.15
"[1, 1, 0, 0, 1, 0, 0, 0, 1, 1, 0, 0, 0, 1, 0]",151,92,59,16,8,0.17391304347826086,0.13559322033898305
"[0, 0, 0, 1, 1, 1, 1, 1, 0, 1, 1, 0, 1, 0, 0]",136,69,67,11,3,0.15942028985507245,0.04477611940298507
"[1, 1, 0, 0, 1, 1, 1, 0, 1, 0, 0, 0, 0, 1, 0]",127,65,62,2,7,0.03076923076923077,0.11290322580645161
"[0, 1, 1, 1, 1, 0, 0, 1, 1, 0, 0, 1, 0, 1, 0]",215,139,76,12,10,0.08633093525179857,0.13157894736842105
"[1, 1, 1, 0, 1, 0, 1, 0, 1, 0, 0, 1, 0, 0, 0]",118,65,53,6,8,0.09230769230769231,0.1509433962264151
"[0, 1, 0, 0, 1, 0, 1, 1, 0, 1, 0, 0, 0, 1, 1]",125,54,71,6,5,0.1111111111111111,0.07042253521126761
"[1, 0, 1, 0, 0, 1, 0, 1, 1, 0, 1, 0, 0, 0, 1]",127,74,53,10,6,0.13513513513513514,0.11320754716981132
"[1, 0, 1, 1, 0, 0, 0, 1, 1, 1, 0, 0, 1, 0, 1]",101,56,45,7,6,0.125,0.13333333333333333
"[1, 1, 0, 0, 1, 1, 1, 0, 1, 1, 0, 1, 0, 0, 0]",122,58,64,9,4,0.15517241379310345,0.0625
"[0, 1, 1, 1, 0, 1, 1, 0, 0, 1, 0, 1, 0, 0, 1]",125,71,54,7,8,0.09859154929577464,0.14814814814814814
"[1, 0, 1, 0, 0, 0, 0, 1, 1, 1, 0, 1, 1, 0, 0]",117,59,58,6,7,0.1016949152542373,0.1206896551724138
"[0, 0, 1, 1, 1, 1, 0, 0, 1, 0, 0, 0, 1, 0, 0]",180,110,70,11,5,0.1,0.07142857142857142
"[1, 1, 0, 1, 1, 0, 1, 0, 0, 0, 0, 1, 1, 0, 0]",183,93,90,7,6,0.07526881720430108,0.06666666666666667
"[1, 1, 0, 0, 1, 0, 0, 0, 1, 0, 0, 1, 0, 1, 1]",139,67,72,4,10,0.05970149253731343,0.1388888888888889
"[1, 0, 1, 1, 0, 0, 0, 1, 1, 1, 1, 1, 0, 0, 1]",205,91,114,8,18,0.08791208791208792,0.15789473684210525
"[0, 1, 1, 0, 1, 0, 1, 1, 0, 1, 1, 0, 0, 0, 1]",126,58,68,4,8,0.06896551724137931,0.11764705882352941
"[1, 1, 0, 0, 1, 1, 0, 0, 1, 1, 0, 1, 0, 0, 1]",225,111,114,6,10,0.05405405405405406,0.08771929824561403
"[1, 1, 0, 1, 0, 1, 1, 1, 1, 1, 0, 0, 0, 0, 0]",245,112,133,15,13,0.13392857142857142,0.09774436090225563
"[0, 0, 0, 0, 0, 1, 1, 0, 1, 1, 1, 0, 1, 0, 1]",130,78,52,5,8,0.0641025641025641,0.15384615384615385
"[1, 1, 0, 1, 1, 1, 0, 1, 1, 0, 0, 0, 0, 1, 1]",287,123,164,8,20,0.06504065040650407,0.12195121951219512
"[1, 0, 1, 0, 1, 0, 1, 1, 0, 0, 1, 0, 0, 1, 0]",102,52,50,4,4,0.07692307692307693,0.08
"[0, 0, 1, 1, 0, 0, 0, 0, 1, 1, 1, 0, 0, 1, 0]",230,134,96,12,10,0.08955223880597014,0.10416666666666667
"[0, 1, 0, 0, 1, 1, 0, 0, 0, 0, 1, 1, 1, 0, 0]",195,122,73,10,6,0.08196721311475409,0.0821917808219178
"[1, 0, 0, 1, 0, 1, 0, 0, 1, 1, 0, 0, 0, 1, 0]",133,75,58,1,10,0.013333333333333334,0.1724137931034483
"[1, 0, 1, 0, 0, 0, 1, 0, 0, 0, 0, 1, 1, 0, 0]",344,230,114,18,9,0.0782608695652174,0.07894736842105263
"[0, 1, 1, 0, 0, 1, 0, 0, 0, 0, 1, 1, 0, 1, 1]",140,75,65,4,4,0.05333333333333334,0.06153846153846154
"[0, 1, 1, 0, 1, 1, 0, 1, 0, 0, 1, 0, 1, 1, 1]",136,65,71,6,4,0.09230769230769231,0.056338028169014086
"[0, 0, 1, 1, 1, 1, 0, 0, 1, 0, 1, 1, 1, 0, 1]",177,76,101,6,16,0.07894736842105263,0.15841584158415842
"[0, 0, 1, 0, 0, 0, 1, 0, 0, 1, 1, 1, 1, 1, 1]",239,109,130,9,13,0.08256880733944955,0.1
"[0, 1, 0, 1, 1, 1, 0, 0, 1, 1, 0, 1, 1, 1, 0]",132,62,70,6,11,0.0967741935483871,0.15714285714285714
"[0, 1, 1, 1, 1, 0, 0, 0, 1, 0, 0, 0, 0, 1, 0]",168,105,63,8,4,0.0761904761904762,0.06349206349206349
"[1, 1, 0, 1, 1, 1, 1, 0, 1, 0, 1, 1, 1, 0, 0]",297,107,190,12,12,0.11214953271028037,0.06315789473684211
"[0, 1, 1, 0, 1, 0, 0, 0, 1, 0, 1, 1, 0, 0, 1]",121,65,56,5,2,0.07692307692307693,0.03571428571428571
"[0, 0, 1, 0, 1, 1, 0, 0, 1, 0, 1, 1, 0, 1, 0]",100,52,48,6,7,0.11538461538461539,0.14583333333333334
"[0, 1, 1, 1, 0, 1, 1, 0, 1, 1, 1, 0, 1, 1, 0]",219,74,145,4,11,0.05405405405405406,0.07586206896551724
"[1, 0, 1, 1, 0, 0, 0, 0, 1, 0, 0, 0, 1, 0, 1]",152,94,58,11,9,0.11702127659574468,0.15517241379310345
"[1, 0, 0, 1, 0, 0, 0, 0, 0, 1, 0, 0, 1, 1, 1]",249,140,109,16,8,0.11428571428571428,0.07339449541284404
"[0, 0, 1, 0, 1, 1, 0, 0, 1, 0, 0, 0, 0, 0, 1]",263,170,93,19,10,0.11176470588235295,0.10752688172043011
"[1, 0, 1, 0, 1, 0, 0, 1, 0, 1, 0, 1, 0, 1, 0]",98,55,43,4,2,0.07272727272727272,0.046511627906976744
"[1, 0, 0, 0, 1, 0, 0, 1, 0, 0, 0, 0, 0, 1, 0]",458,321,137,24,20,0.07476635514018691,0.145985401459854
"[0, 1, 0, 0, 0, 0, 1, 1, 0, 1, 0, 1, 1, 1, 0]",125,65,60,5,4,0.07692307692307693,0.06666666666666667
"[1, 1, 1, 0, 0, 0, 1, 1, 0, 0, 0, 1, 1, 0, 0]",160,71,89,10,10,0.14084507042253522,0.11235955056179775
"[1, 1, 1, 1, 0, 0, 1, 0, 0, 0, 0, 0, 0, 0, 0]",540,325,215,26,20,0.08,0.09302325581395349
"[1, 1, 0, 1, 1, 0, 0, 0, 1, 1, 0, 0, 0, 1, 1]",129,68,61,5,5,0.07352941176470588,0.08196721311475409
"[1, 0, 0, 1, 0, 1, 1, 0, 1, 1, 1, 0, 0, 1, 0]",105,52,53,5,4,0.09615384615384616,0.07547169811320754
"[1, 0, 1, 0, 1, 1, 1, 1, 1, 0, 1, 0, 1, 0, 0]",141,63,78,8,8,0.12698412698412698,0.10256410256410256
"[1, 1, 0, 1, 0, 0, 1, 0, 0, 0, 0, 0, 1, 0, 1]",146,84,62,6,7,0.07142857142857142,0.11290322580645161
"[0, 0, 0, 1, 1, 0, 1, 0, 1, 0, 0, 0, 1, 1, 1]",181,117,64,10,7,0.08547008547008547,0.109375
"[0, 0, 1, 1, 1, 0, 0, 0, 1, 1, 0, 1, 0, 1, 0]",98,60,38,8,0,0.13333333333333333,0.0
"[1, 1, 1, 1, 1, 0, 1, 1, 0, 0, 0, 0, 1, 0, 0]",149,68,81,4,6,0.058823529411764705,0.07407407407407407
"[0, 1, 0, 1, 1, 1, 1, 0, 0, 1, 0, 1, 0, 1, 0]",108,60,48,6,7,0.1,0.14583333333333334
"[0, 1, 0, 0, 1, 0, 0, 1, 1, 1, 0, 1, 0, 1, 0]",80,43,37,3,2,0.06976744186046512,0.05405405405405406
"[1, 1, 0, 0, 1, 0, 1, 0, 0, 1, 1, 0, 0, 1, 0]",123,65,58,2,7,0.03076923076923077,0.1206896551724138
"[0, 0, 1, 1, 0, 0, 1, 0, 0, 1, 0, 1, 1, 1, 1]",187,107,80,14,11,0.1308411214953271,0.1375
"[0, 1, 1, 1, 0, 1, 0, 0, 0, 1, 1, 1, 1, 1, 0]",149,67,82,4,6,0.05970149253731343,0.07317073170731707
"[1, 1, 0, 1, 0, 0, 0, 0, 1, 0, 0, 1, 0, 0, 0]",216,130,86,19,9,0.14615384615384616,0.10465116279069768
"[0, 1, 1, 1, 1, 0, 0, 1, 1, 0, 1, 1, 1, 0, 1]",317,148,169,14,13,0.0945945945945946,0.07692307692307693
"[1, 1, 0, 1, 0, 0, 1, 0, 0, 0, 0, 1, 1, 0, 0]",244,156,88,16,5,0.10256410256410256,0.056818181818181816
"[1, 0, 1, 0, 1, 0, 0, 0, 1, 0, 0, 0, 0, 1, 1]",197,112,85,12,11,0.10714285714285714,0.12941176470588237
"[0, 1, 1, 0, 1, 1, 0, 1, 0, 0, 1, 1, 1, 1, 1]",325,130,195,10,19,0.07692307692307693,0.09743589743589744
"[1, 0, 1, 1, 0, 0, 1, 0, 1, 1, 0, 0, 0, 1, 0]",114,64,50,6,3,0.09375,0.06
"[0, 0, 0, 0, 1, 1, 1, 1, 0, 0, 0, 1, 1, 0, 0]",351,200,151,19,13,0.095,0.08609271523178808
"[0, 0, 1, 1, 1, 1, 1, 0, 0, 1, 1, 0, 1, 0, 1]",194,87,107,6,5,0.06896551724137931,0.04672897196261682
"[0, 1, 0, 1, 1, 0, 1, 0, 1, 0, 0, 0, 1, 1, 1]",136,72,64,8,3,0.1111111111111111,0.046875
"[1, 1, 1, 0, 0, 0, 1, 1, 0, 0, 0, 1, 1, 1, 0]",134,68,66,9,9,0.1323529411764706,0.13636363636363635
"[1, 0, 1, 1, 0, 0, 1, 0, 1, 0, 1, 1, 0, 1, 1]",146,62,84,10,6,0.16129032258064516,0.07142857142857142
"[1, 0, 0, 0, 1, 1, 1, 0, 0, 1, 0, 0, 0, 1, 0]",143,64,79,6,10,0.09375,0.12658227848101267
"[0, 1, 0, 0, 1, 0, 1, 0, 1, 0, 1, 1, 1, 0, 0]",109,63,46,5,6,0.07936507936507936,0.13043478260869565
"[0, 1, 1, 1, 1, 0, 0, 0, 0, 1, 1, 0, 1, 0, 1]",253,180,73,17,8,0.09444444444444444,0.1095890410958904
"[0, 1, 0, 1, 0, 1, 1, 0, 1, 0, 0, 1, 1, 0, 1]",105,49,56,4,2,0.08163265306122448,0.03571428571428571
"[1, 0, 1, 1, 1, 0, 1, 0, 0, 0, 0, 1, 0, 1, 0]",110,62,48,3,2,0.04838709677419355,0.041666666666666664
"[0, 0, 1, 1, 0, 1, 1, 1, 0, 0, 1, 1, 0, 0, 0]",182,109,73,11,8,0.10091743119266056,0.1095890410958904
"[0, 0, 0, 1, 1, 1, 0, 0, 1, 1, 0, 1, 0, 1, 1]",143,76,67,6,8,0.07894736842105263,0.11940298507462686
"[0, 1, 1, 0, 1, 1, 1, 0, 1, 1, 0, 1, 0, 0, 0]",97,43,54,4,7,0.09302325581395349,0.12962962962962962
"[1, 0, 0, 0, 1, 1, 1, 1, 0, 0, 1, 0, 0, 0, 0]",196,108,88,12,7,0.1111111111111111,0.07954545454545454
"[1, 1, 0, 1, 1, 1, 1, 1, 1, 0, 0, 0, 0, 0, 1]",231,90,141,9,12,0.1,0.0851063829787234
"[0, 1, 0, 1, 0, 1, 0, 0, 0, 1, 1, 1, 1, 0, 1]",111,52,59,4,3,0.07692307692307693,0.05084745762711865
"[1, 0, 0, 0, 0, 1, 1, 1, 1, 1, 0, 1, 0, 0, 1]",175,49,126,4,20,0.08163265306122448,0.15873015873015872
"[1, 0, 1, 0, 1, 0, 0, 1, 0, 1, 1, 0, 1, 0, 1]",105,55,50,6,5,0.10909090909090909,0.1
"[0, 0, 0, 1, 0, 1, 0, 0, 1, 0, 1, 1, 0, 1, 0]",137,86,51,13,4,0.1511627906976744,0.0784313725490196
"[1, 0, 1, 1, 1, 0, 1, 0, 0, 0, 1, 1, 1, 0, 1]",115,37,78,3,6,0.08108108108108109,0.07692307692307693
"[1, 0, 1, 0, 0, 1, 0, 1, 1, 1, 0, 1, 1, 1, 1]",248,90,158,9,7,0.1,0.04430379746835443
"[0, 1, 1, 0, 0, 0, 0, 0, 1, 0, 0, 1, 1, 1, 1]",271,180,91,20,8,0.1111111111111111,0.08791208791208792
"[1, 0, 1, 0, 0, 0, 1, 0, 1, 1, 1, 0, 0, 1, 1]",168,80,88,6,3,0.075,0.03409090909090909
"[0, 1, 1, 1, 1, 1, 0, 0, 1, 1, 0, 1, 0, 0, 1]",159,66,93,9,7,0.13636363636363635,0.07526881720430108
"[0, 0, 0, 0, 1, 1, 1, 0, 0, 1, 1, 0, 1, 0, 0]",139,85,54,3,3,0.03529411764705882,0.05555555555555555
"[0, 1, 1, 0, 0, 1, 1, 0, 1, 0, 1, 0, 1, 0, 0]",122,70,52,9,6,0.12857142857142856,0.11538461538461539
"[1, 0, 1, 1, 0, 0, 1, 1, 0, 1, 0, 1, 0, 1, 0]",110,51,59,3,7,0.058823529411764705,0.11864406779661017
"[1, 0, 0, 0, 1, 1, 1, 0, 1, 0, 1, 0, 0, 0, 1]",123,63,60,8,7,0.12698412698412698,0.11666666666666667
"[0, 1, 0, 0, 1, 1, 1, 0, 0, 0, 0, 0, 0, 1, 0]",261,159,102,12,12,0.07547169811320754,0.11764705882352941
"[1, 1, 1, 0, 0, 0, 1, 0, 0, 0, 0, 1, 0, 1, 1]",153,67,86,7,5,0.1044776119402985,0.05813953488372093
"[1, 0, 1, 1, 0, 0, 0, 1, 0, 0, 1, 1, 1, 0, 0]",129,71,58,4,5,0.056338028169014086,0.08620689655172414
"[1, 1, 1, 1, 1, 1, 1, 0, 0, 1, 0, 0, 0, 1, 0]",168,59,109,5,2,0.0847457627118644,0.01834862385321101
"[0, 1, 1, 1, 0, 1, 0, 1, 1, 0, 0, 1, 0, 1, 0]",116,58,58,3,9,0.05172413793103448,0.15517241379310345
"[1, 1, 0, 1, 1, 0, 1, 0, 1, 0, 1, 0, 0, 1, 0]",121,47,74,3,7,0.06382978723404255,0.0945945945945946
"[0, 0, 0, 1, 0, 0, 1, 0, 1, 1, 0, 0, 0, 1, 1]",179,104,75,10,8,0.09615384615384616,0.10666666666666667
"[0, 0, 1, 0, 1, 1, 0, 0, 1, 0, 0, 1, 1, 0, 0]",159,94,65,10,2,0.10638297872340426,0.03076923076923077
"[1, 0, 0, 0, 1, 1, 1, 1, 0, 0, 1, 1, 1, 0, 1]",187,82,105,5,12,0.06097560975609756,0.11428571428571428
"[1, 0, 0, 1, 0, 0, 0, 1, 0, 1, 0, 1, 1, 1, 0]",91,55,36,4,5,0.07272727272727272,0.1388888888888889
"[1, 0, 0, 1, 1, 1, 0, 1, 0, 1, 0, 0, 0, 1, 0]",102,49,53,3,7,0.061224489795918366,0.1320754716981132
"[1, 0, 1, 0, 1, 1, 1, 1, 0, 0, 0, 0, 0, 1, 1]",191,78,113,8,11,0.10256410256410256,0.09734513274336283
"[0, 1, 1, 0, 1, 0, 1, 0, 0, 0, 1, 0, 1, 0, 1]",108,58,50,8,4,0.13793103448275862,0.08
"[1, 0, 0, 1, 1, 0, 0, 0, 1, 0, 1, 0, 1, 0, 1]",120,60,60,5,6,0.08333333333333333,0.1
"[0, 1, 0, 1, 1, 1, 0, 1, 0, 1, 0, 0, 0, 0, 0]",155,86,69,8,5,0.09302325581395349,0.07246376811594203
"[0, 1, 0, 0, 0, 1, 1, 1, 0, 1, 1, 1, 1, 0, 0]",147,77,70,7,6,0.09090909090909091,0.08571428571428572
"[1, 1, 0, 1, 0, 0, 1, 1, 0, 1, 1, 1, 1, 0, 1]",219,66,153,8,17,0.12121212121212122,0.1111111111111111
"[0, 1, 1, 1, 0, 1, 1, 0, 0, 1, 0, 1, 0, 1, 0]",112,44,68,2,7,0.045454545454545456,0.10294117647058823
"[0, 1, 0, 1, 1, 1, 0, 0, 1, 1, 1, 0, 1, 1, 0]",152,53,99,6,6,0.11320754716981132,0.06060606060606061
"[0, 1, 1, 0, 0, 0, 1, 1, 0, 1, 1, 0, 0, 0, 0]",231,146,85,16,8,0.1095890410958904,0.09411764705882353
"[0, 1, 1, 1, 1, 0, 1, 0, 1, 0, 0, 0, 1, 1, 0]",124,78,46,7,6,0.08974358974358974,0.13043478260869565
"[1, 1, 1, 0, 0, 0, 1, 0, 0, 0, 1, 1, 1, 1, 0]",154,69,85,6,10,0.08695652173913043,0.11764705882352941
"[0, 0, 1, 1, 1, 1, 0, 0, 1, 1, 0, 1, 1, 1, 0]",243,97,146,5,12,0.05154639175257732,0.0821917808219178
"[0, 0, 1, 0, 1, 1, 1, 0, 1, 1, 0, 1, 1, 0, 0]",140,68,72,7,4,0.10294117647058823,0.05555555555555555
"[1, 1, 1, 1, 1, 0, 1, 0, 1, 0, 1, 0, 1, 0, 0]",134,63,71,6,10,0.09523809523809523,0.14084507042253522
"[1, 0, 0, 0, 1, 0, 1, 1, 0, 0, 0, 1, 1, 0, 1]",105,57,48,5,6,0.08771929824561403,0.125
"[1, 0, 0, 1, 0, 1, 0, 1, 1, 0, 1, 0, 0, 1, 0]",87,35,52,4,5,0.11428571428571428,0.09615384615384616
"[0, 1, 0, 0, 1, 1, 0, 1, 0, 0, 0, 0, 1, 1, 0]",177,106,71,8,9,0.07547169811320754,0.1267605633802817
"[1, 0, 0, 0, 0, 1, 0, 0, 1, 1, 1, 0, 1, 1, 1]",137,55,82,7,9,0.12727272727272726,0.10975609756097561
"[1, 1, 1, 1, 1, 0, 0, 0, 0, 0, 0, 0, 1, 0, 1]",258,77,181,3,15,0.03896103896103896,0.08287292817679558
"[0, 1, 0, 0, 1, 1, 0, 1, 1, 0, 0, 0, 0, 0, 0]",363,237,126,22,11,0.09282700421940929,0.0873015873015873
"[1, 1, 0, 0, 1, 0, 1, 1, 1, 1, 1, 0, 0, 1, 1]",410,149,261,10,29,0.06711409395973154,0.1111111111111111
"[1, 1, 1, 1, 0, 1, 0, 1, 1, 1, 0, 0, 0, 1, 1]",273,98,175,9,18,0.09183673469387756,0.10285714285714286
"[0, 1, 1, 0, 0, 0, 0, 1, 0, 0, 1, 0, 1, 1, 0]",150,94,56,8,5,0.0851063829787234,0.08928571428571429
"[1, 1, 0, 1, 1, 1, 0, 1, 1, 1, 1, 0, 1, 0, 1]",511,154,357,16,36,0.1038961038961039,0.10084033613445378
"[1, 0, 1, 1, 0, 1, 1, 1, 1, 1, 1, 0, 0, 0, 0]",359,131,228,18,21,0.13740458015267176,0.09210526315789473
"[1, 0, 0, 0, 1, 1, 0, 1, 0, 1, 0, 1, 1, 1, 0]",99,41,58,4,2,0.0975609756097561,0.034482758620689655
"[0, 0, 1, 0, 1, 1, 0, 0, 1, 0, 0, 1, 0, 0, 1]",138,82,56,13,6,0.15853658536585366,0.10714285714285714
"[0, 1, 0, 0, 1, 0, 0, 0, 1, 1, 1, 0, 1, 0, 0]",146,80,66,8,7,0.1,0.10606060606060606
"[1, 0, 1, 1, 0, 0, 0, 0, 1, 1, 1, 0, 1, 0, 0]",130,62,68,4,4,0.06451612903225806,0.058823529411764705
"[0, 1, 0, 0, 1, 1, 1, 0, 0, 1, 1, 1, 1, 0, 1]",159,72,87,6,10,0.08333333333333333,0.11494252873563218
"[1, 0, 0, 0, 1, 0, 1, 0, 1, 0, 0, 1, 1, 0, 1]",108,55,53,3,4,0.05454545454545454,0.07547169811320754
"[1, 0, 1, 1, 0, 1, 0, 0, 1, 0, 0, 1, 0, 0, 0]",137,88,49,8,8,0.09090909090909091,0.16326530612244897
"[0, 0, 1, 0, 1, 1, 1, 1, 1, 0, 1, 0, 1, 1, 1]",265,107,158,10,15,0.09345794392523364,0.0949367088607595
"[1, 0, 0, 1, 0, 1, 1, 1, 1, 1, 0, 1, 0, 1, 0]",141,64,77,3,3,0.046875,0.03896103896103896
"[1, 0, 1, 1, 0, 0, 1, 1, 0, 0, 1, 0, 0, 1, 0]",121,59,62,7,6,0.11864406779661017,0.0967741935483871
"[0, 1, 0, 1, 0, 1, 1, 0, 0, 1, 1, 0, 0, 1, 0]",124,64,60,4,5,0.0625,0.08333333333333333
"[1, 1, 0, 1, 1, 0, 0, 1, 1, 1, 1, 0, 1, 1, 0]",272,71,201,8,29,0.11267605633802817,0.14427860696517414
"[1, 0, 1, 0, 1, 0, 1, 0, 1, 0, 0, 1, 0, 0, 0]",136,79,57,3,6,0.0379746835443038,0.10526315789473684
"[1, 1, 1, 1, 0, 0, 0, 0, 1, 1, 1, 0, 0, 0, 1]",238,116,122,14,12,0.1206896551724138,0.09836065573770492
"[0, 1, 1, 1, 0, 1, 1, 1, 1, 0, 1, 1, 0, 0, 0]",153,67,86,7,8,0.1044776119402985,0.09302325581395349
"[0, 0, 0, 1, 1, 1, 1, 0, 0, 1, 0, 1, 0, 0, 1]",164,111,53,12,1,0.10810810810810811,0.018867924528301886
"[0, 0, 0, 0, 1, 1, 1, 0, 1, 0, 1, 1, 0, 1, 1]",155,70,85,7,7,0.1,0.08235294117647059
"[1, 1, 1, 0, 1, 0, 0, 0, 1, 0, 1, 0, 1, 1, 0]",106,55,51,4,10,0.07272727272727272,0.19607843137254902
"[1, 0, 0, 1, 0, 1, 1, 0, 0, 0, 1, 0, 0, 1, 1]",150,93,57,9,2,0.0967741935483871,0.03508771929824561
"[1, 0, 1, 1, 1, 0, 0, 1, 0, 1, 1, 0, 0, 0, 1]",118,62,56,8,4,0.12903225806451613,0.07142857142857142
"[1, 0, 0, 1, 0, 0, 0, 1, 1, 0, 0, 0, 1, 1, 0]",179,110,69,13,8,0.11818181818181818,0.11594202898550725
"[0, 1, 0, 1, 0, 0, 0, 1, 1, 0, 1, 0, 1, 0, 1]",110,72,38,5,6,0.06944444444444445,0.15789473684210525
"[1, 0, 0, 1, 1, 1, 0, 1, 1, 1, 0, 1, 0, 0, 0]",128,60,68,3,3,0.05,0.04411764705882353
"[1, 0, 0, 0, 1, 0, 1, 0, 0, 1, 1, 1, 0, 1, 1]",116,50,66,3,11,0.06,0.16666666666666666
"[0, 0, 1, 0, 0, 0, 1, 0, 1, 0, 0, 1, 1, 1, 0]",128,75,53,6,3,0.08,0.05660377358490566
"[0, 1, 1, 1, 0, 0, 0, 1, 1, 0, 1, 0, 1, 1, 1]",163,69,94,10,8,0.14492753623188406,0.0851063829787234
"[0, 0, 1, 1, 1, 1, 0, 0, 1, 0, 1, 0, 1, 0, 0]",155,80,75,5,8,0.0625,0.10666666666666667
"[1, 1, 1, 0, 1, 1, 0, 0, 0, 1, 1, 0, 1, 0, 1]",149,54,95,4,5,0.07407407407407407,0.05263157894736842
"[0, 0, 1, 0, 1, 1, 1, 0, 0, 0, 0, 1, 0, 1, 1]",122,67,55,10,4,0.14925373134328357,0.07272727272727272
"[1, 1, 1, 0, 1, 0, 0, 1, 1, 0, 0, 0, 1, 0, 1]",107,38,69,3,10,0.07894736842105263,0.14492753623188406
"[1, 0, 0, 1, 1, 1, 0, 0, 1, 0, 1, 0, 1, 0, 0]",89,37,52,6,4,0.16216216216216217,0.07692307692307693
"[1, 0, 1, 1, 0, 1, 0, 1, 1, 1, 1, 0, 0, 1, 0]",149,59,90,4,18,0.06779661016949153,0.2
"[1, 1, 0, 1, 1, 1, 0, 0, 0, 0, 1, 0, 0, 0, 1]",115,57,58,4,4,0.07017543859649122,0.06896551724137931
"[0, 0, 0, 0, 0, 1, 1, 0, 1, 0, 1, 1, 1, 1, 1]",254,156,98,17,11,0.10897435897435898,0.11224489795918367
"[0, 1, 0, 0, 1, 1, 0, 1, 0, 1, 0, 1, 1, 0, 1]",98,45,53,6,7,0.13333333333333333,0.1320754716981132
"[1, 1, 1, 0, 0, 0, 0, 0, 1, 0, 0, 0, 1, 1, 0]",208,116,92,15,7,0.12931034482758622,0.07608695652173914
"[1, 1, 1, 0, 1, 1, 1, 0, 0, 0, 1, 0, 1, 0, 0]",127,65,62,4,1,0.06153846153846154,0.016129032258064516
"[1, 0, 1, 1, 0, 0, 0, 1, 0, 0, 0, 0, 1, 1, 1]",187,94,93,7,8,0.07446808510638298,0.08602150537634409
"[0, 0, 1, 0, 0, 0, 1, 1, 0, 0, 0, 1, 1, 0, 1]",144,80,64,11,4,0.1375,0.0625
"[0, 1, 1, 1, 1, 1, 0, 0, 0, 1, 1, 1, 1, 1, 0]",259,91,168,8,16,0.08791208791208792,0.09523809523809523
"[1, 0, 1, 0, 0, 1, 0, 0, 1, 0, 1, 0, 1, 0, 1]",96,50,46,7,5,0.14,0.10869565217391304
"[0, 1, 1, 0, 1, 0, 1, 1, 0, 1, 0, 0, 1, 0, 0]",123,71,52,5,5,0.07042253521126761,0.09615384615384616
"[1, 1, 0, 1, 0, 1, 0, 1, 0, 0, 1, 1, 1, 1, 0]",180,82,98,7,12,0.08536585365853659,0.12244897959183673
"[1, 1, 0, 0, 0, 1, 1, 0, 1, 1, 1, 0, 0, 1, 0]",107,49,58,5,5,0.10204081632653061,0.08620689655172414
"[0, 0, 0, 1, 1, 1, 1, 0, 0, 0, 1, 1, 0, 0, 1]",231,148,83,19,8,0.12837837837837837,0.0963855421686747
"[1, 0, 1, 1, 1, 0, 1, 1, 0, 1, 1, 0, 0, 0, 0]",143,61,82,5,10,0.08196721311475409,0.12195121951219512
"[1, 1, 1, 0, 1, 1, 1, 0, 0, 1, 1, 1, 0, 1, 0]",252,76,176,6,24,0.07894736842105263,0.13636363636363635
"[0, 0, 0, 1, 1, 0, 0, 0, 1, 1, 0, 1, 1, 1, 0]",127,81,46,12,1,0.14814814814814814,0.021739130434782608
"[0, 0, 0, 0, 1, 1, 1, 0, 1, 0, 1, 1, 0, 1, 0]",127,74,53,11,8,0.14864864864864866,0.1509433962264151
"[0, 1, 1, 0, 1, 1, 1, 0, 0, 1, 0, 0, 0, 0, 0]",177,101,76,11,5,0.10891089108910891,0.06578947368421052
"[0, 0, 1, 0, 0, 1, 1, 0, 1, 1, 0, 1, 1, 0, 1]",105,42,63,1,6,0.023809523809523808,0.09523809523809523
"[0, 1, 1, 1, 0, 0, 0, 1, 0, 0, 1, 1, 0, 1, 1]",116,57,59,4,8,0.07017543859649122,0.13559322033898305
"[0, 1, 1, 0, 0, 0, 1, 1, 0, 0, 1, 1, 0, 1, 1]",148,71,77,7,7,0.09859154929577464,0.09090909090909091
"[0, 0, 0, 0, 1, 0, 1, 1, 1, 0, 1, 0, 1, 1, 1]",136,69,67,10,10,0.14492753623188406,0.14925373134328357
"[0, 1, 1, 1, 0, 0, 0, 1, 0, 0, 0, 0, 1, 1, 1]",198,115,83,11,4,0.09565217391304348,0.04819277108433735
"[0, 0, 1, 1, 0, 1, 0, 1, 0, 1, 0, 1, 0, 1, 1]",99,55,44,4,2,0.07272727272727272,0.045454545454545456
"[1, 1, 0, 1, 1, 0, 0, 0, 0, 1, 1, 0, 1, 0, 1]",102,57,45,5,7,0.08771929824561403,0.15555555555555556
"[1, 1, 1, 1, 0, 0, 0, 1, 0, 0, 0, 1, 0, 0, 1]",145,80,65,10,7,0.125,0.1076923076923077
"[0, 1, 0, 1, 1, 0, 1, 0, 0, 1, 0, 0, 0, 0, 1]",178,95,83,12,6,0.12631578947368421,0.07228915662650602
"[1, 1, 0, 1, 1, 0, 0, 1, 1, 0, 0, 1, 1, 0, 1]",194,76,118,4,7,0.05263157894736842,0.059322033898305086
"[1, 0, 0, 0, 1, 0, 1, 0, 0, 1, 1, 0, 1, 0, 0]",132,79,53,11,2,0.13924050632911392,0.03773584905660377
"[0, 0, 1, 1, 1, 1, 0, 0, 0, 0, 1, 0, 0, 1, 0]",266,150,116,12,7,0.08,0.0603448275862069
"[0, 0, 0, 0, 0, 1, 0, 1, 1, 0, 1, 1, 1, 0, 1]",110,60,50,15,0,0.25,0.0
"[0, 0, 1, 0, 1, 1, 1, 0, 0, 1, 0, 0, 1, 0, 1]",111,55,56,5,4,0.09090909090909091,0.07142857142857142
"[0, 0, 0, 1, 1, 0, 1, 0, 0, 1, 1, 0, 1, 0, 0]",143,87,56,8,7,0.09195402298850575,0.125
"[0, 1, 0, 1, 1, 0, 1, 0, 1, 1, 0, 0, 0, 1, 1]",140,66,74,5,10,0.07575757575757576,0.13513513513513514
"[0, 0, 1, 0, 1, 0, 1, 1, 1, 0, 1, 0, 1, 1, 0]",98,43,55,7,7,0.16279069767441862,0.12727272727272726
"[0, 1, 0, 0, 0, 0, 1, 0, 1, 1, 1, 1, 0, 0, 0]",197,124,73,9,8,0.07258064516129033,0.1095890410958904
"[0, 1, 0, 0, 1, 1, 0, 0, 0, 1, 0, 1, 0, 0, 1]",153,98,55,9,5,0.09183673469387756,0.09090909090909091
"[0, 0, 1, 1, 0, 1, 0, 0, 0, 0, 0, 1, 0, 1, 0]",227,153,74,12,11,0.0784313725490196,0.14864864864864866
"[1, 1, 1, 1, 0, 1, 1, 0, 1, 1, 0, 0, 0, 1, 0]",150,57,93,9,9,0.15789473684210525,0.0967741935483871
"[1, 0, 0, 1, 0, 1, 1, 1, 1, 1, 1, 1, 0, 0, 0]",268,112,156,6,12,0.05357142857142857,0.07692307692307693
"[0, 0, 1, 1, 0, 1, 0, 0, 1, 0, 1, 0, 0, 1, 0]",146,81,65,6,10,0.07407407407407407,0.15384615384615385
"[1, 0, 0, 1, 1, 1, 1, 0, 0, 1, 0, 0, 0, 1, 0]",129,55,74,5,12,0.09090909090909091,0.16216216216216217
"[0, 0, 1, 0, 1, 1, 1, 0, 0, 1, 0, 0, 0, 0, 1]",173,95,78,10,8,0.10526315789473684,0.10256410256410256
"[0, 0, 1, 1, 1, 0, 1, 1, 0, 0, 0, 0, 0, 0, 1]",227,131,96,13,7,0.09923664122137404,0.07291666666666667
"[1, 0, 0, 0, 1, 0, 0, 0, 1, 0, 0, 1, 0, 1, 0]",216,149,67,16,8,0.10738255033557047,0.11940298507462686
"[1, 0, 0, 0, 1, 1, 0, 1, 0, 0, 1, 1, 0, 0, 1]",153,84,69,13,10,0.15476190476190477,0.14492753623188406
"[1, 1, 1, 0, 1, 0, 0, 1, 1, 1, 1, 0, 1, 0, 0]",150,70,80,7,5,0.1,0.0625
"[0, 0, 1, 0, 1, 0, 1, 0, 0, 1, 1, 0, 1, 0, 1]",102,53,49,7,4,0.1320754716981132,0.08163265306122448
"[0, 1, 1, 0, 1, 0, 0, 1, 0, 0, 1, 1, 0, 1, 1]",124,61,63,9,10,0.14754098360655737,0.15873015873015872
"[0, 1, 0, 0, 1, 1, 0, 1, 0, 0, 1, 0, 0, 1, 1]",132,73,59,7,8,0.0958904109589041,0.13559322033898305
"[1, 0, 1, 0, 1, 1, 1, 0, 1, 0, 1, 0, 1, 1, 0]",138,54,84,6,13,0.1111111111111111,0.15476190476190477
"[0, 0, 1, 0, 1, 0, 1, 0, 0, 0, 1, 0, 1, 1, 0]",156,89,67,3,4,0.033707865168539325,0.05970149253731343
"[0, 1, 1, 1, 0, 0, 1, 1, 0, 1, 1, 0, 0, 0, 1]",117,61,56,14,3,0.22950819672131148,0.05357142857142857
"[0, 1, 0, 1, 1, 1, 0, 1, 0, 1, 0, 1, 1, 0, 1]",123,42,81,5,8,0.11904761904761904,0.09876543209876543
"[0, 0, 0, 0, 1, 0, 1, 1, 0, 1, 1, 1, 1, 0, 1]",106,48,58,4,5,0.08333333333333333,0.08620689655172414
"[0, 1, 1, 1, 1, 1, 0, 0, 1, 0, 1, 1, 0, 1, 0]",133,64,69,7,5,0.109375,0.07246376811594203
"[1, 0, 0, 0, 1, 0, 1, 1, 0, 1, 1, 1, 1, 1, 1]",350,122,228,9,21,0.07377049180327869,0.09210526315789473
"[0, 0, 0, 1, 1, 0, 1, 1, 1, 1, 0, 1, 0, 0, 0]",118,69,49,4,7,0.057971014492753624,0.14285714285714285
"[0, 1, 0, 1, 1, 1, 0, 0, 0, 1, 0, 0, 1, 0, 1]",97,52,45,3,2,0.057692307692307696,0.044444444444444446
"[1, 1, 0, 1, 0, 0, 1, 1, 0, 0, 1, 1, 0, 1, 0]",127,61,66,4,5,0.06557377049180328,0.07575757575757576
"[0, 1, 0, 0, 1, 1, 0, 1, 0, 0, 0, 1, 0, 0, 1]",126,75,51,5,3,0.06666666666666667,0.058823529411764705
"[1, 1, 1, 0, 1, 0, 1, 0, 1, 1, 0, 1, 0, 0, 1]",138,59,79,3,5,0.05084745762711865,0.06329113924050633
"[0, 0, 1, 0, 1, 0, 0, 1, 1, 1, 1, 1, 1, 1, 0]",200,97,103,15,10,0.15463917525773196,0.0970873786407767
"[1, 1, 0, 0, 0, 1, 1, 0, 1, 0, 0, 0, 0, 1, 0]",108,69,39,4,2,0.057971014492753624,0.05128205128205128
"[0, 0, 1, 0, 1, 0, 1, 1, 0, 0, 1, 0, 0, 1, 0]",140,67,73,14,10,0.208955223880597,0.136986301369863
"[1, 0, 0, 0, 1, 0, 1, 0, 0, 0, 0, 1, 0, 1, 0]",242,160,82,20,8,0.125,0.0975609756097561
"[0, 1, 1, 1, 0, 1, 0, 1, 0, 0, 1, 0, 0, 0, 1]",99,54,45,7,2,0.12962962962962962,0.044444444444444446
"[0, 1, 0, 1, 1, 0, 0, 0, 1, 1, 1, 1, 0, 0, 0]",230,130,100,14,8,0.1076923076923077,0.08
"[0, 0, 1, 1, 1, 1, 1, 0, 1, 0, 0, 1, 0, 0, 1]",122,59,63,7,3,0.11864406779661017,0.047619047619047616
"[1, 1, 0, 0, 0, 0, 1, 1, 0, 0, 1, 1, 0, 1, 1]",455,229,226,16,18,0.06986899563318777,0.07964601769911504
"[1, 0, 0, 1, 0, 1, 1, 1, 0, 0, 1, 0, 0, 1, 1]",122,60,62,6,7,0.1,0.11290322580645161
"[1, 1, 0, 1, 1, 1, 0, 0, 1, 0, 1, 1, 1, 0, 0]",174,71,103,8,9,0.11267605633802817,0.08737864077669903
"[1, 0, 0, 1, 0, 0, 0, 1, 0, 0, 1, 1, 1, 1, 0]",154,75,79,7,5,0.09333333333333334,0.06329113924050633
"[1, 1, 0, 1, 0, 1, 0, 0, 1, 0, 0, 0, 1, 0, 0]",141,75,66,13,4,0.17333333333333334,0.06060606060606061
"[1, 0, 0, 1, 1, 1, 1, 0, 1, 1, 1, 1, 0, 1, 0]",265,76,189,6,16,0.07894736842105263,0.08465608465608465
"[1, 1, 1, 0, 0, 0, 1, 1, 1, 0, 0, 0, 1, 1, 0]",147,66,81,7,4,0.10606060606060606,0.04938271604938271
"[0, 0, 1, 0, 1, 1, 1, 1, 1, 1, 1, 0, 0, 0, 1]",177,72,105,7,6,0.09722222222222222,0.05714285714285714
"[1, 1, 0, 0, 1, 1, 1, 0, 0, 1, 0, 0, 0, 1, 0]",124,64,60,3,3,0.046875,0.05
"[0, 1, 0, 1, 0, 0, 1, 1, 1, 0, 0, 0, 1, 0, 0]",129,77,52,7,11,0.09090909090909091,0.21153846153846154
"[1, 1, 1, 1, 0, 1, 0, 0, 1, 1, 0, 1, 0, 0, 0]",105,49,56,3,2,0.061224489795918366,0.03571428571428571
"[0, 1, 1, 1, 1, 0, 0, 1, 1, 1, 0, 0, 0, 1, 0]",148,82,66,7,10,0.08536585365853659,0.15151515151515152
"[0, 1, 1, 0, 1, 0, 1, 0, 0, 0, 0, 1, 1, 1, 1]",240,134,106,16,10,0.11940298507462686,0.09433962264150944
"[0, 1, 0, 0, 0, 1, 1, 0, 0, 0, 0, 1, 0, 1, 1]",196,124,72,6,6,0.04838709677419355,0.08333333333333333
"[0, 0, 1, 0, 1, 1, 0, 0, 0, 0, 0, 1, 0, 1, 0]",239,165,74,16,4,0.09696969696969697,0.05405405405405406
"[1, 0, 1, 1, 0, 1, 0, 0, 0, 1, 1, 0, 0, 0, 1]",110,58,52,6,5,0.10344827586206896,0.09615384615384616
"[1, 0, 1, 0, 1, 0, 0, 1, 1, 0, 0, 1, 0, 1, 1]",123,61,62,1,9,0.01639344262295082,0.14516129032258066
"[0, 1, 0, 1, 0, 0, 0, 0, 1, 1, 0, 0, 1, 0, 1]",146,94,52,13,6,0.13829787234042554,0.11538461538461539
"[0, 1, 1, 0, 0, 1, 0, 1, 0, 1, 0, 1, 0, 1, 0]",112,62,50,7,5,0.11290322580645161,0.1
"[0, 1, 1, 0, 0, 1, 1, 0, 1, 0, 1, 0, 0, 0, 0]",213,137,76,16,11,0.11678832116788321,0.14473684210526316
"[0, 0, 1, 1, 1, 0, 0, 1, 0, 1, 0, 0, 1, 0, 0]",140,82,58,8,6,0.0975609756097561,0.10344827586206896
"[1, 1, 0, 0, 1, 1, 1, 0, 1, 1, 0, 0, 1, 0, 1]",147,54,93,4,6,0.07407407407407407,0.06451612903225806
"[1, 0, 0, 0, 0, 1, 1, 0, 1, 1, 1, 1, 0, 1, 1]",192,63,129,6,9,0.09523809523809523,0.06976744186046512
"[0, 1, 1, 1, 0, 1, 1, 1, 0, 1, 1, 0, 0, 0, 0]",153,74,79,7,8,0.0945945945945946,0.10126582278481013
"[1, 0, 0, 0, 1, 1, 1, 1, 0, 1, 1, 0, 1, 0, 0]",127,56,71,1,8,0.017857142857142856,0.11267605633802817
"[1, 0, 1, 1, 0, 0, 0, 0, 1, 1, 1, 0, 1, 0, 1]",118,64,54,5,7,0.078125,0.12962962962962962
"[1, 1, 1, 0, 0, 0, 0, 0, 1, 1, 1, 0, 0, 0, 0]",249,128,121,11,8,0.0859375,0.06611570247933884
"[0, 1, 1, 0, 1, 0, 1, 1, 0, 1, 1, 1, 1, 0, 0]",178,67,111,5,13,0.07462686567164178,0.11711711711711711
"[1, 0, 0, 0, 1, 1, 0, 0, 1, 1, 1, 1, 1, 0, 0]",197,96,101,11,6,0.11458333333333333,0.0594059405940594
"[1, 0, 0, 0, 1, 1, 0, 1, 1, 0, 1, 0, 0, 0, 1]",106,49,57,4,4,0.08163265306122448,0.07017543859649122
"[0, 1, 1, 0, 1, 0, 1, 0, 1, 0, 0, 0, 0, 1, 0]",146,89,57,8,2,0.0898876404494382,0.03508771929824561
"[0, 0, 0, 1, 0, 1, 0, 1, 1, 0, 1, 1, 1, 1, 0]",140,63,77,5,11,0.07936507936507936,0.14285714285714285
"[0, 0, 1, 0, 0, 1, 0, 0, 1, 1, 0, 1, 0, 1, 1]",129,71,58,3,6,0.04225352112676056,0.10344827586206896
"[0, 1, 1, 1, 1, 0, 1, 1, 0, 0, 1, 1, 0, 1, 0]",141,62,79,7,9,0.11290322580645161,0.11392405063291139
"[0, 0, 1, 1, 0, 0, 1, 1, 1, 0, 1, 1, 1, 1, 0]",219,95,124,11,13,0.11578947368421053,0.10483870967741936
"[1, 1, 0, 0, 0, 1, 1, 1, 1, 0, 0, 0, 0, 1, 0]",140,73,67,12,8,0.1643835616438356,0.11940298507462686
"[1, 1, 0, 1, 1, 1, 0, 0, 0, 1, 1, 0, 1, 0, 1]",140,62,78,8,8,0.12903225806451613,0.10256410256410256
"[0, 0, 0, 1, 0, 1, 0, 1, 1, 0, 1, 0, 0, 1, 0]",142,76,66,4,7,0.05263157894736842,0.10606060606060606
"[0, 0, 1, 1, 0, 1, 1, 1, 1, 0, 1, 1, 0, 1, 0]",146,59,87,11,5,0.1864406779661017,0.05747126436781609
"[0, 0, 1, 0, 1, 1, 1, 0, 0, 1, 1, 0, 1, 0, 1]",98,41,57,7,9,0.17073170731707318,0.15789473684210525
"[0, 1, 1, 1, 0, 1, 0, 1, 1, 0, 0, 0, 1, 0, 0]",119,76,43,3,3,0.039473684210526314,0.06976744186046512
"[0, 0, 1, 1, 1, 0, 1, 0, 1, 1, 0, 0, 0, 1, 0]",116,70,46,3,4,0.04285714285714286,0.08695652173913043
"[0, 1, 1, 1, 1, 0, 1, 0, 0, 0, 1, 0, 0, 0, 1]",129,70,59,4,4,0.05714285714285714,0.06779661016949153
"[0, 1, 0, 0, 0, 1, 0, 1, 0, 1, 1, 1, 0, 1, 1]",95,47,48,4,7,0.0851063829787234,0.14583333333333334
"[1, 1, 0, 0, 0, 1, 1, 1, 1, 1, 1, 0, 1, 1, 0]",266,96,170,11,17,0.11458333333333333,0.1
"[1, 1, 0, 0, 1, 0, 1, 1, 0, 1, 0, 0, 1, 0, 1]",106,48,58,5,9,0.10416666666666667,0.15517241379310345
"[0, 0, 1, 1, 0, 1, 1, 0, 0, 1, 0, 1, 1, 0, 1]",96,42,54,2,3,0.047619047619047616,0.05555555555555555
"[0, 0, 1, 1, 1, 1, 0, 0, 0, 1, 1, 1, 0, 0, 0]",203,89,114,7,7,0.07865168539325842,0.06140350877192982
"[0, 0, 0, 0, 1, 1, 1, 0, 0, 1, 0, 1, 1, 1, 1]",201,106,95,14,4,0.1320754716981132,0.042105263157894736
"[0, 0, 0, 1, 0, 0, 1, 1, 1, 0, 1, 1, 1, 0, 0]",130,72,58,7,5,0.09722222222222222,0.08620689655172414
"[0, 1, 1, 1, 0, 1, 1, 0, 0, 0, 0, 1, 0, 0, 0]",141,76,65,6,5,0.07894736842105263,0.07692307692307693
"[1, 1, 0, 0, 1, 0, 0, 1, 1, 0, 0, 0, 0, 0, 1]",172,103,69,11,5,0.10679611650485436,0.07246376811594203
"[0, 0, 0, 0, 1, 0, 0, 1, 1, 1, 0, 0, 1, 0, 1]",129,76,53,4,6,0.05263157894736842,0.11320754716981132
"[1, 0, 0, 0, 1, 0, 0, 0, 1, 1, 0, 1, 1, 1, 1]",164,77,87,7,8,0.09090909090909091,0.09195402298850575
"[0, 1, 0, 1, 1, 1, 1, 0, 0, 0, 1, 1, 0, 0, 1]",146,64,82,3,14,0.046875,0.17073170731707318
"[1, 0, 1, 0, 0, 1, 0, 1, 0, 1, 0, 1, 0, 1, 1]",95,45,50,5,3,0.1111111111111111,0.06
"[0, 0, 0, 0, 0, 1, 0, 1, 1, 0, 1, 1, 1, 0, 0]",166,103,63,12,7,0.11650485436893204,0.1111111111111111
"[0, 1, 1, 1, 1, 0, 0, 0, 0, 0, 0, 1, 0, 0, 1]",344,268,76,19,8,0.0708955223880597,0.10526315789473684
"[1, 0, 1, 1, 0, 0, 0, 0, 0, 0, 0, 1, 1, 0, 1]",174,108,66,15,6,0.1388888888888889,0.09090909090909091
"[1, 0, 1, 0, 1, 0, 0, 1, 1, 0, 1, 1, 0, 0, 0]",131,64,67,4,6,0.0625,0.08955223880597014
"[0, 0, 0, 1, 1, 0, 1, 0, 0, 1, 1, 0, 0, 1, 1]",239,150,89,20,7,0.13333333333333333,0.07865168539325842
"[1, 0, 0, 1, 0, 1, 0, 1, 0, 0, 1, 1, 0, 0, 1]",158,79,79,10,14,0.12658227848101267,0.17721518987341772
"[1, 0, 1, 0, 1, 0, 0, 1, 1, 0, 0, 1, 1, 1, 0]",122,58,64,9,7,0.15517241379310345,0.109375
"[1, 0, 1, 1, 0, 0, 0, 0, 1, 0, 1, 1, 1, 0, 1]",104,48,56,7,5,0.14583333333333334,0.08928571428571429
"[0, 0, 1, 1, 1, 0, 0, 0, 0, 1, 0, 0, 0, 1, 1]",209,134,75,9,5,0.06716417910447761,0.06666666666666667
"[1, 1, 0, 1, 1, 1, 0, 1, 0, 0, 1, 0, 1, 0, 0]",96,44,52,3,6,0.06818181818181818,0.11538461538461539
"[0, 1, 1, 0, 0, 1, 0, 1, 1, 0, 1, 0, 0, 1, 1]",129,76,53,5,7,0.06578947368421052,0.1320754716981132
"[0, 0, 1, 1, 1, 0, 0, 0, 1, 1, 0, 1, 1, 1, 0]",136,79,57,6,6,0.0759493670886076,0.10526315789473684
"[1, 1, 1, 1, 1, 0, 1, 0, 1, 0, 0, 0, 1, 0, 0]",111,54,57,5,4,0.09259259259259259,0.07017543859649122
"[1, 1, 0, 0, 1, 0, 0, 1, 1, 0, 0, 1, 0, 0, 1]",112,55,57,2,6,0.03636363636363636,0.10526315789473684
"[0, 1, 1, 1, 1, 0, 0, 0, 1, 0, 1, 0, 0, 1, 0]",108,63,45,11,6,0.1746031746031746,0.13333333333333333
"[0, 1, 1, 0, 0, 1, 0, 0, 0, 1, 1, 1, 1, 0, 0]",220,127,93,18,5,0.14173228346456693,0.053763440860215055
"[0, 0, 1, 1, 0, 0, 1, 1, 0, 1, 0, 0, 1, 1, 0]",166,91,75,9,6,0.0989010989010989,0.08
"[0, 1, 1, 0, 0, 0, 1, 1, 0, 0, 0, 1, 1, 0, 1]",109,65,44,3,2,0.046153846153846156,0.045454545454545456
"[0, 0, 0, 1, 1, 0, 0, 0, 1, 0, 1, 1, 0, 0, 1]",189,106,83,9,4,0.08490566037735849,0.04819277108433735
"[1, 1, 0, 1, 0, 1, 0, 1, 0, 0, 0, 0, 1, 1, 0]",136,62,74,8,7,0.12903225806451613,0.0945945945945946
"[1, 1, 0, 1, 1, 1, 1, 1, 0, 0, 0, 0, 1, 0, 1]",178,64,114,11,14,0.171875,0.12280701754385964
"[0, 0, 0, 1, 0, 1, 1, 1, 1, 1, 1, 1, 0, 0, 0]",226,129,97,9,11,0.06976744186046512,0.1134020618556701
"[0, 1, 1, 1, 0, 0, 1, 0, 0, 1, 1, 0, 1, 0, 1]",142,76,66,3,8,0.039473684210526314,0.12121212121212122
"[1, 1, 0, 1, 0, 0, 1, 0, 0, 0, 1, 0, 1, 1, 0]",134,62,72,6,3,0.0967741935483871,0.041666666666666664
"[0, 1, 1, 0, 1, 1, 0, 0, 1, 1, 1, 0, 1, 1, 0]",164,62,102,4,7,0.06451612903225806,0.06862745098039216
"[0, 1, 0, 0, 1, 1, 0, 1, 0, 1, 0, 1, 1, 1, 1]",176,68,108,8,15,0.11764705882352941,0.1388888888888889
"[1, 1, 0, 1, 1, 0, 0, 1, 1, 1, 0, 0, 0, 1, 0]",118,40,78,1,9,0.025,0.11538461538461539
"[0, 1, 1, 1, 0, 0, 0, 0, 1, 1, 1, 1, 1, 0, 1]",201,88,113,6,11,0.06818181818181818,0.09734513274336283
"[0, 1, 1, 0, 1, 0, 0, 0, 1, 0, 1, 0, 0, 1, 1]",138,72,66,13,4,0.18055555555555555,0.06060606060606061
"[0, 1, 1, 0, 0, 1, 1, 0, 1, 0, 1, 0, 0, 1, 1]",159,96,63,9,6,0.09375,0.09523809523809523
"[1, 0, 1, 0, 1, 1, 1, 0, 1, 1, 0, 1, 1, 0, 0]",142,59,83,8,7,0.13559322033898305,0.08433734939759036
"[1, 1, 1, 0, 0, 0, 1, 0, 0, 1, 0, 1, 0, 1, 0]",106,55,51,5,5,0.09090909090909091,0.09803921568627451
"[0, 1, 1, 1, 1, 0, 0, 0, 1, 0, 0, 1, 0, 1, 0]",122,70,52,8,6,0.11428571428571428,0.11538461538461539
"[1, 0, 1, 1, 1, 0, 0, 0, 1, 1, 1, 0, 0, 1, 0]",113,57,56,4,6,0.07017543859649122,0.10714285714285714
"[0, 1, 0, 1, 0, 0, 0, 0, 1, 1, 0, 1, 0, 1, 0]",159,87,72,8,9,0.09195402298850575,0.125
"[1, 0, 0, 0, 0, 1, 1, 1, 1, 0, 0, 1, 0, 1, 0]",226,89,137,8,11,0.0898876404494382,0.08029197080291971
"[0, 1, 0, 1, 0, 0, 0, 1, 0, 1, 0, 0, 1, 0, 0]",228,149,79,12,7,0.08053691275167785,0.08860759493670886
"[1, 1, 1, 0, 0, 0, 1, 0, 1, 1, 0, 1, 0, 0, 0]",139,70,69,9,6,0.12857142857142856,0.08695652173913043
"[0, 1, 1, 0, 0, 0, 1, 0, 0, 1, 0, 1, 0, 1, 1]",116,76,40,4,3,0.05263157894736842,0.075
"[1, 0, 1, 0, 0, 0, 1, 1, 0, 0, 0, 0, 0, 1, 1]",222,127,95,7,16,0.05511811023622047,0.16842105263157894
"[1, 0, 0, 1, 1, 1, 1, 1, 0, 0, 0, 1, 0, 0, 0]",150,76,74,4,5,0.05263157894736842,0.06756756756756757
"[1, 1, 1, 0, 0, 1, 1, 1, 1, 1, 0, 0, 0, 1, 0]",200,58,142,3,19,0.05172413793103448,0.13380281690140844
"[0, 1, 0, 1, 1, 1, 1, 1, 1, 1, 0, 0, 0, 1, 0]",152,66,86,12,8,0.18181818181818182,0.09302325581395349
"[0, 1, 0, 1, 1, 1, 1, 0, 1, 0, 1, 1, 1, 0, 0]",196,80,116,4,10,0.05,0.08620689655172414
"[0, 1, 1, 1, 0, 1, 1, 0, 0, 0, 1, 0, 0, 0, 1]",110,65,45,10,5,0.15384615384615385,0.1111111111111111
"[1, 0, 1, 1, 0, 0, 1, 0, 0, 0, 1, 1, 0, 0, 0]",190,103,87,10,7,0.0970873786407767,0.08045977011494253
"[0, 0, 1, 0, 0, 0, 1, 1, 1, 1, 1, 1, 0, 1, 1]",194,80,114,10,10,0.125,0.08771929824561403
"[1, 1, 0, 1, 1, 0, 1, 1, 0, 0, 0, 1, 0, 1, 1]",153,65,88,5,6,0.07692307692307693,0.06818181818181818
"[1, 1, 1, 0, 1, 0, 0, 0, 0, 0, 1, 0, 1, 1, 1]",147,58,89,5,8,0.08620689655172414,0.0898876404494382
"[1, 0, 1, 0, 1, 1, 1, 1, 0, 1, 1, 1, 0, 0, 0]",187,80,107,7,13,0.0875,0.12149532710280374
"[0, 1, 1, 1, 0, 0, 1, 0, 0, 0, 0, 1, 0, 1, 1]",138,73,65,5,4,0.0684931506849315,0.06153846153846154
"[0, 1, 0, 0, 0, 1, 0, 1, 0, 1, 0, 0, 0, 1, 1]",170,96,74,12,11,0.125,0.14864864864864866
"[0, 1, 1, 1, 0, 0, 1, 0, 1, 0, 0, 1, 1, 0, 1]",107,42,65,1,8,0.023809523809523808,0.12307692307692308
"[1, 0, 0, 0, 0, 1, 0, 0, 1, 1, 1, 1, 0, 0, 1]",243,132,111,13,14,0.09848484848484848,0.12612612612612611
"[1, 0, 1, 1, 0, 1, 1, 0, 0, 1, 0, 1, 0, 1, 0]",99,47,52,6,1,0.1276595744680851,0.019230769230769232
"[1, 0, 0, 0, 1, 1, 0, 1, 0, 1, 0, 1, 0, 1, 0]",103,52,51,4,1,0.07692307692307693,0.0196078431372549
"[1, 1, 1, 0, 0, 1, 0, 0, 0, 1, 0, 0, 1, 1, 1]",174,81,93,6,3,0.07407407407407407,0.03225806451612903
"[1, 1, 0, 1, 0, 0, 1, 1, 0, 0, 0, 0, 1, 0, 0]",123,66,57,3,4,0.045454545454545456,0.07017543859649122
"[1, 0, 0, 1, 0, 0, 1, 1, 1, 0, 1, 0, 0, 1, 0]",110,55,55,3,6,0.05454545454545454,0.10909090909090909
"[0, 1, 0, 1, 0, 1, 1, 1, 1, 0, 0, 1, 0, 0, 1]",131,59,72,5,9,0.0847457627118644,0.125
"[1, 0, 1, 1, 0, 0, 0, 1, 0, 1, 0, 1, 1, 1, 1]",171,68,103,9,23,0.1323529411764706,0.22330097087378642
"[0, 0, 1, 0, 1, 0, 1, 1, 0, 0, 1, 0, 1, 0, 0]",144,86,58,8,6,0.09302325581395349,0.10344827586206896
"[0, 1, 0, 1, 1, 0, 1, 0, 1, 1, 0, 1, 1, 1, 0]",132,50,82,7,4,0.14,0.04878048780487805
"[0, 0, 1, 0, 1, 1, 0, 1, 1, 0, 0, 0, 1, 1, 1]",170,77,93,7,8,0.09090909090909091,0.08602150537634409
"[1, 1, 1, 0, 1, 0, 1, 0, 0, 1, 1, 0, 0, 0, 1]",135,59,76,5,5,0.0847457627118644,0.06578947368421052
"[1, 0, 1, 1, 1, 1, 0, 1, 0, 1, 0, 0, 1, 1, 0]",137,61,76,5,13,0.08196721311475409,0.17105263157894737
"[0, 1, 1, 1, 0, 0, 1, 0, 1, 0, 1, 1, 1, 0, 1]",127,60,67,9,6,0.15,0.08955223880597014
"[0, 0, 1, 1, 1, 0, 1, 1, 1, 0, 0, 1, 0, 0, 0]",121,60,61,4,6,0.06666666666666667,0.09836065573770492
"[1, 0, 1, 1, 0, 0, 0, 1, 1, 1, 0, 0, 1, 1, 0]",139,64,75,4,4,0.0625,0.05333333333333334
"[1, 0, 0, 1, 1, 1, 0, 1, 1, 1, 0, 1, 1, 0, 0]",157,65,92,5,8,0.07692307692307693,0.08695652173913043
"[0, 0, 1, 1, 1, 0, 0, 1, 0, 0, 1, 0, 0, 1, 1]",134,72,62,4,3,0.05555555555555555,0.04838709677419355
"[0, 1, 1, 1, 0, 1, 0, 1, 0, 1, 0, 1, 0, 1, 0]",85,43,42,4,4,0.09302325581395349,0.09523809523809523
"[0, 1, 0, 1, 0, 1, 1, 1, 0, 1, 1, 0, 1, 0, 0]",107,46,61,6,3,0.13043478260869565,0.04918032786885246
"[0, 1, 0, 1, 0, 1, 0, 1, 0, 1, 0, 0, 1, 0, 0]",137,79,58,9,3,0.11392405063291139,0.05172413793103448
"[0, 1, 1, 0, 0, 0, 1, 1, 0, 0, 1, 1, 1, 0, 0]",168,94,74,11,6,0.11702127659574468,0.08108108108108109
"[1, 1, 0, 1, 0, 0, 0, 1, 0, 1, 1, 0, 0, 0, 1]",112,62,50,3,4,0.04838709677419355,0.08
"[1, 1, 0, 1, 1, 0, 1, 0, 0, 1, 0, 1, 1, 0, 1]",138,59,79,5,5,0.0847457627118644,0.06329113924050633
"[1, 0, 1, 0, 1, 0, 1, 1, 0, 0, 1, 1, 0, 1, 1]",135,60,75,4,5,0.06666666666666667,0.06666666666666667
"[1, 1, 0, 1, 0, 1, 0, 1, 1, 0, 0, 1, 1, 0, 1]",136,56,80,6,4,0.10714285714285714,0.05
"[1, 1, 0, 0, 0, 0, 0, 1, 1, 1, 0, 1, 0, 1, 0]",120,56,64,2,1,0.03571428571428571,0.015625
"[1, 0, 1, 0, 1, 1, 0, 0, 1, 1, 0, 0, 1, 0, 1]",117,58,59,2,4,0.034482758620689655,0.06779661016949153
"[1, 1, 0, 1, 0, 1, 1, 0, 0, 1, 1, 0, 0, 1, 0]",107,47,60,4,5,0.0851063829787234,0.08333333333333333
"[0, 0, 0, 0, 1, 0, 1, 1, 0, 1, 0, 1, 1, 0, 1]",106,61,45,2,7,0.03278688524590164,0.15555555555555556
"[0, 0, 1, 1, 0, 1, 0, 1, 1, 1, 1, 1, 0, 1, 0]",158,65,93,4,7,0.06153846153846154,0.07526881720430108
"[1, 0, 1, 0, 0, 1, 0, 1, 0, 1, 0, 0, 1, 1, 0]",137,70,67,10,8,0.14285714285714285,0.11940298507462686
"[1, 0, 1, 0, 0, 0, 0, 1, 0, 1, 1, 1, 1, 1, 0]",123,60,63,8,10,0.13333333333333333,0.15873015873015872
"[1, 0, 1, 1, 1, 1, 1, 0, 1, 0, 1, 1, 0, 1, 0]",189,50,139,8,15,0.16,0.1079136690647482
"[0, 1, 1, 1, 1, 0, 0, 0, 0, 0, 1, 1, 1, 0, 1]",178,107,71,10,10,0.09345794392523364,0.14084507042253522
"[0, 1, 1, 0, 0, 1, 1, 1, 0, 1, 1, 0, 1, 0, 0]",125,72,53,6,10,0.08333333333333333,0.18867924528301888
"[1, 1, 0, 1, 0, 1, 0, 0, 0, 1, 0, 0, 1, 1, 0]",102,53,49,9,6,0.16981132075471697,0.12244897959183673
"[1, 0, 1, 0, 0, 0, 0, 0, 1, 0, 1, 0, 1, 1, 1]",139,80,59,12,5,0.15,0.0847457627118644
"[1, 0, 1, 0, 1, 1, 0, 1, 1, 1, 0, 1, 0, 1, 1]",225,83,142,7,17,0.08433734939759036,0.11971830985915492
"[1, 1, 1, 1, 0, 0, 0, 1, 0, 1, 1, 1, 1, 0, 0]",237,83,154,4,12,0.04819277108433735,0.07792207792207792
"[1, 0, 1, 0, 0, 1, 1, 0, 1, 0, 0, 0, 0, 0, 1]",162,85,77,8,7,0.09411764705882353,0.09090909090909091
"[1, 0, 0, 0, 1, 0, 1, 1, 1, 0, 0, 0, 1, 1, 1]",165,79,86,9,5,0.11392405063291139,0.05813953488372093
"[0, 0, 1, 0, 1, 1, 1, 0, 0, 0, 1, 0, 1, 0, 1]",108,56,52,2,5,0.03571428571428571,0.09615384615384616
"[0, 0, 1, 1, 1, 0, 0, 0, 1, 1, 0, 1, 0, 1, 1]",111,56,55,4,4,0.07142857142857142,0.07272727272727272
"[0, 1, 0, 0, 1, 1, 1, 0, 0, 0, 1, 1, 0, 1, 0]",97,58,39,6,3,0.10344827586206896,0.07692307692307693
"[1, 1, 0, 0, 0, 1, 1, 1, 1, 1, 0, 0, 0, 1, 1]",196,69,127,3,9,0.043478260869565216,0.07086614173228346
"[0, 1, 0, 0, 0, 0, 1, 1, 1, 0, 1, 0, 1, 0, 1]",109,54,55,5,5,0.09259259259259259,0.09090909090909091
"[1, 0, 1, 0, 1, 0, 1, 1, 1, 1, 1, 1, 0, 0, 0]",207,96,111,9,16,0.09375,0.14414414414414414
"[0, 0, 1, 1, 1, 1, 1, 0, 0, 1, 0, 0, 1, 0, 0]",128,73,55,12,4,0.1643835616438356,0.07272727272727272
"[1, 0, 1, 0, 0, 1, 0, 1, 0, 0, 0, 1, 1, 0, 1]",102,50,52,4,4,0.08,0.07692307692307693
"[0, 0, 0, 1, 0, 0, 0, 1, 0, 1, 1, 1, 1, 0, 1]",92,50,42,8,6,0.16,0.14285714285714285
"[1, 0, 1, 1, 0, 0, 0, 1, 0, 0, 0, 0, 1, 0, 1]",148,97,51,11,3,0.1134020618556701,0.058823529411764705
"[0, 0, 1, 1, 0, 0, 1, 0, 1, 1, 0, 1, 0, 0, 1]",124,73,51,10,7,0.136986301369863,0.13725490196078433
"[1, 1, 0, 1, 1, 1, 0, 0, 1, 0, 0, 0, 0, 1, 0]",111,54,57,3,4,0.05555555555555555,0.07017543859649122
"[1, 0, 0, 0, 1, 1, 0, 1, 1, 1, 0, 0, 1, 0, 1]",105,46,59,6,10,0.13043478260869565,0.1694915254237288
"[1, 1, 0, 1, 0, 0, 0, 1, 0, 1, 1, 0, 1, 0, 1]",82,30,52,5,7,0.16666666666666666,0.1346153846153846
"[1, 1, 0, 0, 1, 0, 1, 0, 1, 0, 1, 0, 0, 0, 1]",103,45,58,4,5,0.08888888888888889,0.08620689655172414
"[0, 0, 1, 0, 1, 0, 1, 1, 1, 0, 1, 1, 1, 0, 0]",110,60,50,5,4,0.08333333333333333,0.08
"[0, 1, 0, 0, 0, 1, 0, 0, 1, 0, 1, 1, 0, 1, 0]",127,63,64,4,6,0.06349206349206349,0.09375
"[1, 1, 0, 1, 1, 0, 1, 0, 1, 0, 0, 1, 0, 0, 1]",120,55,65,4,6,0.07272727272727272,0.09230769230769231
"[0, 0, 1, 0, 0, 1, 1, 1, 0, 0, 1, 0, 1, 0, 1]",84,34,50,5,6,0.14705882352941177,0.12
"[1, 0, 1, 0, 0, 1, 1, 0, 0, 0, 1, 0, 0, 0, 1]",138,88,50,8,8,0.09090909090909091,0.16
"[1, 0, 1, 1, 0, 1, 0, 1, 1, 0, 0, 0, 1, 0, 1]",115,51,64,6,5,0.11764705882352941,0.078125
"[1, 1, 1, 1, 1, 0, 0, 0, 1, 1, 0, 1, 0, 0, 0]",166,69,97,8,7,0.11594202898550725,0.07216494845360824
"[1, 1, 1, 0, 1, 0, 0, 0, 0, 1, 0, 1, 1, 0, 1]",91,43,48,2,4,0.046511627906976744,0.08333333333333333
"[0, 0, 0, 1, 0, 1, 1, 0, 1, 1, 1, 1, 0, 1, 0]",128,62,66,7,11,0.11290322580645161,0.16666666666666666
"[1, 1, 0, 1, 0, 1, 0, 1, 1, 1, 0, 0, 0, 1, 0]",101,51,50,5,7,0.09803921568627451,0.14
"[1, 1, 0, 1, 0, 1, 0, 1, 0, 1, 0, 0, 0, 0, 0]",173,107,66,9,8,0.08411214953271028,0.12121212121212122
"[1, 1, 0, 1, 0, 0, 0, 1, 1, 0, 0, 0, 1, 1, 0]",134,70,64,4,6,0.05714285714285714,0.09375
"[0, 1, 1, 1, 1, 0, 1, 1, 0, 1, 0, 0, 0, 0, 0]",153,91,62,6,8,0.06593406593406594,0.12903225806451613
"[1, 0, 1, 0, 1, 1, 0, 0, 1, 0, 0, 0, 1, 0, 0]",146,75,71,6,6,0.08,0.08450704225352113
"[0, 1, 0, 1, 1, 1, 1, 1, 1, 0, 0, 0, 1, 0, 0]",131,71,60,6,4,0.08450704225352113,0.06666666666666667
"[0, 0, 1, 1, 1, 0, 1, 0, 0, 1, 1, 1, 0, 1, 0]",107,57,50,4,1,0.07017543859649122,0.02
"[1, 0, 0, 1, 0, 1, 0, 1, 0, 0, 1, 0, 1, 0, 1]",99,59,40,4,3,0.06779661016949153,0.075
"[1, 0, 1, 0, 0, 0, 1, 1, 1, 0, 1, 1, 1, 0, 0]",103,46,57,5,7,0.10869565217391304,0.12280701754385964
"[0, 1, 0, 1, 1, 1, 0, 0, 0, 1, 0, 1, 1, 0, 0]",112,65,47,1,2,0.015384615384615385,0.0425531914893617
"[1, 0, 1, 1, 1, 0, 0, 0, 0, 0, 1, 1, 0, 1, 0]",95,45,50,3,3,0.06666666666666667,0.06
"[1, 0, 1, 0, 1, 0, 1, 0, 1, 0, 0, 1, 0, 1, 1]",125,55,70,9,8,0.16363636363636364,0.11428571428571428
"[0, 0, 0, 1, 1, 1, 0, 1, 0, 0, 1, 0, 0, 1, 0]",134,89,45,9,4,0.10112359550561797,0.08888888888888889
"[0, 0, 0, 1, 1, 1, 0, 1, 1, 0, 0, 1, 0, 1, 1]",130,77,53,7,8,0.09090909090909091,0.1509433962264151
"[0, 0, 1, 1, 0, 1, 1, 1, 0, 1, 1, 0, 0, 0, 1]",99,48,51,4,4,0.08333333333333333,0.0784313725490196
"[0, 1, 1, 0, 0, 0, 1, 1, 0, 1, 1, 1, 1, 1, 0]",166,76,90,5,6,0.06578947368421052,0.06666666666666667
"[1, 1, 1, 0, 1, 1, 0, 1, 0, 0, 0, 1, 0, 1, 0]",94,40,54,2,6,0.05,0.1111111111111111
"[0, 0, 1, 1, 0, 1, 1, 0, 0, 0, 1, 0, 1, 0, 1]",119,68,51,7,5,0.10294117647058823,0.09803921568627451
"[0, 1, 1, 1, 1, 0, 0, 1, 0, 0, 1, 0, 1, 1, 0]",119,67,52,5,4,0.07462686567164178,0.07692307692307693
"[1, 0, 1, 0, 1, 0, 1, 0, 1, 0, 1, 0, 1, 0, 1]",93,57,36,8,2,0.14035087719298245,0.05555555555555555
"[0, 1, 0, 1, 0, 1, 0, 1, 0, 1, 0, 1, 0, 1, 0]",105,53,52,5,7,0.09433962264150944,0.1346153846153846
"[0, 1, 0, 0, 1, 0, 1, 1, 1, 0, 0, 1, 0, 1, 1]",94,40,54,5,1,0.125,0.018518518518518517
"[1, 1, 1, 1, 1, 1, 1, 1, 1, 0, 0, 0, 0, 0, 0]",2544,525,2019,54,187,0.10285714285714286,0.09262010896483408
"[1, 1, 0, 0, 0, 1, 1, 1, 1, 1, 1, 1, 1, 1, 1]",3776,916,2860,87,266,0.09497816593886463,0.09300699300699301
"[0, 1, 0, 1, 0, 0, 0, 1, 0, 0, 1, 1, 0, 0, 0]",307,198,109,17,9,0.08585858585858586,0.08256880733944955
"[1, 1, 0, 0, 1, 1, 0, 0, 0, 1, 0, 1, 0, 0, 0]",211,121,90,12,9,0.09917355371900827,0.1
"[1, 1, 0, 1, 0, 1, 1, 1, 0, 1, 0, 0, 1, 1, 1]",252,81,171,10,19,0.12345679012345678,0.1111111111111111
"[1, 1, 1, 1, 1, 0, 1, 0, 1, 0, 1, 1, 1, 1, 0]",536,166,370,26,48,0.1566265060240964,0.12972972972972974
"[1, 1, 1, 1, 1, 1, 0, 1, 0, 1, 0, 1, 1, 1, 1]",1927,411,1516,46,148,0.11192214111922141,0.09762532981530343
"[1, 1, 1, 1, 1, 1, 1, 1, 0, 1, 0, 1, 0, 1, 1]",1859,454,1405,45,132,0.09911894273127753,0.09395017793594305
"[1, 1, 1, 0, 1, 1, 1, 1, 1, 1, 1, 1, 1, 0, 0]",3104,698,2406,70,210,0.10028653295128939,0.08728179551122195
"[0, 1, 1, 1, 0, 0, 0, 0, 0, 0, 0, 0, 0, 0, 0]",3588,2760,828,286,91,0.1036231884057971,0.10990338164251208
"[1, 0, 0, 0, 0, 1, 1, 0, 0, 1, 0, 0, 0, 0, 0]",730,420,310,35,22,0.08333333333333333,0.07096774193548387
"[1, 0, 0, 0, 0, 0, 0, 1, 1, 0, 1, 1, 0, 0, 0]",375,212,163,22,13,0.10377358490566038,0.07975460122699386
"[0, 1, 0, 0, 0, 0, 1, 0, 1, 1, 0, 0, 1, 0, 1]",117,68,49,2,6,0.029411764705882353,0.12244897959183673
"[0, 0, 0, 0, 0, 0, 1, 1, 0, 0, 0, 0, 0, 0, 0]",27648,22795,4853,2123,403,0.09313445931125247,0.0830414176797857
"[0, 1, 0, 0, 0, 0, 0, 0, 0, 0, 1, 0, 0, 0, 0]",7286,5944,1342,563,116,0.09471736204576044,0.08643815201192251
"[0, 0, 0, 1, 0, 0, 0, 0, 0, 0, 0, 0, 1, 0, 0]",6985,5702,1283,576,110,0.10101718695194668,0.08573655494933749
"[0, 0, 0, 0, 1, 0, 0, 0, 0, 0, 0, 0, 0, 1, 0]",6826,5583,1243,579,102,0.10370768404083826,0.08205953338696702
"[1, 1, 0, 1, 1, 1, 1, 1, 1, 1, 1, 1, 1, 1, 1]",67866,8653,59213,836,5632,0.09661389113602219,0.09511424856028237
"[1, 0, 0, 0, 1, 1, 1, 1, 0, 0, 1, 1, 1, 1, 1]",796,279,517,30,56,0.10752688172043011,0.10831721470019343
"[1, 1, 1, 1, 0, 0, 0, 1, 1, 1, 1, 0, 0, 1, 1]",661,209,452,15,36,0.07177033492822966,0.07964601769911504
"[0, 1, 1, 1, 1, 0, 0, 0, 1, 1, 1, 1, 0, 0, 1]",287,130,157,10,17,0.07692307692307693,0.10828025477707007
"[1, 0, 1, 1, 0, 1, 1, 1, 1, 0, 0, 1, 0, 0, 0]",121,64,57,9,10,0.140625,0.17543859649122806
"[1, 0, 0, 0, 0, 0, 1, 1, 1, 1, 0, 1, 1, 0, 1]",136,61,75,5,6,0.08196721311475409,0.08
"[1, 1, 1, 0, 0, 1, 1, 0, 1, 0, 0, 0, 0, 0, 1]",174,77,97,7,4,0.09090909090909091,0.041237113402061855
"[1, 0, 1, 1, 1, 1, 0, 1, 1, 1, 1, 1, 0, 1, 0]",505,179,326,17,45,0.09497206703910614,0.13803680981595093
"[1, 1, 0, 1, 0, 1, 1, 0, 1, 1, 1, 0, 1, 1, 1]",584,169,415,18,37,0.10650887573964497,0.0891566265060241
"[1, 1, 1, 1, 1, 1, 1, 1, 0, 1, 0, 1, 1, 0, 1]",1736,390,1346,39,131,0.1,0.09732540861812779
"[1, 1, 0, 1, 0, 1, 1, 1, 1, 1, 1, 1, 1, 1, 0]",1978,481,1497,48,131,0.0997920997920998,0.08750835003340013
"[1, 0, 1, 0, 0, 1, 0, 1, 1, 1, 1, 1, 0, 1, 1]",240,74,166,8,15,0.10810810810810811,0.09036144578313253
"[0, 1, 1, 1, 1, 0, 1, 0, 0, 1, 0, 1, 1, 1, 1]",304,138,166,17,19,0.12318840579710146,0.1144578313253012
"[0, 0, 1, 1, 1, 0, 1, 0, 1, 1, 1, 1, 0, 1, 0]",150,66,84,4,12,0.06060606060606061,0.14285714285714285
"[1, 0, 0, 1, 0, 1, 1, 0, 1, 0, 1, 0, 0, 0, 0]",163,82,81,8,5,0.0975609756097561,0.06172839506172839
"[1, 0, 0, 1, 1, 1, 0, 1, 1, 0, 0, 1, 0, 0, 0]",151,90,61,9,6,0.1,0.09836065573770492
"[1, 1, 1, 1, 1, 1, 1, 1, 1, 0, 1, 1, 1, 0, 1]",7560,1285,6275,126,606,0.0980544747081712,0.09657370517928286
"[0, 0, 0, 0, 0, 0, 0, 0, 1, 0, 0, 0, 0, 1, 1]",4214,3431,783,339,68,0.0988050131157097,0.08684546615581099
"[1, 1, 1, 1, 1, 0, 1, 1, 0, 1, 0, 0, 0, 1, 1]",313,97,216,16,12,0.16494845360824742,0.05555555555555555
"[0, 1, 1, 0, 1, 0, 1, 1, 0, 0, 0, 0, 0, 1, 1]",179,97,82,6,10,0.061855670103092786,0.12195121951219512
"[1, 1, 1, 1, 1, 1, 1, 1, 1, 0, 0, 0, 1, 1, 0]",983,245,738,17,72,0.06938775510204082,0.0975609756097561
"[1, 0, 1, 0, 1, 1, 1, 1, 1, 1, 0, 0, 0, 1, 0]",153,65,88,5,6,0.07692307692307693,0.06818181818181818
"[1, 0, 1, 1, 0, 0, 1, 0, 1, 0, 1, 1, 1, 1, 1]",312,112,200,13,13,0.11607142857142858,0.065
"[0, 0, 0, 0, 0, 0, 0, 1, 1, 1, 1, 0, 0, 1, 1]",2427,2015,412,174,33,0.08635235732009926,0.08009708737864078
"[1, 1, 0, 0, 0, 0, 0, 0, 0, 0, 1, 1, 1, 1, 0]",1856,1091,765,106,74,0.09715857011915674,0.09673202614379085
"[0, 0, 1, 1, 0, 0, 0, 0, 0, 0, 0, 0, 1, 1, 1]",3950,2719,1231,260,123,0.09562339095255609,0.09991876523151909
"[0, 0, 0, 0, 0, 0, 0, 0, 0, 0, 1, 0, 0, 1, 1]",4722,3928,794,384,59,0.09775967413441955,0.0743073047858942
"[1, 0, 0, 0, 1, 1, 1, 0, 1, 0, 1, 1, 1, 0, 1]",127,50,77,4,1,0.08,0.012987012987012988
"[1, 1, 0, 0, 1, 1, 1, 1, 0, 0, 1, 1, 1, 1, 1]",5342,1580,3762,157,346,0.09936708860759494,0.09197235513024987
"[0, 0, 0, 0, 0, 1, 0, 1, 1, 0, 0, 1, 1, 1, 1]",302,172,130,12,9,0.06976744186046512,0.06923076923076923
"[0, 0, 0, 0, 0, 0, 1, 0, 1, 0, 0, 0, 0, 0, 0]",8349,6842,1507,681,133,0.09953230049693072,0.08825481088254811
"[0, 0, 0, 0, 1, 1, 0, 0, 0, 0, 1, 1, 1, 1, 1]",2042,1109,933,115,88,0.1036970243462579,0.09431939978563773
"[1, 1, 1, 0, 0, 1, 1, 0, 0, 1, 1, 0, 0, 1, 1]",2082,351,1731,34,173,0.09686609686609686,0.0999422299248989
"[1, 0, 1, 0, 0, 0, 1, 0, 0, 0, 0, 1, 0, 1, 1]",145,87,58,6,7,0.06896551724137931,0.1206896551724138
"[1, 1, 1, 1, 1, 1, 0, 0, 1, 1, 0, 1, 1, 1, 1]",2855,664,2191,61,201,0.09186746987951808,0.09173893199452304
"[0, 1, 1, 0, 1, 1, 1, 0, 1, 1, 1, 1, 1, 1, 0]",531,151,380,9,51,0.059602649006622516,0.13421052631578947
"[1, 1, 1, 1, 1, 1, 0, 1, 0, 1, 1, 1, 1, 1, 1]",8899,1481,7418,140,740,0.09453072248480757,0.09975734699379887
"[1, 1, 1, 1, 1, 1, 1, 0, 1, 0, 1, 1, 1, 1, 1]",8968,1507,7461,133,732,0.08825481088254811,0.09811017289907518
"[1, 1, 0, 1, 1, 1, 1, 1, 1, 1, 1, 0, 1, 0, 1]",1587,369,1218,28,115,0.07588075880758807,0.09441707717569786
"[1, 1, 1, 0, 0, 0, 0, 0, 1, 0, 1, 0, 1, 1, 1]",182,83,99,11,10,0.13253012048192772,0.10101010101010101
"[0, 1, 0, 1, 0, 0, 1, 1, 1, 0, 0, 0, 0, 0, 1]",172,94,78,9,4,0.09574468085106383,0.05128205128205128
"[0, 1, 0, 0, 0, 1, 0, 1, 0, 1, 0, 0, 1, 1, 1]",155,92,63,12,6,0.13043478260869565,0.09523809523809523
"[0, 1, 0, 1, 0, 0, 0, 1, 0, 1, 0, 1, 0, 0, 1]",131,81,50,7,5,0.08641975308641975,0.1
"[0, 0, 1, 1, 0, 0, 1, 0, 1, 0, 1, 1, 1, 1, 0]",152,77,75,10,4,0.12987012987012986,0.05333333333333334
"[0, 1, 0, 1, 0, 0, 1, 1, 0, 0, 1, 0, 1, 0, 1]",102,64,38,7,5,0.109375,0.13157894736842105
"[0, 0, 0, 0, 0, 0, 1, 0, 1, 0, 0, 1, 1, 0, 0]",747,534,213,51,19,0.09550561797752809,0.0892018779342723
"[0, 1, 0, 0, 0, 0, 1, 1, 0, 0, 1, 0, 0, 1, 1]",202,118,84,7,9,0.059322033898305086,0.10714285714285714
"[1, 0, 1, 0, 1, 0, 0, 0, 0, 0, 0, 0, 1, 1, 1]",287,161,126,20,11,0.12422360248447205,0.0873015873015873
"[1, 0, 0, 0, 0, 1, 0, 0, 0, 1, 0, 0, 0, 1, 1]",302,186,116,20,14,0.10752688172043011,0.1206896551724138
"[0, 1, 0, 0, 0, 0, 1, 0, 0, 0, 1, 0, 0, 0, 1]",530,374,156,37,17,0.09893048128342247,0.10897435897435898
"[0, 0, 0, 0, 0, 1, 1, 1, 1, 1, 1, 1, 1, 1, 1]",2947,2206,741,209,67,0.09474161378059837,0.09041835357624832
"[1, 1, 0, 0, 0, 0, 0, 0, 0, 0, 1, 1, 1, 1, 1]",2103,1048,1055,91,107,0.0868320610687023,0.1014218009478673
"[1, 1, 1, 1, 1, 0, 0, 0, 0, 0, 0, 0, 0, 1, 1]",1839,373,1466,40,142,0.10723860589812333,0.09686221009549795
"[0, 0, 1, 1, 1, 1, 1, 1, 0, 0, 0, 0, 0, 0, 0]",2221,1382,839,124,79,0.08972503617945007,0.09415971394517282
"[1, 0, 0, 1, 1, 1, 1, 1, 1, 0, 0, 0, 0, 0, 0]",1599,329,1270,30,117,0.0911854103343465,0.09212598425196851
"[1, 1, 0, 0, 1, 1, 1, 1, 1, 1, 0, 0, 0, 0, 0]",1541,778,763,64,81,0.08226221079691516,0.10615989515072084
"[1, 0, 0, 1, 1, 1, 1, 1, 1, 1, 1, 0, 0, 1, 1]",4280,579,3701,51,333,0.08808290155440414,0.08997568224804108
"[1, 1, 1, 1, 1, 1, 1, 0, 1, 1, 1, 0, 0, 1, 1]",2437,529,1908,40,180,0.07561436672967864,0.09433962264150944
"[1, 1, 1, 1, 1, 1, 1, 0, 1, 1, 0, 0, 1, 0, 1]",576,157,419,19,45,0.12101910828025478,0.10739856801909307
"[0, 0, 0, 0, 1, 1, 0, 0, 1, 1, 0, 1, 0, 0, 1]",281,163,118,14,13,0.08588957055214724,0.11016949152542373
"[0, 0, 1, 1, 1, 1, 0, 1, 0, 1, 0, 0, 0, 0, 0]",231,123,108,9,9,0.07317073170731707,0.08333333333333333
"[1, 1, 0, 0, 0, 0, 1, 1, 1, 1, 0, 1, 0, 1, 0]",218,105,113,14,11,0.13333333333333333,0.09734513274336283
"[1, 1, 1, 1, 0, 1, 1, 1, 1, 0, 1, 1, 1, 1, 1]",7790,1335,6455,133,591,0.099625468164794,0.09155693261037955
"[1, 1, 1, 0, 1, 1, 1, 1, 1, 1, 0, 1, 1, 1, 1]",7514,1271,6243,101,562,0.07946498819826908,0.09002082332212077
"[1, 0, 1, 1, 1, 1, 1, 1, 1, 1, 0, 1, 1, 1, 1]",7679,1335,6344,117,617,0.08764044943820225,0.09725725094577553
"[1, 1, 1, 1, 1, 1, 0, 0, 1, 1, 0, 0, 0, 0, 0]",1708,812,896,81,86,0.09975369458128079,0.09598214285714286
"[1, 0, 0, 0, 0, 0, 1, 0, 0, 1, 0, 0, 1, 0, 1]",280,174,106,20,11,0.11494252873563218,0.10377358490566038
"[0, 0, 0, 0, 1, 0, 0, 0, 1, 0, 1, 0, 0, 0, 0]",1718,1320,398,131,39,0.09924242424242424,0.09798994974874371
"[1, 0, 0, 1, 0, 0, 0, 0, 1, 0, 0, 0, 1, 0, 1]",217,134,83,16,14,0.11940298507462686,0.1686746987951807
"[0, 0, 0, 0, 1, 0, 0, 1, 0, 0, 1, 0, 0, 1, 1]",329,221,108,20,14,0.09049773755656108,0.12962962962962962
"[1, 0, 1, 1, 1, 1, 1, 1, 1, 1, 0, 0, 0, 0, 1]",885,314,571,40,57,0.12738853503184713,0.09982486865148861
"[1, 0, 1, 0, 0, 1, 1, 1, 0, 1, 1, 1, 1, 1, 1]",690,191,499,14,54,0.07329842931937172,0.10821643286573146
"[1, 0, 1, 1, 1, 0, 1, 1, 0, 1, 0, 0, 1, 1, 1]",261,97,164,9,16,0.09278350515463918,0.0975609756097561
"[1, 0, 0, 1, 1, 0, 0, 0, 0, 0, 0, 0, 0, 1, 0]",1002,461,541,37,46,0.08026030368763558,0.08502772643253234
"[0, 0, 0, 1, 1, 0, 1, 0, 0, 0, 1, 0, 0, 0, 0]",624,470,154,39,15,0.08297872340425531,0.09740259740259741
"[1, 0, 0, 0, 1, 1, 0, 1, 0, 0, 0, 1, 0, 0, 0]",221,131,90,21,8,0.16030534351145037,0.08888888888888889
"[0, 0, 0, 1, 0, 0, 0, 0, 0, 0, 0, 1, 1, 1, 1]",942,673,269,53,24,0.0787518573551263,0.08921933085501858
"[0, 1, 1, 0, 0, 0, 0, 0, 0, 0, 1, 0, 0, 0, 0]",2165,1738,427,180,32,0.10356731875719218,0.07494145199063232
"[0, 1, 0, 1, 0, 1, 1, 1, 0, 0, 0, 1, 1, 0, 0]",134,66,68,5,7,0.07575757575757576,0.10294117647058823
"[1, 1, 0, 1, 1, 0, 1, 0, 1, 0, 1, 1, 1, 0, 0]",158,73,85,17,9,0.2328767123287671,0.10588235294117647
"[0, 0, 0, 1, 1, 1, 1, 0, 1, 1, 0, 1, 0, 1, 0]",138,68,70,5,7,0.07352941176470588,0.1
"[0, 0, 1, 1, 0, 1, 1, 1, 1, 1, 1, 1, 1, 1, 1]",2813,729,2084,68,180,0.09327846364883402,0.08637236084452975
"[1, 0, 0, 0, 0, 0, 0, 0, 0, 0, 0, 1, 0, 1, 1]",1103,567,536,50,47,0.08818342151675485,0.08768656716417911
"[0, 1, 0, 0, 0, 0, 1, 1, 0, 0, 1, 1, 1, 1, 0]",446,251,195,29,19,0.11553784860557768,0.09743589743589744
"[0, 0, 1, 0, 0, 1, 0, 0, 0, 0, 1, 1, 0, 0, 1]",373,247,126,12,12,0.048582995951417005,0.09523809523809523
"[1, 1, 0, 0, 0, 1, 0, 0, 1, 0, 0, 0, 0, 1, 1]",210,121,89,10,8,0.08264462809917356,0.0898876404494382
"[1, 1, 1, 1, 0, 0, 0, 1, 0, 0, 1, 0, 0, 0, 0]",198,106,92,10,4,0.09433962264150944,0.043478260869565216
"[0, 1, 1, 0, 0, 0, 1, 1, 1, 0, 1, 1, 1, 0, 1]",163,74,89,5,11,0.06756756756756757,0.12359550561797752
"[1, 0, 0, 0, 0, 0, 1, 1, 0, 0, 1, 1, 1, 0, 0]",210,107,103,6,11,0.056074766355140186,0.10679611650485436
"[1, 0, 0, 1, 0, 0, 1, 0, 0, 0, 0, 0, 1, 1, 0]",298,203,95,29,6,0.14285714285714285,0.06315789473684211
"[1, 1, 1, 0, 0, 0, 1, 0, 0, 0, 0, 0, 1, 1, 0]",200,120,80,13,6,0.10833333333333334,0.075
"[1, 0, 1, 0, 1, 0, 1, 0, 0, 0, 0, 0, 0, 0, 1]",293,183,110,19,4,0.10382513661202186,0.03636363636363636
"[1, 1, 0, 1, 0, 1, 0, 1, 0, 0, 0, 0, 0, 0, 0]",338,218,120,19,7,0.0871559633027523,0.058333333333333334
"[1, 1, 0, 1, 1, 0, 1, 0, 1, 0, 1, 0, 0, 0, 0]",113,50,63,6,2,0.12,0.031746031746031744
"[0, 0, 0, 0, 0, 0, 0, 0, 0, 1, 1, 0, 0, 1, 0]",2728,2254,474,222,44,0.09849157054125998,0.09282700421940929
"[1, 1, 0, 1, 0, 1, 1, 1, 0, 1, 1, 1, 1, 1, 1]",1877,449,1428,43,134,0.0957683741648107,0.0938375350140056
"[0, 0, 0, 1, 0, 0, 1, 0, 0, 0, 1, 1, 0, 0, 0]",680,476,204,37,18,0.07773109243697479,0.08823529411764706
"[0, 0, 1, 1, 1, 1, 1, 0, 0, 0, 0, 1, 0, 0, 1]",138,76,62,7,7,0.09210526315789473,0.11290322580645161
"[1, 0, 1, 1, 0, 0, 0, 1, 1, 1, 0, 0, 0, 0, 1]",140,76,64,9,8,0.11842105263157894,0.125
"[0, 0, 1, 0, 1, 1, 0, 0, 0, 1, 1, 1, 0, 0, 0]",170,97,73,10,6,0.10309278350515463,0.0821917808219178
"[0, 1, 1, 1, 0, 1, 0, 1, 1, 1, 1, 1, 0, 1, 1]",513,175,338,17,36,0.09714285714285714,0.10650887573964497
"[0, 1, 0, 1, 1, 1, 1, 0, 0, 1, 1, 1, 0, 0, 1]",192,68,124,3,15,0.04411764705882353,0.12096774193548387
"[1, 1, 1, 0, 1, 1, 1, 0, 1, 0, 1, 1, 1, 1, 1]",1874,452,1422,61,142,0.13495575221238937,0.09985935302390998
"[0, 0, 0, 0, 0, 0, 0, 0, 1, 1, 1, 0, 1, 0, 0]",784,548,236,64,21,0.11678832116788321,0.08898305084745763
"[0, 1, 1, 1, 1, 1, 1, 1, 0, 0, 1, 0, 1, 1, 1]",719,259,460,27,40,0.10424710424710425,0.08695652173913043
"[1, 1, 0, 1, 0, 1, 0, 1, 1, 1, 0, 1, 1, 0, 1]",214,80,134,6,12,0.075,0.08955223880597014
"[1, 1, 0, 1, 1, 1, 1, 1, 0, 1, 1, 1, 0, 1, 0]",502,132,370,10,33,0.07575757575757576,0.0891891891891892
"[0, 1, 0, 1, 0, 0, 0, 1, 0, 0, 1, 1, 1, 1, 1]",165,71,94,8,8,0.11267605633802817,0.0851063829787234
"[0, 0, 0, 0, 0, 1, 0, 0, 0, 0, 0, 0, 0, 1, 0]",6701,5569,1132,586,107,0.10522535464176692,0.09452296819787986
"[0, 1, 0, 1, 0, 0, 0, 0, 0, 0, 0, 1, 0, 0, 0]",1656,1263,393,118,30,0.0934283452098179,0.07633587786259542
"[0, 1, 0, 0, 0, 0, 0, 0, 0, 0, 1, 0, 1, 0, 0]",1607,1221,386,121,33,0.0990990990990991,0.08549222797927461
"[0, 0, 1, 0, 1, 1, 0, 1, 0, 0, 0, 0, 0, 0, 0]",674,463,211,44,24,0.09503239740820735,0.11374407582938388
"[1, 1, 0, 0, 1, 1, 1, 1, 1, 1, 1, 1, 0, 0, 0]",2131,818,1313,92,131,0.11246943765281174,0.09977151561309977
"[0, 0, 0, 0, 1, 0, 0, 0, 1, 0, 1, 1, 1, 1, 1]",198,121,77,6,3,0.049586776859504134,0.03896103896103896
"[1, 1, 0, 0, 1, 1, 0, 0, 0, 0, 1, 1, 0, 0, 0]",1833,1081,752,92,65,0.0851063829787234,0.08643617021276596
"[0, 0, 0, 0, 0, 0, 0, 1, 1, 0, 0, 1, 1, 0, 0]",5053,4319,734,409,65,0.09469784672377865,0.0885558583106267
"[0, 1, 0, 0, 1, 1, 1, 0, 1, 0, 0, 0, 0, 0, 0]",300,198,102,14,8,0.0707070707070707,0.0784313725490196
"[1, 0, 0, 0, 0, 0, 0, 0, 0, 1, 0, 1, 1, 1, 1]",408,145,263,13,20,0.0896551724137931,0.07604562737642585
"[0, 0, 0, 1, 1, 1, 0, 0, 0, 1, 0, 0, 0, 0, 0]",684,491,193,45,25,0.09164969450101833,0.12953367875647667
"[0, 0, 0, 0, 1, 1, 1, 1, 1, 1, 1, 0, 1, 1, 1]",736,273,463,21,39,0.07692307692307693,0.08423326133909287
"[0, 0, 0, 0, 1, 1, 0, 0, 1, 1, 1, 1, 1, 1, 1]",2465,1004,1461,98,154,0.09760956175298804,0.1054072553045859
"[1, 1, 0, 0, 0, 0, 1, 1, 0, 0, 1, 1, 1, 1, 1]",2484,979,1505,102,141,0.1041879468845761,0.09368770764119601
"[1, 1, 0, 0, 1, 1, 0, 0, 0, 0, 1, 1, 0, 0, 1]",1566,798,768,75,77,0.09398496240601503,0.10026041666666667
"[1, 1, 1, 1, 1, 0, 0, 1, 1, 0, 1, 0, 0, 1, 1]",365,103,262,5,35,0.04854368932038835,0.13358778625954199
"[0, 1, 1, 1, 1, 1, 1, 0, 1, 0, 1, 1, 1, 1, 0]",606,186,420,21,40,0.11290322580645161,0.09523809523809523
"[1, 1, 1, 1, 1, 0, 0, 1, 1, 1, 0, 0, 1, 1, 1]",1167,267,900,28,100,0.10486891385767791,0.1111111111111111
"[1, 1, 1, 1, 0, 1, 0, 0, 1, 1, 1, 1, 0, 0, 0]",273,119,154,8,16,0.06722689075630252,0.1038961038961039
"[0, 1, 1, 1, 0, 0, 1, 1, 1, 1, 1, 1, 0, 1, 1]",673,210,463,10,48,0.047619047619047616,0.10367170626349892
"[0, 0, 0, 1, 1, 0, 0, 1, 1, 1, 0, 0, 0, 0, 0]",505,369,136,24,14,0.06504065040650407,0.10294117647058823
"[1, 1, 1, 1, 1, 1, 0, 1, 1, 1, 1, 1, 0, 0, 0]",865,240,625,21,60,0.0875,0.096
"[1, 1, 0, 0, 1, 1, 1, 1, 1, 1, 1, 1, 0, 1, 1]",3143,760,2383,74,255,0.09736842105263158,0.10700797314309694
"[0, 1, 0, 0, 1, 1, 0, 0, 0, 0, 0, 0, 1, 1, 0]",709,431,278,46,27,0.10672853828306264,0.09712230215827339
"[0, 0, 0, 1, 0, 0, 0, 0, 1, 1, 0, 0, 0, 1, 1]",379,274,105,30,13,0.10948905109489052,0.12380952380952381
"[1, 0, 0, 0, 0, 1, 0, 0, 0, 0, 1, 1, 0, 0, 0]",820,527,293,42,29,0.07969639468690702,0.09897610921501707
"[1, 1, 0, 0, 0, 0, 1, 0, 0, 0, 0, 1, 1, 0, 0]",425,270,155,22,15,0.08148148148148149,0.0967741935483871
"[0, 1, 1, 1, 1, 0, 0, 0, 0, 1, 0, 0, 0, 0, 1]",243,172,71,21,9,0.12209302325581395,0.1267605633802817
"[0, 0, 1, 1, 1, 1, 0, 0, 0, 0, 1, 0, 0, 0, 0]",489,344,145,35,7,0.10174418604651163,0.04827586206896552
"[0, 0, 1, 0, 0, 0, 0, 0, 0, 0, 1, 1, 1, 1, 0]",674,460,214,49,23,0.10652173913043478,0.10747663551401869
"[0, 0, 0, 0, 0, 1, 1, 0, 0, 1, 1, 0, 0, 0, 1]",822,645,177,62,19,0.09612403100775194,0.10734463276836158
"[1, 1, 1, 0, 1, 1, 0, 0, 0, 1, 1, 1, 1, 0, 0]",276,109,167,14,19,0.12844036697247707,0.11377245508982035
"[1, 1, 0, 1, 1, 1, 1, 1, 1, 1, 0, 1, 1, 0, 1]",1568,369,1199,39,118,0.10569105691056911,0.09841534612176814
"[0, 1, 0, 0, 1, 1, 1, 1, 1, 1, 0, 1, 1, 1, 1]",678,219,459,24,48,0.1095890410958904,0.10457516339869281
"[0, 0, 0, 1, 1, 1, 0, 1, 1, 0, 1, 1, 0, 0, 0]",122,69,53,9,4,0.13043478260869565,0.07547169811320754
"[1, 0, 1, 1, 1, 1, 1, 1, 1, 1, 1, 0, 0, 0, 1]",716,219,497,21,43,0.0958904109589041,0.08651911468812877
"[1, 1, 0, 0, 1, 1, 0, 0, 0, 0, 0, 1, 1, 1, 0]",233,133,100,12,10,0.09022556390977443,0.1
"[1, 1, 0, 1, 0, 1, 1, 0, 0, 1, 1, 0, 1, 1, 0]",153,54,99,6,10,0.1111111111111111,0.10101010101010101
"[1, 0, 1, 1, 0, 1, 0, 1, 1, 0, 0, 1, 1, 0, 1]",136,63,73,9,10,0.14285714285714285,0.136986301369863
"[0, 1, 0, 0, 1, 1, 1, 1, 1, 0, 1, 1, 0, 1, 0]",133,55,78,1,9,0.01818181818181818,0.11538461538461539
"[1, 0, 0, 0, 1, 1, 1, 1, 0, 0, 1, 0, 1, 1, 0]",125,52,73,3,10,0.057692307692307696,0.136986301369863
"[1, 1, 1, 0, 0, 1, 1, 0, 0, 0, 0, 1, 1, 1, 1]",2339,386,1953,35,182,0.09067357512953368,0.0931899641577061
"[0, 0, 1, 0, 0, 0, 0, 1, 0, 0, 0, 1, 0, 0, 1]",490,337,153,37,13,0.10979228486646884,0.08496732026143791
"[1, 0, 0, 0, 0, 0, 0, 0, 1, 0, 1, 0, 0, 1, 0]",543,366,177,37,13,0.10109289617486339,0.07344632768361582
"[0, 0, 0, 1, 1, 0, 1, 0, 1, 1, 0, 1, 0, 0, 0]",159,91,68,9,4,0.0989010989010989,0.058823529411764705
"[1, 0, 0, 0, 0, 1, 1, 0, 0, 0, 0, 0, 0, 1, 1]",2481,739,1742,63,166,0.08525033829499323,0.09529276693455797
"[0, 0, 0, 0, 0, 0, 1, 1, 0, 0, 1, 1, 1, 1, 1]",2107,1142,965,115,102,0.10070052539404553,0.10569948186528498
"[1, 0, 0, 0, 0, 0, 0, 0, 0, 0, 1, 1, 0, 0, 1]",1395,852,543,91,48,0.1068075117370892,0.08839779005524862
"[1, 1, 0, 0, 0, 0, 0, 0, 0, 0, 0, 1, 1, 0, 0]",1657,1124,533,102,59,0.09074733096085409,0.11069418386491557
"[0, 1, 1, 1, 1, 0, 0, 0, 0, 0, 1, 0, 1, 1, 0]",183,115,68,13,8,0.11304347826086956,0.11764705882352941
"[1, 0, 1, 1, 0, 1, 0, 1, 1, 1, 0, 0, 0, 0, 0]",164,92,72,9,10,0.09782608695652174,0.1388888888888889
"[0, 0, 1, 0, 0, 0, 0, 0, 0, 1, 0, 0, 0, 1, 0]",1460,1111,349,123,43,0.11071107110711072,0.12320916905444126
"[0, 1, 1, 1, 0, 0, 1, 0, 0, 0, 0, 0, 0, 1, 0]",219,152,67,25,13,0.16447368421052633,0.19402985074626866
"[0, 1, 0, 0, 0, 0, 1, 1, 1, 0, 0, 1, 0, 0, 0]",269,173,96,20,11,0.11560693641618497,0.11458333333333333
"[1, 0, 0, 0, 0, 0, 0, 0, 1, 0, 0, 1, 1, 0, 0]",777,502,275,53,24,0.10557768924302789,0.08727272727272728
"[0, 1, 0, 1, 0, 0, 1, 0, 1, 0, 0, 0, 0, 0, 0]",600,414,186,36,22,0.08695652173913043,0.11827956989247312
"[0, 0, 0, 0, 1, 0, 1, 0, 0, 1, 0, 1, 0, 0, 0]",547,408,139,36,13,0.08823529411764706,0.09352517985611511
"[0, 1, 1, 1, 1, 0, 1, 0, 0, 0, 0, 0, 0, 0, 0]",445,333,112,33,13,0.0990990990990991,0.11607142857142858
"[1, 0, 1, 0, 0, 0, 0, 0, 0, 1, 1, 1, 1, 0, 1]",167,85,82,7,7,0.08235294117647059,0.08536585365853659
"[0, 0, 0, 1, 1, 0, 1, 0, 0, 0, 0, 0, 0, 1, 1]",517,365,152,40,11,0.1095890410958904,0.07236842105263158
"[1, 0, 1, 0, 0, 0, 0, 0, 1, 1, 0, 1, 0, 0, 0]",266,170,96,21,12,0.12352941176470589,0.125
"[0, 0, 0, 1, 1, 1, 1, 0, 0, 1, 1, 1, 1, 0, 0]",1636,1303,333,110,24,0.0844205679201842,0.07207207207207207
"[0, 1, 0, 0, 0, 0, 1, 1, 1, 1, 0, 0, 1, 1, 1]",495,236,259,18,25,0.07627118644067797,0.09652509652509653
"[1, 1, 1, 0, 1, 0, 0, 0, 0, 1, 1, 1, 1, 0, 0]",293,126,167,11,13,0.0873015873015873,0.07784431137724551
"[0, 0, 0, 0, 0, 0, 0, 0, 1, 0, 0, 0, 1, 1, 0]",2212,1724,488,164,53,0.0951276102088167,0.10860655737704918
"[0, 0, 0, 0, 0, 0, 1, 0, 1, 1, 0, 0, 0, 0, 0]",2226,1702,524,173,50,0.10164512338425381,0.09541984732824428
"[1, 1, 1, 0, 0, 0, 1, 0, 0, 0, 0, 1, 1, 0, 1]",106,49,57,3,4,0.061224489795918366,0.07017543859649122
"[1, 1, 0, 0, 1, 0, 0, 1, 0, 1, 1, 1, 1, 0, 0]",154,73,81,8,7,0.1095890410958904,0.08641975308641975
"[1, 1, 0, 1, 1, 0, 0, 1, 0, 0, 1, 0, 1, 1, 1]",156,60,96,2,10,0.03333333333333333,0.10416666666666667
"[1, 0, 0, 0, 1, 1, 1, 1, 0, 1, 1, 0, 0, 1, 0]",99,48,51,5,3,0.10416666666666667,0.058823529411764705
"[1, 1, 1, 1, 1, 0, 1, 0, 1, 0, 0, 1, 0, 0, 1]",140,38,102,4,7,0.10526315789473684,0.06862745098039216
"[0, 0, 0, 0, 1, 1, 1, 1, 0, 0, 0, 0, 0, 0, 0]",5283,3854,1429,345,149,0.08951738453554749,0.10426871938418475
"[1, 1, 1, 1, 0, 1, 1, 0, 0, 0, 0, 0, 1, 1, 1]",308,127,181,14,17,0.11023622047244094,0.09392265193370165
"[0, 0, 0, 1, 1, 1, 1, 1, 0, 1, 1, 0, 0, 0, 0]",191,101,90,9,7,0.0891089108910891,0.07777777777777778
"[1, 0, 1, 0, 1, 1, 1, 0, 0, 0, 0, 1, 0, 0, 0]",144,85,59,6,5,0.07058823529411765,0.0847457627118644
"[0, 1, 0, 0, 0, 1, 1, 1, 1, 0, 0, 1, 0, 1, 0]",125,63,62,6,8,0.09523809523809523,0.12903225806451613
"[1, 1, 1, 1, 0, 1, 0, 0, 0, 1, 0, 1, 0, 1, 0]",113,52,61,8,8,0.15384615384615385,0.13114754098360656
"[1, 1, 1, 1, 1, 0, 1, 0, 0, 0, 1, 0, 1, 0, 1]",134,62,72,9,10,0.14516129032258066,0.1388888888888889
"[1, 1, 1, 1, 1, 0, 1, 1, 1, 1, 1, 0, 1, 0, 0]",590,167,423,17,41,0.10179640718562874,0.09692671394799054
"[1, 0, 0, 1, 0, 0, 0, 1, 1, 1, 1, 1, 0, 1, 1]",167,63,104,4,9,0.06349206349206349,0.08653846153846154
"[0, 0, 0, 1, 1, 1, 0, 0, 1, 1, 0, 1, 0, 0, 1]",109,66,43,5,1,0.07575757575757576,0.023255813953488372
"[1, 1, 1, 0, 1, 0, 1, 1, 1, 1, 1, 0, 1, 0, 1]",514,158,356,12,34,0.0759493670886076,0.09550561797752809
"[1, 0, 0, 1, 0, 0, 0, 1, 1, 1, 1, 0, 1, 0, 0]",126,58,68,2,4,0.034482758620689655,0.058823529411764705
"[1, 1, 1, 1, 1, 1, 0, 0, 1, 0, 0, 0, 1, 1, 1]",509,186,323,16,32,0.08602150537634409,0.09907120743034056
"[0, 1, 0, 0, 0, 1, 0, 0, 1, 0, 0, 0, 1, 1, 0]",276,188,88,10,8,0.05319148936170213,0.09090909090909091
"[1, 0, 1, 0, 0, 0, 0, 0, 0, 0, 0, 1, 0, 0, 0]",1647,1272,375,107,19,0.08411949685534591,0.050666666666666665
"[0, 0, 1, 0, 0, 1, 0, 1, 1, 1, 1, 0, 1, 1, 1]",143,65,78,6,8,0.09230769230769231,0.10256410256410256
"[1, 1, 0, 0, 1, 0, 1, 1, 1, 1, 1, 1, 0, 0, 1]",394,124,270,8,20,0.06451612903225806,0.07407407407407407
"[1, 0, 1, 1, 1, 1, 1, 1, 1, 1, 1, 0, 0, 1, 0]",633,184,449,20,35,0.10869565217391304,0.0779510022271715
"[0, 1, 1, 1, 0, 0, 0, 1, 0, 0, 0, 1, 1, 1, 0]",111,65,46,5,5,0.07692307692307693,0.10869565217391304
"[1, 0, 1, 1, 1, 1, 0, 0, 1, 1, 1, 1, 1, 0, 1]",662,169,493,16,48,0.09467455621301775,0.0973630831643002
"[0, 1, 0, 1, 1, 1, 1, 1, 1, 1, 1, 0, 1, 1, 1]",1718,449,1269,49,123,0.1091314031180401,0.09692671394799054
"[0, 1, 1, 1, 0, 0, 1, 1, 0, 0, 1, 1, 0, 0, 0]",401,227,174,23,15,0.1013215859030837,0.08620689655172414
"[0, 0, 1, 1, 1, 0, 0, 1, 1, 0, 0, 1, 1, 0, 0]",431,214,217,17,21,0.0794392523364486,0.0967741935483871
"[1, 1, 0, 1, 0, 0, 0, 0, 0, 1, 0, 0, 0, 1, 1]",199,110,89,9,5,0.08181818181818182,0.056179775280898875
"[1, 1, 0, 1, 1, 1, 0, 1, 0, 0, 0, 0, 0, 1, 0]",121,60,61,4,3,0.06666666666666667,0.04918032786885246
"[0, 1, 0, 1, 1, 1, 0, 1, 0, 1, 0, 1, 1, 1, 0]",128,69,59,2,6,0.028985507246376812,0.1016949152542373
"[1, 1, 0, 0, 1, 0, 1, 1, 1, 0, 1, 0, 1, 0, 1]",144,51,93,2,11,0.0392156862745098,0.11827956989247312
"[1, 0, 1, 1, 1, 0, 0, 0, 1, 1, 0, 0, 1, 0, 1]",117,52,65,8,5,0.15384615384615385,0.07692307692307693
"[0, 1, 1, 1, 1, 0, 1, 1, 1, 0, 0, 0, 1, 1, 0]",170,62,108,6,12,0.0967741935483871,0.1111111111111111
"[1, 0, 0, 1, 1, 1, 1, 0, 0, 0, 0, 0, 1, 0, 1]",253,83,170,9,15,0.10843373493975904,0.08823529411764706
"[0, 0, 1, 1, 1, 0, 0, 0, 1, 1, 0, 0, 1, 1, 1]",244,122,122,13,10,0.10655737704918032,0.08196721311475409
"[1, 0, 0, 1, 1, 1, 0, 0, 1, 0, 0, 1, 0, 1, 0]",107,55,52,3,4,0.05454545454545454,0.07692307692307693
"[0, 0, 1, 1, 0, 0, 0, 0, 1, 0, 0, 1, 1, 1, 0]",217,150,67,13,6,0.08666666666666667,0.08955223880597014
"[0, 1, 1, 1, 1, 0, 0, 0, 0, 0, 0, 0, 0, 0, 0]",4824,4224,600,429,53,0.1015625,0.08833333333333333
"[1, 0, 0, 1, 0, 0, 0, 0, 1, 0, 0, 0, 0, 1, 1]",358,217,141,21,21,0.0967741935483871,0.14893617021276595
"[1, 1, 0, 0, 0, 1, 1, 0, 0, 1, 0, 0, 0, 0, 1]",173,99,74,9,7,0.09090909090909091,0.0945945945945946
"[1, 0, 0, 1, 1, 0, 0, 0, 1, 0, 0, 1, 1, 1, 1]",242,96,146,8,14,0.08333333333333333,0.0958904109589041
"[0, 0, 0, 1, 1, 0, 1, 1, 1, 1, 1, 0, 0, 1, 1]",260,117,143,8,11,0.06837606837606838,0.07692307692307693
"[0, 0, 0, 0, 1, 0, 1, 0, 0, 1, 1, 1, 1, 0, 0]",288,169,119,23,10,0.13609467455621302,0.08403361344537816
"[1, 1, 0, 1, 1, 0, 0, 0, 0, 0, 0, 1, 0, 0, 0]",292,182,110,15,19,0.08241758241758242,0.17272727272727273
"[1, 1, 0, 0, 0, 0, 0, 0, 0, 1, 1, 1, 0, 1, 1]",226,116,110,15,13,0.12931034482758622,0.11818181818181818
"[0, 0, 1, 0, 0, 0, 0, 1, 0, 1, 0, 1, 1, 1, 1]",169,92,77,11,5,0.11956521739130435,0.06493506493506493
"[0, 1, 1, 0, 0, 0, 1, 0, 0, 0, 0, 1, 0, 1, 0]",235,150,85,11,9,0.07333333333333333,0.10588235294117647
"[0, 1, 1, 1, 1, 0, 0, 1, 1, 0, 0, 0, 1, 0, 0]",243,179,64,22,8,0.12290502793296089,0.125
"[1, 0, 0, 1, 1, 1, 1, 0, 0, 1, 1, 0, 0, 0, 1]",415,109,306,8,26,0.07339449541284404,0.08496732026143791
"[0, 1, 1, 0, 1, 1, 1, 1, 1, 1, 0, 1, 1, 0, 1]",495,140,355,11,22,0.07857142857142857,0.061971830985915494
"[0, 1, 0, 0, 0, 1, 1, 0, 1, 1, 1, 1, 1, 1, 0]",153,54,99,2,14,0.037037037037037035,0.1414141414141414
"[0, 1, 0, 0, 1, 1, 0, 1, 0, 1, 0, 0, 0, 1, 1]",128,65,63,5,9,0.07692307692307693,0.14285714285714285
"[1, 0, 1, 1, 0, 1, 0, 0, 0, 1, 1, 1, 0, 1, 0]",102,44,58,6,2,0.13636363636363635,0.034482758620689655
"[0, 0, 0, 0, 0, 1, 1, 0, 1, 1, 1, 0, 0, 1, 1]",198,118,80,10,8,0.0847457627118644,0.1
"[1, 1, 1, 1, 1, 1, 1, 1, 0, 0, 0, 1, 0, 0, 0]",259,105,154,11,15,0.10476190476190476,0.09740259740259741
"[0, 0, 0, 1, 1, 1, 1, 0, 0, 0, 0, 0, 0, 1, 1]",2311,1916,395,199,41,0.10386221294363257,0.10379746835443038
"[1, 0, 1, 1, 1, 0, 0, 0, 1, 1, 1, 1, 0, 0, 0]",199,95,104,15,10,0.15789473684210525,0.09615384615384616
"[1, 1, 1, 1, 0, 1, 1, 0, 1, 1, 1, 0, 0, 0, 1]",285,109,176,13,14,0.11926605504587157,0.07954545454545454
"[0, 1, 1, 1, 1, 0, 0, 1, 1, 0, 0, 0, 0, 0, 0]",2033,1690,343,159,28,0.0940828402366864,0.08163265306122448
"[1, 0, 1, 1, 1, 1, 0, 0, 0, 0, 0, 0, 0, 0, 0]",792,485,307,53,33,0.10927835051546392,0.10749185667752444
"[0, 0, 1, 0, 0, 0, 0, 0, 1, 0, 1, 1, 1, 1, 0]",174,102,72,11,2,0.10784313725490197,0.027777777777777776
"[1, 0, 0, 0, 1, 0, 0, 1, 0, 0, 1, 1, 1, 0, 0]",169,109,60,12,5,0.11009174311926606,0.08333333333333333
"[1, 1, 0, 0, 0, 1, 0, 0, 1, 0, 0, 1, 1, 1, 0]",113,59,54,4,2,0.06779661016949153,0.037037037037037035
"[0, 1, 0, 0, 0, 0, 0, 0, 0, 0, 0, 0, 0, 1, 1]",4638,3573,1065,313,126,0.08760145535964176,0.11830985915492957
"[0, 0, 0, 1, 0, 0, 0, 1, 1, 0, 0, 0, 1, 1, 1]",272,179,93,16,8,0.0893854748603352,0.08602150537634409
"[0, 1, 0, 1, 1, 0, 0, 0, 1, 0, 0, 0, 1, 1, 0]",167,94,73,9,9,0.09574468085106383,0.1232876712328767
"[0, 0, 0, 0, 0, 0, 1, 0, 1, 1, 0, 0, 0, 1, 0]",568,408,160,31,17,0.07598039215686274,0.10625
"[0, 0, 1, 1, 0, 0, 0, 0, 0, 0, 1, 0, 0, 0, 0]",2493,1916,577,167,49,0.087160751565762,0.08492201039861352
"[0, 0, 1, 0, 0, 1, 1, 0, 0, 0, 0, 0, 0, 1, 0]",591,428,163,42,17,0.09813084112149532,0.10429447852760736
"[1, 1, 0, 0, 0, 1, 0, 0, 0, 1, 0, 0, 1, 1, 0]",166,89,77,8,9,0.0898876404494382,0.11688311688311688
"[1, 0, 0, 0, 1, 1, 0, 0, 0, 1, 1, 1, 1, 1, 1]",298,121,177,8,21,0.06611570247933884,0.11864406779661017
"[1, 1, 0, 0, 0, 1, 1, 0, 0, 0, 1, 1, 1, 1, 1]",262,116,146,14,9,0.1206896551724138,0.06164383561643835
"[0, 0, 0, 0, 1, 1, 0, 0, 0, 1, 1, 0, 0, 0, 1]",376,261,115,32,6,0.12260536398467432,0.05217391304347826
"[1, 1, 0, 0, 0, 0, 1, 1, 0, 0, 0, 1, 1, 0, 0]",355,207,148,17,16,0.0821256038647343,0.10810810810810811
"[1, 0, 1, 1, 1, 0, 0, 0, 0, 1, 1, 0, 0, 0, 1]",137,59,78,4,5,0.06779661016949153,0.0641025641025641
"[0, 0, 1, 1, 0, 1, 1, 1, 0, 0, 0, 0, 1, 1, 0]",190,108,82,14,10,0.12962962962962962,0.12195121951219512
"[1, 0, 1, 0, 0, 0, 1, 1, 0, 1, 1, 1, 0, 0, 0]",127,58,69,9,8,0.15517241379310345,0.11594202898550725
"[1, 0, 1, 0, 1, 0, 0, 0, 1, 1, 0, 1, 1, 1, 0]",107,58,49,8,4,0.13793103448275862,0.08163265306122448
"[1, 1, 0, 1, 1, 0, 1, 0, 1, 0, 0, 0, 1, 1, 0]",104,50,54,2,8,0.04,0.14814814814814814
"[1, 1, 1, 0, 1, 0, 0, 1, 0, 1, 1, 0, 1, 1, 0]",136,63,73,2,4,0.031746031746031744,0.0547945205479452
"[1, 0, 0, 1, 0, 0, 0, 0, 0, 0, 0, 0, 0, 0, 1]",2241,1660,581,146,53,0.08795180722891566,0.09122203098106713
"[0, 0, 0, 0, 1, 1, 0, 0, 0, 0, 1, 0, 1, 0, 0]",763,521,242,45,23,0.08637236084452975,0.09504132231404959
"[1, 0, 0, 0, 0, 0, 0, 1, 1, 0, 0, 0, 0, 1, 0]",948,472,476,47,43,0.09957627118644068,0.09033613445378151
"[1, 0, 1, 1, 1, 1, 0, 0, 0, 0, 1, 1, 1, 1, 0]",484,205,279,10,27,0.04878048780487805,0.0967741935483871
"[0, 1, 1, 0, 0, 0, 0, 0, 0, 0, 0, 1, 0, 1, 1]",672,530,142,47,12,0.08867924528301886,0.08450704225352113
"[0, 0, 0, 0, 1, 0, 0, 0, 1, 0, 0, 0, 0, 1, 1]",949,682,267,76,27,0.11143695014662756,0.10112359550561797
"[0, 0, 0, 1, 0, 1, 1, 1, 0, 0, 1, 1, 0, 0, 0]",260,151,109,13,10,0.08609271523178808,0.09174311926605505
"[0, 0, 0, 0, 0, 1, 0, 1, 1, 1, 0, 0, 1, 1, 0]",204,128,76,9,11,0.0703125,0.14473684210526316
"[1, 1, 0, 1, 1, 0, 0, 0, 0, 1, 0, 0, 0, 1, 1]",129,63,66,9,10,0.14285714285714285,0.15151515151515152
"[0, 0, 0, 1, 0, 0, 0, 0, 1, 1, 0, 0, 1, 1, 0]",617,416,201,36,24,0.08653846153846154,0.11940298507462686
"[1, 0, 0, 0, 1, 1, 1, 0, 0, 0, 0, 1, 0, 0, 0]",255,169,86,13,7,0.07692307692307693,0.08139534883720931
"[1, 1, 0, 0, 0, 1, 1, 1, 1, 1, 0, 1, 0, 0, 0]",142,63,79,6,9,0.09523809523809523,0.11392405063291139
"[0, 0, 1, 0, 0, 1, 1, 0, 0, 1, 1, 1, 1, 0, 0]",429,233,196,29,21,0.12446351931330472,0.10714285714285714
"[0, 0, 1, 0, 0, 1, 0, 0, 1, 0, 0, 1, 1, 0, 0]",282,184,98,22,14,0.11956521739130435,0.14285714285714285
"[1, 1, 1, 0, 1, 0, 0, 1, 0, 0, 1, 0, 0, 1, 0]",109,63,46,9,5,0.14285714285714285,0.10869565217391304
"[1, 1, 1, 0, 1, 0, 0, 0, 1, 1, 1, 1, 0, 0, 1]",300,126,174,14,18,0.1111111111111111,0.10344827586206896
"[0, 0, 0, 1, 0, 0, 0, 0, 0, 1, 1, 0, 0, 1, 0]",570,408,162,35,16,0.0857843137254902,0.09876543209876543
"[0, 0, 1, 1, 1, 0, 0, 1, 0, 1, 0, 1, 0, 0, 0]",125,84,41,15,5,0.17857142857142858,0.12195121951219512
"[0, 0, 0, 1, 1, 0, 0, 1, 0, 0, 0, 0, 1, 1, 1]",402,298,104,25,8,0.08389261744966443,0.07692307692307693
"[1, 1, 0, 0, 0, 0, 0, 0, 0, 1, 1, 0, 0, 1, 1]",653,390,263,42,21,0.1076923076923077,0.07984790874524715
"[1, 1, 0, 1, 1, 1, 0, 0, 0, 1, 0, 0, 1, 0, 0]",124,62,62,4,8,0.06451612903225806,0.12903225806451613
"[1, 1, 1, 0, 1, 1, 1, 0, 0, 0, 1, 0, 0, 1, 0]",105,44,61,2,13,0.045454545454545456,0.21311475409836064
"[1, 0, 1, 1, 0, 1, 0, 0, 0, 0, 1, 0, 1, 1, 1]",125,67,58,5,5,0.07462686567164178,0.08620689655172414
"[0, 0, 0, 1, 0, 0, 1, 0, 0, 1, 0, 0, 0, 1, 0]",488,359,129,29,8,0.0807799442896936,0.06201550387596899
"[1, 1, 0, 0, 1, 0, 1, 0, 0, 0, 0, 0, 0, 0, 0]",871,567,304,57,25,0.10052910052910052,0.08223684210526316
"[0, 0, 0, 0, 0, 0, 0, 1, 1, 1, 0, 0, 1, 0, 1]",350,252,98,25,6,0.0992063492063492,0.061224489795918366
"[0, 0, 1, 1, 0, 1, 1, 0, 0, 1, 1, 1, 0, 0, 0]",136,79,57,7,7,0.08860759493670886,0.12280701754385964
"[1, 1, 0, 0, 0, 0, 1, 1, 0, 1, 1, 0, 0, 1, 1]",219,110,109,6,13,0.05454545454545454,0.11926605504587157
"[1, 0, 1, 0, 1, 1, 0, 1, 1, 1, 0, 0, 0, 0, 0]",156,70,86,4,8,0.05714285714285714,0.09302325581395349
"[0, 0, 0, 0, 0, 1, 0, 1, 1, 0, 0, 1, 0, 1, 0]",228,156,72,17,7,0.10897435897435898,0.09722222222222222
"[1, 0, 1, 1, 0, 0, 0, 1, 0, 0, 0, 0, 0, 0, 1]",269,180,89,17,11,0.09444444444444444,0.12359550561797752
"[0, 0, 0, 1, 0, 1, 1, 1, 0, 0, 0, 0, 1, 0, 0]",231,155,76,13,7,0.08387096774193549,0.09210526315789473
"[0, 0, 0, 0, 0, 0, 1, 0, 1, 1, 1, 0, 0, 0, 0]",810,585,225,46,23,0.07863247863247863,0.10222222222222223
"[1, 0, 0, 0, 1, 1, 0, 0, 1, 0, 1, 0, 0, 0, 0]",280,175,105,21,14,0.12,0.13333333333333333
"[0, 1, 0, 1, 0, 0, 0, 1, 0, 1, 0, 0, 1, 1, 0]",145,73,72,7,11,0.0958904109589041,0.1527777777777778
"[0, 0, 0, 1, 0, 1, 0, 0, 0, 1, 0, 1, 0, 0, 1]",230,142,88,11,5,0.07746478873239436,0.056818181818181816
"[1, 0, 0, 0, 1, 0, 1, 0, 1, 1, 1, 0, 0, 1, 0]",119,54,65,6,3,0.1111111111111111,0.046153846153846156
"[0, 1, 1, 1, 1, 0, 1, 0, 1, 1, 0, 1, 1, 0, 1]",208,80,128,7,9,0.0875,0.0703125
"[1, 1, 1, 1, 0, 1, 0, 0, 1, 1, 1, 0, 1, 1, 0]",256,98,158,9,15,0.09183673469387756,0.0949367088607595
"[1, 1, 1, 1, 0, 0, 0, 1, 0, 1, 1, 0, 0, 0, 1]",125,50,75,1,8,0.02,0.10666666666666667
"[1, 1, 0, 0, 1, 1, 0, 0, 0, 1, 1, 1, 0, 1, 0]",141,70,71,10,9,0.14285714285714285,0.1267605633802817
"[1, 0, 1, 1, 0, 1, 1, 0, 1, 1, 1, 1, 1, 1, 1]",1914,462,1452,35,154,0.07575757575757576,0.10606060606060606
"[0, 0, 0, 1, 0, 1, 0, 1, 0, 1, 0, 1, 1, 0, 0]",183,121,62,7,3,0.05785123966942149,0.04838709677419355
"[1, 0, 0, 0, 0, 1, 0, 0, 1, 0, 0, 0, 0, 0, 1]",566,362,204,38,21,0.10497237569060773,0.10294117647058823
"[0, 0, 0, 1, 0, 0, 1, 0, 0, 1, 0, 0, 0, 0, 1]",541,364,177,34,20,0.09340659340659341,0.11299435028248588
"[1, 0, 1, 1, 0, 0, 0, 0, 1, 1, 0, 0, 0, 1, 1]",192,89,103,3,12,0.033707865168539325,0.11650485436893204
"[1, 1, 1, 1, 1, 1, 0, 1, 1, 0, 0, 0, 0, 1, 1]",578,187,391,15,34,0.08021390374331551,0.08695652173913043
"[0, 1, 1, 0, 1, 1, 0, 1, 1, 1, 0, 0, 1, 1, 1]",329,124,205,17,18,0.13709677419354838,0.08780487804878048
"[0, 1, 1, 0, 1, 1, 1, 1, 0, 1, 1, 0, 1, 1, 0]",228,81,147,8,15,0.09876543209876543,0.10204081632653061
"[1, 0, 0, 1, 0, 1, 1, 0, 0, 1, 1, 0, 1, 1, 0]",98,51,47,4,5,0.0784313725490196,0.10638297872340426
"[0, 0, 0, 0, 1, 0, 0, 1, 0, 0, 0, 1, 0, 0, 0]",1588,1206,382,113,28,0.09369817578772803,0.07329842931937172
"[0, 0, 0, 1, 1, 1, 1, 0, 1, 1, 1, 1, 1, 1, 0]",320,137,183,13,16,0.0948905109489051,0.08743169398907104
"[1, 1, 1, 1, 1, 1, 0, 1, 1, 1, 1, 1, 0, 0, 1]",2479,534,1945,56,170,0.10486891385767791,0.08740359897172237
"[1, 0, 1, 0, 1, 1, 1, 0, 1, 0, 1, 1, 0, 1, 1]",220,77,143,7,11,0.09090909090909091,0.07692307692307693
"[1, 1, 1, 1, 0, 1, 0, 1, 0, 1, 1, 1, 0, 1, 0]",227,76,151,8,14,0.10526315789473684,0.09271523178807947
"[0, 1, 1, 1, 1, 1, 1, 1, 1, 1, 0, 1, 0, 1, 0]",598,203,395,21,36,0.10344827586206896,0.09113924050632911
"[0, 0, 1, 1, 1, 1, 1, 1, 1, 1, 1, 0, 1, 0, 1]",879,280,599,29,58,0.10357142857142858,0.09682804674457429
"[0, 1, 0, 0, 0, 0, 0, 0, 0, 1, 0, 0, 1, 0, 1]",531,381,150,43,18,0.11286089238845144,0.12
"[1, 0, 0, 0, 0, 0, 1, 1, 0, 1, 1, 1, 1, 1, 1]",262,90,172,8,19,0.08888888888888889,0.11046511627906977
"[1, 1, 0, 0, 1, 0, 0, 1, 1, 1, 1, 0, 1, 0, 0]",138,61,77,6,8,0.09836065573770492,0.1038961038961039
"[1, 0, 1, 0, 1, 1, 0, 1, 1, 1, 1, 1, 1, 1, 0]",543,156,387,19,34,0.12179487179487179,0.08785529715762273
"[0, 1, 1, 1, 1, 0, 1, 0, 0, 1, 1, 0, 0, 1, 1]",279,129,150,9,11,0.06976744186046512,0.07333333333333333
"[0, 0, 0, 0, 1, 1, 1, 1, 0, 1, 0, 0, 1, 1, 0]",183,93,90,9,10,0.0967741935483871,0.1111111111111111
"[1, 0, 1, 0, 1, 0, 1, 0, 0, 0, 0, 0, 0, 0, 0]",766,530,236,54,21,0.1018867924528302,0.08898305084745763
"[0, 0, 0, 0, 0, 0, 0, 0, 1, 0, 1, 0, 1, 0, 1]",614,438,176,30,11,0.0684931506849315,0.0625
"[0, 0, 0, 0, 1, 1, 0, 0, 1, 0, 0, 1, 0, 1, 0]",276,177,99,14,6,0.07909604519774012,0.06060606060606061
"[1, 0, 0, 0, 0, 0, 1, 1, 0, 0, 1, 0, 0, 1, 0]",243,137,106,17,12,0.12408759124087591,0.11320754716981132
"[1, 1, 0, 0, 0, 0, 0, 1, 1, 0, 0, 1, 0, 0, 1]",189,97,92,12,10,0.12371134020618557,0.10869565217391304
"[0, 0, 0, 0, 1, 1, 1, 0, 0, 0, 0, 0, 1, 1, 0]",394,272,122,29,10,0.10661764705882353,0.08196721311475409
"[0, 1, 0, 1, 0, 0, 0, 0, 0, 1, 1, 1, 0, 0, 0]",297,187,110,21,15,0.11229946524064172,0.13636363636363635
"[0, 1, 1, 1, 1, 0, 0, 1, 0, 1, 0, 0, 0, 0, 0]",231,169,62,13,7,0.07692307692307693,0.11290322580645161
"[1, 0, 1, 1, 1, 1, 0, 0, 1, 0, 1, 0, 0, 0, 0]",105,53,52,5,5,0.09433962264150944,0.09615384615384616
"[0, 0, 1, 1, 0, 0, 1, 1, 0, 0, 1, 1, 1, 0, 1]",339,164,175,13,15,0.07926829268292683,0.08571428571428572
"[1, 1, 1, 1, 0, 0, 0, 0, 1, 1, 0, 0, 1, 1, 0]",1440,668,772,55,95,0.08233532934131736,0.12305699481865284
"[1, 1, 1, 1, 1, 0, 0, 0, 0, 1, 1, 0, 0, 1, 1]",2250,367,1883,29,194,0.07901907356948229,0.10302708443972385
"[1, 0, 0, 1, 0, 0, 1, 0, 0, 0, 0, 0, 0, 0, 0]",2027,1482,545,123,43,0.08299595141700405,0.07889908256880734
"[1, 0, 1, 1, 0, 1, 1, 0, 1, 0, 0, 0, 1, 0, 0]",105,60,45,6,6,0.1,0.13333333333333333
"[1, 0, 0, 1, 0, 1, 0, 1, 0, 1, 1, 0, 1, 1, 0]",105,49,56,4,3,0.08163265306122448,0.05357142857142857
"[0, 0, 0, 1, 0, 1, 0, 1, 0, 1, 1, 0, 1, 0, 1]",116,68,48,8,2,0.11764705882352941,0.041666666666666664
"[1, 0, 1, 1, 0, 1, 1, 0, 0, 0, 1, 0, 1, 0, 1]",114,48,66,4,4,0.08333333333333333,0.06060606060606061
"[1, 1, 0, 0, 1, 0, 0, 1, 1, 0, 1, 0, 1, 1, 1]",207,76,131,3,13,0.039473684210526314,0.09923664122137404
"[0, 1, 0, 1, 0, 0, 0, 1, 0, 0, 1, 0, 1, 0, 1]",116,74,42,6,4,0.08108108108108109,0.09523809523809523
"[0, 0, 1, 1, 1, 0, 1, 0, 1, 0, 0, 0, 1, 0, 0]",156,102,54,10,5,0.09803921568627451,0.09259259259259259
"[0, 0, 1, 1, 1, 1, 0, 0, 1, 1, 1, 1, 0, 1, 0]",404,185,219,17,28,0.0918918918918919,0.1278538812785388
"[0, 1, 0, 0, 0, 0, 0, 0, 0, 0, 1, 1, 1, 1, 0]",916,597,319,40,25,0.06700167504187604,0.07836990595611286
"[1, 1, 0, 0, 1, 1, 1, 0, 1, 1, 0, 1, 0, 1, 0]",149,55,94,8,13,0.14545454545454545,0.13829787234042554
"[0, 1, 1, 0, 0, 1, 1, 1, 0, 1, 1, 0, 1, 0, 1]",146,73,73,7,5,0.0958904109589041,0.0684931506849315
"[1, 0, 0, 1, 0, 0, 0, 1, 1, 0, 0, 1, 1, 1, 0]",131,65,66,9,5,0.13846153846153847,0.07575757575757576
"[1, 0, 1, 0, 0, 0, 0, 1, 1, 0, 0, 1, 1, 1, 1]",440,207,233,15,26,0.07246376811594203,0.11158798283261803
"[0, 1, 0, 1, 1, 0, 0, 1, 1, 1, 0, 0, 1, 0, 1]",104,48,56,5,5,0.10416666666666667,0.08928571428571429
"[1, 1, 1, 0, 1, 1, 1, 0, 1, 1, 1, 0, 1, 1, 0]",516,143,373,15,42,0.1048951048951049,0.1126005361930295
"[0, 1, 0, 0, 0, 1, 1, 1, 0, 1, 1, 1, 0, 1, 1]",162,75,87,8,4,0.10666666666666667,0.04597701149425287
"[0, 0, 1, 0, 0, 0, 1, 1, 1, 0, 1, 1, 1, 0, 1]",122,58,64,5,5,0.08620689655172414,0.078125
"[1, 1, 0, 1, 0, 0, 1, 0, 0, 0, 1, 1, 1, 0, 1]",115,58,57,6,3,0.10344827586206896,0.05263157894736842
"[1, 0, 1, 1, 0, 0, 1, 1, 1, 0, 1, 0, 0, 1, 0]",107,54,53,4,7,0.07407407407407407,0.1320754716981132
"[1, 1, 1, 1, 0, 0, 1, 1, 1, 1, 0, 1, 1, 0, 1]",789,218,571,27,64,0.12385321100917432,0.11208406304728546
"[0, 1, 0, 1, 0, 0, 0, 0, 1, 0, 0, 0, 0, 1, 1]",320,219,101,26,8,0.1187214611872146,0.07920792079207921
"[0, 0, 0, 1, 0, 1, 0, 0, 0, 0, 1, 0, 0, 0, 0]",1684,1287,397,131,38,0.10178710178710179,0.09571788413098237
"[1, 0, 0, 1, 1, 1, 1, 0, 0, 1, 1, 0, 0, 0, 0]",1617,374,1243,33,107,0.08823529411764706,0.08608205953338696
"[0, 0, 0, 1, 0, 1, 1, 0, 0, 0, 0, 0, 0, 1, 1]",581,390,191,42,12,0.1076923076923077,0.06282722513089005
"[1, 1, 1, 1, 0, 0, 1, 0, 1, 1, 1, 0, 0, 1, 1]",368,141,227,15,18,0.10638297872340426,0.07929515418502203
"[0, 0, 1, 1, 1, 1, 1, 1, 0, 0, 1, 1, 1, 1, 0]",2099,847,1252,84,123,0.09917355371900827,0.09824281150159744
"[0, 1, 0, 0, 0, 0, 1, 1, 0, 0, 0, 1, 1, 1, 1]",255,148,107,17,11,0.11486486486486487,0.102803738317757
"[0, 0, 1, 0, 1, 0, 0, 0, 0, 1, 1, 0, 0, 0, 1]",280,184,96,15,8,0.08152173913043478,0.08333333333333333
"[0, 0, 0, 0, 1, 1, 0, 0, 1, 0, 1, 0, 0, 0, 0]",768,549,219,53,28,0.0965391621129326,0.1278538812785388
"[1, 1, 1, 0, 1, 1, 1, 1, 0, 1, 0, 0, 1, 1, 1]",672,203,469,26,47,0.12807881773399016,0.10021321961620469
"[0, 1, 0, 0, 0, 0, 0, 0, 1, 1, 0, 0, 1, 1, 1]",622,391,231,36,17,0.09207161125319693,0.0735930735930736
"[1, 0, 1, 0, 0, 0, 0, 0, 0, 1, 1, 0, 0, 1, 1]",536,310,226,29,17,0.0935483870967742,0.0752212389380531
"[0, 0, 1, 1, 1, 0, 1, 0, 1, 0, 0, 0, 0, 0, 0]",302,199,103,18,12,0.09045226130653267,0.11650485436893204
"[1, 0, 0, 0, 1, 1, 1, 1, 0, 1, 0, 0, 0, 1, 0]",109,49,60,2,5,0.04081632653061224,0.08333333333333333
"[0, 0, 0, 0, 1, 0, 0, 0, 0, 1, 1, 0, 1, 0, 0]",543,388,155,29,9,0.07474226804123711,0.05806451612903226
"[1, 0, 0, 1, 0, 1, 0, 1, 0, 1, 1, 0, 1, 0, 0]",105,57,48,5,5,0.08771929824561403,0.10416666666666667
"[0, 1, 0, 1, 0, 1, 0, 1, 0, 0, 1, 1, 1, 1, 1]",224,102,122,10,10,0.09803921568627451,0.08196721311475409
"[1, 1, 1, 0, 0, 1, 1, 0, 1, 0, 1, 0, 1, 0, 0]",124,46,78,4,11,0.08695652173913043,0.14102564102564102
"[1, 0, 1, 1, 1, 0, 0, 1, 1, 1, 0, 0, 1, 1, 0]",173,69,104,4,8,0.057971014492753624,0.07692307692307693
"[0, 0, 1, 1, 0, 0, 0, 1, 0, 1, 1, 0, 0, 0, 1]",173,96,77,18,4,0.1875,0.05194805194805195
"[0, 0, 1, 1, 1, 0, 0, 0, 0, 1, 1, 0, 0, 0, 1]",199,124,75,16,9,0.12903225806451613,0.12
"[1, 1, 1, 1, 0, 1, 1, 0, 1, 1, 0, 1, 1, 0, 0]",289,110,179,9,28,0.08181818181818182,0.1564245810055866
"[1, 1, 1, 0, 0, 1, 1, 1, 1, 1, 0, 1, 1, 0, 1]",647,145,502,12,43,0.08275862068965517,0.08565737051792828
"[1, 1, 1, 1, 1, 1, 0, 1, 1, 1, 1, 1, 1, 0, 0]",2944,635,2309,54,229,0.08503937007874016,0.09917713295799047
"[1, 0, 1, 1, 0, 0, 1, 1, 1, 1, 1, 1, 1, 0, 1]",601,170,431,20,48,0.11764705882352941,0.11136890951276102
"[1, 1, 0, 1, 0, 0, 1, 1, 1, 1, 1, 0, 1, 1, 0]",239,80,159,9,14,0.1125,0.0880503144654088
"[1, 0, 1, 1, 1, 1, 0, 0, 0, 1, 1, 0, 1, 0, 1]",145,67,78,12,8,0.1791044776119403,0.10256410256410256
"[0, 0, 0, 1, 0, 0, 1, 0, 1, 0, 0, 1, 0, 0, 0]",538,384,154,46,16,0.11979166666666667,0.1038961038961039
"[1, 1, 1, 1, 0, 0, 1, 1, 0, 0, 1, 1, 1, 0, 1]",641,215,426,20,39,0.09302325581395349,0.09154929577464789
"[1, 1, 1, 1, 1, 0, 0, 1, 1, 0, 0, 1, 1, 1, 0]",685,140,545,17,46,0.12142857142857143,0.08440366972477065
"[0, 0, 1, 1, 0, 1, 0, 0, 1, 1, 1, 1, 0, 1, 0]",118,57,61,7,5,0.12280701754385964,0.08196721311475409
"[0, 0, 1, 1, 1, 0, 0, 1, 1, 1, 1, 1, 1, 0, 1]",296,109,187,13,22,0.11926605504587157,0.11764705882352941
"[1, 1, 1, 1, 1, 1, 0, 1, 1, 1, 1, 0, 0, 1, 1]",2802,664,2138,65,212,0.09789156626506024,0.09915809167446211
"[1, 1, 1, 1, 1, 1, 1, 0, 1, 1, 1, 1, 0, 0, 1]",2492,544,1948,53,177,0.0974264705882353,0.09086242299794661
"[1, 1, 0, 1, 1, 0, 0, 0, 1, 1, 0, 0, 1, 1, 1]",298,137,161,15,17,0.10948905109489052,0.10559006211180125
"[0, 1, 0, 1, 1, 1, 1, 1, 1, 0, 1, 0, 0, 1, 0]",125,47,78,2,10,0.0425531914893617,0.1282051282051282
"[0, 0, 0, 0, 0, 1, 1, 1, 0, 1, 0, 1, 1, 1, 1]",246,157,89,15,9,0.09554140127388536,0.10112359550561797
"[1, 0, 1, 1, 0, 1, 1, 0, 0, 0, 0, 0, 1, 0, 0]",147,96,51,9,9,0.09375,0.17647058823529413
"[1, 1, 0, 0, 0, 1, 0, 0, 0, 1, 0, 1, 0, 1, 0]",137,79,58,6,4,0.0759493670886076,0.06896551724137931
"[0, 1, 0, 1, 1, 0, 0, 0, 1, 0, 0, 0, 1, 0, 1]",125,83,42,9,5,0.10843373493975904,0.11904761904761904
"[1, 0, 1, 0, 1, 1, 0, 0, 0, 1, 0, 0, 0, 1, 0]",119,68,51,4,2,0.058823529411764705,0.0392156862745098
"[0, 1, 0, 0, 0, 1, 0, 0, 0, 1, 0, 0, 0, 0, 1]",547,394,153,37,15,0.09390862944162437,0.09803921568627451
"[0, 0, 1, 0, 0, 1, 1, 0, 0, 1, 1, 0, 0, 0, 0]",766,494,272,51,27,0.10323886639676114,0.09926470588235294
"[0, 1, 1, 1, 0, 0, 0, 1, 0, 1, 0, 1, 1, 1, 0]",114,55,59,4,6,0.07272727272727272,0.1016949152542373
"[1, 0, 0, 1, 1, 0, 0, 1, 1, 0, 1, 1, 1, 0, 0]",167,60,107,6,4,0.1,0.037383177570093455
"[0, 0, 0, 0, 1, 0, 1, 0, 0, 0, 1, 0, 0, 1, 1]",332,222,110,21,10,0.0945945945945946,0.09090909090909091
"[1, 1, 1, 0, 1, 0, 0, 0, 1, 0, 0, 1, 1, 1, 1]",205,85,120,10,10,0.11764705882352941,0.08333333333333333
"[1, 0, 0, 0, 0, 1, 1, 1, 1, 1, 1, 1, 0, 1, 0]",284,79,205,8,19,0.10126582278481013,0.09268292682926829
"[0, 1, 0, 0, 1, 1, 1, 1, 0, 0, 1, 1, 1, 1, 1]",815,317,498,43,61,0.13564668769716087,0.12248995983935743
"[1, 1, 1, 1, 1, 1, 0, 1, 0, 1, 0, 0, 1, 1, 1]",806,238,568,18,59,0.07563025210084033,0.10387323943661972
"[0, 1, 1, 1, 0, 0, 0, 0, 0, 0, 0, 0, 0, 0, 1]",1151,789,362,83,28,0.10519645120405577,0.07734806629834254
"[0, 1, 1, 0, 0, 1, 1, 1, 0, 0, 1, 1, 0, 1, 0]",140,72,68,10,9,0.1388888888888889,0.1323529411764706
"[0, 0, 0, 1, 0, 1, 0, 1, 0, 0, 0, 0, 0, 1, 1]",343,233,110,20,13,0.08583690987124463,0.11818181818181818
"[1, 0, 0, 0, 0, 0, 0, 1, 0, 1, 0, 1, 0, 0, 0]",549,373,176,36,16,0.09651474530831099,0.09090909090909091
"[1, 0, 1, 1, 0, 0, 0, 1, 0, 1, 0, 0, 0, 1, 0]",127,71,56,4,9,0.056338028169014086,0.16071428571428573
"[0, 0, 1, 0, 1, 1, 0, 0, 0, 1, 0, 1, 0, 0, 0]",235,151,84,21,5,0.1390728476821192,0.05952380952380952
"[1, 1, 1, 1, 0, 1, 1, 1, 0, 1, 0, 0, 0, 0, 0]",172,69,103,9,9,0.13043478260869565,0.08737864077669903
"[1, 0, 0, 1, 1, 1, 1, 0, 1, 1, 1, 0, 1, 0, 0]",145,57,88,4,6,0.07017543859649122,0.06818181818181818
"[1, 0, 1, 0, 1, 1, 1, 1, 0, 0, 1, 0, 0, 1, 1]",183,76,107,10,13,0.13157894736842105,0.12149532710280374
"[1, 0, 1, 0, 0, 0, 0, 0, 1, 0, 0, 0, 1, 0, 0]",477,321,156,29,14,0.09034267912772585,0.08974358974358974
"[0, 0, 1, 0, 1, 0, 0, 0, 0, 0, 1, 0, 0, 0, 1]",514,370,144,32,18,0.08648648648648649,0.125
"[1, 0, 1, 1, 1, 0, 0, 0, 0, 0, 1, 0, 1, 0, 1]",127,72,55,4,4,0.05555555555555555,0.07272727272727272
"[1, 1, 1, 1, 1, 1, 0, 1, 1, 1, 0, 0, 0, 0, 0]",300,106,194,5,13,0.04716981132075472,0.06701030927835051
"[0, 0, 1, 1, 0, 1, 0, 1, 1, 0, 0, 0, 0, 0, 0]",397,274,123,21,9,0.07664233576642336,0.07317073170731707
"[0, 0, 0, 0, 1, 0, 0, 0, 1, 0, 0, 0, 0, 1, 0]",1452,1110,342,109,44,0.0981981981981982,0.1286549707602339
"[0, 0, 0, 1, 1, 0, 0, 1, 0, 0, 0, 0, 0, 1, 0]",553,421,132,34,7,0.08076009501187649,0.05303030303030303
"[0, 0, 1, 0, 0, 0, 0, 1, 0, 0, 1, 0, 1, 0, 0]",567,403,164,40,9,0.09925558312655088,0.054878048780487805
"[0, 1, 0, 0, 0, 0, 0, 1, 1, 0, 0, 1, 0, 0, 1]",256,166,90,14,9,0.08433734939759036,0.1
"[1, 1, 0, 1, 1, 0, 1, 1, 1, 0, 0, 0, 0, 1, 0]",130,61,69,7,5,0.11475409836065574,0.07246376811594203
"[1, 0, 0, 1, 0, 0, 1, 1, 0, 1, 1, 0, 1, 1, 1]",196,69,127,3,20,0.043478260869565216,0.15748031496062992
"[0, 1, 0, 1, 0, 0, 1, 0, 0, 1, 1, 0, 1, 1, 0]",90,46,44,5,6,0.10869565217391304,0.13636363636363635
"[1, 1, 1, 1, 0, 1, 0, 0, 1, 0, 1, 0, 0, 1, 0]",103,44,59,9,7,0.20454545454545456,0.11864406779661017
"[0, 1, 0, 1, 1, 0, 0, 0, 1, 0, 1, 1, 1, 1, 1]",185,74,111,5,12,0.06756756756756757,0.10810810810810811
"[0, 0, 1, 0, 0, 1, 0, 0, 1, 1, 0, 1, 0, 0, 1]",132,80,52,10,7,0.125,0.1346153846153846
"[0, 1, 0, 0, 1, 1, 0, 0, 1, 0, 0, 1, 0, 0, 1]",144,87,57,9,3,0.10344827586206896,0.05263157894736842
"[0, 1, 0, 0, 0, 0, 0, 0, 1, 1, 1, 1, 1, 1, 0]",457,259,198,24,18,0.09266409266409266,0.09090909090909091
"[0, 0, 1, 0, 0, 0, 0, 0, 0, 1, 1, 1, 1, 1, 1]",602,347,255,33,24,0.09510086455331412,0.09411764705882353
"[1, 0, 0, 1, 0, 0, 1, 0, 0, 0, 1, 0, 1, 0, 0]",237,140,97,12,11,0.08571428571428572,0.1134020618556701
"[1, 1, 1, 0, 0, 0, 1, 1, 1, 1, 0, 0, 1, 0, 1]",181,58,123,5,18,0.08620689655172414,0.14634146341463414
"[0, 0, 1, 0, 1, 1, 1, 1, 0, 1, 0, 1, 1, 1, 1]",278,125,153,17,17,0.136,0.1111111111111111
"[1, 0, 0, 1, 1, 0, 0, 1, 0, 1, 0, 1, 1, 1, 0]",124,51,73,4,10,0.0784313725490196,0.136986301369863
"[1, 1, 0, 1, 0, 0, 1, 1, 0, 0, 1, 0, 1, 0, 1]",113,57,56,7,5,0.12280701754385964,0.08928571428571429
"[1, 1, 1, 1, 0, 1, 0, 0, 1, 1, 0, 0, 1, 0, 1]",149,58,91,6,11,0.10344827586206896,0.12087912087912088
"[1, 1, 0, 0, 1, 0, 0, 0, 0, 1, 1, 0, 0, 1, 1]",287,154,133,18,16,0.11688311688311688,0.12030075187969924
"[1, 0, 0, 1, 1, 1, 1, 1, 0, 0, 0, 0, 0, 1, 0]",146,70,76,6,7,0.08571428571428572,0.09210526315789473
"[1, 1, 1, 0, 0, 1, 1, 1, 1, 1, 0, 0, 0, 0, 0]",321,130,191,12,19,0.09230769230769231,0.09947643979057591
"[0, 0, 1, 1, 0, 1, 0, 1, 0, 1, 1, 1, 0, 1, 1]",154,72,82,9,8,0.125,0.0975609756097561
"[1, 1, 0, 0, 1, 1, 1, 1, 0, 1, 0, 1, 1, 0, 1]",316,108,208,10,22,0.09259259259259259,0.10576923076923077
"[1, 1, 1, 0, 0, 1, 1, 1, 1, 0, 1, 0, 1, 1, 0]",316,83,233,7,27,0.08433734939759036,0.11587982832618025
"[1, 1, 1, 1, 1, 1, 0, 0, 1, 1, 1, 1, 0, 1, 0]",989,308,681,34,47,0.11038961038961038,0.06901615271659324
"[0, 1, 1, 1, 1, 1, 0, 1, 1, 1, 0, 1, 1, 1, 1]",1781,484,1297,41,112,0.08471074380165289,0.08635312259059368
"[1, 0, 1, 1, 1, 1, 1, 0, 1, 1, 1, 0, 1, 1, 1]",1659,399,1260,44,128,0.11027568922305764,0.10158730158730159
"[1, 1, 0, 1, 1, 1, 1, 1, 0, 1, 1, 1, 0, 1, 1]",1588,371,1217,30,120,0.08086253369272237,0.09860312243221035
"[0, 0, 1, 0, 1, 0, 0, 0, 0, 0, 1, 0, 0, 0, 0]",1716,1284,432,120,38,0.09345794392523364,0.08796296296296297
"[0, 1, 1, 1, 1, 0, 1, 0, 1, 0, 1, 1, 1, 0, 1]",235,85,150,8,21,0.09411764705882353,0.14
"[0, 0, 1, 1, 1, 1, 0, 1, 0, 1, 0, 1, 1, 1, 0]",143,67,76,4,5,0.05970149253731343,0.06578947368421052
"[1, 0, 1, 0, 1, 1, 0, 1, 1, 1, 1, 0, 1, 1, 0]",248,87,161,12,19,0.13793103448275862,0.11801242236024845
"[0, 0, 1, 0, 1, 0, 1, 0, 1, 1, 0, 1, 1, 1, 1]",186,77,109,12,15,0.15584415584415584,0.13761467889908258
"[1, 1, 1, 1, 1, 0, 1, 1, 1, 1, 0, 1, 1, 1, 0]",1689,384,1305,38,123,0.09895833333333333,0.09425287356321839
"[1, 0, 1, 1, 0, 1, 1, 0, 1, 1, 0, 1, 1, 1, 1]",528,145,383,14,31,0.09655172413793103,0.08093994778067885
"[0, 1, 1, 1, 1, 0, 1, 1, 1, 1, 1, 1, 1, 0, 1]",1611,400,1211,40,136,0.1,0.11230388109000826
"[0, 0, 0, 0, 1, 0, 1, 0, 0, 0, 0, 0, 0, 1, 1]",1136,845,291,88,35,0.10414201183431952,0.12027491408934708
"[0, 1, 0, 0, 0, 0, 0, 0, 0, 1, 1, 0, 0, 1, 1]",895,590,305,55,27,0.09322033898305085,0.08852459016393442
"[1, 1, 1, 0, 0, 0, 1, 0, 1, 0, 1, 1, 1, 1, 1]",330,113,217,13,21,0.11504424778761062,0.0967741935483871
"[0, 0, 1, 1, 1, 1, 0, 0, 0, 1, 0, 1, 0, 1, 1]",203,106,97,6,10,0.05660377358490566,0.10309278350515463
"[1, 0, 0, 1, 0, 1, 1, 1, 0, 1, 0, 0, 1, 1, 1]",160,68,92,7,14,0.10294117647058823,0.15217391304347827
"[0, 0, 0, 0, 0, 0, 1, 1, 1, 0, 0, 1, 0, 0, 1]",352,223,129,23,18,0.1031390134529148,0.13953488372093023
"[1, 1, 0, 0, 1, 0, 0, 1, 0, 0, 0, 0, 0, 0, 0]",729,496,233,49,17,0.09879032258064516,0.07296137339055794
"[1, 0, 0, 0, 1, 1, 0, 0, 1, 0, 0, 1, 0, 0, 0]",259,155,104,14,10,0.09032258064516129,0.09615384615384616
"[0, 1, 1, 0, 0, 0, 0, 1, 1, 1, 0, 0, 0, 1, 1]",214,148,66,18,8,0.12162162162162163,0.12121212121212122
"[0, 0, 0, 0, 1, 1, 0, 0, 0, 0, 1, 1, 1, 0, 0]",620,401,219,38,15,0.09476309226932668,0.0684931506849315
"[0, 1, 1, 1, 1, 0, 0, 1, 0, 0, 1, 1, 0, 1, 1]",209,96,113,9,10,0.09375,0.08849557522123894
"[0, 1, 0, 0, 0, 1, 0, 0, 0, 0, 0, 0, 0, 1, 0]",1550,1175,375,105,29,0.08936170212765958,0.07733333333333334
"[0, 0, 1, 0, 0, 0, 0, 0, 0, 0, 0, 0, 1, 1, 1]",2254,1775,479,189,61,0.10647887323943662,0.12734864300626306
"[1, 0, 0, 0, 1, 0, 1, 0, 0, 0, 1, 0, 0, 1, 0]",216,135,81,12,9,0.08888888888888889,0.1111111111111111
"[0, 1, 1, 1, 1, 0, 1, 1, 1, 1, 1, 1, 0, 0, 1]",802,265,537,21,62,0.07924528301886792,0.1154562383612663
"[1, 0, 0, 1, 1, 1, 1, 0, 0, 0, 0, 0, 0, 1, 1]",1696,376,1320,34,115,0.09042553191489362,0.08712121212121213
"[1, 1, 0, 0, 0, 1, 0, 0, 1, 1, 1, 1, 1, 0, 0]",179,94,85,6,2,0.06382978723404255,0.023529411764705882
"[0, 1, 1, 0, 0, 0, 1, 1, 0, 0, 1, 1, 0, 0, 0]",371,216,155,22,13,0.10185185185185185,0.08387096774193549
"[0, 0, 0, 1, 0, 0, 1, 0, 1, 1, 0, 1, 1, 1, 1]",153,70,83,5,8,0.07142857142857142,0.0963855421686747
"[1, 0, 0, 0, 1, 0, 0, 1, 0, 1, 1, 0, 1, 1, 1]",138,64,74,9,6,0.140625,0.08108108108108109
"[0, 1, 1, 1, 0, 0, 0, 0, 0, 0, 0, 1, 0, 0, 0]",628,428,200,31,25,0.07242990654205607,0.125
"[1, 1, 1, 0, 1, 1, 1, 1, 0, 1, 1, 1, 1, 1, 0]",1599,367,1232,30,128,0.08174386920980926,0.1038961038961039
"[1, 1, 1, 1, 1, 1, 1, 0, 1, 0, 0, 1, 1, 1, 1]",2512,576,1936,45,180,0.078125,0.09297520661157024
"[0, 0, 1, 0, 0, 1, 1, 1, 1, 1, 1, 1, 1, 1, 1]",1356,454,902,49,76,0.10792951541850221,0.08425720620842572
"[1, 1, 0, 1, 0, 0, 0, 0, 1, 0, 0, 1, 1, 1, 1]",188,87,101,8,7,0.09195402298850575,0.06930693069306931
"[1, 0, 1, 1, 1, 1, 0, 1, 0, 0, 0, 0, 0, 0, 0]",201,116,85,9,10,0.07758620689655173,0.11764705882352941
"[1, 1, 1, 0, 1, 1, 1, 0, 1, 0, 1, 0, 1, 0, 1]",236,86,150,8,16,0.09302325581395349,0.10666666666666667
"[1, 1, 1, 1, 1, 0, 1, 1, 1, 0, 1, 1, 0, 1, 0]",512,160,352,15,44,0.09375,0.125
"[0, 1, 1, 1, 1, 1, 0, 0, 1, 1, 1, 1, 0, 1, 1]",729,218,511,14,54,0.06422018348623854,0.10567514677103718
"[1, 1, 1, 1, 0, 0, 0, 0, 1, 0, 1, 0, 1, 1, 1]",332,139,193,12,17,0.08633093525179857,0.08808290155440414
"[1, 1, 1, 1, 1, 1, 1, 0, 0, 0, 0, 1, 0, 1, 0]",312,94,218,7,32,0.07446808510638298,0.14678899082568808
"[0, 1, 1, 1, 1, 1, 0, 1, 1, 0, 1, 0, 1, 1, 1]",558,175,383,19,25,0.10857142857142857,0.06527415143603134
"[1, 0, 0, 0, 0, 1, 1, 1, 0, 0, 0, 1, 1, 1, 1]",224,91,133,11,15,0.12087912087912088,0.11278195488721804
"[1, 0, 1, 0, 0, 0, 1, 0, 0, 0, 1, 1, 1, 1, 1]",156,80,76,6,6,0.075,0.07894736842105263
"[1, 0, 0, 0, 1, 0, 1, 0, 0, 0, 1, 0, 0, 0, 1]",240,137,103,6,6,0.043795620437956206,0.05825242718446602
"[0, 0, 1, 0, 1, 0, 0, 0, 0, 0, 1, 1, 0, 0, 0]",865,606,259,57,23,0.09405940594059406,0.0888030888030888
"[1, 0, 0, 0, 1, 0, 0, 0, 1, 0, 0, 0, 0, 0, 0]",1800,1348,452,125,47,0.09272997032640949,0.10398230088495575
"[1, 0, 1, 0, 0, 0, 1, 0, 0, 0, 1, 0, 0, 0, 0]",546,390,156,40,20,0.10256410256410256,0.1282051282051282
"[0, 0, 0, 0, 0, 1, 0, 1, 0, 1, 1, 0, 1, 0, 0]",248,172,76,17,2,0.09883720930232558,0.02631578947368421
"[0, 1, 0, 0, 0, 0, 0, 1, 0, 1, 0, 1, 1, 0, 1]",139,86,53,4,6,0.046511627906976744,0.11320754716981132
"[1, 1, 1, 1, 1, 0, 1, 1, 0, 0, 1, 1, 0, 1, 1]",604,168,436,19,35,0.1130952380952381,0.08027522935779817
"[0, 1, 1, 1, 1, 0, 1, 1, 1, 1, 1, 0, 1, 1, 0]",540,173,367,19,38,0.10982658959537572,0.10354223433242507
"[0, 1, 1, 1, 1, 1, 0, 0, 1, 1, 0, 1, 1, 1, 1]",697,244,453,24,45,0.09836065573770492,0.09933774834437085
"[0, 1, 0, 1, 0, 0, 1, 0, 1, 0, 1, 0, 1, 0, 0]",156,99,57,12,6,0.12121212121212122,0.10526315789473684
"[0, 1, 0, 1, 1, 0, 1, 1, 1, 1, 1, 1, 0, 0, 0]",255,97,158,8,13,0.08247422680412371,0.08227848101265822
"[1, 0, 0, 0, 1, 1, 0, 0, 1, 1, 1, 1, 1, 0, 1]",176,73,103,6,9,0.0821917808219178,0.08737864077669903
"[0, 0, 1, 1, 0, 0, 1, 0, 0, 0, 1, 1, 1, 1, 1]",239,107,132,12,9,0.11214953271028037,0.06818181818181818
"[1, 1, 0, 1, 0, 1, 1, 0, 0, 0, 1, 1, 0, 1, 1]",164,75,89,12,10,0.16,0.11235955056179775
"[1, 1, 1, 0, 0, 1, 1, 1, 1, 0, 0, 0, 0, 0, 0]",1629,358,1271,25,112,0.06983240223463687,0.08811959087332809
"[1, 1, 1, 1, 1, 1, 1, 0, 1, 0, 1, 0, 0, 0, 0]",245,83,162,11,19,0.13253012048192772,0.11728395061728394
"[1, 1, 0, 1, 1, 1, 1, 1, 0, 0, 0, 0, 1, 1, 1]",704,250,454,30,54,0.12,0.11894273127753303
"[1, 0, 0, 0, 0, 1, 1, 1, 1, 0, 1, 1, 1, 0, 1]",195,54,141,2,12,0.037037037037037035,0.0851063829787234
"[0, 1, 1, 1, 1, 0, 0, 0, 1, 0, 1, 1, 1, 1, 1]",431,220,211,29,29,0.1318181818181818,0.13744075829383887
"[1, 1, 0, 1, 0, 1, 1, 0, 1, 1, 1, 1, 0, 0, 0]",205,81,124,12,12,0.14814814814814814,0.0967741935483871
"[1, 1, 1, 0, 1, 0, 1, 1, 0, 1, 1, 1, 1, 0, 0]",336,118,218,18,17,0.15254237288135594,0.0779816513761468
"[1, 0, 0, 0, 0, 1, 0, 1, 1, 1, 1, 0, 0, 1, 0]",108,69,39,9,4,0.13043478260869565,0.10256410256410256
"[0, 1, 1, 1, 0, 0, 0, 0, 1, 0, 0, 1, 0, 0, 0]",238,154,84,13,9,0.08441558441558442,0.10714285714285714
"[0, 0, 1, 1, 1, 0, 0, 0, 0, 1, 0, 0, 1, 0, 0]",231,150,81,19,8,0.12666666666666668,0.09876543209876543
"[0, 0, 0, 0, 0, 1, 0, 0, 0, 1, 1, 1, 0, 0, 0]",667,481,186,50,22,0.10395010395010396,0.11827956989247312
"[0, 0, 1, 1, 1, 0, 0, 0, 1, 1, 1, 0, 0, 0, 0]",276,175,101,10,12,0.05714285714285714,0.1188118811881188
"[0, 1, 0, 1, 0, 0, 1, 1, 1, 0, 0, 0, 1, 1, 1]",128,68,60,7,5,0.10294117647058823,0.08333333333333333
"[0, 1, 0, 1, 0, 1, 1, 0, 0, 0, 1, 0, 1, 0, 1]",108,53,55,7,8,0.1320754716981132,0.14545454545454545
"[0, 0, 0, 1, 0, 1, 0, 1, 1, 0, 0, 0, 1, 0, 1]",154,90,64,8,1,0.08888888888888889,0.015625
"[0, 1, 0, 1, 0, 0, 0, 1, 0, 1, 0, 1, 1, 0, 0]",143,84,59,15,5,0.17857142857142858,0.0847457627118644
"[0, 1, 1, 0, 1, 0, 1, 0, 1, 0, 0, 0, 1, 0, 1]",97,48,49,5,3,0.10416666666666667,0.061224489795918366
"[1, 0, 0, 1, 1, 0, 0, 1, 0, 1, 0, 0, 1, 0, 0]",145,71,74,8,7,0.11267605633802817,0.0945945945945946
"[1, 0, 0, 1, 0, 1, 0, 1, 1, 1, 0, 0, 1, 1, 0]",148,70,78,5,4,0.07142857142857142,0.05128205128205128
"[0, 1, 1, 1, 1, 0, 1, 1, 0, 0, 1, 1, 1, 1, 1]",947,308,639,39,54,0.1266233766233766,0.08450704225352113
"[1, 1, 0, 1, 1, 0, 0, 1, 1, 0, 1, 1, 1, 0, 0]",164,70,94,5,9,0.07142857142857142,0.09574468085106383
"[0, 0, 1, 0, 0, 1, 1, 1, 1, 0, 1, 1, 0, 0, 1]",145,64,81,1,5,0.015625,0.06172839506172839
"[0, 0, 1, 0, 0, 0, 1, 0, 0, 1, 0, 0, 0, 1, 1]",302,201,101,14,11,0.06965174129353234,0.10891089108910891
"[0, 1, 1, 0, 0, 0, 0, 0, 0, 0, 1, 0, 0, 0, 1]",756,584,172,53,14,0.09075342465753425,0.08139534883720931
"[0, 0, 0, 0, 1, 1, 0, 0, 1, 0, 0, 0, 1, 0, 0]",576,394,182,39,14,0.09898477157360407,0.07692307692307693
"[1, 1, 0, 0, 0, 1, 0, 0, 1, 0, 1, 1, 1, 1, 1]",219,96,123,11,17,0.11458333333333333,0.13821138211382114
"[1, 1, 1, 1, 0, 0, 0, 1, 0, 0, 1, 0, 1, 1, 1]",221,94,127,8,12,0.0851063829787234,0.09448818897637795
"[1, 1, 0, 1, 1, 1, 1, 1, 1, 0, 1, 1, 0, 0, 1]",590,164,426,23,55,0.1402439024390244,0.12910798122065728
"[1, 0, 0, 0, 1, 0, 1, 0, 0, 1, 1, 1, 0, 0, 0]",168,85,83,9,5,0.10588235294117647,0.060240963855421686
"[0, 1, 0, 1, 1, 0, 0, 0, 0, 1, 1, 0, 0, 0, 1]",175,103,72,14,8,0.13592233009708737,0.1111111111111111
"[1, 1, 0, 0, 1, 0, 1, 1, 1, 1, 1, 1, 1, 0, 0]",414,140,274,13,29,0.09285714285714286,0.10583941605839416
"[1, 1, 1, 1, 0, 1, 1, 0, 1, 1, 1, 0, 1, 1, 0]",492,159,333,15,37,0.09433962264150944,0.1111111111111111
"[1, 0, 1, 1, 0, 0, 1, 0, 0, 1, 1, 1, 1, 1, 0]",174,74,100,4,11,0.05405405405405406,0.11
"[1, 1, 0, 0, 1, 1, 1, 1, 1, 0, 1, 1, 0, 0, 1]",369,97,272,9,26,0.09278350515463918,0.09558823529411764
"[0, 1, 1, 1, 0, 0, 1, 1, 0, 1, 1, 1, 1, 1, 1]",707,226,481,13,39,0.05752212389380531,0.08108108108108109
"[0, 0, 0, 1, 0, 0, 1, 0, 1, 1, 0, 0, 0, 1, 0]",242,165,77,18,6,0.10909090909090909,0.07792207792207792
"[1, 1, 1, 1, 1, 0, 0, 0, 1, 0, 0, 1, 0, 1, 1]",201,72,129,5,19,0.06944444444444445,0.14728682170542637
"[0, 0, 0, 0, 1, 0, 0, 0, 0, 0, 1, 1, 1, 1, 0]",563,390,173,35,17,0.08974358974358974,0.09826589595375723
"[1, 1, 0, 0, 0, 0, 0, 1, 0, 0, 0, 0, 0, 1, 1]",440,274,166,26,19,0.0948905109489051,0.1144578313253012
"[0, 0, 1, 1, 0, 0, 0, 1, 1, 1, 0, 0, 1, 0, 1]",135,61,74,10,8,0.16393442622950818,0.10810810810810811
"[0, 0, 0, 0, 0, 0, 0, 0, 1, 0, 0, 0, 1, 0, 1]",1820,1424,396,129,34,0.09058988764044944,0.08585858585858586
"[1, 0, 1, 0, 1, 1, 0, 0, 0, 0, 0, 0, 0, 1, 0]",273,179,94,16,13,0.0893854748603352,0.13829787234042554
"[0, 1, 1, 0, 1, 0, 0, 1, 1, 1, 0, 1, 1, 1, 0]",125,53,72,5,6,0.09433962264150944,0.08333333333333333
"[1, 1, 1, 0, 0, 1, 1, 1, 0, 1, 1, 0, 1, 0, 0]",178,71,107,7,9,0.09859154929577464,0.08411214953271028
"[0, 1, 1, 1, 0, 0, 1, 1, 1, 0, 1, 1, 0, 1, 0]",160,66,94,4,10,0.06060606060606061,0.10638297872340426
"[0, 1, 0, 0, 0, 0, 0, 1, 1, 1, 1, 1, 1, 1, 0]",203,102,101,8,12,0.0784313725490196,0.1188118811881188
"[0, 1, 0, 1, 1, 0, 0, 0, 0, 0, 0, 0, 0, 1, 1]",767,514,253,54,21,0.10505836575875487,0.08300395256916997
"[1, 1, 0, 1, 1, 1, 0, 0, 1, 0, 0, 1, 0, 0, 1]",107,52,55,9,4,0.17307692307692307,0.07272727272727272
"[1, 1, 1, 0, 1, 1, 1, 0, 0, 1, 0, 0, 1, 0, 0]",124,68,56,4,8,0.058823529411764705,0.14285714285714285
"[0, 1, 1, 1, 0, 0, 1, 0, 1, 0, 1, 1, 1, 1, 1]",279,113,166,13,13,0.11504424778761062,0.0783132530120482
"[1, 0, 1, 0, 1, 1, 0, 0, 1, 0, 1, 1, 1, 0, 0]",145,65,80,5,7,0.07692307692307693,0.0875
"[0, 1, 0, 0, 1, 0, 1, 0, 1, 0, 1, 1, 0, 0, 1]",121,60,61,4,5,0.06666666666666667,0.08196721311475409
"[1, 1, 0, 0, 0, 0, 1, 0, 1, 1, 1, 0, 1, 0, 1]",123,59,64,6,7,0.1016949152542373,0.109375
"[1, 1, 0, 1, 0, 1, 1, 1, 0, 1, 0, 1, 0, 0, 0]",106,40,66,5,6,0.125,0.09090909090909091
"[1, 1, 0, 1, 0, 0, 1, 1, 0, 1, 1, 1, 1, 1, 1]",693,200,493,13,52,0.065,0.10547667342799188
"[0, 1, 1, 1, 0, 1, 0, 0, 1, 1, 0, 1, 1, 1, 1]",299,117,182,11,20,0.09401709401709402,0.10989010989010989
"[1, 1, 1, 0, 0, 0, 1, 1, 1, 1, 0, 1, 1, 0, 1]",283,92,191,5,23,0.05434782608695652,0.12041884816753927
"[0, 0, 0, 1, 1, 1, 0, 0, 0, 0, 1, 1, 1, 1, 1]",371,202,169,14,14,0.06930693069306931,0.08284023668639054
"[0, 0, 0, 0, 0, 0, 1, 1, 0, 1, 1, 0, 0, 0, 0]",878,627,251,58,22,0.09250398724082935,0.08764940239043825
"[0, 0, 0, 0, 1, 0, 0, 0, 1, 0, 1, 1, 0, 0, 0]",601,439,162,39,14,0.0888382687927107,0.08641975308641975
"[0, 1, 1, 1, 1, 1, 0, 0, 1, 0, 0, 0, 0, 0, 1]",147,83,64,7,2,0.08433734939759036,0.03125
"[1, 1, 1, 1, 0, 0, 1, 0, 1, 0, 1, 0, 0, 1, 0]",109,48,61,2,4,0.041666666666666664,0.06557377049180328
"[1, 1, 0, 1, 1, 0, 1, 0, 1, 1, 0, 1, 0, 1, 1]",242,82,160,8,12,0.0975609756097561,0.075
"[0, 0, 0, 0, 1, 0, 0, 0, 1, 0, 0, 0, 1, 0, 0]",1517,1167,350,98,24,0.08397600685518423,0.06857142857142857
"[0, 0, 0, 0, 1, 1, 1, 1, 1, 0, 0, 0, 0, 0, 0]",767,508,259,50,26,0.0984251968503937,0.10038610038610038
"[1, 0, 1, 1, 1, 1, 1, 1, 0, 1, 0, 0, 1, 0, 1]",220,75,145,6,12,0.08,0.08275862068965517
"[0, 0, 0, 0, 1, 0, 0, 0, 0, 1, 1, 1, 0, 0, 1]",286,182,104,14,10,0.07692307692307693,0.09615384615384616
"[1, 1, 0, 0, 0, 0, 0, 1, 1, 1, 1, 0, 1, 1, 1]",280,109,171,6,13,0.05504587155963303,0.07602339181286549
"[1, 1, 1, 0, 1, 0, 1, 1, 0, 1, 1, 0, 1, 1, 1]",540,166,374,14,33,0.08433734939759036,0.08823529411764706
"[1, 1, 1, 1, 1, 0, 1, 0, 1, 1, 0, 1, 1, 0, 1]",503,141,362,17,33,0.12056737588652482,0.09116022099447514
"[0, 0, 0, 1, 1, 0, 0, 0, 1, 0, 1, 0, 1, 1, 1]",227,162,65,15,10,0.09259259259259259,0.15384615384615385
"[0, 0, 0, 1, 0, 0, 0, 0, 1, 1, 1, 0, 0, 0, 1]",252,159,93,15,16,0.09433962264150944,0.17204301075268819
"[1, 1, 0, 0, 1, 1, 0, 0, 1, 1, 0, 0, 0, 0, 0]",1885,1130,755,99,57,0.08761061946902655,0.07549668874172186
"[0, 0, 1, 1, 0, 0, 1, 1, 0, 0, 1, 0, 0, 1, 1]",332,166,166,16,14,0.0963855421686747,0.08433734939759036
"[1, 0, 1, 1, 0, 1, 0, 0, 0, 0, 1, 1, 0, 0, 1]",191,93,98,9,7,0.0967741935483871,0.07142857142857142
"[0, 0, 0, 1, 0, 0, 1, 0, 0, 0, 0, 0, 0, 1, 1]",1058,770,288,86,29,0.11168831168831168,0.10069444444444445
"[0, 1, 0, 1, 0, 0, 0, 1, 0, 1, 1, 0, 0, 0, 0]",327,211,116,21,7,0.0995260663507109,0.0603448275862069
"[1, 0, 0, 0, 0, 0, 1, 0, 1, 0, 0, 0, 1, 0, 1]",239,148,91,18,11,0.12162162162162163,0.12087912087912088
"[0, 1, 0, 0, 0, 0, 0, 1, 0, 0, 0, 0, 1, 1, 1]",457,311,146,31,12,0.09967845659163987,0.0821917808219178
"[1, 1, 0, 1, 1, 1, 0, 1, 1, 1, 0, 0, 0, 1, 0]",132,55,77,3,10,0.05454545454545454,0.12987012987012986
"[0, 0, 1, 1, 0, 1, 1, 0, 0, 0, 0, 1, 0, 1, 1]",129,67,62,6,3,0.08955223880597014,0.04838709677419355
"[0, 0, 0, 0, 1, 0, 0, 0, 0, 0, 0, 1, 1, 0, 1]",609,451,158,44,17,0.0975609756097561,0.10759493670886076
"[1, 1, 0, 0, 1, 1, 1, 1, 1, 0, 0, 0, 0, 1, 0]",156,75,81,7,4,0.09333333333333334,0.04938271604938271
"[1, 1, 0, 0, 1, 1, 0, 0, 0, 1, 1, 1, 1, 0, 1]",191,76,115,8,12,0.10526315789473684,0.10434782608695652
"[1, 1, 1, 0, 0, 0, 1, 1, 0, 0, 1, 1, 0, 0, 1]",301,123,178,13,16,0.10569105691056911,0.0898876404494382
"[1, 1, 0, 1, 0, 1, 1, 1, 0, 0, 0, 1, 1, 0, 0]",139,65,74,3,10,0.046153846153846156,0.13513513513513514
"[0, 1, 1, 1, 0, 1, 0, 1, 1, 1, 0, 0, 0, 1, 1]",156,65,91,10,6,0.15384615384615385,0.06593406593406594
"[0, 0, 0, 0, 1, 0, 1, 1, 1, 1, 0, 1, 1, 0, 1]",115,57,58,4,4,0.07017543859649122,0.06896551724137931
"[1, 1, 1, 1, 0, 1, 0, 0, 1, 0, 0, 1, 0, 0, 0]",117,60,57,4,5,0.06666666666666667,0.08771929824561403
"[0, 1, 0, 0, 1, 0, 1, 0, 1, 1, 0, 1, 1, 1, 1]",152,62,90,8,8,0.12903225806451613,0.08888888888888889
"[0, 1, 0, 1, 1, 0, 1, 0, 1, 1, 1, 0, 1, 1, 0]",143,69,74,5,9,0.07246376811594203,0.12162162162162163
"[1, 0, 0, 0, 0, 0, 0, 1, 0, 1, 1, 0, 1, 0, 1]",165,86,79,9,7,0.10465116279069768,0.08860759493670886
"[1, 0, 1, 0, 0, 1, 0, 0, 1, 1, 0, 1, 1, 1, 0]",104,44,60,4,3,0.09090909090909091,0.05
"[1, 1, 0, 1, 0, 1, 0, 0, 1, 0, 1, 0, 0, 0, 1]",93,46,47,4,3,0.08695652173913043,0.06382978723404255
"[1, 0, 0, 1, 1, 1, 1, 1, 1, 0, 1, 0, 1, 0, 0]",194,66,128,4,20,0.06060606060606061,0.15625
"[0, 0, 1, 0, 0, 0, 0, 1, 1, 1, 1, 1, 1, 1, 0]",213,94,119,4,15,0.0425531914893617,0.12605042016806722
"[1, 0, 1, 1, 1, 0, 1, 1, 1, 0, 0, 0, 0, 1, 0]",106,45,61,4,5,0.08888888888888889,0.08196721311475409
"[1, 1, 1, 0, 0, 1, 0, 1, 1, 0, 0, 1, 0, 1, 1]",161,47,114,2,12,0.0425531914893617,0.10526315789473684
"[1, 0, 1, 1, 1, 1, 0, 0, 0, 1, 1, 1, 1, 0, 1]",241,77,164,6,21,0.07792207792207792,0.12804878048780488
"[0, 1, 1, 0, 0, 0, 0, 0, 0, 0, 0, 1, 1, 0, 0]",4202,3630,572,360,62,0.09917355371900827,0.10839160839160839
"[0, 0, 0, 1, 1, 0, 0, 0, 0, 0, 1, 1, 1, 1, 0]",395,271,124,20,8,0.07380073800738007,0.06451612903225806
"[1, 1, 1, 1, 0, 0, 1, 1, 0, 0, 1, 1, 1, 0, 0]",430,166,264,12,23,0.07228915662650602,0.08712121212121213
"[1, 1, 1, 1, 0, 1, 1, 1, 1, 1, 1, 0, 1, 0, 0]",558,160,398,20,55,0.125,0.13819095477386933
"[0, 0, 1, 1, 0, 0, 0, 1, 0, 0, 1, 0, 1, 1, 1]",220,124,96,13,8,0.10483870967741936,0.08333333333333333
"[1, 0, 0, 1, 0, 1, 0, 0, 0, 1, 0, 1, 0, 1, 1]",122,63,59,3,5,0.047619047619047616,0.0847457627118644
"[0, 0, 0, 1, 1, 1, 0, 1, 1, 0, 1, 1, 0, 1, 0]",119,62,57,10,4,0.16129032258064516,0.07017543859649122
"[0, 0, 1, 0, 1, 1, 1, 0, 1, 1, 0, 0, 0, 0, 1]",140,66,74,6,3,0.09090909090909091,0.04054054054054054
"[0, 0, 0, 0, 0, 0, 0, 1, 0, 1, 0, 0, 1, 0, 1]",630,454,176,34,15,0.07488986784140969,0.08522727272727272
"[1, 1, 1, 1, 0, 0, 0, 0, 1, 0, 1, 0, 0, 0, 0]",220,132,88,17,8,0.12878787878787878,0.09090909090909091
"[0, 1, 1, 0, 0, 1, 1, 0, 1, 0, 0, 0, 1, 0, 0]",160,99,61,11,4,0.1111111111111111,0.06557377049180328
"[1, 0, 0, 0, 0, 0, 0, 1, 1, 0, 0, 1, 1, 0, 1]",411,124,287,17,34,0.13709677419354838,0.11846689895470383
"[1, 0, 0, 1, 1, 0, 1, 1, 1, 0, 1, 1, 0, 0, 1]",159,56,103,5,10,0.08928571428571429,0.0970873786407767
"[1, 1, 0, 0, 0, 0, 0, 1, 1, 1, 1, 0, 1, 1, 0]",162,73,89,6,4,0.0821917808219178,0.0449438202247191
"[1, 1, 0, 1, 0, 0, 0, 0, 1, 1, 1, 1, 1, 0, 1]",153,58,95,9,11,0.15517241379310345,0.11578947368421053
"[0, 1, 1, 0, 0, 1, 0, 1, 1, 1, 1, 0, 1, 0, 0]",114,55,59,4,5,0.07272727272727272,0.0847457627118644
"[0, 0, 1, 1, 0, 0, 1, 0, 1, 1, 1, 1, 0, 1, 0]",122,59,63,2,11,0.03389830508474576,0.1746031746031746
"[0, 0, 0, 1, 1, 1, 1, 1, 0, 1, 1, 0, 0, 0, 1]",139,75,64,9,4,0.12,0.0625
"[0, 1, 0, 0, 0, 1, 1, 1, 1, 1, 0, 1, 1, 0, 0]",134,67,67,5,1,0.07462686567164178,0.014925373134328358
"[0, 0, 1, 0, 1, 0, 1, 1, 1, 1, 1, 1, 0, 1, 0]",139,64,75,13,4,0.203125,0.05333333333333334
"[0, 0, 0, 0, 0, 0, 1, 1, 1, 0, 1, 1, 1, 1, 0]",197,98,99,7,5,0.07142857142857142,0.050505050505050504
"[1, 1, 0, 0, 0, 0, 0, 1, 0, 1, 0, 0, 1, 0, 1]",184,104,80,5,9,0.04807692307692308,0.1125
"[1, 1, 1, 0, 0, 1, 0, 0, 0, 0, 1, 1, 1, 0, 0]",147,74,73,5,6,0.06756756756756757,0.0821917808219178
"[1, 1, 0, 1, 1, 1, 1, 0, 0, 1, 0, 0, 0, 0, 1]",146,57,89,12,8,0.21052631578947367,0.0898876404494382
"[1, 0, 0, 0, 1, 1, 1, 1, 0, 0, 1, 1, 1, 1, 0]",477,194,283,17,26,0.08762886597938144,0.09187279151943463
"[1, 1, 1, 1, 1, 1, 0, 1, 1, 0, 1, 1, 0, 1, 1]",1663,381,1282,45,116,0.11811023622047244,0.0904836193447738
"[1, 1, 1, 1, 0, 1, 0, 0, 1, 0, 1, 0, 1, 1, 1]",286,113,173,14,14,0.12389380530973451,0.08092485549132948
"[1, 0, 1, 1, 1, 1, 1, 1, 1, 0, 0, 0, 0, 0, 0]",539,246,293,23,31,0.09349593495934959,0.10580204778156997
"[0, 0, 0, 0, 0, 1, 1, 0, 0, 1, 0, 1, 1, 0, 0]",358,253,105,27,7,0.1067193675889328,0.06666666666666667
"[1, 1, 0, 0, 1, 1, 0, 0, 0, 0, 1, 0, 0, 1, 0]",257,148,109,17,6,0.11486486486486487,0.05504587155963303
"[0, 1, 0, 0, 0, 1, 0, 0, 1, 0, 0, 1, 1, 0, 0]",304,170,134,22,8,0.12941176470588237,0.05970149253731343
"[1, 0, 1, 0, 1, 1, 0, 1, 0, 0, 0, 1, 0, 0, 1]",108,54,54,4,6,0.07407407407407407,0.1111111111111111
"[1, 1, 0, 1, 0, 1, 1, 0, 1, 0, 0, 0, 1, 0, 0]",134,77,57,5,6,0.06493506493506493,0.10526315789473684
"[1, 1, 1, 0, 0, 0, 0, 1, 1, 0, 0, 1, 1, 1, 0]",369,90,279,5,21,0.05555555555555555,0.07526881720430108
"[1, 1, 1, 1, 1, 0, 1, 1, 1, 0, 1, 1, 1, 1, 0]",1621,373,1248,37,113,0.09919571045576407,0.09054487179487179
"[1, 0, 1, 1, 1, 0, 1, 0, 0, 1, 1, 0, 1, 1, 0]",149,58,91,7,8,0.1206896551724138,0.08791208791208792
"[0, 0, 1, 0, 0, 1, 1, 1, 0, 1, 1, 0, 1, 1, 1]",162,64,98,3,9,0.046875,0.09183673469387756
"[1, 1, 1, 0, 1, 1, 0, 0, 1, 1, 1, 1, 0, 0, 0]",361,131,230,14,19,0.10687022900763359,0.08260869565217391
"[0, 0, 1, 0, 1, 1, 1, 1, 0, 1, 1, 0, 0, 1, 1]",202,89,113,4,4,0.0449438202247191,0.035398230088495575
"[0, 0, 1, 1, 0, 1, 0, 0, 0, 0, 1, 1, 0, 0, 1]",240,134,106,11,10,0.08208955223880597,0.09433962264150944
"[0, 0, 0, 1, 1, 0, 1, 0, 0, 0, 0, 1, 1, 0, 0]",384,254,130,25,11,0.0984251968503937,0.08461538461538462
"[1, 0, 0, 0, 0, 1, 0, 1, 1, 0, 0, 0, 0, 1, 1]",283,155,128,13,13,0.08387096774193549,0.1015625
"[0, 0, 1, 1, 0, 0, 1, 1, 1, 0, 0, 1, 1, 0, 0]",258,147,111,17,10,0.11564625850340136,0.09009009009009009
"[0, 0, 0, 1, 0, 0, 1, 1, 0, 0, 1, 1, 0, 0, 1]",363,227,136,17,11,0.07488986784140969,0.08088235294117647
"[0, 0, 0, 0, 1, 0, 1, 1, 0, 1, 0, 0, 0, 1, 0]",216,144,72,9,10,0.0625,0.1388888888888889
"[1, 0, 0, 0, 0, 1, 0, 0, 1, 1, 1, 0, 0, 0, 0]",353,189,164,13,14,0.06878306878306878,0.08536585365853659
"[0, 0, 1, 0, 0, 0, 0, 0, 1, 1, 1, 0, 0, 0, 1]",294,194,100,18,14,0.09278350515463918,0.14
"[1, 0, 1, 0, 0, 1, 1, 0, 0, 1, 0, 0, 1, 0, 0]",144,82,62,7,3,0.08536585365853659,0.04838709677419355
"[1, 1, 0, 1, 0, 1, 0, 0, 1, 1, 0, 0, 1, 0, 0]",140,78,62,5,8,0.0641025641025641,0.12903225806451613
"[0, 0, 1, 0, 1, 0, 1, 0, 1, 0, 1, 1, 1, 1, 1]",148,65,83,6,9,0.09230769230769231,0.10843373493975904
"[1, 1, 0, 0, 0, 0, 1, 0, 1, 0, 1, 0, 1, 0, 1]",117,62,55,5,1,0.08064516129032258,0.01818181818181818
"[1, 1, 1, 0, 0, 0, 0, 1, 0, 1, 0, 1, 0, 1, 0]",125,57,68,8,7,0.14035087719298245,0.10294117647058823
"[0, 0, 1, 1, 0, 0, 0, 0, 1, 0, 1, 0, 1, 1, 0]",206,124,82,14,11,0.11290322580645161,0.13414634146341464
"[0, 1, 1, 1, 1, 0, 0, 1, 1, 0, 0, 0, 0, 1, 1]",1668,1308,360,112,23,0.0856269113149847,0.06388888888888888
"[1, 1, 0, 1, 1, 0, 1, 0, 0, 0, 0, 1, 1, 0, 1]",127,60,67,7,3,0.11666666666666667,0.04477611940298507
"[1, 0, 1, 0, 0, 1, 0, 0, 0, 1, 0, 1, 0, 0, 0]",239,142,97,11,8,0.07746478873239436,0.08247422680412371
"[1, 1, 1, 0, 1, 1, 0, 0, 1, 1, 0, 1, 0, 1, 1]",251,82,169,7,13,0.08536585365853659,0.07692307692307693
"[0, 1, 1, 1, 1, 1, 0, 0, 1, 1, 1, 1, 1, 0, 1]",642,215,427,21,36,0.09767441860465116,0.08430913348946135
"[0, 0, 0, 1, 1, 1, 1, 0, 0, 0, 0, 1, 1, 0, 0]",2030,1686,344,138,40,0.08185053380782918,0.11627906976744186
"[1, 1, 1, 1, 1, 1, 1, 0, 0, 0, 0, 1, 0, 0, 0]",252,104,148,9,11,0.08653846153846154,0.07432432432432433
"[0, 1, 0, 0, 1, 0, 1, 1, 0, 0, 0, 0, 0, 0, 1]",354,224,130,24,18,0.10714285714285714,0.13846153846153847
"[0, 1, 0, 1, 0, 1, 1, 1, 1, 1, 0, 1, 1, 0, 1]",207,77,130,8,12,0.1038961038961039,0.09230769230769231
"[0, 0, 1, 0, 1, 0, 1, 0, 0, 0, 0, 0, 0, 1, 0]",538,389,149,48,20,0.12339331619537275,0.1342281879194631
"[1, 0, 0, 1, 1, 0, 0, 0, 1, 0, 1, 1, 0, 0, 0]",184,106,78,8,12,0.07547169811320754,0.15384615384615385
"[1, 1, 0, 1, 0, 1, 1, 1, 0, 0, 0, 1, 0, 1, 0]",118,56,62,10,7,0.17857142857142858,0.11290322580645161
"[1, 0, 0, 0, 1, 1, 0, 1, 0, 1, 1, 1, 0, 0, 0]",129,61,68,2,4,0.03278688524590164,0.058823529411764705
"[0, 1, 0, 1, 0, 0, 0, 1, 1, 0, 1, 0, 1, 1, 1]",120,63,57,7,6,0.1111111111111111,0.10526315789473684
"[1, 1, 0, 1, 1, 1, 1, 0, 1, 0, 1, 1, 1, 1, 1]",1790,427,1363,52,111,0.12177985948477751,0.08143800440205429
"[0, 0, 0, 1, 0, 0, 0, 1, 0, 0, 0, 1, 1, 1, 1]",292,194,98,17,7,0.08762886597938144,0.07142857142857142
"[0, 0, 0, 0, 1, 0, 0, 0, 1, 0, 0, 0, 1, 1, 1]",563,426,137,38,26,0.0892018779342723,0.1897810218978102
"[0, 0, 0, 0, 1, 1, 1, 0, 1, 0, 0, 0, 0, 1, 0]",269,185,84,26,9,0.14054054054054055,0.10714285714285714
"[1, 1, 1, 0, 1, 0, 1, 1, 1, 0, 0, 1, 1, 0, 1]",257,94,163,8,9,0.0851063829787234,0.05521472392638037
"[0, 1, 0, 0, 0, 1, 1, 1, 1, 1, 1, 0, 1, 0, 1]",160,67,93,4,10,0.05970149253731343,0.10752688172043011
"[0, 1, 1, 0, 1, 1, 0, 0, 1, 0, 0, 0, 0, 1, 0]",133,84,49,7,4,0.08333333333333333,0.08163265306122448
"[0, 1, 1, 1, 0, 0, 0, 0, 0, 1, 0, 1, 1, 1, 0]",108,57,51,3,6,0.05263157894736842,0.11764705882352941
"[1, 0, 1, 1, 1, 0, 0, 0, 0, 0, 1, 0, 1, 1, 1]",152,75,77,6,6,0.08,0.07792207792207792
"[0, 1, 1, 0, 0, 1, 1, 1, 1, 0, 1, 0, 0, 0, 1]",163,102,61,9,5,0.08823529411764706,0.08196721311475409
"[0, 1, 0, 0, 0, 1, 1, 1, 0, 0, 1, 1, 1, 0, 0]",145,86,59,9,2,0.10465116279069768,0.03389830508474576
"[1, 0, 0, 0, 1, 0, 1, 1, 1, 1, 1, 0, 0, 0, 0]",219,110,109,14,15,0.12727272727272726,0.13761467889908258
"[0, 0, 1, 1, 0, 0, 0, 1, 0, 1, 1, 1, 1, 1, 0]",153,77,76,9,6,0.11688311688311688,0.07894736842105263
"[0, 1, 0, 1, 1, 0, 1, 1, 0, 1, 1, 1, 0, 0, 1]",146,70,76,7,9,0.1,0.11842105263157894
"[0, 0, 1, 0, 0, 1, 1, 1, 1, 0, 0, 0, 0, 0, 1]",224,127,97,11,11,0.08661417322834646,0.1134020618556701
"[1, 0, 0, 0, 1, 1, 0, 1, 0, 0, 0, 0, 0, 0, 0]",698,462,236,45,21,0.09740259740259741,0.08898305084745763
"[0, 1, 0, 1, 0, 0, 0, 1, 1, 0, 1, 0, 0, 0, 0]",268,179,89,16,5,0.0893854748603352,0.056179775280898875
"[0, 1, 0, 1, 0, 1, 0, 0, 0, 1, 1, 0, 1, 0, 0]",155,88,67,8,7,0.09090909090909091,0.1044776119402985
"[0, 0, 1, 0, 0, 0, 1, 0, 0, 0, 0, 0, 0, 1, 0]",1556,1186,370,121,31,0.10202360876897133,0.08378378378378379
"[1, 1, 0, 0, 0, 0, 1, 1, 1, 0, 1, 0, 0, 0, 1]",148,81,67,6,4,0.07407407407407407,0.05970149253731343
"[1, 0, 1, 0, 0, 1, 0, 1, 0, 1, 1, 0, 0, 0, 0]",180,104,76,10,6,0.09615384615384616,0.07894736842105263
"[0, 0, 0, 1, 1, 1, 0, 0, 0, 1, 1, 0, 0, 0, 1]",173,98,75,12,1,0.12244897959183673,0.013333333333333334
"[1, 0, 1, 1, 1, 1, 1, 0, 0, 0, 1, 1, 1, 0, 1]",267,100,167,9,11,0.09,0.0658682634730539
"[0, 1, 1, 0, 1, 1, 1, 1, 1, 0, 0, 0, 1, 1, 0]",157,66,91,4,7,0.06060606060606061,0.07692307692307693
"[0, 0, 1, 0, 1, 1, 1, 0, 0, 1, 1, 0, 1, 1, 1]",165,78,87,8,8,0.10256410256410256,0.09195402298850575
"[0, 1, 1, 0, 1, 1, 1, 0, 0, 0, 0, 1, 1, 0, 1]",145,66,79,10,8,0.15151515151515152,0.10126582278481013
"[0, 0, 0, 0, 0, 0, 0, 1, 0, 1, 0, 1, 0, 1, 1]",338,229,109,28,10,0.1222707423580786,0.09174311926605505
"[1, 1, 0, 1, 1, 1, 1, 1, 0, 1, 1, 0, 0, 0, 1]",260,83,177,10,18,0.12048192771084337,0.1016949152542373
"[1, 0, 1, 1, 0, 1, 0, 1, 1, 1, 0, 1, 1, 1, 1]",547,163,384,15,36,0.09202453987730061,0.09375
"[1, 1, 1, 0, 1, 1, 1, 0, 1, 1, 1, 0, 1, 0, 1]",535,165,370,12,35,0.07272727272727272,0.0945945945945946
"[1, 0, 1, 1, 1, 1, 0, 0, 1, 1, 0, 0, 1, 0, 1]",186,72,114,9,9,0.125,0.07894736842105263
"[1, 1, 1, 0, 1, 0, 1, 1, 1, 1, 0, 0, 1, 1, 0]",374,139,235,14,21,0.10071942446043165,0.08936170212765958
"[1, 1, 1, 0, 1, 0, 1, 1, 1, 0, 1, 1, 1, 1, 0]",548,157,391,16,41,0.10191082802547771,0.10485933503836317
"[1, 0, 1, 1, 1, 0, 1, 0, 1, 1, 1, 0, 1, 1, 1]",534,165,369,14,30,0.08484848484848485,0.08130081300813008
"[0, 1, 1, 1, 0, 1, 1, 1, 0, 1, 0, 1, 1, 1, 0]",206,73,133,13,16,0.1780821917808219,0.12030075187969924
"[1, 0, 1, 1, 0, 0, 1, 1, 0, 0, 1, 0, 1, 0, 1]",107,49,58,0,3,0.0,0.05172413793103448
"[0, 1, 0, 1, 0, 1, 1, 1, 1, 0, 0, 0, 1, 1, 1]",200,89,111,11,12,0.12359550561797752,0.10810810810810811
"[1, 1, 0, 1, 0, 0, 0, 0, 1, 1, 1, 1, 0, 0, 0]",282,136,146,16,15,0.11764705882352941,0.10273972602739725
"[1, 1, 0, 1, 0, 1, 0, 1, 0, 0, 0, 1, 0, 1, 1]",126,58,68,4,7,0.06896551724137931,0.10294117647058823
"[1, 0, 0, 0, 0, 1, 1, 0, 1, 0, 0, 1, 1, 1, 0]",112,55,57,0,5,0.0,0.08771929824561403
"[0, 0, 1, 1, 0, 0, 0, 1, 1, 0, 0, 0, 0, 1, 1]",468,303,165,35,16,0.11551155115511551,0.09696969696969697
"[1, 1, 0, 0, 1, 1, 1, 0, 1, 0, 0, 1, 1, 1, 1]",417,158,259,15,26,0.0949367088607595,0.10038610038610038
"[1, 1, 1, 1, 0, 0, 1, 1, 1, 0, 1, 0, 0, 1, 1]",370,124,246,12,23,0.0967741935483871,0.09349593495934959
"[0, 0, 0, 1, 0, 1, 1, 0, 1, 0, 1, 1, 0, 1, 1]",117,54,63,6,5,0.1111111111111111,0.07936507936507936
"[1, 1, 1, 1, 1, 1, 1, 0, 1, 0, 0, 0, 0, 1, 0]",185,76,109,4,16,0.05263157894736842,0.14678899082568808
"[1, 1, 0, 0, 0, 0, 0, 0, 0, 1, 0, 0, 1, 0, 0]",640,429,211,30,20,0.06993006993006994,0.0947867298578199
"[0, 1, 1, 0, 0, 0, 1, 1, 1, 0, 0, 0, 0, 1, 1]",229,139,90,11,10,0.07913669064748201,0.1111111111111111
"[0, 0, 1, 0, 1, 0, 0, 1, 0, 1, 0, 0, 1, 1, 1]",150,86,64,8,4,0.09302325581395349,0.0625
"[1, 1, 1, 0, 1, 1, 1, 0, 0, 0, 0, 0, 0, 0, 0]",383,197,186,15,19,0.07614213197969544,0.10215053763440861
"[1, 0, 0, 1, 1, 1, 1, 0, 1, 1, 0, 1, 1, 0, 1]",251,88,163,10,16,0.11363636363636363,0.09815950920245399
"[1, 0, 0, 1, 0, 0, 1, 1, 1, 1, 0, 1, 1, 0, 1]",151,61,90,4,5,0.06557377049180328,0.05555555555555555
"[0, 1, 1, 1, 0, 1, 1, 1, 1, 0, 1, 0, 0, 0, 1]",149,61,88,5,7,0.08196721311475409,0.07954545454545454
"[0, 0, 0, 1, 1, 1, 0, 0, 1, 0, 0, 1, 0, 0, 0]",277,183,94,24,4,0.13114754098360656,0.0425531914893617
"[1, 0, 1, 1, 0, 0, 1, 0, 1, 0, 0, 1, 1, 0, 0]",141,74,67,8,5,0.10810810810810811,0.07462686567164178
"[0, 1, 0, 1, 0, 1, 1, 0, 0, 1, 0, 1, 0, 0, 1]",104,54,50,10,6,0.18518518518518517,0.12
"[0, 1, 1, 1, 0, 1, 0, 1, 0, 1, 0, 1, 0, 1, 1]",138,63,75,5,13,0.07936507936507936,0.17333333333333334
"[1, 1, 1, 0, 0, 0, 1, 0, 0, 0, 1, 1, 1, 0, 0]",127,63,64,2,9,0.031746031746031744,0.140625
"[0, 1, 1, 1, 1, 0, 0, 0, 1, 1, 1, 0, 0, 0, 0]",213,133,80,13,5,0.09774436090225563,0.0625
"[0, 1, 0, 0, 1, 0, 0, 0, 0, 0, 1, 0, 0, 1, 0]",462,322,140,31,12,0.09627329192546584,0.08571428571428572
"[0, 0, 0, 0, 1, 1, 1, 1, 1, 1, 0, 1, 0, 0, 1]",261,132,129,10,14,0.07575757575757576,0.10852713178294573
"[0, 1, 1, 0, 1, 0, 0, 1, 1, 0, 0, 1, 1, 1, 0]",112,55,57,7,5,0.12727272727272726,0.08771929824561403
"[0, 1, 0, 1, 1, 0, 1, 0, 0, 1, 1, 0, 0, 0, 1]",130,75,55,10,10,0.13333333333333333,0.18181818181818182
"[1, 0, 0, 0, 0, 0, 0, 0, 0, 1, 0, 0, 1, 0, 0]",1817,1292,525,140,56,0.10835913312693499,0.10666666666666667
"[0, 1, 0, 1, 1, 1, 0, 0, 0, 0, 1, 1, 0, 0, 0]",332,191,141,17,16,0.08900523560209424,0.11347517730496454
"[1, 1, 1, 0, 0, 0, 1, 0, 1, 0, 1, 1, 1, 1, 0]",168,54,114,6,11,0.1111111111111111,0.09649122807017543
"[0, 0, 1, 1, 1, 1, 1, 0, 1, 1, 1, 1, 0, 0, 0]",235,86,149,5,11,0.05813953488372093,0.0738255033557047
"[1, 1, 0, 0, 0, 1, 1, 0, 1, 1, 0, 1, 0, 0, 1]",119,57,62,6,5,0.10526315789473684,0.08064516129032258
"[1, 0, 1, 1, 1, 1, 0, 0, 1, 1, 0, 0, 1, 0, 0]",150,71,79,9,6,0.1267605633802817,0.0759493670886076
"[1, 1, 1, 1, 0, 1, 0, 1, 0, 0, 1, 0, 1, 0, 1]",125,48,77,5,6,0.10416666666666667,0.07792207792207792
"[0, 1, 1, 1, 0, 1, 0, 1, 1, 1, 1, 1, 1, 1, 0]",577,159,418,16,40,0.10062893081761007,0.09569377990430622
"[1, 1, 1, 1, 1, 1, 0, 0, 1, 0, 1, 1, 0, 1, 1]",694,202,492,21,60,0.10396039603960396,0.12195121951219512
"[1, 1, 0, 0, 1, 0, 0, 0, 1, 1, 1, 1, 1, 1, 1]",454,169,285,13,27,0.07692307692307693,0.09473684210526316
"[1, 0, 0, 1, 0, 0, 0, 0, 0, 0, 0, 1, 0, 1, 0]",511,352,159,30,17,0.08522727272727272,0.1069182389937107
"[0, 0, 0, 1, 0, 1, 1, 1, 0, 0, 0, 0, 0, 0, 1]",389,256,133,17,18,0.06640625,0.13533834586466165
"[0, 1, 0, 0, 0, 0, 0, 0, 0, 1, 0, 1, 1, 1, 0]",263,181,82,19,8,0.10497237569060773,0.0975609756097561
"[1, 1, 0, 1, 1, 1, 1, 1, 1, 0, 0, 0, 1, 1, 1]",762,222,540,18,56,0.08108108108108109,0.1037037037037037
"[1, 0, 1, 0, 0, 1, 0, 1, 1, 1, 1, 1, 1, 0, 1]",248,81,167,12,20,0.14814814814814814,0.11976047904191617
"[1, 0, 1, 0, 0, 1, 0, 0, 0, 0, 0, 1, 0, 0, 1]",246,177,69,19,7,0.10734463276836158,0.10144927536231885
"[1, 0, 1, 0, 0, 1, 0, 0, 1, 0, 1, 1, 0, 1, 0]",102,66,36,4,1,0.06060606060606061,0.027777777777777776
"[0, 0, 1, 0, 1, 0, 1, 0, 0, 1, 0, 1, 1, 1, 1]",147,70,77,6,7,0.08571428571428572,0.09090909090909091
"[1, 0, 0, 0, 0, 0, 0, 1, 1, 0, 0, 1, 1, 0, 0]",2275,764,1511,77,133,0.10078534031413612,0.08802117802779616
"[1, 0, 0, 1, 1, 1, 0, 0, 0, 1, 1, 1, 0, 0, 1]",118,58,60,5,10,0.08620689655172414,0.16666666666666666
"[0, 1, 1, 0, 0, 1, 0, 0, 1, 0, 1, 0, 1, 0, 0]",133,83,50,7,5,0.08433734939759036,0.1
"[0, 1, 0, 0, 0, 0, 1, 1, 0, 0, 1, 0, 0, 1, 0]",242,150,92,11,10,0.07333333333333333,0.10869565217391304
"[0, 0, 0, 1, 0, 1, 0, 1, 0, 0, 0, 0, 1, 1, 0]",331,226,105,25,11,0.11061946902654868,0.10476190476190476
"[0, 0, 1, 1, 0, 1, 1, 1, 0, 0, 1, 1, 0, 0, 1]",186,86,100,14,7,0.16279069767441862,0.07
"[0, 0, 0, 1, 0, 1, 1, 1, 1, 1, 0, 0, 1, 0, 1]",120,62,58,6,3,0.0967741935483871,0.05172413793103448
"[1, 1, 1, 0, 0, 0, 1, 1, 0, 1, 0, 1, 0, 0, 0]",120,56,64,8,4,0.14285714285714285,0.0625
"[1, 0, 0, 1, 0, 1, 1, 1, 0, 0, 0, 1, 1, 0, 1]",105,41,64,3,8,0.07317073170731707,0.125
"[1, 0, 0, 1, 1, 1, 0, 0, 0, 1, 0, 0, 0, 1, 1]",135,67,68,11,2,0.16417910447761194,0.029411764705882353
"[0, 1, 1, 0, 0, 1, 1, 1, 0, 0, 0, 1, 0, 0, 0]",180,109,71,10,6,0.09174311926605505,0.08450704225352113
"[0, 1, 1, 1, 1, 1, 1, 0, 1, 1, 0, 0, 1, 0, 0]",148,72,76,10,8,0.1388888888888889,0.10526315789473684
"[0, 1, 0, 1, 0, 0, 1, 1, 0, 0, 0, 0, 0, 1, 1]",242,142,100,14,15,0.09859154929577464,0.15
"[0, 1, 1, 1, 1, 0, 1, 0, 0, 1, 1, 0, 1, 1, 1]",276,116,160,7,15,0.0603448275862069,0.09375
"[1, 0, 1, 1, 0, 1, 0, 1, 0, 1, 1, 1, 1, 0, 1]",208,72,136,8,12,0.1111111111111111,0.08823529411764706
"[0, 0, 0, 1, 0, 1, 1, 0, 1, 0, 1, 0, 1, 1, 1]",114,60,54,7,5,0.11666666666666667,0.09259259259259259
"[0, 0, 1, 1, 1, 0, 1, 1, 0, 1, 0, 1, 1, 1, 1]",366,141,225,18,28,0.1276595744680851,0.12444444444444444
"[0, 1, 0, 0, 1, 1, 1, 0, 1, 1, 1, 1, 1, 1, 0]",264,86,178,11,20,0.12790697674418605,0.11235955056179775
"[1, 0, 1, 1, 0, 1, 1, 0, 1, 1, 1, 1, 1, 1, 0]",569,164,405,14,39,0.08536585365853659,0.0962962962962963
"[0, 0, 0, 1, 0, 1, 0, 1, 0, 0, 1, 0, 1, 0, 0]",211,139,72,16,10,0.11510791366906475,0.1388888888888889
"[0, 1, 1, 0, 1, 0, 0, 0, 1, 0, 1, 0, 1, 0, 0]",146,89,57,10,7,0.11235955056179775,0.12280701754385964
"[1, 1, 0, 1, 1, 0, 0, 1, 1, 0, 1, 0, 0, 0, 1]",114,43,71,4,5,0.09302325581395349,0.07042253521126761
"[0, 0, 1, 0, 0, 1, 1, 0, 1, 1, 0, 0, 1, 1, 0]",137,74,63,6,7,0.08108108108108109,0.1111111111111111
"[1, 0, 1, 0, 1, 0, 0, 1, 1, 1, 1, 0, 1, 1, 1]",293,98,195,3,22,0.030612244897959183,0.11282051282051282
"[0, 0, 1, 0, 1, 1, 0, 1, 0, 1, 0, 0, 1, 1, 1]",127,60,67,3,7,0.05,0.1044776119402985
"[1, 1, 1, 1, 0, 0, 0, 1, 0, 1, 1, 0, 1, 0, 1]",149,62,87,5,7,0.08064516129032258,0.08045977011494253
"[1, 1, 0, 1, 0, 1, 1, 0, 0, 1, 1, 1, 1, 0, 1]",266,85,181,4,16,0.047058823529411764,0.08839779005524862
"[0, 1, 1, 1, 1, 0, 1, 0, 1, 1, 0, 0, 1, 1, 1]",365,152,213,13,23,0.08552631578947369,0.107981220657277
"[1, 0, 0, 1, 0, 0, 0, 0, 1, 0, 1, 0, 1, 0, 1]",141,79,62,7,4,0.08860759493670886,0.06451612903225806
"[1, 0, 1, 1, 1, 1, 0, 0, 1, 0, 1, 1, 0, 0, 0]",140,69,71,3,7,0.043478260869565216,0.09859154929577464
"[0, 1, 1, 0, 1, 0, 0, 1, 0, 1, 1, 0, 1, 1, 0]",102,50,52,3,5,0.06,0.09615384615384616
"[1, 0, 1, 1, 1, 1, 1, 1, 0, 1, 1, 0, 1, 1, 1]",1604,356,1248,29,120,0.08146067415730338,0.09615384615384616
"[0, 1, 1, 0, 0, 0, 0, 0, 1, 1, 0, 0, 0, 1, 0]",306,211,95,12,7,0.05687203791469194,0.07368421052631578
"[1, 0, 1, 1, 0, 1, 0, 0, 1, 0, 0, 0, 0, 0, 0]",269,168,101,15,9,0.08928571428571429,0.0891089108910891
"[1, 1, 1, 1, 0, 1, 1, 0, 1, 0, 0, 1, 0, 0, 0]",123,62,61,5,5,0.08064516129032258,0.08196721311475409
"[0, 1, 0, 1, 0, 0, 1, 0, 1, 0, 1, 0, 0, 0, 0]",275,161,114,14,11,0.08695652173913043,0.09649122807017543
"[1, 1, 0, 0, 1, 1, 1, 1, 1, 1, 1, 0, 0, 1, 0]",385,144,241,11,19,0.0763888888888889,0.07883817427385892
"[1, 1, 1, 0, 1, 1, 1, 0, 1, 1, 0, 1, 1, 0, 0]",245,91,154,4,10,0.04395604395604396,0.06493506493506493
"[1, 1, 1, 1, 1, 1, 1, 0, 0, 0, 0, 1, 1, 0, 1]",757,140,617,10,74,0.07142857142857142,0.11993517017828201
"[1, 1, 1, 1, 0, 1, 1, 0, 1, 0, 1, 1, 0, 1, 1]",533,159,374,10,31,0.06289308176100629,0.08288770053475936
"[0, 0, 1, 0, 0, 1, 0, 0, 0, 0, 1, 1, 1, 1, 1]",288,158,130,21,11,0.13291139240506328,0.08461538461538462
"[1, 0, 0, 0, 1, 0, 0, 1, 0, 0, 0, 0, 1, 1, 1]",246,136,110,17,8,0.125,0.07272727272727272
"[0, 0, 1, 0, 0, 0, 1, 0, 1, 0, 0, 0, 0, 1, 0]",523,361,162,35,17,0.09695290858725762,0.10493827160493827
"[0, 1, 1, 0, 1, 1, 1, 0, 0, 1, 0, 0, 1, 1, 1]",192,79,113,6,9,0.0759493670886076,0.07964601769911504
"[0, 1, 0, 1, 1, 0, 1, 1, 1, 1, 1, 1, 0, 1, 0]",227,90,137,7,16,0.07777777777777778,0.11678832116788321
"[1, 0, 1, 1, 0, 1, 1, 1, 1, 1, 1, 1, 0, 1, 1]",1610,411,1199,33,126,0.08029197080291971,0.10508757297748124
"[0, 1, 1, 1, 0, 1, 1, 1, 1, 0, 1, 0, 1, 1, 0]",225,88,137,10,14,0.11363636363636363,0.10218978102189781
"[0, 0, 0, 1, 1, 0, 0, 0, 1, 0, 0, 0, 1, 1, 0]",320,222,98,19,12,0.08558558558558559,0.12244897959183673
"[0, 1, 1, 1, 0, 0, 1, 1, 1, 1, 0, 1, 0, 1, 1]",273,109,164,11,24,0.10091743119266056,0.14634146341463414
"[1, 0, 0, 0, 0, 1, 1, 1, 0, 0, 0, 0, 0, 1, 1]",282,131,151,17,9,0.1297709923664122,0.059602649006622516
"[0, 1, 0, 1, 1, 1, 1, 0, 0, 1, 1, 0, 1, 1, 0]",176,72,104,6,7,0.08333333333333333,0.0673076923076923
"[1, 0, 0, 0, 0, 1, 0, 1, 1, 0, 1, 1, 1, 1, 1]",207,71,136,3,13,0.04225352112676056,0.09558823529411764
"[1, 1, 1, 0, 0, 0, 0, 1, 0, 1, 1, 0, 1, 1, 1]",235,76,159,9,14,0.11842105263157894,0.0880503144654088
"[0, 0, 0, 1, 0, 1, 0, 1, 1, 1, 0, 0, 0, 0, 1]",195,106,89,7,7,0.0660377358490566,0.07865168539325842
"[0, 1, 1, 1, 1, 0, 1, 1, 0, 0, 0, 1, 0, 1, 1]",167,67,100,10,5,0.14925373134328357,0.05
"[1, 0, 0, 0, 0, 0, 0, 0, 0, 0, 1, 1, 0, 1, 1]",449,224,225,14,26,0.0625,0.11555555555555555
"[1, 0, 0, 1, 0, 0, 0, 0, 1, 1, 0, 1, 0, 1, 0]",144,94,50,7,4,0.07446808510638298,0.08
"[0, 0, 1, 0, 0, 1, 0, 0, 1, 1, 0, 0, 1, 0, 1]",176,106,70,9,5,0.08490566037735849,0.07142857142857142
"[0, 0, 1, 1, 0, 0, 0, 1, 0, 1, 1, 0, 1, 0, 1]",112,63,49,9,7,0.14285714285714285,0.14285714285714285
"[1, 0, 0, 1, 0, 1, 0, 0, 1, 1, 0, 1, 0, 1, 1]",123,55,68,2,5,0.03636363636363636,0.07352941176470588
"[1, 1, 0, 0, 1, 0, 1, 1, 1, 0, 0, 0, 0, 1, 1]",221,100,121,7,12,0.07,0.09917355371900827
"[0, 1, 1, 1, 1, 0, 1, 1, 1, 0, 1, 0, 1, 1, 1]",558,162,396,16,45,0.09876543209876543,0.11363636363636363
"[0, 0, 1, 0, 0, 1, 1, 0, 1, 1, 1, 1, 0, 1, 1]",171,68,103,7,3,0.10294117647058823,0.02912621359223301
"[0, 1, 1, 1, 1, 1, 0, 1, 1, 0, 1, 0, 0, 0, 1]",137,61,76,2,9,0.03278688524590164,0.11842105263157894
"[0, 0, 1, 1, 0, 1, 1, 1, 0, 0, 1, 0, 0, 0, 1]",118,61,57,5,5,0.08196721311475409,0.08771929824561403
"[0, 0, 0, 0, 1, 1, 1, 0, 1, 0, 1, 1, 0, 0, 0]",220,119,101,13,12,0.1092436974789916,0.1188118811881188
"[0, 0, 0, 1, 0, 1, 0, 0, 0, 0, 0, 1, 1, 0, 1]",247,152,95,12,8,0.07894736842105263,0.08421052631578947
"[1, 0, 1, 1, 1, 0, 1, 1, 1, 1, 1, 0, 0, 0, 0]",294,113,181,8,18,0.07079646017699115,0.09944751381215469
"[0, 0, 1, 0, 1, 0, 1, 1, 1, 1, 0, 0, 1, 1, 1]",264,103,161,16,17,0.1553398058252427,0.10559006211180125
"[1, 0, 1, 0, 0, 0, 1, 0, 1, 0, 1, 1, 1, 1, 0]",116,59,57,7,3,0.11864406779661017,0.05263157894736842
"[0, 1, 0, 1, 0, 0, 1, 0, 0, 1, 0, 0, 1, 1, 1]",143,79,64,7,6,0.08860759493670886,0.09375
"[0, 0, 1, 0, 1, 1, 1, 0, 1, 0, 0, 0, 0, 1, 1]",165,94,71,10,6,0.10638297872340426,0.08450704225352113
"[1, 1, 0, 0, 0, 1, 0, 1, 1, 1, 0, 1, 0, 0, 0]",143,75,68,8,4,0.10666666666666667,0.058823529411764705
"[0, 1, 1, 0, 0, 0, 1, 1, 0, 0, 1, 1, 1, 1, 0]",287,157,130,12,10,0.07643312101910828,0.07692307692307693
"[0, 0, 1, 1, 1, 1, 1, 0, 1, 1, 0, 1, 0, 0, 1]",163,74,89,11,10,0.14864864864864866,0.11235955056179775
"[0, 0, 0, 1, 0, 0, 1, 1, 1, 1, 1, 0, 1, 1, 0]",131,61,70,7,8,0.11475409836065574,0.11428571428571428
"[0, 0, 1, 0, 0, 1, 1, 1, 0, 1, 1, 1, 1, 1, 1]",292,104,188,15,21,0.14423076923076922,0.11170212765957446
"[1, 0, 1, 1, 0, 0, 1, 0, 0, 1, 1, 1, 0, 1, 1]",161,58,103,4,6,0.06896551724137931,0.05825242718446602
"[1, 0, 0, 1, 1, 1, 0, 1, 1, 0, 0, 0, 0, 0, 0]",244,124,120,13,11,0.10483870967741936,0.09166666666666666
"[1, 0, 0, 1, 0, 0, 0, 1, 0, 1, 0, 1, 0, 0, 1]",135,75,60,6,10,0.08,0.16666666666666666
"[0, 0, 0, 1, 1, 0, 1, 0, 1, 1, 0, 1, 1, 0, 1]",112,53,59,7,5,0.1320754716981132,0.0847457627118644
"[1, 0, 1, 0, 1, 0, 1, 1, 0, 0, 1, 1, 0, 0, 1]",189,76,113,11,12,0.14473684210526316,0.10619469026548672
"[0, 0, 0, 1, 0, 0, 1, 0, 0, 1, 0, 1, 0, 0, 0]",539,405,134,29,8,0.07160493827160494,0.05970149253731343
"[1, 0, 0, 0, 1, 1, 0, 1, 1, 0, 0, 0, 1, 1, 0]",124,63,61,7,7,0.1111111111111111,0.11475409836065574
"[0, 0, 1, 0, 0, 0, 1, 1, 0, 1, 1, 0, 0, 0, 1]",155,99,56,11,8,0.1111111111111111,0.14285714285714285
"[1, 1, 1, 0, 0, 1, 0, 0, 0, 1, 1, 0, 1, 1, 0]",113,54,59,4,6,0.07407407407407407,0.1016949152542373
"[1, 1, 0, 0, 0, 0, 0, 0, 0, 0, 1, 0, 1, 1, 0]",385,254,131,27,14,0.1062992125984252,0.10687022900763359
"[0, 0, 0, 1, 0, 0, 0, 1, 0, 0, 1, 0, 0, 1, 1]",301,213,88,20,7,0.09389671361502347,0.07954545454545454
"[1, 0, 1, 1, 1, 1, 0, 1, 1, 1, 0, 0, 1, 0, 0]",155,47,108,4,10,0.0851063829787234,0.09259259259259259
"[0, 1, 1, 1, 1, 1, 1, 1, 0, 1, 0, 1, 1, 0, 1]",534,194,340,22,23,0.1134020618556701,0.06764705882352941
"[1, 0, 1, 0, 1, 0, 1, 1, 1, 1, 0, 1, 1, 1, 0]",223,89,134,9,15,0.10112359550561797,0.11194029850746269
"[0, 0, 1, 0, 1, 1, 1, 0, 0, 0, 0, 0, 1, 1, 0]",195,114,81,8,6,0.07017543859649122,0.07407407407407407
"[1, 1, 0, 0, 0, 0, 0, 0, 0, 1, 0, 1, 1, 0, 0]",310,195,115,14,8,0.07179487179487179,0.06956521739130435
"[0, 0, 1, 1, 1, 0, 0, 0, 0, 0, 0, 0, 1, 0, 1]",285,191,94,21,12,0.1099476439790576,0.1276595744680851
"[1, 1, 0, 0, 1, 1, 1, 0, 0, 0, 0, 0, 0, 0, 1]",222,147,75,13,7,0.08843537414965986,0.09333333333333334
"[1, 1, 0, 1, 1, 0, 1, 1, 0, 0, 1, 1, 1, 0, 0]",149,46,103,3,5,0.06521739130434782,0.04854368932038835
"[0, 1, 0, 0, 0, 0, 0, 0, 0, 0, 0, 1, 0, 1, 0]",1581,1194,387,111,33,0.09296482412060302,0.08527131782945736
"[0, 0, 1, 0, 0, 1, 0, 0, 0, 0, 0, 1, 0, 0, 0]",1574,1189,385,138,42,0.11606391925988226,0.10909090909090909
"[1, 0, 1, 0, 0, 0, 1, 0, 0, 0, 0, 0, 0, 1, 1]",405,252,153,18,19,0.07142857142857142,0.12418300653594772
"[1, 1, 0, 0, 0, 1, 0, 1, 0, 0, 1, 1, 0, 0, 0]",204,124,80,10,5,0.08064516129032258,0.0625
"[1, 0, 0, 0, 1, 0, 1, 1, 0, 0, 0, 1, 0, 1, 0]",132,72,60,7,9,0.09722222222222222,0.15
"[1, 1, 1, 1, 0, 1, 0, 0, 1, 1, 0, 1, 0, 1, 0]",130,54,76,5,9,0.09259259259259259,0.11842105263157894
"[0, 0, 1, 1, 1, 1, 1, 1, 0, 1, 0, 0, 1, 1, 0]",199,81,118,5,14,0.06172839506172839,0.11864406779661017
"[1, 1, 1, 0, 0, 0, 1, 1, 0, 0, 0, 0, 1, 0, 0]",188,100,88,9,8,0.09,0.09090909090909091
"[1, 0, 1, 0, 0, 0, 0, 1, 1, 1, 0, 0, 0, 1, 1]",142,87,55,7,3,0.08045977011494253,0.05454545454545454
"[0, 1, 1, 1, 0, 0, 1, 0, 1, 0, 0, 0, 0, 1, 1]",152,79,73,10,4,0.12658227848101267,0.0547945205479452
"[0, 1, 1, 0, 1, 1, 1, 1, 1, 1, 0, 1, 1, 0, 0]",280,91,189,10,26,0.10989010989010989,0.13756613756613756
"[0, 1, 0, 1, 0, 1, 0, 1, 1, 0, 0, 0, 1, 1, 0]",110,65,45,6,2,0.09230769230769231,0.044444444444444446
"[1, 1, 0, 1, 0, 1, 0, 1, 0, 1, 1, 0, 0, 0, 1]",111,47,64,4,5,0.0851063829787234,0.078125
"[1, 1, 0, 0, 0, 0, 1, 0, 1, 1, 0, 0, 1, 1, 0]",160,69,91,12,9,0.17391304347826086,0.0989010989010989
"[1, 1, 0, 1, 1, 1, 1, 0, 1, 1, 0, 0, 0, 0, 0]",173,77,96,2,6,0.025974025974025976,0.0625
"[1, 1, 0, 1, 0, 0, 1, 1, 1, 1, 0, 1, 0, 1, 0]",121,46,75,3,7,0.06521739130434782,0.09333333333333334
"[0, 0, 1, 1, 0, 1, 1, 1, 0, 0, 1, 1, 1, 1, 1]",412,156,256,12,18,0.07692307692307693,0.0703125
"[1, 0, 0, 0, 1, 1, 0, 1, 1, 1, 1, 1, 1, 1, 1]",849,264,585,27,65,0.10227272727272728,0.1111111111111111
"[1, 1, 1, 0, 0, 0, 1, 1, 0, 1, 1, 1, 1, 1, 1]",812,221,591,25,66,0.11312217194570136,0.1116751269035533
"[1, 1, 1, 1, 1, 0, 1, 1, 1, 0, 1, 0, 1, 0, 0]",242,89,153,10,16,0.11235955056179775,0.10457516339869281
"[0, 0, 1, 0, 1, 1, 1, 0, 1, 1, 0, 1, 0, 0, 1]",118,53,65,5,7,0.09433962264150944,0.1076923076923077
"[0, 1, 1, 1, 1, 1, 0, 0, 1, 0, 1, 1, 1, 0, 1]",242,103,139,4,11,0.038834951456310676,0.07913669064748201
"[0, 1, 0, 1, 0, 0, 0, 0, 1, 1, 0, 1, 1, 1, 1]",151,71,80,7,6,0.09859154929577464,0.075
"[1, 0, 1, 1, 1, 0, 1, 0, 1, 0, 0, 0, 0, 1, 1]",163,80,83,4,11,0.05,0.13253012048192772
"[1, 1, 0, 0, 1, 0, 1, 1, 0, 1, 0, 1, 0, 1, 1]",151,69,82,5,6,0.07246376811594203,0.07317073170731707
"[0, 1, 0, 0, 0, 1, 1, 1, 0, 0, 0, 0, 1, 1, 0]",256,150,106,13,12,0.08666666666666667,0.11320754716981132
"[1, 0, 0, 0, 1, 0, 1, 0, 0, 1, 0, 0, 1, 0, 0]",223,139,84,17,11,0.1223021582733813,0.13095238095238096
"[1, 0, 0, 0, 0, 1, 0, 0, 0, 1, 1, 0, 0, 1, 1]",298,173,125,20,9,0.11560693641618497,0.072
"[0, 1, 0, 0, 1, 0, 0, 0, 0, 1, 0, 0, 0, 1, 1]",279,187,92,20,9,0.10695187165775401,0.09782608695652174
"[1, 1, 1, 1, 0, 1, 1, 0, 1, 1, 1, 0, 0, 1, 1]",716,218,498,21,44,0.0963302752293578,0.08835341365461848
"[0, 1, 0, 1, 1, 1, 1, 0, 1, 1, 0, 1, 1, 1, 0]",247,88,159,16,12,0.18181818181818182,0.07547169811320754
"[1, 0, 0, 0, 1, 0, 1, 1, 1, 1, 0, 1, 1, 0, 1]",152,50,102,5,7,0.1,0.06862745098039216
"[0, 1, 0, 0, 1, 1, 0, 0, 0, 1, 0, 0, 0, 0, 0]",635,449,186,55,16,0.12249443207126949,0.08602150537634409
"[1, 0, 1, 0, 1, 0, 1, 0, 0, 0, 0, 0, 1, 1, 0]",173,91,82,9,14,0.0989010989010989,0.17073170731707318
"[0, 1, 0, 1, 0, 1, 0, 1, 0, 0, 0, 0, 0, 1, 1]",177,108,69,11,8,0.10185185185185185,0.11594202898550725
"[0, 1, 1, 0, 1, 0, 1, 1, 0, 1, 0, 0, 0, 0, 1]",119,58,61,5,4,0.08620689655172414,0.06557377049180328
"[0, 1, 0, 0, 1, 1, 0, 0, 1, 0, 0, 0, 0, 1, 1]",211,118,93,9,9,0.07627118644067797,0.0967741935483871
"[0, 1, 1, 0, 0, 0, 1, 1, 0, 1, 0, 0, 1, 1, 1]",163,85,78,10,11,0.11764705882352941,0.14102564102564102
"[1, 1, 0, 0, 1, 0, 1, 1, 0, 0, 0, 1, 1, 0, 1]",110,52,58,5,3,0.09615384615384616,0.05172413793103448
"[0, 0, 0, 0, 0, 1, 1, 1, 0, 0, 1, 0, 1, 1, 0]",160,100,60,14,6,0.14,0.1
"[1, 0, 0, 1, 1, 1, 0, 1, 1, 1, 0, 1, 0, 1, 1]",217,66,151,9,20,0.13636363636363635,0.13245033112582782
"[1, 0, 1, 1, 1, 1, 1, 0, 1, 0, 0, 1, 1, 1, 0]",219,89,130,11,15,0.12359550561797752,0.11538461538461539
"[0, 1, 1, 1, 0, 1, 1, 1, 1, 1, 0, 1, 0, 0, 1]",234,88,146,8,16,0.09090909090909091,0.1095890410958904
"[0, 1, 1, 1, 1, 0, 1, 0, 0, 1, 0, 0, 1, 1, 1]",196,93,103,3,12,0.03225806451612903,0.11650485436893204
"[0, 1, 1, 1, 0, 0, 0, 1, 1, 1, 1, 0, 1, 0, 0]",131,57,74,2,6,0.03508771929824561,0.08108108108108109
"[1, 1, 1, 1, 1, 1, 1, 1, 0, 0, 0, 1, 0, 1, 1]",970,285,685,24,76,0.08421052631578947,0.11094890510948906
"[1, 1, 1, 1, 0, 1, 1, 0, 0, 1, 0, 0, 1, 0, 0]",123,66,57,4,6,0.06060606060606061,0.10526315789473684
"[0, 1, 0, 0, 1, 1, 1, 0, 1, 0, 1, 0, 0, 1, 0]",106,50,56,3,2,0.06,0.03571428571428571
"[0, 0, 0, 1, 1, 1, 0, 0, 1, 0, 0, 0, 1, 1, 1]",178,103,75,8,12,0.07766990291262135,0.16
"[1, 0, 1, 1, 0, 0, 0, 1, 0, 0, 0, 0, 0, 0, 0]",708,491,217,48,19,0.09775967413441955,0.08755760368663594
"[0, 1, 1, 0, 1, 1, 1, 1, 1, 1, 0, 0, 0, 0, 0]",325,159,166,17,20,0.1069182389937107,0.12048192771084337
"[1, 1, 0, 0, 0, 1, 1, 0, 0, 0, 0, 0, 1, 0, 1]",153,93,60,8,4,0.08602150537634409,0.06666666666666667
"[1, 1, 0, 0, 0, 0, 1, 1, 0, 1, 1, 0, 0, 0, 1]",194,103,91,4,11,0.038834951456310676,0.12087912087912088
"[1, 0, 1, 1, 0, 0, 0, 0, 1, 1, 0, 1, 1, 0, 0]",156,93,63,7,7,0.07526881720430108,0.1111111111111111
"[1, 0, 1, 0, 1, 1, 0, 0, 0, 0, 1, 1, 0, 1, 1]",141,71,70,8,9,0.11267605633802817,0.12857142857142856
"[0, 1, 0, 1, 1, 0, 1, 1, 0, 0, 1, 0, 1, 0, 0]",113,61,52,7,8,0.11475409836065574,0.15384615384615385
"[1, 1, 1, 1, 0, 1, 0, 1, 1, 1, 1, 0, 1, 1, 0]",518,157,361,16,37,0.10191082802547771,0.10249307479224377
"[1, 1, 0, 0, 1, 0, 0, 1, 1, 0, 0, 1, 1, 1, 1]",400,156,244,11,20,0.07051282051282051,0.08196721311475409
"[1, 1, 1, 1, 0, 0, 1, 0, 0, 1, 1, 0, 0, 1, 1]",331,129,202,11,17,0.08527131782945736,0.08415841584158416
"[0, 1, 1, 1, 1, 1, 1, 0, 0, 1, 0, 0, 1, 1, 0]",201,102,99,11,7,0.10784313725490197,0.0707070707070707
"[0, 0, 1, 0, 0, 1, 1, 1, 0, 0, 1, 1, 1, 1, 1]",302,134,168,19,18,0.1417910447761194,0.10714285714285714
"[1, 1, 1, 1, 0, 0, 1, 0, 0, 1, 1, 1, 0, 0, 1]",173,75,98,9,8,0.12,0.08163265306122448
"[1, 0, 1, 0, 1, 1, 0, 1, 0, 0, 1, 0, 1, 1, 1]",151,59,92,3,8,0.05084745762711865,0.08695652173913043
"[1, 1, 0, 0, 1, 0, 1, 1, 1, 1, 1, 1, 1, 1, 0]",678,197,481,19,39,0.09644670050761421,0.08108108108108109
"[0, 0, 0, 0, 1, 0, 0, 0, 0, 0, 1, 0, 1, 1, 0]",580,411,169,41,9,0.09975669099756691,0.05325443786982249
"[1, 0, 0, 1, 1, 0, 1, 1, 0, 1, 1, 1, 1, 1, 0]",281,93,188,8,22,0.08602150537634409,0.11702127659574468
"[0, 1, 1, 1, 1, 0, 0, 1, 1, 0, 1, 1, 0, 1, 1]",386,203,183,18,21,0.08866995073891626,0.11475409836065574
"[1, 0, 0, 1, 1, 1, 1, 1, 0, 1, 0, 0, 0, 0, 1]",176,74,102,4,9,0.05405405405405406,0.08823529411764706
"[0, 0, 1, 1, 1, 0, 0, 1, 1, 1, 1, 1, 0, 1, 0]",168,74,94,6,11,0.08108108108108109,0.11702127659574468
"[1, 0, 0, 1, 0, 0, 0, 1, 1, 1, 0, 0, 1, 1, 1]",178,87,91,7,7,0.08045977011494253,0.07692307692307693
"[1, 1, 0, 0, 1, 0, 0, 0, 1, 1, 1, 0, 0, 1, 1]",157,87,70,8,11,0.09195402298850575,0.15714285714285714
"[1, 1, 0, 0, 1, 1, 1, 1, 0, 1, 0, 1, 1, 1, 1]",924,278,646,29,51,0.10431654676258993,0.07894736842105263
"[0, 0, 1, 0, 0, 1, 1, 0, 0, 1, 0, 0, 1, 1, 0]",167,103,64,7,6,0.06796116504854369,0.09375
"[0, 1, 0, 0, 0, 1, 0, 0, 0, 0, 0, 0, 1, 1, 0]",790,549,241,53,30,0.0965391621129326,0.12448132780082988
"[0, 1, 0, 1, 0, 0, 1, 0, 0, 0, 1, 1, 0, 0, 0]",299,191,108,23,10,0.12041884816753927,0.09259259259259259
"[0, 0, 0, 0, 0, 0, 0, 1, 0, 1, 0, 1, 0, 0, 1]",616,440,176,32,16,0.07272727272727272,0.09090909090909091
"[1, 0, 1, 0, 0, 0, 0, 1, 0, 1, 1, 1, 0, 1, 0]",118,68,50,8,1,0.11764705882352941,0.02
"[1, 0, 0, 0, 1, 0, 1, 1, 0, 1, 1, 0, 1, 0, 0]",121,62,59,4,6,0.06451612903225806,0.1016949152542373
"[1, 0, 0, 1, 0, 0, 1, 0, 1, 1, 1, 1, 0, 1, 1]",138,55,83,5,3,0.09090909090909091,0.03614457831325301
"[1, 0, 1, 1, 1, 0, 0, 1, 1, 0, 1, 1, 0, 1, 1]",283,101,182,8,19,0.07920792079207921,0.1043956043956044
"[0, 1, 1, 1, 0, 1, 1, 1, 1, 1, 0, 1, 1, 0, 1]",473,148,325,20,29,0.13513513513513514,0.08923076923076922
"[0, 0, 1, 0, 0, 1, 1, 1, 1, 1, 1, 0, 0, 0, 0]",439,243,196,29,27,0.11934156378600823,0.1377551020408163
"[1, 0, 0, 1, 0, 0, 1, 1, 1, 1, 1, 1, 0, 0, 0]",268,125,143,13,17,0.104,0.11888111888111888
"[1, 1, 1, 1, 1, 0, 0, 1, 0, 0, 1, 1, 1, 1, 1]",974,221,753,25,87,0.11312217194570136,0.11553784860557768
"[1, 0, 1, 0, 0, 0, 1, 0, 1, 1, 1, 1, 1, 1, 1]",325,117,208,6,16,0.05128205128205128,0.07692307692307693
"[1, 1, 1, 1, 1, 0, 1, 0, 0, 0, 1, 0, 1, 1, 1]",291,96,195,15,22,0.15625,0.11282051282051282
"[0, 1, 0, 1, 1, 1, 0, 1, 0, 0, 1, 0, 0, 0, 0]",148,83,65,7,6,0.08433734939759036,0.09230769230769231
"[0, 0, 1, 0, 0, 0, 1, 1, 0, 1, 1, 0, 1, 0, 1]",103,61,42,12,10,0.19672131147540983,0.23809523809523808
"[0, 1, 1, 0, 1, 1, 1, 1, 1, 0, 0, 1, 1, 0, 1]",253,92,161,9,9,0.09782608695652174,0.055900621118012424
"[0, 0, 0, 1, 1, 1, 1, 0, 1, 0, 1, 1, 1, 0, 1]",157,81,76,5,9,0.06172839506172839,0.11842105263157894
"[1, 1, 0, 0, 0, 1, 1, 1, 1, 0, 1, 0, 1, 1, 1]",284,110,174,12,17,0.10909090909090909,0.09770114942528736
"[1, 0, 0, 0, 0, 1, 1, 1, 0, 1, 0, 1, 0, 1, 1]",154,53,101,2,8,0.03773584905660377,0.07920792079207921
"[1, 1, 0, 1, 1, 1, 0, 1, 1, 1, 1, 1, 0, 0, 0]",332,106,226,9,16,0.08490566037735849,0.07079646017699115
"[1, 0, 1, 0, 1, 0, 0, 0, 1, 0, 1, 0, 0, 0, 0]",254,160,94,12,9,0.075,0.09574468085106383
"[0, 0, 0, 0, 1, 0, 1, 0, 1, 0, 0, 0, 1, 0, 1]",239,155,84,16,6,0.1032258064516129,0.07142857142857142
"[1, 1, 1, 0, 0, 0, 1, 0, 0, 0, 0, 0, 0, 1, 0]",218,130,88,8,14,0.06153846153846154,0.1590909090909091
"[1, 1, 1, 1, 0, 0, 0, 1, 0, 0, 0, 0, 0, 0, 1]",225,139,86,18,9,0.12949640287769784,0.10465116279069768
"[0, 1, 1, 0, 1, 1, 0, 0, 1, 1, 1, 1, 0, 0, 0]",279,147,132,14,12,0.09523809523809523,0.09090909090909091
"[1, 1, 0, 1, 0, 0, 1, 1, 0, 1, 1, 0, 0, 1, 1]",172,73,99,3,9,0.0410958904109589,0.09090909090909091
"[1, 0, 0, 0, 1, 0, 0, 0, 0, 1, 1, 0, 1, 0, 0]",235,155,80,15,10,0.0967741935483871,0.125
"[0, 1, 1, 0, 1, 0, 0, 0, 1, 1, 1, 1, 1, 0, 0]",162,78,84,15,9,0.19230769230769232,0.10714285714285714
"[1, 0, 0, 1, 1, 0, 1, 0, 0, 0, 1, 1, 1, 1, 1]",215,70,145,8,14,0.11428571428571428,0.09655172413793103
"[1, 0, 0, 0, 0, 1, 0, 0, 0, 1, 1, 1, 1, 1, 0]",155,75,80,2,4,0.02666666666666667,0.05
"[0, 0, 0, 1, 1, 1, 1, 0, 0, 0, 1, 0, 1, 0, 1]",178,120,58,10,5,0.08333333333333333,0.08620689655172414
"[0, 0, 0, 0, 0, 1, 1, 1, 1, 0, 0, 0, 1, 0, 1]",345,262,83,28,5,0.10687022900763359,0.060240963855421686
"[0, 1, 0, 1, 0, 0, 0, 0, 1, 1, 1, 0, 1, 0, 0]",181,110,71,6,6,0.05454545454545454,0.08450704225352113
"[0, 0, 1, 0, 1, 0, 1, 1, 0, 0, 0, 0, 0, 0, 1]",379,252,127,21,17,0.08333333333333333,0.13385826771653545
"[0, 0, 1, 0, 0, 1, 0, 1, 0, 1, 1, 0, 0, 0, 0]",331,214,117,21,8,0.09813084112149532,0.06837606837606838
"[0, 0, 0, 0, 0, 0, 0, 1, 0, 0, 1, 0, 1, 0, 1]",591,431,160,49,18,0.1136890951276102,0.1125
"[1, 0, 0, 0, 0, 0, 0, 0, 1, 1, 0, 1, 1, 1, 1]",229,101,128,9,13,0.0891089108910891,0.1015625
"[0, 1, 0, 0, 0, 0, 1, 1, 0, 0, 1, 0, 0, 0, 1]",252,165,87,15,8,0.09090909090909091,0.09195402298850575
"[0, 1, 1, 1, 0, 0, 1, 0, 0, 0, 0, 0, 0, 0, 0]",861,619,242,73,25,0.11793214862681745,0.10330578512396695
"[0, 1, 0, 0, 1, 1, 1, 0, 0, 0, 0, 0, 0, 1, 1]",392,236,156,21,15,0.08898305084745763,0.09615384615384616
"[0, 0, 0, 1, 1, 0, 0, 1, 1, 0, 0, 1, 0, 0, 0]",464,346,118,29,7,0.0838150289017341,0.059322033898305086
"[1, 0, 1, 1, 0, 1, 1, 0, 0, 0, 1, 1, 1, 1, 1]",375,132,243,12,31,0.09090909090909091,0.12757201646090535
"[1, 1, 1, 1, 0, 0, 1, 0, 1, 1, 1, 1, 1, 0, 0]",336,108,228,9,21,0.08333333333333333,0.09210526315789473
"[0, 1, 1, 1, 0, 0, 0, 1, 0, 1, 1, 1, 1, 1, 1]",355,141,214,15,17,0.10638297872340426,0.0794392523364486
"[1, 1, 1, 1, 1, 1, 1, 0, 0, 1, 1, 1, 0, 0, 0]",452,124,328,11,29,0.08870967741935484,0.08841463414634146
"[1, 1, 0, 0, 1, 1, 1, 1, 1, 1, 1, 0, 0, 0, 1]",438,173,265,14,25,0.08092485549132948,0.09433962264150944
"[0, 1, 1, 1, 1, 0, 0, 1, 1, 1, 1, 1, 1, 1, 0]",1124,554,570,52,59,0.09386281588447654,0.10350877192982456
"[0, 1, 0, 0, 1, 1, 0, 0, 1, 0, 0, 1, 1, 1, 1]",174,77,97,10,8,0.12987012987012986,0.08247422680412371
"[1, 1, 1, 1, 0, 1, 1, 1, 1, 0, 1, 0, 0, 0, 1]",249,94,155,12,14,0.1276595744680851,0.09032258064516129
"[1, 1, 1, 1, 0, 0, 1, 0, 1, 0, 0, 1, 1, 1, 1]",433,146,287,14,19,0.0958904109589041,0.06620209059233449
"[1, 1, 1, 0, 0, 1, 1, 0, 1, 0, 1, 1, 1, 0, 0]",218,80,138,10,14,0.125,0.10144927536231885
"[0, 0, 0, 1, 1, 1, 1, 1, 0, 1, 1, 1, 0, 0, 1]",216,104,112,10,13,0.09615384615384616,0.11607142857142858
"[0, 0, 1, 0, 1, 1, 0, 1, 1, 0, 0, 0, 0, 1, 0]",153,84,69,9,3,0.10714285714285714,0.043478260869565216
"[0, 1, 0, 0, 1, 0, 1, 0, 0, 1, 0, 1, 1, 0, 1]",120,62,58,6,9,0.0967741935483871,0.15517241379310345
"[1, 0, 1, 0, 1, 1, 1, 1, 0, 1, 0, 0, 1, 1, 1]",299,85,214,9,28,0.10588235294117647,0.1308411214953271
"[0, 1, 1, 1, 1, 0, 0, 0, 1, 1, 1, 0, 1, 1, 0]",172,78,94,4,6,0.05128205128205128,0.06382978723404255
"[0, 1, 1, 1, 1, 0, 0, 1, 1, 0, 1, 1, 1, 1, 1]",937,451,486,39,42,0.08647450110864745,0.08641975308641975
"[1, 0, 1, 0, 0, 1, 1, 1, 0, 0, 0, 1, 0, 0, 1]",116,56,60,10,7,0.17857142857142858,0.11666666666666667
"[1, 0, 0, 1, 1, 1, 1, 1, 1, 0, 0, 0, 1, 1, 1]",674,147,527,10,58,0.06802721088435375,0.11005692599620494
"[1, 1, 1, 1, 0, 0, 0, 0, 1, 1, 1, 1, 0, 0, 1]",2031,796,1235,67,134,0.08417085427135679,0.10850202429149798
"[0, 1, 1, 1, 1, 1, 0, 1, 0, 0, 1, 1, 0, 1, 0]",108,51,57,1,4,0.0196078431372549,0.07017543859649122
"[0, 1, 0, 0, 0, 1, 1, 0, 1, 1, 1, 0, 1, 1, 1]",156,66,90,9,4,0.13636363636363635,0.044444444444444446
"[0, 1, 0, 1, 0, 1, 1, 1, 1, 0, 1, 0, 1, 1, 1]",265,83,182,10,17,0.12048192771084337,0.09340659340659341
"[1, 0, 1, 1, 0, 1, 0, 0, 1, 0, 1, 0, 1, 0, 1]",93,44,49,5,2,0.11363636363636363,0.04081632653061224
"[1, 1, 1, 0, 1, 1, 0, 1, 0, 0, 1, 0, 1, 0, 1]",130,70,60,4,9,0.05714285714285714,0.15
"[0, 0, 0, 0, 1, 1, 1, 0, 1, 0, 1, 0, 0, 1, 1]",142,87,55,9,10,0.10344827586206896,0.18181818181818182
"[1, 0, 1, 1, 1, 0, 1, 1, 0, 1, 1, 1, 1, 1, 0]",546,144,402,12,29,0.08333333333333333,0.07213930348258707
"[0, 0, 1, 0, 1, 0, 1, 1, 1, 0, 0, 1, 1, 0, 1]",116,44,72,3,5,0.06818181818181818,0.06944444444444445
"[1, 0, 1, 1, 1, 1, 1, 0, 0, 1, 0, 1, 0, 1, 1]",249,96,153,10,13,0.10416666666666667,0.08496732026143791
"[0, 1, 1, 0, 1, 0, 0, 0, 1, 0, 1, 1, 1, 1, 1]",157,81,76,7,8,0.08641975308641975,0.10526315789473684
"[1, 1, 1, 0, 1, 1, 0, 1, 0, 1, 0, 1, 1, 0, 1]",232,87,145,8,12,0.09195402298850575,0.08275862068965517
"[0, 1, 1, 0, 0, 0, 0, 1, 0, 0, 0, 0, 1, 1, 0]",372,273,99,27,6,0.0989010989010989,0.06060606060606061
"[0, 1, 1, 1, 0, 1, 1, 0, 0, 1, 0, 0, 1, 0, 1]",116,58,58,3,4,0.05172413793103448,0.06896551724137931
"[0, 1, 0, 1, 0, 1, 1, 1, 0, 1, 1, 0, 0, 1, 0]",124,58,66,2,6,0.034482758620689655,0.09090909090909091
"[1, 0, 1, 1, 0, 0, 1, 0, 1, 0, 1, 1, 1, 0, 1]",116,44,72,1,8,0.022727272727272728,0.1111111111111111
"[1, 0, 0, 0, 0, 0, 0, 0, 1, 1, 0, 1, 0, 0, 1]",294,183,111,15,14,0.08196721311475409,0.12612612612612611
"[1, 0, 0, 0, 1, 1, 0, 0, 1, 0, 0, 1, 1, 1, 1]",224,97,127,6,22,0.061855670103092786,0.1732283464566929
"[0, 1, 1, 0, 1, 0, 0, 1, 0, 1, 0, 1, 0, 0, 0]",153,76,77,4,19,0.05263157894736842,0.24675324675324675
"[0, 1, 0, 0, 0, 1, 1, 0, 1, 0, 0, 1, 0, 1, 0]",120,66,54,4,4,0.06060606060606061,0.07407407407407407
"[1, 1, 0, 0, 1, 1, 0, 0, 1, 1, 1, 0, 1, 0, 1]",249,99,150,7,19,0.0707070707070707,0.12666666666666668
"[0, 0, 1, 1, 0, 1, 0, 0, 0, 0, 1, 1, 1, 1, 0]",185,103,82,11,7,0.10679611650485436,0.08536585365853659
"[1, 1, 0, 0, 0, 1, 1, 0, 1, 0, 0, 0, 0, 1, 1]",159,82,77,15,3,0.18292682926829268,0.03896103896103896
"[0, 0, 1, 1, 0, 1, 0, 0, 1, 1, 1, 0, 0, 1, 0]",97,49,48,4,3,0.08163265306122448,0.0625
"[1, 0, 0, 0, 1, 1, 0, 1, 0, 0, 1, 1, 1, 0, 0]",123,62,61,3,6,0.04838709677419355,0.09836065573770492
"[0, 0, 1, 0, 0, 0, 0, 0, 0, 0, 1, 0, 0, 0, 1]",1562,1210,352,114,36,0.09421487603305785,0.10227272727272728
"[1, 1, 0, 0, 0, 1, 0, 0, 1, 0, 0, 1, 0, 0, 1]",150,89,61,12,3,0.1348314606741573,0.04918032786885246
"[0, 1, 0, 1, 0, 0, 0, 1, 0, 0, 0, 1, 1, 0, 1]",144,94,50,9,4,0.09574468085106383,0.08
"[0, 1, 1, 1, 1, 0, 0, 0, 1, 0, 1, 0, 0, 0, 1]",137,89,48,9,1,0.10112359550561797,0.020833333333333332
"[0, 0, 0, 1, 0, 0, 0, 0, 1, 0, 1, 1, 1, 1, 1]",186,100,86,12,6,0.12,0.06976744186046512
"[0, 0, 1, 1, 0, 1, 0, 0, 0, 1, 0, 0, 0, 0, 1]",283,193,90,14,10,0.07253886010362694,0.1111111111111111
"[0, 0, 1, 0, 0, 0, 1, 1, 1, 0, 1, 0, 0, 1, 1]",111,56,55,4,4,0.07142857142857142,0.07272727272727272
"[1, 0, 0, 1, 1, 0, 0, 1, 0, 0, 0, 1, 1, 1, 0]",152,61,91,8,8,0.13114754098360656,0.08791208791208792
"[1, 0, 1, 0, 0, 1, 1, 0, 0, 1, 0, 0, 0, 1, 1]",131,57,74,9,10,0.15789473684210525,0.13513513513513514
"[0, 0, 1, 0, 1, 0, 0, 0, 0, 0, 0, 0, 1, 1, 1]",620,417,203,28,24,0.0671462829736211,0.11822660098522167
"[0, 0, 0, 0, 1, 1, 0, 0, 1, 0, 1, 0, 1, 0, 0]",282,174,108,9,7,0.05172413793103448,0.06481481481481481
"[0, 0, 0, 0, 0, 1, 1, 0, 0, 1, 0, 1, 0, 1, 0]",273,190,83,15,6,0.07894736842105263,0.07228915662650602
"[1, 1, 0, 1, 0, 1, 1, 1, 0, 1, 1, 0, 0, 0, 0]",166,70,96,4,12,0.05714285714285714,0.125
"[1, 0, 0, 1, 0, 1, 1, 1, 0, 1, 1, 0, 0, 0, 1]",111,42,69,6,4,0.14285714285714285,0.057971014492753624
"[1, 1, 0, 0, 1, 0, 1, 1, 1, 0, 1, 1, 0, 0, 0]",153,61,92,2,9,0.03278688524590164,0.09782608695652174
"[1, 1, 0, 1, 0, 1, 0, 1, 0, 0, 1, 1, 0, 0, 0]",149,81,68,3,6,0.037037037037037035,0.08823529411764706
"[0, 1, 1, 0, 1, 0, 1, 0, 1, 0, 0, 1, 1, 0, 0]",145,68,77,6,11,0.08823529411764706,0.14285714285714285
"[0, 1, 0, 1, 1, 0, 1, 0, 1, 0, 1, 0, 0, 1, 1]",129,52,77,4,12,0.07692307692307693,0.15584415584415584
"[0, 1, 0, 0, 1, 1, 1, 1, 1, 0, 0, 0, 1, 0, 0]",144,82,62,8,5,0.0975609756097561,0.08064516129032258
"[0, 1, 1, 0, 1, 0, 0, 0, 0, 1, 0, 0, 1, 1, 1]",158,96,62,8,6,0.08333333333333333,0.0967741935483871
"[1, 0, 0, 0, 0, 1, 1, 0, 1, 0, 0, 0, 0, 1, 0]",233,127,106,8,9,0.06299212598425197,0.08490566037735849
"[1, 1, 0, 0, 1, 1, 0, 0, 0, 0, 1, 1, 0, 1, 0]",321,181,140,11,11,0.06077348066298342,0.07857142857142857
"[1, 1, 1, 1, 1, 0, 1, 1, 0, 1, 1, 0, 0, 1, 1]",772,211,561,14,49,0.06635071090047394,0.0873440285204991
"[0, 1, 1, 0, 0, 1, 0, 1, 0, 1, 1, 0, 1, 0, 0]",119,67,52,9,8,0.13432835820895522,0.15384615384615385
"[0, 0, 0, 1, 1, 1, 0, 1, 1, 1, 0, 0, 1, 1, 1]",242,131,111,14,13,0.10687022900763359,0.11711711711711711
"[0, 0, 1, 1, 1, 1, 1, 1, 0, 0, 0, 1, 1, 1, 0]",301,170,131,16,10,0.09411764705882353,0.07633587786259542
"[0, 0, 0, 0, 1, 0, 1, 1, 1, 0, 1, 1, 1, 1, 1]",243,119,124,9,8,0.07563025210084033,0.06451612903225806
"[1, 1, 1, 0, 1, 1, 0, 0, 0, 1, 1, 0, 1, 0, 0]",98,48,50,6,3,0.125,0.06
"[1, 0, 1, 1, 0, 0, 1, 0, 1, 1, 1, 1, 1, 0, 1]",249,88,161,13,18,0.14772727272727273,0.11180124223602485
"[1, 1, 1, 0, 1, 1, 0, 0, 1, 0, 1, 1, 1, 1, 1]",620,177,443,18,51,0.1016949152542373,0.11512415349887133
"[0, 0, 0, 1, 1, 0, 0, 0, 1, 1, 1, 0, 1, 1, 0]",150,86,64,11,6,0.12790697674418605,0.09375
"[1, 0, 1, 1, 0, 1, 1, 0, 1, 0, 1, 0, 1, 0, 1]",148,54,94,2,8,0.037037037037037035,0.0851063829787234
"[0, 0, 1, 0, 1, 1, 1, 0, 1, 1, 0, 0, 1, 0, 1]",126,62,64,7,6,0.11290322580645161,0.09375
"[1, 1, 0, 1, 0, 1, 1, 1, 0, 1, 0, 1, 0, 0, 1]",144,63,81,3,11,0.047619047619047616,0.13580246913580246
"[1, 0, 1, 1, 1, 0, 1, 0, 0, 1, 1, 1, 0, 1, 1]",225,82,143,10,14,0.12195121951219512,0.0979020979020979
"[0, 1, 0, 1, 1, 1, 0, 0, 1, 0, 1, 1, 1, 0, 0]",134,56,78,8,7,0.14285714285714285,0.08974358974358974
"[1, 0, 1, 0, 1, 1, 1, 0, 0, 1, 0, 1, 1, 1, 0]",167,73,94,10,9,0.136986301369863,0.09574468085106383
"[0, 0, 1, 1, 1, 0, 1, 0, 1, 0, 1, 1, 1, 0, 0]",119,57,62,5,0,0.08771929824561403,0.0
"[0, 1, 1, 0, 0, 0, 0, 1, 1, 1, 0, 1, 0, 1, 0]",134,91,43,12,4,0.13186813186813187,0.09302325581395349
"[0, 0, 1, 1, 1, 0, 0, 1, 1, 1, 0, 0, 0, 1, 1]",155,78,77,5,6,0.0641025641025641,0.07792207792207792
"[1, 1, 0, 1, 1, 1, 1, 0, 0, 1, 1, 0, 1, 0, 0]",162,47,115,3,13,0.06382978723404255,0.11304347826086956
"[0, 0, 1, 0, 0, 0, 1, 1, 0, 0, 1, 1, 0, 1, 1]",136,75,61,1,4,0.013333333333333334,0.06557377049180328
"[1, 1, 1, 1, 1, 0, 0, 0, 1, 1, 0, 0, 1, 0, 1]",173,60,113,6,12,0.1,0.10619469026548672
"[0, 0, 1, 1, 0, 1, 0, 1, 0, 0, 0, 0, 0, 0, 1]",301,190,111,15,9,0.07894736842105263,0.08108108108108109
"[0, 1, 0, 0, 0, 1, 1, 0, 1, 0, 1, 0, 0, 0, 0]",285,170,115,20,10,0.11764705882352941,0.08695652173913043
"[1, 1, 0, 0, 1, 0, 0, 0, 0, 0, 1, 1, 0, 0, 0]",411,270,141,36,11,0.13333333333333333,0.07801418439716312
"[0, 1, 1, 0, 0, 1, 1, 0, 0, 0, 1, 0, 0, 0, 1]",242,177,65,28,10,0.15819209039548024,0.15384615384615385
"[0, 0, 0, 1, 0, 1, 0, 0, 0, 0, 1, 0, 1, 0, 0]",497,358,139,37,19,0.10335195530726257,0.1366906474820144
"[0, 0, 1, 0, 1, 0, 1, 1, 0, 0, 1, 1, 1, 1, 1]",290,125,165,11,16,0.088,0.09696969696969697
"[1, 1, 1, 0, 0, 1, 0, 1, 0, 1, 1, 0, 1, 0, 1]",148,61,87,5,7,0.08196721311475409,0.08045977011494253
"[0, 0, 1, 0, 1, 1, 0, 0, 1, 1, 1, 0, 0, 1, 0]",101,48,53,3,9,0.0625,0.16981132075471697
"[0, 0, 0, 0, 1, 0, 1, 0, 1, 0, 0, 1, 0, 1, 1]",170,111,59,12,6,0.10810810810810811,0.1016949152542373
"[1, 0, 0, 1, 0, 0, 1, 0, 1, 1, 1, 1, 0, 0, 1]",164,79,85,14,12,0.17721518987341772,0.1411764705882353
"[0, 0, 0, 1, 0, 0, 1, 0, 0, 0, 0, 1, 0, 0, 1]",506,355,151,38,16,0.10704225352112676,0.10596026490066225
"[0, 0, 1, 1, 0, 1, 1, 0, 0, 0, 1, 0, 0, 0, 1]",157,101,56,8,9,0.07920792079207921,0.16071428571428573
"[1, 1, 1, 1, 1, 1, 0, 0, 1, 0, 0, 0, 0, 1, 1]",336,123,213,10,18,0.08130081300813008,0.08450704225352113
"[0, 1, 1, 0, 0, 0, 0, 0, 0, 1, 0, 0, 1, 1, 1]",566,438,128,39,11,0.08904109589041095,0.0859375
"[0, 0, 1, 0, 0, 1, 0, 1, 1, 0, 0, 1, 0, 0, 1]",136,77,59,4,8,0.05194805194805195,0.13559322033898305
"[0, 0, 1, 0, 0, 1, 0, 0, 1, 0, 1, 1, 0, 0, 1]",148,86,62,8,11,0.09302325581395349,0.1774193548387097
"[0, 1, 1, 1, 0, 1, 1, 1, 0, 0, 1, 1, 0, 1, 0]",144,57,87,4,9,0.07017543859649122,0.10344827586206896
"[1, 1, 1, 1, 0, 0, 0, 0, 1, 0, 0, 1, 0, 1, 1]",191,90,101,8,7,0.08888888888888889,0.06930693069306931
"[0, 1, 1, 0, 0, 1, 0, 0, 1, 1, 0, 0, 0, 0, 1]",217,129,88,16,6,0.12403100775193798,0.06818181818181818
"[1, 0, 1, 1, 0, 0, 1, 0, 0, 1, 1, 0, 0, 0, 0]",202,116,86,4,7,0.034482758620689655,0.08139534883720931
"[1, 1, 1, 1, 0, 1, 1, 0, 0, 1, 0, 0, 1, 1, 0]",175,78,97,3,5,0.038461538461538464,0.05154639175257732
"[1, 1, 0, 1, 1, 1, 1, 1, 0, 1, 1, 0, 0, 1, 0]",218,81,137,4,11,0.04938271604938271,0.08029197080291971
"[1, 1, 1, 0, 0, 0, 0, 0, 0, 0, 1, 0, 0, 1, 1]",319,134,185,12,15,0.08955223880597014,0.08108108108108109
"[0, 1, 1, 0, 1, 1, 1, 0, 1, 0, 0, 0, 0, 1, 0]",92,41,51,2,6,0.04878048780487805,0.11764705882352941
"[0, 0, 1, 0, 1, 0, 1, 1, 0, 1, 1, 0, 1, 0, 1]",95,47,48,7,3,0.14893617021276595,0.0625
"[0, 1, 0, 0, 0, 1, 0, 1, 0, 1, 1, 0, 1, 1, 0]",102,55,47,5,3,0.09090909090909091,0.06382978723404255
"[1, 0, 0, 1, 1, 1, 0, 0, 1, 0, 1, 1, 0, 1, 0]",128,53,75,9,3,0.16981132075471697,0.04
"[1, 1, 0, 0, 1, 1, 1, 0, 0, 1, 0, 1, 1, 0, 1]",177,77,100,6,11,0.07792207792207792,0.11
"[0, 0, 1, 1, 0, 0, 1, 1, 0, 0, 1, 1, 1, 0, 0]",339,183,156,13,15,0.07103825136612021,0.09615384615384616
"[1, 0, 1, 0, 1, 0, 1, 1, 0, 0, 1, 0, 0, 0, 0]",152,95,57,9,9,0.09473684210526316,0.15789473684210525
"[1, 0, 1, 0, 1, 1, 0, 0, 1, 0, 1, 0, 1, 0, 1]",103,47,56,6,7,0.1276595744680851,0.125
"[0, 0, 0, 1, 1, 1, 0, 0, 1, 0, 1, 0, 1, 1, 0]",127,75,52,10,4,0.13333333333333333,0.07692307692307693
"[1, 0, 1, 0, 0, 0, 0, 1, 0, 1, 0, 0, 0, 0, 0]",597,420,177,53,17,0.1261904761904762,0.096045197740113
"[1, 0, 0, 1, 0, 1, 0, 1, 0, 0, 1, 1, 0, 1, 0]",103,57,46,3,5,0.05263157894736842,0.10869565217391304
"[1, 0, 0, 1, 1, 1, 1, 1, 0, 1, 1, 1, 0, 0, 0]",211,83,128,5,13,0.060240963855421686,0.1015625
"[0, 1, 0, 0, 0, 1, 1, 1, 1, 0, 0, 0, 1, 0, 0]",156,89,67,8,10,0.0898876404494382,0.14925373134328357
"[1, 0, 0, 1, 0, 1, 0, 0, 1, 0, 0, 0, 1, 1, 1]",125,65,60,4,3,0.06153846153846154,0.05
"[0, 1, 0, 0, 0, 1, 0, 0, 0, 0, 1, 0, 1, 0, 0]",516,378,138,42,12,0.1111111111111111,0.08695652173913043
"[0, 1, 1, 0, 1, 1, 1, 1, 0, 0, 0, 0, 0, 0, 0]",382,224,158,19,14,0.08482142857142858,0.08860759493670886
"[0, 0, 1, 0, 0, 0, 0, 0, 0, 0, 1, 1, 0, 1, 1]",333,224,109,24,9,0.10714285714285714,0.08256880733944955
"[0, 0, 1, 0, 1, 0, 0, 0, 0, 0, 1, 0, 0, 1, 1]",316,231,85,21,12,0.09090909090909091,0.1411764705882353
"[0, 0, 0, 0, 1, 0, 1, 0, 1, 1, 0, 1, 1, 0, 0]",171,97,74,7,5,0.07216494845360824,0.06756756756756757
"[0, 0, 0, 0, 0, 1, 0, 1, 0, 1, 1, 0, 1, 1, 0]",143,91,52,6,5,0.06593406593406594,0.09615384615384616
"[1, 0, 0, 1, 1, 1, 0, 0, 0, 0, 1, 1, 0, 1, 0]",133,68,65,2,4,0.029411764705882353,0.06153846153846154
"[1, 1, 0, 1, 0, 1, 1, 0, 1, 1, 1, 0, 0, 1, 1]",274,107,167,11,11,0.102803738317757,0.0658682634730539
"[1, 0, 1, 1, 1, 0, 0, 1, 0, 1, 1, 0, 1, 1, 1]",282,93,189,8,25,0.08602150537634409,0.13227513227513227
"[1, 1, 0, 1, 1, 0, 1, 1, 1, 0, 0, 1, 0, 1, 1]",280,100,180,11,14,0.11,0.07777777777777778
"[0, 0, 1, 0, 1, 1, 0, 0, 0, 0, 1, 1, 1, 1, 1]",321,156,165,14,16,0.08974358974358974,0.09696969696969697
"[1, 1, 0, 1, 0, 0, 0, 0, 1, 0, 1, 1, 0, 0, 0]",164,102,62,7,5,0.06862745098039216,0.08064516129032258
"[0, 0, 0, 0, 0, 1, 1, 1, 0, 0, 1, 1, 1, 1, 1]",369,221,148,12,11,0.05429864253393665,0.07432432432432433
"[0, 0, 1, 0, 1, 0, 0, 1, 0, 1, 1, 1, 0, 1, 1]",109,59,50,4,9,0.06779661016949153,0.18
"[0, 0, 0, 0, 1, 1, 1, 0, 1, 1, 0, 1, 0, 1, 1]",142,71,71,6,7,0.08450704225352113,0.09859154929577464
"[1, 1, 1, 0, 0, 1, 1, 1, 1, 0, 1, 1, 0, 0, 1]",369,92,277,15,34,0.16304347826086957,0.12274368231046931
"[1, 1, 1, 0, 0, 1, 0, 0, 0, 0, 1, 1, 0, 0, 0]",289,169,120,24,18,0.14201183431952663,0.15
"[0, 0, 0, 0, 1, 0, 0, 1, 1, 0, 1, 0, 0, 1, 0]",246,158,88,12,10,0.0759493670886076,0.11363636363636363
"[0, 1, 0, 0, 0, 1, 0, 0, 0, 1, 1, 1, 0, 1, 1]",120,64,56,4,3,0.0625,0.05357142857142857
"[0, 1, 1, 1, 0, 1, 0, 0, 0, 1, 0, 0, 0, 1, 1]",100,55,45,5,5,0.09090909090909091,0.1111111111111111
"[1, 1, 1, 1, 0, 0, 1, 1, 1, 0, 1, 0, 0, 0, 1]",202,80,122,10,13,0.125,0.10655737704918032
"[1, 0, 0, 0, 0, 0, 1, 1, 1, 1, 0, 0, 1, 1, 1]",543,236,307,25,28,0.1059322033898305,0.09120521172638436
"[0, 0, 0, 1, 0, 0, 0, 1, 0, 1, 1, 0, 0, 0, 1]",235,159,76,19,4,0.11949685534591195,0.05263157894736842
"[0, 0, 0, 0, 1, 0, 0, 0, 0, 1, 0, 0, 0, 1, 1]",791,586,205,58,24,0.09897610921501707,0.11707317073170732
"[1, 0, 0, 0, 0, 0, 0, 1, 1, 1, 0, 1, 0, 0, 0]",341,198,143,23,12,0.11616161616161616,0.08391608391608392
"[0, 1, 0, 1, 1, 1, 1, 1, 0, 0, 0, 0, 1, 1, 0]",261,135,126,11,10,0.08148148148148149,0.07936507936507936
"[0, 1, 1, 1, 0, 0, 0, 0, 0, 0, 1, 1, 0, 0, 1]",488,279,209,32,25,0.11469534050179211,0.11961722488038277
"[0, 1, 1, 0, 0, 0, 0, 0, 0, 1, 1, 0, 1, 1, 0]",290,213,77,15,8,0.07042253521126761,0.1038961038961039
"[0, 0, 1, 1, 1, 1, 0, 1, 0, 1, 0, 0, 1, 1, 1]",253,105,148,8,17,0.0761904761904762,0.11486486486486487
"[0, 1, 1, 1, 0, 1, 0, 0, 1, 1, 0, 0, 1, 1, 1]",259,118,141,5,16,0.0423728813559322,0.11347517730496454
"[1, 0, 1, 0, 1, 1, 0, 0, 1, 1, 1, 0, 1, 0, 0]",117,57,60,5,5,0.08771929824561403,0.08333333333333333
"[1, 0, 1, 1, 1, 1, 0, 0, 0, 1, 1, 1, 1, 1, 1]",922,265,657,24,58,0.09056603773584905,0.0882800608828006
"[1, 1, 1, 0, 1, 0, 1, 1, 1, 1, 0, 0, 0, 1, 1]",306,107,199,17,12,0.1588785046728972,0.06030150753768844
"[0, 1, 1, 1, 1, 1, 0, 0, 1, 1, 1, 1, 0, 0, 0]",503,241,262,21,19,0.08713692946058091,0.07251908396946564
"[1, 0, 1, 1, 1, 1, 0, 1, 1, 1, 0, 1, 1, 0, 1]",479,137,342,13,33,0.0948905109489051,0.09649122807017543
"[1, 1, 1, 1, 0, 0, 0, 1, 0, 1, 0, 1, 0, 1, 1]",177,62,115,10,13,0.16129032258064516,0.11304347826086956
"[1, 0, 1, 1, 1, 1, 1, 1, 0, 1, 1, 1, 0, 0, 1]",638,183,455,21,45,0.11475409836065574,0.0989010989010989
"[0, 0, 0, 1, 0, 1, 1, 0, 0, 0, 1, 1, 1, 0, 1]",103,54,49,2,5,0.037037037037037035,0.10204081632653061
"[1, 1, 1, 1, 0, 0, 1, 1, 0, 0, 1, 0, 0, 1, 0]",191,104,87,7,9,0.0673076923076923,0.10344827586206896
"[0, 0, 0, 0, 1, 1, 0, 0, 1, 0, 1, 1, 1, 0, 0]",202,114,88,7,7,0.06140350877192982,0.07954545454545454
"[1, 0, 0, 0, 0, 1, 1, 0, 0, 1, 0, 1, 1, 1, 0]",157,74,83,10,9,0.13513513513513514,0.10843373493975904
"[0, 1, 0, 0, 1, 0, 1, 0, 1, 1, 1, 0, 1, 1, 1]",159,56,103,5,9,0.08928571428571429,0.08737864077669903
"[1, 1, 0, 0, 0, 0, 0, 1, 0, 1, 0, 1, 1, 0, 1]",113,64,49,2,2,0.03125,0.04081632653061224
"[0, 0, 1, 0, 1, 0, 1, 1, 0, 1, 1, 0, 0, 0, 0]",170,108,62,8,4,0.07407407407407407,0.06451612903225806
"[1, 1, 1, 0, 1, 1, 0, 0, 0, 0, 0, 1, 1, 0, 1]",117,59,58,6,4,0.1016949152542373,0.06896551724137931
"[1, 1, 0, 1, 1, 1, 1, 1, 0, 1, 0, 1, 0, 1, 1]",475,139,336,7,31,0.050359712230215826,0.09226190476190477
"[1, 0, 1, 0, 0, 0, 0, 0, 1, 0, 0, 1, 0, 1, 1]",155,76,79,6,8,0.07894736842105263,0.10126582278481013
"[1, 1, 0, 1, 0, 0, 0, 0, 0, 1, 0, 0, 1, 0, 1]",148,94,54,8,3,0.0851063829787234,0.05555555555555555
"[0, 1, 1, 0, 0, 1, 0, 1, 1, 1, 0, 0, 1, 0, 0]",108,59,49,6,7,0.1016949152542373,0.14285714285714285
"[0, 1, 0, 1, 1, 0, 0, 0, 0, 0, 1, 0, 0, 0, 1]",243,153,90,13,8,0.08496732026143791,0.08888888888888889
"[1, 1, 0, 1, 0, 1, 1, 0, 0, 0, 0, 0, 1, 0, 0]",174,101,73,15,3,0.1485148514851485,0.0410958904109589
"[0, 1, 0, 1, 0, 0, 1, 1, 0, 0, 0, 0, 1, 1, 0]",332,196,136,14,14,0.07142857142857142,0.10294117647058823
"[1, 0, 0, 0, 1, 0, 0, 0, 0, 0, 1, 1, 0, 1, 0]",213,138,75,14,8,0.10144927536231885,0.10666666666666667
"[1, 0, 1, 0, 0, 1, 1, 0, 1, 0, 0, 1, 1, 0, 0]",142,78,64,8,5,0.10256410256410256,0.078125
"[0, 1, 0, 1, 0, 0, 1, 0, 0, 1, 1, 1, 0, 0, 0]",167,101,66,10,7,0.09900990099009901,0.10606060606060606
"[0, 0, 1, 0, 1, 1, 1, 0, 1, 0, 1, 0, 0, 1, 0]",103,42,61,4,5,0.09523809523809523,0.08196721311475409
"[1, 1, 0, 1, 0, 0, 0, 0, 0, 1, 0, 0, 1, 1, 0]",169,96,73,12,3,0.125,0.0410958904109589
"[0, 1, 0, 1, 0, 0, 1, 1, 1, 0, 1, 0, 1, 0, 1]",103,39,64,3,9,0.07692307692307693,0.140625
"[1, 1, 0, 1, 1, 0, 1, 1, 0, 0, 0, 0, 1, 0, 0]",112,63,49,7,4,0.1111111111111111,0.08163265306122448
"[0, 0, 1, 1, 0, 0, 0, 1, 1, 1, 0, 1, 0, 0, 1]",103,53,50,2,4,0.03773584905660377,0.08
"[0, 0, 0, 0, 1, 1, 0, 0, 0, 1, 1, 1, 0, 1, 0]",162,98,64,8,2,0.08163265306122448,0.03125
"[1, 1, 1, 0, 1, 1, 1, 1, 1, 1, 0, 0, 1, 0, 0]",242,85,157,10,17,0.11764705882352941,0.10828025477707007
"[1, 1, 1, 0, 1, 0, 0, 1, 0, 0, 0, 1, 1, 0, 0]",131,76,55,9,4,0.11842105263157894,0.07272727272727272
"[1, 0, 1, 1, 0, 1, 0, 0, 0, 1, 1, 1, 1, 0, 1]",160,56,104,6,4,0.10714285714285714,0.038461538461538464
"[1, 0, 1, 0, 1, 0, 1, 1, 0, 1, 0, 0, 0, 1, 1]",127,73,54,8,7,0.1095890410958904,0.12962962962962962
"[0, 1, 0, 0, 1, 1, 0, 0, 0, 1, 0, 1, 0, 1, 0]",144,83,61,8,3,0.0963855421686747,0.04918032786885246
"[0, 1, 0, 0, 1, 1, 0, 0, 1, 0, 1, 0, 0, 1, 0]",117,66,51,6,3,0.09090909090909091,0.058823529411764705
"[1, 0, 0, 1, 1, 1, 0, 1, 1, 0, 0, 1, 0, 0, 1]",140,68,72,5,4,0.07352941176470588,0.05555555555555555
"[1, 1, 1, 0, 0, 1, 0, 1, 0, 1, 1, 1, 0, 1, 1]",253,76,177,6,18,0.07894736842105263,0.1016949152542373
"[1, 1, 1, 1, 1, 1, 1, 0, 0, 1, 0, 1, 0, 1, 1]",768,199,569,20,50,0.10050251256281408,0.08787346221441125
"[0, 1, 0, 1, 0, 0, 0, 0, 1, 1, 1, 1, 1, 0, 0]",164,82,82,7,7,0.08536585365853659,0.08536585365853659
"[0, 0, 1, 0, 1, 0, 0, 0, 0, 1, 1, 1, 1, 1, 0]",137,77,60,8,6,0.1038961038961039,0.1
"[0, 0, 1, 0, 1, 0, 1, 1, 0, 1, 1, 1, 0, 0, 0]",136,79,57,7,2,0.08860759493670886,0.03508771929824561
"[1, 0, 0, 1, 0, 1, 0, 1, 1, 0, 1, 1, 1, 0, 0]",136,58,78,9,10,0.15517241379310345,0.1282051282051282
"[0, 1, 1, 0, 1, 0, 0, 0, 1, 1, 1, 1, 1, 1, 0]",221,104,117,10,11,0.09615384615384616,0.09401709401709402
"[1, 0, 1, 0, 1, 0, 1, 1, 0, 0, 1, 1, 1, 0, 0]",145,67,78,7,9,0.1044776119402985,0.11538461538461539
"[0, 1, 0, 0, 1, 1, 0, 1, 0, 1, 0, 1, 1, 0, 0]",113,64,49,10,2,0.15625,0.04081632653061224
"[0, 0, 0, 1, 0, 1, 0, 0, 1, 0, 0, 0, 1, 1, 1]",261,151,110,10,7,0.06622516556291391,0.06363636363636363
"[0, 1, 1, 0, 1, 1, 1, 1, 0, 0, 1, 1, 0, 0, 0]",283,141,142,13,15,0.09219858156028368,0.1056338028169014
"[0, 1, 0, 0, 1, 0, 1, 1, 1, 1, 1, 0, 1, 1, 0]",131,56,75,2,5,0.03571428571428571,0.06666666666666667
"[0, 0, 1, 1, 1, 1, 0, 1, 1, 0, 0, 0, 1, 1, 1]",273,120,153,15,11,0.125,0.0718954248366013
"[0, 0, 1, 0, 1, 1, 1, 0, 0, 1, 1, 1, 1, 0, 1]",164,67,97,4,10,0.05970149253731343,0.10309278350515463
"[1, 1, 0, 1, 0, 0, 1, 0, 1, 0, 1, 0, 0, 0, 0]",158,90,68,5,6,0.05555555555555555,0.08823529411764706
"[1, 0, 0, 0, 0, 1, 0, 1, 1, 0, 1, 0, 0, 0, 1]",149,85,64,9,11,0.10588235294117647,0.171875
"[1, 1, 1, 1, 0, 0, 0, 1, 1, 0, 0, 0, 0, 1, 0]",170,87,83,7,8,0.08045977011494253,0.0963855421686747
"[1, 0, 1, 1, 1, 0, 0, 1, 1, 0, 0, 0, 1, 1, 1]",220,97,123,8,11,0.08247422680412371,0.08943089430894309
"[1, 0, 1, 0, 0, 0, 0, 0, 0, 0, 1, 0, 1, 0, 1]",243,156,87,19,5,0.12179487179487179,0.05747126436781609
"[1, 0, 1, 0, 0, 1, 1, 1, 1, 1, 1, 0, 0, 0, 0]",426,190,236,16,24,0.08421052631578947,0.1016949152542373
"[1, 1, 0, 1, 0, 1, 1, 1, 1, 0, 0, 0, 0, 1, 0]",130,58,72,12,9,0.20689655172413793,0.125
"[1, 1, 0, 0, 1, 1, 0, 0, 1, 0, 1, 0, 1, 1, 0]",148,50,98,2,9,0.04,0.09183673469387756
"[1, 1, 0, 0, 0, 1, 1, 1, 0, 0, 1, 1, 0, 0, 1]",191,84,107,9,10,0.10714285714285714,0.09345794392523364
"[0, 1, 1, 0, 0, 1, 0, 1, 1, 0, 1, 1, 0, 0, 1]",120,60,60,4,10,0.06666666666666667,0.16666666666666666
"[1, 0, 0, 1, 1, 0, 0, 1, 0, 1, 1, 0, 1, 1, 0]",134,61,73,9,5,0.14754098360655737,0.0684931506849315
"[0, 1, 0, 0, 0, 0, 0, 1, 1, 0, 1, 0, 1, 1, 0]",161,100,61,8,5,0.08,0.08196721311475409
"[1, 1, 1, 0, 1, 0, 1, 0, 0, 1, 0, 1, 1, 1, 1]",277,102,175,5,19,0.049019607843137254,0.10857142857142857
"[1, 1, 0, 1, 1, 0, 0, 1, 1, 0, 1, 1, 0, 0, 1]",167,80,87,9,10,0.1125,0.11494252873563218
"[1, 0, 1, 1, 0, 1, 1, 0, 1, 1, 0, 0, 1, 1, 0]",185,79,106,6,9,0.0759493670886076,0.08490566037735849
"[1, 0, 1, 1, 1, 1, 1, 0, 0, 1, 0, 0, 0, 0, 0]",164,83,81,10,4,0.12048192771084337,0.04938271604938271
"[1, 1, 1, 0, 1, 1, 1, 1, 1, 0, 0, 1, 0, 0, 0]",160,63,97,5,11,0.07936507936507936,0.1134020618556701
"[1, 1, 1, 0, 0, 1, 0, 1, 0, 1, 0, 1, 1, 1, 0]",130,52,78,3,6,0.057692307692307696,0.07692307692307693
"[1, 1, 0, 1, 1, 0, 1, 0, 0, 0, 0, 0, 0, 1, 0]",149,79,70,12,8,0.1518987341772152,0.11428571428571428
"[1, 0, 1, 0, 1, 0, 0, 1, 1, 1, 1, 1, 1, 1, 0]",339,140,199,7,27,0.05,0.135678391959799
"[1, 1, 0, 0, 0, 1, 0, 0, 0, 0, 0, 0, 1, 1, 1]",384,236,148,15,15,0.0635593220338983,0.10135135135135136
"[1, 0, 1, 0, 1, 0, 1, 1, 0, 0, 1, 1, 0, 0, 0]",176,90,86,8,8,0.08888888888888889,0.09302325581395349
"[0, 1, 1, 0, 0, 1, 0, 0, 1, 1, 0, 0, 1, 1, 1]",238,136,102,18,14,0.1323529411764706,0.13725490196078433
"[1, 1, 0, 0, 1, 1, 0, 0, 0, 1, 1, 1, 1, 0, 0]",278,133,145,9,12,0.06766917293233082,0.08275862068965517
"[1, 1, 1, 0, 0, 0, 1, 1, 1, 1, 0, 1, 0, 0, 0]",154,70,84,8,8,0.11428571428571428,0.09523809523809523
"[0, 1, 0, 1, 1, 0, 0, 1, 1, 1, 1, 0, 0, 0, 0]",417,198,219,23,20,0.11616161616161616,0.091324200913242
"[0, 0, 0, 1, 1, 0, 1, 0, 1, 1, 0, 0, 1, 1, 1]",213,119,94,6,15,0.05042016806722689,0.1595744680851064
"[0, 1, 0, 0, 0, 0, 1, 1, 0, 1, 0, 1, 0, 0, 0]",258,146,112,8,10,0.0547945205479452,0.08928571428571429
"[0, 1, 1, 1, 0, 1, 1, 0, 0, 0, 0, 1, 0, 1, 1]",136,76,60,9,5,0.11842105263157894,0.08333333333333333
"[0, 0, 1, 0, 0, 1, 0, 1, 0, 0, 1, 1, 1, 0, 1]",84,38,46,3,3,0.07894736842105263,0.06521739130434782
"[0, 1, 1, 1, 0, 0, 1, 0, 0, 1, 1, 0, 1, 0, 0]",122,59,63,4,1,0.06779661016949153,0.015873015873015872
"[0, 0, 1, 1, 1, 0, 0, 1, 0, 0, 1, 1, 0, 1, 0]",128,73,55,7,4,0.0958904109589041,0.07272727272727272
"[1, 1, 1, 0, 0, 1, 1, 1, 0, 0, 1, 0, 0, 0, 1]",139,50,89,7,10,0.14,0.11235955056179775
"[1, 0, 1, 1, 1, 1, 0, 0, 1, 1, 1, 0, 0, 1, 0]",157,71,86,8,9,0.11267605633802817,0.10465116279069768
"[1, 1, 1, 0, 1, 0, 1, 0, 1, 0, 1, 0, 1, 0, 0]",112,41,71,3,8,0.07317073170731707,0.11267605633802817
"[0, 0, 0, 0, 1, 0, 0, 1, 1, 1, 1, 1, 1, 1, 0]",202,107,95,10,14,0.09345794392523364,0.14736842105263157
"[1, 0, 0, 0, 0, 0, 0, 1, 0, 1, 1, 0, 0, 0, 0]",713,458,255,39,21,0.0851528384279476,0.08235294117647059
"[0, 1, 0, 1, 0, 0, 0, 0, 0, 0, 1, 0, 1, 1, 0]",231,148,83,16,8,0.10810810810810811,0.0963855421686747
"[1, 0, 0, 1, 0, 0, 0, 1, 0, 0, 0, 0, 0, 0, 1]",611,422,189,37,21,0.08767772511848342,0.1111111111111111
"[0, 1, 1, 0, 0, 1, 0, 0, 1, 0, 0, 0, 1, 0, 0]",215,133,82,12,10,0.09022556390977443,0.12195121951219512
"[0, 0, 1, 1, 1, 1, 1, 1, 0, 1, 0, 0, 1, 0, 1]",171,81,90,9,6,0.1111111111111111,0.06666666666666667
"[0, 1, 0, 1, 1, 0, 0, 1, 0, 0, 0, 0, 1, 1, 1]",195,112,83,11,9,0.09821428571428571,0.10843373493975904
"[1, 0, 1, 0, 1, 0, 0, 0, 0, 0, 0, 1, 1, 0, 1]",156,82,74,8,6,0.0975609756097561,0.08108108108108109
"[1, 1, 0, 0, 0, 0, 1, 0, 0, 0, 0, 0, 1, 0, 0]",583,408,175,29,20,0.07107843137254902,0.11428571428571428
"[1, 1, 1, 0, 1, 0, 0, 1, 0, 1, 1, 1, 0, 1, 1]",244,71,173,8,11,0.11267605633802817,0.06358381502890173
"[1, 0, 1, 1, 0, 0, 1, 1, 1, 1, 0, 1, 0, 0, 1]",182,68,114,3,14,0.04411764705882353,0.12280701754385964
"[1, 1, 1, 0, 0, 0, 1, 1, 0, 1, 0, 0, 1, 0, 1]",102,43,59,4,7,0.09302325581395349,0.11864406779661017
"[0, 1, 0, 1, 0, 0, 1, 1, 1, 0, 0, 0, 0, 0, 0]",353,243,110,27,19,0.1111111111111111,0.17272727272727273
"[0, 0, 1, 1, 1, 0, 0, 1, 1, 0, 1, 0, 1, 1, 1]",201,90,111,7,13,0.07777777777777778,0.11711711711711711
"[0, 0, 1, 1, 0, 1, 1, 1, 1, 0, 1, 0, 1, 0, 0]",114,52,62,5,10,0.09615384615384616,0.16129032258064516
"[0, 0, 0, 1, 1, 0, 1, 1, 1, 1, 0, 1, 0, 1, 0]",103,52,51,8,5,0.15384615384615385,0.09803921568627451
"[1, 1, 0, 0, 0, 1, 1, 0, 1, 1, 1, 1, 0, 1, 0]",138,62,76,8,4,0.12903225806451613,0.05263157894736842
"[0, 1, 1, 0, 1, 1, 0, 1, 1, 1, 0, 1, 0, 1, 0]",140,59,81,5,9,0.0847457627118644,0.1111111111111111
"[1, 1, 1, 0, 1, 0, 0, 0, 1, 1, 0, 0, 1, 0, 0]",123,65,58,6,4,0.09230769230769231,0.06896551724137931
"[0, 0, 1, 0, 1, 1, 1, 0, 1, 1, 1, 0, 1, 1, 0]",119,47,72,6,8,0.1276595744680851,0.1111111111111111
"[0, 1, 0, 0, 1, 0, 1, 1, 0, 1, 1, 1, 0, 1, 0]",78,35,43,2,4,0.05714285714285714,0.09302325581395349
"[1, 0, 1, 0, 1, 0, 0, 1, 0, 1, 1, 0, 1, 1, 1]",150,72,78,6,6,0.08333333333333333,0.07692307692307693
"[1, 0, 1, 0, 0, 0, 1, 0, 1, 0, 1, 1, 1, 1, 1]",168,80,88,5,3,0.0625,0.03409090909090909
"[1, 0, 1, 1, 1, 0, 1, 1, 1, 1, 1, 0, 0, 0, 1]",237,81,156,12,21,0.14814814814814814,0.1346153846153846
"[1, 1, 0, 1, 0, 1, 0, 0, 1, 0, 0, 0, 0, 1, 0]",144,87,57,9,4,0.10344827586206896,0.07017543859649122
"[1, 0, 0, 1, 1, 0, 1, 1, 0, 1, 0, 1, 0, 0, 1]",121,55,66,4,3,0.07272727272727272,0.045454545454545456
"[1, 1, 1, 1, 0, 1, 1, 1, 1, 0, 0, 0, 0, 1, 1]",656,211,445,15,43,0.07109004739336493,0.09662921348314607
"[1, 0, 1, 1, 0, 0, 1, 0, 1, 0, 0, 1, 0, 1, 0]",88,40,48,5,5,0.125,0.10416666666666667
"[0, 0, 1, 1, 0, 1, 1, 0, 0, 1, 0, 1, 0, 0, 1]",113,59,54,4,5,0.06779661016949153,0.09259259259259259
"[1, 1, 0, 0, 1, 0, 0, 1, 0, 0, 0, 1, 1, 0, 1]",104,47,57,5,7,0.10638297872340426,0.12280701754385964
"[0, 1, 1, 1, 0, 1, 0, 1, 1, 1, 0, 1, 1, 0, 0]",151,43,108,6,15,0.13953488372093023,0.1388888888888889
"[0, 0, 0, 0, 1, 1, 0, 1, 0, 0, 1, 0, 0, 0, 0]",684,481,203,47,17,0.09771309771309772,0.08374384236453201
"[0, 0, 0, 0, 1, 1, 0, 1, 1, 0, 0, 0, 1, 1, 1]",256,145,111,16,10,0.1103448275862069,0.09009009009009009
"[0, 1, 0, 1, 0, 0, 0, 0, 0, 0, 1, 0, 0, 0, 0]",1694,1291,403,99,42,0.0766847405112316,0.10421836228287841
"[0, 1, 0, 0, 0, 1, 0, 0, 0, 0, 1, 0, 0, 0, 1]",518,370,148,44,17,0.11891891891891893,0.11486486486486487
"[0, 0, 0, 1, 0, 1, 0, 0, 0, 0, 1, 0, 0, 1, 1]",327,205,122,24,11,0.11707317073170732,0.09016393442622951
"[1, 0, 1, 0, 0, 0, 1, 1, 1, 0, 0, 0, 0, 0, 1]",174,101,73,7,11,0.06930693069306931,0.1506849315068493
"[1, 0, 0, 0, 1, 1, 0, 0, 1, 0, 1, 1, 0, 0, 0]",151,77,74,10,11,0.12987012987012986,0.14864864864864866
"[0, 0, 0, 1, 0, 0, 0, 0, 0, 1, 0, 1, 0, 0, 1]",473,322,151,31,9,0.09627329192546584,0.059602649006622516
"[0, 1, 0, 1, 1, 0, 0, 1, 1, 1, 1, 1, 1, 0, 1]",261,91,170,12,19,0.13186813186813187,0.11176470588235295
"[1, 0, 0, 0, 1, 1, 0, 1, 0, 1, 1, 0, 0, 1, 1]",153,70,83,15,4,0.21428571428571427,0.04819277108433735
"[1, 0, 0, 1, 0, 1, 1, 1, 1, 0, 1, 0, 0, 1, 1]",169,57,112,7,12,0.12280701754385964,0.10714285714285714
"[0, 1, 0, 1, 1, 0, 0, 1, 0, 1, 1, 1, 1, 0, 1]",133,56,77,5,9,0.08928571428571429,0.11688311688311688
"[0, 0, 0, 1, 0, 1, 1, 1, 1, 1, 0, 0, 0, 0, 0]",315,201,114,19,15,0.0945273631840796,0.13157894736842105
"[1, 0, 0, 0, 0, 0, 1, 1, 0, 0, 0, 1, 0, 1, 1]",195,97,98,14,7,0.14432989690721648,0.07142857142857142
"[0, 1, 1, 1, 0, 0, 1, 1, 0, 1, 0, 0, 1, 0, 1]",106,46,60,3,6,0.06521739130434782,0.1
"[0, 0, 1, 1, 1, 0, 0, 0, 1, 1, 1, 1, 0, 0, 0]",227,127,100,14,13,0.11023622047244094,0.13
"[1, 0, 0, 0, 0, 0, 0, 0, 1, 1, 1, 1, 1, 0, 0]",293,166,127,12,12,0.07228915662650602,0.09448818897637795
"[1, 0, 1, 0, 0, 0, 0, 1, 1, 1, 0, 0, 1, 1, 1]",187,84,103,12,4,0.14285714285714285,0.038834951456310676
"[1, 0, 1, 1, 0, 0, 0, 1, 1, 1, 0, 0, 0, 0, 0]",215,123,92,15,9,0.12195121951219512,0.09782608695652174
"[0, 1, 0, 0, 1, 0, 1, 0, 0, 1, 0, 1, 1, 0, 0]",165,107,58,12,5,0.11214953271028037,0.08620689655172414
"[1, 0, 0, 1, 0, 0, 0, 1, 0, 1, 0, 0, 0, 1, 1]",180,95,85,6,9,0.06315789473684211,0.10588235294117647
"[1, 0, 1, 1, 1, 1, 0, 1, 0, 1, 1, 1, 1, 0, 1]",491,144,347,19,26,0.13194444444444445,0.07492795389048991
"[0, 1, 1, 1, 1, 1, 0, 0, 0, 1, 1, 1, 0, 0, 0]",158,84,74,5,9,0.05952380952380952,0.12162162162162163
"[0, 0, 1, 0, 1, 0, 0, 1, 1, 1, 0, 1, 1, 1, 1]",173,79,94,11,5,0.13924050632911392,0.05319148936170213
"[1, 0, 0, 1, 0, 1, 0, 0, 1, 1, 1, 0, 1, 1, 1]",163,61,102,5,8,0.08196721311475409,0.0784313725490196
"[1, 1, 1, 0, 0, 0, 0, 1, 0, 1, 0, 0, 1, 0, 1]",118,57,61,10,3,0.17543859649122806,0.04918032786885246
"[1, 1, 0, 0, 0, 0, 0, 0, 1, 0, 1, 0, 0, 1, 1]",254,144,110,16,8,0.1111111111111111,0.07272727272727272
"[0, 0, 0, 1, 1, 0, 0, 0, 0, 1, 1, 1, 0, 0, 1]",348,261,87,22,9,0.0842911877394636,0.10344827586206896
"[1, 0, 0, 1, 1, 0, 0, 1, 0, 0, 1, 0, 1, 1, 1]",156,55,101,3,18,0.05454545454545454,0.1782178217821782
"[1, 0, 0, 0, 1, 1, 1, 0, 1, 1, 1, 1, 1, 1, 1]",770,224,546,27,55,0.12053571428571429,0.10073260073260074
"[0, 1, 0, 0, 0, 1, 1, 1, 0, 1, 1, 1, 1, 1, 1]",316,110,206,8,25,0.07272727272727272,0.12135922330097088
"[1, 0, 1, 0, 0, 0, 1, 0, 0, 0, 0, 1, 1, 1, 1]",248,133,115,17,19,0.12781954887218044,0.16521739130434782
"[1, 1, 0, 0, 0, 0, 0, 1, 0, 0, 1, 1, 0, 1, 1]",154,87,67,8,7,0.09195402298850575,0.1044776119402985
"[1, 1, 1, 1, 0, 1, 1, 0, 1, 1, 1, 1, 0, 1, 0]",500,150,350,18,33,0.12,0.09428571428571429
"[1, 0, 0, 1, 1, 0, 1, 0, 0, 1, 1, 0, 1, 0, 1]",94,38,56,4,4,0.10526315789473684,0.07142857142857142
"[1, 1, 1, 1, 1, 0, 0, 1, 0, 0, 1, 1, 1, 0, 1]",261,93,168,10,24,0.10752688172043011,0.14285714285714285
"[1, 1, 0, 0, 0, 0, 1, 0, 1, 1, 0, 1, 0, 1, 1]",116,54,62,5,4,0.09259259259259259,0.06451612903225806
"[0, 0, 0, 0, 1, 1, 1, 1, 1, 0, 0, 1, 0, 1, 0]",151,87,64,9,8,0.10344827586206896,0.125
"[1, 0, 1, 0, 1, 0, 0, 1, 0, 1, 1, 1, 0, 0, 0]",117,59,58,10,7,0.1694915254237288,0.1206896551724138
"[0, 1, 0, 1, 0, 1, 1, 1, 0, 1, 1, 0, 0, 0, 1]",117,54,63,5,3,0.09259259259259259,0.047619047619047616
"[0, 1, 0, 1, 1, 0, 0, 0, 0, 0, 1, 0, 1, 0, 1]",125,70,55,7,5,0.1,0.09090909090909091
"[1, 0, 0, 1, 0, 1, 1, 0, 1, 1, 1, 0, 0, 1, 1]",187,73,114,9,14,0.1232876712328767,0.12280701754385964
"[0, 0, 0, 0, 1, 0, 1, 0, 0, 1, 0, 1, 0, 1, 0]",260,185,75,19,7,0.10270270270270271,0.09333333333333334
"[1, 1, 0, 1, 0, 0, 1, 1, 0, 0, 1, 0, 1, 1, 1]",180,81,99,6,14,0.07407407407407407,0.1414141414141414
"[0, 1, 1, 1, 0, 1, 0, 0, 1, 1, 0, 0, 1, 0, 1]",90,45,45,0,5,0.0,0.1111111111111111
"[0, 0, 1, 1, 1, 0, 1, 0, 0, 1, 1, 0, 0, 1, 0]",99,54,45,6,3,0.1111111111111111,0.06666666666666667
"[1, 1, 1, 1, 0, 1, 0, 1, 0, 0, 1, 0, 1, 1, 0]",141,61,80,6,9,0.09836065573770492,0.1125
"[0, 1, 1, 0, 0, 0, 0, 1, 0, 0, 1, 1, 1, 1, 0]",168,113,55,11,5,0.09734513274336283,0.09090909090909091
"[0, 1, 0, 0, 0, 1, 1, 1, 0, 1, 0, 1, 1, 0, 0]",155,87,68,8,5,0.09195402298850575,0.07352941176470588
"[0, 1, 1, 1, 0, 0, 0, 0, 0, 0, 1, 1, 1, 0, 1]",167,84,83,10,8,0.11904761904761904,0.0963855421686747
"[1, 1, 1, 0, 1, 1, 0, 0, 0, 0, 0, 1, 1, 0, 0]",213,120,93,13,9,0.10833333333333334,0.0967741935483871
"[1, 0, 1, 1, 0, 1, 1, 0, 1, 0, 0, 0, 0, 0, 0]",177,104,73,7,8,0.0673076923076923,0.1095890410958904
"[1, 1, 1, 1, 0, 1, 1, 1, 1, 0, 1, 0, 0, 1, 0]",254,91,163,10,15,0.10989010989010989,0.09202453987730061
"[1, 1, 0, 0, 0, 1, 0, 1, 1, 0, 0, 1, 1, 0, 1]",126,62,64,4,5,0.06451612903225806,0.078125
"[1, 0, 1, 0, 0, 1, 1, 1, 0, 1, 0, 1, 0, 1, 0]",111,52,59,8,5,0.15384615384615385,0.0847457627118644
"[0, 1, 0, 0, 1, 0, 1, 0, 0, 0, 0, 0, 0, 1, 1]",407,265,142,34,13,0.12830188679245283,0.09154929577464789
"[1, 0, 1, 0, 0, 0, 0, 0, 1, 1, 0, 1, 0, 0, 1]",174,97,77,6,6,0.061855670103092786,0.07792207792207792
"[0, 0, 1, 0, 0, 1, 0, 0, 0, 1, 0, 0, 1, 1, 1]",242,133,109,7,14,0.05263157894736842,0.12844036697247707
"[1, 1, 0, 1, 1, 1, 1, 0, 0, 0, 0, 0, 1, 1, 0]",183,88,95,7,3,0.07954545454545454,0.031578947368421054
"[1, 1, 0, 0, 0, 0, 0, 0, 1, 0, 1, 1, 0, 0, 1]",206,119,87,7,7,0.058823529411764705,0.08045977011494253
"[0, 0, 1, 0, 1, 1, 0, 1, 1, 1, 0, 1, 1, 1, 1]",275,109,166,11,16,0.10091743119266056,0.0963855421686747
"[1, 0, 1, 1, 1, 1, 0, 0, 0, 1, 0, 0, 1, 0, 0]",127,66,61,5,8,0.07575757575757576,0.13114754098360656
"[1, 1, 1, 0, 1, 0, 0, 0, 0, 0, 1, 0, 0, 0, 0]",261,154,107,14,10,0.09090909090909091,0.09345794392523364
"[0, 0, 1, 0, 1, 1, 0, 1, 0, 1, 1, 1, 1, 1, 1]",319,136,183,10,23,0.07352941176470588,0.12568306010928962
"[0, 0, 1, 0, 1, 0, 1, 1, 1, 1, 1, 0, 0, 1, 1]",218,87,131,5,7,0.05747126436781609,0.05343511450381679
"[0, 1, 0, 1, 1, 1, 0, 0, 0, 0, 1, 0, 0, 1, 0]",135,66,69,7,10,0.10606060606060606,0.14492753623188406
"[1, 0, 0, 1, 0, 1, 1, 1, 0, 0, 0, 0, 1, 0, 0]",132,68,64,5,5,0.07352941176470588,0.078125
"[0, 1, 0, 1, 1, 0, 0, 1, 0, 1, 1, 1, 0, 0, 0]",136,67,69,6,6,0.08955223880597014,0.08695652173913043
"[0, 0, 0, 1, 1, 0, 1, 0, 1, 1, 0, 0, 1, 0, 1]",116,70,46,11,7,0.15714285714285714,0.15217391304347827
"[1, 1, 1, 0, 1, 1, 0, 0, 1, 1, 0, 0, 0, 1, 0]",121,58,63,6,8,0.10344827586206896,0.12698412698412698
"[0, 1, 1, 0, 0, 0, 1, 0, 1, 1, 1, 0, 0, 1, 1]",179,96,83,10,4,0.10416666666666667,0.04819277108433735
"[1, 1, 1, 1, 1, 0, 0, 1, 1, 0, 0, 0, 0, 0, 1]",416,88,328,8,32,0.09090909090909091,0.0975609756097561
"[1, 1, 1, 0, 1, 0, 1, 0, 0, 0, 0, 1, 1, 0, 0]",197,90,107,7,12,0.07777777777777778,0.11214953271028037
"[1, 1, 0, 0, 0, 0, 1, 1, 1, 0, 1, 1, 1, 0, 1]",182,74,108,8,10,0.10810810810810811,0.09259259259259259
"[0, 0, 0, 1, 0, 1, 1, 1, 1, 1, 1, 1, 0, 1, 1]",282,123,159,10,21,0.08130081300813008,0.1320754716981132
"[0, 1, 1, 1, 1, 0, 1, 0, 1, 1, 1, 0, 0, 1, 1]",386,156,230,10,24,0.0641025641025641,0.10434782608695652
"[1, 0, 1, 0, 0, 0, 1, 0, 0, 1, 1, 0, 1, 0, 0]",153,87,66,11,7,0.12643678160919541,0.10606060606060606
"[1, 0, 0, 1, 0, 1, 0, 0, 1, 1, 1, 0, 1, 0, 0]",103,43,60,3,4,0.06976744186046512,0.06666666666666667
"[1, 1, 1, 0, 1, 1, 1, 0, 1, 0, 0, 0, 1, 1, 1]",287,96,191,11,10,0.11458333333333333,0.05235602094240838
"[0, 0, 1, 1, 0, 0, 0, 0, 0, 1, 1, 0, 1, 1, 1]",298,174,124,13,13,0.07471264367816093,0.10483870967741936
"[0, 0, 0, 1, 0, 1, 0, 1, 0, 1, 0, 1, 0, 1, 0]",135,80,55,9,11,0.1125,0.2
"[0, 0, 1, 1, 1, 1, 1, 1, 1, 1, 0, 1, 1, 0, 0]",479,170,309,25,34,0.14705882352941177,0.11003236245954692
"[0, 1, 1, 0, 1, 0, 0, 0, 1, 1, 1, 1, 0, 0, 1]",188,96,92,10,6,0.10416666666666667,0.06521739130434782
"[1, 1, 0, 1, 0, 0, 0, 1, 1, 0, 1, 0, 1, 0, 0]",124,55,69,5,9,0.09090909090909091,0.13043478260869565
"[0, 0, 1, 1, 0, 0, 1, 0, 1, 0, 0, 1, 1, 1, 1]",208,99,109,17,10,0.1717171717171717,0.09174311926605505
"[1, 1, 1, 1, 1, 0, 0, 1, 0, 1, 0, 1, 1, 0, 1]",277,89,188,12,19,0.1348314606741573,0.10106382978723404
"[0, 0, 0, 1, 0, 0, 1, 0, 0, 1, 0, 0, 0, 1, 1]",303,215,88,27,7,0.12558139534883722,0.07954545454545454
"[0, 1, 1, 1, 1, 1, 1, 0, 1, 1, 1, 1, 0, 0, 1]",802,284,518,40,57,0.14084507042253522,0.11003861003861004
"[1, 0, 0, 0, 0, 0, 1, 0, 0, 1, 0, 1, 1, 1, 1]",192,89,103,9,8,0.10112359550561797,0.07766990291262135
"[0, 0, 1, 0, 1, 0, 1, 0, 1, 0, 0, 0, 1, 0, 1]",143,97,46,7,2,0.07216494845360824,0.043478260869565216
"[0, 1, 0, 1, 1, 1, 0, 1, 1, 1, 1, 1, 0, 1, 0]",206,69,137,3,15,0.043478260869565216,0.10948905109489052
"[1, 0, 1, 0, 0, 1, 1, 1, 1, 0, 1, 0, 1, 1, 0]",162,57,105,6,6,0.10526315789473684,0.05714285714285714
"[0, 0, 1, 1, 1, 0, 1, 1, 0, 1, 0, 1, 1, 0, 0]",115,52,63,6,5,0.11538461538461539,0.07936507936507936
"[0, 0, 1, 0, 1, 1, 1, 1, 1, 1, 0, 1, 1, 0, 1]",236,82,154,5,21,0.06097560975609756,0.13636363636363635
"[1, 1, 0, 0, 1, 0, 1, 0, 1, 1, 1, 0, 1, 0, 1]",134,54,80,5,12,0.09259259259259259,0.15
"[1, 1, 0, 0, 0, 1, 0, 1, 1, 0, 0, 1, 0, 1, 0]",101,56,45,4,2,0.07142857142857142,0.044444444444444446
"[1, 1, 0, 0, 0, 0, 0, 0, 1, 1, 0, 1, 1, 0, 1]",223,124,99,10,11,0.08064516129032258,0.1111111111111111
"[1, 0, 1, 1, 0, 1, 1, 0, 0, 0, 0, 1, 1, 0, 0]",240,122,118,10,15,0.08196721311475409,0.1271186440677966
"[1, 1, 1, 1, 1, 0, 1, 0, 0, 0, 0, 1, 1, 0, 1]",165,60,105,9,8,0.15,0.0761904761904762
"[0, 1, 0, 0, 1, 1, 0, 0, 0, 0, 1, 0, 0, 1, 0]",286,188,98,17,13,0.09042553191489362,0.1326530612244898
"[0, 1, 1, 1, 0, 0, 1, 0, 0, 1, 1, 0, 0, 0, 0]",236,138,98,13,9,0.09420289855072464,0.09183673469387756
"[1, 1, 1, 0, 1, 1, 1, 1, 0, 1, 0, 1, 0, 0, 0]",166,66,100,8,8,0.12121212121212122,0.08
"[1, 1, 1, 1, 0, 1, 1, 1, 1, 0, 1, 0, 1, 0, 0]",241,82,159,7,10,0.08536585365853659,0.06289308176100629
"[0, 1, 0, 0, 0, 0, 0, 1, 1, 1, 1, 1, 0, 0, 1]",203,111,92,14,9,0.12612612612612611,0.09782608695652174
"[0, 1, 0, 1, 1, 0, 0, 1, 1, 1, 1, 1, 0, 1, 1]",242,104,138,16,9,0.15384615384615385,0.06521739130434782
"[0, 1, 0, 0, 1, 0, 1, 1, 0, 1, 1, 1, 1, 1, 1]",301,117,184,11,19,0.09401709401709402,0.10326086956521739
"[0, 1, 0, 1, 0, 1, 1, 0, 1, 0, 0, 1, 1, 1, 0]",103,49,54,2,2,0.04081632653061224,0.037037037037037035
"[1, 1, 1, 0, 1, 1, 0, 0, 0, 1, 1, 1, 0, 0, 0]",135,61,74,8,8,0.13114754098360656,0.10810810810810811
"[0, 1, 0, 0, 1, 0, 1, 1, 0, 0, 0, 0, 1, 0, 1]",148,95,53,7,7,0.07368421052631578,0.1320754716981132
"[0, 0, 1, 0, 0, 0, 0, 0, 1, 1, 1, 0, 0, 1, 1]",255,174,81,17,10,0.09770114942528736,0.12345679012345678
"[1, 1, 0, 1, 1, 0, 1, 1, 0, 0, 1, 0, 0, 0, 1]",123,62,61,5,3,0.08064516129032258,0.04918032786885246
"[0, 1, 1, 0, 0, 0, 0, 0, 0, 1, 1, 0, 0, 1, 0]",616,478,138,38,12,0.0794979079497908,0.08695652173913043
"[0, 0, 1, 1, 1, 0, 1, 1, 1, 1, 0, 0, 0, 0, 0]",231,108,123,9,17,0.08333333333333333,0.13821138211382114
"[1, 0, 1, 1, 0, 1, 0, 0, 1, 0, 1, 1, 0, 0, 1]",128,59,69,7,8,0.11864406779661017,0.11594202898550725
"[0, 0, 1, 0, 0, 0, 0, 1, 0, 0, 1, 1, 0, 1, 1]",148,97,51,9,2,0.09278350515463918,0.0392156862745098
"[0, 0, 0, 1, 0, 0, 0, 0, 1, 0, 0, 1, 1, 0, 1]",235,160,75,12,7,0.075,0.09333333333333334
"[0, 0, 0, 0, 0, 1, 0, 0, 0, 0, 1, 0, 0, 1, 1]",850,619,231,67,23,0.10823909531502424,0.09956709956709957
"[1, 0, 1, 1, 0, 0, 1, 1, 0, 0, 1, 1, 1, 0, 0]",144,73,71,8,5,0.1095890410958904,0.07042253521126761
"[0, 0, 1, 0, 1, 1, 0, 0, 1, 1, 0, 0, 1, 1, 1]",328,161,167,11,7,0.06832298136645963,0.041916167664670656
"[0, 0, 1, 1, 0, 1, 1, 1, 0, 1, 0, 0, 1, 0, 0]",117,58,59,3,4,0.05172413793103448,0.06779661016949153
"[0, 1, 0, 0, 1, 1, 1, 1, 0, 1, 0, 1, 0, 1, 0]",96,50,46,7,4,0.14,0.08695652173913043
"[0, 1, 1, 1, 0, 0, 0, 0, 1, 0, 1, 0, 1, 1, 1]",131,65,66,8,0,0.12307692307692308,0.0
"[1, 0, 1, 1, 1, 1, 1, 1, 0, 1, 0, 1, 1, 1, 0]",523,140,383,17,28,0.12142857142857143,0.0731070496083551
"[0, 1, 0, 1, 1, 1, 1, 1, 1, 0, 1, 0, 1, 1, 1]",564,196,368,18,42,0.09183673469387756,0.11413043478260869
"[1, 1, 0, 0, 1, 0, 1, 0, 1, 1, 0, 1, 1, 0, 0]",124,49,75,2,10,0.04081632653061224,0.13333333333333333
"[1, 1, 1, 1, 0, 1, 0, 1, 0, 0, 1, 0, 0, 0, 0]",134,68,66,3,6,0.04411764705882353,0.09090909090909091
"[1, 0, 1, 0, 1, 1, 0, 0, 0, 1, 1, 1, 1, 0, 0]",201,85,116,13,15,0.15294117647058825,0.12931034482758622
"[0, 1, 0, 0, 1, 1, 1, 1, 1, 0, 0, 1, 0, 1, 0]",114,53,61,9,2,0.16981132075471697,0.03278688524590164
"[1, 1, 0, 0, 0, 1, 0, 1, 0, 0, 1, 1, 1, 1, 1]",271,102,169,15,17,0.14705882352941177,0.10059171597633136
"[1, 1, 1, 0, 0, 1, 1, 0, 0, 1, 0, 1, 1, 0, 0]",205,77,128,8,14,0.1038961038961039,0.109375
"[1, 1, 1, 1, 0, 0, 1, 0, 0, 0, 1, 1, 0, 1, 1]",173,70,103,7,9,0.1,0.08737864077669903
"[0, 1, 1, 1, 1, 1, 1, 1, 1, 0, 1, 0, 1, 0, 0]",318,131,187,19,11,0.1450381679389313,0.058823529411764705
"[1, 0, 0, 0, 1, 1, 1, 1, 0, 1, 1, 1, 1, 1, 0]",285,98,187,10,17,0.10204081632653061,0.09090909090909091
"[1, 1, 1, 1, 1, 0, 0, 0, 1, 0, 1, 0, 0, 0, 1]",160,58,102,2,5,0.034482758620689655,0.049019607843137254
"[1, 0, 1, 1, 1, 1, 1, 0, 0, 0, 1, 0, 1, 0, 0]",119,65,54,8,6,0.12307692307692308,0.1111111111111111
"[0, 0, 0, 1, 1, 1, 1, 1, 0, 0, 0, 1, 1, 1, 1]",289,164,125,18,10,0.10975609756097561,0.08
"[1, 0, 1, 1, 0, 1, 0, 0, 0, 0, 1, 1, 1, 1, 1]",313,110,203,3,18,0.02727272727272727,0.08866995073891626
"[0, 0, 1, 1, 1, 1, 1, 0, 1, 0, 1, 1, 0, 1, 1]",266,95,171,7,16,0.07368421052631578,0.0935672514619883
"[1, 1, 0, 0, 1, 1, 1, 1, 1, 0, 1, 0, 1, 1, 0]",315,95,220,12,25,0.12631578947368421,0.11363636363636363
"[0, 1, 0, 1, 0, 1, 0, 0, 0, 1, 1, 1, 0, 0, 1]",133,72,61,4,6,0.05555555555555555,0.09836065573770492
"[1, 1, 0, 0, 0, 0, 0, 1, 1, 1, 1, 0, 1, 0, 0]",151,86,65,10,3,0.11627906976744186,0.046153846153846156
"[0, 0, 1, 1, 1, 0, 0, 1, 0, 1, 0, 0, 1, 0, 1]",113,58,55,3,6,0.05172413793103448,0.10909090909090909
"[1, 0, 0, 0, 0, 0, 1, 1, 1, 1, 0, 1, 1, 0, 0]",154,66,88,6,7,0.09090909090909091,0.07954545454545454
"[1, 1, 0, 1, 0, 1, 1, 0, 0, 0, 1, 1, 1, 1, 1]",349,111,238,11,23,0.0990990990990991,0.09663865546218488
"[1, 0, 0, 1, 1, 1, 0, 1, 0, 1, 1, 0, 0, 0, 1]",118,55,63,4,4,0.07272727272727272,0.06349206349206349
"[1, 0, 1, 0, 1, 0, 0, 1, 1, 1, 0, 1, 0, 1, 1]",152,70,82,8,7,0.11428571428571428,0.08536585365853659
"[1, 0, 0, 0, 1, 1, 1, 0, 0, 0, 1, 0, 1, 1, 0]",112,49,63,2,9,0.04081632653061224,0.14285714285714285
"[0, 1, 0, 0, 1, 1, 0, 0, 1, 1, 0, 0, 0, 1, 1]",161,90,71,5,12,0.05555555555555555,0.16901408450704225
"[1, 0, 0, 1, 0, 1, 0, 0, 1, 1, 0, 0, 1, 1, 0]",184,102,82,9,4,0.08823529411764706,0.04878048780487805
"[0, 0, 0, 1, 1, 1, 0, 1, 1, 0, 1, 0, 0, 1, 0]",102,63,39,5,7,0.07936507936507936,0.1794871794871795
"[1, 1, 0, 0, 0, 0, 1, 1, 1, 0, 0, 0, 1, 0, 1]",146,83,63,9,4,0.10843373493975904,0.06349206349206349
"[0, 0, 0, 0, 1, 1, 1, 0, 0, 1, 1, 1, 0, 0, 1]",186,109,77,10,11,0.09174311926605505,0.14285714285714285
"[1, 1, 0, 1, 0, 0, 1, 0, 1, 1, 1, 0, 1, 0, 0]",111,53,58,7,3,0.1320754716981132,0.05172413793103448
"[1, 0, 1, 0, 1, 0, 1, 1, 0, 1, 0, 0, 0, 0, 1]",114,59,55,5,4,0.0847457627118644,0.07272727272727272
"[1, 0, 0, 1, 1, 1, 1, 1, 1, 1, 0, 1, 0, 1, 0]",306,72,234,6,20,0.08333333333333333,0.08547008547008547
"[0, 1, 0, 1, 0, 1, 1, 1, 0, 0, 0, 1, 0, 1, 1]",98,54,44,9,8,0.16666666666666666,0.18181818181818182
"[1, 1, 0, 0, 0, 0, 0, 0, 1, 0, 0, 1, 1, 0, 0]",389,226,163,18,10,0.07964601769911504,0.06134969325153374
"[1, 0, 0, 1, 1, 0, 1, 1, 1, 0, 0, 0, 0, 0, 0]",247,151,96,11,10,0.0728476821192053,0.10416666666666667
"[1, 0, 1, 1, 0, 1, 0, 1, 1, 1, 1, 1, 1, 0, 0]",382,150,232,8,27,0.05333333333333334,0.11637931034482758
"[1, 0, 1, 1, 1, 1, 0, 0, 1, 0, 0, 0, 0, 0, 1]",147,87,60,5,6,0.05747126436781609,0.1
"[1, 0, 1, 0, 0, 1, 0, 0, 1, 0, 1, 1, 1, 1, 1]",174,72,102,5,9,0.06944444444444445,0.08823529411764706
"[1, 0, 0, 1, 1, 0, 1, 1, 1, 0, 0, 0, 0, 1, 1]",216,86,130,8,12,0.09302325581395349,0.09230769230769231
"[1, 0, 1, 0, 1, 1, 0, 1, 0, 0, 0, 1, 1, 1, 0]",114,54,60,5,4,0.09259259259259259,0.06666666666666667
"[1, 0, 1, 1, 1, 0, 0, 1, 1, 0, 0, 1, 1, 1, 1]",815,289,526,19,63,0.0657439446366782,0.11977186311787072
"[0, 0, 1, 0, 0, 1, 0, 1, 0, 1, 0, 1, 0, 0, 0]",238,161,77,12,9,0.07453416149068323,0.11688311688311688
"[0, 1, 1, 1, 1, 1, 0, 0, 1, 1, 1, 1, 0, 1, 0]",285,103,182,8,17,0.07766990291262135,0.09340659340659341
"[0, 1, 0, 1, 0, 0, 1, 1, 0, 1, 0, 0, 0, 1, 1]",138,70,68,8,10,0.11428571428571428,0.14705882352941177
"[1, 1, 0, 0, 0, 1, 1, 0, 0, 1, 0, 0, 1, 1, 0]",133,77,56,8,5,0.1038961038961039,0.08928571428571429
"[0, 0, 0, 0, 0, 0, 0, 1, 0, 0, 1, 1, 0, 1, 0]",582,409,173,33,12,0.08068459657701711,0.06936416184971098
"[1, 1, 1, 0, 1, 1, 0, 1, 0, 0, 0, 1, 1, 0, 0]",152,76,76,6,10,0.07894736842105263,0.13157894736842105
"[0, 1, 1, 1, 0, 1, 1, 1, 1, 1, 1, 1, 0, 0, 0]",413,164,249,15,28,0.09146341463414634,0.11244979919678715
"[0, 1, 1, 0, 0, 0, 1, 0, 0, 1, 1, 0, 0, 1, 1]",211,129,82,13,6,0.10077519379844961,0.07317073170731707
"[0, 1, 0, 1, 1, 0, 0, 0, 1, 0, 0, 1, 1, 0, 0]",180,113,67,9,6,0.07964601769911504,0.08955223880597014
"[0, 0, 1, 1, 0, 0, 1, 1, 1, 1, 0, 0, 0, 1, 0]",338,182,156,25,16,0.13736263736263737,0.10256410256410256
"[0, 0, 1, 0, 0, 1, 0, 1, 1, 1, 0, 1, 1, 0, 0]",109,67,42,9,3,0.13432835820895522,0.07142857142857142
"[1, 1, 1, 0, 1, 0, 0, 0, 1, 0, 1, 1, 1, 0, 0]",141,68,73,7,6,0.10294117647058823,0.0821917808219178
"[1, 0, 0, 1, 1, 1, 1, 0, 1, 0, 0, 0, 1, 0, 0]",126,61,65,8,3,0.13114754098360656,0.046153846153846156
"[0, 0, 0, 1, 0, 0, 1, 1, 1, 1, 0, 1, 0, 0, 0]",154,90,64,5,6,0.05555555555555555,0.09375
"[0, 0, 0, 0, 0, 0, 1, 1, 1, 0, 1, 0, 0, 1, 1]",279,164,115,18,7,0.10975609756097561,0.06086956521739131
"[1, 0, 0, 0, 0, 0, 0, 1, 1, 1, 0, 1, 0, 0, 1]",203,90,113,8,3,0.08888888888888889,0.02654867256637168
"[1, 0, 0, 1, 0, 1, 1, 1, 0, 0, 0, 1, 0, 1, 0]",111,56,55,6,4,0.10714285714285714,0.07272727272727272
"[1, 1, 0, 1, 1, 1, 1, 0, 0, 1, 0, 1, 1, 1, 0]",244,91,153,9,12,0.0989010989010989,0.0784313725490196
"[1, 0, 0, 0, 1, 1, 0, 1, 0, 0, 0, 1, 0, 0, 1]",146,78,68,4,7,0.05128205128205128,0.10294117647058823
"[0, 1, 0, 1, 0, 1, 0, 1, 0, 1, 1, 1, 0, 0, 0]",103,41,62,3,3,0.07317073170731707,0.04838709677419355
"[1, 1, 0, 0, 0, 0, 1, 0, 1, 0, 1, 1, 0, 0, 1]",156,86,70,8,10,0.09302325581395349,0.14285714285714285
"[0, 1, 1, 1, 1, 0, 0, 0, 0, 1, 0, 1, 0, 1, 1]",204,140,64,14,10,0.1,0.15625
"[0, 1, 0, 0, 0, 0, 1, 0, 1, 1, 0, 1, 0, 0, 0]",239,153,86,13,7,0.08496732026143791,0.08139534883720931
"[0, 0, 0, 1, 1, 0, 0, 0, 1, 0, 0, 1, 1, 1, 0]",178,127,51,19,6,0.14960629921259844,0.11764705882352941
"[1, 0, 1, 1, 1, 1, 0, 1, 0, 1, 0, 1, 1, 0, 0]",160,73,87,8,4,0.1095890410958904,0.04597701149425287
"[1, 0, 0, 1, 0, 1, 1, 1, 1, 0, 1, 0, 1, 0, 1]",166,74,92,8,12,0.10810810810810811,0.13043478260869565
"[0, 1, 1, 1, 1, 0, 0, 1, 0, 0, 0, 0, 0, 0, 0]",464,334,130,25,11,0.0748502994011976,0.08461538461538462
"[1, 1, 0, 0, 1, 0, 1, 0, 1, 0, 0, 1, 0, 1, 0]",102,58,44,3,3,0.05172413793103448,0.06818181818181818
"[0, 1, 1, 1, 0, 0, 1, 0, 1, 0, 1, 0, 0, 1, 0]",103,56,47,7,9,0.125,0.19148936170212766
"[1, 0, 1, 0, 0, 1, 0, 0, 0, 0, 1, 0, 0, 1, 1]",167,96,71,9,1,0.09375,0.014084507042253521
"[1, 1, 0, 0, 0, 0, 1, 1, 1, 0, 1, 0, 1, 1, 0]",182,86,96,7,12,0.08139534883720931,0.125
"[1, 0, 0, 0, 1, 0, 0, 1, 1, 1, 0, 0, 1, 1, 1]",199,85,114,5,8,0.058823529411764705,0.07017543859649122
"[0, 1, 1, 1, 0, 0, 0, 0, 1, 0, 1, 1, 0, 0, 1]",142,86,56,7,4,0.08139534883720931,0.07142857142857142
"[1, 0, 0, 0, 0, 0, 1, 0, 1, 0, 0, 1, 1, 1, 0]",136,71,65,9,13,0.1267605633802817,0.2
"[1, 0, 1, 0, 1, 0, 1, 0, 0, 0, 0, 0, 1, 0, 1]",128,79,49,10,3,0.12658227848101267,0.061224489795918366
"[0, 1, 0, 0, 0, 1, 0, 1, 1, 1, 0, 1, 1, 0, 0]",114,59,55,4,9,0.06779661016949153,0.16363636363636364
"[1, 1, 0, 0, 1, 1, 0, 1, 0, 1, 1, 0, 1, 1, 0]",147,53,94,3,8,0.05660377358490566,0.0851063829787234
"[1, 0, 1, 1, 0, 0, 0, 0, 1, 0, 1, 0, 1, 0, 1]",116,56,60,4,6,0.07142857142857142,0.1
"[0, 0, 1, 0, 1, 1, 0, 0, 0, 0, 1, 0, 1, 0, 1]",137,76,61,7,3,0.09210526315789473,0.04918032786885246
"[0, 0, 0, 1, 0, 1, 1, 0, 0, 0, 0, 1, 0, 1, 0]",252,166,86,13,10,0.0783132530120482,0.11627906976744186
"[0, 0, 0, 0, 1, 0, 0, 0, 1, 1, 0, 0, 0, 1, 0]",582,395,187,34,14,0.08607594936708861,0.0748663101604278
"[0, 1, 1, 0, 1, 1, 0, 1, 1, 1, 0, 1, 1, 0, 1]",201,75,126,3,12,0.04,0.09523809523809523
"[1, 0, 0, 1, 1, 1, 0, 1, 0, 0, 0, 1, 0, 1, 1]",146,70,76,9,5,0.12857142857142856,0.06578947368421052
"[1, 0, 0, 1, 1, 1, 0, 0, 1, 1, 1, 0, 1, 0, 0]",122,56,66,6,9,0.10714285714285714,0.13636363636363635
"[0, 0, 1, 0, 0, 1, 1, 1, 0, 0, 1, 1, 1, 0, 1]",99,56,43,2,5,0.03571428571428571,0.11627906976744186
"[0, 1, 0, 0, 0, 0, 0, 1, 0, 1, 1, 0, 0, 1, 0]",229,158,71,9,7,0.056962025316455694,0.09859154929577464
"[1, 1, 0, 1, 1, 0, 0, 1, 0, 1, 0, 0, 0, 0, 0]",165,103,62,5,5,0.04854368932038835,0.08064516129032258
"[1, 0, 0, 1, 1, 1, 0, 1, 0, 1, 1, 0, 0, 1, 1]",223,66,157,3,22,0.045454545454545456,0.14012738853503184
"[0, 0, 1, 1, 1, 1, 1, 0, 0, 0, 1, 1, 1, 1, 0]",221,93,128,14,10,0.15053763440860216,0.078125
"[1, 0, 1, 0, 1, 0, 1, 1, 1, 0, 1, 1, 0, 0, 0]",114,55,59,4,7,0.07272727272727272,0.11864406779661017
"[0, 1, 0, 1, 1, 0, 1, 0, 0, 1, 0, 0, 0, 1, 0]",145,87,58,4,7,0.04597701149425287,0.1206896551724138
"[1, 0, 1, 0, 1, 0, 0, 1, 1, 0, 0, 0, 0, 0, 1]",206,117,89,13,10,0.1111111111111111,0.11235955056179775
"[1, 1, 1, 0, 0, 0, 0, 1, 0, 1, 1, 0, 1, 0, 1]",112,49,63,4,4,0.08163265306122448,0.06349206349206349
"[1, 1, 1, 1, 0, 0, 0, 0, 1, 0, 1, 1, 0, 1, 0]",121,64,57,5,7,0.078125,0.12280701754385964
"[0, 0, 1, 0, 1, 0, 0, 1, 0, 1, 1, 0, 0, 0, 0]",300,198,102,21,8,0.10606060606060606,0.0784313725490196
"[0, 0, 1, 0, 0, 1, 1, 1, 0, 0, 0, 1, 0, 0, 1]",158,90,68,11,6,0.12222222222222222,0.08823529411764706
"[0, 0, 1, 1, 0, 0, 1, 0, 0, 1, 0, 1, 1, 0, 0]",158,96,62,9,9,0.09375,0.14516129032258066
"[1, 1, 0, 0, 1, 0, 0, 1, 0, 0, 1, 0, 1, 0, 0]",131,74,57,4,5,0.05405405405405406,0.08771929824561403
"[1, 0, 1, 1, 0, 0, 0, 1, 0, 1, 0, 0, 0, 0, 0]",276,173,103,17,10,0.09826589595375723,0.0970873786407767
"[0, 1, 0, 1, 1, 0, 1, 1, 0, 1, 0, 0, 1, 0, 0]",116,69,47,3,6,0.043478260869565216,0.1276595744680851
"[0, 0, 0, 1, 0, 1, 1, 1, 0, 0, 0, 0, 0, 1, 0]",237,165,72,15,8,0.09090909090909091,0.1111111111111111
"[0, 0, 0, 1, 0, 1, 0, 1, 1, 1, 1, 0, 1, 1, 0]",109,57,52,5,3,0.08771929824561403,0.057692307692307696
"[1, 1, 1, 0, 0, 0, 1, 1, 0, 1, 1, 0, 0, 0, 0]",166,88,78,9,11,0.10227272727272728,0.14102564102564102
"[0, 0, 1, 1, 0, 1, 0, 1, 0, 0, 0, 0, 1, 0, 0]",244,159,85,16,6,0.10062893081761007,0.07058823529411765
"[1, 0, 0, 0, 0, 0, 1, 0, 1, 1, 0, 1, 1, 0, 0]",163,90,73,10,11,0.1111111111111111,0.1506849315068493
"[1, 0, 0, 0, 1, 1, 0, 0, 0, 0, 1, 1, 0, 1, 1]",177,95,82,8,8,0.08421052631578947,0.0975609756097561
"[1, 1, 0, 0, 0, 0, 0, 1, 0, 1, 0, 0, 1, 0, 0]",265,167,98,20,6,0.11976047904191617,0.061224489795918366
"[1, 1, 0, 1, 0, 0, 0, 0, 1, 1, 1, 1, 1, 1, 0]",357,150,207,10,15,0.06666666666666667,0.07246376811594203
"[0, 1, 1, 0, 0, 0, 1, 0, 0, 1, 0, 1, 1, 1, 0]",138,80,58,6,5,0.075,0.08620689655172414
"[0, 1, 1, 1, 0, 1, 0, 0, 1, 1, 1, 0, 1, 0, 1]",135,47,88,1,9,0.02127659574468085,0.10227272727272728
"[0, 1, 1, 0, 0, 0, 1, 0, 1, 1, 1, 0, 1, 0, 0]",131,75,56,8,3,0.10666666666666667,0.05357142857142857
"[1, 1, 1, 0, 1, 0, 0, 0, 1, 1, 0, 1, 1, 0, 1]",130,56,74,8,2,0.14285714285714285,0.02702702702702703
"[1, 0, 1, 1, 0, 0, 0, 0, 0, 1, 1, 1, 1, 1, 0]",156,73,83,2,8,0.0273972602739726,0.0963855421686747
"[0, 0, 1, 0, 1, 1, 0, 0, 0, 0, 1, 1, 0, 1, 0]",160,95,65,6,3,0.06315789473684211,0.046153846153846156
"[1, 0, 0, 0, 1, 0, 1, 1, 1, 1, 0, 1, 0, 0, 1]",105,46,59,4,5,0.08695652173913043,0.0847457627118644
"[1, 0, 0, 0, 0, 1, 0, 1, 0, 0, 1, 1, 0, 0, 1]",220,117,103,13,12,0.1111111111111111,0.11650485436893204
"[0, 0, 1, 0, 1, 0, 0, 0, 0, 1, 1, 1, 1, 0, 0]",391,239,152,19,15,0.0794979079497908,0.09868421052631579
"[0, 1, 0, 0, 0, 1, 0, 0, 1, 0, 1, 0, 0, 0, 0]",561,393,168,39,9,0.09923664122137404,0.05357142857142857
"[1, 1, 1, 1, 1, 1, 0, 0, 1, 0, 0, 1, 0, 1, 0]",188,78,110,5,10,0.0641025641025641,0.09090909090909091
"[0, 1, 0, 0, 1, 0, 1, 1, 0, 0, 0, 0, 0, 1, 1]",190,116,74,7,5,0.0603448275862069,0.06756756756756757
"[0, 1, 0, 0, 0, 1, 0, 0, 1, 1, 1, 1, 1, 0, 0]",128,74,54,5,4,0.06756756756756757,0.07407407407407407
"[0, 1, 0, 1, 1, 1, 1, 1, 0, 1, 0, 1, 1, 1, 0]",234,82,152,8,21,0.0975609756097561,0.13815789473684212
"[1, 0, 1, 0, 1, 1, 0, 1, 1, 0, 0, 1, 0, 1, 1]",139,49,90,5,8,0.10204081632653061,0.08888888888888889
"[0, 1, 1, 0, 0, 0, 0, 0, 0, 0, 1, 0, 1, 1, 0]",290,208,82,18,4,0.08653846153846154,0.04878048780487805
"[0, 1, 0, 1, 1, 0, 1, 1, 1, 1, 0, 0, 1, 0, 1]",171,79,92,4,6,0.05063291139240506,0.06521739130434782
"[0, 1, 1, 0, 0, 1, 0, 1, 1, 1, 1, 1, 0, 0, 0]",136,69,67,10,9,0.14492753623188406,0.13432835820895522
"[1, 0, 1, 1, 0, 0, 0, 1, 0, 1, 1, 0, 0, 0, 0]",194,112,82,15,6,0.13392857142857142,0.07317073170731707
"[0, 0, 1, 1, 0, 0, 1, 0, 1, 1, 0, 0, 0, 1, 0]",149,84,65,6,2,0.07142857142857142,0.03076923076923077
"[1, 0, 0, 1, 0, 1, 1, 0, 1, 1, 0, 1, 1, 0, 0]",116,57,59,5,5,0.08771929824561403,0.0847457627118644
"[0, 1, 1, 0, 1, 0, 1, 1, 0, 1, 0, 0, 0, 1, 0]",125,64,61,5,6,0.078125,0.09836065573770492
"[1, 0, 0, 0, 1, 1, 0, 1, 1, 1, 0, 0, 1, 1, 0]",154,59,95,7,17,0.11864406779661017,0.17894736842105263
"[1, 1, 1, 1, 0, 0, 0, 1, 1, 1, 0, 1, 0, 1, 1]",299,115,184,14,17,0.12173913043478261,0.09239130434782608
"[1, 1, 1, 0, 1, 1, 0, 0, 0, 1, 0, 1, 0, 1, 0]",96,44,52,2,4,0.045454545454545456,0.07692307692307693
"[1, 0, 0, 0, 1, 1, 0, 1, 0, 0, 0, 0, 0, 0, 1]",289,187,102,22,7,0.11764705882352941,0.06862745098039216
"[0, 0, 1, 1, 0, 1, 1, 0, 1, 1, 1, 0, 0, 1, 0]",117,54,63,4,5,0.07407407407407407,0.07936507936507936
"[0, 0, 0, 0, 0, 1, 1, 1, 1, 0, 0, 1, 0, 0, 1]",369,274,95,26,8,0.0948905109489051,0.08421052631578947
"[0, 1, 0, 0, 1, 0, 0, 1, 0, 0, 1, 0, 1, 1, 0]",129,79,50,6,3,0.0759493670886076,0.06
"[0, 0, 1, 0, 0, 1, 1, 1, 1, 0, 0, 1, 0, 0, 1]",139,76,63,6,5,0.07894736842105263,0.07936507936507936
"[0, 0, 0, 1, 0, 0, 1, 1, 1, 1, 0, 0, 1, 0, 0]",174,105,69,14,8,0.13333333333333333,0.11594202898550725
"[1, 1, 0, 1, 0, 1, 0, 1, 0, 0, 0, 1, 1, 1, 1]",186,78,108,9,13,0.11538461538461539,0.12037037037037036
"[0, 1, 0, 0, 1, 0, 0, 1, 0, 0, 0, 0, 1, 0, 1]",242,149,93,16,9,0.10738255033557047,0.0967741935483871
"[0, 0, 1, 1, 1, 1, 0, 1, 0, 0, 0, 0, 1, 1, 0]",171,104,67,13,7,0.125,0.1044776119402985
"[1, 0, 0, 1, 1, 0, 0, 0, 0, 0, 0, 1, 0, 1, 1]",350,116,234,8,28,0.06896551724137931,0.11965811965811966
"[1, 1, 0, 1, 0, 1, 0, 0, 1, 1, 0, 1, 1, 1, 1]",268,95,173,6,9,0.06315789473684211,0.05202312138728324
"[0, 0, 1, 0, 1, 0, 1, 0, 1, 1, 0, 0, 0, 1, 1]",135,73,62,6,11,0.0821917808219178,0.1774193548387097
"[0, 1, 0, 1, 0, 1, 1, 1, 0, 1, 1, 1, 1, 1, 0]",276,99,177,8,15,0.08080808080808081,0.0847457627118644
"[1, 1, 0, 0, 1, 0, 1, 1, 0, 1, 0, 1, 0, 1, 0]",92,44,48,3,5,0.06818181818181818,0.10416666666666667
"[1, 1, 1, 0, 1, 1, 1, 1, 0, 1, 0, 1, 1, 1, 0]",543,161,382,9,36,0.055900621118012424,0.09424083769633508
"[1, 0, 1, 1, 0, 0, 1, 1, 1, 1, 0, 0, 0, 0, 1]",431,182,249,16,24,0.08791208791208792,0.0963855421686747
"[1, 0, 0, 1, 0, 1, 0, 1, 0, 1, 1, 1, 1, 1, 0]",152,62,90,6,7,0.0967741935483871,0.07777777777777778
"[0, 0, 1, 0, 0, 0, 1, 0, 1, 1, 1, 0, 1, 0, 0]",127,71,56,3,8,0.04225352112676056,0.14285714285714285
"[1, 0, 0, 0, 0, 0, 0, 0, 0, 1, 1, 1, 0, 1, 0]",378,188,190,15,21,0.0797872340425532,0.11052631578947368
"[1, 0, 0, 1, 1, 1, 0, 0, 0, 0, 1, 1, 1, 1, 0]",291,136,155,16,10,0.11764705882352941,0.06451612903225806
"[1, 0, 1, 0, 0, 0, 1, 1, 0, 1, 0, 0, 1, 1, 1]",140,69,71,4,5,0.057971014492753624,0.07042253521126761
"[1, 1, 0, 0, 1, 0, 1, 1, 0, 1, 0, 0, 0, 1, 1]",124,53,71,3,7,0.05660377358490566,0.09859154929577464
"[1, 0, 0, 0, 1, 0, 1, 0, 1, 0, 1, 1, 1, 1, 1]",187,69,118,4,15,0.057971014492753624,0.1271186440677966
"[1, 1, 0, 1, 1, 0, 1, 0, 1, 0, 0, 1, 1, 1, 0]",163,60,103,3,14,0.05,0.13592233009708737
"[0, 1, 0, 1, 1, 0, 1, 1, 0, 0, 0, 0, 1, 1, 0]",188,97,91,9,11,0.09278350515463918,0.12087912087912088
"[0, 1, 1, 1, 0, 1, 1, 0, 1, 0, 0, 1, 1, 0, 1]",156,77,79,7,4,0.09090909090909091,0.05063291139240506
"[0, 0, 1, 1, 0, 0, 0, 0, 1, 0, 1, 1, 0, 0, 1]",196,114,82,9,6,0.07894736842105263,0.07317073170731707
"[0, 0, 0, 1, 1, 0, 0, 0, 1, 0, 1, 0, 1, 0, 0]",281,189,92,18,10,0.09523809523809523,0.10869565217391304
"[1, 1, 0, 0, 0, 1, 0, 0, 0, 0, 1, 1, 1, 1, 1]",246,128,118,10,14,0.078125,0.11864406779661017
"[1, 1, 1, 1, 0, 0, 0, 1, 0, 0, 0, 0, 1, 1, 1]",236,113,123,10,10,0.08849557522123894,0.08130081300813008
"[1, 1, 0, 0, 1, 1, 0, 0, 1, 1, 1, 0, 1, 1, 0]",225,101,124,11,11,0.10891089108910891,0.08870967741935484
"[1, 1, 1, 1, 1, 0, 0, 1, 0, 0, 0, 1, 0, 0, 0]",144,63,81,10,13,0.15873015873015872,0.16049382716049382
"[1, 0, 0, 0, 0, 0, 0, 1, 0, 0, 1, 1, 1, 1, 1]",325,131,194,10,16,0.07633587786259542,0.08247422680412371
"[0, 1, 0, 0, 1, 0, 0, 0, 0, 0, 0, 1, 0, 0, 1]",547,379,168,33,18,0.0870712401055409,0.10714285714285714
"[0, 1, 1, 0, 1, 0, 1, 0, 0, 1, 1, 0, 0, 1, 1]",204,102,102,9,13,0.08823529411764706,0.12745098039215685
"[1, 0, 0, 0, 1, 1, 0, 0, 0, 1, 1, 0, 0, 0, 0]",420,258,162,22,15,0.08527131782945736,0.09259259259259259
"[0, 1, 0, 0, 0, 1, 1, 0, 0, 0, 1, 1, 0, 0, 0]",347,236,111,26,7,0.11016949152542373,0.06306306306306306
"[0, 0, 1, 1, 0, 0, 1, 1, 1, 1, 0, 1, 0, 0, 1]",222,106,116,10,11,0.09433962264150944,0.09482758620689655
"[0, 0, 0, 1, 1, 0, 0, 1, 1, 1, 1, 0, 1, 0, 0]",229,163,66,18,11,0.11042944785276074,0.16666666666666666
"[1, 0, 0, 0, 0, 1, 1, 0, 1, 1, 0, 1, 1, 0, 1]",119,45,74,2,3,0.044444444444444446,0.04054054054054054
"[1, 1, 1, 0, 0, 0, 0, 1, 1, 1, 1, 0, 1, 1, 0]",293,78,215,8,22,0.10256410256410256,0.10232558139534884
"[0, 1, 1, 1, 0, 1, 0, 0, 0, 1, 1, 1, 1, 1, 1]",422,184,238,15,23,0.08152173913043478,0.09663865546218488
"[0, 1, 0, 1, 0, 0, 0, 0, 0, 0, 1, 1, 0, 1, 0]",249,169,80,17,5,0.10059171597633136,0.0625
"[1, 1, 0, 1, 0, 1, 1, 1, 0, 0, 1, 1, 1, 1, 0]",346,129,217,15,21,0.11627906976744186,0.0967741935483871
"[1, 1, 0, 0, 0, 1, 0, 0, 1, 0, 1, 1, 0, 1, 1]",132,70,62,4,5,0.05714285714285714,0.08064516129032258
"[0, 0, 1, 1, 1, 1, 1, 0, 1, 0, 0, 0, 1, 1, 0]",154,67,87,7,8,0.1044776119402985,0.09195402298850575
"[1, 1, 1, 0, 0, 0, 0, 1, 0, 1, 1, 0, 0, 0, 0]",230,112,118,5,12,0.044642857142857144,0.1016949152542373
"[0, 1, 1, 1, 1, 0, 0, 1, 1, 1, 0, 0, 0, 0, 1]",223,124,99,14,8,0.11290322580645161,0.08080808080808081
"[0, 0, 0, 0, 0, 0, 1, 0, 0, 1, 1, 0, 0, 1, 1]",619,435,184,48,16,0.1103448275862069,0.08695652173913043
"[0, 0, 0, 0, 0, 1, 1, 0, 1, 0, 0, 1, 0, 0, 1]",319,228,91,23,6,0.10087719298245613,0.06593406593406594
"[1, 0, 0, 1, 0, 1, 1, 0, 1, 0, 0, 0, 0, 0, 1]",155,93,62,8,3,0.08602150537634409,0.04838709677419355
"[1, 0, 1, 1, 0, 0, 0, 0, 0, 1, 1, 0, 0, 1, 1]",279,148,131,9,11,0.060810810810810814,0.08396946564885496
"[0, 1, 1, 0, 0, 0, 1, 0, 1, 1, 0, 0, 1, 0, 0]",132,78,54,10,5,0.1282051282051282,0.09259259259259259
"[0, 0, 1, 1, 1, 0, 0, 1, 1, 1, 0, 0, 1, 1, 0]",160,92,68,13,8,0.14130434782608695,0.11764705882352941
"[0, 1, 0, 1, 1, 0, 0, 0, 1, 0, 1, 0, 1, 1, 1]",125,63,62,4,8,0.06349206349206349,0.12903225806451613
"[1, 1, 0, 0, 0, 1, 0, 1, 1, 1, 1, 0, 1, 1, 1]",316,121,195,17,20,0.14049586776859505,0.10256410256410256
"[0, 1, 0, 1, 1, 0, 0, 0, 1, 0, 0, 1, 0, 0, 0]",255,173,82,15,6,0.08670520231213873,0.07317073170731707
"[0, 1, 1, 0, 1, 0, 1, 0, 1, 1, 0, 1, 0, 0, 1]",104,44,60,4,2,0.09090909090909091,0.03333333333333333
"[1, 0, 0, 0, 0, 1, 1, 1, 1, 1, 0, 0, 1, 1, 0]",240,97,143,8,13,0.08247422680412371,0.09090909090909091
"[1, 0, 1, 1, 1, 0, 0, 0, 0, 1, 1, 1, 1, 1, 0]",212,84,128,10,8,0.11904761904761904,0.0625
"[1, 1, 0, 0, 1, 0, 0, 1, 1, 1, 0, 1, 1, 1, 0]",167,77,90,8,8,0.1038961038961039,0.08888888888888889
"[1, 0, 0, 1, 1, 1, 1, 0, 0, 0, 0, 1, 0, 0, 0]",255,98,157,11,10,0.11224489795918367,0.06369426751592357
"[0, 0, 1, 0, 1, 1, 1, 0, 0, 1, 0, 1, 0, 0, 1]",112,60,52,9,5,0.15,0.09615384615384616
"[0, 1, 0, 1, 1, 0, 0, 1, 0, 0, 0, 0, 0, 0, 1]",293,200,93,18,9,0.09,0.0967741935483871
"[0, 1, 0, 0, 1, 0, 0, 1, 0, 0, 1, 0, 1, 0, 1]",130,72,58,11,4,0.1527777777777778,0.06896551724137931
"[1, 0, 0, 1, 1, 0, 1, 0, 0, 0, 1, 0, 0, 0, 0]",259,152,107,11,12,0.07236842105263158,0.11214953271028037
"[1, 0, 1, 0, 0, 1, 0, 0, 1, 1, 0, 1, 0, 0, 0]",146,77,69,9,5,0.11688311688311688,0.07246376811594203
"[1, 1, 0, 0, 1, 0, 1, 0, 1, 0, 0, 0, 1, 1, 0]",113,56,57,4,8,0.07142857142857142,0.14035087719298245
"[1, 0, 1, 1, 1, 0, 1, 0, 0, 1, 0, 0, 0, 1, 0]",102,55,47,9,4,0.16363636363636364,0.0851063829787234
"[0, 1, 1, 1, 0, 0, 1, 0, 1, 1, 1, 1, 0, 1, 1]",229,75,154,9,23,0.12,0.14935064935064934
"[0, 1, 0, 0, 1, 0, 1, 0, 0, 1, 0, 1, 0, 0, 0]",221,144,77,8,9,0.05555555555555555,0.11688311688311688
"[0, 0, 1, 0, 1, 0, 1, 1, 0, 0, 0, 0, 0, 1, 1]",224,140,84,16,5,0.11428571428571428,0.05952380952380952
"[1, 1, 0, 0, 1, 1, 1, 0, 1, 1, 0, 0, 0, 0, 1]",194,98,96,5,8,0.05102040816326531,0.08333333333333333
"[0, 0, 1, 1, 1, 0, 0, 1, 1, 0, 1, 1, 1, 1, 0]",149,61,88,2,13,0.03278688524590164,0.14772727272727273
"[1, 1, 1, 1, 1, 0, 1, 0, 1, 0, 1, 0, 0, 1, 1]",285,96,189,11,21,0.11458333333333333,0.1111111111111111
"[1, 0, 0, 1, 0, 0, 0, 1, 0, 1, 0, 0, 1, 1, 1]",157,78,79,8,8,0.10256410256410256,0.10126582278481013
"[1, 0, 1, 1, 1, 1, 0, 0, 1, 0, 1, 0, 1, 0, 0]",110,55,55,4,8,0.07272727272727272,0.14545454545454545
"[0, 0, 1, 1, 1, 1, 1, 0, 0, 0, 0, 1, 1, 1, 0]",164,81,83,10,6,0.12345679012345678,0.07228915662650602
"[0, 0, 1, 0, 0, 0, 1, 1, 0, 1, 1, 1, 0, 1, 0]",93,52,41,5,4,0.09615384615384616,0.0975609756097561
"[0, 0, 1, 0, 1, 1, 1, 0, 1, 1, 1, 1, 0, 0, 0]",143,68,75,10,7,0.14705882352941177,0.09333333333333334
"[1, 1, 1, 0, 1, 1, 1, 0, 1, 0, 0, 0, 1, 0, 0]",104,47,57,10,9,0.2127659574468085,0.15789473684210525
"[0, 1, 0, 0, 0, 1, 0, 0, 0, 0, 1, 0, 0, 1, 1]",262,183,79,16,6,0.08743169398907104,0.0759493670886076
"[1, 0, 0, 0, 1, 0, 1, 0, 1, 1, 0, 0, 0, 0, 1]",173,86,87,10,6,0.11627906976744186,0.06896551724137931
"[0, 1, 0, 0, 0, 1, 0, 1, 0, 1, 1, 0, 0, 0, 0]",237,156,81,12,8,0.07692307692307693,0.09876543209876543
"[1, 1, 0, 0, 0, 1, 0, 1, 0, 0, 1, 0, 1, 0, 0]",132,78,54,10,4,0.1282051282051282,0.07407407407407407
"[0, 1, 0, 0, 1, 0, 0, 0, 1, 0, 0, 1, 0, 1, 0]",247,163,84,17,16,0.10429447852760736,0.19047619047619047
"[1, 1, 1, 0, 0, 1, 0, 1, 1, 0, 0, 1, 1, 0, 1]",150,55,95,6,5,0.10909090909090909,0.05263157894736842
"[1, 0, 0, 0, 0, 1, 1, 1, 0, 0, 0, 1, 0, 0, 0]",275,161,114,15,10,0.09316770186335403,0.08771929824561403
"[0, 0, 0, 1, 1, 1, 1, 1, 1, 0, 0, 1, 1, 0, 1]",406,285,121,30,10,0.10526315789473684,0.08264462809917356
"[1, 0, 0, 1, 1, 1, 0, 1, 0, 0, 1, 0, 1, 0, 1]",110,53,57,7,5,0.1320754716981132,0.08771929824561403
"[1, 0, 1, 0, 1, 0, 0, 1, 0, 1, 1, 1, 1, 1, 0]",156,69,87,3,6,0.043478260869565216,0.06896551724137931
"[0, 1, 1, 0, 1, 0, 1, 0, 0, 1, 0, 1, 1, 1, 1]",173,68,105,9,11,0.1323529411764706,0.10476190476190476
"[0, 0, 0, 1, 0, 1, 1, 0, 0, 1, 0, 1, 1, 1, 0]",122,68,54,8,2,0.11764705882352941,0.037037037037037035
"[1, 1, 1, 0, 1, 0, 0, 0, 0, 0, 1, 0, 1, 1, 0]",119,63,56,10,5,0.15873015873015872,0.08928571428571429
"[1, 1, 1, 1, 0, 1, 1, 1, 0, 0, 1, 1, 0, 0, 0]",279,92,187,11,11,0.11956521739130435,0.058823529411764705
"[0, 0, 1, 0, 1, 1, 0, 0, 1, 1, 0, 1, 0, 1, 1]",121,53,68,6,7,0.11320754716981132,0.10294117647058823
"[0, 1, 1, 0, 1, 1, 0, 1, 1, 1, 1, 0, 1, 1, 1]",548,198,350,15,38,0.07575757575757576,0.10857142857142857
"[1, 1, 1, 1, 1, 1, 0, 0, 0, 0, 1, 1, 1, 0, 0]",440,190,250,19,25,0.1,0.1
"[1, 1, 1, 0, 1, 0, 0, 1, 1, 0, 1, 1, 1, 0, 0]",175,55,120,3,7,0.05454545454545454,0.058333333333333334
"[0, 0, 0, 0, 0, 1, 1, 0, 0, 0, 1, 1, 0, 1, 1]",283,206,77,20,6,0.0970873786407767,0.07792207792207792
"[0, 1, 0, 1, 1, 0, 1, 0, 0, 0, 1, 1, 0, 0, 0]",184,108,76,12,6,0.1111111111111111,0.07894736842105263
"[1, 1, 1, 0, 0, 1, 1, 1, 0, 1, 0, 0, 0, 1, 1]",220,84,136,12,12,0.14285714285714285,0.08823529411764706
"[1, 1, 1, 0, 0, 0, 1, 1, 1, 1, 1, 1, 0, 0, 0]",457,163,294,13,29,0.07975460122699386,0.09863945578231292
"[1, 0, 0, 1, 0, 0, 0, 0, 1, 0, 0, 1, 0, 1, 0]",235,144,91,12,8,0.08333333333333333,0.08791208791208792
"[1, 0, 1, 1, 1, 0, 1, 0, 1, 0, 1, 1, 1, 1, 0]",264,100,164,8,20,0.08,0.12195121951219512
"[0, 1, 1, 0, 1, 0, 0, 1, 0, 0, 1, 1, 1, 1, 0]",133,63,70,3,4,0.047619047619047616,0.05714285714285714
"[0, 0, 0, 1, 0, 1, 1, 0, 1, 0, 0, 1, 0, 0, 1]",128,76,52,10,5,0.13157894736842105,0.09615384615384616
"[0, 0, 1, 1, 0, 1, 1, 0, 0, 0, 1, 1, 1, 1, 1]",269,122,147,10,17,0.08196721311475409,0.11564625850340136
"[1, 1, 1, 0, 1, 1, 0, 1, 0, 0, 0, 1, 0, 0, 1]",91,41,50,10,5,0.24390243902439024,0.1
"[1, 1, 0, 1, 0, 1, 1, 1, 0, 0, 1, 0, 0, 0, 0]",148,79,69,10,4,0.12658227848101267,0.057971014492753624
"[1, 1, 1, 0, 1, 0, 1, 1, 1, 0, 0, 1, 0, 0, 0]",117,62,55,8,3,0.12903225806451613,0.05454545454545454
"[0, 1, 1, 1, 0, 1, 0, 1, 1, 1, 0, 0, 1, 0, 0]",134,60,74,9,9,0.15,0.12162162162162163
"[1, 0, 1, 0, 1, 1, 1, 0, 1, 0, 1, 1, 1, 0, 0]",154,62,92,6,9,0.0967741935483871,0.09782608695652174
"[1, 0, 1, 0, 1, 0, 1, 1, 0, 0, 1, 1, 1, 0, 1]",147,62,85,4,8,0.06451612903225806,0.09411764705882353
"[1, 1, 0, 0, 0, 1, 0, 1, 0, 0, 0, 0, 1, 1, 1]",215,114,101,10,17,0.08771929824561403,0.16831683168316833
"[1, 1, 1, 0, 0, 0, 1, 0, 1, 0, 0, 0, 0, 1, 1]",179,72,107,4,15,0.05555555555555555,0.14018691588785046
"[1, 1, 0, 1, 1, 0, 1, 1, 0, 0, 0, 1, 1, 0, 0]",140,66,74,3,8,0.045454545454545456,0.10810810810810811
"[0, 1, 1, 0, 0, 1, 0, 0, 1, 1, 1, 0, 0, 1, 0]",145,82,63,8,7,0.0975609756097561,0.1111111111111111
"[1, 1, 0, 0, 0, 0, 0, 0, 0, 1, 1, 0, 1, 0, 0]",297,182,115,15,12,0.08241758241758242,0.10434782608695652
"[0, 0, 0, 0, 0, 0, 1, 1, 0, 1, 1, 0, 1, 0, 0]",295,189,106,14,5,0.07407407407407407,0.04716981132075472
"[1, 0, 1, 1, 0, 1, 0, 0, 1, 1, 1, 0, 1, 0, 0]",114,59,55,3,4,0.05084745762711865,0.07272727272727272
"[0, 1, 0, 0, 1, 0, 1, 0, 1, 1, 0, 1, 0, 0, 1]",87,51,36,6,1,0.11764705882352941,0.027777777777777776
"[1, 0, 1, 1, 1, 1, 0, 1, 1, 1, 0, 0, 1, 1, 0]",281,101,180,9,16,0.0891089108910891,0.08888888888888889
"[0, 1, 0, 1, 1, 0, 1, 1, 0, 0, 0, 0, 1, 1, 1]",215,105,110,6,12,0.05714285714285714,0.10909090909090909
"[0, 0, 1, 0, 1, 0, 1, 1, 1, 1, 1, 1, 1, 0, 1]",256,94,162,6,13,0.06382978723404255,0.08024691358024691
"[0, 0, 0, 0, 0, 1, 1, 1, 0, 0, 1, 1, 0, 1, 1]",175,105,70,15,7,0.14285714285714285,0.1
"[0, 1, 0, 0, 0, 0, 1, 0, 0, 0, 0, 1, 1, 0, 1]",222,151,71,17,4,0.11258278145695365,0.056338028169014086
"[1, 0, 0, 0, 0, 1, 1, 0, 1, 0, 1, 0, 0, 0, 1]",175,99,76,8,10,0.08080808080808081,0.13157894736842105
"[0, 1, 0, 0, 0, 1, 0, 1, 1, 0, 1, 1, 0, 0, 0]",166,113,53,10,6,0.08849557522123894,0.11320754716981132
"[1, 1, 0, 0, 1, 0, 0, 0, 1, 0, 0, 1, 1, 0, 0]",207,123,84,19,10,0.15447154471544716,0.11904761904761904
"[0, 1, 0, 1, 0, 0, 1, 0, 0, 0, 0, 1, 1, 1, 0]",158,95,63,4,4,0.042105263157894736,0.06349206349206349
"[0, 1, 0, 0, 1, 1, 1, 1, 0, 1, 0, 0, 1, 1, 0]",114,57,57,5,12,0.08771929824561403,0.21052631578947367
"[0, 0, 1, 1, 1, 0, 1, 0, 0, 0, 1, 0, 0, 1, 1]",148,86,62,14,6,0.16279069767441862,0.0967741935483871
"[0, 1, 1, 1, 1, 1, 1, 0, 0, 1, 0, 1, 0, 0, 0]",164,101,63,18,1,0.1782178217821782,0.015873015873015872
"[0, 0, 0, 1, 1, 0, 0, 0, 0, 0, 1, 1, 0, 1, 0]",325,231,94,19,12,0.08225108225108226,0.1276595744680851
"[0, 1, 0, 0, 0, 0, 1, 1, 1, 0, 1, 0, 1, 1, 1]",153,66,87,7,7,0.10606060606060606,0.08045977011494253
"[1, 0, 1, 0, 0, 1, 1, 0, 1, 0, 0, 0, 0, 1, 1]",130,68,62,4,5,0.058823529411764705,0.08064516129032258
"[0, 0, 0, 1, 1, 0, 1, 0, 0, 1, 0, 1, 0, 0, 1]",152,98,54,8,7,0.08163265306122448,0.12962962962962962
"[0, 0, 0, 0, 0, 1, 1, 0, 1, 0, 0, 1, 0, 1, 0]",269,186,83,20,9,0.10752688172043011,0.10843373493975904
"[1, 0, 1, 0, 0, 1, 1, 0, 0, 0, 0, 0, 1, 1, 0]",202,125,77,13,7,0.104,0.09090909090909091
"[1, 0, 0, 0, 1, 1, 1, 0, 1, 1, 1, 1, 0, 0, 0]",178,87,91,8,7,0.09195402298850575,0.07692307692307693
"[0, 1, 0, 1, 0, 1, 0, 0, 0, 1, 0, 0, 0, 0, 1]",245,161,84,8,11,0.049689440993788817,0.13095238095238096
"[1, 0, 1, 0, 0, 1, 1, 0, 1, 1, 0, 0, 0, 0, 0]",195,111,84,6,6,0.05405405405405406,0.07142857142857142
"[0, 0, 0, 1, 0, 1, 0, 0, 1, 0, 1, 1, 0, 0, 1]",161,99,62,11,3,0.1111111111111111,0.04838709677419355
"[1, 1, 0, 0, 0, 1, 0, 1, 0, 0, 1, 0, 1, 1, 0]",97,49,48,4,6,0.08163265306122448,0.125
"[0, 1, 1, 0, 1, 0, 0, 1, 0, 1, 1, 1, 1, 0, 1]",138,60,78,5,5,0.08333333333333333,0.0641025641025641
"[1, 0, 0, 1, 0, 1, 1, 1, 0, 1, 1, 0, 0, 1, 1]",192,77,115,4,16,0.05194805194805195,0.1391304347826087
"[0, 1, 1, 1, 1, 0, 1, 1, 0, 1, 1, 0, 1, 0, 1]",219,92,127,4,11,0.043478260869565216,0.08661417322834646
"[0, 1, 0, 0, 1, 1, 0, 1, 1, 0, 1, 0, 1, 0, 1]",104,43,61,4,6,0.09302325581395349,0.09836065573770492
"[1, 0, 0, 0, 0, 0, 0, 0, 1, 0, 0, 1, 1, 0, 1]",288,180,108,15,9,0.08333333333333333,0.08333333333333333
"[1, 1, 1, 0, 0, 0, 0, 1, 1, 0, 0, 0, 0, 1, 0]",372,120,252,21,25,0.175,0.0992063492063492
"[0, 0, 1, 0, 1, 1, 0, 1, 1, 1, 0, 0, 0, 1, 1]",125,63,62,10,6,0.15873015873015872,0.0967741935483871
"[0, 1, 1, 0, 1, 0, 0, 0, 0, 1, 1, 1, 1, 1, 1]",384,162,222,12,22,0.07407407407407407,0.0990990990990991
"[1, 1, 1, 0, 0, 0, 0, 0, 0, 0, 1, 0, 1, 0, 0]",321,166,155,14,18,0.08433734939759036,0.11612903225806452
"[1, 0, 1, 1, 0, 1, 1, 1, 0, 0, 0, 0, 0, 0, 0]",264,151,113,9,9,0.059602649006622516,0.07964601769911504
"[0, 1, 1, 1, 0, 0, 0, 0, 1, 0, 1, 1, 1, 1, 1]",200,77,123,3,10,0.03896103896103896,0.08130081300813008
"[0, 1, 0, 0, 0, 0, 0, 0, 0, 1, 1, 0, 0, 0, 1]",680,476,204,47,21,0.09873949579831932,0.10294117647058823
"[1, 0, 1, 1, 1, 1, 0, 0, 1, 0, 1, 1, 0, 1, 1]",234,89,145,6,10,0.06741573033707865,0.06896551724137931
"[0, 0, 1, 1, 1, 1, 1, 1, 1, 1, 0, 1, 0, 0, 0]",260,111,149,11,12,0.0990990990990991,0.08053691275167785
"[1, 1, 1, 1, 0, 1, 1, 0, 0, 1, 0, 1, 1, 1, 0]",213,79,134,7,14,0.08860759493670886,0.1044776119402985
"[1, 0, 0, 1, 1, 0, 1, 0, 1, 0, 1, 1, 0, 0, 0]",148,58,90,6,10,0.10344827586206896,0.1111111111111111
"[1, 1, 0, 0, 0, 0, 1, 1, 0, 1, 1, 1, 1, 0, 0]",201,85,116,11,16,0.12941176470588237,0.13793103448275862
"[1, 0, 1, 1, 0, 1, 0, 0, 1, 0, 1, 1, 0, 1, 0]",114,45,69,2,8,0.044444444444444446,0.11594202898550725
"[1, 1, 1, 1, 0, 0, 0, 0, 1, 0, 0, 1, 1, 0, 1]",163,75,88,5,9,0.06666666666666667,0.10227272727272728
"[0, 0, 1, 1, 0, 1, 1, 0, 1, 1, 1, 0, 1, 0, 0]",109,49,60,5,5,0.10204081632653061,0.08333333333333333
"[0, 1, 0, 1, 1, 0, 0, 0, 1, 1, 1, 1, 1, 0, 0]",145,69,76,5,7,0.07246376811594203,0.09210526315789473
"[0, 0, 1, 0, 1, 1, 0, 0, 0, 1, 1, 1, 1, 1, 0]",128,52,76,5,11,0.09615384615384616,0.14473684210526316
"[0, 0, 1, 1, 0, 1, 0, 1, 1, 1, 1, 0, 0, 1, 0]",106,47,59,3,10,0.06382978723404255,0.1694915254237288
"[0, 1, 0, 0, 0, 1, 0, 1, 1, 1, 0, 0, 1, 1, 1]",172,77,95,12,12,0.15584415584415584,0.12631578947368421
"[0, 1, 1, 0, 0, 0, 0, 0, 1, 0, 1, 1, 1, 0, 1]",125,80,45,6,4,0.075,0.08888888888888889
"[1, 0, 0, 1, 1, 0, 1, 0, 1, 1, 1, 1, 1, 0, 0]",199,74,125,7,11,0.0945945945945946,0.088
"[0, 0, 0, 1, 0, 1, 0, 1, 0, 1, 0, 1, 1, 0, 1]",98,57,41,5,2,0.08771929824561403,0.04878048780487805
"[1, 1, 1, 0, 0, 0, 1, 1, 1, 1, 0, 0, 1, 1, 0]",348,128,220,13,11,0.1015625,0.05
"[0, 0, 1, 0, 1, 1, 1, 1, 0, 0, 1, 0, 1, 1, 0]",109,53,56,3,3,0.05660377358490566,0.05357142857142857
"[0, 1, 1, 1, 0, 0, 1, 0, 0, 0, 0, 1, 1, 1, 1]",247,140,107,9,9,0.06428571428571428,0.08411214953271028
"[0, 0, 1, 1, 1, 0, 0, 0, 1, 0, 1, 1, 0, 1, 0]",108,61,47,4,3,0.06557377049180328,0.06382978723404255
"[1, 1, 0, 0, 1, 1, 0, 0, 1, 1, 0, 1, 1, 0, 0]",221,98,123,8,13,0.08163265306122448,0.10569105691056911
"[0, 1, 1, 0, 1, 0, 1, 0, 0, 1, 1, 0, 0, 0, 1]",99,63,36,8,6,0.12698412698412698,0.16666666666666666
"[0, 1, 0, 0, 1, 1, 1, 1, 1, 1, 0, 1, 0, 1, 1]",272,93,179,7,17,0.07526881720430108,0.09497206703910614
"[1, 0, 1, 0, 1, 1, 0, 1, 0, 1, 1, 0, 1, 0, 0]",104,43,61,6,4,0.13953488372093023,0.06557377049180328
"[1, 0, 0, 1, 0, 1, 1, 0, 1, 0, 1, 1, 0, 1, 0]",127,58,69,4,10,0.06896551724137931,0.14492753623188406
"[1, 1, 0, 0, 0, 0, 0, 1, 1, 0, 0, 1, 1, 0, 1]",175,97,78,9,6,0.09278350515463918,0.07692307692307693
"[0, 0, 0, 1, 1, 1, 0, 0, 1, 1, 0, 1, 0, 1, 0]",111,53,58,7,6,0.1320754716981132,0.10344827586206896
"[0, 0, 1, 0, 0, 0, 1, 0, 1, 0, 1, 0, 1, 0, 0]",206,127,79,14,2,0.11023622047244094,0.02531645569620253
"[0, 0, 0, 0, 1, 0, 0, 0, 1, 0, 1, 0, 1, 0, 1]",216,150,66,12,6,0.08,0.09090909090909091
"[0, 1, 1, 0, 1, 0, 0, 0, 1, 0, 1, 0, 1, 1, 1]",109,59,50,9,6,0.15254237288135594,0.12
"[0, 1, 1, 0, 1, 0, 0, 1, 1, 1, 0, 1, 0, 0, 0]",121,63,58,10,3,0.15873015873015872,0.05172413793103448
"[1, 1, 1, 0, 0, 1, 1, 1, 1, 0, 0, 0, 1, 1, 0]",350,90,260,10,27,0.1111111111111111,0.10384615384615385
"[0, 1, 0, 0, 0, 0, 1, 1, 1, 1, 0, 0, 0, 1, 0]",199,118,81,10,8,0.0847457627118644,0.09876543209876543
"[0, 0, 1, 1, 0, 1, 0, 0, 0, 0, 1, 1, 1, 1, 1]",239,124,115,14,9,0.11290322580645161,0.0782608695652174
"[0, 1, 1, 0, 0, 0, 1, 0, 0, 1, 1, 1, 1, 0, 1]",117,61,56,5,7,0.08196721311475409,0.125
"[0, 0, 0, 0, 1, 1, 0, 1, 0, 1, 1, 1, 0, 1, 1]",149,76,73,11,5,0.14473684210526316,0.0684931506849315
"[1, 1, 0, 0, 1, 1, 1, 0, 1, 1, 0, 1, 1, 0, 1]",255,82,173,8,14,0.0975609756097561,0.08092485549132948
"[0, 1, 0, 0, 0, 1, 0, 0, 0, 0, 1, 1, 1, 1, 1]",258,142,116,11,17,0.07746478873239436,0.14655172413793102
"[0, 1, 0, 0, 0, 1, 1, 0, 0, 1, 0, 0, 0, 1, 0]",220,130,90,11,13,0.08461538461538462,0.14444444444444443
"[0, 1, 0, 1, 0, 0, 0, 1, 1, 1, 1, 1, 0, 1, 0]",107,54,53,7,1,0.12962962962962962,0.018867924528301886
"[0, 0, 0, 0, 1, 0, 0, 1, 0, 1, 0, 0, 1, 1, 0]",287,174,113,16,4,0.09195402298850575,0.035398230088495575
"[0, 0, 0, 0, 0, 1, 0, 1, 0, 1, 1, 0, 0, 1, 0]",242,157,85,15,7,0.09554140127388536,0.08235294117647059
"[0, 1, 1, 0, 0, 0, 0, 0, 1, 1, 1, 0, 1, 0, 0]",181,106,75,14,5,0.1320754716981132,0.06666666666666667
"[0, 1, 0, 1, 1, 1, 0, 0, 0, 0, 0, 1, 0, 0, 1]",161,103,58,14,4,0.13592233009708737,0.06896551724137931
"[0, 1, 0, 0, 0, 0, 0, 1, 1, 0, 0, 0, 1, 1, 1]",282,180,102,14,14,0.07777777777777778,0.13725490196078433
"[0, 1, 0, 0, 0, 0, 0, 1, 1, 1, 1, 1, 0, 1, 0]",119,55,64,6,3,0.10909090909090909,0.046875
"[1, 0, 0, 1, 0, 1, 0, 0, 0, 1, 1, 1, 0, 0, 0]",183,108,75,14,3,0.12962962962962962,0.04
"[0, 0, 1, 0, 0, 1, 0, 1, 0, 0, 0, 1, 1, 1, 0]",161,100,61,7,5,0.07,0.08196721311475409
"[1, 1, 1, 0, 1, 0, 0, 1, 0, 1, 0, 1, 1, 1, 0]",144,63,81,6,8,0.09523809523809523,0.09876543209876543
"[1, 0, 1, 1, 0, 0, 0, 1, 1, 1, 0, 0, 0, 1, 0]",109,65,44,10,5,0.15384615384615385,0.11363636363636363
"[1, 0, 1, 0, 1, 1, 0, 0, 0, 1, 1, 1, 0, 0, 0]",126,64,62,7,5,0.109375,0.08064516129032258
"[0, 1, 0, 0, 1, 0, 1, 1, 1, 0, 0, 0, 0, 1, 1]",187,97,90,11,6,0.1134020618556701,0.06666666666666667
"[1, 1, 1, 0, 0, 0, 1, 0, 1, 1, 1, 1, 1, 0, 1]",281,104,177,11,15,0.10576923076923077,0.0847457627118644
"[1, 1, 1, 0, 0, 0, 1, 0, 0, 1, 1, 1, 0, 0, 1]",156,75,81,5,11,0.06666666666666667,0.13580246913580246
"[0, 0, 1, 1, 0, 0, 0, 1, 0, 0, 0, 1, 1, 1, 0]",152,97,55,9,4,0.09278350515463918,0.07272727272727272
"[1, 1, 1, 0, 1, 0, 1, 1, 0, 0, 1, 0, 0, 1, 0]",122,60,62,7,6,0.11666666666666667,0.0967741935483871
"[0, 1, 1, 1, 1, 0, 1, 0, 1, 1, 0, 0, 1, 0, 0]",124,67,57,6,8,0.08955223880597014,0.14035087719298245
"[1, 0, 0, 0, 0, 0, 0, 1, 0, 1, 1, 1, 0, 1, 0]",146,70,76,5,3,0.07142857142857142,0.039473684210526314
"[0, 0, 0, 1, 1, 1, 1, 0, 0, 1, 1, 0, 0, 0, 1]",451,349,102,41,10,0.1174785100286533,0.09803921568627451
"[1, 0, 1, 1, 0, 0, 0, 0, 0, 0, 1, 0, 0, 1, 1]",218,119,99,13,8,0.1092436974789916,0.08080808080808081
"[0, 0, 1, 1, 1, 0, 1, 1, 1, 0, 1, 1, 1, 0, 0]",144,60,84,9,7,0.15,0.08333333333333333
"[0, 0, 1, 1, 0, 1, 1, 0, 0, 0, 0, 1, 1, 1, 0]",142,64,78,9,10,0.140625,0.1282051282051282
"[0, 0, 1, 1, 0, 1, 1, 1, 1, 0, 1, 0, 1, 1, 0]",141,58,83,4,9,0.06896551724137931,0.10843373493975904
"[1, 1, 1, 0, 1, 1, 0, 0, 1, 1, 1, 0, 0, 0, 1]",180,79,101,3,6,0.0379746835443038,0.0594059405940594
"[0, 1, 0, 0, 1, 1, 0, 0, 0, 1, 1, 0, 1, 0, 0]",140,84,56,9,6,0.10714285714285714,0.10714285714285714
"[1, 0, 1, 1, 1, 0, 0, 0, 0, 1, 0, 0, 0, 0, 1]",167,100,67,13,7,0.13,0.1044776119402985
"[0, 0, 1, 0, 1, 0, 1, 1, 0, 0, 1, 0, 1, 1, 1]",135,53,82,3,3,0.05660377358490566,0.036585365853658534
"[1, 0, 1, 0, 1, 1, 0, 0, 0, 1, 0, 0, 1, 1, 1]",153,56,97,6,10,0.10714285714285714,0.10309278350515463
"[1, 0, 0, 0, 1, 1, 1, 0, 1, 1, 0, 1, 0, 0, 0]",128,53,75,3,10,0.05660377358490566,0.13333333333333333
"[0, 1, 1, 0, 1, 0, 1, 0, 1, 0, 0, 1, 0, 0, 0]",130,75,55,5,8,0.06666666666666667,0.14545454545454545
"[0, 1, 0, 1, 1, 0, 1, 0, 1, 0, 1, 0, 0, 1, 0]",94,59,35,4,6,0.06779661016949153,0.17142857142857143
"[0, 1, 1, 1, 0, 1, 1, 1, 0, 1, 0, 1, 0, 1, 1]",233,89,144,9,11,0.10112359550561797,0.0763888888888889
"[0, 0, 1, 0, 1, 1, 1, 1, 0, 1, 0, 1, 0, 0, 1]",113,57,56,9,5,0.15789473684210525,0.08928571428571429
"[1, 0, 0, 1, 0, 0, 0, 0, 0, 1, 0, 0, 0, 0, 1]",544,369,175,42,16,0.11382113821138211,0.09142857142857143
"[1, 0, 1, 0, 0, 0, 0, 0, 0, 1, 1, 1, 0, 0, 0]",311,195,116,20,14,0.10256410256410256,0.1206896551724138
"[0, 0, 0, 0, 0, 0, 1, 0, 1, 1, 1, 0, 0, 1, 0]",241,155,86,15,8,0.0967741935483871,0.09302325581395349
"[0, 1, 0, 0, 0, 1, 1, 0, 1, 0, 0, 1, 1, 0, 1]",97,45,52,1,8,0.022222222222222223,0.15384615384615385
"[1, 1, 1, 0, 1, 0, 0, 1, 0, 0, 0, 1, 0, 0, 0]",149,81,68,7,6,0.08641975308641975,0.08823529411764706
"[1, 1, 1, 0, 0, 0, 1, 1, 1, 0, 1, 1, 1, 0, 0]",178,71,107,8,12,0.11267605633802817,0.11214953271028037
"[1, 1, 0, 1, 1, 0, 0, 1, 0, 0, 1, 0, 1, 1, 0]",126,66,60,5,7,0.07575757575757576,0.11666666666666667
"[1, 1, 1, 0, 0, 0, 0, 0, 1, 0, 0, 1, 0, 0, 1]",177,87,90,9,5,0.10344827586206896,0.05555555555555555
"[1, 0, 1, 0, 1, 0, 1, 0, 1, 1, 1, 1, 0, 1, 1]",251,103,148,15,13,0.14563106796116504,0.08783783783783784
"[0, 1, 0, 0, 0, 1, 1, 1, 1, 0, 0, 1, 1, 0, 1]",124,66,58,5,8,0.07575757575757576,0.13793103448275862
"[1, 1, 0, 1, 1, 0, 1, 1, 1, 0, 0, 1, 0, 1, 0]",141,64,77,8,5,0.125,0.06493506493506493
"[1, 1, 0, 0, 0, 1, 0, 0, 1, 0, 0, 0, 0, 1, 0]",254,166,88,11,10,0.06626506024096386,0.11363636363636363
"[0, 1, 1, 0, 0, 1, 1, 1, 0, 1, 0, 0, 0, 1, 0]",126,69,57,6,4,0.08695652173913043,0.07017543859649122
"[0, 0, 1, 1, 1, 1, 1, 1, 0, 0, 0, 1, 1, 0, 1]",299,125,174,19,14,0.152,0.08045977011494253
"[0, 1, 0, 0, 1, 1, 1, 1, 0, 0, 0, 1, 1, 1, 0]",142,61,81,6,6,0.09836065573770492,0.07407407407407407
"[1, 0, 1, 1, 0, 0, 1, 1, 1, 1, 0, 1, 1, 1, 0]",257,89,168,8,18,0.0898876404494382,0.10714285714285714
"[0, 1, 1, 0, 1, 1, 1, 0, 1, 1, 0, 1, 0, 1, 1]",232,80,152,7,14,0.0875,0.09210526315789473
"[0, 0, 0, 1, 1, 1, 0, 0, 0, 1, 0, 1, 1, 0, 0]",156,100,56,13,4,0.13,0.07142857142857142
"[0, 1, 0, 0, 0, 0, 0, 1, 0, 1, 1, 1, 1, 1, 0]",139,75,64,8,6,0.10666666666666667,0.09375
"[0, 0, 1, 1, 1, 0, 1, 0, 0, 0, 0, 1, 0, 0, 0]",272,181,91,23,9,0.1270718232044199,0.0989010989010989
"[0, 1, 1, 0, 0, 1, 0, 0, 0, 0, 0, 0, 1, 0, 0]",595,429,166,45,14,0.1048951048951049,0.08433734939759036
"[1, 0, 0, 1, 0, 1, 1, 0, 1, 1, 0, 1, 0, 1, 1]",145,59,86,7,7,0.11864406779661017,0.08139534883720931
"[1, 1, 1, 0, 1, 0, 0, 1, 1, 1, 1, 0, 1, 0, 1]",235,66,169,5,14,0.07575757575757576,0.08284023668639054
"[1, 1, 0, 1, 0, 0, 1, 0, 0, 1, 1, 1, 0, 1, 1]",145,63,82,5,13,0.07936507936507936,0.15853658536585366
"[1, 0, 1, 1, 0, 1, 0, 0, 1, 0, 0, 1, 1, 1, 0]",112,54,58,4,8,0.07407407407407407,0.13793103448275862
"[1, 0, 1, 0, 0, 0, 1, 1, 0, 1, 1, 0, 1, 0, 0]",94,51,43,5,4,0.09803921568627451,0.09302325581395349
"[0, 1, 0, 1, 0, 0, 0, 1, 1, 0, 1, 1, 0, 1, 0]",90,50,40,5,5,0.1,0.125
"[1, 1, 0, 1, 0, 1, 0, 1, 0, 0, 0, 1, 1, 0, 1]",117,46,71,4,9,0.08695652173913043,0.1267605633802817
"[1, 0, 1, 1, 0, 0, 1, 1, 0, 1, 1, 1, 1, 0, 1]",280,103,177,12,21,0.11650485436893204,0.11864406779661017
"[0, 1, 0, 0, 1, 1, 1, 1, 0, 0, 1, 0, 1, 0, 0]",128,79,49,10,2,0.12658227848101267,0.04081632653061224
"[0, 0, 1, 1, 0, 1, 1, 1, 0, 1, 0, 0, 0, 0, 0]",177,99,78,11,9,0.1111111111111111,0.11538461538461539
"[0, 0, 1, 1, 0, 0, 0, 1, 0, 0, 0, 1, 1, 1, 1]",267,162,105,20,7,0.12345679012345678,0.06666666666666667
"[1, 1, 1, 0, 0, 1, 0, 0, 0, 0, 1, 0, 1, 0, 0]",153,85,68,5,10,0.058823529411764705,0.14705882352941177
"[1, 1, 0, 0, 1, 1, 0, 1, 0, 0, 0, 1, 0, 1, 1]",136,81,55,9,3,0.1111111111111111,0.05454545454545454
"[0, 1, 1, 0, 1, 1, 1, 0, 0, 0, 1, 0, 1, 1, 1]",203,103,100,8,11,0.07766990291262135,0.11
"[0, 1, 1, 0, 1, 0, 0, 0, 1, 1, 0, 0, 1, 0, 1]",109,60,49,9,3,0.15,0.061224489795918366
"[1, 0, 0, 1, 0, 0, 1, 0, 1, 0, 1, 1, 1, 1, 1]",179,67,112,2,13,0.029850746268656716,0.11607142857142858
"[1, 0, 0, 1, 1, 0, 0, 1, 0, 0, 1, 0, 1, 0, 1]",107,44,63,4,6,0.09090909090909091,0.09523809523809523
"[0, 1, 1, 0, 1, 0, 1, 0, 1, 0, 1, 0, 1, 0, 0]",116,58,58,4,5,0.06896551724137931,0.08620689655172414
"[1, 0, 1, 1, 1, 0, 1, 0, 1, 1, 1, 0, 1, 0, 0]",131,45,86,2,5,0.044444444444444446,0.05813953488372093
"[1, 0, 1, 1, 0, 1, 1, 0, 1, 0, 1, 0, 1, 0, 0]",103,50,53,4,4,0.08,0.07547169811320754
"[1, 1, 1, 1, 1, 1, 0, 1, 0, 1, 0, 0, 0, 1, 1]",327,105,222,11,22,0.10476190476190476,0.0990990990990991
"[1, 1, 1, 1, 1, 1, 1, 0, 1, 0, 1, 0, 0, 0, 1]",310,93,217,11,24,0.11827956989247312,0.11059907834101383
"[1, 1, 0, 0, 0, 1, 0, 0, 0, 1, 0, 1, 1, 0, 1]",132,68,64,7,7,0.10294117647058823,0.109375
"[1, 1, 0, 0, 1, 0, 1, 0, 0, 0, 0, 0, 1, 1, 0]",205,118,87,11,13,0.09322033898305085,0.14942528735632185
"[0, 0, 0, 1, 1, 1, 1, 0, 1, 1, 0, 0, 1, 0, 1]",127,73,54,1,6,0.0136986301369863,0.1111111111111111
"[1, 0, 1, 0, 0, 0, 0, 1, 1, 1, 1, 0, 1, 1, 0]",114,51,63,4,8,0.0784313725490196,0.12698412698412698
"[0, 1, 0, 1, 0, 1, 1, 0, 0, 1, 1, 0, 1, 0, 0]",127,69,58,8,7,0.11594202898550725,0.1206896551724138
"[1, 0, 1, 1, 0, 0, 0, 1, 1, 1, 1, 1, 0, 1, 1]",287,107,180,18,18,0.16822429906542055,0.1
"[1, 0, 0, 0, 1, 1, 1, 1, 0, 1, 1, 0, 1, 0, 1]",168,63,105,6,11,0.09523809523809523,0.10476190476190476
"[1, 1, 0, 0, 0, 1, 1, 1, 1, 0, 1, 1, 0, 1, 0]",174,66,108,5,11,0.07575757575757576,0.10185185185185185
"[0, 1, 1, 0, 0, 0, 1, 1, 1, 1, 0, 1, 1, 0, 1]",154,65,89,4,13,0.06153846153846154,0.14606741573033707
"[0, 1, 0, 1, 0, 1, 0, 0, 1, 1, 1, 1, 1, 0, 1]",147,55,92,6,14,0.10909090909090909,0.15217391304347827
"[1, 0, 1, 1, 1, 1, 0, 0, 1, 1, 0, 1, 0, 1, 0]",143,69,74,11,10,0.15942028985507245,0.13513513513513514
"[0, 0, 1, 0, 0, 0, 1, 0, 0, 1, 1, 1, 1, 0, 0]",262,158,104,20,9,0.12658227848101267,0.08653846153846154
"[1, 0, 1, 0, 1, 1, 0, 1, 1, 1, 0, 0, 0, 1, 1]",160,70,90,2,8,0.02857142857142857,0.08888888888888889
"[0, 0, 1, 0, 1, 0, 1, 1, 1, 0, 0, 0, 1, 1, 1]",148,73,75,5,7,0.0684931506849315,0.09333333333333334
"[1, 1, 0, 0, 1, 0, 0, 0, 0, 1, 0, 0, 1, 1, 1]",180,94,86,7,9,0.07446808510638298,0.10465116279069768
"[0, 1, 1, 1, 0, 0, 0, 0, 0, 0, 1, 1, 1, 1, 0]",432,247,185,27,20,0.10931174089068826,0.10810810810810811
"[0, 1, 0, 0, 1, 0, 1, 0, 0, 0, 0, 1, 0, 1, 0]",225,164,61,19,6,0.11585365853658537,0.09836065573770492
"[1, 0, 1, 0, 1, 1, 1, 1, 0, 0, 0, 1, 1, 0, 0]",174,82,92,7,10,0.08536585365853659,0.10869565217391304
"[1, 1, 0, 0, 0, 0, 1, 1, 0, 1, 1, 1, 1, 0, 1]",209,84,125,7,18,0.08333333333333333,0.144
"[1, 1, 1, 0, 1, 1, 0, 0, 0, 0, 1, 1, 0, 1, 1]",163,63,100,6,6,0.09523809523809523,0.06
"[0, 0, 0, 1, 1, 0, 1, 1, 0, 0, 1, 0, 1, 0, 1]",143,79,64,10,4,0.12658227848101267,0.0625
"[1, 1, 0, 1, 0, 1, 0, 1, 1, 0, 1, 1, 1, 0, 0]",175,71,104,9,21,0.1267605633802817,0.20192307692307693
"[1, 0, 0, 0, 0, 0, 1, 0, 1, 1, 0, 1, 0, 0, 1]",171,100,71,6,2,0.06,0.028169014084507043
"[1, 1, 0, 0, 1, 1, 1, 1, 0, 1, 1, 1, 0, 0, 0]",239,99,140,10,16,0.10101010101010101,0.11428571428571428
"[0, 0, 0, 1, 0, 1, 1, 0, 1, 1, 0, 0, 1, 0, 1]",131,80,51,7,4,0.0875,0.0784313725490196
"[1, 1, 0, 0, 0, 1, 1, 1, 0, 1, 1, 1, 0, 0, 1]",184,75,109,8,12,0.10666666666666667,0.11009174311926606
"[0, 0, 1, 0, 0, 0, 0, 0, 1, 1, 1, 0, 1, 1, 0]",148,84,64,7,6,0.08333333333333333,0.09375
"[0, 1, 0, 0, 0, 1, 1, 1, 1, 0, 0, 0, 0, 1, 0]",185,103,82,5,11,0.04854368932038835,0.13414634146341464
"[0, 1, 0, 0, 0, 1, 0, 1, 0, 1, 1, 0, 0, 1, 1]",161,94,67,10,7,0.10638297872340426,0.1044776119402985
"[1, 0, 0, 1, 1, 0, 1, 1, 1, 1, 0, 0, 1, 0, 1]",175,67,108,4,12,0.05970149253731343,0.1111111111111111
"[0, 1, 0, 1, 0, 0, 0, 1, 1, 0, 1, 0, 0, 1, 1]",141,67,74,7,7,0.1044776119402985,0.0945945945945946
"[1, 0, 1, 0, 1, 0, 0, 1, 1, 1, 1, 0, 0, 0, 0]",269,144,125,21,16,0.14583333333333334,0.128
"[0, 0, 0, 0, 0, 1, 0, 1, 0, 1, 0, 0, 0, 1, 1]",327,219,108,21,8,0.0958904109589041,0.07407407407407407
"[0, 0, 1, 1, 0, 0, 0, 1, 1, 1, 1, 1, 0, 0, 0]",183,102,81,7,8,0.06862745098039216,0.09876543209876543
"[1, 1, 0, 0, 0, 0, 1, 0, 1, 1, 1, 1, 1, 1, 0]",192,89,103,10,12,0.11235955056179775,0.11650485436893204
"[0, 0, 1, 1, 0, 1, 0, 0, 0, 0, 1, 1, 0, 1, 1]",129,66,63,10,5,0.15151515151515152,0.07936507936507936
"[1, 0, 0, 1, 0, 0, 1, 1, 1, 0, 0, 0, 0, 1, 1]",214,101,113,9,14,0.0891089108910891,0.12389380530973451
"[1, 1, 1, 0, 1, 0, 0, 1, 1, 0, 0, 1, 0, 0, 1]",130,54,76,7,6,0.12962962962962962,0.07894736842105263
"[1, 0, 1, 1, 0, 0, 1, 1, 1, 0, 1, 0, 0, 1, 1]",175,71,104,8,12,0.11267605633802817,0.11538461538461539
"[0, 1, 1, 1, 1, 1, 0, 0, 0, 1, 0, 0, 1, 1, 1]",238,132,106,14,12,0.10606060606060606,0.11320754716981132
"[1, 0, 0, 1, 0, 0, 0, 0, 1, 1, 1, 0, 0, 0, 1]",167,95,72,12,5,0.12631578947368421,0.06944444444444445
"[1, 1, 0, 0, 1, 0, 0, 0, 0, 1, 1, 1, 0, 0, 0]",179,103,76,7,6,0.06796116504854369,0.07894736842105263
"[1, 0, 1, 0, 1, 0, 0, 1, 0, 0, 1, 1, 0, 1, 0]",118,70,48,12,6,0.17142857142857143,0.125
"[0, 1, 1, 0, 1, 0, 0, 0, 1, 1, 0, 1, 1, 1, 0]",109,46,63,7,3,0.15217391304347827,0.047619047619047616
"[0, 0, 1, 1, 0, 1, 0, 0, 0, 1, 1, 0, 1, 1, 1]",151,84,67,12,4,0.14285714285714285,0.05970149253731343
"[1, 1, 0, 0, 1, 1, 1, 0, 0, 0, 1, 1, 0, 1, 0]",106,49,57,5,8,0.10204081632653061,0.14035087719298245
"[1, 0, 0, 0, 1, 0, 1, 0, 1, 1, 1, 0, 1, 1, 1]",167,57,110,8,10,0.14035087719298245,0.09090909090909091
"[1, 1, 1, 0, 1, 1, 0, 0, 0, 0, 1, 0, 1, 0, 1]",126,61,65,10,5,0.16393442622950818,0.07692307692307693
"[0, 0, 1, 0, 0, 1, 0, 1, 1, 1, 1, 0, 1, 1, 0]",114,50,64,5,5,0.1,0.078125
"[1, 1, 0, 1, 1, 0, 0, 0, 1, 0, 0, 1, 1, 0, 0]",153,81,72,6,10,0.07407407407407407,0.1388888888888889
"[1, 1, 1, 0, 0, 0, 1, 0, 0, 1, 1, 0, 1, 1, 0]",113,50,63,8,7,0.16,0.1111111111111111
"[1, 0, 1, 1, 0, 0, 1, 1, 0, 0, 0, 1, 1, 0, 1]",138,65,73,10,11,0.15384615384615385,0.1506849315068493
"[1, 1, 0, 1, 0, 1, 0, 1, 0, 0, 1, 0, 0, 0, 1]",106,47,59,4,5,0.0851063829787234,0.0847457627118644
"[0, 1, 1, 1, 0, 1, 0, 0, 0, 0, 0, 1, 1, 1, 0]",116,61,55,4,2,0.06557377049180328,0.03636363636363636
"[0, 0, 1, 0, 1, 1, 0, 1, 0, 0, 0, 1, 1, 1, 0]",119,65,54,8,5,0.12307692307692308,0.09259259259259259
"[1, 0, 1, 0, 1, 0, 1, 0, 1, 1, 0, 1, 1, 1, 1]",246,93,153,10,6,0.10752688172043011,0.0392156862745098
"[0, 1, 1, 0, 1, 0, 1, 0, 1, 0, 1, 1, 0, 1, 1]",141,58,83,3,5,0.05172413793103448,0.060240963855421686
"[0, 1, 1, 0, 1, 1, 0, 1, 1, 0, 1, 0, 0, 0, 0]",136,67,69,6,5,0.08955223880597014,0.07246376811594203
"[0, 0, 1, 1, 0, 1, 1, 0, 1, 1, 0, 1, 0, 0, 0]",109,61,48,5,6,0.08196721311475409,0.125
"[0, 0, 0, 1, 0, 0, 1, 0, 1, 1, 0, 0, 1, 0, 0]",211,140,71,11,8,0.07857142857142857,0.11267605633802817
"[1, 0, 0, 0, 1, 1, 1, 1, 1, 0, 0, 1, 1, 0, 1]",164,53,111,8,7,0.1509433962264151,0.06306306306306306
"[0, 0, 0, 0, 1, 0, 1, 1, 0, 1, 0, 0, 1, 1, 1]",165,85,80,3,2,0.03529411764705882,0.025
"[1, 0, 1, 0, 0, 0, 0, 0, 1, 0, 1, 1, 0, 0, 0]",274,177,97,17,5,0.096045197740113,0.05154639175257732
"[0, 1, 1, 0, 0, 0, 1, 0, 1, 0, 0, 0, 0, 1, 0]",259,184,75,15,13,0.08152173913043478,0.17333333333333334
"[0, 1, 1, 1, 0, 1, 0, 1, 1, 1, 0, 1, 1, 1, 0]",239,78,161,7,25,0.08974358974358974,0.15527950310559005
"[0, 0, 1, 0, 0, 0, 1, 0, 1, 0, 1, 0, 0, 0, 1]",250,173,77,18,5,0.10404624277456648,0.06493506493506493
"[0, 0, 1, 0, 0, 0, 1, 0, 0, 1, 1, 1, 1, 0, 1]",120,66,54,7,6,0.10606060606060606,0.1111111111111111
"[0, 1, 1, 1, 0, 1, 0, 0, 0, 0, 1, 1, 0, 0, 1]",210,122,88,16,8,0.13114754098360656,0.09090909090909091
"[0, 0, 0, 0, 1, 0, 0, 1, 1, 0, 0, 1, 0, 1, 1]",172,108,64,6,6,0.05555555555555555,0.09375
"[1, 1, 0, 1, 0, 1, 1, 0, 0, 1, 1, 0, 1, 0, 1]",152,68,84,4,3,0.058823529411764705,0.03571428571428571
"[0, 0, 1, 1, 0, 0, 1, 1, 0, 0, 0, 1, 0, 0, 1]",274,176,98,21,10,0.11931818181818182,0.10204081632653061
"[0, 1, 0, 0, 0, 0, 1, 1, 1, 1, 0, 0, 1, 0, 1]",171,110,61,10,8,0.09090909090909091,0.13114754098360656
"[0, 0, 0, 0, 1, 0, 0, 1, 1, 1, 0, 1, 1, 0, 1]",108,56,52,1,4,0.017857142857142856,0.07692307692307693
"[1, 0, 1, 1, 0, 0, 1, 0, 0, 0, 0, 0, 1, 0, 0]",239,151,88,11,5,0.0728476821192053,0.056818181818181816
"[0, 0, 0, 1, 0, 1, 0, 0, 1, 0, 0, 1, 1, 0, 1]",134,87,47,3,3,0.034482758620689655,0.06382978723404255
"[0, 1, 1, 1, 0, 0, 1, 1, 1, 0, 0, 0, 0, 0, 0]",262,155,107,13,7,0.08387096774193549,0.06542056074766354
"[0, 0, 1, 1, 0, 0, 0, 1, 0, 0, 1, 0, 1, 0, 1]",153,96,57,5,7,0.052083333333333336,0.12280701754385964
"[1, 0, 1, 1, 1, 1, 0, 1, 0, 0, 0, 1, 1, 0, 1]",138,67,71,5,6,0.07462686567164178,0.08450704225352113
"[0, 0, 0, 0, 0, 1, 0, 1, 1, 1, 1, 0, 1, 0, 0]",149,90,59,5,4,0.05555555555555555,0.06779661016949153
"[1, 0, 0, 0, 1, 0, 1, 1, 0, 0, 1, 1, 1, 0, 1]",120,52,68,5,6,0.09615384615384616,0.08823529411764706
"[1, 1, 1, 0, 0, 0, 1, 0, 1, 1, 0, 0, 1, 1, 1]",252,92,160,11,17,0.11956521739130435,0.10625
"[1, 0, 1, 0, 0, 0, 0, 0, 1, 1, 0, 1, 0, 1, 0]",132,71,61,5,6,0.07042253521126761,0.09836065573770492
"[0, 1, 1, 0, 0, 1, 0, 0, 1, 0, 0, 1, 1, 1, 0]",112,64,48,9,0,0.140625,0.0
"[0, 0, 0, 1, 1, 0, 1, 0, 1, 1, 1, 0, 1, 0, 0]",115,57,58,4,6,0.07017543859649122,0.10344827586206896
"[1, 1, 0, 1, 0, 1, 0, 0, 0, 1, 1, 0, 0, 1, 0]",89,46,43,8,5,0.17391304347826086,0.11627906976744186
"[1, 1, 0, 0, 0, 1, 0, 0, 1, 0, 1, 0, 0, 0, 0]",279,183,96,23,15,0.12568306010928962,0.15625
"[0, 1, 1, 0, 0, 0, 1, 0, 0, 1, 0, 1, 0, 0, 0]",278,201,77,22,11,0.10945273631840796,0.14285714285714285
"[0, 0, 0, 0, 0, 1, 0, 1, 1, 0, 1, 0, 0, 1, 1]",169,100,69,9,2,0.09,0.028985507246376812
"[1, 0, 1, 0, 1, 1, 1, 0, 1, 0, 0, 0, 0, 0, 0]",171,110,61,14,7,0.12727272727272726,0.11475409836065574
"[0, 0, 1, 1, 0, 1, 1, 0, 1, 1, 0, 0, 0, 1, 1]",159,74,85,6,7,0.08108108108108109,0.08235294117647059
"[1, 0, 1, 1, 1, 1, 0, 1, 1, 1, 1, 0, 1, 0, 0]",249,86,163,3,21,0.03488372093023256,0.12883435582822086
"[0, 1, 0, 1, 1, 0, 1, 1, 0, 0, 0, 1, 1, 0, 0]",150,89,61,10,2,0.11235955056179775,0.03278688524590164
"[1, 0, 0, 0, 1, 0, 1, 1, 0, 1, 1, 0, 1, 1, 0]",114,53,61,3,4,0.05660377358490566,0.06557377049180328
"[1, 1, 1, 0, 0, 1, 0, 0, 0, 1, 0, 0, 0, 0, 1]",185,106,79,10,5,0.09433962264150944,0.06329113924050633
"[1, 0, 0, 0, 0, 1, 1, 0, 1, 1, 1, 0, 0, 1, 0]",125,63,62,5,7,0.07936507936507936,0.11290322580645161
"[1, 0, 0, 1, 0, 0, 1, 1, 1, 1, 1, 0, 0, 0, 1]",130,54,76,8,4,0.14814814814814814,0.05263157894736842
"[0, 1, 1, 0, 0, 0, 0, 1, 1, 0, 0, 1, 0, 0, 1]",287,222,65,18,4,0.08108108108108109,0.06153846153846154
"[1, 0, 1, 0, 1, 0, 1, 1, 0, 1, 0, 0, 1, 1, 0]",111,48,63,3,3,0.0625,0.047619047619047616
"[1, 0, 1, 0, 1, 0, 0, 0, 1, 0, 1, 1, 0, 0, 0]",173,107,66,7,5,0.06542056074766354,0.07575757575757576
"[1, 0, 0, 0, 1, 1, 0, 1, 0, 1, 0, 0, 0, 1, 1]",108,43,65,5,7,0.11627906976744186,0.1076923076923077
"[0, 0, 0, 1, 1, 0, 1, 1, 0, 0, 1, 1, 0, 0, 1]",225,121,104,8,8,0.06611570247933884,0.07692307692307693
"[1, 1, 1, 1, 1, 0, 0, 1, 0, 0, 0, 0, 0, 0, 0]",308,139,169,14,24,0.10071942446043165,0.14201183431952663
"[0, 1, 1, 1, 0, 0, 0, 0, 0, 1, 0, 0, 1, 0, 1]",140,80,60,3,10,0.0375,0.16666666666666666
"[1, 1, 0, 1, 0, 0, 1, 1, 0, 0, 1, 1, 1, 0, 0]",133,61,72,4,6,0.06557377049180328,0.08333333333333333
"[1, 0, 1, 1, 0, 1, 0, 0, 0, 0, 1, 0, 0, 1, 0]",141,74,67,7,8,0.0945945945945946,0.11940298507462686
"[1, 0, 0, 1, 0, 0, 1, 0, 1, 1, 0, 1, 1, 1, 1]",166,64,102,5,8,0.078125,0.0784313725490196
"[1, 1, 0, 1, 1, 1, 0, 1, 1, 0, 1, 1, 0, 1, 0]",226,74,152,11,7,0.14864864864864866,0.046052631578947366
"[0, 0, 1, 0, 0, 1, 1, 0, 1, 1, 1, 0, 0, 1, 1]",140,75,65,13,4,0.17333333333333334,0.06153846153846154
"[1, 0, 1, 1, 1, 1, 0, 0, 0, 1, 0, 1, 0, 0, 1]",114,40,74,3,7,0.075,0.0945945945945946
"[0, 1, 0, 1, 1, 1, 1, 0, 0, 0, 1, 0, 1, 0, 0]",98,48,50,7,5,0.14583333333333334,0.1
"[0, 1, 0, 0, 0, 1, 1, 1, 0, 0, 1, 0, 1, 0, 1]",123,56,67,4,7,0.07142857142857142,0.1044776119402985
"[1, 0, 0, 1, 0, 1, 0, 1, 1, 0, 0, 1, 0, 1, 1]",145,59,86,11,6,0.1864406779661017,0.06976744186046512
"[0, 1, 0, 1, 0, 1, 1, 1, 0, 1, 1, 1, 0, 0, 0]",114,55,59,5,5,0.09090909090909091,0.0847457627118644
"[1, 0, 1, 0, 1, 1, 1, 0, 0, 0, 0, 0, 1, 0, 1]",112,63,49,4,4,0.06349206349206349,0.08163265306122448
"[1, 0, 1, 0, 1, 0, 0, 1, 0, 1, 0, 1, 0, 1, 1]",109,49,60,5,3,0.10204081632653061,0.05
"[1, 0, 0, 1, 1, 1, 0, 1, 0, 1, 1, 1, 1, 0, 0]",214,62,152,8,14,0.12903225806451613,0.09210526315789473
"[1, 0, 1, 0, 1, 1, 0, 0, 1, 0, 0, 1, 1, 0, 0]",155,73,82,6,10,0.0821917808219178,0.12195121951219512
"[1, 1, 0, 1, 1, 1, 0, 1, 0, 0, 0, 0, 1, 0, 1]",102,41,61,5,3,0.12195121951219512,0.04918032786885246
"[0, 1, 1, 1, 1, 0, 0, 0, 1, 1, 0, 1, 1, 1, 0]",156,72,84,7,11,0.09722222222222222,0.13095238095238096
"[0, 0, 0, 1, 1, 0, 1, 1, 1, 0, 0, 1, 1, 0, 0]",193,93,100,10,20,0.10752688172043011,0.2
"[1, 0, 0, 1, 1, 0, 0, 1, 1, 0, 0, 1, 0, 1, 1]",293,78,215,11,25,0.14102564102564102,0.11627906976744186
"[0, 0, 0, 1, 1, 1, 0, 1, 0, 0, 0, 1, 1, 0, 1]",115,62,53,6,3,0.0967741935483871,0.05660377358490566
"[0, 0, 1, 1, 1, 0, 1, 1, 0, 1, 1, 0, 0, 1, 0]",118,57,61,5,6,0.08771929824561403,0.09836065573770492
"[0, 0, 0, 1, 1, 1, 0, 0, 0, 1, 0, 0, 1, 1, 1]",193,114,79,12,8,0.10526315789473684,0.10126582278481013
"[0, 1, 0, 0, 1, 0, 1, 1, 0, 1, 0, 1, 0, 1, 1]",112,53,59,8,11,0.1509433962264151,0.1864406779661017
"[0, 0, 0, 0, 1, 0, 1, 0, 0, 1, 0, 1, 1, 0, 1]",148,96,52,7,6,0.07291666666666667,0.11538461538461539
"[1, 0, 0, 1, 0, 0, 1, 0, 1, 1, 0, 1, 1, 1, 0]",86,43,43,8,5,0.18604651162790697,0.11627906976744186
"[0, 1, 1, 0, 0, 0, 1, 1, 0, 1, 0, 0, 0, 1, 1]",128,75,53,7,9,0.09333333333333334,0.16981132075471697
"[1, 0, 1, 0, 1, 1, 1, 0, 0, 0, 0, 0, 1, 1, 1]",172,78,94,4,6,0.05128205128205128,0.06382978723404255
"[1, 0, 0, 1, 1, 1, 0, 1, 1, 0, 1, 0, 1, 0, 1]",144,54,90,3,8,0.05555555555555555,0.08888888888888889
"[1, 0, 0, 0, 1, 0, 1, 1, 1, 0, 0, 1, 1, 0, 0]",193,97,96,6,12,0.061855670103092786,0.125
"[1, 1, 0, 1, 0, 1, 0, 1, 0, 1, 0, 0, 1, 1, 1]",177,74,103,8,9,0.10810810810810811,0.08737864077669903
"[1, 1, 1, 0, 1, 0, 1, 0, 1, 0, 1, 0, 0, 1, 1]",172,65,107,7,7,0.1076923076923077,0.06542056074766354
"[1, 0, 0, 0, 1, 0, 1, 0, 1, 1, 0, 0, 1, 1, 0]",159,88,71,13,9,0.14772727272727273,0.1267605633802817
"[1, 0, 0, 1, 1, 0, 0, 0, 0, 1, 1, 0, 0, 1, 0]",370,118,252,10,19,0.0847457627118644,0.07539682539682539
"[0, 0, 0, 0, 0, 1, 0, 0, 1, 1, 1, 0, 0, 1, 1]",259,168,91,17,5,0.10119047619047619,0.054945054945054944
"[1, 0, 1, 1, 1, 1, 0, 1, 0, 0, 0, 0, 1, 0, 1]",107,56,51,3,8,0.05357142857142857,0.1568627450980392
"[0, 1, 0, 0, 1, 0, 0, 1, 1, 1, 1, 1, 0, 1, 1]",157,65,92,4,9,0.06153846153846154,0.09782608695652174
"[0, 1, 0, 0, 0, 1, 1, 1, 0, 0, 1, 0, 1, 1, 0]",116,59,57,5,2,0.0847457627118644,0.03508771929824561
"[1, 1, 1, 1, 0, 0, 1, 0, 0, 0, 1, 0, 0, 1, 1]",148,71,77,6,4,0.08450704225352113,0.05194805194805195
"[1, 0, 1, 0, 0, 1, 0, 1, 1, 0, 1, 1, 1, 1, 0]",159,82,77,8,7,0.0975609756097561,0.09090909090909091
"[0, 1, 0, 0, 0, 0, 1, 1, 1, 0, 1, 0, 1, 1, 0]",121,76,45,8,11,0.10526315789473684,0.24444444444444444
"[1, 1, 0, 1, 0, 0, 1, 0, 1, 0, 0, 0, 1, 1, 1]",147,66,81,5,10,0.07575757575757576,0.12345679012345678
"[0, 0, 1, 0, 1, 1, 1, 0, 0, 1, 0, 0, 1, 0, 0]",119,64,55,4,8,0.0625,0.14545454545454545
"[0, 0, 1, 0, 0, 1, 1, 1, 0, 0, 1, 0, 0, 0, 1]",137,89,48,10,4,0.11235955056179775,0.08333333333333333
"[1, 0, 1, 1, 1, 0, 1, 1, 1, 0, 1, 1, 0, 0, 0]",164,66,98,8,8,0.12121212121212122,0.08163265306122448
"[1, 1, 0, 1, 1, 1, 0, 0, 1, 0, 1, 1, 0, 0, 1]",148,65,83,5,11,0.07692307692307693,0.13253012048192772
"[1, 1, 1, 0, 1, 0, 1, 1, 0, 1, 0, 0, 0, 1, 1]",158,56,102,5,12,0.08928571428571429,0.11764705882352941
"[0, 0, 0, 0, 1, 0, 1, 0, 1, 0, 0, 1, 1, 1, 0]",148,94,54,5,3,0.05319148936170213,0.05555555555555555
"[1, 0, 1, 1, 0, 0, 0, 1, 0, 1, 0, 1, 1, 0, 0]",143,79,64,7,4,0.08860759493670886,0.0625
"[1, 1, 1, 1, 1, 1, 1, 0, 1, 1, 0, 0, 0, 1, 0]",299,95,204,6,25,0.06315789473684211,0.12254901960784313
"[1, 0, 1, 1, 1, 0, 0, 1, 1, 0, 0, 1, 1, 1, 0]",195,80,115,6,9,0.075,0.0782608695652174
"[1, 0, 0, 0, 0, 1, 1, 0, 1, 1, 1, 0, 1, 1, 0]",129,52,77,2,8,0.038461538461538464,0.1038961038961039
"[0, 1, 0, 1, 1, 0, 0, 1, 0, 0, 0, 1, 0, 1, 0]",117,59,58,3,1,0.05084745762711865,0.017241379310344827
"[0, 0, 1, 1, 0, 0, 0, 1, 0, 1, 1, 1, 0, 1, 1]",153,72,81,4,4,0.05555555555555555,0.04938271604938271
"[1, 1, 1, 0, 1, 0, 0, 0, 0, 1, 1, 0, 0, 1, 1]",306,147,159,15,15,0.10204081632653061,0.09433962264150944
"[1, 1, 0, 0, 1, 0, 1, 1, 0, 1, 1, 0, 1, 0, 0]",111,60,51,11,5,0.18333333333333332,0.09803921568627451
"[1, 0, 1, 0, 0, 0, 1, 1, 0, 1, 0, 0, 0, 1, 1]",115,58,57,6,11,0.10344827586206896,0.19298245614035087
"[1, 0, 1, 1, 1, 1, 0, 1, 0, 1, 0, 0, 0, 1, 1]",149,58,91,11,6,0.1896551724137931,0.06593406593406594
"[1, 1, 1, 0, 0, 0, 1, 1, 0, 1, 0, 1, 0, 1, 1]",155,46,109,1,10,0.021739130434782608,0.09174311926605505
"[1, 1, 0, 1, 1, 0, 1, 1, 1, 1, 1, 0, 0, 0, 0]",290,100,190,10,24,0.1,0.12631578947368421
"[1, 0, 1, 0, 1, 0, 1, 1, 1, 0, 0, 0, 1, 0, 0]",104,48,56,4,5,0.08333333333333333,0.08928571428571429
"[0, 0, 0, 1, 0, 1, 0, 1, 1, 0, 1, 1, 0, 1, 1]",129,50,79,5,5,0.1,0.06329113924050633
"[0, 0, 0, 0, 1, 0, 1, 1, 0, 0, 1, 1, 1, 1, 1]",257,135,122,14,10,0.1037037037037037,0.08196721311475409
"[1, 1, 0, 0, 0, 1, 1, 0, 1, 1, 0, 0, 1, 1, 1]",259,113,146,11,18,0.09734513274336283,0.1232876712328767
"[0, 0, 1, 0, 1, 0, 1, 1, 0, 1, 0, 0, 1, 0, 1]",104,63,41,5,5,0.07936507936507936,0.12195121951219512
"[0, 0, 1, 0, 1, 0, 0, 0, 0, 1, 0, 0, 1, 0, 1]",222,141,81,15,4,0.10638297872340426,0.04938271604938271
"[0, 1, 0, 0, 0, 0, 1, 1, 0, 1, 1, 1, 1, 1, 0]",109,56,53,10,6,0.17857142857142858,0.11320754716981132
"[1, 0, 1, 0, 0, 0, 1, 0, 0, 0, 1, 1, 0, 0, 1]",184,106,78,6,9,0.05660377358490566,0.11538461538461539
"[1, 0, 0, 0, 0, 0, 1, 1, 1, 1, 1, 0, 1, 0, 1]",129,62,67,4,7,0.06451612903225806,0.1044776119402985
"[1, 1, 0, 0, 0, 1, 1, 0, 1, 0, 0, 0, 0, 0, 1]",179,106,73,11,3,0.10377358490566038,0.0410958904109589
"[0, 0, 0, 1, 0, 1, 0, 1, 0, 1, 1, 1, 0, 1, 0]",101,52,49,8,3,0.15384615384615385,0.061224489795918366
"[1, 1, 0, 0, 1, 1, 1, 1, 0, 0, 0, 0, 1, 0, 0]",336,184,152,13,7,0.07065217391304347,0.046052631578947366
"[1, 0, 0, 0, 0, 1, 1, 1, 1, 0, 1, 1, 1, 0, 0]",169,58,111,4,12,0.06896551724137931,0.10810810810810811
"[0, 1, 1, 1, 1, 0, 1, 1, 1, 0, 0, 0, 0, 0, 1]",157,66,91,8,8,0.12121212121212122,0.08791208791208792
"[0, 0, 1, 1, 1, 0, 0, 0, 1, 1, 1, 1, 0, 0, 1]",195,98,97,9,11,0.09183673469387756,0.1134020618556701
"[0, 0, 1, 0, 1, 1, 1, 0, 0, 0, 1, 0, 0, 1, 0]",136,83,53,7,4,0.08433734939759036,0.07547169811320754
"[1, 0, 0, 0, 1, 1, 1, 1, 0, 0, 0, 1, 0, 1, 1]",141,58,83,10,4,0.1724137931034483,0.04819277108433735
"[0, 1, 0, 0, 1, 1, 0, 1, 1, 1, 0, 0, 0, 0, 0]",213,113,100,8,5,0.07079646017699115,0.05
"[1, 1, 0, 0, 1, 0, 1, 1, 1, 1, 1, 0, 1, 0, 1]",214,89,125,5,13,0.056179775280898875,0.104
"[0, 0, 0, 1, 1, 1, 1, 0, 1, 0, 1, 1, 1, 0, 0]",160,93,67,9,8,0.0967741935483871,0.11940298507462686
"[1, 0, 1, 0, 1, 1, 0, 1, 0, 0, 1, 1, 1, 0, 0]",127,50,77,3,5,0.06,0.06493506493506493
"[1, 1, 0, 0, 0, 1, 1, 1, 1, 0, 1, 1, 1, 1, 0]",263,106,157,8,15,0.07547169811320754,0.09554140127388536
"[1, 0, 0, 1, 0, 0, 1, 0, 1, 0, 1, 0, 0, 1, 0]",138,83,55,7,3,0.08433734939759036,0.05454545454545454
"[0, 1, 0, 0, 1, 0, 0, 1, 0, 1, 0, 1, 0, 0, 1]",142,83,59,8,5,0.0963855421686747,0.0847457627118644
"[1, 1, 0, 0, 1, 0, 0, 1, 1, 1, 1, 0, 0, 0, 0]",297,157,140,25,8,0.1592356687898089,0.05714285714285714
"[0, 1, 1, 0, 1, 1, 1, 0, 1, 0, 0, 0, 0, 0, 0]",184,106,78,4,6,0.03773584905660377,0.07692307692307693
"[0, 0, 1, 0, 0, 0, 0, 0, 1, 1, 1, 0, 1, 0, 1]",138,71,67,6,5,0.08450704225352113,0.07462686567164178
"[1, 0, 1, 1, 0, 1, 1, 1, 0, 0, 1, 1, 0, 0, 1]",250,99,151,12,14,0.12121212121212122,0.09271523178807947
"[0, 1, 1, 0, 1, 1, 1, 0, 0, 1, 1, 0, 0, 0, 1]",123,61,62,4,7,0.06557377049180328,0.11290322580645161
"[0, 0, 0, 1, 0, 0, 1, 0, 1, 1, 1, 1, 0, 0, 1]",154,87,67,7,6,0.08045977011494253,0.08955223880597014
"[0, 1, 0, 1, 1, 1, 1, 1, 0, 1, 0, 0, 0, 1, 1]",185,88,97,6,11,0.06818181818181818,0.1134020618556701
"[0, 1, 0, 1, 0, 1, 0, 1, 0, 0, 0, 1, 1, 0, 0]",175,98,77,10,3,0.10204081632653061,0.03896103896103896
"[0, 1, 0, 0, 1, 1, 1, 0, 1, 1, 1, 0, 1, 0, 0]",113,56,57,5,5,0.08928571428571429,0.08771929824561403
"[1, 1, 1, 1, 1, 1, 0, 0, 0, 1, 0, 0, 1, 1, 0]",194,66,128,6,11,0.09090909090909091,0.0859375
"[0, 0, 0, 0, 0, 0, 1, 1, 1, 1, 1, 0, 1, 1, 0]",230,122,108,13,15,0.10655737704918032,0.1388888888888889
"[1, 1, 0, 1, 0, 1, 1, 0, 1, 0, 0, 0, 1, 1, 1]",183,83,100,8,8,0.0963855421686747,0.08
"[1, 0, 1, 0, 0, 0, 1, 1, 0, 1, 1, 1, 1, 0, 1]",122,49,73,6,6,0.12244897959183673,0.0821917808219178
"[1, 1, 0, 1, 1, 0, 0, 0, 1, 1, 0, 1, 0, 1, 1]",164,69,95,7,6,0.10144927536231885,0.06315789473684211
"[1, 0, 0, 0, 0, 0, 1, 1, 0, 1, 0, 1, 0, 0, 1]",168,95,73,10,6,0.10526315789473684,0.0821917808219178
"[0, 1, 1, 1, 1, 0, 0, 1, 0, 0, 1, 0, 1, 0, 0]",130,84,46,6,3,0.07142857142857142,0.06521739130434782
"[1, 1, 0, 0, 0, 1, 0, 1, 0, 0, 0, 0, 1, 0, 1]",132,79,53,9,5,0.11392405063291139,0.09433962264150944
"[0, 1, 0, 1, 0, 0, 0, 0, 1, 0, 0, 1, 0, 1, 1]",125,73,52,4,1,0.0547945205479452,0.019230769230769232
"[1, 1, 1, 0, 0, 0, 0, 0, 1, 1, 0, 1, 0, 1, 1]",154,54,100,2,13,0.037037037037037035,0.13
"[0, 0, 1, 1, 1, 0, 1, 1, 0, 0, 0, 1, 0, 1, 0]",109,59,50,5,5,0.0847457627118644,0.1
"[0, 0, 1, 1, 1, 1, 0, 0, 1, 0, 0, 0, 0, 0, 0]",488,313,175,32,12,0.10223642172523961,0.06857142857142857
"[1, 1, 0, 0, 0, 0, 1, 1, 0, 1, 0, 0, 1, 1, 0]",176,88,88,7,15,0.07954545454545454,0.17045454545454544
"[1, 0, 0, 0, 1, 0, 0, 1, 0, 1, 0, 0, 0, 0, 1]",251,160,91,19,15,0.11875,0.16483516483516483
"[0, 1, 1, 0, 0, 0, 0, 1, 0, 1, 1, 1, 0, 1, 1]",136,79,57,7,7,0.08860759493670886,0.12280701754385964
"[1, 1, 1, 0, 0, 0, 1, 0, 1, 0, 0, 1, 1, 1, 1]",261,115,146,12,11,0.10434782608695652,0.07534246575342465
"[1, 0, 0, 1, 0, 1, 1, 1, 0, 1, 1, 1, 0, 0, 0]",123,61,62,6,7,0.09836065573770492,0.11290322580645161
"[1, 1, 1, 0, 1, 1, 0, 0, 0, 1, 0, 0, 0, 0, 1]",112,50,62,1,10,0.02,0.16129032258064516
"[1, 0, 0, 1, 1, 0, 0, 0, 1, 1, 0, 1, 0, 1, 1]",142,42,100,3,7,0.07142857142857142,0.07
"[0, 0, 1, 1, 0, 1, 0, 0, 1, 0, 0, 0, 0, 0, 1]",256,164,92,22,9,0.13414634146341464,0.09782608695652174
"[0, 1, 1, 1, 1, 0, 1, 0, 1, 0, 0, 1, 0, 0, 1]",106,43,63,5,4,0.11627906976744186,0.06349206349206349
"[0, 1, 0, 1, 1, 1, 1, 0, 1, 0, 1, 0, 0, 1, 0]",105,48,57,8,7,0.16666666666666666,0.12280701754385964
"[1, 0, 0, 1, 1, 0, 1, 0, 1, 1, 0, 0, 0, 1, 0]",114,59,55,3,3,0.05084745762711865,0.05454545454545454
"[0, 1, 1, 0, 1, 1, 0, 1, 1, 0, 0, 1, 1, 0, 0]",186,92,94,8,6,0.08695652173913043,0.06382978723404255
"[1, 0, 1, 1, 1, 0, 1, 0, 1, 0, 1, 0, 0, 1, 1]",144,61,83,6,6,0.09836065573770492,0.07228915662650602
"[1, 0, 1, 0, 0, 0, 0, 1, 1, 0, 0, 0, 1, 1, 0]",152,84,68,15,8,0.17857142857142858,0.11764705882352941
"[1, 0, 0, 1, 0, 0, 1, 1, 1, 0, 1, 0, 1, 1, 0]",99,43,56,5,7,0.11627906976744186,0.125
"[1, 1, 1, 0, 0, 1, 0, 0, 1, 1, 1, 0, 1, 0, 1]",153,51,102,2,14,0.0392156862745098,0.13725490196078433
"[0, 0, 0, 1, 0, 1, 1, 1, 0, 0, 1, 0, 1, 1, 1]",142,66,76,6,8,0.09090909090909091,0.10526315789473684
"[0, 1, 1, 0, 1, 1, 1, 0, 0, 0, 0, 0, 0, 1, 1]",302,156,146,10,15,0.0641025641025641,0.10273972602739725
"[0, 1, 0, 1, 1, 1, 1, 1, 0, 1, 0, 0, 1, 0, 0]",113,54,59,6,7,0.1111111111111111,0.11864406779661017
"[1, 0, 1, 1, 0, 0, 1, 0, 1, 0, 0, 1, 1, 1, 0]",111,58,53,5,1,0.08620689655172414,0.018867924528301886
"[0, 1, 0, 0, 1, 0, 1, 0, 0, 0, 1, 1, 1, 0, 1]",118,57,61,5,5,0.08771929824561403,0.08196721311475409
"[1, 0, 0, 1, 0, 1, 1, 1, 1, 0, 0, 0, 1, 1, 1]",187,75,112,4,10,0.05333333333333334,0.08928571428571429
"[1, 1, 1, 0, 0, 0, 0, 1, 0, 0, 0, 1, 1, 1, 1]",281,96,185,8,16,0.08333333333333333,0.08648648648648649
"[0, 1, 1, 1, 0, 0, 1, 0, 1, 1, 0, 1, 0, 0, 1]",108,60,48,8,5,0.13333333333333333,0.10416666666666667
"[1, 1, 0, 0, 0, 1, 1, 1, 0, 0, 1, 0, 1, 1, 0]",114,63,51,5,6,0.07936507936507936,0.11764705882352941
"[0, 1, 1, 1, 0, 0, 0, 1, 1, 1, 0, 0, 1, 0, 1]",101,39,62,5,4,0.1282051282051282,0.06451612903225806
"[0, 1, 1, 1, 0, 0, 1, 1, 1, 0, 0, 0, 0, 1, 0]",106,65,41,4,3,0.06153846153846154,0.07317073170731707
"[0, 0, 0, 1, 0, 0, 0, 0, 1, 1, 1, 0, 1, 0, 0]",258,157,101,12,10,0.07643312101910828,0.09900990099009901
"[0, 1, 1, 1, 1, 1, 0, 0, 1, 0, 1, 1, 0, 0, 0]",136,61,75,6,4,0.09836065573770492,0.05333333333333334
"[1, 1, 1, 0, 0, 1, 0, 0, 0, 1, 1, 0, 1, 0, 1]",117,50,67,3,6,0.06,0.08955223880597014
"[1, 1, 1, 0, 0, 0, 1, 0, 0, 0, 1, 0, 0, 1, 1]",166,84,82,8,9,0.09523809523809523,0.10975609756097561
"[0, 0, 1, 1, 1, 0, 0, 1, 1, 0, 0, 0, 1, 0, 1]",117,61,56,4,4,0.06557377049180328,0.07142857142857142
"[1, 0, 0, 0, 1, 1, 1, 0, 0, 0, 1, 0, 0, 1, 0]",130,81,49,8,7,0.09876543209876543,0.14285714285714285
"[1, 0, 0, 1, 1, 1, 1, 0, 1, 1, 0, 0, 1, 0, 0]",125,58,67,4,10,0.06896551724137931,0.14925373134328357
"[0, 0, 1, 1, 0, 1, 0, 1, 0, 1, 0, 0, 1, 0, 1]",109,58,51,7,5,0.1206896551724138,0.09803921568627451
"[1, 0, 0, 1, 0, 1, 0, 1, 0, 1, 0, 1, 0, 1, 0]",109,54,55,2,3,0.037037037037037035,0.05454545454545454
"[1, 1, 1, 0, 1, 1, 0, 0, 0, 1, 0, 1, 0, 0, 0]",126,69,57,6,5,0.08695652173913043,0.08771929824561403
"[0, 1, 0, 1, 1, 0, 0, 1, 0, 1, 0, 1, 1, 0, 0]",111,56,55,6,7,0.10714285714285714,0.12727272727272726
"[0, 1, 0, 0, 1, 1, 1, 1, 0, 0, 1, 1, 0, 1, 1]",213,76,137,7,15,0.09210526315789473,0.10948905109489052
"[1, 0, 0, 1, 0, 1, 0, 0, 1, 1, 1, 1, 0, 0, 1]",207,96,111,9,8,0.09375,0.07207207207207207
"[0, 0, 0, 1, 0, 0, 1, 0, 1, 0, 0, 1, 1, 1, 1]",190,106,84,7,11,0.0660377358490566,0.13095238095238096
"[0, 1, 0, 1, 0, 0, 0, 0, 0, 0, 1, 1, 1, 0, 0]",314,215,99,28,8,0.13023255813953488,0.08080808080808081
"[1, 0, 1, 1, 1, 0, 1, 0, 0, 0, 0, 0, 0, 1, 0]",119,71,48,5,5,0.07042253521126761,0.10416666666666667
"[1, 1, 0, 0, 0, 1, 0, 0, 1, 1, 1, 0, 1, 0, 1]",91,45,46,7,6,0.15555555555555556,0.13043478260869565
"[0, 1, 0, 1, 1, 0, 1, 0, 1, 1, 1, 0, 1, 1, 1]",251,100,151,11,20,0.11,0.13245033112582782
"[0, 0, 1, 0, 1, 1, 0, 0, 1, 0, 0, 1, 1, 1, 0]",113,57,56,3,3,0.05263157894736842,0.05357142857142857
"[1, 1, 0, 1, 1, 0, 1, 1, 0, 0, 0, 1, 0, 0, 0]",111,53,58,3,7,0.05660377358490566,0.1206896551724138
"[0, 1, 0, 0, 1, 0, 0, 1, 1, 1, 1, 1, 0, 0, 0]",175,101,74,12,2,0.1188118811881188,0.02702702702702703
"[1, 0, 0, 1, 0, 0, 0, 1, 0, 1, 1, 0, 1, 1, 1]",153,62,91,6,10,0.0967741935483871,0.10989010989010989
"[0, 1, 0, 0, 1, 1, 1, 0, 0, 1, 0, 1, 0, 1, 1]",97,46,51,4,4,0.08695652173913043,0.0784313725490196
"[1, 1, 0, 1, 0, 0, 1, 0, 0, 1, 0, 1, 1, 0, 1]",94,39,55,2,3,0.05128205128205128,0.05454545454545454
"[0, 0, 0, 0, 1, 0, 1, 0, 1, 0, 0, 1, 0, 1, 0]",217,149,68,17,3,0.11409395973154363,0.04411764705882353
"[0, 1, 0, 0, 0, 0, 1, 0, 1, 0, 0, 1, 1, 0, 1]",117,67,50,3,5,0.04477611940298507,0.1
"[1, 1, 1, 0, 1, 0, 1, 0, 0, 1, 0, 0, 0, 0, 0]",169,95,74,7,5,0.07368421052631578,0.06756756756756757
"[0, 0, 1, 1, 0, 1, 1, 1, 0, 1, 0, 1, 0, 0, 0]",144,75,69,7,8,0.09333333333333334,0.11594202898550725
"[0, 1, 0, 0, 1, 1, 1, 1, 0, 0, 0, 1, 0, 0, 1]",111,56,55,7,4,0.125,0.07272727272727272
"[0, 1, 0, 0, 1, 1, 0, 1, 0, 1, 0, 0, 0, 0, 1]",154,99,55,5,3,0.050505050505050504,0.05454545454545454
"[0, 1, 1, 0, 1, 0, 1, 1, 0, 1, 0, 0, 1, 1, 0]",105,52,53,2,5,0.038461538461538464,0.09433962264150944
"[0, 0, 0, 1, 1, 1, 1, 0, 0, 0, 1, 0, 1, 1, 0]",164,108,56,9,9,0.08333333333333333,0.16071428571428573
"[1, 0, 0, 1, 0, 0, 1, 1, 1, 1, 1, 0, 1, 0, 0]",128,63,65,10,6,0.15873015873015872,0.09230769230769231
"[0, 1, 0, 0, 1, 1, 1, 0, 0, 0, 0, 1, 0, 1, 0]",118,69,49,6,9,0.08695652173913043,0.1836734693877551
"[0, 1, 1, 0, 1, 1, 0, 0, 1, 0, 0, 1, 0, 0, 1]",121,69,52,8,4,0.11594202898550725,0.07692307692307693
"[0, 0, 1, 1, 1, 0, 1, 0, 1, 0, 1, 0, 0, 0, 1]",103,54,49,6,3,0.1111111111111111,0.061224489795918366
"[0, 0, 0, 1, 1, 1, 0, 1, 0, 0, 1, 0, 1, 0, 1]",121,71,50,4,7,0.056338028169014086,0.14
"[1, 1, 1, 1, 0, 1, 0, 0, 1, 1, 0, 0, 1, 1, 0]",253,102,151,9,14,0.08823529411764706,0.09271523178807947
"[0, 1, 1, 0, 1, 0, 0, 1, 1, 1, 0, 1, 1, 0, 1]",154,63,91,6,11,0.09523809523809523,0.12087912087912088
"[0, 1, 0, 0, 1, 0, 0, 1, 1, 1, 0, 1, 1, 0, 0]",121,63,58,7,2,0.1111111111111111,0.034482758620689655
"[0, 1, 0, 0, 0, 0, 1, 0, 1, 1, 0, 0, 1, 1, 0]",181,110,71,16,5,0.14545454545454545,0.07042253521126761
"[1, 0, 0, 1, 1, 0, 1, 1, 0, 0, 0, 1, 0, 1, 1]",126,58,68,6,6,0.10344827586206896,0.08823529411764706
"[1, 0, 0, 1, 1, 0, 1, 0, 0, 0, 1, 1, 0, 1, 0]",95,50,45,6,4,0.12,0.08888888888888889
"[0, 1, 1, 0, 0, 1, 1, 1, 1, 0, 1, 1, 1, 0, 0]",207,112,95,9,13,0.08035714285714286,0.1368421052631579
"[0, 0, 0, 0, 1, 1, 0, 1, 1, 1, 1, 0, 0, 0, 1]",157,91,66,8,8,0.08791208791208792,0.12121212121212122
"[1, 0, 0, 1, 1, 1, 0, 0, 0, 0, 1, 0, 1, 0, 1]",108,51,57,5,5,0.09803921568627451,0.08771929824561403
"[1, 0, 1, 1, 1, 1, 0, 0, 0, 0, 1, 0, 0, 1, 0]",110,57,53,5,3,0.08771929824561403,0.05660377358490566
"[0, 0, 1, 1, 0, 1, 0, 0, 0, 1, 1, 1, 1, 1, 1]",263,122,141,16,17,0.13114754098360656,0.12056737588652482
"[0, 0, 0, 1, 0, 1, 0, 1, 0, 0, 0, 1, 1, 0, 1]",141,84,57,4,5,0.047619047619047616,0.08771929824561403
"[0, 0, 0, 1, 0, 1, 0, 0, 1, 0, 0, 1, 0, 1, 0]",224,139,85,16,6,0.11510791366906475,0.07058823529411765
"[1, 1, 1, 0, 0, 0, 1, 1, 0, 0, 1, 0, 0, 1, 1]",158,70,88,8,9,0.11428571428571428,0.10227272727272728
"[1, 0, 1, 0, 0, 1, 1, 1, 0, 0, 1, 0, 1, 0, 0]",118,56,62,3,4,0.05357142857142857,0.06451612903225806
"[1, 1, 1, 1, 1, 0, 1, 0, 0, 1, 1, 0, 1, 0, 0]",152,48,104,3,12,0.0625,0.11538461538461539
"[0, 0, 0, 1, 1, 0, 1, 0, 0, 0, 1, 1, 0, 0, 0]",354,219,135,10,15,0.045662100456621,0.1111111111111111
"[0, 1, 0, 1, 0, 0, 1, 1, 0, 1, 0, 1, 0, 0, 1]",116,65,51,4,7,0.06153846153846154,0.13725490196078433
"[1, 1, 0, 0, 1, 0, 0, 0, 1, 1, 0, 1, 0, 1, 1]",128,50,78,8,10,0.16,0.1282051282051282
"[1, 0, 1, 1, 1, 0, 1, 0, 1, 0, 0, 1, 1, 0, 0]",143,69,74,6,9,0.08695652173913043,0.12162162162162163
"[1, 0, 1, 1, 0, 1, 0, 0, 1, 0, 1, 0, 0, 1, 0]",88,45,43,1,1,0.022222222222222223,0.023255813953488372
"[1, 0, 1, 0, 0, 0, 0, 1, 1, 0, 0, 1, 0, 1, 1]",142,71,71,7,7,0.09859154929577464,0.09859154929577464
"[1, 0, 1, 0, 0, 0, 0, 1, 1, 0, 0, 1, 0, 1, 0]",142,80,62,12,6,0.15,0.0967741935483871
"[1, 1, 0, 1, 0, 1, 1, 0, 1, 0, 0, 1, 0, 0, 1]",111,56,55,3,5,0.05357142857142857,0.09090909090909091
"[0, 0, 0, 1, 1, 0, 1, 0, 0, 0, 1, 0, 0, 1, 1]",193,118,75,13,8,0.11016949152542373,0.10666666666666667
"[1, 1, 0, 1, 1, 1, 0, 0, 1, 1, 0, 0, 0, 1, 0]",106,49,57,0,6,0.0,0.10526315789473684
"[1, 1, 0, 1, 0, 0, 1, 1, 1, 0, 1, 0, 1, 1, 0]",127,49,78,5,11,0.10204081632653061,0.14102564102564102
"[0, 1, 0, 0, 0, 1, 1, 0, 0, 1, 0, 1, 1, 0, 1]",111,59,52,7,4,0.11864406779661017,0.07692307692307693
"[1, 1, 1, 1, 0, 1, 0, 1, 0, 0, 0, 1, 1, 0, 1]",139,53,86,6,5,0.11320754716981132,0.05813953488372093
"[0, 1, 1, 0, 0, 1, 1, 1, 0, 1, 1, 0, 0, 1, 0]",121,62,59,2,7,0.03225806451612903,0.11864406779661017
"[0, 0, 0, 1, 1, 0, 0, 1, 1, 1, 1, 1, 0, 0, 1]",277,181,96,18,7,0.09944751381215469,0.07291666666666667
"[0, 1, 0, 1, 0, 1, 0, 0, 0, 1, 0, 0, 1, 1, 0]",157,82,75,3,6,0.036585365853658534,0.08
"[1, 0, 1, 1, 0, 0, 1, 0, 1, 1, 0, 0, 0, 0, 0]",206,114,92,11,8,0.09649122807017543,0.08695652173913043
"[0, 1, 0, 1, 1, 0, 1, 1, 1, 0, 1, 0, 1, 0, 0]",100,44,56,6,8,0.13636363636363635,0.14285714285714285
"[0, 0, 1, 0, 1, 0, 1, 1, 0, 1, 0, 0, 1, 0, 0]",132,84,48,7,1,0.08333333333333333,0.020833333333333332
"[1, 0, 1, 1, 0, 0, 1, 1, 0, 1, 1, 0, 1, 0, 0]",102,47,55,0,5,0.0,0.09090909090909091
"[0, 0, 0, 1, 1, 1, 0, 1, 0, 1, 1, 1, 0, 1, 1]",165,78,87,12,3,0.15384615384615385,0.034482758620689655
"[0, 1, 1, 0, 1, 1, 1, 1, 1, 0, 0, 0, 0, 1, 0]",115,52,63,12,9,0.23076923076923078,0.14285714285714285
"[0, 0, 1, 1, 0, 1, 1, 1, 0, 0, 1, 0, 1, 0, 0]",127,71,56,6,6,0.08450704225352113,0.10714285714285714
"[0, 1, 0, 1, 1, 0, 0, 0, 1, 1, 0, 0, 1, 1, 0]",213,113,100,11,6,0.09734513274336283,0.06
"[0, 0, 1, 0, 0, 0, 1, 0, 1, 0, 1, 1, 1, 0, 1]",106,72,34,8,4,0.1111111111111111,0.11764705882352941
"[0, 0, 0, 1, 1, 1, 1, 1, 1, 1, 0, 1, 1, 0, 1]",347,169,178,21,20,0.1242603550295858,0.11235955056179775
"[1, 0, 0, 1, 1, 1, 0, 0, 1, 0, 1, 0, 0, 0, 0]",172,108,64,10,8,0.09259259259259259,0.125
"[0, 0, 0, 1, 0, 1, 0, 1, 1, 0, 1, 1, 1, 0, 1]",100,43,57,2,7,0.046511627906976744,0.12280701754385964
"[1, 1, 0, 1, 0, 1, 1, 1, 0, 1, 1, 1, 0, 0, 0]",171,63,108,5,12,0.07936507936507936,0.1111111111111111
"[1, 1, 1, 0, 1, 1, 0, 0, 0, 0, 0, 1, 0, 0, 1]",119,53,66,7,5,0.1320754716981132,0.07575757575757576
"[0, 0, 1, 1, 1, 0, 0, 0, 1, 0, 0, 1, 0, 1, 1]",119,65,54,9,8,0.13846153846153847,0.14814814814814814
"[0, 0, 0, 1, 1, 1, 0, 0, 0, 1, 0, 0, 1, 0, 1]",153,97,56,11,6,0.1134020618556701,0.10714285714285714
"[1, 1, 0, 1, 0, 1, 0, 1, 0, 0, 0, 0, 1, 0, 0]",154,82,72,4,5,0.04878048780487805,0.06944444444444445
"[1, 1, 1, 0, 0, 0, 0, 1, 1, 0, 1, 1, 1, 0, 0]",179,63,116,6,10,0.09523809523809523,0.08620689655172414
"[0, 1, 1, 1, 0, 0, 0, 0, 1, 1, 0, 1, 1, 1, 0]",119,51,68,3,3,0.058823529411764705,0.04411764705882353
"[0, 1, 0, 0, 1, 0, 1, 0, 1, 0, 1, 0, 1, 1, 1]",106,55,51,5,6,0.09090909090909091,0.11764705882352941
"[0, 0, 0, 0, 1, 0, 1, 1, 0, 1, 1, 1, 0, 1, 0]",104,57,47,4,4,0.07017543859649122,0.0851063829787234
"[0, 0, 0, 0, 1, 0, 1, 0, 1, 1, 0, 0, 0, 1, 1]",180,111,69,7,4,0.06306306306306306,0.057971014492753624
"[1, 0, 0, 1, 0, 0, 1, 1, 1, 0, 0, 0, 1, 0, 0]",140,84,56,11,3,0.13095238095238096,0.05357142857142857
"[1, 0, 1, 0, 1, 0, 0, 1, 1, 0, 0, 0, 1, 1, 1]",144,64,80,5,12,0.078125,0.15
"[0, 0, 1, 0, 0, 1, 1, 0, 0, 1, 0, 1, 1, 1, 0]",113,65,48,6,7,0.09230769230769231,0.14583333333333334
"[0, 0, 1, 0, 0, 0, 0, 1, 0, 0, 1, 1, 1, 1, 0]",214,123,91,12,13,0.0975609756097561,0.14285714285714285
"[1, 0, 1, 1, 0, 1, 0, 0, 1, 1, 1, 1, 0, 1, 1]",226,77,149,8,12,0.1038961038961039,0.08053691275167785
"[0, 1, 0, 1, 1, 1, 1, 0, 1, 1, 0, 1, 0, 0, 0]",103,47,56,7,5,0.14893617021276595,0.08928571428571429
"[1, 0, 1, 1, 1, 0, 0, 1, 0, 0, 0, 1, 0, 1, 1]",126,63,63,11,6,0.1746031746031746,0.09523809523809523
"[0, 1, 1, 0, 1, 1, 0, 1, 1, 0, 0, 0, 0, 0, 1]",144,88,56,2,5,0.022727272727272728,0.08928571428571429
"[0, 0, 0, 1, 0, 0, 1, 1, 0, 1, 1, 1, 0, 0, 1]",111,56,55,6,5,0.10714285714285714,0.09090909090909091
"[0, 0, 1, 1, 0, 0, 0, 0, 0, 1, 1, 0, 1, 0, 1]",197,127,70,10,10,0.07874015748031496,0.14285714285714285
"[1, 0, 0, 0, 1, 1, 1, 1, 0, 0, 0, 1, 1, 0, 0]",156,78,78,12,8,0.15384615384615385,0.10256410256410256
"[1, 1, 0, 1, 1, 0, 1, 1, 0, 1, 0, 0, 0, 0, 1]",129,57,72,7,4,0.12280701754385964,0.05555555555555555
"[0, 1, 1, 0, 0, 1, 1, 0, 1, 0, 1, 1, 0, 0, 1]",141,70,71,6,9,0.08571428571428572,0.1267605633802817
"[0, 1, 0, 0, 1, 0, 1, 0, 1, 1, 1, 1, 1, 0, 1]",129,58,71,2,10,0.034482758620689655,0.14084507042253522
"[1, 0, 1, 0, 0, 1, 1, 1, 0, 0, 1, 0, 0, 0, 0]",159,99,60,9,3,0.09090909090909091,0.05
"[1, 0, 0, 0, 1, 1, 1, 0, 0, 1, 0, 0, 1, 0, 1]",121,52,69,5,10,0.09615384615384616,0.14492753623188406
"[1, 0, 0, 0, 1, 1, 0, 1, 0, 0, 1, 0, 0, 0, 1]",158,86,72,7,6,0.08139534883720931,0.08333333333333333
"[1, 1, 1, 1, 0, 1, 0, 0, 0, 1, 1, 0, 1, 0, 0]",117,56,61,11,8,0.19642857142857142,0.13114754098360656
"[1, 1, 1, 1, 1, 0, 0, 0, 1, 1, 0, 0, 1, 0, 0]",141,64,77,8,7,0.125,0.09090909090909091
"[0, 1, 0, 1, 1, 1, 1, 1, 0, 0, 0, 1, 1, 0, 0]",160,70,90,9,7,0.12857142857142856,0.07777777777777778
"[1, 0, 1, 1, 1, 1, 0, 1, 1, 0, 1, 1, 0, 0, 0]",174,64,110,5,13,0.078125,0.11818181818181818
"[1, 0, 1, 0, 1, 0, 0, 0, 0, 1, 0, 1, 1, 0, 0]",164,96,68,9,8,0.09375,0.11764705882352941
"[0, 1, 1, 0, 0, 0, 1, 1, 0, 0, 0, 1, 0, 1, 0]",134,89,45,8,5,0.0898876404494382,0.1111111111111111
"[1, 1, 0, 1, 0, 0, 1, 1, 1, 1, 1, 0, 0, 1, 0]",144,48,96,7,8,0.14583333333333334,0.08333333333333333
"[0, 0, 0, 1, 1, 0, 1, 0, 0, 0, 1, 1, 1, 0, 1]",109,67,42,7,3,0.1044776119402985,0.07142857142857142
"[1, 1, 0, 0, 1, 0, 1, 0, 0, 0, 1, 0, 1, 1, 1]",147,67,80,4,8,0.05970149253731343,0.1
"[1, 0, 0, 0, 1, 0, 1, 0, 1, 0, 1, 1, 1, 1, 0]",113,54,59,3,5,0.05555555555555555,0.0847457627118644
"[0, 1, 1, 0, 1, 0, 1, 0, 1, 1, 1, 1, 0, 0, 0]",171,78,93,10,10,0.1282051282051282,0.10752688172043011
"[1, 1, 0, 1, 1, 0, 1, 0, 1, 0, 0, 0, 0, 0, 1]",125,65,60,7,4,0.1076923076923077,0.06666666666666667
"[1, 0, 1, 1, 0, 1, 1, 0, 0, 1, 0, 1, 1, 0, 0]",132,67,65,10,10,0.14925373134328357,0.15384615384615385
"[0, 1, 0, 0, 1, 1, 1, 1, 0, 0, 1, 0, 0, 0, 1]",135,65,70,8,9,0.12307692307692308,0.12857142857142856
"[1, 0, 1, 1, 0, 1, 0, 0, 0, 1, 0, 1, 0, 0, 1]",109,62,47,10,8,0.16129032258064516,0.1702127659574468
"[1, 1, 1, 0, 0, 1, 1, 0, 0, 1, 1, 0, 1, 0, 1]",279,63,216,7,15,0.1111111111111111,0.06944444444444445
"[1, 1, 0, 0, 0, 0, 1, 0, 0, 0, 1, 0, 1, 1, 0]",161,98,63,7,4,0.07142857142857142,0.06349206349206349
"[1, 0, 1, 0, 1, 1, 0, 1, 1, 1, 1, 0, 0, 0, 0]",214,93,121,6,14,0.06451612903225806,0.11570247933884298
"[1, 0, 1, 1, 0, 0, 1, 1, 1, 0, 1, 1, 0, 1, 0]",123,56,67,10,5,0.17857142857142858,0.07462686567164178
"[0, 1, 1, 0, 1, 1, 1, 0, 0, 0, 1, 1, 1, 0, 0]",137,55,82,7,10,0.12727272727272726,0.12195121951219512
"[1, 1, 0, 1, 1, 0, 0, 0, 1, 1, 0, 0, 0, 1, 0]",118,59,59,2,5,0.03389830508474576,0.0847457627118644
"[0, 1, 1, 0, 0, 1, 0, 1, 1, 0, 0, 0, 0, 0, 1]",165,105,60,7,5,0.06666666666666667,0.08333333333333333
"[1, 0, 0, 1, 1, 0, 0, 1, 1, 0, 1, 0, 1, 0, 1]",169,56,113,6,12,0.10714285714285714,0.10619469026548672
"[0, 1, 0, 1, 0, 1, 1, 0, 0, 1, 0, 0, 1, 1, 1]",149,66,83,6,6,0.09090909090909091,0.07228915662650602
"[1, 1, 1, 0, 0, 1, 1, 0, 1, 1, 0, 0, 0, 0, 1]",212,85,127,6,14,0.07058823529411765,0.11023622047244094
"[0, 0, 1, 1, 0, 1, 0, 1, 0, 1, 1, 0, 1, 1, 0]",109,54,55,3,7,0.05555555555555555,0.12727272727272726
"[1, 1, 0, 1, 1, 1, 0, 0, 0, 0, 1, 0, 1, 1, 0]",119,65,54,7,7,0.1076923076923077,0.12962962962962962
"[0, 1, 1, 1, 0, 0, 0, 1, 1, 0, 1, 1, 0, 0, 1]",119,68,51,7,7,0.10294117647058823,0.13725490196078433
"[1, 1, 0, 1, 1, 0, 0, 0, 0, 0, 1, 0, 0, 1, 0]",138,80,58,4,7,0.05,0.1206896551724138
"[1, 0, 1, 1, 1, 0, 1, 0, 1, 1, 1, 0, 0, 0, 1]",141,58,83,7,8,0.1206896551724138,0.0963855421686747
"[1, 1, 0, 0, 1, 0, 1, 1, 0, 0, 1, 1, 1, 1, 0]",223,103,120,13,11,0.1262135922330097,0.09166666666666666
"[0, 1, 1, 1, 0, 1, 0, 0, 0, 1, 0, 1, 0, 1, 1]",118,65,53,9,4,0.13846153846153847,0.07547169811320754
"[0, 0, 0, 1, 0, 1, 0, 0, 1, 0, 1, 1, 0, 1, 1]",125,67,58,6,10,0.08955223880597014,0.1724137931034483
"[0, 1, 1, 0, 1, 1, 0, 0, 0, 0, 1, 0, 1, 0, 0]",140,78,62,10,3,0.1282051282051282,0.04838709677419355
"[0, 0, 0, 1, 1, 0, 0, 1, 1, 0, 1, 1, 0, 1, 0]",146,92,54,10,8,0.10869565217391304,0.14814814814814814
"[1, 0, 1, 0, 0, 1, 0, 0, 1, 0, 1, 0, 1, 1, 0]",126,70,56,5,3,0.07142857142857142,0.05357142857142857
"[1, 1, 0, 1, 1, 0, 1, 1, 0, 0, 1, 0, 1, 1, 0]",124,46,78,5,10,0.10869565217391304,0.1282051282051282
"[0, 1, 0, 1, 1, 1, 1, 1, 0, 0, 1, 0, 0, 0, 0]",159,77,82,8,12,0.1038961038961039,0.14634146341463414
"[0, 0, 1, 0, 1, 1, 0, 1, 0, 0, 1, 1, 0, 1, 1]",113,56,57,9,5,0.16071428571428573,0.08771929824561403
"[1, 0, 1, 0, 1, 1, 1, 1, 1, 0, 0, 0, 1, 1, 0]",164,76,88,7,8,0.09210526315789473,0.09090909090909091
"[1, 0, 0, 1, 1, 0, 1, 0, 0, 0, 0, 1, 1, 0, 1]",122,54,68,3,3,0.05555555555555555,0.04411764705882353
"[1, 1, 0, 1, 0, 1, 0, 1, 1, 0, 0, 0, 1, 0, 1]",117,54,63,3,6,0.05555555555555555,0.09523809523809523
"[1, 1, 0, 1, 0, 1, 1, 1, 0, 1, 0, 0, 0, 0, 1]",108,57,51,7,3,0.12280701754385964,0.058823529411764705
"[1, 0, 0, 1, 1, 0, 0, 0, 1, 1, 1, 1, 1, 0, 0]",174,93,81,7,4,0.07526881720430108,0.04938271604938271
"[1, 0, 1, 0, 0, 0, 1, 0, 1, 1, 0, 0, 1, 0, 1]",112,57,55,5,3,0.08771929824561403,0.05454545454545454
"[1, 1, 0, 0, 1, 1, 0, 1, 0, 1, 0, 0, 0, 0, 1]",168,86,82,9,8,0.10465116279069768,0.0975609756097561
"[0, 0, 1, 0, 1, 0, 1, 0, 0, 1, 1, 0, 1, 1, 0]",120,62,58,9,7,0.14516129032258066,0.1206896551724138
"[0, 1, 0, 0, 1, 0, 1, 0, 1, 0, 0, 1, 1, 0, 1]",108,52,56,6,6,0.11538461538461539,0.10714285714285714
"[1, 1, 0, 1, 0, 0, 1, 0, 1, 0, 1, 1, 0, 0, 1]",114,54,60,6,5,0.1111111111111111,0.08333333333333333
"[1, 1, 1, 0, 0, 1, 0, 1, 0, 1, 0, 0, 0, 0, 0]",168,91,77,8,7,0.08791208791208792,0.09090909090909091
"[0, 1, 1, 0, 0, 1, 1, 0, 0, 1, 0, 0, 1, 0, 1]",140,82,58,11,4,0.13414634146341464,0.06896551724137931
"[0, 0, 1, 0, 0, 0, 1, 1, 0, 0, 1, 0, 1, 1, 0]",148,91,57,11,1,0.12087912087912088,0.017543859649122806
"[1, 0, 1, 0, 1, 1, 1, 0, 1, 0, 0, 0, 1, 0, 0]",96,56,40,6,7,0.10714285714285714,0.175
"[1, 1, 1, 0, 1, 1, 0, 0, 1, 0, 0, 0, 0, 0, 0]",221,123,98,16,8,0.13008130081300814,0.08163265306122448
"[0, 1, 1, 0, 1, 1, 1, 0, 1, 0, 1, 1, 0, 0, 0]",122,50,72,6,5,0.12,0.06944444444444445
"[1, 0, 0, 1, 1, 1, 1, 1, 0, 1, 0, 0, 1, 0, 0]",121,48,73,4,4,0.08333333333333333,0.0547945205479452
"[1, 1, 1, 0, 0, 1, 0, 1, 0, 1, 1, 1, 0, 1, 0]",134,54,80,6,11,0.1111111111111111,0.1375
"[0, 0, 1, 0, 1, 0, 1, 0, 0, 1, 0, 1, 0, 1, 0]",119,75,44,5,5,0.06666666666666667,0.11363636363636363
"[0, 0, 1, 1, 0, 0, 0, 1, 1, 0, 1, 0, 1, 1, 1]",182,90,92,12,7,0.13333333333333333,0.07608695652173914
"[0, 1, 1, 0, 1, 1, 1, 0, 1, 1, 0, 1, 0, 1, 0]",125,46,79,5,4,0.10869565217391304,0.05063291139240506
"[1, 1, 1, 1, 1, 0, 1, 1, 1, 0, 1, 0, 0, 1, 0]",231,85,146,9,18,0.10588235294117647,0.1232876712328767
"[1, 0, 0, 1, 1, 1, 1, 1, 0, 1, 0, 1, 0, 0, 1]",143,44,99,7,11,0.1590909090909091,0.1111111111111111
"[0, 0, 1, 0, 1, 1, 0, 1, 0, 0, 0, 1, 0, 1, 1]",120,60,60,3,10,0.05,0.16666666666666666
"[1, 1, 1, 1, 0, 0, 0, 0, 0, 1, 0, 1, 1, 1, 0]",155,83,72,8,7,0.0963855421686747,0.09722222222222222
"[1, 0, 0, 1, 1, 0, 1, 0, 1, 1, 1, 0, 0, 1, 0]",103,44,59,4,5,0.09090909090909091,0.0847457627118644
"[0, 1, 0, 1, 1, 0, 0, 0, 1, 1, 0, 0, 0, 1, 1]",132,65,67,5,8,0.07692307692307693,0.11940298507462686
"[1, 1, 0, 0, 1, 0, 1, 0, 0, 1, 1, 1, 1, 0, 0]",197,83,114,4,7,0.04819277108433735,0.06140350877192982
"[1, 0, 0, 1, 0, 0, 1, 0, 0, 0, 0, 1, 1, 1, 0]",155,94,61,6,6,0.06382978723404255,0.09836065573770492
"[0, 1, 0, 0, 1, 0, 1, 1, 0, 0, 0, 1, 0, 0, 1]",157,87,70,11,4,0.12643678160919541,0.05714285714285714
"[1, 1, 0, 1, 0, 0, 0, 0, 0, 1, 1, 0, 0, 1, 1]",302,149,153,12,14,0.08053691275167785,0.0915032679738562
"[0, 0, 0, 1, 1, 1, 0, 1, 0, 1, 0, 1, 0, 0, 0]",145,100,45,5,3,0.05,0.06666666666666667
"[1, 1, 1, 0, 0, 1, 0, 1, 0, 0, 0, 1, 1, 0, 1]",118,56,62,3,9,0.05357142857142857,0.14516129032258066
"[0, 0, 0, 1, 0, 1, 1, 0, 1, 1, 0, 1, 1, 0, 0]",113,63,50,2,3,0.031746031746031744,0.06
"[1, 0, 0, 1, 1, 0, 1, 1, 1, 0, 1, 0, 0, 1, 0]",118,58,60,4,3,0.06896551724137931,0.05
"[0, 1, 1, 0, 1, 1, 0, 1, 1, 1, 1, 0, 0, 0, 0]",200,103,97,12,4,0.11650485436893204,0.041237113402061855
"[1, 0, 1, 1, 0, 1, 1, 0, 1, 1, 1, 1, 0, 0, 0]",174,70,104,5,10,0.07142857142857142,0.09615384615384616
"[0, 1, 0, 1, 0, 0, 1, 1, 1, 1, 0, 0, 1, 0, 0]",125,70,55,2,8,0.02857142857142857,0.14545454545454545
"[0, 0, 0, 1, 1, 0, 1, 1, 1, 1, 0, 0, 1, 0, 0]",131,60,71,2,12,0.03333333333333333,0.16901408450704225
"[0, 0, 0, 1, 1, 1, 1, 0, 0, 0, 1, 1, 1, 0, 0]",169,100,69,11,8,0.11,0.11594202898550725
"[1, 0, 1, 1, 0, 1, 0, 0, 1, 1, 0, 1, 0, 0, 1]",98,40,58,3,4,0.075,0.06896551724137931
"[1, 1, 1, 0, 0, 1, 1, 1, 0, 1, 0, 0, 1, 0, 0]",135,54,81,9,10,0.16666666666666666,0.12345679012345678
"[0, 1, 0, 0, 1, 0, 1, 1, 0, 1, 0, 1, 1, 0, 1]",110,69,41,6,2,0.08695652173913043,0.04878048780487805
"[0, 0, 1, 0, 0, 1, 0, 1, 1, 0, 1, 0, 1, 1, 0]",129,56,73,6,3,0.10714285714285714,0.0410958904109589
"[0, 1, 0, 1, 1, 0, 1, 1, 1, 0, 1, 1, 0, 1, 0]",123,55,68,4,6,0.07272727272727272,0.08823529411764706
"[0, 1, 0, 1, 1, 1, 0, 0, 0, 1, 0, 1, 0, 1, 1]",106,53,53,3,1,0.05660377358490566,0.018867924528301886
"[1, 0, 1, 0, 1, 1, 0, 0, 1, 0, 0, 1, 0, 0, 1]",100,55,45,3,3,0.05454545454545454,0.06666666666666667
"[1, 0, 0, 1, 0, 0, 1, 0, 0, 1, 0, 1, 0, 0, 0]",217,138,79,13,9,0.09420289855072464,0.11392405063291139
"[1, 1, 0, 1, 0, 0, 1, 0, 0, 1, 0, 0, 1, 0, 1]",103,48,55,4,6,0.08333333333333333,0.10909090909090909
"[1, 1, 1, 1, 0, 1, 0, 0, 0, 0, 0, 1, 0, 1, 1]",141,70,71,4,7,0.05714285714285714,0.09859154929577464
"[1, 0, 0, 0, 1, 0, 1, 1, 1, 1, 0, 0, 0, 1, 1]",141,73,68,9,4,0.1232876712328767,0.058823529411764705
"[1, 1, 1, 0, 0, 0, 1, 0, 1, 1, 1, 1, 0, 0, 0]",194,81,113,5,7,0.06172839506172839,0.061946902654867256
"[0, 1, 1, 1, 0, 0, 0, 1, 0, 1, 1, 1, 1, 0, 0]",158,81,77,4,9,0.04938271604938271,0.11688311688311688
"[1, 0, 0, 1, 1, 0, 1, 0, 0, 1, 0, 1, 1, 0, 0]",136,63,73,9,8,0.14285714285714285,0.1095890410958904
"[1, 1, 0, 1, 0, 0, 1, 1, 0, 1, 0, 0, 1, 0, 1]",111,43,68,3,8,0.06976744186046512,0.11764705882352941
"[0, 1, 1, 1, 0, 1, 1, 1, 1, 0, 1, 0, 1, 0, 0]",142,50,92,4,9,0.08,0.09782608695652174
"[1, 0, 1, 0, 1, 1, 0, 0, 0, 1, 0, 0, 1, 0, 1]",98,49,49,6,6,0.12244897959183673,0.12244897959183673
"[0, 0, 1, 1, 1, 0, 1, 1, 1, 1, 0, 0, 1, 0, 1]",155,56,99,8,6,0.14285714285714285,0.06060606060606061
"[0, 0, 1, 1, 0, 1, 0, 0, 1, 1, 0, 0, 0, 1, 1]",135,72,63,7,6,0.09722222222222222,0.09523809523809523
"[0, 0, 1, 1, 1, 0, 1, 0, 1, 1, 0, 0, 1, 0, 1]",131,62,69,6,8,0.0967741935483871,0.11594202898550725
"[0, 0, 1, 1, 0, 1, 0, 1, 0, 1, 0, 1, 1, 0, 1]",95,50,45,8,8,0.16,0.17777777777777778
"[0, 0, 0, 0, 1, 0, 0, 1, 1, 1, 0, 1, 0, 1, 1]",112,65,47,6,6,0.09230769230769231,0.1276595744680851
"[0, 1, 0, 1, 1, 1, 0, 0, 1, 0, 1, 0, 0, 0, 1]",124,69,55,6,12,0.08695652173913043,0.21818181818181817
"[1, 0, 1, 0, 0, 1, 1, 1, 0, 1, 0, 1, 1, 0, 1]",124,57,67,9,5,0.15789473684210525,0.07462686567164178
"[0, 1, 0, 1, 0, 0, 1, 1, 0, 0, 0, 1, 1, 1, 1]",156,74,82,5,6,0.06756756756756757,0.07317073170731707
"[0, 1, 0, 0, 1, 0, 0, 1, 0, 1, 1, 1, 1, 1, 1]",191,83,108,11,8,0.13253012048192772,0.07407407407407407
"[1, 1, 1, 0, 1, 0, 1, 0, 0, 1, 0, 0, 1, 0, 1]",86,41,45,4,4,0.0975609756097561,0.08888888888888889
"[1, 1, 1, 1, 0, 1, 0, 1, 0, 0, 1, 0, 0, 1, 0]",82,43,39,7,1,0.16279069767441862,0.02564102564102564
"[1, 0, 1, 0, 1, 0, 0, 1, 1, 1, 0, 1, 1, 0, 0]",132,65,67,10,10,0.15384615384615385,0.14925373134328357
"[1, 1, 0, 0, 0, 1, 1, 1, 0, 1, 0, 1, 1, 0, 0]",129,64,65,6,6,0.09375,0.09230769230769231
"[1, 1, 1, 0, 0, 1, 0, 0, 1, 0, 0, 1, 1, 0, 1]",102,39,63,6,10,0.15384615384615385,0.15873015873015872
"[1, 0, 0, 1, 0, 0, 1, 0, 1, 1, 1, 0, 0, 1, 0]",105,54,51,9,4,0.16666666666666666,0.0784313725490196
"[0, 1, 1, 1, 1, 0, 0, 1, 0, 0, 1, 0, 0, 1, 1]",184,107,77,12,5,0.11214953271028037,0.06493506493506493
"[0, 1, 0, 1, 1, 1, 0, 0, 1, 0, 0, 0, 0, 1, 1]",146,73,73,4,6,0.0547945205479452,0.0821917808219178
"[0, 0, 0, 0, 0, 1, 0, 0, 1, 0, 1, 1, 0, 1, 0]",212,148,64,16,6,0.10810810810810811,0.09375
"[0, 0, 1, 0, 1, 1, 0, 0, 0, 1, 0, 0, 0, 1, 0]",222,150,72,11,9,0.07333333333333333,0.125
"[0, 1, 1, 0, 1, 0, 1, 0, 0, 0, 0, 1, 1, 0, 1]",124,74,50,6,7,0.08108108108108109,0.14
"[0, 0, 1, 1, 0, 0, 1, 0, 1, 1, 1, 1, 1, 0, 0]",159,76,83,14,8,0.18421052631578946,0.0963855421686747
"[0, 0, 0, 1, 0, 0, 1, 0, 1, 1, 0, 1, 0, 0, 1]",143,81,62,8,3,0.09876543209876543,0.04838709677419355
"[1, 0, 1, 0, 0, 0, 0, 1, 1, 1, 0, 1, 1, 1, 1]",214,98,116,10,13,0.10204081632653061,0.11206896551724138
"[0, 0, 0, 1, 1, 1, 0, 1, 1, 1, 0, 1, 0, 0, 1]",114,66,48,3,2,0.045454545454545456,0.041666666666666664
"[0, 1, 0, 1, 0, 1, 1, 1, 0, 1, 0, 1, 1, 0, 0]",137,55,82,9,4,0.16363636363636364,0.04878048780487805
"[1, 1, 0, 1, 1, 0, 0, 0, 1, 0, 1, 0, 0, 0, 1]",107,48,59,4,6,0.08333333333333333,0.1016949152542373
"[1, 0, 0, 1, 1, 0, 1, 0, 0, 0, 0, 0, 1, 0, 0]",215,135,80,11,5,0.08148148148148149,0.0625
"[1, 1, 0, 1, 0, 1, 0, 1, 1, 0, 1, 1, 1, 0, 1]",223,78,145,10,13,0.1282051282051282,0.0896551724137931
"[0, 0, 1, 0, 1, 0, 1, 1, 1, 0, 1, 0, 1, 0, 1]",102,49,53,8,4,0.16326530612244897,0.07547169811320754
"[0, 0, 0, 1, 1, 0, 1, 1, 1, 0, 0, 0, 1, 0, 0]",146,84,62,7,6,0.08333333333333333,0.0967741935483871
"[0, 0, 1, 1, 1, 1, 0, 1, 1, 0, 0, 0, 1, 1, 0]",145,69,76,5,4,0.07246376811594203,0.05263157894736842
"[0, 1, 0, 0, 1, 0, 1, 0, 1, 1, 1, 1, 1, 1, 0]",155,64,91,7,11,0.109375,0.12087912087912088
"[1, 0, 1, 0, 0, 1, 0, 0, 0, 1, 1, 0, 1, 1, 1]",113,58,55,8,7,0.13793103448275862,0.12727272727272726
"[1, 0, 1, 1, 0, 1, 1, 0, 0, 0, 1, 0, 0, 0, 1]",98,55,43,4,3,0.07272727272727272,0.06976744186046512
"[1, 0, 1, 1, 0, 0, 0, 1, 1, 0, 0, 1, 1, 0, 1]",137,62,75,5,8,0.08064516129032258,0.10666666666666667
"[1, 1, 1, 1, 1, 1, 0, 0, 1, 0, 0, 0, 0, 0, 1]",210,100,110,9,17,0.09,0.15454545454545454
"[0, 0, 0, 0, 1, 0, 1, 0, 1, 1, 0, 0, 1, 0, 1]",157,97,60,10,7,0.10309278350515463,0.11666666666666667
"[0, 0, 1, 1, 1, 0, 1, 1, 0, 1, 0, 0, 1, 1, 0]",139,56,83,4,13,0.07142857142857142,0.1566265060240964
"[1, 0, 0, 0, 0, 0, 1, 1, 0, 1, 0, 1, 0, 1, 0]",131,76,55,5,1,0.06578947368421052,0.01818181818181818
"[1, 1, 0, 1, 0, 0, 0, 1, 0, 1, 1, 0, 0, 1, 0]",107,55,52,2,3,0.03636363636363636,0.057692307692307696
"[1, 1, 0, 1, 0, 0, 1, 0, 1, 0, 0, 1, 0, 1, 0]",94,52,42,5,7,0.09615384615384616,0.16666666666666666
"[1, 1, 1, 1, 0, 1, 1, 0, 0, 0, 1, 0, 0, 1, 0]",108,48,60,5,6,0.10416666666666667,0.1
"[0, 0, 0, 0, 1, 1, 0, 1, 1, 1, 1, 0, 1, 0, 0]",141,81,60,6,6,0.07407407407407407,0.1
"[1, 0, 1, 1, 1, 0, 0, 1, 1, 0, 1, 0, 0, 0, 1]",106,45,61,4,6,0.08888888888888889,0.09836065573770492
"[0, 0, 1, 1, 1, 1, 0, 1, 1, 1, 1, 0, 1, 0, 0]",176,78,98,9,9,0.11538461538461539,0.09183673469387756
"[0, 1, 0, 0, 0, 0, 0, 1, 0, 1, 0, 1, 1, 1, 0]",140,84,56,9,3,0.10714285714285714,0.05357142857142857
"[1, 1, 0, 1, 1, 0, 1, 1, 1, 0, 0, 1, 0, 0, 1]",155,64,91,7,8,0.109375,0.08791208791208792
"[1, 0, 0, 0, 1, 1, 1, 1, 1, 0, 0, 0, 1, 1, 0]",129,66,63,12,7,0.18181818181818182,0.1111111111111111
"[1, 0, 1, 0, 1, 0, 1, 0, 1, 0, 0, 1, 0, 0, 1]",111,62,49,3,4,0.04838709677419355,0.08163265306122448
"[1, 0, 0, 1, 1, 0, 1, 1, 0, 1, 0, 1, 0, 1, 1]",157,58,99,7,14,0.1206896551724138,0.1414141414141414
"[1, 1, 0, 1, 1, 0, 0, 0, 1, 0, 0, 1, 1, 1, 0]",101,48,53,3,6,0.0625,0.11320754716981132
"[1, 0, 1, 1, 1, 0, 0, 0, 1, 0, 1, 1, 0, 0, 1]",124,53,71,3,10,0.05660377358490566,0.14084507042253522
"[0, 0, 1, 1, 1, 0, 0, 1, 0, 1, 1, 0, 1, 1, 0]",106,49,57,6,3,0.12244897959183673,0.05263157894736842
"[0, 0, 1, 0, 1, 1, 1, 0, 0, 1, 0, 1, 1, 0, 1]",92,40,52,3,2,0.075,0.038461538461538464
"[0, 1, 1, 1, 1, 1, 0, 1, 0, 0, 1, 0, 1, 0, 0]",110,58,52,6,7,0.10344827586206896,0.1346153846153846
"[1, 0, 0, 1, 1, 0, 1, 1, 1, 0, 1, 0, 1, 0, 0]",119,52,67,7,5,0.1346153846153846,0.07462686567164178
"[0, 0, 1, 1, 0, 0, 0, 1, 1, 1, 1, 0, 1, 1, 0]",119,59,60,5,6,0.0847457627118644,0.1
"[0, 0, 1, 1, 1, 0, 0, 0, 1, 0, 1, 1, 0, 0, 0]",153,92,61,11,7,0.11956521739130435,0.11475409836065574
"[1, 0, 1, 1, 0, 1, 1, 0, 0, 0, 0, 1, 0, 1, 0]",105,50,55,4,6,0.08,0.10909090909090909
"[1, 1, 1, 1, 1, 1, 1, 0, 0, 0, 0, 0, 0, 0, 1]",582,151,431,8,41,0.052980132450331126,0.0951276102088167
"[0, 0, 1, 0, 0, 1, 1, 0, 0, 0, 1, 1, 1, 1, 1]",217,109,108,8,13,0.07339449541284404,0.12037037037037036
"[1, 1, 0, 0, 0, 1, 0, 1, 0, 0, 0, 1, 0, 0, 1]",144,91,53,9,1,0.0989010989010989,0.018867924528301886
"[1, 0, 0, 0, 0, 1, 1, 0, 0, 0, 0, 1, 1, 0, 1]",442,152,290,19,25,0.125,0.08620689655172414
"[0, 1, 1, 0, 0, 0, 0, 1, 1, 0, 1, 0, 1, 0, 0]",198,132,66,16,12,0.12121212121212122,0.18181818181818182
"[0, 1, 0, 0, 0, 1, 1, 0, 0, 1, 0, 0, 0, 0, 1]",270,168,102,17,9,0.10119047619047619,0.08823529411764706
"[0, 0, 1, 1, 1, 1, 1, 1, 0, 0, 1, 1, 1, 1, 1]",4998,1534,3464,136,337,0.08865710560625815,0.0972863741339492
"[1, 1, 1, 1, 1, 0, 0, 1, 1, 0, 1, 0, 1, 1, 1]",903,182,721,15,75,0.08241758241758242,0.10402219140083217
"[1, 1, 1, 0, 0, 0, 0, 0, 0, 0, 0, 0, 0, 1, 1]",2565,672,1893,62,185,0.09226190476190477,0.09772847332276809
"[0, 1, 1, 0, 1, 1, 1, 1, 1, 1, 1, 1, 1, 1, 0]",2063,528,1535,47,144,0.08901515151515152,0.09381107491856677
"[1, 0, 1, 1, 0, 1, 1, 1, 1, 1, 1, 1, 1, 1, 1]",9495,1783,7712,165,694,0.09254066180594504,0.0899896265560166
"[0, 0, 0, 1, 0, 1, 0, 0, 0, 0, 1, 1, 0, 0, 1]",399,268,131,27,11,0.10074626865671642,0.08396946564885496
"[0, 0, 0, 0, 1, 1, 0, 0, 0, 0, 0, 0, 0, 0, 0]",27133,22246,4887,2069,491,0.09300548413197879,0.10047063638223859
"[0, 0, 0, 0, 0, 0, 0, 1, 1, 0, 0, 0, 0, 0, 0]",28332,25109,3223,2420,311,0.0963797841411446,0.09649394973627055
"[0, 0, 0, 1, 0, 0, 0, 0, 0, 0, 0, 0, 0, 0, 1]",8965,7380,1585,669,144,0.09065040650406504,0.09085173501577287
"[0, 0, 1, 1, 1, 1, 1, 1, 1, 1, 1, 1, 1, 1, 1]",29705,6186,23519,543,2232,0.0877788554801164,0.09490199413240359
"[0, 1, 0, 0, 0, 1, 1, 1, 1, 0, 0, 0, 1, 1, 1]",209,114,95,11,7,0.09649122807017543,0.07368421052631578
"[1, 0, 0, 1, 1, 0, 1, 0, 0, 0, 0, 0, 1, 1, 1]",261,112,149,11,11,0.09821428571428571,0.0738255033557047
"[1, 0, 1, 0, 0, 0, 1, 1, 1, 1, 1, 1, 1, 1, 0]",447,159,288,11,37,0.06918238993710692,0.1284722222222222
"[0, 1, 1, 1, 1, 0, 1, 1, 1, 1, 1, 0, 1, 0, 0]",287,100,187,11,16,0.11,0.0855614973262032
"[1, 0, 1, 1, 1, 1, 0, 1, 1, 1, 1, 1, 1, 1, 1]",8503,1619,6884,156,615,0.09635577516985794,0.08933759442184776
"[1, 1, 1, 0, 1, 1, 1, 1, 0, 1, 1, 1, 1, 1, 1]",7921,1403,6518,135,668,0.0962223806129722,0.1024854249769868
"[1, 1, 1, 1, 1, 1, 0, 1, 0, 1, 1, 0, 1, 1, 1]",1867,433,1434,45,141,0.10392609699769054,0.09832635983263599
"[0, 1, 0, 1, 0, 0, 0, 1, 1, 1, 0, 1, 0, 1, 1]",127,69,58,5,6,0.07246376811594203,0.10344827586206896
"[1, 0, 0, 0, 1, 0, 1, 0, 0, 0, 1, 1, 1, 0, 1]",101,46,55,5,6,0.10869565217391304,0.10909090909090909
"[1, 1, 1, 0, 0, 0, 1, 0, 1, 0, 0, 0, 1, 1, 1]",205,84,121,10,7,0.11904761904761904,0.05785123966942149
"[0, 0, 0, 1, 0, 1, 0, 1, 1, 1, 0, 0, 0, 1, 0]",129,79,50,7,4,0.08860759493670886,0.08
"[0, 1, 0, 0, 0, 0, 1, 0, 1, 0, 1, 1, 0, 1, 0]",140,84,56,13,4,0.15476190476190477,0.07142857142857142
"[0, 0, 0, 0, 0, 0, 0, 0, 1, 0, 0, 0, 1, 0, 0]",7372,6122,1250,570,137,0.09310682783404116,0.1096
"[0, 0, 1, 0, 0, 0, 0, 1, 1, 1, 0, 0, 0, 0, 0]",736,521,215,44,20,0.08445297504798464,0.09302325581395349
"[0, 1, 0, 0, 0, 0, 0, 0, 0, 0, 0, 1, 0, 0, 0]",7055,5759,1296,586,119,0.10175377669734328,0.09182098765432099
"[0, 0, 0, 0, 1, 0, 0, 1, 0, 0, 0, 1, 0, 0, 1]",524,385,139,47,11,0.12207792207792208,0.07913669064748201
"[1, 0, 1, 1, 1, 1, 1, 1, 0, 0, 0, 1, 0, 1, 1]",283,111,172,12,21,0.10810810810810811,0.12209302325581395
"[0, 0, 0, 0, 0, 0, 1, 1, 1, 1, 0, 0, 1, 1, 1]",2114,1171,943,96,83,0.08198121263877028,0.088016967126193
"[1, 0, 1, 0, 1, 1, 1, 0, 1, 0, 1, 1, 0, 0, 0]",120,52,68,7,4,0.1346153846153846,0.058823529411764705
"[0, 1, 0, 1, 1, 1, 1, 1, 1, 0, 1, 0, 0, 0, 1]",148,73,75,7,7,0.0958904109589041,0.09333333333333334
"[0, 1, 1, 0, 0, 0, 1, 0, 1, 1, 1, 1, 1, 1, 0]",195,90,105,9,6,0.1,0.05714285714285714
"[0, 0, 0, 1, 0, 1, 1, 0, 0, 1, 1, 1, 1, 0, 0]",301,162,139,14,14,0.08641975308641975,0.10071942446043165
"[0, 0, 0, 0, 0, 0, 1, 0, 1, 1, 0, 0, 1, 1, 1]",372,251,121,27,15,0.10756972111553785,0.12396694214876033
"[0, 1, 0, 0, 0, 0, 0, 0, 1, 0, 1, 0, 0, 0, 0]",1732,1331,401,133,24,0.09992486851990984,0.059850374064837904
"[1, 0, 0, 1, 0, 0, 0, 0, 0, 0, 1, 0, 1, 0, 0]",537,345,192,37,22,0.1072463768115942,0.11458333333333333
"[0, 0, 0, 0, 1, 1, 1, 1, 1, 1, 0, 0, 1, 0, 0]",366,205,161,23,22,0.11219512195121951,0.13664596273291926
"[1, 1, 0, 0, 1, 1, 1, 1, 0, 0, 0, 0, 1, 1, 0]",1507,753,754,53,76,0.0703851261620186,0.10079575596816977
"[0, 1, 0, 0, 0, 0, 1, 0, 1, 1, 1, 0, 0, 1, 1]",142,78,64,9,11,0.11538461538461539,0.171875
"[0, 0, 1, 0, 0, 0, 0, 1, 0, 1, 1, 1, 0, 0, 1]",155,104,51,10,5,0.09615384615384616,0.09803921568627451
"[0, 0, 0, 1, 0, 1, 0, 0, 0, 1, 0, 0, 0, 0, 1]",549,386,163,42,18,0.10880829015544041,0.11042944785276074
"[1, 1, 1, 0, 0, 0, 0, 1, 0, 1, 0, 0, 0, 1, 0]",146,73,73,7,5,0.0958904109589041,0.0684931506849315
"[0, 0, 0, 0, 0, 0, 0, 0, 0, 1, 0, 0, 1, 0, 0]",7755,6434,1321,634,125,0.09853901150139882,0.09462528387585163
"[0, 0, 1, 1, 1, 1, 0, 1, 1, 1, 1, 0, 1, 1, 0]",278,112,166,10,17,0.08928571428571429,0.10240963855421686
"[1, 0, 1, 1, 0, 1, 1, 1, 1, 0, 0, 1, 1, 1, 1]",1024,294,730,27,69,0.09183673469387756,0.09452054794520548
"[1, 1, 1, 0, 1, 1, 0, 1, 1, 1, 1, 0, 0, 1, 1]",849,232,617,22,68,0.09482758620689655,0.11021069692058347
"[1, 1, 1, 1, 1, 0, 1, 1, 1, 1, 1, 0, 1, 1, 0]",1589,357,1232,41,105,0.11484593837535013,0.08522727272727272
"[1, 1, 0, 1, 0, 1, 0, 0, 0, 1, 0, 1, 0, 1, 0]",95,56,39,5,7,0.08928571428571429,0.1794871794871795
"[1, 0, 1, 0, 1, 1, 1, 1, 0, 1, 0, 1, 0, 0, 0]",117,60,57,2,11,0.03333333333333333,0.19298245614035087
"[1, 1, 0, 1, 0, 1, 0, 0, 0, 1, 1, 1, 0, 0, 0]",145,73,72,6,6,0.0821917808219178,0.08333333333333333
"[0, 0, 0, 1, 1, 0, 0, 0, 0, 0, 1, 0, 0, 0, 0]",2170,1749,421,150,43,0.08576329331046312,0.1021377672209026
"[0, 1, 0, 0, 0, 0, 1, 1, 0, 0, 0, 0, 0, 1, 0]",536,381,155,37,17,0.09711286089238845,0.10967741935483871
"[0, 0, 0, 0, 0, 0, 0, 1, 0, 1, 0, 0, 0, 0, 1]",1921,1462,459,139,49,0.09507523939808482,0.10675381263616558
"[1, 0, 0, 1, 1, 0, 0, 0, 0, 0, 0, 0, 0, 0, 0]",6614,2782,3832,252,341,0.0905823148813803,0.0889874739039666
"[1, 1, 1, 0, 1, 0, 0, 1, 1, 0, 0, 0, 0, 0, 0]",343,179,164,11,15,0.061452513966480445,0.09146341463414634
"[0, 0, 1, 1, 1, 0, 1, 0, 0, 1, 1, 0, 0, 0, 0]",235,114,121,14,12,0.12280701754385964,0.09917355371900827
"[0, 1, 0, 0, 0, 0, 1, 0, 0, 0, 0, 0, 1, 0, 0]",1558,1203,355,115,31,0.09559434746467166,0.08732394366197183
"[0, 0, 1, 0, 0, 0, 0, 0, 1, 0, 0, 0, 0, 0, 0]",7560,6230,1330,613,130,0.09839486356340289,0.09774436090225563
"[0, 0, 0, 1, 0, 0, 0, 0, 1, 0, 0, 0, 0, 0, 1]",1696,1287,409,131,40,0.10178710178710179,0.097799511002445
"[0, 0, 0, 0, 0, 1, 0, 0, 0, 0, 0, 0, 1, 1, 1]",2385,1916,469,192,42,0.10020876826722339,0.08955223880597014
"[0, 0, 0, 0, 1, 0, 0, 1, 0, 1, 0, 1, 0, 0, 0]",506,373,133,33,10,0.08847184986595175,0.07518796992481203
"[0, 0, 0, 1, 1, 1, 1, 1, 1, 1, 1, 1, 1, 1, 1]",8093,4896,3197,448,304,0.0915032679738562,0.0950891460744448
"[1, 1, 1, 1, 1, 1, 0, 0, 1, 1, 1, 1, 1, 1, 0]",6432,1669,4763,154,437,0.09227082085080887,0.09174889775351669
"[1, 1, 1, 1, 1, 1, 1, 1, 0, 1, 1, 0, 0, 1, 1]",2673,552,2121,59,191,0.1068840579710145,0.09005186232909006
"[0, 0, 1, 0, 1, 1, 1, 1, 0, 1, 1, 0, 1, 1, 1]",288,121,167,11,14,0.09090909090909091,0.08383233532934131
"[1, 1, 0, 0, 1, 0, 1, 1, 1, 1, 0, 1, 1, 0, 1]",209,72,137,7,15,0.09722222222222222,0.10948905109489052
"[0, 0, 0, 0, 0, 0, 0, 0, 0, 1, 1, 0, 0, 1, 1]",6189,5256,933,485,85,0.09227549467275495,0.09110396570203644
"[1, 1, 0, 1, 0, 1, 1, 0, 0, 0, 0, 1, 1, 0, 0]",257,125,132,10,10,0.08,0.07575757575757576
"[1, 1, 1, 1, 1, 1, 0, 1, 1, 1, 1, 0, 1, 1, 1]",7864,1399,6465,130,622,0.09292351679771266,0.09621036349574633
"[0, 0, 1, 1, 1, 1, 1, 0, 1, 1, 1, 1, 1, 1, 1]",2601,660,1941,46,170,0.0696969696969697,0.08758371973209686
"[1, 1, 1, 1, 0, 0, 1, 1, 1, 1, 1, 0, 1, 1, 1]",2923,746,2177,80,210,0.10723860589812333,0.09646302250803858
"[1, 1, 1, 1, 1, 1, 1, 0, 0, 1, 1, 1, 1, 1, 0]",3028,522,2506,43,245,0.08237547892720307,0.09776536312849161
"[1, 1, 1, 1, 0, 1, 1, 1, 1, 1, 1, 0, 1, 1, 1]",7395,1352,6043,124,597,0.09171597633136094,0.0987919907330796
"[1, 1, 0, 1, 1, 1, 1, 1, 1, 1, 1, 0, 1, 1, 1]",7570,1344,6226,126,577,0.09375,0.09267587536138773
"[1, 0, 0, 0, 0, 0, 0, 0, 0, 0, 1, 1, 1, 1, 1]",926,422,504,43,58,0.1018957345971564,0.11507936507936507
"[1, 0, 0, 1, 0, 0, 1, 0, 1, 1, 1, 0, 1, 0, 0]",96,43,53,6,6,0.13953488372093023,0.11320754716981132
"[0, 0, 0, 0, 0, 1, 0, 0, 1, 0, 0, 1, 0, 1, 1]",311,197,114,14,16,0.07106598984771574,0.14035087719298245
"[1, 0, 0, 0, 0, 1, 0, 0, 0, 1, 0, 1, 0, 0, 0]",558,381,177,32,14,0.08398950131233596,0.07909604519774012
"[0, 0, 1, 0, 0, 0, 0, 1, 0, 0, 0, 1, 0, 1, 0]",471,328,143,25,11,0.07621951219512195,0.07692307692307693
"[1, 0, 0, 0, 0, 1, 0, 0, 1, 0, 0, 1, 0, 0, 1]",251,155,96,10,12,0.06451612903225806,0.125
"[0, 1, 1, 0, 1, 0, 0, 1, 1, 1, 0, 1, 1, 1, 1]",277,113,164,7,13,0.061946902654867256,0.07926829268292683
"[0, 0, 0, 1, 0, 0, 1, 1, 0, 1, 1, 1, 0, 1, 1]",111,56,55,6,5,0.10714285714285714,0.09090909090909091
"[0, 1, 0, 0, 0, 0, 0, 0, 0, 0, 0, 0, 1, 0, 0]",6935,5722,1213,519,107,0.0907025515554002,0.08821104699093157
"[0, 1, 0, 0, 0, 0, 0, 0, 1, 1, 0, 0, 0, 0, 1]",1168,794,374,75,40,0.09445843828715365,0.10695187165775401
"[1, 0, 0, 1, 0, 0, 1, 1, 0, 0, 0, 0, 0, 0, 0]",1023,724,299,58,34,0.08011049723756906,0.11371237458193979
"[0, 1, 0, 0, 1, 0, 0, 1, 1, 0, 0, 0, 0, 0, 0]",957,665,292,64,28,0.0962406015037594,0.0958904109589041
"[0, 1, 1, 0, 1, 1, 1, 1, 1, 1, 1, 1, 1, 0, 0]",1002,326,676,23,40,0.0705521472392638,0.05917159763313609
"[1, 0, 1, 0, 0, 0, 1, 0, 0, 0, 0, 0, 0, 0, 0]",1973,1473,500,157,40,0.10658520027155464,0.08
"[0, 0, 1, 1, 0, 1, 0, 0, 0, 1, 0, 0, 0, 0, 0]",617,444,173,40,23,0.09009009009009009,0.1329479768786127
"[0, 0, 0, 0, 0, 1, 0, 0, 0, 1, 1, 0, 1, 0, 0]",500,364,136,44,15,0.12087912087912088,0.11029411764705882
"[0, 0, 0, 0, 1, 1, 0, 0, 0, 0, 1, 0, 0, 0, 0]",2427,1854,573,169,65,0.09115426105717368,0.11343804537521815
"[1, 0, 0, 0, 0, 1, 1, 0, 0, 0, 0, 1, 0, 0, 0]",826,436,390,36,42,0.08256880733944955,0.1076923076923077
"[0, 1, 1, 1, 0, 0, 0, 1, 1, 0, 0, 0, 0, 0, 0]",470,294,176,27,13,0.09183673469387756,0.07386363636363637
"[1, 0, 1, 1, 1, 0, 0, 0, 1, 1, 0, 0, 0, 0, 0]",242,139,103,16,13,0.11510791366906475,0.1262135922330097
"[0, 0, 1, 1, 1, 1, 0, 1, 1, 0, 1, 0, 1, 0, 1]",159,80,79,7,10,0.0875,0.12658227848101267
"[1, 1, 1, 1, 1, 0, 0, 1, 1, 1, 1, 0, 1, 1, 1]",3116,534,2582,50,225,0.09363295880149813,0.087141750580945
"[0, 1, 1, 1, 1, 1, 1, 1, 0, 0, 1, 1, 0, 1, 1]",730,278,452,31,34,0.11151079136690648,0.0752212389380531
"[1, 0, 0, 1, 0, 0, 0, 0, 1, 1, 0, 0, 1, 1, 1]",310,160,150,12,18,0.075,0.12
"[1, 0, 0, 0, 1, 0, 0, 1, 0, 0, 0, 0, 1, 1, 0]",314,211,103,22,9,0.10426540284360189,0.08737864077669903
"[1, 1, 1, 1, 1, 0, 1, 1, 1, 1, 1, 0, 0, 0, 1]",632,182,450,18,38,0.0989010989010989,0.08444444444444445
"[0, 0, 1, 0, 0, 1, 1, 0, 1, 1, 1, 1, 1, 0, 1]",134,54,80,3,3,0.05555555555555555,0.0375
"[1, 0, 0, 1, 0, 0, 1, 0, 0, 1, 1, 0, 1, 1, 1]",115,62,53,8,8,0.12903225806451613,0.1509433962264151
"[1, 1, 1, 0, 1, 1, 0, 0, 0, 1, 1, 1, 0, 1, 1]",272,98,174,6,19,0.061224489795918366,0.10919540229885058
"[1, 1, 1, 1, 1, 1, 0, 1, 1, 1, 0, 0, 0, 1, 1]",771,212,559,21,53,0.09905660377358491,0.09481216457960644
"[1, 1, 1, 1, 0, 0, 0, 0, 1, 1, 0, 1, 1, 1, 1]",750,252,498,24,68,0.09523809523809523,0.13654618473895583
"[0, 1, 1, 1, 0, 1, 1, 1, 1, 1, 1, 1, 0, 1, 0]",470,138,332,13,37,0.09420289855072464,0.11144578313253012
"[1, 1, 0, 0, 1, 1, 1, 0, 0, 0, 1, 0, 1, 1, 1]",267,120,147,9,8,0.075,0.05442176870748299
"[1, 1, 0, 0, 0, 0, 0, 1, 0, 0, 0, 0, 1, 1, 0]",395,231,164,20,13,0.08658008658008658,0.07926829268292683
"[1, 0, 1, 0, 0, 1, 0, 1, 0, 0, 1, 0, 0, 1, 0]",138,82,56,5,7,0.06097560975609756,0.125
"[1, 0, 0, 0, 0, 0, 0, 0, 1, 1, 1, 1, 0, 0, 0]",909,569,340,38,21,0.06678383128295255,0.061764705882352944
"[0, 0, 1, 1, 0, 1, 1, 0, 1, 0, 1, 0, 1, 0, 0]",110,55,55,6,4,0.10909090909090909,0.07272727272727272
"[0, 0, 1, 0, 0, 0, 0, 0, 1, 1, 0, 1, 1, 0, 1]",154,89,65,5,3,0.056179775280898875,0.046153846153846156
"[0, 0, 1, 1, 0, 0, 0, 1, 0, 0, 0, 0, 0, 1, 1]",446,314,132,33,18,0.10509554140127389,0.13636363636363635
"[0, 0, 0, 1, 0, 0, 0, 0, 0, 0, 0, 0, 0, 1, 0]",6795,5578,1217,553,100,0.09913947651487988,0.08216926869350863
"[0, 0, 0, 0, 1, 0, 0, 0, 0, 0, 0, 0, 0, 0, 1]",8708,7157,1551,708,155,0.09892413022216012,0.09993552546744036
"[1, 1, 0, 0, 0, 1, 1, 1, 0, 0, 0, 0, 1, 0, 0]",159,89,70,11,4,0.12359550561797752,0.05714285714285714
"[1, 1, 1, 1, 0, 0, 1, 1, 1, 0, 0, 1, 1, 1, 0]",316,110,206,9,18,0.08181818181818182,0.08737864077669903
"[1, 1, 1, 1, 1, 0, 0, 0, 1, 1, 1, 1, 1, 0, 1]",652,159,493,10,55,0.06289308176100629,0.11156186612576065
"[1, 1, 1, 1, 0, 0, 1, 1, 1, 1, 0, 0, 1, 1, 1]",5242,1520,3722,139,373,0.09144736842105264,0.10021493820526599
"[1, 1, 1, 1, 0, 1, 1, 1, 1, 1, 1, 0, 0, 0, 0]",714,218,496,20,44,0.09174311926605505,0.08870967741935484
"[0, 0, 1, 0, 1, 1, 1, 1, 0, 1, 1, 1, 1, 1, 1]",704,233,471,20,52,0.08583690987124463,0.11040339702760085
"[1, 1, 1, 1, 0, 0, 1, 0, 1, 1, 1, 1, 0, 1, 1]",587,160,427,21,42,0.13125,0.09836065573770492
"[1, 1, 1, 1, 1, 0, 0, 1, 0, 1, 1, 1, 1, 0, 1]",603,169,434,10,35,0.05917159763313609,0.08064516129032258
"[1, 1, 1, 1, 1, 0, 1, 0, 1, 1, 0, 1, 1, 1, 1]",1832,405,1427,45,127,0.1111111111111111,0.0889978976874562
"[0, 0, 1, 1, 1, 1, 1, 1, 1, 1, 0, 1, 0, 1, 1]",914,279,635,29,73,0.1039426523297491,0.11496062992125984
"[0, 1, 1, 0, 0, 1, 1, 1, 1, 1, 0, 0, 1, 1, 0]",268,135,133,12,9,0.08888888888888889,0.06766917293233082
"[0, 0, 1, 0, 1, 1, 0, 1, 0, 0, 0, 0, 1, 0, 0]",224,151,73,8,7,0.052980132450331126,0.0958904109589041
"[0, 0, 0, 1, 0, 1, 1, 0, 1, 0, 0, 0, 0, 1, 0]",237,149,88,10,12,0.06711409395973154,0.13636363636363635
"[0, 1, 1, 1, 1, 1, 0, 1, 1, 0, 1, 1, 1, 0, 1]",517,156,361,9,36,0.057692307692307696,0.0997229916897507
"[1, 0, 1, 1, 1, 1, 1, 0, 1, 1, 0, 1, 1, 1, 0]",523,168,355,15,33,0.08928571428571429,0.09295774647887324
"[1, 1, 1, 0, 1, 0, 1, 1, 1, 1, 1, 0, 1, 1, 0]",523,145,378,17,26,0.11724137931034483,0.06878306878306878
"[1, 1, 1, 1, 1, 1, 0, 1, 0, 1, 1, 1, 1, 1, 0]",1783,405,1378,38,144,0.09382716049382717,0.10449927431059507
"[0, 0, 0, 1, 0, 1, 1, 1, 1, 1, 0, 0, 0, 1, 1]",162,78,84,6,9,0.07692307692307693,0.10714285714285714
"[0, 0, 0, 0, 1, 1, 0, 0, 1, 1, 0, 0, 0, 0, 1]",2419,1580,839,159,84,0.10063291139240506,0.10011918951132301
"[0, 1, 0, 1, 0, 0, 0, 0, 0, 0, 0, 0, 0, 1, 1]",1139,836,303,78,32,0.09330143540669857,0.10561056105610561
"[0, 0, 1, 0, 1, 0, 0, 0, 1, 0, 1, 0, 0, 0, 0]",557,408,149,40,16,0.09803921568627451,0.10738255033557047
"[0, 0, 0, 1, 0, 1, 0, 0, 0, 1, 0, 1, 0, 0, 0]",546,384,162,33,17,0.0859375,0.10493827160493827
"[0, 1, 0, 0, 0, 0, 1, 0, 1, 0, 0, 0, 1, 0, 1]",240,157,83,11,5,0.07006369426751592,0.060240963855421686
"[0, 1, 0, 0, 1, 1, 0, 0, 1, 1, 0, 0, 0, 0, 1]",463,267,196,20,11,0.0749063670411985,0.05612244897959184
"[0, 0, 1, 1, 0, 1, 0, 0, 1, 1, 0, 0, 1, 1, 0]",207,110,97,11,9,0.1,0.09278350515463918
"[1, 1, 0, 1, 0, 1, 1, 1, 1, 1, 1, 1, 0, 0, 1]",841,251,590,20,53,0.0796812749003984,0.08983050847457627
"[0, 1, 1, 1, 1, 0, 1, 0, 1, 1, 1, 1, 1, 1, 1]",2145,630,1515,54,134,0.08571428571428572,0.08844884488448845
"[1, 0, 1, 1, 1, 1, 0, 1, 0, 1, 1, 1, 1, 1, 1]",1868,454,1414,43,123,0.0947136563876652,0.086987270155587
"[0, 1, 0, 1, 1, 1, 1, 0, 1, 0, 1, 1, 1, 1, 1]",612,183,429,26,32,0.14207650273224043,0.07459207459207459
"[1, 0, 0, 1, 1, 1, 1, 1, 1, 0, 1, 0, 1, 1, 1]",864,192,672,16,58,0.08333333333333333,0.08630952380952381
"[0, 0, 0, 0, 0, 0, 0, 0, 1, 1, 1, 0, 1, 1, 1]",681,452,229,47,22,0.10398230088495575,0.09606986899563319
"[1, 1, 1, 0, 0, 0, 0, 0, 0, 0, 0, 1, 1, 1, 0]",382,125,257,13,20,0.104,0.07782101167315175
"[1, 1, 1, 1, 1, 0, 1, 0, 0, 0, 0, 1, 1, 1, 1]",525,162,363,8,31,0.04938271604938271,0.08539944903581267
"[1, 1, 1, 0, 0, 1, 1, 1, 1, 1, 1, 0, 1, 1, 1]",3129,511,2618,52,221,0.10176125244618395,0.08441558441558442
"[1, 1, 1, 0, 0, 0, 1, 0, 0, 0, 1, 1, 0, 0, 1]",173,83,90,7,13,0.08433734939759036,0.14444444444444443
"[1, 0, 1, 0, 1, 1, 1, 1, 1, 1, 1, 1, 1, 1, 0]",2032,506,1526,39,142,0.07707509881422925,0.09305373525557012
"[0, 1, 1, 1, 1, 1, 0, 1, 0, 1, 1, 1, 1, 1, 1]",1991,627,1364,63,123,0.10047846889952153,0.09017595307917889
"[1, 1, 0, 0, 0, 1, 1, 0, 0, 0, 0, 0, 1, 0, 0]",250,166,84,13,6,0.0783132530120482,0.07142857142857142
"[1, 0, 0, 0, 1, 1, 0, 1, 0, 0, 1, 1, 0, 0, 0]",187,107,80,5,2,0.04672897196261682,0.025
"[0, 0, 1, 0, 0, 0, 0, 1, 1, 0, 0, 0, 1, 1, 0]",298,183,115,19,13,0.10382513661202186,0.11304347826086956
"[1, 1, 1, 1, 0, 0, 0, 0, 1, 0, 0, 0, 0, 1, 1]",242,142,100,16,9,0.11267605633802817,0.09
"[0, 0, 0, 1, 1, 0, 0, 1, 1, 0, 0, 0, 1, 0, 0]",498,375,123,40,19,0.10666666666666667,0.15447154471544716
"[1, 1, 1, 0, 1, 0, 1, 1, 1, 0, 0, 1, 1, 1, 1]",880,236,644,18,61,0.07627118644067797,0.09472049689440994
"[0, 1, 1, 0, 1, 0, 1, 1, 1, 1, 1, 1, 1, 0, 1]",504,148,356,13,40,0.08783783783783784,0.11235955056179775
"[1, 1, 0, 0, 0, 0, 0, 0, 1, 1, 1, 1, 1, 1, 0]",1656,798,858,78,85,0.09774436090225563,0.09906759906759907
"[0, 1, 1, 0, 1, 1, 0, 0, 0, 0, 0, 0, 1, 1, 1]",350,190,160,16,12,0.08421052631578947,0.075
"[0, 1, 1, 1, 0, 1, 1, 0, 1, 1, 0, 0, 0, 0, 0]",166,89,77,8,6,0.0898876404494382,0.07792207792207792
"[1, 0, 1, 1, 0, 0, 1, 1, 0, 0, 0, 0, 0, 0, 0]",734,447,287,37,23,0.08277404921700224,0.08013937282229965
"[0, 1, 0, 1, 1, 0, 0, 1, 1, 0, 0, 0, 0, 0, 0]",692,433,259,39,21,0.09006928406466513,0.08108108108108109
"[1, 0, 0, 1, 0, 0, 1, 0, 1, 1, 0, 0, 1, 1, 0]",158,82,76,12,7,0.14634146341463414,0.09210526315789473
"[1, 0, 1, 0, 1, 1, 0, 1, 1, 1, 0, 0, 1, 0, 0]",123,70,53,6,5,0.08571428571428572,0.09433962264150944
"[1, 1, 1, 1, 1, 1, 1, 1, 0, 0, 0, 1, 1, 1, 1]",3603,785,2818,65,282,0.08280254777070063,0.10007097232079488
"[0, 0, 1, 1, 0, 1, 1, 0, 0, 1, 1, 1, 0, 0, 1]",141,57,84,4,8,0.07017543859649122,0.09523809523809523
"[1, 1, 1, 1, 0, 0, 1, 0, 0, 1, 1, 1, 1, 1, 0]",315,114,201,13,21,0.11403508771929824,0.1044776119402985
"[1, 1, 1, 0, 0, 1, 0, 1, 1, 0, 1, 1, 1, 0, 1]",230,72,158,8,21,0.1111111111111111,0.13291139240506328
"[0, 0, 0, 1, 1, 1, 1, 0, 0, 1, 0, 1, 1, 1, 0]",151,87,64,6,3,0.06896551724137931,0.046875
"[0, 1, 1, 1, 0, 0, 1, 1, 0, 0, 0, 0, 1, 1, 1]",479,233,246,15,28,0.06437768240343347,0.11382113821138211
"[0, 0, 0, 0, 1, 1, 1, 0, 0, 1, 1, 0, 0, 0, 0]",638,417,221,40,27,0.09592326139088729,0.12217194570135746
"[0, 1, 0, 1, 1, 1, 1, 1, 1, 1, 1, 1, 1, 0, 0]",1216,425,791,42,66,0.0988235294117647,0.08343868520859671
"[1, 0, 0, 0, 0, 1, 0, 0, 0, 1, 0, 0, 1, 1, 1]",275,145,130,4,11,0.027586206896551724,0.08461538461538462
"[0, 0, 0, 0, 1, 0, 0, 0, 0, 1, 0, 0, 0, 1, 0]",1494,1149,345,100,29,0.08703220191470844,0.08405797101449275
"[1, 0, 0, 0, 0, 0, 0, 0, 1, 0, 0, 0, 0, 1, 0]",1563,1150,413,116,35,0.10086956521739131,0.0847457627118644
"[0, 0, 0, 0, 0, 0, 0, 1, 0, 1, 0, 0, 1, 0, 0]",1694,1310,384,116,32,0.08854961832061069,0.08333333333333333
"[0, 0, 1, 1, 0, 1, 0, 1, 1, 0, 1, 0, 0, 0, 0]",158,94,64,7,4,0.07446808510638298,0.0625
"[1, 0, 1, 1, 0, 0, 0, 0, 0, 0, 0, 0, 0, 1, 1]",627,400,227,48,23,0.12,0.1013215859030837
"[0, 0, 0, 0, 0, 0, 0, 0, 1, 1, 1, 1, 0, 0, 0]",5331,3887,1444,364,148,0.09364548494983277,0.10249307479224377
"[0, 1, 0, 1, 1, 0, 1, 0, 1, 1, 1, 0, 0, 0, 0]",155,70,85,9,11,0.12857142857142856,0.12941176470588237
"[0, 0, 0, 0, 0, 0, 1, 0, 0, 0, 1, 0, 0, 0, 1]",1724,1325,399,123,36,0.09283018867924528,0.09022556390977443
"[1, 0, 0, 1, 0, 1, 0, 0, 0, 1, 0, 0, 0, 0, 0]",547,366,181,28,12,0.07650273224043716,0.06629834254143646
"[1, 1, 0, 0, 1, 0, 1, 1, 0, 0, 1, 0, 1, 0, 0]",112,61,51,6,4,0.09836065573770492,0.0784313725490196
"[1, 0, 1, 1, 1, 1, 1, 1, 0, 0, 1, 1, 0, 0, 1]",856,287,569,31,51,0.10801393728222997,0.08963093145869948
"[0, 1, 1, 0, 1, 1, 1, 0, 1, 0, 0, 1, 1, 1, 0]",134,59,75,6,6,0.1016949152542373,0.08
"[1, 1, 0, 1, 0, 0, 0, 0, 0, 0, 0, 0, 1, 1, 0]",507,297,210,18,16,0.06060606060606061,0.0761904761904762
"[0, 1, 0, 0, 0, 0, 0, 1, 1, 0, 1, 0, 0, 0, 0]",589,413,176,32,19,0.0774818401937046,0.10795454545454546
"[1, 1, 0, 0, 1, 1, 1, 1, 0, 0, 1, 1, 0, 0, 1]",1940,758,1182,73,103,0.09630606860158311,0.08714043993231811
"[0, 1, 0, 0, 0, 0, 0, 0, 1, 0, 0, 0, 0, 0, 0]",7585,6210,1375,588,137,0.09468599033816426,0.09963636363636363
"[0, 0, 0, 0, 0, 1, 0, 0, 0, 1, 1, 0, 0, 0, 0]",2492,1955,537,192,53,0.09820971867007673,0.09869646182495345
"[0, 0, 0, 0, 0, 0, 0, 0, 0, 0, 1, 0, 0, 0, 1]",9494,7992,1502,714,130,0.08933933933933934,0.08655126498002663
"[0, 1, 1, 0, 1, 1, 0, 0, 1, 0, 0, 0, 0, 0, 0]",333,212,121,16,15,0.07547169811320754,0.12396694214876033
"[0, 1, 0, 1, 0, 0, 1, 1, 0, 0, 0, 0, 0, 0, 0]",1027,727,300,67,40,0.0921595598349381,0.13333333333333333
"[1, 1, 1, 1, 0, 0, 0, 1, 0, 0, 0, 0, 1, 1, 0]",188,96,92,7,5,0.07291666666666667,0.05434782608695652
"[1, 0, 1, 0, 0, 0, 1, 1, 1, 1, 0, 1, 1, 0, 0]",124,48,76,8,8,0.16666666666666666,0.10526315789473684
"[1, 0, 1, 0, 0, 0, 0, 1, 1, 1, 1, 1, 0, 1, 1]",176,73,103,8,14,0.1095890410958904,0.13592233009708737
"[0, 1, 0, 1, 0, 0, 0, 1, 1, 1, 1, 0, 0, 1, 0]",125,66,59,7,5,0.10606060606060606,0.0847457627118644
"[0, 1, 1, 0, 1, 0, 1, 0, 0, 0, 1, 1, 1, 1, 0]",142,75,67,7,5,0.09333333333333334,0.07462686567164178
"[0, 1, 0, 1, 0, 0, 1, 1, 1, 0, 1, 1, 0, 1, 0]",115,49,66,5,4,0.10204081632653061,0.06060606060606061
"[1, 1, 0, 1, 0, 0, 0, 1, 0, 1, 0, 1, 0, 0, 1]",118,61,57,12,7,0.19672131147540983,0.12280701754385964
"[0, 1, 0, 0, 1, 0, 0, 0, 1, 1, 1, 1, 1, 0, 1]",108,56,52,2,3,0.03571428571428571,0.057692307692307696
"[0, 1, 1, 0, 1, 0, 0, 1, 0, 0, 0, 1, 1, 1, 1]",194,107,87,14,5,0.1308411214953271,0.05747126436781609
"[0, 1, 1, 1, 0, 0, 1, 1, 0, 1, 0, 0, 1, 0, 0]",106,58,48,8,8,0.13793103448275862,0.16666666666666666
"[0, 0, 0, 0, 0, 0, 0, 0, 1, 1, 0, 1, 0, 1, 0]",748,504,244,62,23,0.12301587301587301,0.0942622950819672
"[0, 1, 1, 1, 1, 1, 1, 1, 1, 0, 0, 1, 1, 0, 0]",2196,1495,701,137,62,0.09163879598662207,0.0884450784593438
"[1, 1, 1, 1, 1, 1, 0, 0, 1, 0, 1, 1, 1, 1, 1]",2381,543,1838,40,185,0.07366482504604052,0.10065288356909684
"[0, 0, 0, 1, 0, 0, 0, 1, 1, 1, 0, 1, 0, 1, 1]",133,70,63,9,7,0.12857142857142856,0.1111111111111111
"[1, 0, 1, 1, 1, 0, 0, 0, 1, 0, 0, 0, 1, 1, 1]",149,78,71,6,3,0.07692307692307693,0.04225352112676056
"[0, 0, 1, 0, 1, 1, 1, 0, 1, 1, 1, 1, 1, 1, 1]",764,249,515,21,49,0.08433734939759036,0.09514563106796116
"[1, 1, 1, 1, 0, 1, 1, 1, 0, 1, 1, 1, 1, 1, 0]",1701,398,1303,39,111,0.09798994974874371,0.0851880276285495
"[0, 1, 1, 0, 0, 0, 0, 1, 1, 1, 1, 1, 0, 1, 1]",368,266,102,25,10,0.09398496240601503,0.09803921568627451
"[0, 1, 0, 1, 1, 1, 0, 1, 1, 1, 0, 1, 0, 0, 0]",121,55,66,4,5,0.07272727272727272,0.07575757575757576
"[0, 1, 1, 0, 0, 1, 0, 1, 1, 1, 0, 1, 0, 1, 0]",93,52,41,6,3,0.11538461538461539,0.07317073170731707
"[1, 1, 1, 0, 0, 0, 1, 1, 0, 0, 1, 1, 1, 1, 0]",329,124,205,12,16,0.0967741935483871,0.07804878048780488
"[1, 0, 0, 1, 1, 1, 0, 0, 0, 1, 1, 0, 0, 1, 1]",209,87,122,10,9,0.11494252873563218,0.07377049180327869
"[0, 0, 1, 0, 0, 1, 1, 1, 0, 0, 1, 0, 0, 1, 0]",128,69,59,13,4,0.18840579710144928,0.06779661016949153
"[0, 0, 0, 0, 1, 0, 0, 1, 1, 1, 0, 0, 1, 0, 0]",234,149,85,13,6,0.087248322147651,0.07058823529411765
"[0, 1, 1, 0, 0, 0, 0, 1, 0, 0, 1, 1, 1, 0, 0]",232,152,80,16,4,0.10526315789473684,0.05
"[0, 0, 0, 0, 1, 1, 0, 0, 0, 0, 0, 0, 1, 1, 1]",3980,2783,1197,269,90,0.09665828242903342,0.07518796992481203
"[0, 1, 0, 0, 1, 1, 0, 0, 0, 0, 0, 1, 0, 1, 0]",257,162,95,17,8,0.10493827160493827,0.08421052631578947
"[1, 0, 0, 0, 0, 1, 0, 0, 0, 0, 1, 1, 0, 0, 1]",360,223,137,23,10,0.1031390134529148,0.072992700729927
"[1, 1, 1, 1, 0, 0, 0, 1, 1, 0, 0, 1, 0, 0, 0]",143,70,73,8,11,0.11428571428571428,0.1506849315068493
"[1, 1, 1, 0, 0, 1, 1, 0, 0, 0, 1, 0, 0, 1, 1]",228,71,157,8,17,0.11267605633802817,0.10828025477707007
"[0, 0, 1, 1, 1, 1, 0, 0, 0, 1, 1, 0, 1, 1, 1]",308,133,175,7,17,0.05263157894736842,0.09714285714285714
"[1, 0, 1, 1, 0, 1, 1, 0, 0, 0, 0, 0, 0, 1, 0]",152,84,68,8,6,0.09523809523809523,0.08823529411764706
"[0, 1, 1, 0, 0, 0, 0, 0, 0, 0, 1, 1, 1, 0, 1]",219,147,72,17,6,0.11564625850340136,0.08333333333333333
"[1, 0, 0, 1, 1, 0, 0, 0, 1, 0, 0, 0, 0, 1, 0]",275,153,122,16,9,0.10457516339869281,0.07377049180327869
"[1, 1, 0, 1, 0, 1, 0, 0, 1, 1, 1, 1, 0, 0, 1]",265,107,158,5,13,0.04672897196261682,0.08227848101265822
"[1, 1, 1, 1, 1, 1, 0, 1, 1, 0, 1, 1, 0, 0, 0]",376,112,264,5,25,0.044642857142857144,0.0946969696969697
"[1, 1, 0, 1, 0, 0, 1, 1, 0, 1, 0, 1, 0, 0, 0]",123,67,56,5,7,0.07462686567164178,0.125
"[1, 1, 0, 1, 1, 0, 1, 0, 0, 0, 1, 1, 1, 0, 1]",126,49,77,2,9,0.04081632653061224,0.11688311688311688
"[0, 0, 0, 1, 1, 1, 0, 1, 0, 1, 0, 0, 0, 1, 0]",162,99,63,10,4,0.10101010101010101,0.06349206349206349
"[0, 0, 1, 0, 0, 1, 0, 0, 0, 1, 1, 1, 1, 1, 1]",208,96,112,10,11,0.10416666666666667,0.09821428571428571
"[1, 1, 0, 0, 1, 1, 0, 1, 0, 0, 1, 0, 0, 1, 0]",99,62,37,8,2,0.12903225806451613,0.05405405405405406
"[0, 0, 0, 0, 0, 0, 0, 1, 1, 0, 1, 1, 1, 0, 0]",311,208,103,19,9,0.09134615384615384,0.08737864077669903
"[1, 1, 0, 0, 0, 0, 0, 0, 0, 0, 1, 1, 0, 1, 1]",548,314,234,25,23,0.07961783439490445,0.09829059829059829
"[1, 1, 1, 1, 1, 1, 1, 1, 1, 0, 0, 0, 1, 0, 0]",443,109,334,10,34,0.09174311926605505,0.10179640718562874
"[0, 0, 0, 0, 0, 1, 1, 0, 0, 0, 0, 1, 1, 1, 1]",2531,2130,401,198,37,0.09295774647887324,0.09226932668329177
"[1, 1, 0, 1, 1, 1, 0, 0, 0, 1, 1, 1, 1, 0, 0]",230,80,150,13,19,0.1625,0.12666666666666668
"[1, 0, 0, 1, 0, 0, 0, 0, 0, 1, 0, 1, 1, 1, 1]",151,83,68,13,5,0.1566265060240964,0.07352941176470588
"[1, 0, 1, 0, 0, 1, 0, 0, 0, 0, 0, 1, 0, 1, 1]",164,97,67,4,5,0.041237113402061855,0.07462686567164178
"[1, 1, 0, 0, 0, 0, 0, 1, 0, 0, 0, 0, 0, 0, 0]",2299,1758,541,180,44,0.10238907849829351,0.08133086876155268
"[0, 0, 0, 0, 0, 1, 0, 0, 0, 0, 0, 1, 1, 1, 1]",906,683,223,62,22,0.09077598828696926,0.09865470852017937
"[0, 0, 0, 0, 0, 0, 1, 0, 1, 1, 1, 1, 0, 0, 0]",457,308,149,31,17,0.10064935064935066,0.11409395973154363
"[0, 0, 0, 0, 0, 0, 0, 1, 0, 1, 1, 0, 0, 0, 1]",661,473,188,44,11,0.09302325581395349,0.05851063829787234
"[0, 1, 1, 0, 1, 1, 1, 0, 0, 0, 0, 1, 1, 1, 0]",139,68,71,8,7,0.11764705882352941,0.09859154929577464
"[1, 0, 0, 0, 1, 0, 0, 1, 0, 1, 0, 1, 0, 1, 1]",104,50,54,9,4,0.18,0.07407407407407407
"[0, 1, 1, 0, 0, 0, 1, 1, 1, 1, 1, 1, 1, 0, 0]",297,144,153,14,14,0.09722222222222222,0.0915032679738562
"[0, 0, 0, 1, 1, 0, 0, 0, 1, 1, 0, 0, 0, 1, 1]",284,194,90,16,9,0.08247422680412371,0.1
"[0, 0, 1, 0, 0, 1, 1, 1, 0, 1, 0, 1, 1, 1, 0]",111,42,69,8,5,0.19047619047619047,0.07246376811594203
"[1, 0, 1, 0, 1, 0, 0, 1, 0, 0, 1, 1, 1, 0, 1]",120,57,63,5,10,0.08771929824561403,0.15873015873015872
"[1, 1, 0, 0, 0, 0, 1, 0, 1, 0, 0, 0, 0, 1, 1]",250,163,87,13,10,0.07975460122699386,0.11494252873563218
"[0, 0, 1, 1, 0, 0, 0, 0, 1, 0, 1, 0, 0, 0, 0]",704,497,207,53,14,0.10663983903420524,0.06763285024154589
"[0, 1, 0, 1, 0, 0, 1, 0, 0, 0, 0, 0, 0, 1, 1]",392,261,131,24,14,0.09195402298850575,0.10687022900763359
"[0, 1, 0, 0, 1, 0, 0, 0, 0, 0, 1, 1, 1, 0, 1]",158,87,71,9,3,0.10344827586206896,0.04225352112676056
"[0, 0, 0, 0, 0, 0, 0, 1, 0, 1, 1, 1, 1, 0, 0]",452,298,154,32,17,0.10738255033557047,0.11038961038961038
"[0, 0, 0, 0, 0, 0, 0, 0, 1, 0, 1, 1, 1, 1, 0]",404,273,131,25,13,0.09157509157509157,0.09923664122137404
"[1, 0, 0, 0, 0, 1, 0, 0, 0, 1, 0, 0, 0, 0, 1]",594,411,183,32,24,0.07785888077858881,0.13114754098360656
"[0, 1, 0, 1, 0, 1, 0, 0, 0, 0, 0, 0, 1, 1, 1]",280,176,104,20,10,0.11363636363636363,0.09615384615384616
"[0, 0, 1, 0, 1, 0, 1, 0, 0, 0, 0, 0, 0, 1, 1]",398,265,133,25,8,0.09433962264150944,0.06015037593984962
"[1, 1, 0, 0, 1, 1, 0, 0, 0, 0, 1, 0, 1, 0, 1]",241,105,136,9,14,0.08571428571428572,0.10294117647058823
"[1, 0, 1, 1, 1, 0, 0, 1, 1, 0, 0, 0, 0, 1, 0]",155,88,67,7,5,0.07954545454545454,0.07462686567164178
"[1, 1, 0, 0, 0, 0, 0, 0, 0, 1, 0, 1, 1, 1, 0]",212,121,91,6,3,0.049586776859504134,0.03296703296703297
"[1, 0, 0, 0, 0, 0, 1, 0, 1, 0, 0, 1, 1, 0, 0]",324,191,133,23,17,0.12041884816753927,0.12781954887218044
"[0, 0, 0, 1, 1, 1, 0, 1, 1, 0, 0, 0, 0, 0, 1]",187,108,79,8,7,0.07407407407407407,0.08860759493670886
"[0, 1, 1, 0, 0, 0, 0, 1, 0, 0, 0, 1, 1, 1, 0]",154,98,56,8,7,0.08163265306122448,0.125
"[1, 0, 1, 1, 1, 0, 0, 0, 1, 1, 1, 1, 1, 0, 1]",258,87,171,7,14,0.08045977011494253,0.08187134502923976
"[1, 1, 0, 0, 1, 0, 1, 1, 1, 0, 0, 0, 1, 0, 1]",118,58,60,8,4,0.13793103448275862,0.06666666666666667
"[1, 0, 0, 1, 0, 0, 1, 0, 0, 1, 1, 0, 0, 1, 1]",203,97,106,8,6,0.08247422680412371,0.05660377358490566
"[0, 0, 0, 0, 0, 1, 1, 1, 0, 1, 0, 0, 0, 1, 1]",270,188,82,15,10,0.0797872340425532,0.12195121951219512
"[0, 0, 1, 0, 0, 0, 0, 1, 0, 0, 1, 0, 1, 1, 1]",214,146,68,14,3,0.0958904109589041,0.04411764705882353
"[0, 1, 0, 0, 0, 0, 0, 1, 1, 0, 0, 1, 0, 0, 0]",580,418,162,35,15,0.08373205741626795,0.09259259259259259
"[0, 0, 1, 0, 0, 0, 0, 0, 1, 0, 0, 0, 0, 0, 1]",1669,1238,431,113,37,0.0912762520193861,0.08584686774941995
"[0, 1, 0, 0, 0, 0, 0, 0, 1, 0, 0, 0, 0, 0, 1]",1750,1336,414,111,38,0.08308383233532934,0.09178743961352658
"[0, 1, 1, 0, 0, 1, 0, 1, 1, 0, 1, 0, 0, 0, 1]",109,60,49,4,6,0.06666666666666667,0.12244897959183673
"[0, 1, 0, 0, 1, 0, 0, 1, 1, 0, 1, 0, 1, 0, 0]",154,90,64,2,8,0.022222222222222223,0.125
"[1, 0, 0, 0, 1, 0, 0, 1, 0, 0, 1, 1, 0, 1, 0]",144,77,67,5,6,0.06493506493506493,0.08955223880597014
"[1, 1, 0, 0, 0, 1, 0, 0, 1, 0, 0, 0, 1, 1, 1]",175,72,103,5,11,0.06944444444444445,0.10679611650485436
"[0, 1, 1, 1, 0, 0, 0, 1, 0, 0, 1, 0, 0, 0, 1]",154,89,65,5,5,0.056179775280898875,0.07692307692307693
"[0, 0, 1, 0, 1, 1, 1, 0, 1, 1, 1, 0, 0, 0, 1]",102,55,47,2,5,0.03636363636363636,0.10638297872340426
"[1, 0, 1, 1, 1, 0, 0, 0, 0, 0, 1, 1, 1, 1, 0]",204,108,96,8,12,0.07407407407407407,0.125
"[1, 1, 0, 1, 1, 1, 0, 0, 0, 0, 0, 1, 1, 1, 1]",304,116,188,12,11,0.10344827586206896,0.05851063829787234
"[0, 0, 0, 1, 0, 1, 1, 0, 0, 0, 1, 0, 1, 0, 1]",125,75,50,7,4,0.09333333333333334,0.08
"[1, 0, 1, 0, 0, 0, 0, 1, 0, 0, 0, 0, 1, 0, 1]",232,142,90,22,2,0.15492957746478872,0.022222222222222223
"[0, 1, 0, 0, 0, 1, 0, 0, 0, 1, 0, 1, 0, 0, 0]",488,355,133,35,11,0.09859154929577464,0.08270676691729323
"[0, 0, 0, 1, 0, 0, 0, 0, 0, 1, 0, 0, 0, 1, 0]",1386,1068,318,102,32,0.09550561797752809,0.10062893081761007
"[0, 0, 1, 0, 0, 0, 1, 0, 1, 0, 1, 1, 1, 0, 0]",174,112,62,12,7,0.10714285714285714,0.11290322580645161
"[0, 0, 0, 1, 0, 0, 0, 1, 0, 1, 0, 1, 1, 1, 0]",177,106,71,12,11,0.11320754716981132,0.15492957746478872
"[0, 1, 1, 0, 0, 1, 0, 1, 1, 1, 0, 0, 1, 1, 1]",209,95,114,11,12,0.11578947368421053,0.10526315789473684
"[0, 1, 1, 0, 1, 1, 0, 1, 1, 0, 0, 1, 0, 1, 1]",128,58,70,2,6,0.034482758620689655,0.08571428571428572
"[1, 1, 1, 0, 1, 0, 1, 1, 0, 1, 1, 0, 1, 1, 0]",229,83,146,6,14,0.07228915662650602,0.0958904109589041
"[0, 0, 1, 1, 1, 1, 0, 1, 0, 1, 1, 0, 1, 1, 0]",150,57,93,8,14,0.14035087719298245,0.15053763440860216
"[1, 1, 0, 1, 0, 1, 0, 1, 1, 1, 1, 1, 1, 1, 1]",2015,487,1528,51,152,0.10472279260780287,0.09947643979057591
"[1, 1, 1, 0, 1, 1, 0, 1, 1, 0, 1, 0, 1, 0, 1]",213,73,140,6,13,0.0821917808219178,0.09285714285714286
"[1, 1, 1, 1, 1, 1, 1, 1, 1, 0, 1, 0, 0, 1, 1]",2421,536,1885,50,177,0.09328358208955224,0.09389920424403184
"[1, 0, 0, 1, 0, 1, 1, 1, 0, 1, 0, 1, 1, 1, 1]",288,96,192,8,15,0.08333333333333333,0.078125
"[1, 1, 0, 1, 0, 0, 1, 1, 1, 1, 0, 0, 1, 1, 0]",334,122,212,7,22,0.05737704918032787,0.10377358490566038
"[0, 0, 0, 1, 1, 1, 1, 0, 0, 0, 1, 1, 1, 1, 1]",437,262,175,32,9,0.12213740458015267,0.05142857142857143
"[1, 0, 0, 0, 1, 0, 0, 0, 0, 1, 1, 1, 1, 0, 0]",385,225,160,19,15,0.08444444444444445,0.09375
"[1, 0, 1, 0, 1, 0, 0, 1, 1, 0, 0, 0, 1, 0, 0]",127,74,53,13,5,0.17567567567567569,0.09433962264150944
"[0, 0, 0, 0, 0, 1, 0, 0, 0, 0, 1, 0, 1, 0, 1]",514,366,148,35,13,0.09562841530054644,0.08783783783783784
"[1, 1, 0, 0, 0, 0, 1, 1, 0, 0, 0, 0, 0, 1, 0]",592,389,203,27,26,0.06940874035989718,0.12807881773399016
"[1, 0, 0, 1, 0, 0, 0, 0, 1, 0, 0, 1, 0, 0, 0]",488,363,125,38,14,0.1046831955922865,0.112
"[0, 1, 1, 0, 1, 0, 0, 0, 0, 0, 1, 1, 1, 0, 0]",189,115,74,9,7,0.0782608695652174,0.0945945945945946
"[1, 1, 0, 0, 0, 0, 1, 1, 1, 1, 1, 1, 1, 0, 1]",688,235,453,14,48,0.059574468085106386,0.10596026490066225
"[0, 1, 1, 0, 1, 1, 0, 1, 1, 1, 1, 0, 1, 1, 0]",246,94,152,8,20,0.0851063829787234,0.13157894736842105
"[0, 1, 1, 0, 0, 1, 1, 0, 1, 1, 0, 1, 1, 0, 1]",153,67,86,7,10,0.1044776119402985,0.11627906976744186
"[1, 0, 0, 1, 1, 0, 0, 0, 0, 0, 0, 0, 1, 1, 0]",564,274,290,29,29,0.10583941605839416,0.1
"[0, 1, 0, 0, 1, 0, 0, 0, 1, 0, 0, 0, 1, 0, 0]",506,360,146,29,9,0.08055555555555556,0.06164383561643835
"[0, 0, 0, 1, 0, 0, 1, 0, 0, 0, 1, 0, 0, 0, 1]",535,371,164,34,15,0.09164420485175202,0.09146341463414634
"[1, 1, 1, 0, 1, 1, 1, 1, 1, 1, 1, 0, 0, 1, 0]",599,165,434,11,30,0.06666666666666667,0.06912442396313365
"[1, 1, 1, 1, 0, 0, 0, 0, 1, 1, 1, 1, 0, 1, 1]",813,275,538,28,55,0.10181818181818182,0.10223048327137546
"[1, 1, 0, 0, 1, 1, 0, 0, 1, 0, 0, 0, 0, 0, 0]",466,284,182,25,25,0.0880281690140845,0.13736263736263737
"[1, 1, 1, 0, 0, 1, 1, 0, 0, 1, 0, 0, 0, 0, 0]",273,123,150,21,14,0.17073170731707318,0.09333333333333334
"[0, 1, 1, 1, 1, 0, 1, 1, 1, 1, 1, 1, 1, 1, 0]",1865,503,1362,43,122,0.08548707753479125,0.08957415565345081
"[1, 1, 1, 0, 1, 1, 1, 1, 1, 0, 0, 1, 1, 1, 1]",3083,692,2391,58,223,0.0838150289017341,0.0932664157256378
"[1, 0, 0, 1, 1, 1, 1, 1, 1, 1, 1, 1, 0, 1, 0]",850,176,674,19,61,0.10795454545454546,0.09050445103857567
"[1, 1, 1, 1, 1, 0, 1, 0, 0, 1, 1, 1, 1, 1, 1]",2590,606,1984,60,180,0.09900990099009901,0.0907258064516129
"[0, 0, 1, 0, 1, 1, 1, 1, 1, 0, 1, 1, 1, 0, 0]",152,51,101,4,11,0.0784313725490196,0.10891089108910891
"[0, 0, 0, 0, 0, 0, 0, 1, 0, 0, 1, 0, 1, 1, 1]",733,547,186,50,23,0.09140767824497258,0.12365591397849462
"[0, 1, 0, 1, 1, 1, 1, 0, 1, 1, 1, 1, 1, 1, 1]",1973,487,1486,53,145,0.10882956878850103,0.09757738896366083
"[1, 1, 1, 1, 1, 1, 1, 0, 1, 0, 1, 1, 1, 1, 0]",1774,422,1352,46,137,0.10900473933649289,0.10133136094674557
"[0, 0, 1, 0, 1, 0, 0, 0, 1, 0, 0, 0, 0, 0, 1]",523,363,160,42,11,0.11570247933884298,0.06875
"[1, 0, 0, 1, 1, 1, 1, 0, 1, 0, 0, 1, 0, 1, 0]",113,40,73,2,7,0.05,0.0958904109589041
"[1, 1, 0, 0, 1, 1, 0, 0, 1, 0, 0, 1, 1, 1, 1]",373,160,213,18,18,0.1125,0.08450704225352113
"[0, 0, 1, 0, 0, 1, 1, 1, 0, 0, 1, 1, 0, 0, 1]",215,112,103,11,8,0.09821428571428571,0.07766990291262135
"[1, 0, 0, 1, 0, 0, 1, 1, 1, 0, 0, 1, 1, 0, 0]",204,108,96,8,10,0.07407407407407407,0.10416666666666667
"[0, 1, 0, 1, 0, 1, 1, 1, 1, 1, 0, 1, 1, 1, 1]",583,189,394,18,47,0.09523809523809523,0.11928934010152284
"[0, 1, 1, 1, 1, 0, 1, 0, 1, 0, 1, 1, 1, 1, 1]",609,225,384,23,43,0.10222222222222223,0.11197916666666667
"[0, 1, 0, 1, 1, 1, 0, 1, 0, 1, 1, 1, 1, 0, 1]",236,75,161,10,19,0.13333333333333333,0.11801242236024845
"[1, 0, 0, 1, 1, 1, 1, 0, 1, 1, 1, 1, 1, 0, 0]",363,129,234,17,25,0.13178294573643412,0.10683760683760683
"[0, 0, 0, 1, 1, 1, 0, 0, 0, 0, 0, 0, 1, 1, 0]",556,373,183,30,17,0.08042895442359249,0.09289617486338798
"[1, 1, 1, 1, 1, 1, 0, 0, 0, 0, 1, 1, 0, 0, 1]",2136,817,1319,73,145,0.08935128518971848,0.10993176648976498
"[0, 1, 0, 1, 0, 1, 0, 1, 1, 0, 1, 1, 0, 1, 0]",113,56,57,3,5,0.05357142857142857,0.08771929824561403
"[1, 0, 1, 0, 1, 1, 1, 0, 0, 1, 0, 1, 0, 1, 0]",101,48,53,3,8,0.0625,0.1509433962264151
"[0, 1, 0, 0, 1, 1, 0, 1, 0, 1, 1, 1, 1, 1, 1]",329,121,208,16,20,0.1322314049586777,0.09615384615384616
"[0, 0, 1, 0, 0, 1, 1, 0, 1, 0, 1, 1, 1, 1, 1]",185,74,111,8,16,0.10810810810810811,0.14414414414414414
"[0, 0, 1, 0, 1, 0, 1, 0, 0, 0, 1, 1, 0, 0, 0]",325,222,103,19,6,0.08558558558558559,0.05825242718446602
"[1, 1, 0, 0, 1, 1, 1, 1, 0, 1, 0, 0, 0, 1, 1]",260,106,154,9,18,0.08490566037735849,0.11688311688311688
"[1, 0, 0, 0, 1, 1, 0, 0, 1, 1, 1, 0, 1, 1, 0]",119,55,64,5,10,0.09090909090909091,0.15625
"[1, 0, 1, 0, 1, 0, 0, 1, 0, 0, 0, 1, 1, 0, 0]",178,108,70,6,8,0.05555555555555555,0.11428571428571428
"[0, 1, 0, 1, 0, 1, 0, 0, 0, 0, 1, 1, 0, 0, 1]",232,123,109,15,11,0.12195121951219512,0.10091743119266056
"[1, 0, 0, 1, 0, 1, 0, 1, 0, 1, 0, 0, 0, 0, 1]",148,97,51,14,3,0.14432989690721648,0.058823529411764705
"[1, 1, 1, 0, 1, 1, 1, 0, 1, 1, 0, 1, 0, 1, 1]",559,162,397,12,45,0.07407407407407407,0.11335012594458438
"[1, 0, 0, 1, 1, 0, 0, 0, 0, 1, 0, 0, 0, 0, 0]",760,452,308,35,32,0.07743362831858407,0.1038961038961039
"[1, 1, 1, 1, 1, 1, 0, 0, 1, 1, 1, 1, 0, 0, 0]",2240,861,1379,79,125,0.09175377468060394,0.09064539521392313
"[1, 1, 0, 0, 1, 0, 1, 0, 0, 0, 0, 1, 1, 0, 0]",219,126,93,10,6,0.07936507936507936,0.06451612903225806
"[0, 1, 0, 0, 0, 0, 0, 0, 0, 0, 1, 1, 1, 1, 1]",708,429,279,47,28,0.10955710955710955,0.1003584229390681
"[1, 0, 1, 0, 1, 0, 0, 0, 0, 0, 0, 1, 1, 0, 0]",438,265,173,32,16,0.12075471698113208,0.09248554913294797
"[1, 0, 1, 0, 1, 0, 0, 0, 0, 1, 1, 1, 0, 1, 0]",131,66,65,3,7,0.045454545454545456,0.1076923076923077
"[0, 1, 0, 1, 0, 1, 0, 0, 0, 0, 1, 1, 1, 0, 1]",117,70,47,4,5,0.05714285714285714,0.10638297872340426
"[0, 0, 1, 0, 1, 0, 1, 0, 0, 0, 0, 1, 1, 1, 0]",159,101,58,9,3,0.0891089108910891,0.05172413793103448
"[0, 0, 0, 1, 1, 1, 1, 0, 1, 0, 0, 0, 1, 0, 1]",108,65,43,8,3,0.12307692307692308,0.06976744186046512
"[0, 0, 1, 1, 0, 0, 1, 0, 0, 1, 1, 0, 0, 0, 0]",375,254,121,23,10,0.09055118110236221,0.08264462809917356
"[0, 0, 0, 1, 1, 0, 0, 1, 0, 0, 1, 1, 0, 0, 0]",342,234,108,18,9,0.07692307692307693,0.08333333333333333
"[0, 0, 0, 0, 1, 1, 0, 0, 1, 0, 0, 1, 1, 0, 0]",368,243,125,23,11,0.09465020576131687,0.088
"[0, 1, 0, 1, 0, 1, 0, 1, 1, 0, 1, 0, 0, 0, 0]",133,77,56,9,8,0.11688311688311688,0.14285714285714285
"[1, 0, 1, 0, 0, 1, 1, 0, 0, 1, 0, 1, 0, 1, 0]",100,47,53,3,4,0.06382978723404255,0.07547169811320754
"[1, 0, 0, 0, 1, 1, 0, 0, 1, 0, 0, 0, 1, 0, 0]",232,147,85,17,9,0.11564625850340136,0.10588235294117647
"[1, 1, 0, 1, 1, 1, 0, 1, 1, 0, 1, 1, 1, 1, 1]",1792,403,1389,35,132,0.08684863523573201,0.09503239740820735
"[1, 0, 1, 0, 1, 0, 0, 1, 1, 1, 0, 0, 1, 1, 1]",195,76,119,6,13,0.07894736842105263,0.1092436974789916
"[0, 1, 0, 1, 1, 0, 0, 0, 1, 0, 0, 0, 0, 0, 1]",223,135,88,9,9,0.06666666666666667,0.10227272727272728
"[0, 0, 0, 1, 1, 0, 0, 0, 1, 0, 1, 1, 0, 0, 0]",326,230,96,35,8,0.15217391304347827,0.08333333333333333
"[1, 1, 0, 1, 1, 0, 1, 1, 0, 1, 1, 0, 0, 0, 0]",155,64,91,5,8,0.078125,0.08791208791208792
"[1, 0, 0, 1, 1, 1, 1, 1, 0, 1, 1, 0, 0, 1, 1]",390,122,268,14,30,0.11475409836065574,0.11194029850746269
"[0, 0, 0, 0, 1, 1, 0, 0, 0, 0, 0, 0, 1, 0, 1]",1145,812,333,72,34,0.08866995073891626,0.1021021021021021
"[1, 0, 1, 0, 0, 0, 0, 1, 0, 0, 0, 0, 1, 0, 0]",513,359,154,31,14,0.08635097493036212,0.09090909090909091
"[1, 0, 0, 1, 0, 1, 0, 0, 1, 0, 0, 0, 0, 1, 0]",207,127,80,14,9,0.11023622047244094,0.1125
"[0, 1, 0, 0, 1, 0, 1, 0, 0, 1, 0, 0, 0, 0, 1]",251,176,75,14,7,0.07954545454545454,0.09333333333333334
"[0, 1, 0, 0, 0, 0, 0, 0, 0, 0, 1, 0, 0, 1, 0]",1625,1231,394,111,46,0.0901705930138099,0.116751269035533
"[0, 0, 1, 1, 0, 0, 0, 0, 0, 1, 1, 0, 0, 1, 1]",505,324,181,24,19,0.07407407407407407,0.10497237569060773
"[0, 0, 0, 0, 1, 1, 0, 0, 0, 0, 0, 1, 1, 0, 0]",1175,824,351,74,25,0.08980582524271845,0.07122507122507123
"[1, 1, 1, 1, 0, 1, 0, 1, 1, 0, 0, 0, 1, 0, 1]",138,58,80,6,6,0.10344827586206896,0.075
"[1, 1, 0, 0, 0, 1, 1, 1, 1, 1, 0, 1, 0, 1, 1]",249,87,162,11,16,0.12643678160919541,0.09876543209876543
"[0, 1, 0, 0, 1, 1, 1, 1, 0, 1, 0, 0, 1, 0, 0]",119,72,47,7,2,0.09722222222222222,0.0425531914893617
"[1, 1, 0, 1, 0, 0, 1, 1, 1, 1, 0, 1, 0, 0, 1]",152,62,90,3,3,0.04838709677419355,0.03333333333333333
"[1, 1, 1, 0, 1, 0, 1, 0, 1, 1, 1, 0, 0, 0, 0]",173,63,110,4,8,0.06349206349206349,0.07272727272727272
"[0, 1, 1, 0, 0, 1, 1, 1, 1, 1, 1, 0, 1, 0, 1]",376,224,152,21,13,0.09375,0.08552631578947369
"[1, 0, 0, 0, 1, 1, 1, 0, 1, 1, 0, 0, 0, 1, 1]",149,59,90,6,11,0.1016949152542373,0.12222222222222222
"[1, 1, 1, 1, 0, 1, 0, 0, 1, 0, 0, 1, 1, 0, 0]",165,77,88,4,11,0.05194805194805195,0.125
"[0, 0, 1, 0, 1, 1, 0, 1, 1, 0, 0, 0, 0, 0, 1]",195,108,87,9,6,0.08333333333333333,0.06896551724137931
"[1, 0, 1, 1, 1, 1, 0, 1, 1, 1, 1, 1, 1, 0, 1]",1549,389,1160,39,119,0.10025706940874037,0.10258620689655172
"[0, 0, 1, 0, 0, 0, 1, 0, 0, 0, 0, 1, 1, 0, 0]",804,581,223,60,15,0.10327022375215146,0.06726457399103139
"[1, 1, 1, 1, 1, 1, 1, 0, 0, 0, 0, 0, 1, 1, 1]",933,222,711,16,58,0.07207207207207207,0.08157524613220815
"[1, 1, 1, 1, 1, 1, 1, 1, 1, 0, 0, 0, 0, 0, 1]",876,213,663,13,56,0.06103286384976526,0.08446455505279035
"[1, 0, 1, 1, 1, 1, 1, 1, 1, 1, 0, 0, 1, 1, 1]",3838,901,2937,62,280,0.06881243063263041,0.09533537623425264
"[0, 0, 1, 1, 0, 1, 0, 0, 0, 0, 0, 0, 0, 1, 1]",472,322,150,36,17,0.11180124223602485,0.11333333333333333
"[1, 0, 0, 1, 1, 0, 1, 1, 1, 0, 0, 0, 1, 0, 1]",123,51,72,9,8,0.17647058823529413,0.1111111111111111
"[0, 0, 0, 1, 1, 0, 0, 0, 1, 0, 1, 1, 1, 0, 1]",140,90,50,6,4,0.06666666666666667,0.08
"[1, 1, 1, 1, 1, 1, 0, 0, 0, 1, 1, 0, 0, 0, 1]",225,78,147,7,15,0.08974358974358974,0.10204081632653061
"[1, 0, 0, 1, 1, 1, 1, 1, 1, 0, 0, 0, 1, 1, 0]",303,82,221,10,20,0.12195121951219512,0.09049773755656108
"[1, 1, 0, 1, 0, 0, 0, 1, 0, 0, 1, 1, 1, 1, 1]",211,81,130,7,17,0.08641975308641975,0.13076923076923078
"[1, 0, 1, 1, 1, 0, 1, 0, 0, 0, 1, 0, 0, 1, 1]",128,62,66,4,7,0.06451612903225806,0.10606060606060606
"[0, 0, 1, 0, 0, 1, 0, 0, 1, 1, 0, 1, 1, 1, 0]",107,72,35,5,1,0.06944444444444445,0.02857142857142857
"[1, 0, 1, 1, 1, 1, 1, 1, 0, 0, 0, 0, 1, 1, 1]",886,305,581,31,45,0.10163934426229508,0.0774526678141136
"[1, 0, 1, 0, 0, 1, 1, 1, 1, 0, 0, 1, 1, 1, 1]",722,271,451,30,46,0.11070110701107011,0.10199556541019955
"[1, 1, 1, 0, 0, 1, 1, 0, 1, 0, 1, 0, 1, 1, 1]",353,125,228,9,16,0.072,0.07017543859649122
"[0, 1, 0, 1, 0, 1, 0, 0, 0, 0, 0, 1, 1, 0, 0]",361,238,123,24,15,0.10084033613445378,0.12195121951219512
"[1, 1, 1, 1, 0, 0, 1, 0, 0, 1, 1, 1, 1, 0, 1]",287,105,182,14,16,0.13333333333333333,0.08791208791208792
"[1, 1, 1, 0, 1, 0, 1, 1, 1, 1, 0, 0, 1, 0, 0]",157,68,89,9,11,0.1323529411764706,0.12359550561797752
"[0, 0, 0, 0, 0, 1, 0, 1, 0, 0, 0, 0, 0, 1, 0]",1583,1220,363,110,24,0.09016393442622951,0.06611570247933884
"[0, 0, 1, 0, 0, 0, 0, 0, 1, 0, 1, 0, 0, 0, 0]",1721,1291,430,122,44,0.09450038729666925,0.10232558139534884
"[0, 0, 0, 0, 1, 0, 0, 0, 0, 0, 1, 0, 1, 0, 0]",1563,1208,355,133,32,0.11009933774834436,0.09014084507042254
"[0, 0, 1, 1, 0, 0, 0, 0, 0, 1, 0, 0, 0, 0, 0]",2211,1673,538,145,51,0.08667065152420801,0.09479553903345725
"[0, 1, 1, 1, 0, 0, 0, 0, 0, 1, 0, 1, 0, 1, 0]",144,80,64,6,4,0.075,0.0625
"[0, 0, 1, 0, 0, 0, 1, 0, 0, 0, 0, 1, 0, 0, 0]",1602,1218,384,117,36,0.0960591133004926,0.09375
"[0, 1, 1, 0, 0, 1, 0, 0, 1, 1, 0, 1, 0, 0, 0]",151,92,59,15,5,0.16304347826086957,0.0847457627118644
"[1, 1, 0, 0, 0, 0, 1, 0, 0, 0, 0, 0, 1, 1, 0]",373,240,133,22,18,0.09166666666666666,0.13533834586466165
"[0, 0, 1, 1, 0, 1, 1, 0, 1, 1, 1, 0, 0, 0, 0]",176,100,76,6,5,0.06,0.06578947368421052
"[0, 1, 0, 0, 1, 1, 0, 1, 1, 0, 1, 1, 1, 0, 0]",132,70,62,6,4,0.08571428571428572,0.06451612903225806
"[0, 0, 1, 0, 1, 0, 1, 0, 1, 1, 0, 0, 0, 1, 0]",150,90,60,8,7,0.08888888888888889,0.11666666666666667
"[1, 0, 0, 1, 0, 0, 1, 1, 0, 1, 0, 0, 1, 0, 1]",112,65,47,3,2,0.046153846153846156,0.0425531914893617
"[0, 1, 0, 0, 1, 0, 0, 1, 1, 0, 1, 0, 0, 1, 0]",132,68,64,3,2,0.04411764705882353,0.03125
"[1, 1, 1, 1, 1, 1, 0, 1, 0, 0, 0, 0, 0, 0, 0]",277,133,144,14,18,0.10526315789473684,0.125
"[1, 0, 1, 0, 0, 0, 1, 1, 1, 0, 0, 1, 1, 1, 1]",245,113,132,12,5,0.10619469026548672,0.03787878787878788
"[0, 1, 1, 1, 1, 0, 1, 0, 0, 1, 1, 0, 0, 1, 0]",113,56,57,4,4,0.07142857142857142,0.07017543859649122
"[0, 1, 0, 1, 0, 1, 1, 1, 1, 0, 1, 0, 0, 1, 1]",150,52,98,9,12,0.17307692307692307,0.12244897959183673
"[1, 1, 1, 1, 0, 0, 1, 1, 0, 1, 0, 1, 0, 1, 1]",308,102,206,16,15,0.1568627450980392,0.07281553398058252
"[0, 1, 1, 1, 1, 1, 1, 0, 1, 1, 1, 1, 1, 0, 0]",756,259,497,22,48,0.08494208494208494,0.096579476861167
"[0, 0, 1, 1, 1, 1, 1, 1, 0, 1, 1, 1, 1, 1, 0]",669,206,463,19,45,0.09223300970873786,0.09719222462203024
"[1, 0, 0, 1, 0, 0, 0, 0, 1, 1, 0, 0, 1, 1, 0]",322,180,142,20,12,0.1111111111111111,0.08450704225352113
"[0, 1, 1, 0, 0, 1, 1, 1, 0, 0, 1, 1, 0, 0, 1]",239,134,105,11,11,0.08208955223880597,0.10476190476190476
"[0, 0, 1, 0, 0, 1, 1, 0, 0, 1, 1, 1, 0, 0, 1]",130,72,58,8,6,0.1111111111111111,0.10344827586206896
"[1, 0, 0, 1, 1, 0, 0, 0, 0, 0, 0, 1, 1, 0, 1]",418,126,292,13,32,0.10317460317460317,0.1095890410958904
"[1, 0, 0, 0, 0, 0, 1, 1, 0, 1, 0, 1, 0, 1, 1]",131,60,71,4,7,0.06666666666666667,0.09859154929577464
"[1, 0, 1, 0, 1, 0, 1, 1, 1, 0, 1, 0, 0, 1, 0]",84,43,41,3,3,0.06976744186046512,0.07317073170731707
"[1, 1, 1, 0, 1, 0, 1, 0, 1, 1, 1, 0, 1, 0, 0]",126,48,78,5,15,0.10416666666666667,0.19230769230769232
"[1, 1, 1, 1, 1, 0, 1, 1, 1, 0, 1, 1, 1, 0, 1]",1540,345,1195,38,102,0.11014492753623188,0.08535564853556485
"[0, 0, 0, 1, 0, 1, 0, 0, 0, 0, 0, 0, 1, 1, 0]",915,690,225,63,21,0.09130434782608696,0.09333333333333334
"[1, 1, 0, 0, 0, 1, 0, 1, 0, 1, 1, 1, 1, 1, 1]",354,128,226,16,20,0.125,0.08849557522123894
"[1, 0, 0, 1, 1, 1, 1, 0, 0, 0, 1, 0, 1, 0, 1]",151,56,95,7,15,0.125,0.15789473684210525
"[1, 0, 1, 0, 1, 1, 0, 0, 1, 1, 1, 1, 0, 0, 0]",301,130,171,22,14,0.16923076923076924,0.08187134502923976
"[0, 1, 0, 0, 1, 1, 1, 1, 1, 1, 0, 0, 1, 1, 0]",444,196,248,19,25,0.09693877551020408,0.10080645161290322
"[0, 1, 0, 0, 1, 0, 1, 1, 1, 0, 1, 1, 1, 0, 1]",124,51,73,7,6,0.13725490196078433,0.0821917808219178
"[0, 0, 0, 1, 0, 0, 1, 0, 1, 1, 1, 0, 1, 1, 1]",132,56,76,8,14,0.14285714285714285,0.18421052631578946
"[0, 1, 0, 0, 0, 1, 0, 0, 1, 0, 1, 1, 1, 0, 1]",98,49,49,5,3,0.10204081632653061,0.061224489795918366
"[0, 1, 1, 1, 0, 1, 0, 0, 0, 1, 0, 0, 1, 0, 1]",121,74,47,6,9,0.08108108108108109,0.19148936170212766
"[1, 1, 0, 1, 1, 0, 0, 1, 1, 0, 0, 0, 0, 0, 0]",493,278,215,19,11,0.0683453237410072,0.05116279069767442
"[0, 0, 1, 1, 1, 0, 0, 1, 0, 0, 1, 0, 1, 1, 1]",171,88,83,8,6,0.09090909090909091,0.07228915662650602
"[0, 0, 0, 0, 0, 1, 1, 1, 0, 0, 1, 0, 0, 1, 0]",270,188,82,20,10,0.10638297872340426,0.12195121951219512
"[0, 0, 1, 1, 0, 0, 1, 0, 0, 1, 0, 0, 0, 0, 0]",684,476,208,51,21,0.10714285714285714,0.10096153846153846
"[1, 0, 0, 0, 0, 1, 1, 1, 0, 0, 0, 1, 1, 0, 0]",200,99,101,6,6,0.06060606060606061,0.0594059405940594
"[0, 0, 1, 0, 0, 1, 1, 0, 1, 1, 0, 1, 0, 0, 0]",143,95,48,10,6,0.10526315789473684,0.125
"[1, 0, 0, 0, 1, 0, 0, 0, 0, 0, 0, 0, 1, 0, 0]",1554,1207,347,115,25,0.09527754763877382,0.07204610951008646
"[0, 0, 0, 1, 0, 0, 1, 0, 0, 1, 0, 1, 0, 0, 1]",220,137,83,8,12,0.058394160583941604,0.14457831325301204
"[0, 0, 0, 1, 0, 1, 0, 0, 0, 1, 0, 0, 1, 0, 0]",481,348,133,45,20,0.12931034482758622,0.15037593984962405
"[0, 0, 1, 0, 1, 0, 0, 0, 1, 0, 1, 0, 0, 0, 1]",219,152,67,14,4,0.09210526315789473,0.05970149253731343
"[0, 0, 0, 1, 1, 1, 1, 0, 0, 0, 0, 0, 0, 1, 0]",680,554,126,65,14,0.11732851985559567,0.1111111111111111
"[1, 1, 0, 1, 1, 1, 1, 0, 1, 0, 1, 0, 0, 1, 1]",241,91,150,8,10,0.08791208791208792,0.06666666666666667
"[0, 0, 1, 0, 0, 0, 1, 0, 1, 0, 0, 0, 0, 0, 0]",1807,1367,440,115,51,0.08412582297000731,0.1159090909090909
"[0, 0, 0, 1, 1, 0, 0, 1, 1, 0, 0, 1, 1, 0, 0]",1965,1609,356,154,29,0.09571162212554382,0.08146067415730338
"[1, 0, 0, 0, 0, 0, 0, 0, 1, 0, 0, 0, 1, 1, 0]",646,422,224,41,21,0.0971563981042654,0.09375
"[1, 0, 0, 0, 1, 0, 0, 0, 0, 1, 0, 0, 1, 1, 1]",179,94,85,8,8,0.0851063829787234,0.09411764705882353
"[0, 1, 1, 1, 1, 1, 0, 0, 1, 1, 1, 1, 0, 0, 1]",820,314,506,24,42,0.07643312101910828,0.08300395256916997
"[0, 1, 1, 0, 1, 1, 1, 1, 1, 0, 1, 1, 1, 1, 0]",530,159,371,14,41,0.0880503144654088,0.1105121293800539
"[1, 0, 1, 0, 0, 1, 1, 1, 1, 1, 0, 1, 1, 0, 1]",234,82,152,10,17,0.12195121951219512,0.1118421052631579
"[1, 1, 1, 1, 0, 1, 0, 0, 0, 0, 1, 0, 0, 1, 1]",159,66,93,10,12,0.15151515151515152,0.12903225806451613
"[1, 0, 1, 1, 1, 1, 0, 1, 0, 0, 0, 0, 1, 0, 0]",114,69,45,5,5,0.07246376811594203,0.1111111111111111
"[0, 1, 0, 1, 0, 1, 0, 1, 1, 1, 1, 0, 1, 0, 0]",110,60,50,4,7,0.06666666666666667,0.14
"[1, 1, 0, 1, 0, 1, 0, 1, 0, 1, 1, 1, 1, 0, 1]",206,70,136,8,13,0.11428571428571428,0.09558823529411764
"[0, 1, 1, 1, 0, 1, 1, 0, 1, 0, 1, 1, 1, 1, 0]",262,106,156,14,16,0.1320754716981132,0.10256410256410256
"[0, 1, 0, 1, 0, 1, 1, 1, 1, 1, 1, 0, 1, 1, 1]",538,176,362,17,32,0.09659090909090909,0.08839779005524862
"[1, 0, 0, 1, 1, 1, 1, 1, 1, 1, 0, 0, 0, 0, 1]",482,166,316,15,24,0.09036144578313253,0.0759493670886076
"[1, 1, 1, 1, 1, 0, 1, 0, 1, 1, 1, 0, 0, 0, 0]",294,119,175,8,18,0.06722689075630252,0.10285714285714286
"[0, 1, 0, 0, 0, 0, 1, 0, 0, 1, 0, 0, 0, 1, 0]",432,303,129,23,10,0.07590759075907591,0.07751937984496124
"[0, 1, 0, 0, 0, 1, 0, 0, 0, 1, 0, 0, 0, 0, 0]",1685,1278,407,134,38,0.10485133020344288,0.09336609336609336
"[1, 1, 1, 0, 0, 1, 1, 0, 1, 1, 1, 1, 0, 1, 1]",617,155,462,15,42,0.0967741935483871,0.09090909090909091
"[1, 1, 1, 0, 1, 1, 1, 0, 1, 0, 1, 1, 0, 0, 1]",290,102,188,12,16,0.11764705882352941,0.0851063829787234
"[0, 0, 1, 1, 0, 0, 1, 1, 1, 1, 1, 0, 1, 0, 1]",263,107,156,10,21,0.09345794392523364,0.1346153846153846
"[1, 1, 1, 0, 0, 1, 1, 0, 0, 1, 0, 0, 0, 1, 1]",242,76,166,7,17,0.09210526315789473,0.10240963855421686
"[1, 1, 1, 1, 0, 0, 1, 1, 0, 0, 1, 0, 0, 0, 1]",258,127,131,8,16,0.06299212598425197,0.12213740458015267
"[1, 0, 1, 1, 0, 0, 0, 1, 1, 0, 1, 1, 0, 1, 1]",157,63,94,3,6,0.047619047619047616,0.06382978723404255
"[0, 0, 1, 1, 0, 1, 0, 1, 1, 0, 0, 0, 1, 1, 0]",124,69,55,3,9,0.043478260869565216,0.16363636363636364
"[1, 0, 1, 1, 1, 0, 1, 0, 0, 1, 1, 0, 1, 0, 1]",153,63,90,7,14,0.1111111111111111,0.15555555555555556
"[0, 0, 0, 0, 1, 1, 0, 1, 0, 0, 1, 1, 0, 0, 0]",358,229,129,21,10,0.09170305676855896,0.07751937984496124
"[1, 0, 1, 0, 1, 0, 0, 0, 0, 1, 1, 1, 1, 0, 0]",264,130,134,14,13,0.1076923076923077,0.09701492537313433
"[1, 1, 1, 1, 0, 1, 0, 1, 0, 0, 0, 0, 1, 1, 1]",260,106,154,15,15,0.14150943396226415,0.09740259740259741
"[0, 1, 0, 1, 1, 0, 1, 1, 1, 1, 0, 0, 0, 1, 0]",120,58,62,6,5,0.10344827586206896,0.08064516129032258
"[1, 0, 1, 1, 1, 1, 0, 0, 1, 0, 1, 0, 0, 0, 1]",118,58,60,2,7,0.034482758620689655,0.11666666666666667
"[0, 0, 0, 1, 0, 1, 1, 1, 1, 0, 0, 1, 0, 1, 0]",96,45,51,7,1,0.15555555555555556,0.0196078431372549
"[0, 1, 1, 0, 0, 0, 0, 1, 0, 1, 1, 1, 1, 0, 0]",175,114,61,12,5,0.10526315789473684,0.08196721311475409
"[0, 1, 0, 0, 1, 0, 0, 0, 0, 1, 1, 0, 0, 0, 0]",940,644,296,70,27,0.10869565217391304,0.09121621621621621
"[0, 0, 1, 0, 0, 0, 1, 1, 1, 0, 0, 0, 0, 1, 0]",244,163,81,9,6,0.05521472392638037,0.07407407407407407
"[1, 0, 1, 1, 1, 0, 0, 0, 0, 0, 0, 1, 1, 0, 1]",142,78,64,7,7,0.08974358974358974,0.109375
"[0, 1, 0, 1, 0, 1, 0, 1, 1, 1, 0, 0, 0, 0, 0]",200,121,79,9,4,0.0743801652892562,0.05063291139240506
"[0, 0, 1, 1, 0, 1, 0, 1, 0, 1, 0, 0, 0, 1, 0]",134,79,55,8,3,0.10126582278481013,0.05454545454545454
"[1, 0, 1, 0, 0, 1, 0, 0, 1, 1, 0, 1, 0, 1, 0]",113,60,53,9,4,0.15,0.07547169811320754
"[1, 1, 0, 0, 1, 1, 0, 0, 1, 0, 1, 0, 0, 1, 0]",124,58,66,4,7,0.06896551724137931,0.10606060606060606
"[0, 1, 1, 1, 0, 0, 1, 1, 0, 0, 1, 0, 1, 0, 0]",139,74,65,5,6,0.06756756756756757,0.09230769230769231
"[0, 0, 1, 1, 0, 0, 1, 1, 0, 1, 1, 0, 0, 0, 0]",248,146,102,13,6,0.08904109589041095,0.058823529411764705
"[1, 1, 1, 1, 1, 0, 0, 1, 0, 1, 0, 1, 1, 1, 1]",758,173,585,18,57,0.10404624277456648,0.09743589743589744
"[0, 0, 0, 1, 0, 0, 1, 0, 1, 1, 1, 1, 1, 1, 1]",263,125,138,15,15,0.12,0.10869565217391304
"[1, 0, 0, 1, 1, 1, 0, 1, 1, 0, 1, 1, 1, 1, 1]",685,172,513,13,64,0.0755813953488372,0.12475633528265107
"[0, 1, 1, 1, 1, 1, 1, 0, 0, 1, 1, 1, 0, 1, 1]",922,479,443,42,44,0.08768267223382047,0.09932279909706546
"[0, 1, 1, 0, 0, 0, 0, 1, 1, 0, 0, 1, 1, 0, 0]",1859,1584,275,143,20,0.09027777777777778,0.07272727272727272
"[0, 1, 0, 1, 0, 0, 1, 1, 1, 0, 0, 0, 0, 1, 0]",131,75,56,8,6,0.10666666666666667,0.10714285714285714
"[1, 0, 0, 0, 0, 1, 1, 0, 0, 0, 1, 0, 1, 0, 0]",330,187,143,25,13,0.13368983957219252,0.09090909090909091
"[1, 0, 1, 1, 1, 0, 0, 1, 0, 1, 1, 1, 1, 1, 1]",698,184,514,20,44,0.10869565217391304,0.08560311284046693
"[1, 0, 1, 1, 1, 1, 0, 1, 1, 0, 1, 1, 1, 1, 0]",578,161,417,22,46,0.13664596273291926,0.11031175059952038
"[0, 0, 0, 0, 1, 1, 1, 1, 1, 1, 0, 0, 1, 0, 1]",358,168,190,12,21,0.07142857142857142,0.11052631578947368
"[1, 1, 0, 0, 0, 0, 1, 1, 1, 1, 1, 1, 0, 0, 1]",2007,820,1187,77,124,0.09390243902439024,0.10446503791069923
"[1, 1, 1, 0, 1, 0, 1, 1, 0, 0, 0, 0, 1, 1, 1]",326,131,195,17,17,0.1297709923664122,0.08717948717948718
"[1, 1, 1, 1, 0, 1, 0, 1, 1, 0, 0, 0, 0, 1, 1]",302,113,189,7,23,0.061946902654867256,0.12169312169312169
"[1, 1, 1, 0, 0, 0, 1, 0, 0, 1, 0, 1, 1, 0, 0]",130,57,73,9,10,0.15789473684210525,0.136986301369863
"[0, 1, 1, 1, 0, 0, 0, 0, 0, 1, 0, 0, 0, 0, 0]",625,455,170,34,17,0.07472527472527472,0.1
"[0, 0, 0, 0, 0, 0, 0, 0, 0, 1, 0, 0, 0, 1, 0]",7382,6123,1259,588,115,0.096031357177854,0.09134233518665608
"[0, 0, 0, 0, 0, 1, 1, 0, 1, 1, 1, 0, 1, 1, 1]",214,131,83,10,10,0.07633587786259542,0.12048192771084337
"[1, 0, 0, 1, 1, 0, 1, 1, 1, 0, 1, 0, 1, 0, 1]",151,54,97,3,12,0.05555555555555555,0.12371134020618557
"[1, 0, 0, 1, 0, 1, 0, 1, 0, 1, 1, 0, 0, 1, 0]",105,57,48,4,6,0.07017543859649122,0.125
"[0, 1, 1, 1, 0, 0, 0, 0, 0, 1, 1, 1, 0, 0, 1]",154,89,65,6,12,0.06741573033707865,0.18461538461538463
"[0, 0, 0, 1, 1, 1, 0, 1, 1, 1, 0, 0, 0, 0, 0]",229,152,77,12,4,0.07894736842105263,0.05194805194805195
"[0, 0, 0, 0, 1, 1, 1, 0, 1, 1, 1, 0, 0, 0, 0]",242,158,84,12,6,0.0759493670886076,0.07142857142857142
"[1, 1, 1, 1, 1, 1, 0, 1, 1, 1, 1, 0, 1, 1, 0]",1652,397,1255,25,118,0.06297229219143577,0.09402390438247012
"[0, 1, 1, 0, 1, 1, 1, 1, 1, 0, 0, 1, 0, 0, 1]",153,60,93,6,12,0.1,0.12903225806451613
"[1, 1, 0, 1, 0, 1, 0, 1, 0, 1, 1, 1, 1, 0, 0]",185,71,114,8,6,0.11267605633802817,0.05263157894736842
"[1, 0, 1, 0, 1, 0, 0, 0, 1, 1, 1, 1, 0, 1, 0]",99,43,56,4,3,0.09302325581395349,0.05357142857142857
"[1, 1, 0, 1, 1, 1, 0, 1, 0, 0, 1, 1, 0, 1, 1]",255,69,186,8,19,0.11594202898550725,0.10215053763440861
"[1, 1, 1, 1, 0, 0, 0, 1, 1, 1, 1, 0, 1, 1, 0]",294,105,189,13,14,0.12380952380952381,0.07407407407407407
"[1, 0, 1, 1, 1, 1, 1, 0, 0, 0, 1, 1, 1, 1, 0]",305,112,193,17,13,0.15178571428571427,0.06735751295336788
"[1, 1, 1, 1, 1, 0, 0, 0, 0, 0, 1, 0, 0, 0, 0]",281,129,152,12,18,0.09302325581395349,0.11842105263157894
"[0, 0, 1, 1, 1, 0, 0, 0, 0, 1, 1, 1, 1, 1, 1]",599,268,331,21,32,0.07835820895522388,0.09667673716012085
"[0, 0, 0, 1, 1, 1, 0, 1, 0, 0, 0, 1, 1, 1, 0]",133,79,54,3,6,0.0379746835443038,0.1111111111111111
"[0, 0, 1, 1, 0, 1, 0, 1, 0, 0, 1, 1, 1, 0, 0]",110,67,43,7,7,0.1044776119402985,0.16279069767441862
"[0, 0, 1, 0, 0, 0, 1, 0, 1, 1, 0, 0, 0, 0, 0]",654,462,192,47,22,0.10173160173160173,0.11458333333333333
"[0, 1, 0, 0, 0, 0, 1, 0, 0, 0, 1, 0, 1, 1, 0]",245,158,87,14,11,0.08860759493670886,0.12643678160919541
"[0, 0, 0, 0, 0, 0, 0, 1, 1, 0, 0, 0, 0, 0, 1]",3664,3077,587,278,59,0.09034774130646733,0.10051107325383304
"[0, 1, 0, 1, 0, 0, 0, 0, 1, 1, 1, 1, 0, 1, 0]",110,64,46,8,2,0.125,0.043478260869565216
"[1, 0, 1, 0, 1, 0, 0, 1, 0, 0, 0, 0, 1, 0, 1]",130,74,56,10,4,0.13513513513513514,0.07142857142857142
"[1, 1, 1, 1, 1, 1, 0, 1, 1, 0, 1, 0, 1, 1, 0]",523,148,375,18,31,0.12162162162162163,0.08266666666666667
"[1, 0, 0, 0, 1, 0, 0, 0, 1, 0, 0, 0, 0, 1, 0]",528,360,168,30,14,0.08333333333333333,0.08333333333333333
"[1, 0, 0, 0, 0, 0, 0, 1, 0, 0, 0, 1, 1, 1, 1]",359,189,170,20,12,0.10582010582010581,0.07058823529411765
"[1, 1, 0, 1, 1, 1, 1, 0, 0, 1, 1, 0, 1, 1, 1]",637,182,455,16,45,0.08791208791208792,0.0989010989010989
"[1, 0, 1, 0, 0, 1, 0, 1, 1, 1, 1, 1, 1, 1, 1]",786,273,513,31,44,0.11355311355311355,0.08576998050682261
"[1, 1, 0, 1, 0, 0, 1, 0, 1, 1, 1, 1, 1, 1, 1]",692,226,466,26,45,0.11504424778761062,0.09656652360515021
"[1, 1, 0, 0, 0, 0, 0, 1, 0, 1, 1, 1, 1, 1, 1]",322,148,174,15,14,0.10135135135135136,0.08045977011494253
"[1, 0, 0, 0, 1, 0, 0, 0, 0, 1, 1, 0, 0, 1, 1]",386,227,159,20,16,0.0881057268722467,0.10062893081761007
"[1, 1, 1, 0, 0, 0, 1, 0, 0, 0, 0, 1, 1, 0, 0]",274,139,135,10,11,0.07194244604316546,0.08148148148148149
"[0, 0, 0, 1, 1, 1, 1, 1, 1, 1, 1, 1, 1, 0, 1]",1109,636,473,76,54,0.11949685534591195,0.11416490486257928
"[1, 0, 1, 0, 1, 1, 1, 1, 1, 0, 1, 0, 0, 1, 0]",126,56,70,7,6,0.125,0.08571428571428572
"[1, 0, 0, 0, 1, 0, 1, 1, 1, 1, 0, 0, 0, 0, 1]",210,91,119,8,18,0.08791208791208792,0.15126050420168066
"[0, 0, 0, 1, 0, 1, 1, 0, 0, 0, 1, 0, 1, 1, 1]",135,85,50,7,7,0.08235294117647059,0.14
"[0, 0, 1, 0, 0, 0, 1, 1, 1, 1, 1, 1, 1, 1, 0]",276,147,129,8,8,0.05442176870748299,0.06201550387596899
"[1, 0, 1, 0, 0, 1, 0, 0, 0, 0, 0, 0, 1, 1, 1]",315,190,125,22,9,0.11578947368421053,0.072
"[0, 0, 0, 1, 0, 0, 0, 1, 0, 1, 1, 0, 1, 0, 0]",236,142,94,17,10,0.11971830985915492,0.10638297872340426
"[0, 1, 0, 0, 0, 1, 0, 1, 1, 0, 0, 0, 0, 1, 1]",251,142,109,13,10,0.09154929577464789,0.09174311926605505
"[1, 1, 0, 0, 1, 0, 0, 0, 0, 0, 1, 0, 1, 0, 0]",262,158,104,8,10,0.05063291139240506,0.09615384615384616
"[1, 1, 1, 0, 1, 1, 1, 0, 1, 1, 1, 0, 0, 0, 1]",240,84,156,9,12,0.10714285714285714,0.07692307692307693
"[0, 0, 0, 0, 0, 1, 1, 1, 1, 0, 1, 1, 1, 0, 1]",178,108,70,10,6,0.09259259259259259,0.08571428571428572
"[0, 0, 0, 0, 0, 1, 1, 0, 1, 1, 0, 0, 0, 0, 1]",351,243,108,20,7,0.0823045267489712,0.06481481481481481
"[1, 1, 1, 0, 1, 0, 0, 1, 1, 1, 0, 1, 0, 1, 1]",249,79,170,12,17,0.1518987341772152,0.1
"[1, 1, 1, 1, 0, 0, 0, 1, 0, 0, 1, 0, 1, 0, 1]",121,63,58,3,11,0.047619047619047616,0.1896551724137931
"[1, 1, 1, 1, 1, 1, 0, 0, 0, 1, 0, 0, 1, 0, 1]",195,80,115,12,14,0.15,0.12173913043478261
"[1, 1, 0, 1, 0, 0, 1, 0, 0, 1, 0, 0, 0, 1, 1]",129,65,64,3,6,0.046153846153846156,0.09375
"[0, 0, 1, 0, 1, 0, 1, 1, 0, 1, 1, 1, 1, 0, 0]",167,84,83,10,12,0.11904761904761904,0.14457831325301204
"[1, 0, 1, 1, 1, 1, 1, 0, 1, 0, 0, 0, 1, 0, 0]",110,55,55,3,4,0.05454545454545454,0.07272727272727272
"[1, 0, 1, 1, 0, 1, 1, 1, 1, 1, 0, 1, 0, 0, 0]",167,64,103,7,7,0.109375,0.06796116504854369
"[0, 1, 0, 1, 1, 1, 0, 1, 1, 0, 0, 0, 1, 1, 1]",198,89,109,11,12,0.12359550561797752,0.11009174311926606
"[1, 0, 1, 1, 1, 0, 1, 1, 0, 0, 0, 0, 0, 0, 1]",212,113,99,16,9,0.1415929203539823,0.09090909090909091
"[1, 0, 1, 0, 1, 0, 0, 1, 0, 1, 0, 0, 0, 1, 0]",117,74,43,8,3,0.10810810810810811,0.06976744186046512
"[0, 1, 1, 1, 1, 1, 1, 1, 0, 1, 1, 0, 0, 0, 1]",294,112,182,12,19,0.10714285714285714,0.1043956043956044
"[1, 1, 0, 1, 0, 1, 0, 0, 0, 0, 1, 1, 0, 0, 1]",185,97,88,13,10,0.13402061855670103,0.11363636363636363
"[0, 0, 1, 0, 1, 1, 0, 1, 1, 1, 0, 1, 1, 0, 1]",129,55,74,8,7,0.14545454545454545,0.0945945945945946
"[1, 0, 1, 1, 0, 0, 1, 0, 1, 1, 0, 1, 1, 1, 0]",130,53,77,5,5,0.09433962264150944,0.06493506493506493
"[0, 1, 1, 1, 1, 1, 0, 0, 1, 0, 1, 1, 0, 0, 1]",188,72,116,4,10,0.05555555555555555,0.08620689655172414
"[0, 0, 0, 1, 1, 1, 1, 0, 0, 1, 1, 0, 1, 1, 1]",478,353,125,24,14,0.0679886685552408,0.112
"[0, 0, 0, 0, 1, 1, 0, 0, 0, 0, 0, 1, 1, 1, 1]",842,538,304,48,24,0.08921933085501858,0.07894736842105263
"[1, 1, 1, 1, 0, 1, 0, 0, 0, 1, 0, 1, 0, 1, 1]",126,50,76,6,9,0.12,0.11842105263157894
"[0, 0, 1, 1, 0, 0, 0, 0, 0, 0, 0, 1, 1, 1, 1]",969,618,351,57,42,0.09223300970873786,0.11965811965811966
"[0, 0, 0, 0, 0, 1, 1, 0, 0, 1, 1, 0, 0, 1, 0]",602,477,125,37,11,0.07756813417190776,0.088
"[0, 0, 0, 1, 0, 0, 1, 0, 1, 0, 0, 0, 0, 0, 0]",1909,1447,462,130,47,0.08984105044920525,0.10173160173160173
"[1, 0, 1, 1, 1, 0, 0, 1, 1, 0, 0, 0, 1, 0, 0]",112,57,55,3,3,0.05263157894736842,0.05454545454545454
"[1, 1, 1, 0, 1, 0, 1, 0, 0, 0, 1, 1, 1, 0, 1]",133,62,71,4,5,0.06451612903225806,0.07042253521126761
"[0, 1, 1, 0, 0, 0, 0, 1, 1, 1, 1, 0, 0, 0, 0]",2017,1668,349,148,27,0.08872901678657075,0.07736389684813753
"[1, 0, 1, 1, 0, 0, 0, 0, 1, 1, 1, 1, 0, 0, 0]",443,229,214,19,13,0.08296943231441048,0.06074766355140187
"[0, 1, 0, 1, 1, 1, 0, 1, 1, 0, 0, 0, 0, 1, 1]",178,88,90,5,8,0.056818181818181816,0.08888888888888889
"[0, 0, 0, 0, 1, 0, 1, 1, 1, 0, 1, 1, 0, 0, 0]",177,106,71,12,2,0.11320754716981132,0.028169014084507043
"[1, 1, 1, 0, 1, 0, 0, 0, 0, 0, 0, 0, 0, 1, 0]",260,159,101,19,9,0.11949685534591195,0.0891089108910891
"[0, 0, 0, 0, 0, 0, 1, 0, 1, 0, 0, 1, 0, 1, 1]",322,224,98,25,12,0.11160714285714286,0.12244897959183673
"[1, 1, 0, 0, 0, 0, 1, 0, 1, 0, 0, 0, 0, 0, 0]",758,533,225,45,32,0.08442776735459662,0.14222222222222222
"[0, 0, 0, 0, 1, 0, 1, 1, 0, 0, 0, 0, 1, 1, 1]",404,264,140,20,19,0.07575757575757576,0.1357142857142857
"[0, 1, 0, 0, 1, 1, 0, 1, 0, 0, 0, 1, 1, 0, 0]",231,131,100,14,3,0.10687022900763359,0.03
"[1, 1, 0, 1, 1, 0, 0, 1, 0, 0, 1, 1, 0, 1, 0]",109,50,59,7,9,0.14,0.15254237288135594
"[1, 1, 0, 0, 1, 1, 0, 1, 1, 1, 0, 1, 1, 0, 0]",176,58,118,4,7,0.06896551724137931,0.059322033898305086
"[1, 0, 0, 1, 0, 0, 0, 0, 0, 0, 1, 0, 1, 1, 1]",237,129,108,13,5,0.10077519379844961,0.046296296296296294
"[1, 1, 0, 0, 0, 0, 0, 1, 0, 0, 1, 1, 0, 0, 0]",372,223,149,19,20,0.08520179372197309,0.1342281879194631
"[0, 0, 1, 1, 0, 1, 0, 0, 1, 0, 0, 0, 0, 0, 0]",709,521,188,52,24,0.09980806142034548,0.1276595744680851
"[1, 1, 1, 0, 0, 0, 0, 1, 1, 0, 0, 0, 0, 0, 1]",494,158,336,14,38,0.08860759493670886,0.1130952380952381
"[1, 0, 0, 1, 1, 0, 0, 0, 1, 1, 1, 0, 1, 1, 1]",251,79,172,6,13,0.0759493670886076,0.0755813953488372
"[1, 1, 1, 0, 0, 1, 1, 1, 1, 0, 0, 1, 1, 1, 0]",622,136,486,7,41,0.051470588235294115,0.08436213991769548
"[0, 1, 1, 1, 1, 1, 1, 1, 0, 0, 0, 1, 1, 1, 1]",952,357,595,45,62,0.12605042016806722,0.10420168067226891
"[1, 1, 1, 1, 0, 1, 1, 0, 1, 1, 0, 1, 1, 1, 0]",481,134,347,9,41,0.06716417910447761,0.11815561959654179
"[1, 0, 1, 0, 0, 1, 0, 1, 0, 1, 1, 1, 1, 0, 1]",134,51,83,5,7,0.09803921568627451,0.08433734939759036
"[1, 1, 0, 0, 1, 0, 1, 1, 0, 0, 0, 0, 1, 0, 0]",148,96,52,10,4,0.10416666666666667,0.07692307692307693
"[0, 1, 1, 0, 0, 1, 1, 0, 0, 0, 0, 1, 0, 0, 1]",314,241,73,27,6,0.11203319502074689,0.0821917808219178
"[1, 0, 0, 1, 1, 0, 0, 0, 1, 1, 0, 0, 0, 0, 0]",456,256,200,32,18,0.125,0.09
"[1, 1, 1, 1, 1, 1, 0, 1, 0, 0, 0, 1, 1, 0, 0]",230,74,156,10,12,0.13513513513513514,0.07692307692307693
"[1, 1, 1, 1, 1, 1, 1, 1, 1, 1, 0, 1, 0, 0, 0]",955,259,696,22,58,0.08494208494208494,0.08333333333333333
"[1, 0, 0, 1, 1, 0, 1, 0, 1, 1, 0, 1, 1, 1, 1]",302,100,202,3,24,0.03,0.1188118811881188
"[1, 1, 0, 0, 1, 1, 0, 1, 0, 1, 1, 0, 1, 1, 1]",328,133,195,18,21,0.13533834586466165,0.1076923076923077
"[1, 0, 0, 0, 1, 0, 1, 1, 1, 1, 0, 0, 1, 1, 1]",229,93,136,7,14,0.07526881720430108,0.10294117647058823
"[1, 0, 0, 0, 1, 0, 0, 0, 1, 0, 1, 1, 1, 1, 0]",112,51,61,5,6,0.09803921568627451,0.09836065573770492
"[0, 1, 0, 0, 0, 0, 0, 1, 0, 1, 1, 0, 0, 0, 0]",674,475,199,47,17,0.09894736842105263,0.08542713567839195
"[0, 0, 0, 0, 0, 0, 1, 1, 0, 0, 1, 1, 1, 0, 0]",690,442,248,35,21,0.07918552036199095,0.0846774193548387
"[1, 0, 0, 1, 0, 0, 0, 0, 0, 0, 1, 1, 0, 0, 1]",483,298,185,30,21,0.10067114093959731,0.11351351351351352
"[1, 1, 0, 1, 1, 0, 0, 0, 0, 1, 1, 0, 0, 1, 1]",432,207,225,25,21,0.12077294685990338,0.09333333333333334
"[1, 0, 1, 0, 0, 0, 0, 0, 0, 1, 0, 0, 0, 0, 0]",1748,1344,404,139,38,0.10342261904761904,0.09405940594059406
"[0, 1, 0, 0, 1, 1, 0, 0, 1, 1, 0, 0, 1, 1, 1]",454,226,228,19,25,0.084070796460177,0.10964912280701754
"[0, 1, 0, 0, 0, 0, 1, 0, 0, 0, 0, 1, 0, 0, 1]",531,369,162,38,10,0.10298102981029811,0.06172839506172839
"[0, 1, 1, 1, 0, 0, 0, 0, 0, 1, 0, 0, 0, 1, 1]",213,133,80,14,6,0.10526315789473684,0.075
"[0, 0, 0, 1, 1, 0, 1, 1, 1, 0, 0, 0, 0, 0, 1]",182,108,74,15,11,0.1388888888888889,0.14864864864864866
"[1, 0, 1, 0, 1, 0, 0, 1, 1, 0, 0, 1, 0, 0, 1]",123,53,70,6,8,0.11320754716981132,0.11428571428571428
"[1, 0, 1, 1, 0, 1, 0, 1, 0, 0, 1, 1, 0, 0, 1]",146,68,78,7,8,0.10294117647058823,0.10256410256410256
"[0, 0, 0, 1, 0, 0, 0, 1, 0, 0, 1, 0, 1, 0, 0]",512,368,144,30,16,0.08152173913043478,0.1111111111111111
"[0, 0, 0, 0, 1, 1, 0, 1, 0, 0, 0, 0, 1, 1, 1]",391,257,134,24,6,0.0933852140077821,0.04477611940298507
"[1, 1, 1, 1, 0, 0, 0, 0, 1, 1, 0, 1, 0, 0, 0]",216,124,92,13,10,0.10483870967741936,0.10869565217391304
"[1, 0, 1, 0, 1, 0, 1, 1, 1, 1, 0, 0, 0, 0, 1]",199,91,108,9,15,0.0989010989010989,0.1388888888888889
"[1, 0, 1, 1, 0, 0, 1, 0, 1, 0, 1, 0, 1, 1, 1]",169,81,88,4,11,0.04938271604938271,0.125
"[1, 0, 1, 0, 1, 0, 1, 0, 0, 1, 0, 1, 1, 0, 0]",125,64,61,9,4,0.140625,0.06557377049180328
"[0, 0, 1, 1, 1, 1, 0, 0, 1, 1, 0, 0, 0, 0, 1]",1617,815,802,82,63,0.10061349693251534,0.07855361596009976
"[1, 1, 1, 0, 1, 1, 0, 1, 0, 0, 0, 0, 1, 1, 0]",151,65,86,5,9,0.07692307692307693,0.10465116279069768
"[1, 0, 0, 0, 0, 1, 1, 1, 0, 1, 1, 0, 1, 0, 0]",130,57,73,6,8,0.10526315789473684,0.1095890410958904
"[1, 1, 0, 1, 1, 0, 0, 1, 1, 0, 1, 0, 1, 1, 0]",134,63,71,8,7,0.12698412698412698,0.09859154929577464
"[1, 1, 1, 0, 1, 1, 0, 1, 1, 0, 1, 0, 1, 1, 1]",556,174,382,15,35,0.08620689655172414,0.09162303664921466
"[0, 1, 1, 1, 0, 0, 0, 0, 1, 1, 1, 1, 0, 0, 0]",439,228,211,16,17,0.07017543859649122,0.08056872037914692
"[0, 1, 1, 0, 1, 0, 1, 1, 0, 0, 0, 0, 1, 1, 1]",215,106,109,9,13,0.08490566037735849,0.11926605504587157
"[1, 0, 1, 0, 1, 0, 1, 1, 1, 1, 1, 0, 1, 1, 0]",198,62,136,4,12,0.06451612903225806,0.08823529411764706
"[0, 0, 1, 0, 1, 0, 1, 0, 0, 1, 0, 0, 0, 0, 0]",590,421,169,39,13,0.09263657957244656,0.07692307692307693
"[0, 1, 1, 0, 0, 0, 0, 0, 0, 1, 0, 0, 1, 1, 0]",324,230,94,17,10,0.07391304347826087,0.10638297872340426
"[0, 1, 0, 0, 1, 0, 0, 1, 1, 1, 1, 0, 0, 0, 0]",328,211,117,18,13,0.08530805687203792,0.1111111111111111
"[0, 0, 0, 1, 0, 0, 1, 0, 0, 1, 1, 1, 1, 0, 0]",257,159,98,17,14,0.1069182389937107,0.14285714285714285
"[1, 0, 0, 1, 0, 0, 0, 1, 0, 0, 1, 0, 0, 1, 1]",171,100,71,11,8,0.11,0.11267605633802817
"[1, 0, 1, 1, 0, 0, 0, 0, 0, 1, 1, 1, 0, 1, 1]",144,81,63,9,6,0.1111111111111111,0.09523809523809523
"[1, 0, 0, 0, 1, 0, 1, 1, 0, 0, 0, 0, 0, 1, 1]",249,148,101,16,9,0.10810810810810811,0.0891089108910891
"[0, 0, 0, 0, 1, 0, 1, 0, 0, 0, 1, 1, 0, 1, 0]",245,149,96,18,7,0.12080536912751678,0.07291666666666667
"[1, 0, 1, 1, 1, 0, 1, 1, 0, 0, 0, 0, 0, 1, 1]",178,85,93,12,12,0.1411764705882353,0.12903225806451613
"[0, 0, 1, 1, 1, 0, 1, 0, 0, 0, 0, 1, 0, 1, 0]",130,72,58,12,4,0.16666666666666666,0.06896551724137931
"[0, 0, 0, 0, 0, 0, 0, 1, 1, 1, 0, 1, 0, 0, 0]",740,555,185,56,15,0.1009009009009009,0.08108108108108109
"[0, 1, 0, 0, 1, 1, 0, 0, 0, 0, 0, 1, 0, 0, 0]",558,389,169,33,14,0.08483290488431877,0.08284023668639054
"[0, 1, 1, 1, 0, 0, 0, 1, 0, 0, 0, 0, 1, 1, 0]",187,115,72,7,9,0.06086956521739131,0.125
"[1, 0, 1, 1, 0, 1, 1, 1, 0, 0, 0, 1, 0, 0, 0]",105,50,55,4,6,0.08,0.10909090909090909
"[0, 1, 0, 1, 1, 1, 1, 1, 0, 1, 0, 1, 1, 0, 1]",173,69,104,12,11,0.17391304347826086,0.10576923076923077
"[1, 1, 0, 0, 1, 1, 0, 1, 1, 1, 1, 0, 0, 0, 1]",189,64,125,5,9,0.078125,0.072
"[1, 1, 0, 0, 1, 0, 1, 1, 0, 0, 0, 0, 0, 0, 0]",412,248,164,20,9,0.08064516129032258,0.054878048780487805
"[1, 1, 1, 1, 1, 1, 0, 0, 1, 0, 1, 1, 1, 0, 0]",326,132,194,15,22,0.11363636363636363,0.1134020618556701
"[0, 0, 0, 1, 1, 1, 1, 1, 1, 0, 0, 0, 0, 0, 1]",496,386,110,29,12,0.07512953367875648,0.10909090909090909
"[1, 1, 1, 1, 0, 0, 0, 1, 1, 0, 0, 0, 0, 1, 1]",378,168,210,23,21,0.13690476190476192,0.1
"[0, 0, 1, 0, 1, 0, 1, 1, 1, 1, 0, 0, 1, 0, 1]",120,59,61,4,5,0.06779661016949153,0.08196721311475409
"[0, 0, 0, 1, 1, 1, 1, 1, 0, 1, 0, 0, 1, 0, 1]",123,56,67,5,9,0.08928571428571429,0.13432835820895522
"[1, 1, 1, 0, 0, 1, 1, 1, 0, 0, 1, 0, 0, 0, 0]",180,88,92,11,13,0.125,0.14130434782608695
"[0, 0, 0, 0, 1, 0, 0, 0, 1, 1, 1, 0, 0, 1, 1]",233,142,91,15,6,0.1056338028169014,0.06593406593406594
"[1, 1, 1, 1, 0, 0, 0, 0, 1, 0, 0, 0, 1, 1, 0]",172,83,89,7,9,0.08433734939759036,0.10112359550561797
"[1, 0, 0, 1, 1, 1, 1, 0, 1, 1, 0, 0, 1, 1, 1]",417,131,286,15,28,0.11450381679389313,0.0979020979020979
"[1, 1, 1, 0, 0, 1, 0, 1, 1, 1, 0, 1, 1, 1, 1]",647,174,473,20,45,0.11494252873563218,0.09513742071881606
"[1, 0, 1, 1, 1, 0, 0, 1, 0, 1, 1, 1, 0, 1, 1]",232,101,131,8,14,0.07920792079207921,0.10687022900763359
"[1, 1, 1, 0, 1, 0, 1, 0, 1, 1, 1, 1, 1, 1, 1]",1953,464,1489,53,150,0.11422413793103449,0.10073875083948959
"[1, 1, 1, 1, 1, 0, 1, 1, 1, 0, 0, 1, 0, 1, 1]",622,155,467,12,46,0.07741935483870968,0.09850107066381156
"[0, 1, 1, 1, 1, 1, 1, 0, 1, 1, 1, 0, 0, 1, 0]",254,104,150,8,21,0.07692307692307693,0.14
"[1, 0, 0, 1, 0, 0, 0, 1, 0, 0, 0, 0, 1, 0, 0]",510,346,164,26,14,0.07514450867052024,0.08536585365853659
"[0, 1, 0, 0, 0, 1, 1, 0, 1, 0, 0, 0, 0, 0, 0]",637,449,188,32,17,0.07126948775055679,0.09042553191489362
"[0, 1, 1, 0, 0, 0, 1, 1, 1, 1, 0, 0, 0, 0, 1]",313,164,149,18,13,0.10975609756097561,0.087248322147651
"[1, 1, 0, 0, 0, 1, 1, 1, 0, 1, 0, 0, 0, 0, 0]",212,114,98,11,6,0.09649122807017543,0.061224489795918366
"[1, 1, 1, 0, 0, 0, 1, 1, 1, 0, 1, 0, 0, 0, 0]",151,70,81,6,4,0.08571428571428572,0.04938271604938271
"[1, 0, 0, 0, 1, 1, 0, 0, 0, 1, 0, 1, 1, 1, 1]",170,85,85,11,5,0.12941176470588237,0.058823529411764705
"[1, 0, 0, 1, 0, 1, 1, 1, 0, 0, 1, 1, 0, 1, 1]",155,64,91,8,9,0.125,0.0989010989010989
"[1, 0, 1, 1, 1, 0, 1, 1, 0, 1, 1, 1, 0, 0, 0]",158,74,84,1,7,0.013513513513513514,0.08333333333333333
"[1, 1, 1, 0, 0, 0, 0, 0, 0, 1, 1, 1, 1, 1, 0]",428,96,332,6,24,0.0625,0.07228915662650602
"[0, 1, 0, 0, 1, 0, 0, 0, 0, 0, 1, 0, 0, 1, 1]",315,204,111,21,14,0.10294117647058823,0.12612612612612611
"[0, 1, 0, 0, 1, 0, 0, 1, 0, 0, 0, 0, 0, 1, 0]",486,351,135,37,6,0.10541310541310542,0.044444444444444446
"[1, 0, 1, 0, 1, 0, 0, 1, 0, 0, 1, 0, 0, 0, 0]",245,156,89,15,10,0.09615384615384616,0.11235955056179775
"[1, 0, 1, 0, 1, 1, 1, 1, 1, 1, 1, 1, 0, 0, 1]",1005,282,723,31,75,0.1099290780141844,0.1037344398340249
"[1, 0, 1, 1, 0, 0, 0, 1, 1, 0, 1, 1, 1, 1, 1]",282,102,180,12,20,0.11764705882352941,0.1111111111111111
"[1, 1, 1, 0, 1, 1, 0, 0, 1, 1, 0, 0, 1, 1, 1]",665,214,451,25,45,0.11682242990654206,0.09977827050997783
"[0, 1, 1, 0, 0, 1, 1, 1, 1, 1, 1, 1, 1, 0, 1]",1024,569,455,50,48,0.08787346221441125,0.1054945054945055
"[0, 0, 0, 0, 1, 0, 0, 1, 1, 0, 0, 1, 1, 1, 0]",167,92,75,5,6,0.05434782608695652,0.08
"[0, 1, 0, 1, 1, 1, 1, 0, 1, 1, 0, 0, 0, 0, 0]",154,75,79,8,6,0.10666666666666667,0.0759493670886076
"[0, 0, 1, 0, 1, 0, 1, 1, 1, 1, 0, 1, 1, 0, 0]",112,57,55,4,4,0.07017543859649122,0.07272727272727272
"[1, 1, 0, 0, 1, 0, 1, 0, 1, 1, 1, 1, 0, 1, 1]",279,100,179,10,23,0.1,0.12849162011173185
"[0, 0, 0, 0, 1, 0, 1, 1, 0, 0, 1, 1, 0, 0, 1]",268,174,94,15,10,0.08620689655172414,0.10638297872340426
"[0, 1, 0, 1, 0, 0, 0, 1, 0, 1, 1, 0, 1, 0, 0]",142,82,60,13,8,0.15853658536585366,0.13333333333333333
"[1, 0, 1, 0, 0, 1, 1, 1, 0, 0, 0, 0, 0, 0, 0]",365,221,144,24,11,0.1085972850678733,0.0763888888888889
"[0, 1, 0, 0, 0, 0, 1, 1, 0, 1, 0, 0, 1, 1, 1]",154,91,63,2,8,0.02197802197802198,0.12698412698412698
"[1, 0, 0, 0, 1, 0, 1, 1, 0, 1, 0, 1, 1, 0, 1]",104,46,58,1,3,0.021739130434782608,0.05172413793103448
"[1, 1, 1, 1, 0, 1, 0, 0, 0, 0, 1, 0, 1, 1, 1]",221,93,128,10,15,0.10752688172043011,0.1171875
"[1, 1, 1, 1, 1, 1, 0, 1, 0, 0, 0, 0, 1, 0, 1]",175,72,103,6,9,0.08333333333333333,0.08737864077669903
"[1, 0, 1, 1, 1, 1, 1, 1, 1, 1, 1, 0, 1, 0, 0]",586,171,415,17,40,0.09941520467836257,0.0963855421686747
"[0, 0, 1, 0, 0, 0, 0, 0, 1, 1, 0, 1, 1, 0, 0]",297,175,122,14,8,0.08,0.06557377049180328
"[1, 1, 0, 0, 0, 1, 1, 1, 0, 0, 0, 0, 1, 1, 1]",287,141,146,18,13,0.1276595744680851,0.08904109589041095
"[0, 0, 0, 0, 0, 1, 1, 0, 0, 0, 1, 1, 1, 0, 0]",378,267,111,29,8,0.10861423220973783,0.07207207207207207
"[0, 1, 0, 0, 1, 1, 1, 1, 1, 0, 0, 0, 0, 0, 0]",364,218,146,17,17,0.0779816513761468,0.11643835616438356
"[1, 0, 1, 0, 0, 1, 1, 1, 1, 1, 0, 0, 0, 0, 0]",221,115,106,11,14,0.09565217391304348,0.1320754716981132
"[0, 1, 0, 1, 0, 0, 1, 0, 1, 0, 0, 1, 1, 1, 1]",168,77,91,4,9,0.05194805194805195,0.0989010989010989
"[0, 1, 1, 0, 1, 1, 1, 0, 1, 1, 1, 0, 0, 0, 0]",125,65,60,4,8,0.06153846153846154,0.13333333333333333
"[1, 1, 0, 0, 0, 1, 0, 0, 1, 1, 0, 0, 1, 0, 0]",146,75,71,6,15,0.08,0.2112676056338028
"[0, 0, 0, 0, 1, 1, 0, 1, 1, 0, 1, 0, 1, 0, 0]",144,83,61,8,8,0.0963855421686747,0.13114754098360656
"[1, 1, 1, 0, 1, 0, 0, 0, 1, 0, 1, 1, 0, 0, 1]",131,54,77,4,4,0.07407407407407407,0.05194805194805195
"[0, 0, 0, 1, 1, 1, 1, 0, 1, 0, 1, 0, 1, 0, 1]",126,73,53,7,4,0.0958904109589041,0.07547169811320754
"[0, 1, 1, 1, 0, 0, 0, 1, 1, 1, 1, 0, 1, 0, 1]",143,64,79,9,6,0.140625,0.0759493670886076
"[0, 0, 0, 1, 0, 0, 0, 0, 0, 0, 1, 1, 1, 0, 0]",662,465,197,44,17,0.09462365591397849,0.08629441624365482
"[0, 0, 1, 0, 0, 1, 0, 1, 0, 0, 0, 0, 0, 1, 0]",521,360,161,37,16,0.10277777777777777,0.09937888198757763
"[0, 0, 0, 1, 1, 0, 0, 0, 1, 1, 0, 0, 0, 0, 0]",1014,736,278,68,29,0.09239130434782608,0.10431654676258993
"[1, 1, 0, 1, 0, 1, 1, 0, 1, 0, 0, 1, 1, 1, 0]",145,55,90,6,6,0.10909090909090909,0.06666666666666667
"[0, 0, 0, 0, 0, 1, 1, 0, 0, 1, 0, 1, 0, 0, 0]",730,556,174,53,17,0.09532374100719425,0.09770114942528736
"[1, 0, 1, 0, 0, 0, 0, 0, 0, 1, 1, 0, 0, 1, 0]",250,161,89,17,4,0.10559006211180125,0.0449438202247191
"[1, 1, 0, 1, 0, 0, 1, 0, 0, 1, 0, 0, 0, 0, 0]",270,167,103,15,5,0.08982035928143713,0.04854368932038835
"[1, 0, 0, 0, 0, 1, 1, 1, 1, 1, 1, 0, 1, 0, 0]",239,90,149,5,12,0.05555555555555555,0.08053691275167785
"[0, 0, 1, 0, 0, 0, 0, 1, 1, 1, 1, 1, 1, 0, 1]",173,88,85,8,10,0.09090909090909091,0.11764705882352941
"[0, 0, 1, 1, 0, 1, 1, 1, 1, 0, 1, 1, 0, 0, 1]",183,88,95,7,8,0.07954545454545454,0.08421052631578947
"[1, 1, 1, 1, 0, 1, 0, 0, 0, 1, 1, 0, 0, 1, 1]",276,98,178,10,9,0.10204081632653061,0.05056179775280899
"[1, 1, 1, 1, 1, 1, 0, 1, 1, 0, 1, 0, 0, 0, 0]",220,84,136,10,14,0.11904761904761904,0.10294117647058823
"[1, 1, 1, 0, 0, 1, 0, 0, 0, 0, 0, 0, 1, 1, 1]",305,133,172,15,12,0.11278195488721804,0.06976744186046512
"[1, 0, 1, 0, 1, 1, 1, 1, 1, 1, 0, 0, 1, 0, 0]",163,73,90,10,8,0.136986301369863,0.08888888888888889
"[1, 1, 1, 0, 0, 0, 1, 0, 1, 1, 0, 1, 0, 0, 1]",127,52,75,1,10,0.019230769230769232,0.13333333333333333
"[1, 0, 1, 0, 0, 0, 0, 0, 1, 0, 0, 0, 0, 0, 1]",561,404,157,39,16,0.09653465346534654,0.10191082802547771
"[1, 1, 0, 1, 0, 0, 1, 1, 0, 1, 0, 1, 1, 1, 1]",257,91,166,7,17,0.07692307692307693,0.10240963855421686
"[1, 0, 0, 1, 1, 1, 1, 1, 1, 0, 1, 0, 1, 1, 0]",290,87,203,8,22,0.09195402298850575,0.10837438423645321
"[0, 1, 1, 1, 0, 1, 1, 1, 1, 0, 1, 1, 1, 0, 0]",299,94,205,9,23,0.09574468085106383,0.11219512195121951
"[0, 1, 1, 0, 1, 1, 0, 1, 1, 1, 0, 1, 0, 1, 1]",216,90,126,8,17,0.08888888888888889,0.1349206349206349
"[1, 1, 1, 1, 0, 0, 0, 1, 1, 0, 1, 1, 0, 1, 0]",157,61,96,6,7,0.09836065573770492,0.07291666666666667
"[0, 1, 1, 1, 1, 1, 1, 1, 1, 0, 0, 0, 0, 0, 1]",525,345,180,39,18,0.11304347826086956,0.1
"[1, 0, 0, 1, 0, 1, 1, 1, 1, 1, 1, 1, 1, 0, 0]",469,186,283,13,12,0.06989247311827956,0.04240282685512368
"[0, 1, 0, 1, 1, 1, 1, 1, 0, 1, 0, 1, 0, 0, 0]",114,49,65,4,7,0.08163265306122448,0.1076923076923077
"[0, 0, 1, 0, 1, 0, 1, 1, 1, 1, 0, 0, 1, 1, 0]",178,82,96,8,8,0.0975609756097561,0.08333333333333333
"[0, 1, 0, 1, 0, 0, 1, 0, 1, 0, 1, 1, 1, 1, 0]",122,61,61,2,6,0.03278688524590164,0.09836065573770492
"[1, 1, 1, 0, 1, 0, 1, 0, 0, 1, 0, 1, 0, 1, 1]",113,50,63,3,5,0.06,0.07936507936507936
"[0, 1, 0, 1, 1, 1, 1, 1, 0, 1, 0, 1, 0, 0, 1]",150,74,76,6,8,0.08108108108108109,0.10526315789473684
"[1, 0, 0, 1, 0, 0, 1, 0, 0, 0, 1, 0, 1, 1, 1]",153,83,70,10,9,0.12048192771084337,0.12857142857142856
"[0, 0, 0, 0, 0, 0, 0, 1, 0, 1, 0, 0, 0, 1, 0]",1567,1215,352,117,31,0.0962962962962963,0.08806818181818182
"[1, 1, 1, 0, 1, 1, 0, 1, 1, 0, 0, 0, 1, 1, 1]",311,97,214,12,16,0.12371134020618557,0.07476635514018691
"[1, 1, 1, 1, 1, 0, 1, 1, 1, 1, 1, 1, 0, 0, 0]",980,255,725,24,72,0.09411764705882353,0.0993103448275862
"[0, 1, 0, 0, 1, 0, 0, 0, 1, 0, 0, 1, 1, 1, 0]",152,98,54,9,5,0.09183673469387756,0.09259259259259259
"[0, 0, 1, 0, 0, 0, 1, 0, 1, 0, 0, 0, 0, 1, 1]",348,234,114,23,11,0.09829059829059829,0.09649122807017543
"[0, 1, 0, 1, 0, 1, 0, 0, 1, 0, 1, 1, 1, 1, 0]",113,55,58,4,7,0.07272727272727272,0.1206896551724138
"[0, 1, 0, 0, 1, 1, 1, 0, 0, 0, 1, 0, 1, 0, 1]",122,72,50,5,3,0.06944444444444445,0.06
"[1, 0, 1, 0, 0, 0, 0, 0, 0, 0, 0, 0, 1, 0, 0]",1686,1268,418,115,38,0.09069400630914827,0.09090909090909091
"[0, 0, 0, 0, 1, 0, 1, 1, 0, 1, 0, 1, 0, 0, 0]",249,173,76,12,9,0.06936416184971098,0.11842105263157894
"[0, 1, 0, 1, 0, 1, 0, 0, 0, 0, 0, 1, 0, 0, 0]",507,366,141,34,15,0.09289617486338798,0.10638297872340426
"[1, 0, 0, 1, 1, 0, 1, 1, 1, 0, 0, 1, 1, 0, 0]",173,83,90,9,7,0.10843373493975904,0.07777777777777778
"[0, 0, 1, 0, 1, 0, 0, 1, 1, 0, 1, 1, 1, 0, 0]",112,53,59,3,9,0.05660377358490566,0.15254237288135594
"[1, 1, 0, 0, 1, 0, 1, 0, 0, 1, 1, 0, 1, 1, 1]",177,75,102,9,11,0.12,0.10784313725490197
"[0, 1, 0, 1, 1, 1, 1, 1, 0, 0, 1, 0, 1, 0, 0]",124,64,60,4,3,0.0625,0.05
"[0, 0, 1, 0, 0, 1, 0, 1, 1, 1, 0, 0, 0, 1, 1]",115,57,58,7,4,0.12280701754385964,0.06896551724137931
"[0, 1, 0, 0, 1, 1, 0, 0, 1, 1, 1, 0, 0, 0, 1]",138,68,70,8,9,0.11764705882352941,0.12857142857142856
"[1, 1, 1, 0, 1, 1, 0, 0, 1, 0, 0, 1, 0, 1, 0]",117,61,56,3,10,0.04918032786885246,0.17857142857142858
"[0, 1, 0, 1, 0, 1, 1, 1, 0, 0, 1, 0, 1, 0, 0]",126,66,60,5,9,0.07575757575757576,0.15
"[1, 1, 0, 1, 0, 1, 1, 1, 1, 1, 1, 0, 1, 1, 0]",477,134,343,10,32,0.07462686567164178,0.09329446064139942
"[0, 0, 1, 1, 1, 1, 1, 0, 0, 1, 1, 1, 0, 1, 1]",317,130,187,14,15,0.1076923076923077,0.08021390374331551
"[1, 1, 0, 0, 0, 1, 1, 1, 1, 1, 0, 0, 1, 1, 1]",458,173,285,13,26,0.07514450867052024,0.0912280701754386
"[0, 1, 0, 0, 0, 0, 0, 1, 1, 0, 0, 0, 0, 1, 0]",601,428,173,34,13,0.0794392523364486,0.07514450867052024
"[1, 0, 1, 1, 1, 1, 1, 1, 0, 1, 1, 0, 1, 0, 0]",230,69,161,7,11,0.10144927536231885,0.06832298136645963
"[0, 0, 1, 1, 1, 0, 0, 1, 0, 0, 1, 1, 1, 1, 1]",228,95,133,9,13,0.09473684210526316,0.09774436090225563
"[0, 0, 0, 0, 0, 1, 1, 1, 0, 0, 1, 0, 0, 1, 1]",250,168,82,11,8,0.06547619047619048,0.0975609756097561
"[1, 0, 0, 0, 1, 0, 1, 0, 1, 0, 0, 1, 0, 1, 0]",120,80,40,9,4,0.1125,0.1
"[1, 0, 0, 1, 1, 0, 1, 0, 0, 0, 1, 0, 1, 0, 1]",121,56,65,6,4,0.10714285714285714,0.06153846153846154
"[0, 1, 1, 0, 0, 1, 1, 0, 1, 0, 0, 0, 1, 0, 1]",137,91,46,5,5,0.054945054945054944,0.10869565217391304
"[1, 0, 0, 0, 1, 0, 0, 1, 1, 0, 1, 1, 0, 0, 1]",110,62,48,5,6,0.08064516129032258,0.125
"[0, 0, 1, 0, 1, 1, 1, 0, 0, 1, 1, 1, 1, 1, 1]",510,204,306,21,19,0.10294117647058823,0.06209150326797386
"[1, 1, 0, 0, 1, 0, 0, 1, 1, 1, 1, 0, 0, 1, 1]",357,149,208,12,20,0.08053691275167785,0.09615384615384616
"[0, 1, 0, 0, 1, 1, 1, 1, 0, 1, 1, 1, 0, 1, 1]",247,95,152,9,20,0.09473684210526316,0.13157894736842105
"[1, 1, 0, 1, 0, 0, 1, 0, 1, 1, 1, 0, 0, 0, 0]",156,76,80,7,9,0.09210526315789473,0.1125
"[1, 0, 0, 1, 0, 1, 0, 0, 0, 1, 0, 1, 1, 1, 0]",110,57,53,6,3,0.10526315789473684,0.05660377358490566
"[0, 0, 0, 1, 0, 1, 0, 1, 0, 1, 0, 0, 0, 1, 1]",157,103,54,8,10,0.07766990291262135,0.18518518518518517
"[1, 0, 0, 0, 0, 1, 0, 1, 0, 1, 0, 1, 0, 0, 0]",260,157,103,11,11,0.07006369426751592,0.10679611650485436
"[1, 0, 1, 1, 0, 0, 0, 0, 0, 1, 1, 0, 0, 0, 1]",178,102,76,11,6,0.10784313725490197,0.07894736842105263
"[1, 1, 0, 1, 1, 0, 1, 0, 0, 1, 0, 0, 0, 0, 0]",169,98,71,9,7,0.09183673469387756,0.09859154929577464
"[0, 1, 0, 1, 0, 1, 0, 0, 1, 1, 1, 1, 1, 0, 0]",148,75,73,9,10,0.12,0.136986301369863
"[1, 0, 1, 1, 1, 0, 1, 1, 0, 1, 1, 0, 0, 1, 1]",301,126,175,10,19,0.07936507936507936,0.10857142857142857
"[1, 1, 1, 1, 1, 1, 0, 0, 0, 0, 1, 1, 0, 1, 0]",381,154,227,10,23,0.06493506493506493,0.1013215859030837
"[1, 1, 0, 1, 1, 0, 1, 0, 1, 1, 0, 1, 1, 1, 1]",570,153,417,16,39,0.10457516339869281,0.09352517985611511
"[0, 0, 1, 1, 1, 0, 0, 1, 0, 0, 0, 1, 0, 1, 0]",149,92,57,11,5,0.11956521739130435,0.08771929824561403
"[1, 1, 0, 0, 1, 1, 0, 1, 1, 1, 0, 0, 1, 0, 0]",122,55,67,5,4,0.09090909090909091,0.05970149253731343
"[0, 1, 1, 1, 1, 0, 1, 1, 0, 1, 0, 1, 1, 1, 1]",627,221,406,15,47,0.06787330316742081,0.11576354679802955
"[0, 1, 1, 0, 1, 1, 1, 1, 0, 1, 0, 1, 1, 1, 1]",578,167,411,20,44,0.11976047904191617,0.1070559610705596
"[0, 0, 1, 0, 0, 1, 1, 0, 1, 1, 1, 1, 0, 1, 0]",104,46,58,8,3,0.17391304347826086,0.05172413793103448
"[0, 0, 1, 1, 0, 0, 0, 1, 0, 0, 0, 1, 1, 0, 1]",135,80,55,11,4,0.1375,0.07272727272727272
"[0, 0, 0, 0, 1, 1, 0, 0, 0, 1, 0, 0, 0, 1, 1]",528,349,179,34,19,0.09742120343839542,0.10614525139664804
"[1, 0, 0, 0, 0, 0, 0, 1, 0, 0, 1, 0, 0, 0, 1]",609,369,240,34,21,0.0921409214092141,0.0875
"[0, 0, 0, 1, 1, 1, 0, 0, 1, 1, 1, 1, 0, 1, 0]",135,73,62,6,3,0.0821917808219178,0.04838709677419355
"[0, 0, 0, 0, 1, 1, 1, 0, 0, 1, 1, 1, 1, 0, 1]",154,83,71,8,7,0.0963855421686747,0.09859154929577464
"[0, 0, 0, 0, 1, 0, 1, 1, 0, 1, 1, 1, 1, 1, 1]",245,114,131,13,14,0.11403508771929824,0.10687022900763359
"[0, 1, 0, 0, 0, 1, 0, 1, 0, 1, 1, 1, 0, 0, 0]",165,104,61,6,5,0.057692307692307696,0.08196721311475409
"[1, 0, 0, 1, 0, 1, 1, 0, 0, 0, 0, 0, 0, 1, 0]",241,145,96,20,12,0.13793103448275862,0.125
"[0, 1, 1, 0, 0, 0, 1, 0, 1, 1, 0, 1, 0, 1, 1]",132,64,68,5,7,0.078125,0.10294117647058823
"[0, 1, 1, 1, 1, 1, 1, 0, 0, 0, 0, 1, 0, 1, 0]",211,144,67,13,6,0.09027777777777778,0.08955223880597014
"[1, 1, 0, 1, 0, 1, 0, 0, 0, 1, 1, 0, 0, 1, 1]",166,72,94,8,9,0.1111111111111111,0.09574468085106383
"[0, 1, 0, 0, 1, 1, 0, 1, 0, 1, 1, 0, 1, 0, 1]",100,39,61,6,6,0.15384615384615385,0.09836065573770492
"[1, 0, 0, 1, 0, 1, 1, 1, 0, 0, 0, 0, 1, 1, 1]",244,103,141,10,12,0.0970873786407767,0.0851063829787234
"[1, 1, 0, 0, 1, 1, 1, 0, 0, 1, 0, 1, 1, 1, 0]",142,50,92,5,8,0.1,0.08695652173913043
"[1, 0, 1, 1, 1, 1, 1, 0, 0, 1, 1, 0, 0, 1, 1]",857,306,551,33,60,0.10784313725490197,0.1088929219600726
"[1, 0, 0, 1, 1, 0, 1, 1, 1, 1, 0, 1, 1, 1, 0]",229,72,157,8,17,0.1111111111111111,0.10828025477707007
"[1, 1, 1, 0, 1, 0, 0, 0, 1, 0, 0, 1, 1, 0, 1]",113,52,61,7,8,0.1346153846153846,0.13114754098360656
"[1, 1, 1, 1, 0, 0, 1, 1, 1, 0, 1, 0, 1, 1, 1]",820,241,579,17,56,0.07053941908713693,0.09671848013816926
"[1, 1, 1, 0, 0, 1, 1, 1, 0, 1, 1, 1, 1, 0, 0]",389,120,269,19,29,0.15833333333333333,0.10780669144981413
"[1, 0, 0, 1, 0, 0, 0, 1, 1, 0, 0, 0, 0, 1, 0]",260,158,102,10,9,0.06329113924050633,0.08823529411764706
"[1, 0, 0, 0, 0, 0, 0, 1, 1, 0, 0, 0, 1, 1, 1]",572,210,362,25,36,0.11904761904761904,0.09944751381215469
"[1, 1, 0, 0, 0, 0, 0, 0, 1, 1, 0, 0, 0, 1, 1]",588,351,237,36,26,0.10256410256410256,0.10970464135021098
"[0, 0, 0, 1, 1, 1, 0, 1, 0, 1, 1, 0, 0, 0, 0]",224,152,72,19,7,0.125,0.09722222222222222
"[0, 1, 0, 0, 0, 0, 0, 1, 1, 1, 0, 1, 0, 1, 1]",123,69,54,9,4,0.13043478260869565,0.07407407407407407
"[0, 0, 0, 0, 0, 0, 1, 1, 0, 0, 1, 0, 0, 0, 1]",832,588,244,52,19,0.08843537414965986,0.0778688524590164
"[0, 0, 0, 1, 1, 1, 0, 0, 0, 0, 1, 1, 1, 0, 0]",187,109,78,14,7,0.12844036697247707,0.08974358974358974
"[0, 1, 0, 1, 0, 1, 1, 1, 1, 0, 0, 1, 1, 1, 1]",473,191,282,17,30,0.08900523560209424,0.10638297872340426
"[0, 0, 0, 1, 0, 1, 0, 0, 1, 0, 0, 1, 0, 0, 1]",242,162,80,13,8,0.08024691358024691,0.1
"[1, 1, 0, 0, 0, 0, 0, 1, 1, 0, 0, 1, 0, 0, 0]",300,192,108,18,10,0.09375,0.09259259259259259
"[0, 1, 1, 1, 1, 1, 0, 1, 1, 0, 1, 0, 0, 1, 1]",265,111,154,14,11,0.12612612612612611,0.07142857142857142
"[1, 1, 0, 1, 0, 1, 1, 0, 0, 0, 0, 0, 0, 1, 1]",324,146,178,18,17,0.1232876712328767,0.09550561797752809
"[1, 0, 1, 0, 0, 1, 0, 1, 0, 0, 0, 1, 1, 0, 0]",177,91,86,9,5,0.0989010989010989,0.05813953488372093
"[1, 1, 1, 0, 0, 0, 1, 1, 1, 0, 1, 1, 0, 0, 1]",180,68,112,9,12,0.1323529411764706,0.10714285714285714
"[1, 0, 0, 1, 0, 1, 1, 1, 0, 0, 1, 0, 1, 1, 1]",162,67,95,9,9,0.13432835820895522,0.09473684210526316
"[0, 1, 0, 1, 0, 0, 1, 1, 1, 0, 1, 1, 1, 1, 1]",292,114,178,10,12,0.08771929824561403,0.06741573033707865
"[0, 1, 1, 1, 0, 0, 1, 0, 0, 0, 1, 0, 1, 0, 1]",113,63,50,10,6,0.15873015873015872,0.12
"[0, 1, 1, 0, 1, 0, 1, 1, 0, 1, 1, 0, 1, 0, 0]",102,60,42,10,3,0.16666666666666666,0.07142857142857142
"[0, 0, 0, 0, 0, 1, 1, 0, 1, 0, 1, 1, 0, 1, 1]",165,106,59,12,6,0.11320754716981132,0.1016949152542373
"[1, 0, 1, 1, 0, 1, 0, 0, 1, 1, 0, 0, 0, 0, 0]",234,119,115,11,12,0.09243697478991597,0.10434782608695652
"[0, 1, 0, 0, 1, 0, 0, 1, 0, 1, 0, 0, 0, 1, 0]",207,141,66,15,5,0.10638297872340426,0.07575757575757576
"[1, 0, 0, 0, 0, 0, 1, 1, 1, 0, 0, 0, 0, 1, 0]",263,157,106,17,12,0.10828025477707007,0.11320754716981132
"[0, 0, 0, 0, 1, 0, 1, 1, 0, 1, 0, 0, 0, 0, 0]",620,439,181,45,13,0.10250569476082004,0.0718232044198895
"[1, 0, 0, 0, 0, 1, 0, 0, 1, 1, 0, 0, 0, 0, 0]",871,579,292,49,21,0.0846286701208981,0.07191780821917808
"[1, 0, 1, 1, 0, 1, 1, 1, 0, 1, 1, 1, 1, 1, 0]",525,158,367,12,26,0.0759493670886076,0.07084468664850137
"[1, 1, 0, 1, 1, 1, 1, 0, 1, 1, 1, 0, 0, 1, 0]",237,80,157,7,17,0.0875,0.10828025477707007
"[1, 0, 1, 0, 1, 1, 1, 1, 0, 1, 1, 1, 0, 1, 0]",236,83,153,10,18,0.12048192771084337,0.11764705882352941
"[0, 1, 0, 1, 0, 1, 1, 1, 1, 0, 1, 1, 1, 0, 1]",211,80,131,7,14,0.0875,0.10687022900763359
"[0, 0, 0, 0, 1, 0, 1, 1, 0, 0, 1, 0, 0, 0, 1]",252,151,101,21,14,0.1390728476821192,0.13861386138613863
"[1, 1, 1, 0, 0, 0, 0, 1, 1, 1, 1, 1, 1, 0, 0]",1967,337,1630,35,171,0.10385756676557864,0.1049079754601227
"[1, 0, 0, 0, 1, 0, 1, 0, 0, 1, 1, 0, 0, 1, 1]",218,122,96,14,10,0.11475409836065574,0.10416666666666667
"[1, 1, 1, 1, 1, 0, 0, 1, 0, 0, 0, 1, 0, 1, 1]",164,62,102,3,6,0.04838709677419355,0.058823529411764705
"[1, 0, 1, 0, 0, 1, 1, 0, 1, 0, 1, 0, 0, 1, 1]",156,80,76,8,9,0.1,0.11842105263157894
"[0, 1, 0, 0, 1, 0, 0, 1, 0, 0, 1, 1, 0, 0, 0]",302,189,113,21,8,0.1111111111111111,0.07079646017699115
"[0, 0, 1, 1, 1, 0, 1, 1, 0, 0, 1, 1, 0, 0, 0]",236,127,109,10,11,0.07874015748031496,0.10091743119266056
"[0, 0, 1, 0, 0, 0, 1, 1, 1, 0, 0, 1, 0, 1, 0]",148,79,69,12,9,0.1518987341772152,0.13043478260869565
"[1, 0, 1, 1, 0, 1, 1, 1, 1, 1, 1, 0, 1, 1, 0]",537,159,378,13,28,0.08176100628930817,0.07407407407407407
"[1, 0, 1, 0, 1, 1, 0, 1, 1, 0, 1, 1, 1, 1, 1]",577,156,421,18,39,0.11538461538461539,0.09263657957244656
"[0, 1, 0, 0, 0, 0, 1, 1, 1, 0, 1, 1, 1, 0, 1]",117,51,66,4,4,0.0784313725490196,0.06060606060606061
"[0, 1, 0, 0, 1, 1, 1, 1, 0, 1, 0, 1, 0, 0, 0]",121,73,48,7,4,0.0958904109589041,0.08333333333333333
"[0, 1, 0, 1, 1, 0, 1, 0, 0, 1, 1, 1, 1, 0, 1]",141,59,82,5,8,0.0847457627118644,0.0975609756097561
"[1, 0, 1, 1, 1, 0, 1, 1, 0, 0, 1, 1, 0, 0, 0]",195,90,105,4,5,0.044444444444444446,0.047619047619047616
"[1, 0, 1, 1, 1, 1, 0, 0, 1, 1, 0, 0, 0, 1, 1]",227,108,119,13,12,0.12037037037037036,0.10084033613445378
"[1, 1, 0, 0, 0, 1, 1, 0, 1, 0, 1, 1, 1, 1, 0]",164,61,103,5,11,0.08196721311475409,0.10679611650485436
"[1, 1, 1, 1, 1, 0, 0, 0, 1, 1, 0, 1, 0, 1, 1]",312,105,207,10,17,0.09523809523809523,0.0821256038647343
"[0, 1, 1, 1, 1, 1, 0, 0, 1, 1, 1, 1, 1, 0, 0]",420,196,224,18,14,0.09183673469387756,0.0625
"[0, 0, 0, 0, 0, 0, 1, 1, 0, 0, 0, 1, 0, 1, 0]",713,509,204,45,15,0.08840864440078586,0.07352941176470588
"[1, 0, 1, 1, 1, 1, 1, 0, 0, 0, 0, 1, 1, 0, 0]",426,187,239,19,17,0.10160427807486631,0.07112970711297072
"[1, 1, 0, 1, 0, 1, 1, 1, 1, 1, 0, 0, 1, 0, 1]",240,94,146,12,13,0.1276595744680851,0.08904109589041095
"[1, 1, 0, 1, 0, 1, 0, 1, 1, 1, 0, 1, 0, 1, 0]",118,57,61,9,4,0.15789473684210525,0.06557377049180328
"[1, 1, 1, 1, 1, 0, 0, 1, 1, 0, 0, 1, 1, 0, 1]",698,143,555,13,48,0.09090909090909091,0.08648648648648649
"[0, 1, 0, 1, 1, 0, 1, 1, 1, 1, 0, 1, 1, 0, 0]",192,68,124,6,13,0.08823529411764706,0.10483870967741936
"[1, 1, 1, 0, 0, 1, 0, 0, 1, 1, 0, 0, 0, 1, 0]",115,59,56,3,2,0.05084745762711865,0.03571428571428571
"[1, 0, 1, 0, 1, 0, 0, 0, 0, 0, 1, 1, 0, 1, 0]",148,75,73,4,5,0.05333333333333334,0.0684931506849315
"[1, 0, 0, 1, 0, 0, 1, 1, 1, 1, 0, 0, 1, 0, 0]",126,60,66,9,5,0.15,0.07575757575757576
"[0, 1, 1, 1, 1, 1, 0, 1, 1, 1, 0, 0, 0, 1, 1]",271,118,153,20,14,0.1694915254237288,0.0915032679738562
"[0, 1, 0, 0, 0, 1, 1, 1, 0, 0, 1, 0, 0, 1, 1]",138,80,58,6,3,0.075,0.05172413793103448
"[0, 0, 1, 1, 1, 0, 0, 1, 0, 1, 0, 1, 1, 0, 0]",142,75,67,11,6,0.14666666666666667,0.08955223880597014
"[1, 1, 1, 1, 0, 0, 0, 1, 1, 1, 0, 0, 1, 1, 1]",436,134,302,10,32,0.07462686567164178,0.10596026490066225
"[1, 1, 1, 1, 1, 1, 1, 0, 0, 0, 1, 0, 1, 0, 1]",360,107,253,9,17,0.08411214953271028,0.06719367588932806
"[1, 1, 0, 1, 0, 1, 1, 1, 1, 0, 1, 1, 0, 1, 1]",514,152,362,15,34,0.09868421052631579,0.09392265193370165
"[1, 0, 0, 1, 0, 0, 1, 1, 0, 0, 1, 1, 1, 1, 1]",379,143,236,9,24,0.06293706293706294,0.1016949152542373
"[1, 1, 1, 0, 0, 1, 0, 0, 1, 1, 0, 0, 1, 1, 1]",341,123,218,12,24,0.0975609756097561,0.11009174311926606
"[0, 0, 0, 1, 1, 1, 1, 1, 1, 0, 0, 1, 0, 0, 1]",244,182,62,25,6,0.13736263736263737,0.0967741935483871
"[1, 1, 0, 0, 1, 1, 1, 0, 0, 1, 1, 0, 0, 1, 1]",410,168,242,15,25,0.08928571428571429,0.10330578512396695
"[0, 1, 0, 1, 1, 0, 1, 0, 0, 1, 0, 1, 1, 1, 1]",161,71,90,7,7,0.09859154929577464,0.07777777777777778
"[0, 1, 0, 1, 1, 1, 1, 1, 1, 1, 0, 0, 1, 0, 1]",274,108,166,15,18,0.1388888888888889,0.10843373493975904
"[0, 0, 0, 0, 1, 0, 1, 1, 1, 1, 1, 1, 1, 0, 0]",263,135,128,15,15,0.1111111111111111,0.1171875
"[0, 1, 1, 0, 0, 1, 1, 1, 1, 1, 1, 1, 1, 1, 0]",1200,617,583,42,62,0.06807131280388978,0.10634648370497427
"[0, 0, 1, 0, 1, 1, 0, 1, 1, 0, 0, 1, 0, 0, 1]",103,59,44,5,3,0.0847457627118644,0.06818181818181818
"[0, 1, 0, 1, 0, 0, 1, 0, 0, 1, 0, 1, 0, 0, 0]",232,153,79,18,12,0.11764705882352941,0.1518987341772152
"[1, 0, 0, 1, 0, 0, 0, 0, 1, 1, 0, 1, 0, 0, 0]",275,167,108,10,6,0.059880239520958084,0.05555555555555555
"[1, 0, 0, 0, 0, 0, 0, 1, 1, 0, 1, 0, 1, 1, 1]",286,94,192,13,22,0.13829787234042554,0.11458333333333333
"[1, 0, 1, 0, 1, 0, 1, 0, 1, 0, 0, 0, 0, 0, 0]",310,199,111,14,11,0.07035175879396985,0.0990990990990991
"[0, 0, 1, 0, 1, 0, 1, 0, 1, 0, 1, 0, 0, 0, 0]",251,168,83,20,9,0.11904761904761904,0.10843373493975904
"[0, 0, 0, 0, 0, 0, 1, 0, 1, 0, 1, 0, 1, 0, 1]",271,188,83,20,7,0.10638297872340426,0.08433734939759036
"[1, 0, 1, 1, 0, 0, 1, 0, 0, 0, 0, 0, 0, 0, 1]",285,192,93,15,7,0.078125,0.07526881720430108
"[0, 0, 1, 0, 0, 1, 0, 0, 0, 1, 1, 1, 0, 0, 1]",168,109,59,9,6,0.08256880733944955,0.1016949152542373
"[1, 0, 0, 1, 0, 0, 0, 1, 1, 0, 0, 0, 0, 0, 1]",250,141,109,17,10,0.12056737588652482,0.09174311926605505
"[0, 1, 0, 0, 0, 0, 1, 0, 1, 1, 1, 0, 1, 0, 0]",161,85,76,6,9,0.07058823529411765,0.11842105263157894
"[0, 1, 0, 0, 0, 1, 1, 0, 0, 0, 0, 1, 1, 1, 1]",519,294,225,31,17,0.1054421768707483,0.07555555555555556
"[0, 1, 0, 0, 1, 0, 1, 1, 1, 1, 0, 1, 1, 1, 1]",270,79,191,9,14,0.11392405063291139,0.07329842931937172
"[0, 1, 1, 0, 1, 1, 1, 0, 0, 1, 1, 0, 1, 1, 1]",273,108,165,8,16,0.07407407407407407,0.09696969696969697
"[1, 1, 1, 1, 1, 0, 1, 1, 0, 1, 1, 1, 0, 0, 1]",661,185,476,15,48,0.08108108108108109,0.10084033613445378
"[1, 1, 1, 0, 0, 1, 1, 1, 1, 0, 0, 1, 1, 0, 1]",650,119,531,11,45,0.09243697478991597,0.0847457627118644
"[0, 0, 1, 1, 1, 0, 1, 1, 1, 1, 1, 0, 1, 1, 0]",249,98,151,11,14,0.11224489795918367,0.09271523178807947
"[0, 0, 0, 0, 1, 1, 1, 0, 1, 1, 1, 1, 1, 0, 1]",190,84,106,7,13,0.08333333333333333,0.12264150943396226
"[0, 1, 0, 0, 1, 1, 1, 1, 1, 1, 0, 0, 0, 0, 0]",416,222,194,20,20,0.09009009009009009,0.10309278350515463
"[0, 1, 1, 1, 1, 1, 0, 1, 0, 0, 0, 1, 0, 1, 1]",160,68,92,6,7,0.08823529411764706,0.07608695652173914
"[1, 1, 0, 0, 1, 1, 1, 1, 1, 0, 1, 0, 0, 0, 1]",216,86,130,5,10,0.05813953488372093,0.07692307692307693
"[1, 0, 1, 0, 0, 1, 0, 0, 0, 0, 1, 1, 0, 1, 1]",106,63,43,4,3,0.06349206349206349,0.06976744186046512
"[0, 1, 0, 1, 1, 1, 0, 1, 0, 0, 1, 1, 1, 0, 0]",122,63,59,7,6,0.1111111111111111,0.1016949152542373
"[1, 0, 0, 0, 1, 1, 0, 1, 1, 0, 1, 0, 1, 1, 1]",152,54,98,6,9,0.1111111111111111,0.09183673469387756
"[1, 1, 1, 0, 0, 1, 1, 0, 1, 1, 1, 0, 1, 1, 0]",286,88,198,6,17,0.06818181818181818,0.08585858585858586
"[1, 0, 0, 1, 1, 0, 1, 1, 1, 1, 1, 0, 0, 1, 1]",423,131,292,8,35,0.061068702290076333,0.11986301369863013
"[1, 1, 1, 0, 0, 0, 0, 1, 1, 1, 0, 1, 0, 1, 0]",154,56,98,4,12,0.07142857142857142,0.12244897959183673
"[1, 1, 1, 1, 1, 1, 0, 1, 0, 0, 1, 1, 0, 0, 1]",415,117,298,6,23,0.05128205128205128,0.07718120805369127
"[0, 0, 0, 1, 0, 1, 0, 0, 0, 0, 1, 1, 1, 1, 1]",262,163,99,18,11,0.11042944785276074,0.1111111111111111
"[1, 0, 1, 0, 0, 0, 1, 0, 1, 0, 0, 0, 0, 1, 1]",198,115,83,13,7,0.11304347826086956,0.08433734939759036
"[0, 0, 1, 0, 1, 0, 1, 0, 0, 0, 1, 0, 1, 0, 1]",116,71,45,7,6,0.09859154929577464,0.13333333333333333
"[1, 0, 1, 1, 0, 1, 0, 1, 0, 0, 0, 1, 0, 0, 0]",152,95,57,14,6,0.14736842105263157,0.10526315789473684
"[0, 0, 1, 0, 1, 0, 1, 1, 0, 1, 0, 1, 0, 0, 0]",129,78,51,7,9,0.08974358974358974,0.17647058823529413
"[0, 0, 0, 1, 0, 1, 0, 1, 1, 0, 1, 0, 1, 0, 0]",136,75,61,8,7,0.10666666666666667,0.11475409836065574
"[1, 1, 1, 0, 0, 0, 0, 0, 0, 0, 0, 1, 0, 1, 0]",395,168,227,12,21,0.07142857142857142,0.09251101321585903
"[0, 0, 0, 0, 1, 0, 0, 0, 0, 0, 0, 1, 1, 1, 1]",994,715,279,73,25,0.1020979020979021,0.08960573476702509
"[1, 1, 0, 0, 1, 1, 1, 1, 0, 0, 0, 1, 0, 0, 0]",241,148,93,13,5,0.08783783783783784,0.053763440860215055
"[0, 1, 0, 1, 0, 0, 1, 0, 0, 0, 1, 0, 0, 0, 0]",555,387,168,47,21,0.12144702842377261,0.125
"[0, 0, 0, 0, 1, 1, 1, 1, 0, 0, 1, 1, 0, 1, 0]",320,188,132,17,13,0.09042553191489362,0.09848484848484848
"[0, 0, 0, 1, 1, 0, 1, 0, 1, 0, 0, 0, 0, 0, 1]",302,194,108,22,11,0.1134020618556701,0.10185185185185185
"[0, 0, 0, 0, 0, 1, 1, 0, 1, 0, 1, 0, 0, 0, 0]",686,485,201,52,27,0.10721649484536082,0.13432835820895522
"[0, 0, 0, 1, 1, 0, 0, 0, 1, 0, 1, 0, 1, 0, 1]",161,96,65,10,7,0.10416666666666667,0.1076923076923077
"[0, 0, 0, 1, 0, 0, 1, 1, 0, 1, 0, 0, 0, 1, 1]",180,130,50,10,8,0.07692307692307693,0.16
"[0, 1, 0, 0, 1, 1, 0, 0, 1, 1, 0, 1, 0, 0, 1]",121,61,60,4,3,0.06557377049180328,0.05
"[0, 1, 0, 1, 0, 0, 0, 0, 0, 0, 0, 1, 0, 0, 1]",555,396,159,32,13,0.08080808080808081,0.08176100628930817
"[1, 1, 1, 0, 0, 1, 0, 0, 1, 0, 0, 1, 0, 0, 0]",192,102,90,7,8,0.06862745098039216,0.08888888888888889
"[0, 1, 0, 0, 1, 1, 1, 1, 0, 0, 1, 0, 0, 1, 0]",105,54,51,2,6,0.037037037037037035,0.11764705882352941
"[1, 1, 1, 1, 0, 0, 0, 1, 0, 1, 0, 1, 1, 0, 0]",137,64,73,13,7,0.203125,0.0958904109589041
"[0, 0, 0, 0, 0, 1, 0, 0, 1, 0, 1, 0, 1, 1, 0]",241,151,90,14,11,0.09271523178807947,0.12222222222222222
"[1, 0, 0, 0, 0, 0, 1, 0, 0, 0, 0, 1, 1, 0, 1]",270,146,124,17,14,0.11643835616438356,0.11290322580645161
"[1, 0, 1, 0, 1, 1, 0, 1, 0, 1, 1, 1, 0, 0, 0]",142,59,83,5,5,0.0847457627118644,0.060240963855421686
"[0, 1, 1, 0, 0, 1, 0, 1, 0, 0, 0, 0, 0, 0, 0]",776,573,203,50,17,0.08726003490401396,0.08374384236453201
"[0, 1, 1, 1, 1, 0, 0, 1, 1, 1, 0, 1, 0, 0, 1]",188,110,78,9,5,0.08181818181818182,0.0641025641025641
"[0, 1, 1, 0, 1, 1, 0, 0, 0, 1, 1, 1, 1, 1, 1]",464,190,274,17,26,0.08947368421052632,0.0948905109489051
"[1, 0, 1, 1, 1, 1, 0, 1, 0, 1, 1, 0, 1, 1, 0]",223,89,134,8,16,0.0898876404494382,0.11940298507462686
"[0, 0, 1, 0, 0, 1, 1, 0, 0, 1, 1, 0, 1, 0, 0]",149,94,55,6,5,0.06382978723404255,0.09090909090909091
"[0, 1, 1, 0, 1, 1, 0, 0, 1, 1, 0, 1, 1, 1, 1]",308,115,193,11,16,0.09565217391304348,0.08290155440414508
"[0, 1, 1, 1, 0, 0, 1, 1, 1, 1, 1, 0, 1, 1, 1]",641,203,438,20,52,0.09852216748768473,0.1187214611872146
"[0, 1, 1, 0, 0, 1, 1, 1, 1, 0, 0, 1, 0, 0, 1]",214,146,68,13,3,0.08904109589041095,0.04411764705882353
"[1, 0, 0, 0, 1, 1, 1, 1, 0, 1, 1, 1, 1, 1, 1]",753,228,525,22,54,0.09649122807017543,0.10285714285714286
"[1, 1, 1, 1, 1, 1, 0, 0, 0, 1, 1, 0, 1, 1, 1]",931,254,677,33,68,0.12992125984251968,0.10044313146233383
"[0, 1, 1, 1, 1, 1, 1, 1, 0, 1, 0, 0, 0, 0, 1]",226,110,116,6,5,0.05454545454545454,0.04310344827586207
"[1, 0, 0, 1, 1, 1, 1, 1, 1, 1, 1, 0, 1, 0, 0]",387,101,286,6,24,0.0594059405940594,0.08391608391608392
"[1, 0, 0, 0, 0, 1, 1, 1, 1, 1, 1, 0, 0, 1, 1]",2121,366,1755,31,165,0.08469945355191257,0.09401709401709402
"[1, 1, 1, 0, 0, 0, 0, 1, 0, 1, 0, 0, 0, 1, 1]",183,77,106,8,11,0.1038961038961039,0.10377358490566038
"[1, 0, 1, 1, 1, 0, 0, 1, 1, 0, 1, 0, 1, 1, 1]",261,96,165,8,10,0.08333333333333333,0.06060606060606061
"[1, 0, 1, 1, 0, 1, 1, 0, 0, 0, 0, 1, 0, 1, 1]",122,65,57,9,4,0.13846153846153847,0.07017543859649122
"[1, 1, 0, 1, 1, 0, 1, 0, 1, 1, 1, 1, 0, 1, 0]",222,72,150,4,12,0.05555555555555555,0.08
"[1, 1, 1, 0, 0, 0, 1, 1, 1, 0, 1, 1, 0, 0, 0]",140,63,77,5,7,0.07936507936507936,0.09090909090909091
"[0, 0, 0, 1, 0, 1, 1, 0, 1, 1, 1, 1, 0, 0, 0]",176,86,90,14,7,0.16279069767441862,0.07777777777777778
"[0, 0, 0, 1, 0, 1, 0, 0, 0, 1, 1, 1, 1, 1, 1]",239,126,113,12,11,0.09523809523809523,0.09734513274336283
"[0, 0, 1, 1, 1, 0, 0, 1, 0, 0, 0, 1, 1, 0, 0]",193,131,62,15,6,0.11450381679389313,0.0967741935483871
"[0, 1, 0, 1, 0, 0, 0, 0, 0, 1, 1, 1, 1, 1, 1]",318,161,157,15,7,0.09316770186335403,0.044585987261146494
"[0, 0, 1, 0, 1, 0, 0, 0, 0, 0, 1, 1, 1, 1, 1]",259,140,119,9,16,0.06428571428571428,0.13445378151260504
"[0, 1, 1, 0, 1, 0, 1, 0, 1, 1, 1, 0, 0, 1, 1]",172,69,103,11,9,0.15942028985507245,0.08737864077669903
"[1, 0, 0, 0, 0, 1, 0, 0, 0, 0, 0, 1, 1, 1, 1]",416,211,205,23,21,0.10900473933649289,0.1024390243902439
"[0, 1, 1, 1, 1, 0, 0, 1, 0, 1, 1, 1, 1, 1, 0]",262,111,151,12,17,0.10810810810810811,0.11258278145695365
"[0, 1, 0, 0, 1, 0, 1, 0, 1, 0, 1, 1, 1, 1, 0]",125,58,67,4,2,0.06896551724137931,0.029850746268656716
"[0, 1, 0, 0, 0, 0, 0, 0, 1, 1, 0, 0, 1, 0, 0]",577,415,162,37,15,0.0891566265060241,0.09259259259259259
"[0, 0, 1, 0, 1, 0, 0, 0, 0, 1, 0, 1, 1, 0, 0]",262,171,91,18,12,0.10526315789473684,0.13186813186813187
"[1, 0, 1, 0, 0, 0, 0, 1, 0, 0, 1, 0, 1, 0, 0]",243,157,86,17,11,0.10828025477707007,0.12790697674418605
"[1, 0, 1, 1, 1, 0, 0, 1, 1, 0, 1, 0, 1, 0, 1]",144,49,95,4,11,0.08163265306122448,0.11578947368421053
"[1, 0, 1, 0, 1, 1, 1, 0, 0, 1, 1, 0, 1, 0, 1]",163,59,104,6,12,0.1016949152542373,0.11538461538461539
"[0, 1, 0, 1, 0, 1, 1, 0, 1, 0, 0, 0, 1, 0, 1]",99,49,50,7,5,0.14285714285714285,0.1
"[0, 0, 1, 1, 1, 1, 1, 0, 1, 0, 1, 0, 0, 1, 1]",185,86,99,5,6,0.05813953488372093,0.06060606060606061
"[0, 1, 1, 1, 0, 1, 1, 1, 1, 1, 0, 0, 1, 0, 1]",239,92,147,5,12,0.05434782608695652,0.08163265306122448
"[1, 1, 0, 0, 1, 0, 0, 1, 0, 1, 0, 1, 1, 1, 0]",128,49,79,4,5,0.08163265306122448,0.06329113924050633
"[1, 1, 0, 1, 0, 0, 1, 0, 0, 0, 1, 0, 0, 0, 0]",274,184,90,18,14,0.09782608695652174,0.15555555555555556
"[0, 0, 0, 1, 0, 0, 0, 0, 0, 1, 0, 0, 0, 1, 1]",740,555,185,59,21,0.1063063063063063,0.11351351351351352
"[1, 1, 0, 1, 1, 1, 0, 1, 0, 0, 0, 0, 0, 0, 0]",238,121,117,9,6,0.0743801652892562,0.05128205128205128
"[1, 1, 1, 1, 0, 0, 0, 1, 0, 1, 0, 1, 0, 0, 1]",134,57,77,5,3,0.08771929824561403,0.03896103896103896
"[0, 0, 1, 1, 1, 1, 0, 1, 1, 1, 1, 0, 1, 0, 1]",253,79,174,13,14,0.16455696202531644,0.08045977011494253
"[0, 0, 0, 1, 1, 1, 1, 0, 1, 1, 1, 1, 0, 1, 0]",154,82,72,10,8,0.12195121951219512,0.1111111111111111
"[0, 1, 0, 0, 0, 0, 1, 1, 1, 1, 0, 1, 1, 1, 1]",217,96,121,8,15,0.08333333333333333,0.12396694214876033
"[0, 0, 1, 0, 0, 1, 0, 1, 1, 0, 1, 0, 0, 1, 0]",122,71,51,7,1,0.09859154929577464,0.0196078431372549
"[0, 0, 0, 0, 0, 1, 0, 0, 0, 1, 1, 0, 1, 0, 1]",251,175,76,16,8,0.09142857142857143,0.10526315789473684
"[1, 0, 0, 1, 0, 0, 1, 1, 0, 1, 1, 0, 0, 0, 0]",207,120,87,14,9,0.11666666666666667,0.10344827586206896
"[0, 0, 1, 0, 0, 1, 0, 0, 1, 1, 0, 1, 1, 0, 0]",168,104,64,8,4,0.07692307692307693,0.0625
"[1, 1, 0, 0, 0, 1, 1, 0, 1, 1, 0, 0, 0, 1, 0]",112,64,48,2,7,0.03125,0.14583333333333334
"[0, 0, 1, 1, 0, 1, 1, 1, 0, 0, 1, 1, 1, 0, 1]",162,79,83,5,9,0.06329113924050633,0.10843373493975904
"[0, 1, 0, 1, 1, 1, 1, 1, 0, 0, 1, 1, 0, 1, 0]",123,49,74,5,6,0.10204081632653061,0.08108108108108109
"[1, 0, 0, 0, 0, 1, 0, 1, 1, 1, 1, 1, 0, 0, 1]",152,71,81,5,9,0.07042253521126761,0.1111111111111111
"[0, 0, 1, 1, 0, 0, 1, 1, 0, 0, 0, 1, 1, 0, 0]",338,182,156,23,14,0.12637362637362637,0.08974358974358974
"[0, 0, 0, 1, 1, 0, 0, 1, 0, 1, 0, 1, 0, 0, 0]",280,184,96,21,10,0.11413043478260869,0.10416666666666667
"[1, 0, 0, 0, 0, 0, 0, 1, 0, 0, 0, 1, 1, 0, 1]",284,166,118,15,9,0.09036144578313253,0.07627118644067797
"[0, 0, 1, 0, 0, 1, 0, 0, 0, 0, 0, 1, 1, 1, 1]",375,238,137,17,18,0.07142857142857142,0.13138686131386862
"[1, 1, 0, 0, 1, 0, 1, 0, 1, 1, 0, 1, 0, 0, 0]",121,70,51,9,1,0.12857142857142856,0.0196078431372549
"[0, 0, 1, 1, 1, 1, 0, 1, 1, 0, 1, 0, 1, 1, 1]",356,138,218,9,19,0.06521739130434782,0.0871559633027523
"[0, 0, 1, 1, 1, 0, 1, 1, 1, 0, 1, 1, 1, 1, 0]",253,105,148,18,11,0.17142857142857143,0.07432432432432433
"[0, 1, 1, 0, 1, 0, 1, 1, 1, 1, 1, 1, 0, 1, 0]",238,95,143,10,16,0.10526315789473684,0.11188811188811189
"[0, 1, 0, 0, 0, 0, 0, 0, 1, 0, 1, 0, 1, 0, 1]",238,146,92,12,5,0.0821917808219178,0.05434782608695652
"[1, 0, 0, 1, 0, 0, 0, 1, 1, 1, 0, 1, 0, 1, 1]",111,62,49,1,8,0.016129032258064516,0.16326530612244897
"[1, 1, 0, 1, 0, 1, 0, 1, 0, 1, 0, 1, 1, 0, 1]",131,53,78,9,7,0.16981132075471697,0.08974358974358974
"[1, 1, 0, 1, 1, 0, 1, 0, 1, 0, 1, 0, 1, 0, 1]",120,46,74,2,5,0.043478260869565216,0.06756756756756757
"[1, 0, 1, 0, 1, 0, 0, 0, 0, 0, 1, 0, 0, 0, 1]",225,153,72,18,4,0.11764705882352941,0.05555555555555555
"[0, 0, 0, 0, 0, 1, 1, 0, 1, 0, 0, 0, 1, 0, 1]",284,190,94,12,8,0.06315789473684211,0.0851063829787234
"[0, 1, 1, 0, 0, 0, 1, 0, 0, 1, 1, 0, 0, 0, 0]",391,260,131,17,14,0.06538461538461539,0.10687022900763359
"[0, 0, 1, 1, 0, 0, 0, 1, 0, 0, 1, 1, 0, 0, 0]",353,234,119,22,7,0.09401709401709402,0.058823529411764705
"[0, 0, 0, 1, 1, 0, 0, 0, 1, 0, 0, 1, 1, 0, 0]",337,229,108,20,11,0.08733624454148471,0.10185185185185185
"[1, 1, 1, 0, 1, 0, 0, 1, 1, 1, 0, 0, 0, 0, 1]",137,49,88,4,7,0.08163265306122448,0.07954545454545454
"[0, 0, 1, 1, 0, 0, 0, 0, 1, 1, 1, 0, 1, 0, 1]",240,122,118,11,13,0.09016393442622951,0.11016949152542373
"[1, 0, 1, 0, 1, 0, 1, 0, 0, 1, 0, 0, 0, 1, 1]",122,63,59,8,3,0.12698412698412698,0.05084745762711865
"[0, 0, 0, 1, 1, 1, 1, 0, 1, 0, 1, 1, 1, 1, 1]",394,202,192,18,19,0.0891089108910891,0.09895833333333333
"[1, 1, 0, 0, 1, 0, 1, 1, 0, 0, 1, 0, 0, 1, 0]",93,49,44,4,1,0.08163265306122448,0.022727272727272728
"[1, 1, 1, 1, 0, 0, 1, 0, 1, 1, 0, 0, 1, 0, 0]",131,61,70,8,10,0.13114754098360656,0.14285714285714285
"[1, 0, 0, 1, 1, 0, 1, 0, 0, 1, 1, 1, 1, 1, 1]",448,136,312,15,26,0.11029411764705882,0.08333333333333333
"[0, 0, 0, 0, 0, 1, 0, 0, 0, 1, 0, 1, 0, 1, 0]",510,366,144,38,14,0.10382513661202186,0.09722222222222222
"[0, 0, 0, 1, 0, 1, 0, 1, 0, 0, 0, 1, 0, 0, 0]",537,378,159,39,13,0.10317460317460317,0.08176100628930817
"[0, 0, 0, 0, 1, 0, 1, 0, 1, 0, 0, 0, 1, 0, 0]",524,380,144,41,15,0.10789473684210527,0.10416666666666667
"[0, 1, 0, 1, 1, 0, 1, 1, 0, 1, 0, 1, 1, 0, 1]",135,49,86,3,9,0.061224489795918366,0.10465116279069768
"[1, 0, 0, 0, 1, 1, 1, 0, 0, 1, 0, 0, 1, 1, 0]",126,73,53,7,2,0.0958904109589041,0.03773584905660377
"[0, 1, 0, 1, 0, 1, 1, 0, 0, 1, 1, 1, 1, 1, 1]",515,210,305,27,24,0.12857142857142856,0.07868852459016394
"[0, 0, 1, 1, 1, 0, 0, 1, 0, 1, 0, 1, 1, 0, 1]",99,53,46,5,6,0.09433962264150944,0.13043478260869565
"[0, 0, 1, 0, 0, 1, 0, 1, 1, 1, 1, 0, 0, 1, 1]",186,90,96,7,14,0.07777777777777778,0.14583333333333334
"[0, 0, 1, 1, 1, 1, 0, 0, 0, 1, 0, 1, 1, 0, 0]",166,92,74,9,5,0.09782608695652174,0.06756756756756757
"[1, 1, 0, 0, 1, 1, 1, 1, 0, 0, 0, 1, 0, 1, 1]",355,158,197,19,19,0.12025316455696203,0.09644670050761421
"[0, 0, 0, 0, 1, 0, 0, 1, 0, 0, 1, 0, 1, 1, 0]",259,166,93,18,9,0.10843373493975904,0.0967741935483871
"[1, 0, 1, 0, 0, 1, 0, 0, 0, 0, 0, 0, 1, 0, 0]",496,348,148,32,18,0.09195402298850575,0.12162162162162163
"[0, 0, 0, 1, 0, 0, 1, 0, 1, 0, 1, 0, 1, 1, 1]",141,92,49,3,4,0.03260869565217391,0.08163265306122448
"[0, 0, 0, 1, 1, 0, 1, 1, 1, 0, 1, 0, 0, 0, 0]",169,103,66,10,5,0.0970873786407767,0.07575757575757576
"[1, 1, 1, 1, 1, 0, 1, 0, 1, 0, 0, 0, 0, 0, 0]",203,86,117,9,12,0.10465116279069768,0.10256410256410256
"[1, 0, 1, 1, 1, 1, 0, 1, 0, 0, 1, 1, 1, 1, 0]",292,110,182,10,18,0.09090909090909091,0.0989010989010989
"[0, 1, 1, 1, 1, 0, 1, 0, 1, 1, 1, 0, 1, 1, 1]",574,197,377,18,47,0.09137055837563451,0.1246684350132626
"[1, 0, 0, 1, 0, 1, 1, 0, 1, 0, 1, 0, 0, 1, 1]",113,61,52,2,5,0.03278688524590164,0.09615384615384616
"[1, 1, 0, 1, 0, 1, 1, 0, 0, 1, 0, 1, 0, 1, 0]",106,57,49,9,5,0.15789473684210525,0.10204081632653061
"[1, 1, 0, 1, 0, 0, 1, 1, 0, 0, 0, 0, 1, 0, 1]",147,76,71,9,8,0.11842105263157894,0.11267605633802817
"[0, 0, 0, 1, 0, 1, 1, 1, 0, 1, 0, 0, 1, 1, 0]",132,78,54,6,5,0.07692307692307693,0.09259259259259259
"[1, 0, 0, 0, 0, 0, 1, 0, 1, 1, 1, 0, 1, 0, 0]",139,84,55,6,5,0.07142857142857142,0.09090909090909091
"[1, 0, 1, 0, 0, 1, 1, 0, 1, 0, 0, 0, 0, 1, 0]",130,84,46,9,5,0.10714285714285714,0.10869565217391304
"[0, 0, 0, 1, 1, 1, 1, 1, 0, 1, 0, 1, 1, 1, 1]",402,207,195,22,21,0.10628019323671498,0.1076923076923077
"[1, 1, 0, 0, 1, 1, 1, 1, 1, 0, 1, 1, 1, 0, 0]",342,99,243,11,23,0.1111111111111111,0.09465020576131687
"[1, 0, 1, 1, 0, 1, 0, 1, 1, 0, 0, 1, 1, 0, 0]",166,76,90,8,6,0.10526315789473684,0.06666666666666667
"[0, 1, 0, 1, 1, 0, 1, 0, 1, 1, 0, 0, 1, 1, 0]",134,60,74,6,6,0.1,0.08108108108108109
"[0, 0, 1, 0, 1, 0, 0, 0, 1, 0, 0, 0, 1, 0, 1]",199,135,64,16,3,0.11851851851851852,0.046875
"[1, 1, 1, 1, 0, 0, 0, 1, 0, 0, 0, 1, 0, 0, 0]",176,103,73,10,8,0.0970873786407767,0.1095890410958904
"[0, 0, 1, 1, 0, 0, 1, 0, 0, 1, 0, 1, 0, 0, 1]",155,90,65,6,8,0.06666666666666667,0.12307692307692308
"[0, 0, 1, 1, 0, 0, 0, 1, 1, 0, 0, 1, 0, 0, 1]",190,116,74,6,3,0.05172413793103448,0.04054054054054054
"[0, 1, 1, 1, 0, 0, 1, 0, 1, 0, 0, 0, 0, 1, 0]",128,73,55,7,10,0.0958904109589041,0.18181818181818182
"[1, 0, 1, 1, 1, 0, 1, 1, 0, 0, 1, 1, 1, 0, 1]",228,80,148,8,18,0.1,0.12162162162162163
"[0, 0, 0, 1, 0, 0, 0, 1, 0, 0, 0, 0, 1, 0, 1]",533,374,159,33,14,0.08823529411764706,0.0880503144654088
"[1, 1, 1, 1, 0, 0, 0, 1, 1, 1, 0, 1, 0, 0, 1]",175,74,101,7,9,0.0945945945945946,0.0891089108910891
"[1, 0, 1, 0, 1, 1, 1, 0, 1, 1, 0, 1, 0, 1, 0]",119,44,75,0,3,0.0,0.04
"[1, 1, 1, 1, 0, 0, 0, 0, 0, 1, 1, 1, 0, 0, 1]",181,91,90,12,12,0.13186813186813187,0.13333333333333333
"[0, 1, 1, 1, 0, 0, 0, 0, 1, 1, 0, 1, 0, 1, 0]",136,78,58,9,4,0.11538461538461539,0.06896551724137931
"[1, 0, 1, 0, 1, 0, 1, 0, 0, 1, 1, 1, 0, 0, 0]",113,68,45,10,5,0.14705882352941177,0.1111111111111111
"[0, 0, 1, 1, 1, 1, 1, 1, 0, 1, 1, 0, 0, 1, 1]",479,175,304,16,24,0.09142857142857143,0.07894736842105263
"[0, 1, 1, 0, 0, 0, 0, 0, 0, 1, 1, 1, 0, 1, 0]",245,171,74,14,5,0.08187134502923976,0.06756756756756757
"[0, 1, 1, 1, 0, 0, 1, 0, 1, 1, 0, 1, 1, 1, 1]",297,100,197,8,21,0.08,0.1065989847715736
"[0, 1, 1, 0, 1, 1, 1, 0, 0, 1, 0, 1, 1, 0, 1]",163,58,105,4,13,0.06896551724137931,0.12380952380952381
"[0, 1, 1, 1, 1, 0, 1, 0, 1, 0, 1, 1, 0, 1, 1]",250,88,162,10,17,0.11363636363636363,0.10493827160493827
"[0, 0, 0, 1, 0, 0, 1, 1, 0, 0, 1, 0, 0, 0, 0]",605,418,187,39,22,0.09330143540669857,0.11764705882352941
"[0, 0, 0, 1, 1, 0, 1, 0, 1, 0, 0, 0, 0, 1, 0]",246,168,78,22,4,0.13095238095238096,0.05128205128205128
"[1, 0, 1, 0, 0, 1, 1, 0, 0, 0, 0, 1, 1, 0, 0]",455,261,194,25,19,0.09578544061302682,0.0979381443298969
"[0, 0, 0, 0, 0, 0, 0, 1, 1, 0, 1, 0, 0, 1, 1]",491,377,114,36,10,0.09549071618037135,0.08771929824561403
"[0, 0, 0, 0, 0, 0, 0, 0, 1, 1, 0, 1, 0, 0, 1]",885,641,244,72,19,0.11232449297971919,0.0778688524590164
"[1, 0, 0, 0, 1, 1, 1, 0, 0, 0, 0, 0, 0, 0, 1]",333,195,138,19,13,0.09743589743589744,0.09420289855072464
"[0, 0, 0, 1, 1, 0, 1, 1, 0, 1, 0, 0, 0, 1, 1]",137,84,53,9,4,0.10714285714285714,0.07547169811320754
"[0, 0, 1, 1, 0, 0, 1, 1, 1, 0, 1, 0, 1, 1, 1]",294,129,165,15,19,0.11627906976744186,0.11515151515151516
"[0, 0, 0, 1, 1, 1, 0, 1, 1, 0, 1, 0, 1, 1, 1]",200,98,102,9,11,0.09183673469387756,0.10784313725490197
"[0, 1, 1, 0, 1, 0, 1, 1, 0, 1, 1, 1, 0, 0, 1]",159,65,94,6,7,0.09230769230769231,0.07446808510638298
"[1, 0, 1, 1, 0, 1, 0, 1, 1, 0, 1, 1, 1, 0, 0]",153,55,98,5,13,0.09090909090909091,0.1326530612244898
"[0, 0, 0, 1, 0, 0, 1, 1, 0, 1, 0, 0, 1, 0, 0]",245,171,74,11,7,0.06432748538011696,0.0945945945945946
"[0, 1, 0, 0, 1, 1, 0, 1, 1, 1, 1, 1, 1, 0, 1]",243,77,166,5,20,0.06493506493506493,0.12048192771084337
"[1, 0, 1, 0, 1, 0, 1, 0, 1, 0, 0, 1, 1, 0, 1]",103,49,54,3,5,0.061224489795918366,0.09259259259259259
"[0, 1, 1, 1, 1, 0, 0, 1, 1, 1, 0, 1, 0, 0, 0]",162,109,53,10,3,0.09174311926605505,0.05660377358490566
"[0, 0, 0, 0, 1, 1, 1, 1, 0, 0, 1, 1, 1, 0, 1]",368,168,200,9,30,0.05357142857142857,0.15
"[1, 0, 0, 1, 0, 1, 0, 0, 0, 0, 1, 0, 0, 1, 0]",223,142,81,10,5,0.07042253521126761,0.06172839506172839
"[1, 0, 1, 1, 0, 1, 1, 1, 1, 0, 1, 0, 1, 1, 0]",236,82,154,9,13,0.10975609756097561,0.08441558441558442
"[1, 1, 1, 0, 0, 0, 0, 0, 0, 1, 1, 0, 0, 1, 0]",419,134,285,15,25,0.11194029850746269,0.08771929824561403
"[1, 0, 0, 0, 0, 1, 1, 0, 0, 0, 1, 1, 0, 1, 1]",210,76,134,8,12,0.10526315789473684,0.08955223880597014
"[1, 1, 0, 0, 0, 0, 1, 0, 1, 0, 0, 1, 0, 0, 1]",163,87,76,10,11,0.11494252873563218,0.14473684210526316
"[1, 0, 1, 1, 0, 1, 1, 0, 1, 1, 0, 0, 0, 0, 1]",129,51,78,5,6,0.09803921568627451,0.07692307692307693
"[0, 1, 1, 0, 1, 0, 0, 0, 0, 0, 1, 1, 1, 1, 1]",238,123,115,10,13,0.08130081300813008,0.11304347826086956
"[1, 1, 1, 1, 1, 0, 1, 0, 1, 1, 1, 1, 0, 0, 0]",375,139,236,15,26,0.1079136690647482,0.11016949152542373
"[1, 0, 1, 1, 1, 1, 0, 1, 0, 0, 0, 1, 1, 0, 0]",130,68,62,11,10,0.16176470588235295,0.16129032258064516
"[0, 0, 0, 0, 0, 1, 0, 1, 1, 1, 1, 0, 0, 0, 1]",183,124,59,10,6,0.08064516129032258,0.1016949152542373
"[0, 1, 1, 1, 1, 0, 0, 0, 1, 1, 1, 1, 1, 0, 0]",247,126,121,15,15,0.11904761904761904,0.12396694214876033
"[1, 1, 0, 1, 1, 1, 1, 0, 0, 0, 1, 1, 1, 1, 1]",843,254,589,22,61,0.08661417322834646,0.1035653650254669
"[1, 0, 0, 0, 1, 0, 1, 0, 1, 0, 1, 1, 0, 1, 1]",120,55,65,4,7,0.07272727272727272,0.1076923076923077
"[1, 1, 1, 1, 1, 0, 0, 0, 1, 0, 1, 0, 1, 0, 1]",176,67,109,8,11,0.11940298507462686,0.10091743119266056
"[0, 1, 1, 1, 0, 1, 1, 1, 1, 1, 1, 0, 1, 1, 1]",1626,443,1183,39,120,0.08803611738148984,0.1014370245139476
"[0, 1, 0, 1, 1, 1, 1, 1, 1, 1, 1, 0, 0, 0, 1]",330,126,204,13,24,0.10317460317460317,0.11764705882352941
"[1, 0, 1, 0, 1, 0, 0, 1, 0, 1, 1, 1, 1, 1, 1]",337,125,212,15,15,0.12,0.07075471698113207
"[1, 1, 1, 0, 0, 1, 1, 1, 1, 1, 0, 0, 0, 1, 1]",457,135,322,17,27,0.1259259259259259,0.08385093167701864
"[1, 1, 0, 1, 0, 1, 1, 0, 0, 0, 0, 0, 0, 1, 0]",174,90,84,7,19,0.07777777777777778,0.2261904761904762
"[0, 0, 0, 1, 0, 1, 0, 1, 1, 0, 1, 0, 1, 1, 0]",102,59,43,5,5,0.0847457627118644,0.11627906976744186
"[1, 0, 1, 0, 1, 1, 0, 1, 1, 0, 0, 0, 0, 0, 1]",131,57,74,5,7,0.08771929824561403,0.0945945945945946
"[1, 0, 0, 0, 0, 1, 0, 1, 0, 1, 1, 0, 1, 1, 0]",115,54,61,7,6,0.12962962962962962,0.09836065573770492
"[1, 0, 1, 0, 0, 0, 1, 0, 1, 1, 0, 0, 1, 0, 0]",142,89,53,6,7,0.06741573033707865,0.1320754716981132
"[1, 0, 0, 1, 0, 1, 1, 0, 0, 1, 0, 1, 1, 1, 0]",114,56,58,7,5,0.125,0.08620689655172414
"[0, 0, 1, 0, 0, 0, 1, 1, 0, 1, 0, 1, 0, 1, 0]",126,69,57,5,5,0.07246376811594203,0.08771929824561403
"[0, 1, 1, 1, 0, 1, 0, 1, 1, 0, 0, 0, 0, 0, 1]",138,81,57,5,7,0.06172839506172839,0.12280701754385964
"[0, 1, 1, 0, 1, 0, 0, 0, 0, 1, 0, 0, 1, 1, 0]",161,100,61,7,6,0.07,0.09836065573770492
"[0, 0, 0, 0, 0, 1, 1, 0, 1, 0, 0, 0, 0, 1, 0]",529,381,148,35,10,0.09186351706036745,0.06756756756756757
"[1, 0, 0, 0, 1, 0, 0, 0, 1, 0, 0, 0, 1, 0, 1]",244,144,100,11,11,0.0763888888888889,0.11
"[1, 0, 1, 0, 0, 0, 0, 1, 0, 0, 0, 1, 0, 0, 0]",548,387,161,34,15,0.08785529715762273,0.09316770186335403
"[1, 0, 0, 1, 1, 0, 1, 0, 0, 0, 0, 1, 0, 0, 0]",248,145,103,6,8,0.041379310344827586,0.07766990291262135
"[1, 1, 0, 0, 1, 0, 0, 0, 0, 1, 0, 0, 1, 1, 0]",173,94,79,11,10,0.11702127659574468,0.12658227848101267
"[1, 0, 1, 0, 0, 0, 0, 1, 0, 0, 0, 1, 1, 0, 1]",132,82,50,5,4,0.06097560975609756,0.08
"[1, 0, 1, 0, 0, 0, 0, 0, 1, 0, 0, 1, 1, 0, 1]",122,62,60,6,9,0.0967741935483871,0.15
"[1, 0, 0, 0, 1, 1, 0, 1, 1, 1, 1, 0, 1, 1, 0]",161,57,104,6,9,0.10526315789473684,0.08653846153846154
"[0, 1, 0, 0, 1, 1, 1, 0, 1, 0, 1, 0, 1, 1, 1]",143,58,85,8,10,0.13793103448275862,0.11764705882352941
"[1, 0, 1, 1, 0, 1, 1, 0, 0, 0, 0, 1, 0, 0, 1]",122,68,54,7,5,0.10294117647058823,0.09259259259259259
"[1, 1, 0, 0, 0, 1, 1, 1, 0, 1, 0, 0, 1, 1, 0]",109,52,57,4,5,0.07692307692307693,0.08771929824561403
"[1, 0, 1, 1, 1, 0, 1, 1, 1, 1, 1, 1, 0, 1, 1]",1503,381,1122,46,102,0.12073490813648294,0.09090909090909091
"[0, 0, 0, 0, 0, 1, 1, 1, 1, 0, 0, 1, 0, 1, 1]",326,246,80,19,11,0.07723577235772358,0.1375
"[1, 0, 1, 1, 1, 0, 0, 0, 1, 0, 1, 0, 0, 1, 0]",104,55,49,5,6,0.09090909090909091,0.12244897959183673
"[1, 0, 0, 1, 0, 1, 1, 0, 0, 0, 1, 1, 1, 1, 0]",150,74,76,11,8,0.14864864864864866,0.10526315789473684
"[1, 0, 1, 1, 0, 0, 1, 0, 0, 1, 0, 0, 1, 1, 0]",125,64,61,5,4,0.078125,0.06557377049180328
"[1, 1, 1, 1, 0, 0, 1, 0, 1, 0, 1, 1, 1, 0, 1]",253,87,166,12,16,0.13793103448275862,0.0963855421686747
"[0, 0, 0, 1, 0, 1, 0, 1, 1, 0, 0, 0, 1, 1, 1]",171,101,70,8,6,0.07920792079207921,0.08571428571428572
"[0, 1, 0, 1, 1, 0, 1, 1, 1, 0, 0, 0, 0, 1, 0]",111,59,52,7,7,0.11864406779661017,0.1346153846153846
"[0, 0, 1, 1, 0, 1, 0, 1, 0, 1, 1, 0, 0, 1, 1]",174,84,90,6,12,0.07142857142857142,0.13333333333333333
"[1, 0, 0, 1, 0, 0, 0, 0, 0, 1, 0, 1, 0, 1, 0]",225,142,83,18,5,0.1267605633802817,0.060240963855421686
"[0, 0, 0, 1, 1, 0, 1, 1, 0, 0, 1, 0, 0, 0, 0]",305,217,88,17,9,0.07834101382488479,0.10227272727272728
"[1, 0, 0, 0, 0, 0, 0, 0, 0, 1, 0, 1, 0, 1, 0]",554,328,226,37,24,0.11280487804878049,0.10619469026548672
"[0, 0, 1, 0, 1, 1, 0, 1, 1, 1, 1, 0, 0, 1, 1]",227,99,128,4,12,0.04040404040404041,0.09375
"[0, 1, 1, 1, 1, 1, 0, 1, 1, 1, 0, 0, 1, 0, 0]",179,69,110,9,11,0.13043478260869565,0.1
"[1, 1, 0, 0, 0, 1, 0, 0, 0, 1, 1, 0, 1, 1, 0]",112,48,64,5,6,0.10416666666666667,0.09375
"[1, 1, 0, 0, 0, 0, 0, 0, 0, 1, 1, 0, 1, 0, 1]",208,124,84,11,3,0.08870967741935484,0.03571428571428571
"[0, 1, 1, 1, 0, 0, 0, 0, 0, 0, 0, 1, 1, 0, 1]",173,107,66,9,8,0.08411214953271028,0.12121212121212122
"[0, 0, 0, 0, 1, 0, 1, 1, 0, 0, 1, 1, 1, 0, 0]",184,100,84,11,4,0.11,0.047619047619047616
"[0, 0, 0, 1, 0, 1, 1, 1, 0, 0, 1, 1, 1, 1, 0]",210,106,104,9,8,0.08490566037735849,0.07692307692307693
"[0, 0, 1, 1, 0, 0, 0, 0, 1, 0, 1, 1, 0, 1, 0]",152,96,56,5,6,0.052083333333333336,0.10714285714285714
"[0, 0, 1, 0, 1, 1, 1, 1, 1, 0, 0, 1, 1, 1, 1]",520,228,292,16,34,0.07017543859649122,0.11643835616438356
"[1, 1, 1, 0, 0, 0, 1, 0, 1, 1, 1, 1, 1, 0, 0]",225,83,142,8,14,0.0963855421686747,0.09859154929577464
"[1, 0, 0, 0, 0, 1, 0, 1, 1, 1, 0, 1, 0, 0, 1]",117,61,56,7,7,0.11475409836065574,0.125
"[0, 0, 1, 1, 1, 0, 1, 1, 1, 1, 0, 1, 1, 0, 1]",225,75,150,6,23,0.08,0.15333333333333332
"[0, 1, 1, 0, 0, 1, 0, 1, 0, 1, 1, 0, 0, 0, 1]",111,59,52,10,5,0.1694915254237288,0.09615384615384616
"[0, 0, 1, 0, 0, 1, 1, 0, 0, 0, 1, 1, 1, 0, 0]",164,86,78,5,7,0.05813953488372093,0.08974358974358974
"[1, 0, 0, 1, 1, 1, 0, 0, 1, 0, 0, 1, 1, 0, 0]",161,69,92,6,11,0.08695652173913043,0.11956521739130435
"[1, 1, 0, 0, 0, 0, 0, 0, 0, 1, 1, 1, 1, 0, 1]",202,111,91,11,8,0.0990990990990991,0.08791208791208792
"[1, 1, 0, 1, 0, 1, 0, 0, 1, 0, 1, 1, 1, 1, 0]",141,61,80,7,10,0.11475409836065574,0.125
"[1, 1, 0, 0, 1, 0, 1, 0, 1, 0, 1, 1, 1, 0, 0]",142,73,69,5,7,0.0684931506849315,0.10144927536231885
"[0, 0, 1, 1, 1, 0, 0, 0, 1, 1, 0, 1, 1, 1, 1]",229,93,136,8,18,0.08602150537634409,0.1323529411764706
"[1, 1, 0, 0, 1, 1, 0, 1, 1, 0, 1, 1, 0, 1, 0]",139,60,79,8,8,0.13333333333333333,0.10126582278481013
"[1, 1, 0, 0, 0, 0, 1, 1, 0, 1, 1, 1, 0, 1, 1]",233,97,136,12,14,0.12371134020618557,0.10294117647058823
"[1, 0, 0, 1, 1, 1, 1, 0, 1, 1, 1, 1, 0, 0, 1]",408,125,283,13,24,0.104,0.08480565371024736
"[0, 1, 1, 1, 0, 1, 0, 1, 1, 0, 1, 1, 1, 0, 0]",150,58,92,3,10,0.05172413793103448,0.10869565217391304
"[0, 1, 1, 0, 1, 0, 0, 1, 0, 0, 1, 1, 1, 1, 1]",232,125,107,8,12,0.064,0.11214953271028037
"[0, 1, 0, 1, 0, 1, 1, 0, 1, 0, 0, 0, 0, 1, 0]",121,73,48,3,2,0.0410958904109589,0.041666666666666664
"[1, 0, 1, 1, 1, 1, 1, 0, 0, 1, 1, 0, 0, 1, 0]",189,77,112,9,8,0.11688311688311688,0.07142857142857142
"[0, 0, 0, 0, 0, 1, 1, 1, 1, 0, 0, 1, 0, 1, 0]",271,193,78,16,3,0.08290155440414508,0.038461538461538464
"[1, 1, 0, 1, 0, 0, 0, 0, 1, 0, 0, 0, 1, 1, 0]",152,84,68,7,4,0.08333333333333333,0.058823529411764705
"[0, 0, 0, 1, 1, 1, 1, 0, 1, 0, 0, 0, 0, 1, 0]",160,100,60,10,7,0.1,0.11666666666666667
"[1, 1, 0, 0, 0, 0, 0, 1, 1, 1, 1, 1, 0, 0, 1]",223,108,115,10,18,0.09259259259259259,0.1565217391304348
"[0, 0, 0, 1, 0, 1, 1, 0, 0, 1, 1, 0, 1, 1, 1]",169,85,84,13,11,0.15294117647058825,0.13095238095238096
"[0, 0, 0, 0, 1, 0, 0, 1, 0, 1, 0, 0, 1, 1, 1]",240,152,88,8,8,0.05263157894736842,0.09090909090909091
"[1, 1, 0, 0, 1, 1, 1, 0, 0, 1, 0, 0, 0, 1, 1]",160,79,81,8,6,0.10126582278481013,0.07407407407407407
"[1, 1, 0, 1, 1, 1, 0, 1, 0, 1, 0, 1, 1, 0, 1]",210,79,131,10,13,0.12658227848101267,0.09923664122137404
"[0, 1, 0, 1, 0, 1, 0, 0, 0, 1, 1, 1, 1, 1, 0]",125,66,59,8,3,0.12121212121212122,0.05084745762711865
"[1, 1, 1, 1, 0, 1, 0, 1, 0, 1, 0, 1, 0, 1, 0]",131,55,76,5,7,0.09090909090909091,0.09210526315789473
"[1, 1, 0, 1, 0, 0, 0, 1, 1, 0, 0, 0, 0, 1, 1]",299,160,139,22,16,0.1375,0.11510791366906475
"[0, 0, 1, 1, 0, 0, 0, 0, 1, 0, 0, 1, 1, 1, 1]",359,202,157,19,17,0.09405940594059406,0.10828025477707007
"[0, 1, 1, 1, 1, 0, 0, 1, 1, 0, 0, 0, 0, 1, 0]",404,310,94,33,12,0.1064516129032258,0.1276595744680851
"[1, 0, 0, 0, 1, 0, 1, 1, 1, 0, 1, 1, 1, 1, 0]",138,52,86,6,7,0.11538461538461539,0.08139534883720931
"[1, 0, 1, 0, 0, 1, 1, 1, 1, 1, 1, 0, 1, 1, 0]",237,88,149,13,15,0.14772727272727273,0.10067114093959731
"[0, 1, 1, 1, 1, 1, 1, 0, 1, 0, 0, 1, 0, 1, 0]",146,73,73,2,7,0.0273972602739726,0.0958904109589041
"[0, 0, 0, 1, 1, 0, 0, 1, 1, 1, 1, 0, 1, 1, 0]",217,137,80,10,13,0.072992700729927,0.1625
"[0, 1, 1, 0, 1, 0, 1, 1, 1, 1, 1, 1, 0, 0, 1]",381,154,227,12,20,0.07792207792207792,0.0881057268722467
"[0, 1, 1, 0, 1, 1, 0, 0, 1, 0, 1, 0, 0, 0, 1]",118,74,44,7,3,0.0945945945945946,0.06818181818181818
"[0, 0, 0, 0, 0, 0, 1, 1, 0, 1, 1, 1, 0, 1, 1]",192,98,94,11,8,0.11224489795918367,0.0851063829787234
"[0, 1, 1, 1, 1, 0, 1, 0, 0, 1, 0, 1, 1, 1, 0]",134,67,67,7,6,0.1044776119402985,0.08955223880597014
"[0, 1, 1, 1, 0, 1, 1, 1, 0, 0, 1, 1, 0, 0, 0]",190,92,98,7,9,0.07608695652173914,0.09183673469387756
"[1, 0, 0, 1, 1, 0, 1, 0, 1, 1, 1, 0, 0, 1, 1]",246,84,162,8,15,0.09523809523809523,0.09259259259259259
"[1, 0, 0, 0, 1, 1, 0, 1, 1, 1, 1, 0, 1, 0, 1]",109,39,70,4,7,0.10256410256410256,0.1
"[1, 1, 1, 0, 0, 0, 0, 1, 1, 1, 0, 0, 0, 1, 1]",227,71,156,5,22,0.07042253521126761,0.14102564102564102
"[1, 1, 1, 0, 0, 0, 0, 0, 1, 0, 1, 1, 1, 1, 1]",294,101,193,10,19,0.09900990099009901,0.09844559585492228
"[0, 0, 0, 1, 0, 0, 1, 0, 0, 1, 0, 1, 1, 0, 1]",142,89,53,8,4,0.0898876404494382,0.07547169811320754
"[0, 1, 0, 0, 1, 1, 1, 0, 1, 0, 0, 0, 0, 1, 0]",143,93,50,19,3,0.20430107526881722,0.06
"[0, 1, 0, 1, 0, 0, 0, 0, 0, 0, 1, 0, 0, 1, 0]",488,330,158,25,16,0.07575757575757576,0.10126582278481013
"[1, 1, 1, 0, 1, 0, 1, 1, 0, 0, 0, 0, 1, 1, 0]",191,82,109,4,9,0.04878048780487805,0.08256880733944955
"[0, 0, 1, 1, 1, 0, 0, 1, 0, 1, 1, 1, 0, 1, 1]",158,68,90,5,11,0.07352941176470588,0.12222222222222222
"[0, 0, 0, 1, 1, 1, 0, 0, 1, 0, 1, 1, 1, 0, 1]",105,49,56,7,5,0.14285714285714285,0.08928571428571429
"[0, 0, 1, 0, 1, 1, 0, 1, 1, 1, 0, 1, 0, 0, 0]",113,59,54,4,6,0.06779661016949153,0.1111111111111111
"[1, 0, 1, 0, 0, 1, 0, 1, 1, 0, 1, 1, 1, 0, 1]",115,38,77,5,12,0.13157894736842105,0.15584415584415584
"[0, 1, 0, 1, 0, 0, 1, 0, 1, 1, 0, 1, 1, 1, 0]",94,52,42,9,7,0.17307692307692307,0.16666666666666666
"[1, 1, 1, 1, 1, 0, 1, 0, 1, 0, 1, 0, 0, 1, 0]",137,61,76,7,10,0.11475409836065574,0.13157894736842105
"[0, 1, 0, 1, 0, 1, 1, 1, 1, 0, 1, 1, 0, 0, 1]",152,59,93,6,9,0.1016949152542373,0.0967741935483871
"[0, 1, 1, 0, 0, 0, 0, 1, 0, 0, 0, 0, 0, 1, 0]",567,403,164,32,16,0.0794044665012407,0.0975609756097561
"[1, 0, 1, 0, 1, 0, 0, 1, 0, 0, 0, 0, 1, 0, 0]",215,126,89,8,11,0.06349206349206349,0.12359550561797752
"[0, 0, 1, 1, 0, 0, 1, 0, 0, 0, 1, 1, 0, 1, 1]",135,68,67,6,6,0.08823529411764706,0.08955223880597014
"[0, 1, 1, 0, 0, 1, 1, 0, 0, 1, 0, 0, 0, 1, 1]",227,148,79,13,5,0.08783783783783784,0.06329113924050633
"[1, 1, 1, 1, 1, 0, 1, 1, 1, 0, 1, 0, 0, 1, 1]",621,165,456,20,28,0.12121212121212122,0.06140350877192982
"[0, 0, 0, 1, 0, 1, 0, 0, 1, 0, 1, 1, 1, 1, 1]",169,75,94,16,11,0.21333333333333335,0.11702127659574468
"[0, 1, 0, 0, 0, 1, 0, 1, 0, 0, 1, 0, 1, 1, 1]",172,96,76,10,5,0.10416666666666667,0.06578947368421052
"[0, 1, 1, 0, 1, 1, 1, 1, 0, 1, 0, 0, 0, 1, 1]",163,68,95,1,14,0.014705882352941176,0.14736842105263157
"[1, 1, 1, 0, 0, 1, 1, 0, 1, 0, 0, 0, 0, 0, 0]",260,119,141,6,15,0.05042016806722689,0.10638297872340426
"[1, 1, 1, 1, 1, 0, 0, 1, 1, 0, 1, 0, 0, 0, 0]",219,90,129,5,18,0.05555555555555555,0.13953488372093023
"[0, 0, 1, 1, 0, 1, 1, 1, 1, 0, 0, 0, 0, 0, 0]",365,219,146,20,16,0.091324200913242,0.1095890410958904
"[0, 1, 1, 0, 0, 0, 0, 1, 0, 0, 0, 0, 1, 0, 1]",261,179,82,19,7,0.10614525139664804,0.08536585365853659
"[0, 1, 0, 0, 1, 0, 0, 0, 1, 1, 0, 0, 1, 1, 0]",267,171,96,19,12,0.1111111111111111,0.125
"[0, 0, 1, 0, 0, 1, 1, 0, 0, 1, 0, 0, 0, 1, 0]",216,138,78,13,7,0.09420289855072464,0.08974358974358974
"[0, 0, 1, 1, 0, 1, 0, 0, 0, 1, 1, 1, 0, 0, 0]",167,96,71,11,11,0.11458333333333333,0.15492957746478872
"[1, 0, 1, 0, 0, 0, 0, 1, 0, 0, 1, 0, 0, 1, 1]",163,86,77,9,7,0.10465116279069768,0.09090909090909091
"[1, 1, 1, 0, 1, 0, 0, 0, 0, 0, 1, 1, 0, 1, 1]",122,58,64,7,9,0.1206896551724138,0.140625
"[0, 0, 0, 0, 1, 1, 1, 1, 1, 0, 1, 0, 0, 0, 0]",223,134,89,10,5,0.07462686567164178,0.056179775280898875
"[1, 1, 1, 0, 1, 0, 0, 1, 1, 0, 1, 0, 0, 1, 1]",159,59,100,11,10,0.1864406779661017,0.1
"[0, 1, 0, 1, 1, 1, 1, 1, 0, 0, 0, 0, 0, 0, 0]",391,223,168,19,18,0.08520179372197309,0.10714285714285714
"[1, 1, 0, 1, 0, 0, 0, 0, 0, 1, 1, 0, 0, 0, 1]",166,94,72,8,6,0.0851063829787234,0.08333333333333333
"[0, 1, 1, 1, 0, 1, 0, 0, 0, 0, 0, 1, 1, 0, 0]",242,155,87,19,12,0.12258064516129032,0.13793103448275862
"[0, 0, 1, 0, 1, 0, 0, 1, 0, 0, 1, 1, 1, 1, 1]",186,91,95,10,6,0.10989010989010989,0.06315789473684211
"[1, 1, 0, 1, 1, 1, 0, 1, 0, 0, 0, 1, 0, 0, 0]",103,52,51,6,5,0.11538461538461539,0.09803921568627451
"[1, 1, 1, 0, 0, 1, 1, 0, 1, 0, 0, 1, 0, 1, 1]",191,69,122,5,12,0.07246376811594203,0.09836065573770492
"[0, 1, 1, 0, 0, 1, 1, 1, 1, 1, 0, 1, 1, 1, 0]",281,126,155,13,13,0.10317460317460317,0.08387096774193549
"[1, 0, 0, 0, 0, 1, 1, 1, 0, 0, 1, 1, 1, 0, 1]",147,60,87,5,8,0.08333333333333333,0.09195402298850575
"[0, 0, 1, 0, 0, 1, 0, 1, 1, 1, 0, 1, 0, 1, 0]",107,70,37,5,3,0.07142857142857142,0.08108108108108109
"[1, 0, 1, 0, 1, 1, 1, 0, 0, 1, 1, 1, 1, 0, 0]",331,126,205,10,21,0.07936507936507936,0.1024390243902439
"[0, 1, 0, 1, 0, 1, 1, 1, 0, 0, 1, 1, 1, 1, 0]",212,96,116,8,6,0.08333333333333333,0.05172413793103448
"[1, 1, 0, 1, 0, 0, 0, 0, 1, 1, 1, 0, 0, 0, 0]",207,107,100,9,8,0.08411214953271028,0.08
"[0, 1, 0, 0, 0, 1, 0, 1, 0, 1, 1, 0, 1, 0, 1]",96,49,47,2,8,0.04081632653061224,0.1702127659574468
"[1, 0, 1, 0, 1, 0, 1, 0, 1, 1, 1, 0, 0, 0, 0]",157,63,94,8,4,0.12698412698412698,0.0425531914893617
"[1, 0, 1, 0, 0, 0, 1, 1, 1, 0, 1, 1, 1, 1, 1]",292,104,188,9,22,0.08653846153846154,0.11702127659574468
"[0, 0, 1, 0, 1, 0, 0, 1, 0, 0, 1, 1, 1, 1, 0]",135,78,57,4,4,0.05128205128205128,0.07017543859649122
"[0, 0, 0, 1, 0, 1, 0, 0, 0, 0, 1, 0, 1, 1, 0]",243,159,84,24,7,0.1509433962264151,0.08333333333333333
"[1, 1, 1, 1, 1, 0, 1, 1, 0, 0, 0, 0, 1, 0, 1]",159,61,98,5,7,0.08196721311475409,0.07142857142857142
"[0, 0, 0, 1, 1, 0, 1, 1, 1, 1, 1, 1, 1, 1, 0]",376,162,214,9,30,0.05555555555555555,0.14018691588785046
"[0, 0, 1, 0, 1, 0, 0, 0, 0, 1, 1, 1, 0, 1, 1]",139,77,62,7,1,0.09090909090909091,0.016129032258064516
"[0, 0, 0, 1, 1, 1, 1, 1, 0, 0, 1, 0, 1, 0, 0]",145,85,60,10,9,0.11764705882352941,0.15
"[1, 0, 0, 0, 0, 0, 1, 1, 0, 1, 1, 1, 0, 0, 1]",127,61,66,7,7,0.11475409836065574,0.10606060606060606
"[1, 0, 0, 0, 1, 1, 1, 0, 0, 1, 0, 0, 0, 0, 1]",170,97,73,7,7,0.07216494845360824,0.0958904109589041
"[0, 1, 1, 1, 0, 1, 1, 0, 0, 0, 1, 1, 1, 0, 0]",114,52,62,4,4,0.07692307692307693,0.06451612903225806
"[0, 0, 0, 0, 1, 0, 1, 1, 1, 0, 1, 0, 1, 1, 0]",103,60,43,5,5,0.08333333333333333,0.11627906976744186
"[1, 0, 1, 0, 0, 1, 0, 0, 0, 0, 1, 0, 1, 1, 1]",143,77,66,6,6,0.07792207792207792,0.09090909090909091
"[1, 1, 0, 0, 1, 1, 1, 1, 0, 0, 1, 0, 1, 0, 1]",265,111,154,8,22,0.07207207207207207,0.14285714285714285
"[1, 0, 1, 0, 0, 1, 0, 1, 0, 1, 0, 0, 1, 0, 1]",108,64,44,4,7,0.0625,0.1590909090909091
"[0, 0, 0, 0, 0, 1, 0, 1, 0, 0, 1, 0, 1, 0, 1]",272,177,95,18,14,0.1016949152542373,0.14736842105263157
"[1, 0, 1, 1, 0, 0, 0, 0, 1, 1, 1, 0, 0, 0, 0]",205,121,84,13,5,0.10743801652892562,0.05952380952380952
"[0, 0, 1, 0, 1, 1, 1, 1, 0, 1, 1, 0, 0, 0, 0]",136,67,69,8,5,0.11940298507462686,0.07246376811594203
"[0, 0, 1, 1, 1, 0, 1, 0, 0, 0, 1, 1, 0, 0, 0]",211,117,94,12,12,0.10256410256410256,0.1276595744680851
"[0, 1, 0, 0, 1, 1, 1, 0, 1, 0, 0, 0, 1, 1, 0]",119,61,58,5,6,0.08196721311475409,0.10344827586206896
"[1, 1, 0, 1, 1, 0, 1, 1, 0, 1, 0, 0, 0, 0, 0]",134,84,50,5,4,0.05952380952380952,0.08
"[1, 0, 0, 1, 0, 1, 0, 1, 0, 0, 1, 0, 1, 1, 0]",123,62,61,4,6,0.06451612903225806,0.09836065573770492
"[1, 0, 0, 1, 0, 1, 0, 0, 0, 0, 0, 0, 1, 1, 1]",360,195,165,24,12,0.12307692307692308,0.07272727272727272
"[0, 1, 0, 1, 0, 0, 1, 0, 0, 1, 1, 1, 0, 0, 1]",135,68,67,2,6,0.029411764705882353,0.08955223880597014
"[1, 1, 0, 0, 0, 0, 0, 1, 1, 0, 0, 0, 0, 0, 1]",398,266,132,23,9,0.08646616541353383,0.06818181818181818
"[0, 1, 0, 1, 1, 1, 1, 0, 1, 1, 1, 1, 0, 1, 1]",496,150,346,13,38,0.08666666666666667,0.10982658959537572
"[0, 1, 1, 1, 1, 0, 0, 1, 0, 0, 0, 1, 0, 1, 1]",156,94,62,10,7,0.10638297872340426,0.11290322580645161
"[0, 0, 0, 0, 1, 0, 0, 1, 0, 1, 1, 0, 0, 1, 1]",209,137,72,16,4,0.11678832116788321,0.05555555555555555
"[0, 1, 0, 0, 0, 0, 1, 1, 1, 1, 0, 1, 1, 0, 1]",113,58,55,6,3,0.10344827586206896,0.05454545454545454
"[1, 1, 0, 0, 0, 0, 1, 1, 0, 1, 0, 0, 1, 0, 0]",192,108,84,11,4,0.10185185185185185,0.047619047619047616
"[1, 0, 1, 0, 1, 1, 0, 0, 0, 0, 1, 0, 0, 0, 0]",277,166,111,22,13,0.13253012048192772,0.11711711711711711
"[1, 0, 0, 1, 0, 1, 1, 0, 1, 1, 1, 0, 1, 1, 1]",257,84,173,10,13,0.11904761904761904,0.07514450867052024
"[1, 0, 1, 1, 1, 1, 1, 0, 0, 0, 0, 0, 1, 0, 0]",152,78,74,7,11,0.08974358974358974,0.14864864864864866
"[1, 1, 1, 1, 1, 0, 0, 0, 1, 1, 1, 1, 0, 1, 0]",293,93,200,10,23,0.10752688172043011,0.115
"[1, 0, 0, 1, 0, 0, 1, 1, 1, 0, 1, 1, 1, 0, 1]",153,57,96,6,6,0.10526315789473684,0.0625
"[0, 1, 1, 1, 1, 0, 0, 0, 1, 0, 0, 1, 0, 0, 1]",142,79,63,10,7,0.12658227848101267,0.1111111111111111
"[1, 1, 0, 1, 1, 0, 0, 1, 1, 1, 1, 0, 1, 0, 0]",176,69,107,6,10,0.08695652173913043,0.09345794392523364
"[1, 1, 1, 0, 0, 1, 1, 0, 0, 0, 1, 0, 1, 1, 0]",138,54,84,6,11,0.1111111111111111,0.13095238095238096
"[1, 0, 0, 0, 1, 0, 1, 0, 1, 1, 1, 1, 1, 0, 0]",130,54,76,1,4,0.018518518518518517,0.05263157894736842
"[1, 1, 1, 1, 1, 1, 0, 0, 1, 1, 0, 1, 1, 1, 0]",780,232,548,18,41,0.07758620689655173,0.07481751824817519
"[0, 1, 0, 0, 0, 1, 1, 0, 1, 0, 1, 1, 0, 0, 1]",114,66,48,5,12,0.07575757575757576,0.25
"[0, 1, 0, 1, 1, 1, 0, 1, 0, 0, 0, 1, 1, 0, 1]",86,45,41,3,4,0.06666666666666667,0.0975609756097561
"[0, 1, 0, 1, 0, 1, 1, 0, 0, 0, 1, 1, 0, 1, 1]",112,57,55,4,5,0.07017543859649122,0.09090909090909091
"[0, 1, 0, 1, 1, 1, 1, 0, 1, 1, 1, 0, 1, 1, 0]",219,76,143,8,15,0.10526315789473684,0.1048951048951049
"[1, 0, 1, 0, 0, 0, 1, 1, 1, 0, 0, 0, 1, 1, 0]",130,69,61,4,2,0.057971014492753624,0.03278688524590164
"[0, 0, 1, 1, 1, 1, 0, 1, 0, 0, 0, 1, 1, 1, 0]",135,66,69,6,8,0.09090909090909091,0.11594202898550725
"[0, 0, 0, 1, 1, 0, 1, 1, 0, 1, 1, 1, 1, 1, 0]",165,71,94,6,2,0.08450704225352113,0.02127659574468085
"[0, 0, 0, 0, 0, 1, 1, 0, 1, 1, 0, 1, 1, 1, 1]",225,134,91,15,10,0.11194029850746269,0.10989010989010989
"[1, 1, 0, 0, 0, 1, 0, 0, 1, 0, 0, 0, 1, 1, 0]",153,87,66,9,6,0.10344827586206896,0.09090909090909091
"[1, 0, 1, 1, 1, 1, 0, 0, 0, 0, 0, 0, 1, 0, 1]",136,76,60,4,6,0.05263157894736842,0.1
"[1, 0, 0, 1, 1, 0, 0, 1, 0, 1, 1, 0, 0, 1, 1]",192,68,124,6,9,0.08823529411764706,0.07258064516129033
"[0, 1, 1, 0, 0, 1, 1, 0, 0, 1, 0, 1, 1, 0, 0]",162,102,60,8,5,0.0784313725490196,0.08333333333333333
"[0, 1, 0, 0, 0, 1, 0, 0, 1, 1, 0, 1, 0, 0, 0]",235,147,88,16,7,0.10884353741496598,0.07954545454545454
"[0, 0, 1, 0, 1, 0, 0, 0, 1, 0, 0, 1, 1, 0, 1]",130,81,49,9,8,0.1111111111111111,0.16326530612244897
"[0, 1, 0, 0, 0, 0, 1, 0, 1, 0, 0, 0, 0, 1, 0]",529,367,162,34,17,0.09264305177111716,0.10493827160493827
"[0, 0, 0, 0, 1, 1, 0, 1, 0, 0, 0, 0, 1, 0, 1]",272,181,91,25,7,0.13812154696132597,0.07692307692307693
"[0, 0, 0, 1, 0, 0, 1, 1, 0, 0, 1, 0, 1, 0, 0]",230,150,80,12,6,0.08,0.075
"[0, 1, 0, 0, 0, 1, 0, 0, 1, 1, 0, 0, 1, 0, 1]",149,91,58,8,7,0.08791208791208792,0.1206896551724138
"[1, 0, 1, 0, 1, 0, 1, 0, 1, 0, 1, 0, 1, 1, 0]",104,58,46,7,4,0.1206896551724138,0.08695652173913043
"[0, 1, 0, 1, 0, 1, 0, 1, 0, 1, 0, 1, 0, 1, 1]",107,60,47,4,2,0.06666666666666667,0.0425531914893617
"[0, 1, 0, 0, 1, 0, 0, 0, 1, 0, 1, 0, 1, 0, 1]",123,72,51,4,3,0.05555555555555555,0.058823529411764705
"[1, 1, 0, 1, 0, 1, 0, 0, 1, 1, 0, 0, 0, 0, 1]",233,131,102,15,13,0.11450381679389313,0.12745098039215685
"[1, 1, 1, 1, 1, 0, 1, 0, 0, 0, 1, 1, 0, 1, 0]",155,64,91,11,5,0.171875,0.054945054945054944
"[0, 1, 1, 1, 1, 1, 0, 0, 0, 1, 1, 0, 0, 1, 0]",123,57,66,6,6,0.10526315789473684,0.09090909090909091
"[0, 0, 0, 1, 1, 1, 0, 0, 0, 1, 0, 1, 0, 0, 0]",267,183,84,10,8,0.0546448087431694,0.09523809523809523
"[1, 1, 1, 0, 1, 0, 0, 1, 1, 1, 0, 0, 0, 1, 1]",153,64,89,10,9,0.15625,0.10112359550561797
"[0, 1, 1, 0, 0, 1, 1, 0, 0, 0, 0, 1, 0, 1, 1]",289,219,70,21,5,0.0958904109589041,0.07142857142857142
"[0, 1, 0, 1, 1, 0, 0, 0, 0, 0, 1, 1, 1, 0, 0]",186,120,66,13,7,0.10833333333333334,0.10606060606060606
"[1, 1, 0, 0, 0, 1, 0, 1, 1, 1, 0, 0, 1, 0, 1]",115,55,60,6,4,0.10909090909090909,0.06666666666666667
"[1, 1, 1, 1, 0, 0, 0, 0, 1, 0, 1, 0, 0, 1, 1]",233,110,123,8,17,0.07272727272727272,0.13821138211382114
"[1, 1, 1, 1, 1, 0, 0, 0, 0, 1, 0, 1, 0, 0, 1]",186,69,117,8,10,0.11594202898550725,0.08547008547008547
"[0, 1, 0, 1, 1, 1, 1, 1, 0, 1, 1, 1, 1, 0, 1]",520,149,371,14,36,0.09395973154362416,0.09703504043126684
"[0, 1, 1, 0, 0, 1, 0, 0, 0, 1, 1, 0, 0, 1, 1]",206,124,82,8,13,0.06451612903225806,0.15853658536585366
"[0, 0, 0, 1, 0, 1, 0, 1, 0, 1, 0, 0, 0, 1, 0]",233,142,91,17,10,0.11971830985915492,0.10989010989010989
"[1, 0, 0, 1, 1, 1, 1, 0, 0, 1, 0, 0, 1, 1, 0]",170,65,105,7,6,0.1076923076923077,0.05714285714285714
"[1, 0, 0, 1, 1, 1, 1, 1, 0, 0, 0, 1, 1, 1, 0]",174,56,118,4,11,0.07142857142857142,0.09322033898305085
"[1, 1, 0, 0, 1, 0, 1, 1, 0, 1, 0, 1, 1, 1, 0]",131,60,71,5,6,0.08333333333333333,0.08450704225352113
"[1, 1, 1, 1, 0, 1, 1, 1, 1, 0, 0, 1, 0, 1, 1]",542,156,386,13,32,0.08333333333333333,0.08290155440414508
"[1, 0, 0, 1, 1, 1, 1, 0, 1, 0, 1, 1, 1, 1, 0]",307,98,209,5,21,0.05102040816326531,0.10047846889952153
"[0, 0, 0, 0, 0, 0, 1, 1, 0, 1, 1, 0, 1, 1, 1]",296,167,129,13,14,0.07784431137724551,0.10852713178294573
"[1, 1, 0, 1, 1, 0, 1, 1, 0, 0, 0, 0, 1, 1, 0]",186,81,105,8,13,0.09876543209876543,0.12380952380952381
"[0, 1, 1, 0, 1, 1, 0, 0, 1, 0, 0, 1, 1, 0, 1]",98,48,50,5,4,0.10416666666666667,0.08
"[1, 0, 1, 1, 0, 0, 1, 0, 1, 1, 0, 1, 0, 1, 0]",95,44,51,3,2,0.06818181818181818,0.0392156862745098
"[0, 0, 1, 0, 1, 0, 1, 1, 1, 1, 0, 1, 0, 1, 1]",140,54,86,6,8,0.1111111111111111,0.09302325581395349
"[1, 1, 1, 0, 0, 1, 1, 0, 1, 1, 0, 0, 1, 0, 1]",180,65,115,8,11,0.12307692307692308,0.09565217391304348
"[1, 0, 0, 0, 0, 0, 0, 0, 1, 1, 1, 1, 0, 1, 1]",217,97,120,7,15,0.07216494845360824,0.125
"[1, 1, 1, 1, 0, 0, 1, 1, 1, 0, 0, 0, 0, 0, 0]",318,162,156,16,10,0.09876543209876543,0.0641025641025641
"[0, 1, 1, 1, 1, 1, 0, 0, 1, 1, 1, 0, 0, 0, 0]",176,72,104,9,11,0.125,0.10576923076923077
"[0, 0, 0, 1, 0, 1, 1, 1, 1, 1, 0, 1, 0, 0, 0]",131,77,54,8,4,0.1038961038961039,0.07407407407407407
"[1, 1, 1, 0, 0, 1, 1, 1, 0, 1, 1, 0, 0, 1, 1]",394,140,254,14,26,0.1,0.10236220472440945
"[0, 0, 0, 1, 1, 1, 0, 1, 1, 0, 1, 1, 1, 0, 0]",153,76,77,7,7,0.09210526315789473,0.09090909090909091
"[0, 0, 0, 0, 1, 1, 0, 0, 0, 1, 1, 1, 0, 0, 1]",204,130,74,12,7,0.09230769230769231,0.0945945945945946
"[0, 0, 0, 0, 0, 1, 0, 1, 0, 0, 0, 1, 0, 1, 1]",315,218,97,23,10,0.10550458715596331,0.10309278350515463
"[1, 0, 0, 1, 1, 0, 1, 0, 1, 1, 1, 1, 1, 0, 1]",235,76,159,8,16,0.10526315789473684,0.10062893081761007
"[1, 0, 0, 1, 1, 0, 1, 0, 0, 1, 0, 1, 1, 0, 1]",115,53,62,6,5,0.11320754716981132,0.08064516129032258
"[0, 1, 0, 1, 1, 1, 0, 1, 1, 1, 0, 0, 1, 1, 0]",183,69,114,8,13,0.11594202898550725,0.11403508771929824
"[1, 0, 0, 0, 0, 1, 0, 1, 0, 1, 0, 1, 1, 1, 1]",191,68,123,7,13,0.10294117647058823,0.10569105691056911
"[0, 1, 0, 1, 1, 0, 0, 0, 0, 1, 0, 1, 0, 0, 1]",150,88,62,12,4,0.13636363636363635,0.06451612903225806
"[0, 0, 1, 0, 0, 1, 0, 0, 1, 0, 1, 1, 0, 0, 0]",281,177,104,14,6,0.07909604519774012,0.057692307692307696
"[0, 1, 0, 1, 0, 1, 1, 1, 0, 1, 0, 0, 0, 1, 1]",104,49,55,9,8,0.1836734693877551,0.14545454545454545
"[0, 1, 1, 0, 0, 0, 0, 1, 0, 0, 1, 0, 1, 0, 0]",264,181,83,13,6,0.0718232044198895,0.07228915662650602
"[1, 1, 0, 0, 0, 1, 0, 1, 1, 0, 1, 0, 0, 1, 0]",106,65,41,3,5,0.046153846153846156,0.12195121951219512
"[0, 0, 1, 0, 1, 0, 1, 0, 1, 1, 0, 0, 0, 0, 0]",316,203,113,23,17,0.11330049261083744,0.1504424778761062
"[0, 1, 1, 0, 1, 1, 0, 0, 1, 1, 0, 0, 1, 0, 1]",120,55,65,3,7,0.05454545454545454,0.1076923076923077
"[0, 1, 0, 0, 1, 1, 1, 1, 1, 1, 1, 0, 1, 1, 0]",275,101,174,10,19,0.09900990099009901,0.10919540229885058
"[0, 1, 1, 0, 0, 1, 1, 1, 0, 0, 0, 0, 1, 0, 0]",168,109,59,8,4,0.07339449541284404,0.06779661016949153
"[0, 1, 1, 0, 0, 1, 1, 0, 0, 1, 1, 1, 0, 0, 0]",248,172,76,12,7,0.06976744186046512,0.09210526315789473
"[1, 1, 0, 1, 0, 0, 1, 0, 0, 1, 0, 1, 1, 0, 0]",130,62,68,4,11,0.06451612903225806,0.16176470588235295
"[0, 1, 1, 1, 0, 1, 0, 0, 1, 0, 0, 1, 0, 1, 1]",113,54,59,4,6,0.07407407407407407,0.1016949152542373
"[0, 1, 0, 1, 0, 0, 0, 1, 1, 0, 1, 1, 1, 0, 1]",115,61,54,4,5,0.06557377049180328,0.09259259259259259
"[1, 0, 1, 1, 1, 0, 0, 0, 0, 1, 0, 1, 0, 1, 1]",123,54,69,4,5,0.07407407407407407,0.07246376811594203
"[1, 1, 0, 1, 0, 1, 1, 1, 1, 1, 1, 0, 1, 0, 1]",472,151,321,16,32,0.10596026490066225,0.09968847352024922
"[0, 1, 0, 1, 1, 0, 1, 1, 0, 0, 0, 0, 0, 1, 1]",164,101,63,4,2,0.039603960396039604,0.031746031746031744
"[1, 1, 1, 0, 0, 0, 1, 0, 1, 1, 0, 1, 1, 0, 0]",142,66,76,7,8,0.10606060606060606,0.10526315789473684
"[1, 1, 1, 1, 1, 1, 1, 1, 0, 1, 1, 0, 0, 0, 0]",558,179,379,20,35,0.11173184357541899,0.09234828496042216
"[0, 1, 1, 1, 0, 0, 1, 1, 0, 1, 1, 1, 0, 0, 0]",152,71,81,6,12,0.08450704225352113,0.14814814814814814
"[1, 1, 0, 0, 1, 1, 0, 0, 0, 1, 0, 1, 0, 0, 1]",162,82,80,12,5,0.14634146341463414,0.0625
"[1, 0, 0, 1, 0, 1, 1, 1, 1, 1, 1, 0, 0, 1, 0]",152,55,97,3,5,0.05454545454545454,0.05154639175257732
"[0, 1, 0, 1, 0, 0, 1, 0, 1, 1, 1, 1, 1, 1, 0]",180,78,102,11,15,0.14102564102564102,0.14705882352941177
"[1, 1, 1, 1, 0, 0, 0, 1, 1, 1, 1, 0, 1, 1, 1]",716,191,525,20,51,0.10471204188481675,0.09714285714285714
"[0, 0, 0, 1, 0, 0, 0, 1, 1, 1, 1, 0, 0, 0, 1]",176,100,76,10,12,0.1,0.15789473684210525
"[1, 0, 0, 0, 0, 1, 0, 0, 0, 1, 1, 1, 1, 0, 0]",253,142,111,13,6,0.09154929577464789,0.05405405405405406
"[0, 1, 0, 1, 1, 0, 1, 0, 0, 0, 0, 1, 0, 0, 1]",130,77,53,3,7,0.03896103896103896,0.1320754716981132
"[0, 1, 1, 1, 0, 0, 1, 0, 1, 1, 0, 0, 0, 0, 1]",125,67,58,10,5,0.14925373134328357,0.08620689655172414
"[1, 1, 1, 1, 0, 1, 1, 0, 0, 1, 1, 1, 0, 0, 1]",321,121,200,12,21,0.09917355371900827,0.105
"[0, 1, 1, 1, 1, 0, 1, 1, 0, 0, 1, 1, 1, 0, 0]",189,76,113,4,7,0.05263157894736842,0.061946902654867256
"[1, 1, 1, 0, 1, 0, 1, 1, 0, 0, 0, 1, 1, 1, 1]",357,121,236,10,31,0.08264462809917356,0.13135593220338984
"[0, 1, 0, 0, 1, 1, 1, 0, 1, 0, 1, 1, 0, 0, 0]",131,63,68,5,3,0.07936507936507936,0.04411764705882353
"[0, 0, 1, 1, 0, 0, 0, 1, 1, 1, 0, 0, 0, 1, 0]",179,111,68,7,4,0.06306306306306306,0.058823529411764705
"[0, 0, 1, 0, 1, 1, 1, 0, 0, 0, 0, 0, 1, 1, 1]",222,117,105,10,7,0.08547008547008547,0.06666666666666667
"[1, 1, 0, 1, 1, 0, 1, 0, 0, 0, 0, 1, 1, 1, 0]",123,66,57,8,7,0.12121212121212122,0.12280701754385964
"[1, 1, 0, 1, 0, 0, 1, 1, 0, 1, 1, 1, 1, 0, 0]",194,76,118,5,12,0.06578947368421052,0.1016949152542373
"[1, 1, 1, 0, 0, 1, 0, 0, 1, 1, 1, 1, 1, 1, 1]",1019,276,743,23,75,0.08333333333333333,0.1009421265141319
"[0, 0, 1, 1, 0, 0, 0, 0, 0, 1, 0, 0, 1, 0, 1]",313,190,123,15,11,0.07894736842105263,0.08943089430894309
"[0, 1, 1, 1, 1, 0, 0, 1, 1, 1, 1, 0, 0, 0, 1]",455,324,131,21,15,0.06481481481481481,0.11450381679389313
"[0, 1, 1, 0, 0, 0, 0, 0, 0, 1, 0, 1, 1, 1, 1]",327,233,94,27,7,0.11587982832618025,0.07446808510638298
"[1, 1, 0, 0, 0, 0, 1, 1, 0, 1, 0, 1, 1, 0, 0]",181,88,93,5,9,0.056818181818181816,0.0967741935483871
"[1, 0, 0, 0, 1, 1, 0, 1, 1, 0, 0, 1, 1, 0, 1]",117,51,66,7,5,0.13725490196078433,0.07575757575757576
"[1, 0, 0, 1, 1, 1, 1, 0, 0, 0, 0, 1, 1, 1, 0]",394,96,298,8,36,0.08333333333333333,0.12080536912751678
"[0, 0, 1, 1, 1, 1, 1, 1, 1, 0, 1, 0, 1, 0, 1]",311,116,195,15,18,0.12931034482758622,0.09230769230769231
"[0, 1, 1, 0, 1, 0, 1, 0, 0, 1, 0, 1, 0, 0, 0]",130,83,47,7,1,0.08433734939759036,0.02127659574468085
"[1, 0, 0, 0, 0, 0, 1, 0, 1, 1, 0, 0, 0, 1, 1]",188,92,96,12,11,0.13043478260869565,0.11458333333333333
"[0, 0, 0, 1, 1, 1, 1, 1, 0, 0, 1, 0, 0, 1, 1]",212,119,93,7,6,0.058823529411764705,0.06451612903225806
"[0, 0, 0, 0, 0, 1, 1, 1, 1, 1, 0, 0, 1, 0, 0]",243,151,92,16,7,0.10596026490066225,0.07608695652173914
"[1, 1, 0, 0, 0, 0, 1, 1, 0, 1, 1, 0, 1, 0, 1]",152,70,82,4,7,0.05714285714285714,0.08536585365853659
"[1, 1, 1, 1, 1, 1, 0, 1, 0, 0, 1, 1, 0, 1, 1]",630,196,434,15,52,0.07653061224489796,0.11981566820276497
"[0, 0, 1, 0, 1, 0, 0, 1, 0, 1, 0, 1, 1, 0, 1]",104,64,40,6,3,0.09375,0.075
"[0, 0, 1, 1, 0, 1, 1, 1, 0, 0, 0, 0, 1, 1, 1]",247,107,140,8,9,0.07476635514018691,0.06428571428571428
"[1, 1, 0, 1, 0, 0, 0, 1, 1, 1, 0, 0, 1, 1, 0]",166,74,92,3,4,0.04054054054054054,0.043478260869565216
"[1, 0, 1, 1, 0, 1, 0, 0, 0, 1, 1, 1, 0, 0, 1]",136,66,70,7,9,0.10606060606060606,0.12857142857142856
"[1, 1, 1, 1, 0, 1, 1, 1, 0, 0, 1, 1, 0, 0, 1]",508,154,354,16,33,0.1038961038961039,0.09322033898305085
"[0, 1, 1, 0, 1, 1, 1, 1, 1, 0, 0, 1, 1, 1, 0]",267,98,169,14,19,0.14285714285714285,0.11242603550295859
"[0, 0, 0, 1, 0, 1, 1, 0, 1, 1, 1, 1, 1, 0, 0]",157,79,78,4,8,0.05063291139240506,0.10256410256410256
"[0, 0, 0, 0, 1, 1, 0, 0, 1, 0, 1, 0, 1, 1, 1]",320,176,144,23,17,0.13068181818181818,0.11805555555555555
"[1, 0, 0, 0, 0, 1, 1, 1, 0, 0, 0, 1, 0, 1, 0]",167,99,68,8,7,0.08080808080808081,0.10294117647058823
"[1, 0, 1, 1, 0, 1, 0, 0, 1, 1, 1, 0, 0, 0, 0]",134,73,61,6,10,0.0821917808219178,0.16393442622950818
"[1, 0, 0, 1, 0, 1, 1, 0, 1, 0, 0, 1, 1, 1, 0]",112,52,60,2,5,0.038461538461538464,0.08333333333333333
"[0, 0, 0, 0, 1, 0, 0, 1, 1, 0, 1, 0, 1, 0, 0]",252,152,100,13,8,0.08552631578947369,0.08
"[1, 0, 0, 0, 0, 1, 0, 1, 1, 1, 1, 1, 1, 1, 0]",242,94,148,6,15,0.06382978723404255,0.10135135135135136
"[1, 1, 0, 0, 0, 0, 1, 0, 0, 1, 0, 0, 0, 0, 0]",672,470,202,50,21,0.10638297872340426,0.10396039603960396
"[0, 1, 0, 0, 1, 1, 1, 1, 0, 1, 0, 0, 0, 1, 0]",119,68,51,6,4,0.08823529411764706,0.0784313725490196
"[1, 0, 1, 1, 1, 0, 1, 1, 1, 1, 0, 0, 1, 0, 1]",219,69,150,6,10,0.08695652173913043,0.06666666666666667
"[1, 1, 0, 0, 0, 0, 0, 1, 1, 0, 1, 1, 0, 1, 1]",147,88,59,6,5,0.06818181818181818,0.0847457627118644
"[0, 1, 0, 0, 0, 1, 0, 1, 0, 0, 0, 0, 1, 0, 1]",240,163,77,12,8,0.0736196319018405,0.1038961038961039
"[0, 1, 1, 1, 0, 1, 1, 0, 0, 0, 1, 1, 1, 1, 0]",183,74,109,10,8,0.13513513513513514,0.07339449541284404
"[1, 1, 0, 1, 1, 1, 0, 1, 1, 0, 0, 0, 1, 1, 1]",320,107,213,13,19,0.12149532710280374,0.0892018779342723
"[1, 1, 1, 1, 1, 1, 0, 1, 1, 1, 0, 1, 1, 0, 0]",697,163,534,8,63,0.049079754601226995,0.11797752808988764
"[1, 0, 1, 1, 1, 1, 0, 0, 1, 0, 0, 0, 0, 0, 0]",222,113,109,13,11,0.11504424778761062,0.10091743119266056
"[1, 1, 0, 0, 1, 0, 1, 0, 0, 1, 0, 0, 0, 1, 1]",116,56,60,4,6,0.07142857142857142,0.1
"[1, 0, 1, 0, 0, 0, 0, 1, 0, 0, 0, 1, 0, 1, 1]",160,100,60,10,5,0.1,0.08333333333333333
"[0, 1, 1, 1, 0, 1, 0, 1, 1, 0, 0, 1, 0, 0, 0]",116,46,70,5,3,0.10869565217391304,0.04285714285714286
"[0, 0, 0, 1, 1, 1, 0, 1, 0, 1, 1, 0, 0, 1, 0]",120,58,62,4,5,0.06896551724137931,0.08064516129032258
"[0, 1, 0, 0, 0, 0, 0, 1, 0, 1, 0, 0, 1, 1, 1]",185,121,64,9,5,0.0743801652892562,0.078125
"[1, 0, 0, 0, 1, 0, 1, 1, 1, 0, 1, 1, 0, 0, 0]",126,63,63,7,5,0.1111111111111111,0.07936507936507936
"[1, 0, 1, 0, 1, 0, 1, 1, 0, 1, 1, 1, 1, 0, 0]",184,72,112,7,12,0.09722222222222222,0.10714285714285714
"[0, 1, 1, 0, 1, 1, 1, 0, 1, 0, 1, 1, 1, 1, 1]",619,205,414,14,31,0.06829268292682927,0.0748792270531401
"[1, 1, 1, 0, 1, 0, 0, 1, 1, 0, 0, 1, 1, 1, 0]",164,65,99,2,13,0.03076923076923077,0.13131313131313133
"[0, 1, 0, 1, 0, 0, 0, 0, 0, 1, 1, 1, 1, 1, 0]",147,75,72,8,4,0.10666666666666667,0.05555555555555555
"[0, 1, 0, 1, 0, 0, 1, 1, 1, 0, 1, 0, 0, 0, 0]",166,94,72,5,5,0.05319148936170213,0.06944444444444445
"[1, 0, 0, 0, 1, 1, 0, 0, 0, 0, 0, 0, 1, 0, 1]",321,212,109,23,11,0.10849056603773585,0.10091743119266056
"[0, 0, 1, 1, 0, 0, 1, 1, 1, 0, 1, 0, 1, 1, 0]",149,74,75,5,4,0.06756756756756757,0.05333333333333334
"[1, 0, 1, 1, 1, 1, 0, 0, 1, 1, 1, 1, 1, 0, 0]",376,120,256,11,16,0.09166666666666666,0.0625
"[0, 1, 0, 1, 1, 1, 1, 0, 0, 1, 1, 1, 1, 1, 0]",283,100,183,5,15,0.05,0.08196721311475409
"[1, 0, 0, 1, 0, 1, 1, 1, 1, 0, 1, 0, 1, 1, 1]",239,76,163,7,6,0.09210526315789473,0.03680981595092025
"[1, 1, 0, 0, 1, 1, 1, 1, 1, 0, 0, 1, 0, 1, 0]",167,66,101,9,5,0.13636363636363635,0.04950495049504951
"[1, 0, 0, 0, 0, 1, 1, 0, 0, 1, 0, 0, 1, 0, 0]",289,154,135,11,15,0.07142857142857142,0.1111111111111111
"[0, 0, 1, 0, 1, 0, 1, 0, 1, 0, 1, 0, 1, 0, 0]",143,85,58,8,7,0.09411764705882353,0.1206896551724138
"[1, 1, 0, 1, 1, 0, 0, 0, 0, 0, 1, 1, 0, 0, 1]",192,94,98,5,9,0.05319148936170213,0.09183673469387756
"[0, 0, 1, 0, 1, 1, 0, 1, 0, 1, 0, 1, 0, 0, 1]",107,61,46,4,2,0.06557377049180328,0.043478260869565216
"[0, 0, 0, 0, 1, 0, 1, 0, 0, 1, 0, 1, 1, 0, 0]",284,186,98,14,8,0.07526881720430108,0.08163265306122448
"[1, 0, 0, 0, 0, 1, 0, 1, 0, 0, 1, 0, 1, 1, 0]",146,83,63,9,6,0.10843373493975904,0.09523809523809523
"[0, 0, 0, 1, 0, 1, 0, 0, 0, 1, 0, 1, 0, 1, 0]",224,162,62,16,8,0.09876543209876543,0.12903225806451613
"[1, 1, 0, 0, 1, 0, 0, 1, 0, 1, 1, 0, 0, 1, 0]",108,54,54,9,5,0.16666666666666666,0.09259259259259259
"[0, 0, 1, 1, 1, 1, 0, 1, 1, 0, 1, 1, 1, 0, 0]",171,67,104,6,9,0.08955223880597014,0.08653846153846154
"[0, 0, 0, 1, 0, 1, 1, 1, 1, 0, 0, 1, 0, 0, 1]",109,62,47,8,5,0.12903225806451613,0.10638297872340426
"[0, 0, 0, 0, 1, 0, 1, 1, 1, 1, 0, 0, 1, 0, 0]",157,93,64,10,12,0.10752688172043011,0.1875
"[1, 1, 0, 1, 0, 0, 0, 1, 0, 0, 0, 1, 0, 1, 1]",129,69,60,6,8,0.08695652173913043,0.13333333333333333
"[0, 1, 1, 0, 0, 0, 1, 0, 1, 0, 0, 0, 0, 0, 0]",708,512,196,58,15,0.11328125,0.07653061224489796
"[1, 0, 0, 0, 1, 1, 0, 0, 1, 0, 1, 0, 1, 0, 0]",151,85,66,8,5,0.09411764705882353,0.07575757575757576
"[0, 1, 0, 1, 1, 1, 1, 0, 0, 0, 1, 0, 1, 0, 1]",112,49,63,7,2,0.14285714285714285,0.031746031746031744
"[1, 0, 0, 1, 0, 1, 1, 1, 1, 0, 0, 0, 1, 0, 1]",80,37,43,4,6,0.10810810810810811,0.13953488372093023
"[1, 1, 1, 1, 0, 1, 1, 0, 0, 1, 0, 0, 0, 1, 1]",164,64,100,4,7,0.0625,0.07
"[1, 1, 0, 0, 0, 1, 0, 1, 0, 1, 1, 1, 1, 0, 1]",141,59,82,1,7,0.01694915254237288,0.08536585365853659
"[0, 0, 1, 1, 0, 1, 0, 0, 0, 1, 1, 1, 0, 0, 1]",127,76,51,8,8,0.10526315789473684,0.1568627450980392
"[0, 1, 0, 1, 0, 0, 0, 0, 1, 0, 1, 1, 1, 0, 0]",158,95,63,11,6,0.11578947368421053,0.09523809523809523
"[0, 0, 0, 1, 0, 0, 1, 1, 0, 0, 0, 1, 0, 0, 0]",562,407,155,44,17,0.10810810810810811,0.10967741935483871
"[0, 0, 1, 0, 0, 0, 1, 0, 0, 1, 1, 0, 0, 0, 1]",236,145,91,14,9,0.09655172413793103,0.0989010989010989
"[0, 0, 1, 0, 1, 0, 1, 1, 0, 0, 0, 0, 0, 1, 0]",234,153,81,10,5,0.06535947712418301,0.06172839506172839
"[0, 1, 0, 1, 1, 1, 0, 1, 0, 0, 0, 1, 0, 0, 0]",129,77,52,13,7,0.16883116883116883,0.1346153846153846
"[1, 1, 1, 0, 0, 0, 0, 0, 0, 1, 0, 0, 1, 0, 0]",368,196,172,22,16,0.11224489795918367,0.09302325581395349
"[1, 1, 1, 0, 1, 1, 1, 0, 1, 1, 0, 0, 0, 0, 0]",181,72,109,5,12,0.06944444444444445,0.11009174311926606
"[0, 1, 1, 1, 1, 0, 0, 0, 1, 0, 0, 0, 1, 0, 1]",123,57,66,5,5,0.08771929824561403,0.07575757575757576
"[1, 1, 0, 0, 0, 0, 1, 1, 1, 1, 0, 0, 0, 1, 0]",323,173,150,16,12,0.09248554913294797,0.08
"[1, 0, 1, 1, 0, 0, 1, 0, 0, 0, 0, 1, 1, 0, 0]",221,125,96,16,6,0.128,0.0625
"[1, 0, 1, 1, 1, 0, 0, 1, 0, 1, 1, 0, 1, 0, 1]",121,42,79,4,12,0.09523809523809523,0.1518987341772152
"[0, 1, 0, 1, 1, 1, 0, 0, 1, 0, 1, 1, 0, 1, 0]",94,41,53,6,3,0.14634146341463414,0.05660377358490566
"[0, 1, 0, 1, 1, 1, 1, 0, 1, 0, 0, 1, 0, 0, 1]",110,50,60,3,6,0.06,0.1
"[1, 1, 1, 0, 0, 0, 0, 1, 0, 1, 0, 0, 1, 1, 0]",167,79,88,6,9,0.0759493670886076,0.10227272727272728
"[0, 0, 1, 1, 0, 1, 1, 0, 1, 1, 1, 1, 1, 0, 0]",214,89,125,6,15,0.06741573033707865,0.12
"[1, 1, 1, 0, 1, 0, 0, 0, 1, 1, 0, 1, 1, 1, 1]",281,87,194,7,21,0.08045977011494253,0.10824742268041238
"[1, 1, 1, 0, 1, 0, 0, 0, 1, 1, 1, 1, 1, 1, 0]",360,122,238,9,18,0.07377049180327869,0.07563025210084033
"[1, 0, 0, 0, 1, 0, 0, 0, 1, 0, 0, 1, 1, 1, 1]",183,82,101,9,14,0.10975609756097561,0.13861386138613863
"[1, 1, 0, 1, 0, 1, 1, 1, 0, 0, 0, 0, 1, 1, 1]",311,118,193,13,21,0.11016949152542373,0.10880829015544041
"[1, 1, 0, 0, 0, 1, 1, 1, 1, 1, 0, 0, 0, 0, 1]",232,87,145,10,17,0.11494252873563218,0.11724137931034483
"[0, 1, 1, 1, 0, 0, 0, 1, 1, 1, 1, 1, 0, 0, 0]",191,82,109,6,10,0.07317073170731707,0.09174311926605505
"[0, 0, 0, 0, 1, 0, 1, 1, 1, 1, 0, 0, 0, 1, 0]",158,96,62,9,9,0.09375,0.14516129032258066
"[1, 1, 0, 1, 1, 0, 1, 1, 0, 0, 0, 0, 1, 0, 1]",107,44,63,2,3,0.045454545454545456,0.047619047619047616
"[0, 0, 1, 1, 0, 1, 1, 1, 1, 1, 0, 1, 0, 1, 1]",249,91,158,6,12,0.06593406593406594,0.0759493670886076
"[1, 0, 1, 0, 1, 0, 0, 1, 1, 1, 1, 0, 1, 1, 0]",159,61,98,9,12,0.14754098360655737,0.12244897959183673
"[1, 1, 0, 0, 1, 1, 0, 0, 1, 0, 1, 1, 0, 0, 0]",201,91,110,9,11,0.0989010989010989,0.1
"[0, 1, 1, 1, 1, 0, 0, 1, 1, 1, 1, 1, 0, 0, 1]",511,274,237,20,15,0.072992700729927,0.06329113924050633
"[0, 1, 1, 0, 1, 1, 1, 0, 0, 1, 1, 0, 1, 1, 0]",149,62,87,6,13,0.0967741935483871,0.14942528735632185
"[0, 1, 1, 1, 0, 1, 1, 0, 0, 0, 1, 0, 1, 0, 1]",108,52,56,5,6,0.09615384615384616,0.10714285714285714
"[1, 0, 0, 0, 1, 1, 0, 1, 1, 1, 1, 0, 0, 0, 0]",204,92,112,7,12,0.07608695652173914,0.10714285714285714
"[1, 1, 1, 0, 1, 1, 0, 1, 0, 1, 1, 0, 0, 0, 1]",151,54,97,4,10,0.07407407407407407,0.10309278350515463
"[1, 0, 1, 1, 0, 1, 1, 1, 0, 0, 1, 0, 1, 1, 1]",270,87,183,7,15,0.08045977011494253,0.08196721311475409
"[0, 0, 1, 1, 1, 0, 1, 1, 1, 0, 0, 1, 0, 0, 1]",119,46,73,2,6,0.043478260869565216,0.0821917808219178
"[0, 0, 0, 1, 1, 1, 1, 0, 0, 1, 0, 0, 1, 1, 1]",319,219,100,36,10,0.1643835616438356,0.1
"[0, 1, 0, 0, 1, 0, 0, 1, 0, 0, 1, 0, 0, 1, 0]",226,146,80,14,9,0.0958904109589041,0.1125
"[0, 1, 1, 1, 1, 0, 0, 1, 1, 1, 0, 1, 0, 1, 0]",170,83,87,9,14,0.10843373493975904,0.16091954022988506
"[0, 1, 0, 1, 1, 1, 1, 1, 1, 0, 1, 1, 1, 1, 0]",601,191,410,17,35,0.08900523560209424,0.08536585365853659
"[1, 0, 0, 0, 0, 1, 0, 1, 0, 0, 1, 0, 1, 0, 1]",131,81,50,7,7,0.08641975308641975,0.14
"[0, 0, 0, 1, 0, 1, 0, 0, 0, 1, 1, 1, 1, 0, 1]",126,61,65,7,4,0.11475409836065574,0.06153846153846154
"[0, 0, 0, 0, 1, 1, 1, 0, 1, 1, 0, 1, 0, 0, 1]",125,62,63,8,6,0.12903225806451613,0.09523809523809523
"[0, 1, 0, 0, 0, 0, 0, 0, 0, 1, 1, 1, 0, 1, 1]",194,117,77,17,5,0.1452991452991453,0.06493506493506493
"[1, 1, 1, 1, 1, 0, 1, 0, 1, 0, 0, 1, 1, 0, 1]",244,79,165,5,16,0.06329113924050633,0.09696969696969697
"[0, 1, 0, 1, 0, 1, 0, 1, 1, 1, 1, 1, 0, 0, 1]",186,79,107,11,12,0.13924050632911392,0.11214953271028037
"[0, 0, 1, 1, 0, 0, 0, 1, 1, 0, 1, 1, 1, 1, 1]",280,124,156,14,17,0.11290322580645161,0.10897435897435898
"[1, 0, 1, 1, 0, 1, 0, 0, 0, 1, 1, 0, 1, 0, 0]",117,64,53,6,5,0.09375,0.09433962264150944
"[0, 0, 0, 1, 0, 0, 0, 0, 1, 0, 1, 1, 1, 0, 1]",148,88,60,15,6,0.17045454545454544,0.1
"[0, 1, 1, 0, 1, 1, 0, 0, 0, 1, 0, 1, 0, 0, 1]",113,58,55,4,8,0.06896551724137931,0.14545454545454545
"[0, 0, 1, 1, 1, 1, 0, 1, 1, 0, 1, 0, 1, 1, 0]",142,66,76,5,13,0.07575757575757576,0.17105263157894737
"[0, 1, 0, 0, 0, 1, 1, 0, 0, 0, 1, 0, 1, 0, 1]",156,118,38,6,5,0.05084745762711865,0.13157894736842105
"[0, 0, 0, 1, 1, 1, 0, 1, 1, 0, 1, 0, 1, 0, 0]",127,69,58,9,4,0.13043478260869565,0.06896551724137931
"[1, 1, 0, 1, 0, 1, 1, 0, 1, 0, 1, 1, 0, 0, 1]",185,73,112,5,14,0.0684931506849315,0.125
"[1, 0, 0, 0, 0, 0, 0, 1, 0, 0, 1, 0, 1, 0, 0]",529,362,167,27,12,0.07458563535911603,0.0718562874251497
"[0, 0, 1, 1, 1, 0, 1, 0, 1, 0, 1, 1, 0, 0, 0]",129,67,62,6,4,0.08955223880597014,0.06451612903225806
"[1, 1, 1, 0, 0, 0, 1, 1, 0, 0, 0, 1, 1, 0, 1]",122,60,62,3,7,0.05,0.11290322580645161
"[0, 0, 0, 0, 1, 1, 0, 1, 0, 0, 1, 0, 1, 1, 1]",212,127,85,14,7,0.11023622047244094,0.08235294117647059
"[0, 0, 1, 0, 1, 0, 1, 1, 1, 1, 0, 1, 1, 1, 0]",152,66,86,3,11,0.045454545454545456,0.12790697674418605
"[1, 0, 0, 1, 1, 0, 1, 1, 1, 1, 1, 0, 1, 0, 1]",230,75,155,10,11,0.13333333333333333,0.07096774193548387
"[1, 0, 1, 0, 1, 1, 1, 1, 1, 1, 1, 1, 0, 0, 0]",512,179,333,17,44,0.09497206703910614,0.13213213213213212
"[1, 0, 1, 0, 0, 1, 1, 0, 0, 1, 1, 0, 1, 1, 1]",174,62,112,4,12,0.06451612903225806,0.10714285714285714
"[1, 0, 1, 0, 1, 0, 0, 1, 1, 0, 0, 1, 1, 0, 1]",112,54,58,5,5,0.09259259259259259,0.08620689655172414
"[1, 0, 1, 1, 1, 1, 0, 0, 1, 0, 0, 1, 0, 1, 0]",97,45,52,4,6,0.08888888888888889,0.11538461538461539
"[1, 1, 1, 1, 1, 0, 0, 0, 0, 1, 0, 1, 1, 0, 0]",193,81,112,9,9,0.1111111111111111,0.08035714285714286
"[0, 1, 1, 1, 0, 1, 1, 1, 1, 1, 1, 0, 0, 0, 1]",286,101,185,8,18,0.07920792079207921,0.0972972972972973
"[1, 0, 0, 0, 0, 1, 1, 1, 0, 1, 1, 1, 1, 0, 0]",200,89,111,9,8,0.10112359550561797,0.07207207207207207
"[0, 1, 0, 1, 1, 0, 0, 0, 0, 1, 0, 0, 1, 0, 0]",238,154,84,23,8,0.14935064935064934,0.09523809523809523
"[0, 0, 1, 1, 0, 1, 0, 1, 0, 0, 0, 1, 0, 0, 0]",252,166,86,17,13,0.10240963855421686,0.1511627906976744
"[1, 0, 0, 1, 1, 1, 1, 1, 0, 1, 1, 1, 1, 1, 0]",677,166,511,17,57,0.10240963855421686,0.11154598825831702
"[1, 1, 1, 1, 1, 0, 1, 1, 0, 0, 1, 1, 1, 0, 0]",306,101,205,9,19,0.0891089108910891,0.09268292682926829
"[0, 1, 1, 1, 0, 0, 0, 1, 1, 0, 0, 0, 1, 1, 0]",129,71,58,8,7,0.11267605633802817,0.1206896551724138
"[0, 0, 1, 0, 1, 1, 1, 1, 0, 0, 1, 1, 0, 0, 1]",262,128,134,10,13,0.078125,0.09701492537313433
"[1, 0, 1, 0, 0, 1, 0, 1, 0, 0, 1, 0, 1, 1, 0]",116,53,63,6,9,0.11320754716981132,0.14285714285714285
"[1, 1, 0, 0, 1, 1, 1, 0, 0, 0, 0, 1, 0, 1, 1]",139,63,76,3,8,0.047619047619047616,0.10526315789473684
"[0, 0, 1, 1, 0, 1, 0, 0, 1, 0, 0, 1, 0, 0, 0]",228,163,65,9,5,0.05521472392638037,0.07692307692307693
"[0, 1, 1, 1, 1, 0, 0, 0, 1, 0, 1, 1, 1, 0, 0]",139,78,61,13,2,0.16666666666666666,0.03278688524590164
"[1, 0, 0, 0, 1, 0, 1, 0, 1, 1, 1, 0, 1, 0, 0]",135,69,66,4,6,0.057971014492753624,0.09090909090909091
"[0, 0, 0, 0, 1, 1, 0, 1, 1, 1, 0, 0, 0, 0, 0]",354,217,137,29,12,0.1336405529953917,0.08759124087591241
"[1, 1, 0, 1, 0, 1, 1, 0, 0, 0, 1, 0, 0, 1, 0]",106,57,49,5,2,0.08771929824561403,0.04081632653061224
"[0, 1, 0, 1, 1, 0, 1, 0, 0, 1, 0, 0, 1, 0, 0]",142,81,61,2,1,0.024691358024691357,0.01639344262295082
"[0, 1, 0, 1, 0, 1, 1, 0, 1, 0, 0, 1, 0, 0, 1]",104,50,54,5,3,0.1,0.05555555555555555
"[1, 1, 0, 0, 1, 0, 0, 1, 0, 0, 0, 1, 1, 1, 1]",187,91,96,7,7,0.07692307692307693,0.07291666666666667
"[1, 0, 1, 0, 0, 0, 1, 1, 0, 0, 1, 0, 0, 1, 0]",127,68,59,4,6,0.058823529411764705,0.1016949152542373
"[1, 0, 1, 0, 0, 1, 1, 1, 1, 0, 1, 0, 0, 1, 1]",163,73,90,13,8,0.1780821917808219,0.08888888888888889
"[1, 0, 1, 1, 1, 0, 0, 1, 1, 1, 0, 0, 1, 1, 1]",374,127,247,15,14,0.11811023622047244,0.05668016194331984
"[1, 1, 0, 1, 0, 1, 1, 0, 0, 1, 1, 1, 0, 1, 1]",225,61,164,4,14,0.06557377049180328,0.08536585365853659
"[0, 1, 1, 1, 1, 0, 1, 1, 1, 0, 0, 0, 0, 1, 1]",316,139,177,14,19,0.10071942446043165,0.10734463276836158
"[1, 0, 0, 0, 1, 0, 1, 1, 1, 0, 0, 1, 0, 1, 0]",117,64,53,8,3,0.125,0.05660377358490566
"[0, 1, 1, 0, 0, 1, 1, 0, 1, 0, 1, 0, 1, 0, 1]",117,58,59,6,4,0.10344827586206896,0.06779661016949153
"[1, 1, 0, 1, 0, 0, 0, 1, 1, 0, 0, 1, 1, 0, 1]",135,62,73,6,9,0.0967741935483871,0.1232876712328767
"[0, 1, 1, 1, 0, 1, 1, 0, 0, 0, 0, 1, 1, 0, 1]",108,57,51,7,1,0.12280701754385964,0.0196078431372549
"[0, 0, 1, 0, 0, 1, 1, 0, 1, 0, 0, 0, 1, 0, 0]",220,137,83,12,9,0.08759124087591241,0.10843373493975904
"[0, 1, 0, 0, 1, 0, 0, 0, 1, 0, 0, 1, 0, 1, 1]",130,73,57,5,3,0.0684931506849315,0.05263157894736842
"[1, 1, 1, 0, 1, 0, 0, 1, 0, 0, 0, 1, 0, 0, 1]",120,57,63,7,5,0.12280701754385964,0.07936507936507936
"[1, 1, 1, 1, 0, 1, 1, 1, 0, 1, 0, 0, 1, 0, 0]",151,64,87,6,9,0.09375,0.10344827586206896
"[1, 0, 0, 0, 0, 1, 0, 1, 1, 1, 0, 1, 1, 0, 0]",121,65,56,5,9,0.07692307692307693,0.16071428571428573
"[1, 1, 0, 0, 1, 0, 1, 1, 0, 0, 1, 0, 0, 1, 1]",143,74,69,7,7,0.0945945945945946,0.10144927536231885
"[0, 1, 0, 0, 1, 1, 1, 1, 0, 0, 1, 0, 1, 1, 0]",132,69,63,8,5,0.11594202898550725,0.07936507936507936
"[0, 1, 0, 1, 0, 1, 1, 0, 0, 0, 0, 0, 1, 1, 0]",191,118,73,12,4,0.1016949152542373,0.0547945205479452
"[1, 1, 1, 1, 0, 1, 0, 1, 0, 1, 0, 0, 1, 1, 1]",303,111,192,7,18,0.06306306306306306,0.09375
"[0, 0, 0, 1, 0, 0, 1, 0, 0, 0, 1, 1, 0, 1, 1]",144,85,59,4,7,0.047058823529411764,0.11864406779661017
"[1, 1, 0, 1, 1, 1, 1, 0, 0, 0, 0, 0, 1, 0, 0]",124,60,64,4,5,0.06666666666666667,0.078125
"[0, 0, 0, 0, 1, 0, 0, 1, 1, 0, 0, 0, 1, 1, 1]",300,202,98,23,13,0.11386138613861387,0.1326530612244898
"[1, 1, 0, 1, 0, 0, 0, 1, 0, 1, 0, 1, 1, 0, 0]",102,51,51,5,4,0.09803921568627451,0.0784313725490196
"[1, 1, 1, 1, 0, 1, 1, 0, 0, 1, 1, 1, 0, 1, 0]",238,84,154,7,17,0.08333333333333333,0.11038961038961038
"[1, 1, 1, 0, 0, 0, 0, 1, 0, 1, 0, 1, 0, 0, 0]",170,97,73,15,3,0.15463917525773196,0.0410958904109589
"[0, 1, 0, 0, 1, 0, 1, 0, 1, 1, 1, 1, 0, 0, 0]",146,83,63,9,7,0.10843373493975904,0.1111111111111111
"[1, 0, 0, 0, 1, 0, 0, 1, 0, 1, 0, 1, 1, 1, 1]",138,67,71,10,1,0.14925373134328357,0.014084507042253521
"[0, 1, 1, 0, 0, 0, 1, 1, 1, 0, 0, 1, 1, 1, 1]",285,126,159,12,19,0.09523809523809523,0.11949685534591195
"[1, 1, 0, 1, 1, 0, 0, 0, 1, 0, 0, 1, 0, 1, 0]",100,52,48,3,4,0.057692307692307696,0.08333333333333333
"[0, 1, 0, 1, 0, 1, 0, 0, 0, 0, 1, 1, 1, 0, 0]",159,92,67,5,7,0.05434782608695652,0.1044776119402985
"[0, 1, 1, 1, 0, 1, 0, 0, 0, 1, 0, 1, 1, 0, 1]",114,53,61,4,7,0.07547169811320754,0.11475409836065574
"[0, 0, 0, 1, 1, 1, 0, 1, 0, 0, 0, 1, 0, 1, 1]",132,67,65,5,7,0.07462686567164178,0.1076923076923077
"[0, 1, 0, 1, 0, 0, 1, 1, 1, 1, 1, 1, 0, 0, 0]",277,135,142,16,11,0.11851851851851852,0.07746478873239436
"[1, 1, 1, 1, 0, 0, 0, 1, 1, 1, 1, 1, 1, 0, 0]",679,217,462,29,40,0.1336405529953917,0.08658008658008658
"[1, 1, 0, 0, 1, 1, 0, 1, 0, 1, 0, 0, 1, 0, 1]",95,43,52,3,7,0.06976744186046512,0.1346153846153846
"[1, 0, 0, 1, 0, 0, 1, 1, 0, 0, 1, 0, 1, 0, 1]",125,79,46,6,4,0.0759493670886076,0.08695652173913043
"[1, 0, 1, 0, 0, 1, 0, 1, 1, 0, 0, 1, 0, 1, 1]",115,57,58,4,6,0.07017543859649122,0.10344827586206896
"[1, 0, 1, 0, 1, 1, 1, 1, 0, 0, 0, 1, 0, 1, 0]",108,58,50,9,4,0.15517241379310345,0.08
"[1, 0, 0, 0, 1, 1, 1, 0, 0, 0, 1, 0, 0, 0, 0]",290,161,129,15,14,0.09316770186335403,0.10852713178294573
"[0, 0, 0, 1, 1, 0, 1, 1, 1, 0, 1, 1, 0, 1, 0]",90,44,46,3,6,0.06818181818181818,0.13043478260869565
"[1, 1, 1, 0, 1, 1, 0, 1, 1, 1, 1, 1, 0, 1, 0]",502,150,352,10,42,0.06666666666666667,0.11931818181818182
"[1, 1, 1, 1, 1, 0, 1, 1, 1, 0, 0, 1, 1, 0, 0]",533,174,359,18,34,0.10344827586206896,0.0947075208913649
"[1, 0, 1, 1, 0, 1, 0, 0, 0, 1, 0, 0, 1, 1, 1]",132,60,72,5,7,0.08333333333333333,0.09722222222222222
"[1, 0, 0, 1, 1, 0, 1, 1, 0, 1, 0, 0, 0, 1, 0]",93,45,48,8,5,0.17777777777777778,0.10416666666666667
"[0, 1, 1, 0, 0, 1, 1, 1, 0, 0, 0, 0, 0, 1, 1]",235,152,83,16,7,0.10526315789473684,0.08433734939759036
"[1, 0, 1, 0, 1, 0, 1, 1, 0, 1, 0, 1, 0, 0, 1]",110,52,58,4,7,0.07692307692307693,0.1206896551724138
"[0, 1, 0, 1, 0, 1, 0, 1, 0, 1, 1, 0, 1, 0, 1]",91,38,53,3,6,0.07894736842105263,0.11320754716981132
"[1, 1, 1, 0, 1, 1, 1, 1, 0, 1, 1, 0, 1, 0, 0]",220,78,142,6,10,0.07692307692307693,0.07042253521126761
"[1, 0, 1, 1, 1, 1, 0, 1, 0, 0, 0, 1, 1, 1, 0]",138,49,89,10,6,0.20408163265306123,0.06741573033707865
"[1, 1, 0, 0, 0, 1, 1, 0, 1, 1, 0, 1, 0, 1, 1]",158,65,93,6,8,0.09230769230769231,0.08602150537634409
"[1, 0, 0, 1, 1, 1, 0, 1, 0, 0, 1, 0, 0, 0, 0]",180,104,76,12,6,0.11538461538461539,0.07894736842105263
"[1, 0, 0, 1, 0, 1, 0, 1, 1, 0, 1, 1, 1, 1, 1]",277,79,198,12,18,0.1518987341772152,0.09090909090909091
"[0, 1, 1, 1, 0, 0, 0, 1, 1, 0, 1, 1, 1, 0, 1]",137,61,76,4,7,0.06557377049180328,0.09210526315789473
"[0, 1, 1, 1, 0, 1, 0, 1, 0, 1, 1, 1, 1, 0, 0]",203,88,115,9,16,0.10227272727272728,0.1391304347826087
"[1, 0, 0, 1, 1, 1, 1, 0, 1, 1, 0, 1, 0, 1, 0]",135,49,86,1,10,0.02040816326530612,0.11627906976744186
"[1, 0, 1, 0, 1, 0, 1, 0, 0, 1, 1, 0, 1, 0, 1]",110,44,66,4,7,0.09090909090909091,0.10606060606060606
"[1, 1, 1, 0, 0, 0, 1, 0, 1, 0, 0, 1, 0, 0, 0]",171,95,76,11,12,0.11578947368421053,0.15789473684210525
"[0, 1, 0, 1, 1, 1, 0, 0, 1, 0, 0, 0, 0, 1, 0]",166,101,65,2,7,0.019801980198019802,0.1076923076923077
"[0, 1, 1, 1, 0, 0, 1, 0, 1, 0, 1, 0, 1, 0, 1]",93,48,45,3,0,0.0625,0.0
"[1, 0, 1, 0, 0, 1, 1, 1, 0, 0, 1, 0, 1, 0, 1]",84,35,49,7,2,0.2,0.04081632653061224
"[0, 0, 1, 0, 1, 1, 1, 1, 1, 1, 0, 1, 0, 1, 1]",279,93,186,8,17,0.08602150537634409,0.0913978494623656
"[1, 0, 1, 0, 1, 1, 0, 0, 1, 1, 1, 0, 1, 0, 1]",156,62,94,3,12,0.04838709677419355,0.1276595744680851
"[1, 0, 1, 1, 0, 1, 0, 1, 0, 1, 1, 0, 0, 1, 1]",194,79,115,8,9,0.10126582278481013,0.0782608695652174
"[0, 1, 0, 1, 1, 0, 1, 1, 0, 1, 1, 0, 0, 0, 1]",119,49,70,4,11,0.08163265306122448,0.15714285714285714
"[0, 1, 0, 0, 1, 0, 1, 1, 0, 1, 1, 0, 1, 1, 0]",103,50,53,6,4,0.12,0.07547169811320754
"[1, 1, 0, 0, 0, 0, 1, 0, 0, 0, 0, 0, 1, 1, 1]",466,288,178,28,14,0.09722222222222222,0.07865168539325842
"[1, 1, 0, 1, 0, 0, 1, 1, 1, 0, 1, 0, 0, 1, 1]",163,61,102,4,11,0.06557377049180328,0.10784313725490197
"[0, 1, 1, 1, 0, 0, 0, 1, 1, 0, 1, 0, 1, 1, 0]",104,44,60,1,5,0.022727272727272728,0.08333333333333333
"[1, 0, 0, 0, 1, 0, 1, 1, 0, 0, 0, 0, 1, 1, 1]",208,110,98,9,14,0.08181818181818182,0.14285714285714285
"[1, 1, 0, 0, 0, 1, 1, 1, 0, 0, 0, 1, 0, 0, 0]",201,118,83,13,4,0.11016949152542373,0.04819277108433735
"[0, 1, 0, 1, 0, 0, 1, 1, 0, 1, 0, 0, 0, 0, 0]",248,154,94,15,11,0.09740259740259741,0.11702127659574468
"[1, 1, 0, 1, 1, 1, 1, 1, 0, 1, 0, 1, 1, 0, 0]",269,94,175,8,19,0.0851063829787234,0.10857142857142857
"[1, 1, 1, 0, 0, 0, 0, 1, 0, 0, 1, 1, 0, 1, 1]",146,59,87,3,5,0.05084745762711865,0.05747126436781609
"[0, 1, 0, 1, 0, 0, 0, 1, 1, 1, 0, 0, 0, 0, 1]",187,103,84,12,14,0.11650485436893204,0.16666666666666666
"[0, 0, 0, 0, 1, 1, 0, 1, 0, 0, 0, 1, 0, 1, 1]",208,133,75,15,5,0.11278195488721804,0.06666666666666667
"[1, 0, 1, 1, 0, 1, 0, 0, 1, 0, 0, 0, 1, 1, 1]",148,75,73,5,9,0.06666666666666667,0.1232876712328767
"[1, 1, 0, 1, 1, 0, 1, 0, 0, 1, 0, 0, 0, 1, 1]",134,68,66,4,7,0.058823529411764705,0.10606060606060606
"[1, 1, 1, 0, 0, 1, 1, 0, 1, 1, 0, 1, 0, 0, 1]",176,69,107,3,6,0.043478260869565216,0.056074766355140186
"[0, 0, 0, 1, 0, 1, 0, 0, 1, 0, 0, 0, 0, 1, 0]",504,346,158,30,19,0.08670520231213873,0.12025316455696203
"[1, 0, 0, 0, 1, 0, 1, 1, 1, 0, 0, 1, 0, 0, 0]",174,93,81,6,15,0.06451612903225806,0.18518518518518517
"[1, 0, 1, 1, 0, 0, 0, 0, 0, 0, 0, 0, 1, 0, 1]",306,171,135,9,14,0.05263157894736842,0.1037037037037037
"[0, 0, 1, 1, 1, 0, 1, 0, 0, 0, 0, 0, 1, 1, 1]",242,129,113,22,7,0.17054263565891473,0.061946902654867256
"[1, 1, 0, 1, 0, 1, 0, 1, 0, 0, 1, 1, 1, 0, 1]",130,53,77,1,8,0.018867924528301886,0.1038961038961039
"[0, 1, 1, 0, 0, 0, 0, 0, 1, 1, 0, 1, 0, 0, 0]",299,211,88,13,9,0.061611374407582936,0.10227272727272728
"[1, 1, 0, 1, 0, 0, 1, 1, 0, 0, 0, 0, 0, 1, 1]",173,94,79,7,4,0.07446808510638298,0.05063291139240506
"[0, 1, 1, 1, 1, 0, 1, 0, 0, 1, 1, 0, 0, 0, 0]",203,120,83,8,8,0.06666666666666667,0.0963855421686747
"[1, 0, 0, 0, 1, 0, 1, 0, 0, 1, 0, 1, 1, 1, 0]",120,76,44,12,8,0.15789473684210525,0.18181818181818182
"[1, 1, 0, 1, 1, 1, 1, 1, 1, 0, 1, 0, 0, 1, 0]",230,99,131,13,10,0.13131313131313133,0.07633587786259542
"[0, 0, 1, 0, 1, 0, 0, 1, 1, 0, 1, 1, 0, 0, 0]",158,89,69,8,5,0.0898876404494382,0.07246376811594203
"[0, 1, 1, 0, 0, 1, 1, 0, 0, 1, 0, 1, 0, 0, 1]",150,96,54,11,2,0.11458333333333333,0.037037037037037035
"[0, 1, 1, 1, 1, 1, 1, 1, 0, 0, 1, 0, 1, 1, 0]",297,128,169,5,22,0.0390625,0.1301775147928994
"[1, 0, 1, 0, 1, 1, 1, 1, 0, 0, 0, 0, 0, 0, 0]",395,215,180,16,19,0.07441860465116279,0.10555555555555556
"[1, 1, 1, 0, 1, 0, 1, 1, 1, 1, 0, 0, 0, 0, 0]",253,112,141,7,14,0.0625,0.09929078014184398
"[0, 0, 0, 1, 1, 1, 1, 1, 1, 0, 1, 1, 1, 1, 0]",386,173,213,15,21,0.08670520231213873,0.09859154929577464
"[0, 0, 1, 0, 1, 1, 1, 1, 0, 1, 0, 0, 1, 1, 1]",183,69,114,8,10,0.11594202898550725,0.08771929824561403
"[1, 0, 1, 1, 1, 0, 1, 1, 0, 0, 1, 1, 0, 1, 0]",128,49,79,4,16,0.08163265306122448,0.20253164556962025
"[0, 1, 1, 0, 0, 0, 1, 0, 1, 0, 1, 1, 0, 1, 0]",103,58,45,8,4,0.13793103448275862,0.08888888888888889
"[1, 1, 1, 1, 0, 1, 0, 1, 0, 0, 0, 1, 1, 0, 0]",156,72,84,8,3,0.1111111111111111,0.03571428571428571
"[0, 1, 0, 0, 1, 0, 0, 1, 1, 1, 0, 0, 0, 1, 1]",134,65,69,6,6,0.09230769230769231,0.08695652173913043
"[1, 0, 1, 1, 1, 0, 0, 1, 0, 1, 0, 0, 1, 0, 0]",126,66,60,7,6,0.10606060606060606,0.1
"[0, 0, 1, 0, 1, 0, 0, 1, 0, 1, 0, 1, 1, 1, 0]",101,50,51,4,7,0.08,0.13725490196078433
"[0, 1, 0, 0, 0, 1, 0, 1, 0, 0, 1, 0, 1, 0, 1]",127,63,64,3,6,0.047619047619047616,0.09375
"[0, 1, 0, 1, 0, 0, 0, 1, 1, 0, 0, 0, 0, 0, 1]",278,178,100,10,6,0.056179775280898875,0.06
"[0, 0, 0, 0, 1, 0, 0, 1, 1, 0, 1, 1, 0, 0, 0]",257,179,78,19,7,0.10614525139664804,0.08974358974358974
"[0, 0, 1, 0, 1, 0, 1, 0, 1, 0, 0, 1, 1, 1, 0]",113,63,50,6,6,0.09523809523809523,0.12
"[1, 1, 1, 0, 0, 1, 0, 1, 0, 1, 0, 1, 0, 0, 1]",104,54,50,3,4,0.05555555555555555,0.08
"[1, 0, 1, 1, 1, 1, 1, 1, 0, 0, 1, 0, 1, 0, 1]",249,90,159,8,14,0.08888888888888889,0.0880503144654088
"[0, 1, 1, 0, 0, 0, 1, 0, 0, 1, 0, 0, 0, 1, 0]",245,161,84,15,4,0.09316770186335403,0.047619047619047616
"[0, 1, 0, 1, 1, 1, 0, 0, 1, 0, 1, 0, 0, 1, 0]",110,60,50,8,7,0.13333333333333333,0.14
"[0, 1, 1, 0, 1, 0, 0, 1, 0, 1, 1, 0, 1, 0, 0]",138,76,62,7,4,0.09210526315789473,0.06451612903225806
"[0, 1, 0, 0, 0, 1, 1, 0, 1, 1, 0, 0, 0, 0, 0]",280,175,105,14,9,0.08,0.08571428571428572
"[0, 1, 1, 1, 1, 1, 0, 0, 0, 0, 1, 0, 0, 1, 1]",165,77,88,3,7,0.03896103896103896,0.07954545454545454
"[1, 0, 1, 1, 0, 0, 0, 1, 1, 0, 1, 1, 1, 0, 1]",129,53,76,7,5,0.1320754716981132,0.06578947368421052
"[1, 1, 0, 1, 1, 0, 0, 0, 1, 1, 0, 1, 1, 1, 0]",136,50,86,5,8,0.1,0.09302325581395349
"[0, 1, 1, 0, 1, 1, 1, 1, 1, 0, 0, 0, 1, 0, 1]",138,61,77,5,5,0.08196721311475409,0.06493506493506493
"[1, 0, 0, 1, 1, 0, 1, 0, 0, 0, 1, 0, 1, 1, 1]",152,58,94,3,10,0.05172413793103448,0.10638297872340426
"[1, 1, 0, 0, 0, 1, 1, 0, 0, 0, 1, 1, 0, 0, 0]",232,145,87,11,9,0.07586206896551724,0.10344827586206896
"[0, 1, 1, 0, 1, 1, 0, 1, 1, 1, 0, 1, 0, 0, 0]",111,53,58,5,3,0.09433962264150944,0.05172413793103448
"[1, 1, 1, 1, 0, 0, 1, 0, 1, 1, 0, 0, 0, 1, 1]",184,79,105,8,17,0.10126582278481013,0.1619047619047619
"[0, 1, 1, 0, 1, 1, 0, 0, 1, 0, 1, 1, 0, 0, 0]",148,69,79,4,7,0.057971014492753624,0.08860759493670886
"[1, 1, 0, 0, 0, 1, 0, 1, 1, 1, 1, 1, 1, 0, 0]",271,110,161,12,19,0.10909090909090909,0.11801242236024845
"[1, 0, 0, 0, 0, 0, 0, 1, 1, 1, 0, 1, 0, 1, 0]",169,88,81,6,5,0.06818181818181818,0.06172839506172839
"[1, 1, 0, 1, 1, 0, 1, 0, 0, 0, 0, 1, 0, 1, 0]",114,74,40,6,2,0.08108108108108109,0.05
"[1, 0, 0, 1, 1, 1, 1, 1, 0, 0, 1, 1, 1, 0, 0]",243,80,163,6,19,0.075,0.1165644171779141
"[0, 1, 1, 0, 0, 1, 1, 0, 1, 1, 0, 0, 0, 1, 0]",106,66,40,4,6,0.06060606060606061,0.15
"[1, 0, 1, 1, 0, 1, 0, 1, 0, 0, 1, 1, 0, 0, 0]",145,67,78,10,11,0.14925373134328357,0.14102564102564102
"[1, 0, 1, 1, 0, 1, 0, 1, 1, 0, 1, 0, 0, 1, 0]",103,48,55,3,5,0.0625,0.09090909090909091
"[1, 1, 0, 0, 1, 0, 1, 1, 0, 1, 0, 1, 1, 0, 1]",160,61,99,3,10,0.04918032786885246,0.10101010101010101
"[1, 0, 0, 0, 1, 1, 0, 1, 0, 0, 0, 0, 1, 1, 0]",186,106,80,7,5,0.0660377358490566,0.0625
"[1, 1, 1, 0, 0, 1, 1, 0, 1, 0, 1, 0, 0, 0, 0]",168,76,92,9,7,0.11842105263157894,0.07608695652173914
"[0, 1, 1, 1, 0, 0, 0, 1, 1, 1, 0, 0, 1, 1, 0]",152,70,82,6,15,0.08571428571428572,0.18292682926829268
"[1, 0, 0, 0, 0, 0, 1, 0, 0, 0, 1, 0, 1, 0, 1]",228,151,77,14,6,0.09271523178807947,0.07792207792207792
"[0, 1, 0, 0, 1, 0, 1, 0, 1, 1, 0, 0, 0, 1, 0]",160,93,67,10,4,0.10752688172043011,0.05970149253731343
"[1, 0, 0, 1, 0, 1, 0, 1, 0, 1, 0, 1, 1, 1, 0]",97,43,54,3,5,0.06976744186046512,0.09259259259259259
"[0, 0, 0, 0, 1, 0, 1, 0, 0, 1, 1, 1, 1, 1, 0]",151,79,72,12,5,0.1518987341772152,0.06944444444444445
"[1, 0, 0, 0, 0, 0, 1, 0, 1, 0, 0, 1, 1, 1, 1]",212,81,131,13,6,0.16049382716049382,0.04580152671755725
"[0, 1, 1, 0, 0, 1, 1, 1, 0, 0, 0, 0, 0, 1, 0]",156,106,50,7,4,0.0660377358490566,0.08
"[0, 0, 1, 1, 1, 0, 1, 0, 1, 1, 0, 1, 1, 1, 1]",320,116,204,15,17,0.12931034482758622,0.08333333333333333
"[0, 0, 1, 1, 0, 1, 0, 1, 0, 0, 1, 1, 0, 1, 0]",120,70,50,12,4,0.17142857142857143,0.08
"[1, 0, 0, 0, 0, 0, 1, 0, 0, 1, 1, 0, 1, 0, 1]",117,65,52,2,3,0.03076923076923077,0.057692307692307696
"[1, 1, 1, 0, 1, 0, 0, 0, 1, 0, 0, 0, 1, 0, 0]",142,85,57,8,3,0.09411764705882353,0.05263157894736842
"[1, 1, 0, 1, 0, 1, 0, 0, 0, 1, 1, 0, 1, 1, 0]",103,51,52,6,4,0.11764705882352941,0.07692307692307693
"[1, 0, 1, 1, 1, 1, 0, 1, 1, 0, 0, 0, 1, 1, 0]",168,72,96,10,8,0.1388888888888889,0.08333333333333333
"[1, 1, 1, 1, 0, 1, 1, 1, 1, 0, 1, 1, 0, 0, 0]",322,96,226,10,18,0.10416666666666667,0.07964601769911504
"[0, 1, 1, 1, 0, 1, 1, 0, 0, 1, 1, 0, 1, 1, 0]",122,60,62,7,5,0.11666666666666667,0.08064516129032258
"[1, 0, 1, 1, 0, 1, 0, 1, 0, 0, 0, 1, 1, 0, 0]",126,72,54,8,6,0.1111111111111111,0.1111111111111111
"[1, 1, 1, 1, 0, 1, 0, 1, 1, 0, 1, 0, 1, 0, 1]",233,83,150,10,12,0.12048192771084337,0.08
"[0, 1, 0, 1, 1, 1, 0, 1, 0, 0, 1, 0, 0, 1, 1]",108,54,54,4,6,0.07407407407407407,0.1111111111111111
"[0, 1, 0, 0, 1, 0, 0, 1, 0, 0, 1, 1, 0, 1, 0]",129,80,49,10,6,0.125,0.12244897959183673
"[1, 1, 0, 1, 0, 0, 1, 0, 1, 0, 0, 0, 1, 0, 1]",102,52,50,4,4,0.07692307692307693,0.08
"[0, 1, 0, 0, 1, 1, 0, 0, 0, 1, 1, 0, 0, 0, 1]",167,92,75,12,7,0.13043478260869565,0.09333333333333334
"[1, 0, 0, 0, 0, 1, 1, 0, 1, 0, 1, 1, 1, 0, 1]",128,52,76,4,7,0.07692307692307693,0.09210526315789473
"[1, 0, 0, 1, 1, 1, 1, 0, 0, 0, 1, 0, 1, 1, 1]",350,92,258,7,26,0.07608695652173914,0.10077519379844961
"[0, 0, 0, 1, 0, 0, 1, 0, 1, 0, 1, 0, 1, 0, 1]",158,99,59,11,3,0.1111111111111111,0.05084745762711865
"[0, 0, 1, 1, 1, 0, 1, 1, 0, 1, 1, 1, 1, 0, 1]",256,100,156,16,17,0.16,0.10897435897435898
"[1, 0, 1, 0, 1, 1, 1, 0, 0, 1, 0, 0, 1, 1, 1]",193,75,118,5,9,0.06666666666666667,0.07627118644067797
"[0, 0, 0, 0, 1, 1, 1, 1, 0, 0, 0, 1, 1, 1, 0]",206,99,107,9,5,0.09090909090909091,0.04672897196261682
"[1, 0, 0, 0, 0, 1, 1, 1, 0, 1, 0, 0, 0, 1, 0]",139,79,60,6,2,0.0759493670886076,0.03333333333333333
"[0, 1, 0, 0, 0, 0, 1, 1, 1, 0, 1, 0, 0, 0, 1]",160,84,76,8,6,0.09523809523809523,0.07894736842105263
"[1, 0, 1, 0, 1, 0, 0, 0, 1, 1, 1, 1, 1, 1, 1]",422,137,285,11,28,0.08029197080291971,0.09824561403508772
"[1, 1, 1, 0, 0, 0, 0, 0, 1, 0, 0, 1, 1, 1, 0]",131,64,67,6,4,0.09375,0.05970149253731343
"[1, 0, 0, 1, 1, 1, 1, 0, 1, 1, 0, 0, 0, 0, 0]",219,84,135,9,17,0.10714285714285714,0.1259259259259259
"[1, 1, 1, 0, 0, 0, 1, 1, 0, 0, 1, 1, 0, 1, 1]",168,55,113,10,11,0.18181818181818182,0.09734513274336283
"[0, 1, 1, 0, 0, 1, 1, 1, 1, 0, 0, 0, 1, 1, 0]",211,125,86,15,13,0.12,0.1511627906976744
"[0, 0, 0, 0, 1, 1, 1, 1, 0, 0, 1, 0, 1, 0, 1]",234,119,115,13,15,0.1092436974789916,0.13043478260869565
"[1, 0, 0, 0, 1, 0, 1, 1, 0, 1, 1, 0, 0, 1, 0]",112,60,52,3,8,0.05,0.15384615384615385
"[1, 0, 0, 0, 0, 0, 1, 1, 0, 1, 0, 0, 1, 0, 0]",252,155,97,14,5,0.09032258064516129,0.05154639175257732
"[1, 1, 0, 1, 0, 1, 1, 0, 0, 0, 1, 1, 1, 0, 0]",128,59,69,4,10,0.06779661016949153,0.14492753623188406
"[0, 0, 1, 1, 0, 1, 1, 0, 1, 0, 0, 0, 0, 1, 0]",143,94,49,12,5,0.1276595744680851,0.10204081632653061
"[1, 1, 0, 0, 1, 1, 1, 0, 0, 0, 0, 1, 1, 0, 0]",294,133,161,19,11,0.14285714285714285,0.06832298136645963
"[0, 1, 1, 0, 0, 0, 1, 1, 0, 0, 0, 0, 1, 0, 0]",286,186,100,9,6,0.04838709677419355,0.06
"[1, 1, 1, 0, 1, 1, 1, 0, 1, 0, 0, 0, 0, 0, 0]",183,90,93,7,10,0.07777777777777778,0.10752688172043011
"[0, 1, 0, 0, 0, 1, 1, 1, 1, 0, 1, 0, 1, 1, 0]",100,47,53,8,3,0.1702127659574468,0.05660377358490566
"[1, 0, 0, 1, 1, 0, 0, 1, 1, 0, 0, 1, 1, 1, 0]",327,72,255,6,20,0.08333333333333333,0.0784313725490196
"[0, 1, 1, 0, 0, 1, 1, 0, 1, 0, 0, 0, 0, 0, 1]",180,114,66,10,7,0.08771929824561403,0.10606060606060606
"[1, 1, 1, 1, 0, 1, 0, 1, 1, 0, 1, 0, 1, 0, 0]",129,53,76,6,7,0.11320754716981132,0.09210526315789473
"[0, 1, 1, 0, 0, 1, 0, 0, 0, 1, 0, 1, 1, 0, 1]",95,60,35,5,4,0.08333333333333333,0.11428571428571428
"[0, 1, 1, 1, 0, 0, 1, 0, 0, 1, 1, 0, 0, 1, 1]",211,106,105,12,10,0.11320754716981132,0.09523809523809523
"[0, 1, 0, 0, 1, 0, 1, 0, 0, 0, 0, 1, 1, 1, 1]",219,129,90,14,11,0.10852713178294573,0.12222222222222222
"[1, 0, 1, 1, 1, 1, 1, 1, 1, 0, 0, 0, 1, 1, 0]",294,104,190,8,19,0.07692307692307693,0.1
"[1, 1, 1, 0, 0, 0, 1, 1, 1, 0, 1, 0, 1, 0, 1]",147,66,81,3,10,0.045454545454545456,0.12345679012345678
"[0, 0, 1, 0, 0, 1, 1, 0, 1, 0, 1, 1, 1, 0, 0]",133,64,69,5,6,0.078125,0.08695652173913043
"[1, 1, 0, 1, 0, 0, 1, 0, 0, 1, 1, 0, 1, 0, 1]",103,45,58,5,3,0.1111111111111111,0.05172413793103448
"[1, 0, 1, 1, 1, 1, 1, 1, 0, 1, 0, 1, 0, 1, 0]",215,65,150,9,22,0.13846153846153847,0.14666666666666667
"[0, 0, 1, 0, 0, 0, 1, 0, 1, 0, 1, 1, 0, 0, 1]",151,87,64,12,7,0.13793103448275862,0.109375
"[0, 0, 0, 1, 0, 0, 0, 1, 0, 1, 0, 1, 1, 0, 0]",234,140,94,16,11,0.11428571428571428,0.11702127659574468
"[0, 1, 0, 1, 0, 1, 1, 0, 0, 0, 1, 0, 0, 1, 1]",109,59,50,8,4,0.13559322033898305,0.08
"[0, 0, 0, 1, 0, 0, 1, 1, 0, 1, 1, 1, 1, 1, 0]",118,64,54,7,6,0.109375,0.1111111111111111
"[1, 1, 0, 0, 0, 1, 0, 1, 1, 1, 0, 1, 1, 0, 0]",126,50,76,5,8,0.1,0.10526315789473684
"[1, 0, 0, 1, 1, 0, 0, 1, 0, 1, 1, 0, 1, 0, 0]",110,49,61,5,7,0.10204081632653061,0.11475409836065574
"[1, 0, 1, 0, 1, 1, 1, 0, 0, 1, 1, 1, 0, 1, 1]",281,101,180,11,20,0.10891089108910891,0.1111111111111111
"[0, 0, 0, 1, 1, 1, 1, 0, 1, 0, 0, 0, 1, 0, 0]",178,109,69,10,7,0.09174311926605505,0.10144927536231885
"[1, 1, 1, 0, 1, 0, 1, 0, 0, 0, 1, 0, 0, 0, 0]",157,95,62,5,6,0.05263157894736842,0.0967741935483871
"[1, 1, 0, 0, 0, 0, 0, 1, 0, 0, 1, 0, 0, 1, 1]",225,131,94,14,5,0.10687022900763359,0.05319148936170213
"[1, 1, 1, 1, 0, 0, 1, 0, 0, 0, 1, 0, 0, 0, 0]",185,100,85,9,8,0.09,0.09411764705882353
"[1, 1, 0, 1, 1, 0, 1, 0, 0, 0, 0, 0, 0, 0, 1]",197,108,89,11,4,0.10185185185185185,0.0449438202247191
"[1, 1, 1, 0, 1, 1, 0, 1, 0, 0, 0, 0, 0, 0, 0]",221,109,112,10,10,0.09174311926605505,0.08928571428571429
"[1, 1, 0, 0, 0, 1, 0, 1, 1, 1, 0, 1, 1, 0, 1]",156,78,78,9,6,0.11538461538461539,0.07692307692307693
"[1, 1, 1, 1, 0, 0, 0, 1, 0, 1, 1, 1, 0, 1, 1]",284,85,199,8,20,0.09411764705882353,0.10050251256281408
"[1, 0, 0, 0, 0, 1, 1, 0, 0, 1, 0, 0, 1, 1, 0]",197,100,97,5,7,0.05,0.07216494845360824
"[0, 0, 0, 1, 1, 1, 0, 1, 1, 1, 0, 0, 1, 1, 0]",165,81,84,8,7,0.09876543209876543,0.08333333333333333
"[1, 0, 1, 0, 0, 1, 1, 0, 1, 1, 0, 0, 1, 0, 0]",124,64,60,3,5,0.046875,0.08333333333333333
"[1, 1, 1, 1, 0, 0, 1, 0, 0, 0, 1, 0, 0, 1, 0]",114,51,63,4,9,0.0784313725490196,0.14285714285714285
"[0, 0, 1, 0, 1, 0, 1, 1, 0, 0, 1, 1, 1, 0, 1]",117,54,63,5,7,0.09259259259259259,0.1111111111111111
"[1, 0, 0, 1, 1, 1, 1, 0, 0, 1, 0, 1, 0, 1, 1]",241,64,177,6,11,0.09375,0.062146892655367235
"[1, 0, 0, 0, 0, 0, 1, 0, 1, 1, 1, 1, 1, 0, 1]",128,59,69,4,8,0.06779661016949153,0.11594202898550725
"[1, 0, 1, 1, 0, 1, 1, 0, 0, 1, 1, 0, 1, 0, 1]",149,70,79,7,9,0.1,0.11392405063291139
"[1, 1, 0, 1, 1, 0, 1, 0, 1, 1, 1, 1, 0, 0, 0]",229,105,124,8,12,0.0761904761904762,0.0967741935483871
"[0, 1, 0, 1, 1, 0, 1, 1, 0, 1, 0, 1, 1, 1, 1]",273,107,166,12,14,0.11214953271028037,0.08433734939759036
"[1, 0, 0, 0, 0, 0, 0, 1, 1, 1, 0, 0, 1, 1, 0]",264,136,128,11,12,0.08088235294117647,0.09375
"[1, 1, 0, 1, 1, 0, 1, 0, 0, 1, 0, 0, 1, 1, 1]",185,76,109,12,8,0.15789473684210525,0.07339449541284404
"[1, 0, 0, 0, 1, 1, 0, 0, 1, 0, 1, 0, 1, 1, 1]",127,52,75,3,8,0.057692307692307696,0.10666666666666667
"[1, 1, 0, 1, 1, 0, 1, 0, 1, 1, 0, 0, 0, 0, 0]",176,85,91,6,11,0.07058823529411765,0.12087912087912088
"[1, 0, 0, 1, 0, 1, 0, 0, 1, 1, 1, 1, 0, 1, 1]",162,66,96,9,8,0.13636363636363635,0.08333333333333333
"[0, 1, 0, 0, 0, 1, 1, 0, 1, 1, 1, 1, 0, 0, 1]",141,67,74,3,4,0.04477611940298507,0.05405405405405406
"[0, 1, 1, 1, 1, 1, 1, 0, 1, 0, 1, 1, 1, 0, 1]",534,176,358,11,40,0.0625,0.11173184357541899
"[1, 1, 0, 0, 0, 0, 1, 0, 0, 1, 1, 1, 0, 1, 0]",109,60,49,7,7,0.11666666666666667,0.14285714285714285
"[1, 1, 0, 1, 1, 1, 1, 1, 0, 1, 0, 0, 0, 0, 1]",162,70,92,7,6,0.1,0.06521739130434782
"[1, 0, 0, 1, 0, 0, 1, 1, 1, 0, 0, 1, 0, 1, 1]",135,74,61,5,9,0.06756756756756757,0.14754098360655737
"[0, 1, 0, 0, 1, 0, 0, 1, 1, 1, 0, 0, 1, 0, 1]",123,56,67,5,4,0.08928571428571429,0.05970149253731343
"[0, 1, 1, 0, 1, 0, 0, 1, 0, 0, 1, 1, 1, 0, 0]",137,78,59,7,6,0.08974358974358974,0.1016949152542373
"[1, 0, 0, 0, 1, 1, 1, 1, 0, 1, 0, 0, 0, 0, 0]",213,111,102,8,19,0.07207207207207207,0.18627450980392157
"[1, 1, 0, 1, 0, 0, 0, 0, 1, 1, 1, 0, 0, 1, 1]",173,74,99,10,9,0.13513513513513514,0.09090909090909091
"[0, 0, 1, 0, 1, 1, 0, 1, 0, 0, 1, 1, 1, 1, 1]",214,103,111,6,7,0.05825242718446602,0.06306306306306306
"[1, 1, 0, 0, 1, 0, 1, 0, 0, 1, 1, 1, 0, 1, 1]",154,53,101,4,12,0.07547169811320754,0.1188118811881188
"[1, 0, 1, 0, 0, 1, 1, 0, 0, 1, 0, 1, 0, 0, 1]",108,52,56,5,5,0.09615384615384616,0.08928571428571429
"[0, 1, 0, 0, 1, 0, 1, 0, 0, 0, 1, 0, 0, 0, 1]",208,133,75,18,5,0.13533834586466165,0.06666666666666667
"[1, 0, 1, 1, 0, 0, 0, 1, 1, 1, 0, 1, 0, 1, 1]",160,70,90,5,12,0.07142857142857142,0.13333333333333333
"[1, 1, 0, 1, 1, 0, 0, 1, 0, 1, 1, 1, 0, 1, 0]",119,51,68,3,4,0.058823529411764705,0.058823529411764705
"[0, 1, 0, 0, 0, 0, 1, 1, 1, 1, 0, 1, 1, 0, 0]",122,58,64,8,10,0.13793103448275862,0.15625
"[1, 1, 1, 0, 1, 1, 1, 1, 1, 0, 1, 0, 1, 0, 0]",265,86,179,8,19,0.09302325581395349,0.10614525139664804
"[0, 0, 0, 1, 0, 0, 0, 1, 0, 0, 1, 1, 1, 1, 0]",224,139,85,8,12,0.05755395683453238,0.1411764705882353
"[1, 0, 1, 1, 1, 1, 0, 1, 1, 0, 0, 1, 0, 1, 1]",244,81,163,10,15,0.12345679012345678,0.09202453987730061
"[0, 0, 0, 1, 0, 1, 1, 0, 0, 1, 1, 1, 1, 1, 1]",359,159,200,16,18,0.10062893081761007,0.09
"[0, 1, 0, 0, 0, 0, 1, 1, 0, 0, 1, 1, 1, 0, 1]",145,73,72,10,7,0.136986301369863,0.09722222222222222
"[0, 1, 0, 0, 0, 0, 0, 0, 1, 1, 0, 1, 0, 0, 1]",260,168,92,9,12,0.05357142857142857,0.13043478260869565
"[0, 0, 0, 1, 1, 0, 0, 0, 0, 0, 1, 1, 1, 0, 0]",332,228,104,24,7,0.10526315789473684,0.0673076923076923
"[0, 0, 1, 1, 0, 1, 1, 1, 1, 0, 1, 0, 1, 0, 1]",153,56,97,8,8,0.14285714285714285,0.08247422680412371
"[0, 0, 0, 0, 1, 0, 1, 0, 1, 0, 0, 1, 1, 1, 1]",207,118,89,7,9,0.059322033898305086,0.10112359550561797
"[1, 1, 0, 0, 1, 0, 0, 1, 0, 0, 0, 1, 0, 0, 1]",147,83,64,8,4,0.0963855421686747,0.0625
"[1, 1, 0, 1, 1, 1, 0, 0, 1, 0, 0, 1, 0, 0, 0]",129,59,70,3,5,0.05084745762711865,0.07142857142857142
"[0, 1, 1, 0, 1, 1, 0, 0, 1, 0, 1, 0, 1, 0, 1]",100,51,49,4,5,0.0784313725490196,0.10204081632653061
"[0, 0, 0, 0, 1, 0, 0, 0, 1, 1, 1, 1, 0, 0, 1]",287,179,108,18,7,0.1005586592178771,0.06481481481481481
"[0, 0, 0, 0, 0, 0, 1, 1, 1, 1, 1, 0, 0, 0, 1]",300,176,124,21,14,0.11931818181818182,0.11290322580645161
"[1, 1, 0, 1, 1, 0, 0, 1, 1, 0, 1, 0, 0, 1, 1]",179,83,96,6,10,0.07228915662650602,0.10416666666666667
"[1, 0, 0, 1, 0, 0, 0, 0, 0, 1, 0, 1, 0, 0, 1]",248,154,94,15,7,0.09740259740259741,0.07446808510638298
"[0, 0, 0, 0, 1, 0, 1, 1, 0, 1, 1, 1, 1, 1, 0]",138,70,68,8,2,0.11428571428571428,0.029411764705882353
"[1, 1, 0, 1, 1, 1, 0, 0, 0, 1, 0, 0, 1, 1, 0]",122,59,63,2,9,0.03389830508474576,0.14285714285714285
"[0, 0, 0, 1, 0, 0, 0, 0, 1, 0, 1, 1, 0, 1, 0]",214,134,80,11,6,0.08208955223880597,0.075
"[0, 1, 1, 1, 1, 1, 0, 1, 0, 1, 0, 1, 0, 0, 0]",126,61,65,8,5,0.13114754098360656,0.07692307692307693
"[0, 0, 1, 1, 0, 0, 0, 0, 1, 0, 0, 0, 0, 1, 0]",659,443,216,45,18,0.10158013544018059,0.08333333333333333
"[1, 0, 0, 0, 1, 0, 1, 1, 1, 0, 1, 1, 0, 0, 1]",124,52,72,5,5,0.09615384615384616,0.06944444444444445
"[0, 1, 1, 1, 0, 0, 0, 0, 1, 1, 0, 1, 0, 1, 1]",150,71,79,6,8,0.08450704225352113,0.10126582278481013
"[0, 1, 1, 0, 0, 1, 0, 0, 1, 1, 1, 0, 0, 0, 0]",217,144,73,14,3,0.09722222222222222,0.0410958904109589
"[1, 1, 0, 1, 0, 1, 0, 1, 0, 0, 1, 1, 0, 0, 1]",139,65,74,9,6,0.13846153846153847,0.08108108108108109
"[0, 0, 0, 0, 1, 1, 0, 1, 0, 1, 0, 1, 0, 0, 1]",145,86,59,7,9,0.08139534883720931,0.15254237288135594
"[1, 1, 1, 0, 0, 0, 1, 0, 0, 1, 1, 1, 0, 0, 0]",138,62,76,3,7,0.04838709677419355,0.09210526315789473
"[0, 0, 1, 1, 1, 1, 0, 0, 1, 0, 1, 1, 0, 0, 0]",173,97,76,14,8,0.14432989690721648,0.10526315789473684
"[1, 1, 1, 1, 1, 1, 0, 1, 0, 1, 0, 0, 1, 0, 0]",173,74,99,10,7,0.13513513513513514,0.0707070707070707
"[1, 0, 0, 0, 0, 0, 0, 0, 1, 1, 0, 0, 0, 1, 1]",471,269,202,27,15,0.10037174721189591,0.07425742574257425
"[1, 0, 1, 0, 0, 0, 0, 1, 0, 0, 1, 1, 1, 0, 1]",115,59,56,5,2,0.0847457627118644,0.03571428571428571
"[0, 1, 1, 0, 0, 0, 1, 0, 0, 0, 1, 1, 1, 0, 1]",104,51,53,3,5,0.058823529411764705,0.09433962264150944
"[1, 0, 0, 1, 1, 0, 1, 1, 0, 0, 0, 0, 1, 1, 1]",297,121,176,5,21,0.04132231404958678,0.11931818181818182
"[0, 0, 1, 1, 1, 0, 1, 1, 1, 1, 0, 1, 1, 0, 0]",160,60,100,4,12,0.06666666666666667,0.12
"[1, 0, 1, 0, 1, 1, 1, 0, 1, 1, 1, 0, 1, 1, 0]",253,90,163,10,15,0.1111111111111111,0.09202453987730061
"[1, 0, 0, 1, 0, 1, 1, 0, 0, 1, 0, 0, 0, 1, 0]",109,59,50,8,3,0.13559322033898305,0.06
"[0, 1, 1, 0, 0, 0, 1, 1, 0, 1, 1, 0, 0, 1, 1]",186,102,84,9,8,0.08823529411764706,0.09523809523809523
"[1, 0, 1, 1, 0, 0, 0, 1, 1, 0, 1, 1, 0, 0, 1]",124,59,65,4,5,0.06779661016949153,0.07692307692307693
"[0, 0, 1, 1, 1, 1, 0, 0, 1, 1, 1, 0, 0, 0, 0]",279,159,120,13,13,0.08176100628930817,0.10833333333333334
"[1, 1, 0, 0, 1, 0, 0, 1, 0, 0, 0, 1, 0, 1, 1]",127,57,70,6,8,0.10526315789473684,0.11428571428571428
"[1, 1, 1, 1, 1, 1, 0, 0, 1, 0, 0, 1, 0, 0, 0]",175,73,102,6,10,0.0821917808219178,0.09803921568627451
"[0, 0, 0, 1, 0, 1, 0, 1, 1, 1, 1, 1, 0, 0, 0]",163,98,65,6,10,0.061224489795918366,0.15384615384615385
"[0, 1, 0, 1, 1, 1, 0, 1, 1, 0, 0, 0, 0, 1, 0]",105,55,50,8,4,0.14545454545454545,0.08
"[0, 0, 1, 1, 0, 0, 1, 0, 1, 0, 1, 1, 0, 1, 1]",135,59,76,7,3,0.11864406779661017,0.039473684210526314
"[1, 0, 1, 0, 1, 0, 1, 1, 0, 0, 0, 1, 0, 0, 1]",98,50,48,3,4,0.06,0.08333333333333333
"[0, 0, 1, 1, 0, 1, 0, 0, 1, 0, 1, 1, 0, 1, 0]",119,60,59,7,2,0.11666666666666667,0.03389830508474576
"[1, 0, 0, 0, 0, 1, 0, 1, 1, 0, 1, 0, 0, 1, 1]",143,70,73,4,8,0.05714285714285714,0.1095890410958904
"[0, 1, 1, 1, 0, 0, 0, 0, 0, 0, 0, 0, 1, 0, 1]",300,191,109,19,10,0.09947643979057591,0.09174311926605505
"[0, 0, 1, 0, 0, 0, 0, 1, 0, 1, 1, 1, 0, 1, 1]",129,70,59,10,9,0.14285714285714285,0.15254237288135594
"[0, 0, 0, 0, 1, 0, 0, 1, 0, 1, 1, 0, 0, 1, 0]",216,146,70,17,4,0.11643835616438356,0.05714285714285714
"[0, 1, 0, 0, 0, 1, 0, 0, 0, 0, 1, 1, 0, 0, 1]",373,238,135,23,10,0.09663865546218488,0.07407407407407407
"[1, 1, 1, 1, 0, 0, 0, 1, 0, 1, 1, 0, 1, 1, 1]",382,153,229,17,21,0.1111111111111111,0.09170305676855896
"[0, 1, 0, 0, 1, 0, 0, 1, 1, 1, 1, 0, 1, 1, 1]",170,71,99,11,12,0.15492957746478872,0.12121212121212122
"[1, 1, 1, 0, 0, 1, 0, 1, 1, 1, 0, 1, 0, 0, 0]",113,41,72,3,6,0.07317073170731707,0.08333333333333333
"[0, 1, 1, 0, 0, 1, 0, 1, 1, 0, 1, 0, 1, 1, 1]",173,82,91,6,4,0.07317073170731707,0.04395604395604396
"[1, 0, 1, 0, 1, 1, 1, 0, 0, 0, 0, 1, 1, 1, 0]",134,63,71,6,5,0.09523809523809523,0.07042253521126761
"[1, 0, 0, 1, 0, 1, 0, 1, 0, 1, 1, 1, 0, 0, 0]",134,62,72,8,3,0.12903225806451613,0.041666666666666664
"[0, 1, 1, 0, 0, 1, 1, 0, 1, 0, 1, 0, 1, 1, 1]",223,133,90,10,5,0.07518796992481203,0.05555555555555555
"[1, 0, 0, 0, 0, 0, 1, 0, 1, 0, 0, 1, 0, 0, 1]",244,153,91,12,8,0.0784313725490196,0.08791208791208792
"[1, 1, 1, 1, 0, 0, 1, 0, 1, 0, 0, 0, 1, 0, 0]",115,64,51,4,12,0.0625,0.23529411764705882
"[1, 1, 1, 0, 1, 1, 1, 1, 0, 0, 1, 0, 1, 0, 0]",140,57,83,5,5,0.08771929824561403,0.060240963855421686
"[0, 1, 0, 1, 1, 1, 1, 0, 1, 0, 0, 0, 1, 1, 0]",134,70,64,7,10,0.1,0.15625
"[0, 0, 1, 1, 1, 1, 0, 1, 0, 0, 1, 1, 0, 1, 0]",108,51,57,6,8,0.11764705882352941,0.14035087719298245
"[1, 0, 0, 1, 0, 1, 0, 0, 0, 1, 1, 1, 1, 1, 0]",122,56,66,9,5,0.16071428571428573,0.07575757575757576
"[0, 0, 0, 1, 0, 1, 1, 0, 0, 1, 1, 1, 0, 1, 0]",122,64,58,5,5,0.078125,0.08620689655172414
"[1, 0, 1, 0, 0, 0, 0, 1, 0, 1, 0, 0, 1, 1, 0]",162,88,74,2,4,0.022727272727272728,0.05405405405405406
"[0, 1, 0, 1, 1, 1, 1, 0, 1, 1, 1, 1, 0, 1, 0]",234,96,138,5,12,0.052083333333333336,0.08695652173913043
"[1, 0, 0, 0, 0, 1, 0, 1, 0, 1, 1, 1, 1, 0, 1]",109,49,60,5,3,0.10204081632653061,0.05
"[0, 1, 0, 1, 0, 1, 1, 0, 0, 0, 0, 0, 0, 1, 0]",250,166,84,15,12,0.09036144578313253,0.14285714285714285
"[1, 0, 1, 0, 1, 1, 0, 1, 1, 0, 0, 0, 1, 1, 0]",107,43,64,5,5,0.11627906976744186,0.078125
"[1, 0, 1, 0, 0, 0, 0, 1, 1, 0, 1, 0, 1, 0, 1]",110,67,43,4,5,0.05970149253731343,0.11627906976744186
"[1, 0, 0, 0, 1, 0, 0, 0, 0, 1, 0, 1, 1, 0, 0]",260,150,110,16,14,0.10666666666666667,0.12727272727272726
"[0, 1, 0, 0, 0, 1, 1, 1, 0, 1, 1, 0, 1, 1, 1]",176,81,95,7,11,0.08641975308641975,0.11578947368421053
"[0, 0, 1, 0, 0, 1, 0, 1, 1, 1, 1, 0, 1, 0, 1]",104,45,59,2,7,0.044444444444444446,0.11864406779661017
"[0, 0, 0, 0, 1, 1, 0, 0, 1, 0, 0, 1, 0, 1, 1]",239,143,96,18,11,0.1258741258741259,0.11458333333333333
"[1, 0, 0, 1, 1, 0, 0, 0, 0, 1, 0, 0, 1, 1, 0]",217,95,122,12,5,0.12631578947368421,0.040983606557377046
"[1, 1, 0, 0, 1, 0, 0, 1, 0, 0, 0, 1, 1, 1, 0]",112,56,56,7,7,0.125,0.125
"[1, 1, 1, 0, 0, 1, 0, 0, 1, 0, 0, 0, 1, 1, 1]",176,67,109,6,7,0.08955223880597014,0.06422018348623854
"[1, 1, 0, 1, 1, 1, 0, 1, 0, 1, 1, 1, 0, 0, 1]",277,94,183,7,13,0.07446808510638298,0.07103825136612021
"[1, 0, 1, 1, 1, 0, 1, 0, 0, 1, 0, 0, 1, 1, 0]",110,46,64,1,1,0.021739130434782608,0.015625
"[0, 1, 0, 1, 1, 0, 0, 0, 1, 0, 0, 0, 0, 1, 1]",223,146,77,9,7,0.06164383561643835,0.09090909090909091
"[0, 0, 1, 0, 1, 0, 1, 1, 0, 0, 1, 0, 1, 1, 0]",139,73,66,5,5,0.0684931506849315,0.07575757575757576
"[1, 0, 1, 0, 1, 1, 1, 0, 1, 1, 1, 1, 0, 0, 1]",300,121,179,9,17,0.0743801652892562,0.09497206703910614
"[1, 0, 1, 0, 0, 1, 0, 1, 1, 0, 0, 0, 0, 0, 1]",162,97,65,8,7,0.08247422680412371,0.1076923076923077
"[0, 1, 0, 1, 1, 0, 0, 1, 0, 1, 0, 0, 1, 0, 1]",84,45,39,1,4,0.022222222222222223,0.10256410256410256
"[0, 1, 1, 0, 1, 0, 0, 0, 1, 0, 0, 1, 0, 1, 1]",89,50,39,5,3,0.1,0.07692307692307693
"[1, 0, 0, 0, 1, 1, 1, 0, 1, 1, 0, 0, 1, 0, 1]",90,42,48,3,7,0.07142857142857142,0.14583333333333334
"[0, 1, 0, 1, 0, 0, 0, 1, 1, 1, 0, 0, 1, 0, 0]",137,82,55,7,4,0.08536585365853659,0.07272727272727272
"[0, 1, 0, 0, 0, 0, 1, 0, 0, 0, 1, 1, 1, 0, 0]",271,186,85,17,8,0.0913978494623656,0.09411764705882353
"[0, 1, 1, 0, 0, 1, 1, 0, 0, 0, 1, 0, 1, 0, 0]",201,147,54,15,7,0.10204081632653061,0.12962962962962962
"[1, 1, 1, 1, 0, 0, 0, 1, 1, 0, 1, 1, 1, 0, 1]",265,92,173,10,25,0.10869565217391304,0.14450867052023122
"[1, 1, 1, 1, 0, 0, 0, 1, 1, 1, 0, 0, 1, 1, 0]",212,90,122,12,10,0.13333333333333333,0.08196721311475409
"[1, 0, 1, 1, 1, 0, 1, 0, 0, 0, 0, 1, 0, 0, 0]",154,92,62,6,6,0.06521739130434782,0.0967741935483871
"[0, 0, 1, 1, 0, 1, 0, 0, 1, 1, 0, 0, 1, 0, 1]",137,74,63,13,6,0.17567567567567569,0.09523809523809523
"[0, 0, 0, 1, 1, 0, 1, 0, 0, 1, 1, 0, 0, 1, 0]",166,96,70,13,12,0.13541666666666666,0.17142857142857143
"[1, 0, 1, 1, 1, 0, 0, 1, 0, 0, 1, 0, 1, 0, 0]",97,58,39,4,3,0.06896551724137931,0.07692307692307693
"[0, 0, 1, 1, 1, 0, 1, 0, 0, 0, 1, 1, 0, 1, 1]",116,63,53,10,4,0.15873015873015872,0.07547169811320754
"[1, 1, 0, 0, 1, 0, 0, 0, 0, 0, 0, 1, 0, 0, 1]",300,221,79,29,9,0.13122171945701358,0.11392405063291139
"[1, 1, 1, 1, 0, 1, 0, 0, 1, 0, 1, 0, 0, 0, 0]",126,53,73,7,5,0.1320754716981132,0.0684931506849315
"[1, 0, 1, 0, 0, 1, 0, 1, 1, 0, 1, 0, 1, 0, 1]",93,41,52,6,5,0.14634146341463414,0.09615384615384616
"[0, 0, 1, 0, 1, 0, 1, 0, 0, 1, 0, 1, 1, 0, 1]",113,62,51,4,5,0.06451612903225806,0.09803921568627451
"[1, 0, 0, 0, 0, 0, 1, 0, 1, 0, 1, 0, 0, 1, 0]",229,145,84,13,9,0.0896551724137931,0.10714285714285714
"[0, 1, 1, 1, 1, 0, 1, 1, 1, 1, 0, 0, 0, 0, 1]",286,103,183,6,12,0.05825242718446602,0.06557377049180328
"[0, 1, 0, 0, 1, 1, 1, 1, 0, 1, 1, 1, 1, 0, 0]",206,85,121,6,13,0.07058823529411765,0.10743801652892562
"[1, 1, 1, 0, 1, 1, 1, 0, 1, 0, 1, 0, 1, 1, 0]",233,80,153,9,11,0.1125,0.0718954248366013
"[1, 1, 1, 1, 1, 0, 1, 1, 0, 1, 0, 0, 0, 0, 0]",185,71,114,9,12,0.1267605633802817,0.10526315789473684
"[1, 0, 1, 0, 0, 1, 1, 0, 1, 0, 1, 1, 1, 1, 1]",298,112,186,6,20,0.05357142857142857,0.10752688172043011
"[1, 1, 1, 1, 1, 1, 0, 1, 0, 0, 1, 0, 0, 0, 1]",153,68,85,4,13,0.058823529411764705,0.15294117647058825
"[1, 1, 0, 1, 1, 1, 0, 0, 0, 0, 1, 0, 0, 1, 1]",137,66,71,12,8,0.18181818181818182,0.11267605633802817
"[0, 0, 0, 1, 0, 0, 1, 0, 0, 1, 1, 1, 0, 0, 1]",157,96,61,6,5,0.0625,0.08196721311475409
"[0, 1, 1, 0, 0, 1, 0, 0, 0, 1, 1, 0, 0, 0, 1]",178,111,67,14,6,0.12612612612612611,0.08955223880597014
"[0, 0, 0, 0, 0, 1, 1, 1, 0, 0, 1, 1, 0, 1, 0]",153,106,47,13,8,0.12264150943396226,0.1702127659574468
"[1, 1, 0, 0, 1, 1, 0, 1, 1, 0, 0, 1, 0, 1, 1]",190,70,120,5,7,0.07142857142857142,0.058333333333333334
"[1, 0, 0, 1, 1, 0, 0, 0, 1, 1, 0, 1, 0, 1, 0]",124,57,67,4,11,0.07017543859649122,0.16417910447761194
"[0, 1, 0, 1, 0, 0, 1, 1, 0, 0, 0, 1, 1, 0, 1]",127,66,61,7,10,0.10606060606060606,0.16393442622950818
"[1, 0, 0, 1, 0, 0, 0, 1, 1, 1, 1, 0, 0, 1, 1]",287,99,188,8,16,0.08080808080808081,0.0851063829787234
"[1, 0, 1, 0, 1, 1, 0, 0, 0, 1, 1, 0, 0, 0, 0]",219,120,99,15,4,0.125,0.04040404040404041
"[1, 1, 0, 1, 1, 1, 0, 1, 0, 1, 1, 0, 0, 1, 0]",154,56,98,5,11,0.08928571428571429,0.11224489795918367
"[1, 1, 0, 1, 0, 1, 1, 1, 1, 0, 1, 1, 0, 0, 0]",181,71,110,11,9,0.15492957746478872,0.08181818181818182
"[0, 1, 0, 1, 0, 0, 0, 0, 1, 1, 0, 1, 1, 0, 0]",177,97,80,12,7,0.12371134020618557,0.0875
"[1, 0, 1, 1, 0, 1, 0, 0, 1, 1, 1, 1, 1, 1, 0]",340,119,221,10,15,0.08403361344537816,0.06787330316742081
"[1, 0, 1, 1, 0, 0, 0, 1, 0, 1, 1, 0, 1, 0, 0]",138,80,58,5,5,0.0625,0.08620689655172414
"[1, 1, 0, 1, 1, 0, 0, 0, 1, 0, 0, 1, 1, 0, 1]",86,45,41,4,4,0.08888888888888889,0.0975609756097561
"[1, 0, 1, 0, 0, 0, 1, 1, 0, 1, 1, 0, 0, 1, 0]",98,51,47,2,3,0.0392156862745098,0.06382978723404255
"[1, 0, 0, 0, 0, 1, 0, 1, 1, 1, 0, 0, 0, 0, 1]",192,95,97,9,9,0.09473684210526316,0.09278350515463918
"[1, 0, 1, 0, 0, 1, 0, 1, 0, 1, 1, 1, 1, 1, 1]",284,92,192,5,18,0.05434782608695652,0.09375
"[0, 0, 1, 0, 1, 0, 0, 1, 0, 1, 0, 1, 1, 1, 1]",138,73,65,8,5,0.1095890410958904,0.07692307692307693
"[0, 1, 1, 1, 0, 0, 1, 1, 0, 0, 1, 1, 1, 0, 1]",184,77,107,6,8,0.07792207792207792,0.07476635514018691
"[0, 1, 0, 1, 0, 0, 1, 0, 1, 0, 0, 0, 0, 1, 1]",181,101,80,4,7,0.039603960396039604,0.0875
"[1, 1, 0, 1, 0, 1, 0, 0, 1, 1, 1, 0, 1, 1, 0]",151,68,83,14,3,0.20588235294117646,0.03614457831325301
"[1, 0, 1, 0, 0, 1, 1, 0, 0, 0, 1, 0, 1, 1, 1]",134,66,68,5,6,0.07575757575757576,0.08823529411764706
"[0, 0, 1, 1, 1, 0, 1, 0, 1, 0, 1, 0, 0, 1, 1]",127,52,75,3,7,0.057692307692307696,0.09333333333333334
"[1, 1, 0, 0, 0, 1, 1, 1, 0, 1, 0, 1, 0, 1, 0]",102,47,55,10,4,0.2127659574468085,0.07272727272727272
"[0, 0, 1, 0, 1, 0, 1, 0, 0, 0, 1, 1, 1, 0, 1]",106,51,55,7,7,0.13725490196078433,0.12727272727272726
"[1, 1, 0, 1, 1, 0, 0, 1, 0, 1, 0, 1, 0, 0, 0]",133,75,58,4,4,0.05333333333333334,0.06896551724137931
"[1, 0, 0, 0, 1, 1, 0, 0, 1, 0, 1, 1, 0, 1, 1]",123,55,68,3,8,0.05454545454545454,0.11764705882352941
"[0, 1, 0, 1, 0, 0, 0, 1, 1, 0, 0, 0, 1, 1, 0]",172,111,61,7,8,0.06306306306306306,0.13114754098360656
"[1, 1, 0, 1, 0, 1, 0, 0, 0, 1, 1, 0, 0, 0, 1]",102,48,54,4,7,0.08333333333333333,0.12962962962962962
"[1, 0, 0, 0, 1, 1, 1, 0, 0, 0, 0, 0, 1, 1, 1]",230,109,121,9,12,0.08256880733944955,0.09917355371900827
"[0, 1, 1, 1, 0, 0, 0, 1, 0, 0, 0, 1, 1, 1, 1]",171,84,87,13,7,0.15476190476190477,0.08045977011494253
"[1, 1, 0, 0, 0, 1, 0, 0, 1, 1, 1, 0, 0, 0, 1]",131,74,57,4,5,0.05405405405405406,0.08771929824561403
"[0, 1, 0, 1, 1, 1, 0, 1, 1, 0, 1, 1, 0, 0, 1]",170,77,93,2,5,0.025974025974025976,0.053763440860215055
"[1, 1, 0, 1, 0, 1, 0, 1, 0, 1, 0, 0, 0, 1, 0]",109,65,44,9,8,0.13846153846153847,0.18181818181818182
"[1, 0, 0, 1, 0, 1, 1, 1, 1, 1, 1, 0, 0, 0, 1]",179,68,111,5,14,0.07352941176470588,0.12612612612612611
"[0, 1, 0, 1, 1, 0, 1, 1, 0, 1, 1, 0, 0, 0, 0]",123,68,55,6,5,0.08823529411764706,0.09090909090909091
"[1, 0, 0, 1, 0, 1, 1, 0, 0, 1, 0, 1, 1, 0, 0]",115,63,52,5,5,0.07936507936507936,0.09615384615384616
"[0, 0, 1, 0, 0, 0, 1, 1, 0, 1, 1, 1, 1, 0, 0]",155,98,57,8,5,0.08163265306122448,0.08771929824561403
"[0, 1, 1, 0, 0, 0, 1, 0, 1, 0, 1, 1, 0, 1, 1]",146,73,73,8,11,0.1095890410958904,0.1506849315068493
"[1, 0, 1, 1, 1, 1, 0, 1, 0, 0, 1, 1, 1, 0, 0]",148,59,89,4,9,0.06779661016949153,0.10112359550561797
"[0, 1, 0, 1, 0, 0, 0, 1, 1, 1, 0, 1, 0, 0, 1]",122,67,55,6,6,0.08955223880597014,0.10909090909090909
"[0, 1, 1, 1, 1, 0, 0, 0, 0, 1, 0, 0, 1, 1, 1]",315,219,96,21,8,0.0958904109589041,0.08333333333333333
"[0, 0, 1, 0, 1, 0, 1, 1, 0, 1, 1, 0, 1, 1, 1]",152,73,79,6,10,0.0821917808219178,0.12658227848101267
"[1, 1, 0, 0, 0, 1, 0, 1, 1, 1, 1, 0, 1, 0, 0]",114,50,64,2,6,0.04,0.09375
"[0, 0, 1, 0, 0, 1, 1, 1, 0, 1, 1, 1, 1, 1, 0]",155,58,97,3,11,0.05172413793103448,0.1134020618556701
"[1, 0, 0, 1, 0, 1, 1, 1, 0, 0, 0, 1, 0, 0, 1]",101,45,56,2,9,0.044444444444444446,0.16071428571428573
"[0, 1, 1, 0, 0, 0, 1, 1, 0, 1, 1, 0, 1, 1, 1]",193,89,104,7,9,0.07865168539325842,0.08653846153846154
"[0, 1, 1, 0, 1, 0, 1, 0, 0, 1, 1, 1, 1, 0, 0]",191,87,104,6,10,0.06896551724137931,0.09615384615384616
"[1, 1, 0, 0, 0, 0, 0, 1, 1, 1, 1, 1, 0, 0, 0]",203,102,101,5,7,0.049019607843137254,0.06930693069306931
"[1, 0, 1, 0, 0, 1, 0, 0, 1, 0, 0, 0, 1, 0, 1]",130,78,52,6,5,0.07692307692307693,0.09615384615384616
"[0, 0, 0, 1, 1, 1, 1, 1, 1, 0, 1, 0, 1, 1, 0]",193,99,94,3,7,0.030303030303030304,0.07446808510638298
"[0, 1, 0, 1, 1, 0, 0, 1, 1, 0, 0, 1, 0, 0, 1]",129,78,51,6,2,0.07692307692307693,0.0392156862745098
"[1, 0, 1, 1, 0, 1, 1, 0, 0, 1, 1, 1, 0, 1, 1]",262,91,171,5,13,0.054945054945054944,0.07602339181286549
"[1, 0, 1, 0, 1, 1, 0, 1, 1, 1, 0, 1, 1, 0, 0]",138,55,83,5,10,0.09090909090909091,0.12048192771084337
"[1, 0, 1, 0, 0, 0, 1, 1, 0, 0, 0, 1, 1, 1, 0]",108,57,51,4,3,0.07017543859649122,0.058823529411764705
"[1, 1, 1, 1, 0, 1, 0, 1, 1, 1, 0, 0, 1, 0, 0]",147,79,68,3,7,0.0379746835443038,0.10294117647058823
"[1, 1, 0, 0, 1, 1, 1, 0, 0, 0, 1, 0, 1, 0, 0]",118,66,52,6,4,0.09090909090909091,0.07692307692307693
"[1, 0, 1, 1, 1, 0, 0, 0, 0, 1, 0, 1, 0, 1, 0]",103,50,53,7,1,0.14,0.018867924528301886
"[0, 1, 0, 0, 1, 1, 0, 1, 1, 1, 0, 0, 0, 0, 1]",139,62,77,4,11,0.06451612903225806,0.14285714285714285
"[0, 1, 0, 1, 1, 1, 0, 1, 1, 0, 0, 0, 0, 0, 0]",227,123,104,11,8,0.08943089430894309,0.07692307692307693
"[1, 1, 0, 1, 1, 1, 0, 0, 0, 0, 0, 1, 0, 0, 1]",142,73,69,8,4,0.1095890410958904,0.057971014492753624
"[1, 0, 1, 1, 1, 1, 1, 0, 1, 0, 0, 0, 1, 1, 0]",172,82,90,7,5,0.08536585365853659,0.05555555555555555
"[0, 1, 1, 1, 0, 1, 1, 0, 0, 0, 1, 0, 1, 1, 1]",157,72,85,6,8,0.08333333333333333,0.09411764705882353
"[0, 0, 1, 1, 1, 1, 0, 1, 1, 1, 0, 1, 0, 0, 1]",141,59,82,5,6,0.0847457627118644,0.07317073170731707
"[0, 0, 0, 0, 1, 0, 1, 0, 0, 1, 0, 1, 1, 1, 0]",144,84,60,9,5,0.10714285714285714,0.08333333333333333
"[1, 1, 0, 0, 1, 1, 0, 0, 1, 0, 0, 0, 0, 1, 0]",188,109,79,6,13,0.05504587155963303,0.16455696202531644
"[1, 0, 1, 1, 1, 0, 0, 1, 0, 0, 0, 1, 0, 1, 0]",103,54,49,10,5,0.18518518518518517,0.10204081632653061
"[0, 0, 0, 0, 0, 0, 1, 1, 0, 1, 0, 1, 1, 1, 1]",324,192,132,21,14,0.109375,0.10606060606060606
"[1, 1, 1, 0, 0, 0, 0, 0, 0, 1, 1, 0, 1, 0, 1]",224,76,148,9,8,0.11842105263157894,0.05405405405405406
"[1, 0, 0, 0, 0, 1, 0, 1, 1, 1, 1, 1, 0, 1, 0]",126,66,60,8,9,0.12121212121212122,0.15
"[1, 0, 0, 0, 0, 0, 0, 0, 1, 1, 1, 1, 1, 0, 1]",170,76,94,5,8,0.06578947368421052,0.0851063829787234
"[0, 0, 1, 0, 1, 1, 0, 1, 0, 0, 1, 0, 0, 1, 0]",123,70,53,13,0,0.18571428571428572,0.0
"[0, 1, 0, 1, 1, 0, 0, 0, 0, 0, 1, 1, 1, 1, 0]",217,113,104,9,11,0.07964601769911504,0.10576923076923077
"[1, 0, 0, 1, 0, 0, 1, 0, 0, 1, 1, 1, 0, 1, 1]",110,52,58,4,10,0.07692307692307693,0.1724137931034483
"[1, 0, 1, 0, 1, 0, 1, 0, 0, 1, 0, 1, 1, 1, 0]",101,58,43,7,4,0.1206896551724138,0.09302325581395349
"[1, 0, 1, 1, 1, 0, 0, 1, 0, 1, 0, 1, 1, 1, 0]",131,54,77,1,10,0.018518518518518517,0.12987012987012986
"[0, 1, 1, 0, 1, 0, 0, 1, 0, 0, 0, 0, 1, 0, 1]",146,92,54,5,8,0.05434782608695652,0.14814814814814814
"[0, 1, 0, 0, 0, 1, 1, 0, 0, 0, 1, 0, 1, 1, 0]",163,106,57,8,6,0.07547169811320754,0.10526315789473684
"[1, 1, 1, 0, 1, 1, 1, 0, 0, 0, 0, 1, 0, 0, 0]",121,57,64,6,8,0.10526315789473684,0.125
"[0, 1, 1, 1, 0, 1, 0, 0, 0, 1, 1, 0, 0, 0, 1]",101,61,40,6,3,0.09836065573770492,0.075
"[1, 1, 0, 1, 1, 1, 0, 0, 0, 1, 0, 1, 0, 0, 1]",123,54,69,3,6,0.05555555555555555,0.08695652173913043
"[0, 0, 0, 0, 0, 1, 0, 1, 0, 0, 0, 1, 1, 0, 1]",260,170,90,21,9,0.12352941176470589,0.1
"[0, 1, 1, 1, 0, 0, 0, 0, 1, 0, 0, 0, 0, 1, 0]",226,140,86,20,7,0.14285714285714285,0.08139534883720931
"[1, 1, 0, 0, 0, 1, 0, 0, 1, 1, 0, 1, 1, 0, 1]",107,46,61,6,8,0.13043478260869565,0.13114754098360656
"[0, 0, 0, 1, 0, 0, 1, 1, 1, 0, 1, 1, 1, 1, 1]",174,75,99,4,12,0.05333333333333334,0.12121212121212122
"[0, 1, 0, 0, 1, 1, 1, 0, 1, 0, 1, 1, 0, 1, 1]",146,61,85,9,8,0.14754098360655737,0.09411764705882353
"[0, 0, 1, 1, 1, 0, 1, 1, 1, 0, 1, 1, 0, 1, 0]",143,69,74,9,3,0.13043478260869565,0.04054054054054054
"[1, 1, 0, 1, 0, 0, 0, 1, 1, 0, 1, 1, 0, 1, 1]",152,72,80,12,8,0.16666666666666666,0.1
"[1, 0, 1, 0, 0, 0, 0, 0, 0, 0, 1, 0, 1, 1, 1]",244,164,80,12,9,0.07317073170731707,0.1125
"[1, 0, 0, 1, 0, 1, 1, 0, 0, 1, 0, 1, 0, 0, 1]",102,50,52,7,1,0.14,0.019230769230769232
"[0, 1, 1, 1, 0, 0, 1, 1, 1, 1, 0, 1, 1, 1, 0]",242,90,152,9,8,0.1,0.05263157894736842
"[1, 1, 0, 0, 1, 1, 1, 1, 0, 1, 1, 1, 0, 0, 1]",350,114,236,11,21,0.09649122807017543,0.08898305084745763
"[1, 1, 1, 0, 1, 1, 1, 1, 0, 0, 1, 0, 0, 0, 0]",165,75,90,4,2,0.05333333333333334,0.022222222222222223
"[1, 0, 1, 1, 0, 0, 0, 1, 1, 1, 1, 0, 1, 0, 1]",157,66,91,3,12,0.045454545454545456,0.13186813186813187
"[0, 1, 0, 1, 1, 1, 0, 1, 0, 1, 1, 1, 0, 0, 0]",130,57,73,4,6,0.07017543859649122,0.0821917808219178
"[0, 1, 1, 0, 0, 1, 1, 1, 1, 0, 1, 1, 0, 1, 0]",188,88,100,9,10,0.10227272727272728,0.1
"[0, 1, 1, 0, 0, 1, 1, 0, 1, 1, 0, 0, 0, 0, 1]",172,107,65,11,7,0.102803738317757,0.1076923076923077
"[1, 0, 0, 1, 0, 0, 0, 1, 1, 0, 1, 0, 1, 0, 0]",126,78,48,10,4,0.1282051282051282,0.08333333333333333
"[1, 0, 1, 1, 0, 1, 1, 0, 0, 0, 1, 1, 1, 1, 0]",201,87,114,9,12,0.10344827586206896,0.10526315789473684
"[0, 1, 0, 0, 0, 1, 0, 1, 0, 0, 1, 1, 0, 1, 0]",135,71,64,4,6,0.056338028169014086,0.09375
"[1, 1, 0, 1, 0, 1, 0, 1, 1, 0, 0, 0, 1, 0, 0]",104,61,43,6,6,0.09836065573770492,0.13953488372093023
"[0, 1, 0, 1, 1, 0, 1, 0, 0, 0, 1, 1, 1, 0, 1]",100,47,53,4,3,0.0851063829787234,0.05660377358490566
"[1, 0, 1, 1, 0, 1, 1, 1, 0, 1, 1, 0, 0, 0, 1]",135,49,86,10,5,0.20408163265306123,0.05813953488372093
"[1, 0, 1, 1, 1, 1, 0, 1, 0, 0, 0, 0, 0, 1, 1]",158,77,81,4,4,0.05194805194805195,0.04938271604938271
"[1, 0, 1, 1, 0, 1, 0, 0, 1, 0, 1, 0, 1, 0, 0]",117,49,68,8,9,0.16326530612244897,0.1323529411764706
"[1, 0, 1, 0, 0, 0, 1, 1, 0, 1, 0, 1, 1, 0, 1]",112,54,58,8,2,0.14814814814814814,0.034482758620689655
"[0, 1, 0, 1, 0, 1, 0, 0, 0, 1, 1, 0, 1, 0, 1]",88,49,39,4,3,0.08163265306122448,0.07692307692307693
"[1, 1, 0, 1, 0, 1, 0, 1, 1, 0, 1, 1, 0, 1, 0]",130,49,81,3,9,0.061224489795918366,0.1111111111111111
"[0, 1, 0, 0, 1, 0, 0, 0, 0, 0, 1, 1, 0, 1, 1]",171,108,63,13,4,0.12037037037037036,0.06349206349206349
"[1, 1, 0, 1, 1, 1, 0, 1, 0, 0, 0, 0, 0, 1, 1]",155,65,90,7,8,0.1076923076923077,0.08888888888888889
"[0, 1, 1, 1, 1, 0, 1, 1, 1, 0, 0, 1, 0, 1, 1]",238,90,148,10,19,0.1111111111111111,0.12837837837837837
"[0, 1, 0, 1, 1, 0, 0, 0, 0, 1, 0, 1, 1, 1, 0]",103,58,45,3,6,0.05172413793103448,0.13333333333333333
"[1, 1, 1, 1, 0, 1, 0, 0, 1, 0, 1, 0, 1, 1, 0]",143,59,84,7,12,0.11864406779661017,0.14285714285714285
"[1, 0, 0, 1, 0, 0, 1, 1, 1, 1, 1, 0, 0, 0, 0]",225,122,103,9,6,0.07377049180327869,0.05825242718446602
"[1, 0, 1, 0, 1, 0, 0, 1, 0, 0, 0, 1, 0, 0, 1]",137,88,49,7,9,0.07954545454545454,0.1836734693877551
"[0, 0, 0, 0, 1, 0, 1, 0, 1, 1, 1, 1, 0, 0, 1]",148,84,64,6,5,0.07142857142857142,0.078125
"[1, 0, 1, 0, 0, 0, 0, 1, 1, 0, 1, 0, 0, 1, 1]",118,69,49,4,5,0.057971014492753624,0.10204081632653061
"[0, 1, 1, 1, 0, 0, 0, 1, 0, 0, 0, 1, 0, 0, 1]",154,90,64,6,4,0.06666666666666667,0.0625
"[1, 0, 1, 0, 0, 0, 0, 1, 0, 1, 1, 0, 1, 0, 1]",105,62,43,6,4,0.0967741935483871,0.09302325581395349
"[1, 0, 0, 1, 0, 0, 1, 0, 1, 1, 0, 1, 0, 0, 0]",136,80,56,6,12,0.075,0.21428571428571427
"[0, 0, 1, 1, 0, 1, 0, 0, 1, 0, 0, 0, 0, 1, 1]",233,142,91,11,9,0.07746478873239436,0.0989010989010989
"[1, 1, 1, 0, 0, 1, 0, 1, 1, 0, 1, 1, 0, 0, 0]",144,67,77,7,9,0.1044776119402985,0.11688311688311688
"[0, 0, 1, 1, 1, 1, 1, 1, 1, 0, 0, 1, 0, 1, 0]",218,94,124,10,9,0.10638297872340426,0.07258064516129033
"[1, 0, 0, 0, 0, 0, 1, 1, 1, 0, 0, 1, 1, 0, 1]",115,66,49,4,6,0.06060606060606061,0.12244897959183673
"[0, 0, 0, 0, 1, 1, 0, 1, 0, 0, 1, 1, 0, 1, 0]",143,80,63,7,6,0.0875,0.09523809523809523
"[1, 1, 1, 1, 1, 1, 0, 1, 1, 0, 0, 0, 1, 0, 0]",164,57,107,6,14,0.10526315789473684,0.1308411214953271
"[0, 1, 1, 1, 0, 1, 0, 1, 0, 1, 1, 0, 0, 0, 1]",121,59,62,5,7,0.0847457627118644,0.11290322580645161
"[0, 0, 1, 0, 1, 0, 1, 0, 1, 1, 1, 0, 1, 0, 1]",102,48,54,3,6,0.0625,0.1111111111111111
"[1, 0, 0, 0, 1, 1, 1, 0, 0, 1, 1, 1, 0, 1, 0]",104,50,54,5,5,0.1,0.09259259259259259
"[1, 0, 0, 1, 1, 0, 1, 1, 0, 1, 1, 0, 1, 0, 1]",119,42,77,3,13,0.07142857142857142,0.16883116883116883
"[0, 1, 1, 0, 1, 1, 1, 0, 1, 1, 0, 0, 0, 1, 1]",158,66,92,9,14,0.13636363636363635,0.15217391304347827
"[1, 1, 0, 1, 0, 1, 1, 0, 1, 0, 0, 1, 1, 0, 1]",112,51,61,2,6,0.0392156862745098,0.09836065573770492
"[0, 0, 1, 0, 1, 0, 1, 0, 1, 1, 1, 0, 0, 0, 1]",101,49,52,4,5,0.08163265306122448,0.09615384615384616
"[0, 0, 0, 1, 1, 0, 1, 1, 1, 1, 0, 0, 0, 1, 1]",175,95,80,9,6,0.09473684210526316,0.075
"[1, 0, 0, 0, 1, 1, 1, 0, 1, 0, 0, 1, 1, 0, 0]",120,62,58,4,5,0.06451612903225806,0.08620689655172414
"[1, 0, 1, 0, 1, 1, 1, 0, 0, 0, 1, 1, 0, 1, 1]",128,47,81,3,7,0.06382978723404255,0.08641975308641975
"[0, 1, 0, 1, 0, 1, 0, 1, 1, 1, 0, 0, 0, 1, 1]",119,58,61,5,4,0.08620689655172414,0.06557377049180328
"[1, 1, 1, 1, 0, 1, 0, 0, 0, 0, 0, 1, 0, 0, 1]",134,65,69,7,5,0.1076923076923077,0.07246376811594203
"[0, 1, 0, 0, 0, 0, 1, 1, 0, 1, 0, 1, 1, 0, 0]",139,73,66,8,11,0.1095890410958904,0.16666666666666666
"[1, 0, 1, 0, 0, 0, 0, 1, 1, 0, 1, 0, 1, 1, 0]",110,58,52,6,5,0.10344827586206896,0.09615384615384616
"[1, 1, 1, 0, 1, 0, 0, 1, 1, 0, 1, 1, 0, 0, 0]",134,55,79,7,8,0.12727272727272726,0.10126582278481013
"[1, 0, 1, 0, 0, 0, 0, 1, 1, 0, 0, 1, 1, 1, 0]",176,90,86,6,8,0.06666666666666667,0.09302325581395349
"[1, 0, 0, 1, 1, 0, 1, 0, 0, 0, 1, 0, 0, 1, 0]",126,73,53,8,5,0.1095890410958904,0.09433962264150944
"[1, 0, 1, 0, 1, 0, 1, 1, 0, 1, 0, 0, 1, 1, 1]",156,75,81,4,5,0.05333333333333334,0.06172839506172839
"[0, 0, 1, 1, 1, 0, 0, 0, 1, 0, 0, 0, 1, 0, 0]",241,173,68,12,6,0.06936416184971098,0.08823529411764706
"[0, 0, 0, 1, 0, 0, 1, 0, 0, 0, 1, 0, 1, 1, 1]",219,139,80,9,9,0.06474820143884892,0.1125
"[1, 0, 0, 1, 0, 0, 1, 1, 0, 0, 0, 0, 0, 1, 0]",230,146,84,7,8,0.04794520547945205,0.09523809523809523
"[1, 0, 1, 0, 1, 1, 0, 0, 1, 1, 1, 0, 0, 0, 1]",149,59,90,5,10,0.0847457627118644,0.1111111111111111
"[0, 1, 1, 1, 0, 1, 1, 1, 1, 0, 0, 0, 0, 1, 0]",126,67,59,5,5,0.07462686567164178,0.0847457627118644
"[0, 1, 1, 0, 0, 0, 0, 1, 1, 0, 1, 0, 0, 0, 1]",215,148,67,23,7,0.1554054054054054,0.1044776119402985
"[1, 1, 0, 1, 0, 0, 0, 1, 0, 0, 0, 0, 1, 0, 0]",214,131,83,11,8,0.08396946564885496,0.0963855421686747
"[0, 1, 1, 0, 0, 1, 1, 1, 0, 1, 0, 1, 0, 1, 0]",115,52,63,2,6,0.038461538461538464,0.09523809523809523
"[0, 0, 0, 1, 1, 1, 1, 1, 0, 0, 0, 1, 1, 0, 0]",173,110,63,15,8,0.13636363636363635,0.12698412698412698
"[0, 0, 0, 0, 0, 1, 0, 1, 1, 0, 1, 1, 0, 1, 1]",134,75,59,3,6,0.04,0.1016949152542373
"[0, 1, 1, 0, 1, 0, 0, 0, 1, 0, 1, 0, 1, 0, 1]",112,64,48,8,7,0.125,0.14583333333333334
"[0, 1, 1, 0, 1, 0, 0, 0, 1, 1, 0, 0, 0, 1, 1]",128,69,59,5,2,0.07246376811594203,0.03389830508474576
"[0, 0, 1, 1, 0, 0, 1, 0, 1, 1, 1, 0, 0, 1, 0]",122,62,60,9,10,0.14516129032258066,0.16666666666666666
"[1, 0, 0, 0, 0, 0, 0, 1, 1, 0, 1, 1, 0, 0, 1]",250,121,129,9,10,0.0743801652892562,0.07751937984496124
"[0, 0, 1, 1, 1, 1, 0, 0, 0, 0, 0, 1, 1, 1, 0]",235,106,129,6,7,0.05660377358490566,0.05426356589147287
"[1, 0, 1, 1, 0, 1, 1, 1, 1, 1, 1, 0, 1, 0, 1]",504,153,351,14,37,0.0915032679738562,0.10541310541310542
"[1, 0, 0, 1, 1, 0, 1, 1, 0, 1, 1, 1, 1, 0, 0]",209,84,125,7,9,0.08333333333333333,0.072
"[0, 1, 0, 0, 0, 0, 1, 0, 1, 1, 1, 0, 0, 1, 0]",139,82,57,5,5,0.06097560975609756,0.08771929824561403
"[1, 1, 1, 0, 1, 1, 0, 0, 1, 1, 0, 1, 0, 0, 0]",116,52,64,8,4,0.15384615384615385,0.0625
"[1, 0, 1, 1, 1, 0, 1, 0, 1, 0, 0, 1, 0, 1, 0]",98,44,54,5,6,0.11363636363636363,0.1111111111111111
"[1, 1, 0, 1, 1, 1, 1, 0, 1, 1, 0, 1, 0, 1, 0]",208,67,141,8,18,0.11940298507462686,0.1276595744680851
"[0, 1, 1, 1, 0, 0, 0, 1, 1, 0, 0, 1, 0, 0, 0]",133,81,52,8,7,0.09876543209876543,0.1346153846153846
"[1, 1, 0, 1, 1, 1, 0, 0, 1, 0, 1, 0, 0, 1, 1]",166,74,92,4,10,0.05405405405405406,0.10869565217391304
"[0, 1, 1, 0, 1, 1, 1, 0, 0, 0, 1, 0, 1, 0, 0]",115,60,55,9,6,0.15,0.10909090909090909
"[0, 1, 1, 0, 1, 1, 1, 1, 1, 0, 1, 1, 0, 1, 0]",198,75,123,9,9,0.12,0.07317073170731707
"[1, 0, 1, 0, 0, 1, 1, 1, 1, 0, 0, 0, 0, 1, 0]",132,78,54,9,3,0.11538461538461539,0.05555555555555555
"[0, 0, 1, 0, 1, 0, 0, 1, 0, 0, 0, 1, 1, 1, 0]",144,98,46,9,3,0.09183673469387756,0.06521739130434782
"[0, 1, 1, 0, 1, 1, 0, 0, 0, 1, 0, 0, 0, 1, 1]",116,69,47,6,4,0.08695652173913043,0.0851063829787234
"[0, 1, 1, 0, 1, 1, 1, 1, 1, 0, 0, 0, 1, 0, 0]",97,48,49,3,5,0.0625,0.10204081632653061
"[0, 0, 1, 1, 0, 1, 0, 1, 0, 0, 1, 0, 0, 0, 1]",141,90,51,11,6,0.12222222222222222,0.11764705882352941
"[0, 0, 1, 0, 0, 0, 0, 1, 1, 1, 0, 1, 0, 0, 1]",154,94,60,11,8,0.11702127659574468,0.13333333333333333
"[1, 0, 1, 1, 1, 0, 0, 1, 1, 0, 0, 1, 0, 0, 1]",114,55,59,2,5,0.03636363636363636,0.0847457627118644
"[0, 0, 1, 0, 1, 1, 1, 1, 0, 1, 0, 1, 0, 1, 0]",127,48,79,4,6,0.08333333333333333,0.0759493670886076
"[0, 1, 1, 1, 0, 1, 1, 0, 0, 1, 0, 0, 0, 0, 1]",141,79,62,5,7,0.06329113924050633,0.11290322580645161
"[1, 0, 1, 0, 1, 0, 1, 1, 0, 0, 1, 0, 1, 1, 0]",96,51,45,7,7,0.13725490196078433,0.15555555555555556
"[1, 1, 1, 0, 0, 0, 1, 0, 1, 0, 1, 0, 1, 0, 1]",114,58,56,4,6,0.06896551724137931,0.10714285714285714
"[0, 1, 1, 0, 0, 1, 1, 1, 0, 1, 1, 1, 0, 0, 0]",149,79,70,8,5,0.10126582278481013,0.07142857142857142
"[1, 0, 1, 1, 0, 1, 1, 1, 1, 0, 0, 0, 0, 1, 0]",119,58,61,6,7,0.10344827586206896,0.11475409836065574
"[0, 0, 1, 1, 1, 1, 0, 1, 0, 0, 1, 0, 1, 1, 0]",110,49,61,2,5,0.04081632653061224,0.08196721311475409
"[0, 1, 1, 1, 1, 1, 0, 0, 0, 1, 0, 1, 1, 1, 0]",131,62,69,4,8,0.06451612903225806,0.11594202898550725
"[0, 0, 1, 0, 0, 1, 0, 1, 0, 1, 1, 1, 1, 1, 0]",122,56,66,7,4,0.125,0.06060606060606061
"[0, 1, 0, 0, 1, 0, 0, 0, 1, 1, 1, 1, 0, 1, 1]",122,65,57,6,4,0.09230769230769231,0.07017543859649122
"[0, 1, 1, 1, 1, 1, 0, 1, 1, 0, 0, 1, 0, 0, 0]",128,58,70,3,2,0.05172413793103448,0.02857142857142857
"[0, 1, 0, 1, 0, 1, 1, 0, 1, 1, 0, 1, 1, 0, 1]",125,68,57,4,1,0.058823529411764705,0.017543859649122806
"[1, 0, 0, 0, 1, 1, 1, 1, 1, 0, 1, 0, 0, 1, 1]",173,75,98,6,11,0.08,0.11224489795918367
"[1, 0, 0, 0, 0, 0, 1, 1, 1, 0, 1, 1, 0, 0, 0]",163,94,69,6,3,0.06382978723404255,0.043478260869565216
"[1, 0, 1, 1, 1, 1, 1, 0, 0, 0, 0, 1, 0, 1, 1]",192,80,112,6,9,0.075,0.08035714285714286
"[0, 0, 1, 0, 1, 0, 1, 0, 1, 0, 0, 1, 1, 0, 1]",114,63,51,7,7,0.1111111111111111,0.13725490196078433
"[1, 1, 0, 1, 0, 0, 0, 1, 0, 1, 0, 0, 1, 0, 1]",120,58,62,6,9,0.10344827586206896,0.14516129032258066
"[0, 1, 0, 1, 1, 1, 1, 0, 0, 1, 1, 1, 0, 1, 1]",278,99,179,7,18,0.0707070707070707,0.1005586592178771
"[0, 0, 1, 0, 0, 1, 0, 1, 0, 0, 1, 0, 0, 1, 0]",198,125,73,19,8,0.152,0.1095890410958904
"[1, 1, 1, 0, 1, 0, 1, 0, 0, 1, 0, 0, 0, 1, 1]",125,50,75,4,8,0.08,0.10666666666666667
"[1, 1, 1, 0, 0, 0, 0, 1, 0, 1, 1, 0, 1, 1, 0]",132,61,71,11,10,0.18032786885245902,0.14084507042253522
"[1, 1, 1, 0, 1, 0, 1, 0, 0, 0, 0, 0, 1, 1, 1]",184,80,104,7,6,0.0875,0.057692307692307696
"[0, 1, 0, 0, 1, 1, 1, 1, 0, 0, 1, 0, 1, 0, 1]",108,44,64,5,6,0.11363636363636363,0.09375
"[1, 1, 0, 1, 0, 1, 1, 0, 0, 1, 0, 0, 1, 1, 0]",138,61,77,6,4,0.09836065573770492,0.05194805194805195
"[1, 0, 0, 1, 0, 1, 0, 0, 1, 1, 0, 1, 0, 0, 1]",106,64,42,4,2,0.0625,0.047619047619047616
"[0, 0, 1, 1, 0, 1, 1, 1, 1, 0, 0, 1, 0, 0, 1]",129,61,68,6,4,0.09836065573770492,0.058823529411764705
"[1, 1, 0, 0, 0, 1, 1, 1, 1, 0, 0, 0, 1, 1, 0]",142,69,73,7,7,0.10144927536231885,0.0958904109589041
"[1, 1, 0, 1, 1, 1, 0, 0, 0, 0, 0, 0, 1, 0, 1]",141,74,67,7,3,0.0945945945945946,0.04477611940298507
"[0, 0, 1, 0, 0, 0, 0, 1, 1, 1, 0, 1, 1, 1, 0]",118,62,56,9,3,0.14516129032258066,0.05357142857142857
"[0, 1, 0, 0, 1, 1, 1, 1, 0, 1, 0, 0, 0, 1, 1]",142,62,80,12,6,0.1935483870967742,0.075
"[1, 0, 1, 1, 0, 0, 1, 0, 0, 1, 0, 0, 0, 1, 0]",134,70,64,8,5,0.11428571428571428,0.078125
"[1, 1, 1, 0, 1, 1, 0, 0, 1, 1, 1, 0, 0, 0, 0]",168,76,92,4,10,0.05263157894736842,0.10869565217391304
"[1, 1, 1, 1, 1, 0, 0, 0, 1, 0, 1, 1, 0, 1, 0]",162,53,109,6,8,0.11320754716981132,0.07339449541284404
"[1, 0, 1, 0, 1, 1, 0, 0, 1, 0, 0, 1, 0, 1, 0]",112,56,56,4,3,0.07142857142857142,0.05357142857142857
"[0, 1, 1, 1, 1, 0, 0, 0, 0, 1, 0, 1, 1, 0, 0]",179,118,61,10,9,0.0847457627118644,0.14754098360655737
"[0, 1, 0, 0, 0, 0, 1, 1, 0, 1, 1, 0, 0, 1, 1]",180,94,86,5,6,0.05319148936170213,0.06976744186046512
"[1, 0, 1, 1, 0, 1, 1, 0, 1, 0, 0, 0, 1, 1, 0]",118,55,63,11,2,0.2,0.031746031746031744
"[1, 1, 1, 0, 1, 1, 0, 0, 1, 1, 0, 0, 1, 0, 1]",148,56,92,5,11,0.08928571428571429,0.11956521739130435
"[1, 0, 0, 1, 0, 1, 0, 1, 0, 1, 0, 0, 1, 0, 0]",149,83,66,8,4,0.0963855421686747,0.06060606060606061
"[1, 1, 0, 0, 0, 1, 1, 0, 1, 0, 1, 0, 0, 1, 1]",164,72,92,5,7,0.06944444444444445,0.07608695652173914
"[0, 0, 1, 1, 1, 0, 1, 1, 0, 0, 0, 1, 0, 0, 0]",158,101,57,18,5,0.1782178217821782,0.08771929824561403
"[1, 0, 1, 0, 1, 0, 0, 0, 1, 0, 1, 1, 0, 1, 1]",110,51,59,2,4,0.0392156862745098,0.06779661016949153
"[0, 0, 1, 1, 0, 1, 1, 1, 1, 0, 1, 0, 0, 1, 0]",126,69,57,8,2,0.11594202898550725,0.03508771929824561
"[0, 0, 1, 0, 1, 0, 0, 1, 0, 1, 1, 0, 1, 1, 1]",140,67,73,5,10,0.07462686567164178,0.136986301369863
"[0, 1, 0, 0, 0, 0, 1, 0, 1, 0, 1, 0, 1, 0, 1]",133,73,60,4,9,0.0547945205479452,0.15
"[1, 1, 0, 0, 1, 1, 0, 1, 1, 0, 0, 0, 1, 0, 0]",119,56,63,7,9,0.125,0.14285714285714285
"[0, 1, 1, 0, 0, 1, 1, 0, 1, 1, 0, 0, 1, 0, 0]",114,68,46,5,7,0.07352941176470588,0.15217391304347827
"[0, 1, 0, 1, 0, 1, 1, 0, 0, 1, 1, 0, 1, 0, 1]",121,49,72,5,6,0.10204081632653061,0.08333333333333333
"[1, 1, 1, 0, 0, 1, 1, 1, 0, 1, 0, 0, 0, 0, 0]",164,64,100,5,5,0.078125,0.05
"[1, 0, 0, 1, 1, 0, 1, 1, 0, 0, 0, 1, 0, 0, 0]",151,82,69,15,6,0.18292682926829268,0.08695652173913043
"[0, 0, 1, 1, 0, 0, 1, 0, 1, 0, 1, 0, 0, 1, 0]",135,73,62,6,2,0.0821917808219178,0.03225806451612903
"[1, 1, 0, 1, 0, 1, 0, 1, 0, 0, 1, 0, 0, 1, 1]",131,60,71,5,7,0.08333333333333333,0.09859154929577464
"[1, 0, 0, 1, 0, 1, 0, 1, 0, 1, 0, 1, 1, 0, 0]",111,61,50,7,6,0.11475409836065574,0.12
"[1, 1, 1, 0, 0, 1, 0, 0, 1, 1, 1, 0, 1, 0, 0]",114,62,52,7,6,0.11290322580645161,0.11538461538461539
"[0, 1, 1, 0, 1, 0, 0, 0, 0, 1, 0, 1, 0, 1, 0]",134,75,59,6,3,0.08,0.05084745762711865
"[0, 1, 1, 0, 1, 1, 0, 1, 0, 0, 1, 0, 1, 1, 0]",120,54,66,2,2,0.037037037037037035,0.030303030303030304
"[0, 0, 0, 0, 1, 1, 1, 0, 0, 1, 0, 1, 1, 0, 1]",108,51,57,7,5,0.13725490196078433,0.08771929824561403
"[0, 0, 1, 1, 0, 1, 1, 0, 0, 1, 0, 0, 0, 0, 1]",177,118,59,18,4,0.15254237288135594,0.06779661016949153
"[1, 0, 0, 0, 1, 0, 0, 0, 1, 0, 1, 1, 0, 1, 1]",138,72,66,5,5,0.06944444444444445,0.07575757575757576
"[1, 1, 1, 0, 0, 1, 0, 0, 0, 1, 1, 0, 0, 1, 1]",206,87,119,7,12,0.08045977011494253,0.10084033613445378
"[0, 1, 1, 0, 0, 1, 0, 0, 1, 0, 1, 1, 1, 1, 1]",215,94,121,11,15,0.11702127659574468,0.12396694214876033
"[0, 0, 0, 1, 1, 1, 0, 1, 1, 0, 0, 1, 1, 1, 0]",120,63,57,7,7,0.1111111111111111,0.12280701754385964
"[1, 0, 1, 0, 1, 1, 1, 1, 0, 0, 0, 1, 0, 0, 1]",113,46,67,3,6,0.06521739130434782,0.08955223880597014
"[0, 1, 0, 1, 1, 0, 1, 0, 1, 1, 1, 1, 0, 0, 0]",178,70,108,7,8,0.1,0.07407407407407407
"[1, 1, 1, 0, 1, 0, 1, 0, 1, 0, 0, 1, 0, 0, 1]",114,47,67,5,8,0.10638297872340426,0.11940298507462686
"[0, 1, 0, 0, 0, 0, 0, 0, 1, 1, 0, 1, 1, 1, 1]",203,113,90,16,10,0.1415929203539823,0.1111111111111111
"[0, 1, 0, 0, 1, 1, 0, 1, 0, 1, 0, 1, 0, 0, 1]",100,48,52,5,6,0.10416666666666667,0.11538461538461539
"[1, 0, 1, 0, 1, 1, 1, 1, 1, 1, 0, 1, 0, 1, 0]",217,74,143,4,13,0.05405405405405406,0.09090909090909091
"[1, 1, 1, 1, 0, 1, 1, 1, 0, 1, 0, 0, 1, 0, 1]",227,79,148,8,16,0.10126582278481013,0.10810810810810811
"[1, 0, 0, 0, 1, 1, 0, 0, 1, 1, 1, 0, 1, 1, 1]",201,75,126,7,19,0.09333333333333334,0.15079365079365079
"[0, 1, 1, 0, 0, 1, 1, 1, 0, 0, 1, 0, 0, 1, 0]",122,67,55,10,4,0.14925373134328357,0.07272727272727272
"[1, 1, 1, 0, 0, 1, 0, 0, 0, 0, 0, 1, 1, 1, 0]",127,65,62,5,6,0.07692307692307693,0.0967741935483871
"[1, 1, 1, 0, 0, 0, 1, 0, 1, 0, 0, 0, 1, 1, 0]",131,64,67,5,6,0.078125,0.08955223880597014
"[0, 0, 0, 1, 0, 1, 0, 1, 1, 1, 0, 1, 1, 0, 1]",97,45,52,3,4,0.06666666666666667,0.07692307692307693
"[0, 0, 1, 0, 1, 1, 0, 0, 0, 1, 0, 0, 1, 0, 0]",229,154,75,14,6,0.09090909090909091,0.08
"[0, 1, 0, 1, 1, 1, 1, 1, 0, 0, 1, 1, 0, 1, 1]",260,98,162,12,19,0.12244897959183673,0.11728395061728394
"[0, 0, 0, 0, 0, 1, 1, 1, 0, 1, 1, 0, 0, 1, 0]",156,94,62,8,1,0.0851063829787234,0.016129032258064516
"[0, 1, 0, 0, 1, 1, 0, 0, 1, 0, 1, 1, 1, 0, 1]",114,50,64,4,10,0.08,0.15625
"[1, 0, 0, 1, 1, 0, 1, 0, 1, 1, 0, 1, 1, 0, 0]",136,63,73,3,6,0.047619047619047616,0.0821917808219178
"[1, 1, 0, 1, 1, 0, 0, 1, 0, 0, 1, 1, 0, 0, 1]",136,58,78,4,7,0.06896551724137931,0.08974358974358974
"[1, 0, 0, 1, 0, 1, 1, 0, 1, 0, 0, 1, 1, 0, 1]",112,58,54,3,8,0.05172413793103448,0.14814814814814814
"[1, 0, 1, 0, 0, 1, 0, 1, 1, 1, 0, 0, 0, 1, 0]",99,62,37,7,5,0.11290322580645161,0.13513513513513514
"[1, 0, 0, 1, 0, 1, 1, 1, 1, 0, 1, 0, 1, 0, 0]",99,40,59,7,8,0.175,0.13559322033898305
"[0, 0, 0, 0, 1, 0, 0, 0, 1, 0, 1, 1, 1, 1, 0]",157,94,63,9,7,0.09574468085106383,0.1111111111111111
"[0, 1, 0, 1, 0, 0, 1, 1, 1, 1, 1, 0, 1, 0, 0]",125,60,65,7,3,0.11666666666666667,0.046153846153846156
"[0, 0, 1, 1, 0, 0, 1, 1, 0, 1, 1, 0, 1, 0, 1]",129,70,59,10,8,0.14285714285714285,0.13559322033898305
"[0, 1, 0, 1, 0, 1, 1, 0, 0, 0, 1, 0, 0, 1, 0]",127,79,48,7,4,0.08860759493670886,0.08333333333333333
"[1, 1, 1, 0, 1, 1, 1, 0, 0, 0, 0, 0, 1, 1, 0]",142,61,81,3,9,0.04918032786885246,0.1111111111111111
"[0, 1, 0, 0, 1, 1, 0, 0, 1, 1, 0, 1, 1, 0, 0]",125,75,50,6,3,0.08,0.06
"[1, 1, 0, 1, 0, 0, 1, 1, 0, 1, 0, 0, 1, 0, 0]",107,51,56,3,8,0.058823529411764705,0.14285714285714285
"[0, 0, 1, 1, 0, 0, 1, 1, 1, 1, 0, 1, 1, 1, 0]",238,98,140,11,15,0.11224489795918367,0.10714285714285714
"[1, 0, 1, 0, 1, 0, 0, 1, 1, 0, 1, 1, 1, 0, 1]",140,58,82,7,7,0.1206896551724138,0.08536585365853659
"[1, 0, 1, 1, 0, 1, 0, 1, 0, 0, 1, 1, 1, 0, 0]",128,53,75,3,2,0.05660377358490566,0.02666666666666667
"[0, 0, 0, 0, 1, 0, 1, 1, 0, 0, 1, 1, 1, 0, 1]",113,62,51,4,6,0.06451612903225806,0.11764705882352941
"[0, 0, 1, 0, 0, 1, 1, 1, 0, 1, 0, 1, 0, 1, 0]",93,54,39,5,3,0.09259259259259259,0.07692307692307693
"[1, 1, 0, 1, 1, 1, 1, 1, 0, 0, 0, 1, 0, 1, 0]",121,45,76,3,10,0.06666666666666667,0.13157894736842105
"[0, 1, 1, 0, 1, 1, 0, 1, 1, 1, 0, 0, 0, 0, 0]",170,96,74,6,14,0.0625,0.1891891891891892
"[0, 1, 0, 1, 0, 1, 0, 0, 1, 0, 1, 0, 0, 0, 1]",132,82,50,7,8,0.08536585365853659,0.16
"[1, 1, 1, 1, 1, 0, 0, 1, 1, 0, 1, 0, 0, 1, 0]",169,59,110,6,6,0.1016949152542373,0.05454545454545454
"[0, 1, 1, 1, 0, 1, 0, 1, 1, 0, 0, 1, 0, 1, 1]",166,76,90,12,9,0.15789473684210525,0.1
"[0, 0, 0, 1, 1, 0, 1, 0, 1, 0, 1, 0, 1, 1, 0]",104,58,46,6,9,0.10344827586206896,0.1956521739130435
"[1, 0, 0, 1, 0, 0, 0, 1, 1, 0, 0, 1, 1, 0, 1]",123,69,54,7,6,0.10144927536231885,0.1111111111111111
"[0, 1, 0, 1, 0, 0, 0, 0, 1, 1, 1, 1, 0, 1, 1]",132,60,72,8,8,0.13333333333333333,0.1111111111111111
"[1, 1, 1, 1, 0, 0, 1, 0, 1, 0, 1, 0, 1, 1, 0]",143,51,92,7,7,0.13725490196078433,0.07608695652173914
"[1, 0, 1, 1, 1, 1, 1, 0, 0, 1, 0, 1, 0, 1, 0]",121,45,76,5,7,0.1111111111111111,0.09210526315789473
"[1, 0, 0, 0, 1, 1, 1, 0, 0, 0, 1, 0, 0, 1, 1]",152,84,68,9,5,0.10714285714285714,0.07352941176470588
"[0, 1, 1, 0, 1, 0, 0, 1, 0, 1, 1, 0, 0, 0, 1]",136,70,66,8,12,0.11428571428571428,0.18181818181818182
"[1, 1, 0, 0, 1, 1, 1, 0, 0, 1, 0, 0, 1, 0, 1]",122,54,68,7,5,0.12962962962962962,0.07352941176470588
"[0, 0, 1, 0, 0, 1, 0, 1, 1, 0, 1, 1, 0, 1, 1]",129,63,66,9,6,0.14285714285714285,0.09090909090909091
"[0, 1, 1, 0, 1, 0, 1, 1, 1, 0, 1, 1, 1, 1, 0]",250,87,163,7,8,0.08045977011494253,0.049079754601226995
"[0, 1, 0, 1, 1, 0, 0, 1, 1, 0, 1, 0, 1, 1, 0]",114,52,62,4,8,0.07692307692307693,0.12903225806451613
"[1, 0, 1, 0, 1, 0, 1, 0, 1, 1, 0, 0, 0, 1, 0]",100,53,47,4,4,0.07547169811320754,0.0851063829787234
"[0, 1, 1, 1, 0, 1, 1, 1, 1, 1, 0, 1, 0, 1, 0]",221,75,146,3,18,0.04,0.1232876712328767
"[0, 1, 0, 1, 1, 0, 1, 0, 1, 1, 1, 0, 1, 0, 1]",120,50,70,4,7,0.08,0.1
"[1, 0, 1, 1, 0, 0, 1, 0, 0, 0, 1, 0, 0, 1, 1]",130,71,59,9,13,0.1267605633802817,0.22033898305084745
"[0, 1, 0, 0, 1, 0, 0, 0, 0, 1, 0, 1, 1, 1, 1]",173,96,77,7,3,0.07291666666666667,0.03896103896103896
"[0, 1, 1, 1, 1, 1, 1, 1, 0, 1, 0, 0, 0, 1, 0]",139,70,69,7,10,0.1,0.14492753623188406
"[1, 1, 1, 0, 1, 0, 1, 0, 0, 1, 1, 0, 1, 0, 0]",110,48,62,6,5,0.125,0.08064516129032258
"[0, 1, 1, 0, 1, 0, 1, 0, 0, 1, 0, 0, 1, 1, 0]",115,52,63,8,10,0.15384615384615385,0.15873015873015872
"[1, 1, 1, 1, 1, 0, 1, 0, 1, 0, 1, 1, 0, 0, 0]",157,63,94,4,5,0.06349206349206349,0.05319148936170213
"[1, 1, 0, 0, 0, 1, 1, 1, 1, 0, 1, 0, 1, 0, 0]",137,57,80,3,8,0.05263157894736842,0.1
"[0, 1, 0, 1, 0, 1, 1, 0, 0, 0, 1, 1, 1, 0, 0]",127,67,60,6,9,0.08955223880597014,0.15
"[1, 0, 1, 0, 0, 0, 0, 1, 0, 1, 1, 0, 1, 1, 0]",93,53,40,7,3,0.1320754716981132,0.075
"[1, 0, 1, 0, 0, 0, 0, 1, 0, 1, 1, 0, 1, 1, 1]",125,56,69,3,6,0.05357142857142857,0.08695652173913043
"[1, 0, 0, 1, 0, 0, 1, 0, 1, 1, 0, 0, 0, 1, 0]",129,80,49,7,8,0.0875,0.16326530612244897
"[1, 0, 0, 1, 1, 1, 1, 0, 1, 0, 0, 0, 0, 1, 0]",133,59,74,9,8,0.15254237288135594,0.10810810810810811
"[0, 1, 1, 0, 1, 1, 1, 1, 0, 1, 0, 0, 1, 0, 1]",152,72,80,10,8,0.1388888888888889,0.1
"[0, 1, 0, 0, 1, 0, 0, 1, 1, 1, 1, 1, 0, 1, 0]",112,48,64,4,6,0.08333333333333333,0.09375
"[0, 0, 1, 0, 0, 1, 0, 0, 1, 1, 1, 1, 1, 0, 1]",109,49,60,6,3,0.12244897959183673,0.05
"[1, 1, 0, 0, 1, 0, 1, 0, 0, 1, 1, 0, 1, 0, 1]",124,53,71,6,5,0.11320754716981132,0.07042253521126761
"[1, 0, 0, 0, 1, 0, 0, 1, 1, 0, 1, 0, 1, 1, 0]",108,54,54,6,5,0.1111111111111111,0.09259259259259259
"[0, 1, 1, 0, 1, 0, 1, 1, 0, 0, 0, 1, 0, 1, 1]",144,74,70,5,5,0.06756756756756757,0.07142857142857142
"[1, 1, 1, 1, 1, 0, 1, 1, 0, 0, 0, 1, 0, 0, 1]",154,63,91,6,12,0.09523809523809523,0.13186813186813187
"[1, 0, 1, 1, 1, 1, 0, 1, 1, 0, 1, 0, 0, 0, 0]",124,46,78,3,9,0.06521739130434782,0.11538461538461539
"[1, 1, 1, 1, 0, 1, 0, 0, 1, 0, 0, 0, 1, 0, 0]",130,67,63,11,10,0.16417910447761194,0.15873015873015872
"[0, 1, 0, 0, 0, 1, 0, 1, 1, 1, 1, 0, 1, 1, 1]",162,63,99,5,8,0.07936507936507936,0.08080808080808081
"[1, 0, 1, 0, 1, 0, 0, 1, 1, 0, 1, 0, 0, 1, 0]",106,63,43,8,2,0.12698412698412698,0.046511627906976744
"[0, 1, 1, 0, 0, 0, 1, 1, 0, 1, 0, 1, 1, 1, 0]",122,51,71,5,5,0.09803921568627451,0.07042253521126761
"[1, 1, 0, 0, 1, 0, 0, 1, 1, 0, 0, 1, 1, 0, 1]",116,56,60,7,7,0.125,0.11666666666666667
"[1, 0, 1, 1, 0, 1, 1, 0, 0, 0, 1, 0, 1, 1, 0]",119,58,61,5,5,0.08620689655172414,0.08196721311475409
"[1, 0, 1, 0, 1, 1, 1, 0, 1, 1, 0, 0, 0, 1, 0]",101,46,55,2,4,0.043478260869565216,0.07272727272727272
"[1, 1, 0, 1, 0, 1, 0, 1, 0, 0, 1, 0, 0, 1, 0]",97,52,45,7,6,0.1346153846153846,0.13333333333333333
"[1, 0, 0, 0, 1, 1, 0, 1, 1, 0, 1, 0, 1, 0, 1]",117,46,71,2,6,0.043478260869565216,0.08450704225352113
"[0, 0, 0, 1, 0, 0, 0, 1, 1, 0, 1, 1, 0, 1, 1]",114,66,48,5,2,0.07575757575757576,0.041666666666666664
"[0, 1, 1, 1, 0, 0, 0, 0, 0, 1, 1, 0, 1, 0, 1]",107,65,42,3,3,0.046153846153846156,0.07142857142857142
"[0, 1, 0, 1, 0, 0, 1, 1, 0, 1, 0, 1, 1, 0, 0]",123,59,64,6,5,0.1016949152542373,0.078125
"[0, 1, 0, 1, 0, 0, 1, 1, 0, 1, 0, 1, 0, 1, 0]",106,60,46,5,9,0.08333333333333333,0.1956521739130435
"[0, 1, 0, 0, 0, 1, 1, 1, 1, 1, 0, 0, 0, 1, 1]",147,65,82,8,8,0.12307692307692308,0.0975609756097561
"[0, 1, 1, 0, 1, 1, 1, 1, 1, 0, 0, 1, 0, 0, 0]",116,54,62,10,5,0.18518518518518517,0.08064516129032258
"[0, 0, 0, 0, 0, 1, 1, 1, 0, 1, 1, 0, 1, 0, 1]",132,78,54,6,9,0.07692307692307693,0.16666666666666666
"[0, 0, 1, 0, 1, 1, 0, 1, 1, 0, 1, 0, 1, 1, 0]",94,46,48,3,3,0.06521739130434782,0.0625
"[1, 1, 0, 1, 0, 1, 1, 1, 0, 1, 0, 0, 0, 0, 0]",121,63,58,5,9,0.07936507936507936,0.15517241379310345
"[0, 0, 0, 0, 1, 1, 1, 0, 1, 1, 0, 0, 1, 0, 0]",158,99,59,7,9,0.0707070707070707,0.15254237288135594
"[0, 0, 1, 0, 0, 1, 1, 1, 0, 0, 0, 1, 0, 1, 1]",121,63,58,5,7,0.07936507936507936,0.1206896551724138
"[1, 1, 1, 0, 1, 0, 0, 0, 0, 0, 0, 1, 0, 1, 1]",123,58,65,4,6,0.06896551724137931,0.09230769230769231
"[1, 0, 0, 1, 0, 1, 1, 0, 0, 0, 1, 0, 1, 0, 0]",139,81,58,7,7,0.08641975308641975,0.1206896551724138
"[1, 1, 0, 0, 0, 1, 0, 0, 1, 1, 1, 0, 0, 1, 0]",108,50,58,5,9,0.1,0.15517241379310345
"[1, 1, 1, 0, 0, 1, 1, 0, 1, 0, 0, 0, 1, 0, 0]",117,52,65,6,5,0.11538461538461539,0.07692307692307693
"[0, 1, 1, 1, 0, 1, 0, 1, 1, 0, 1, 0, 0, 1, 0]",92,42,50,3,7,0.07142857142857142,0.14
"[0, 1, 0, 1, 0, 0, 1, 0, 1, 0, 0, 0, 1, 1, 1]",139,79,60,10,5,0.12658227848101267,0.08333333333333333
"[1, 1, 1, 0, 1, 0, 0, 0, 1, 1, 1, 0, 0, 1, 0]",122,55,67,3,5,0.05454545454545454,0.07462686567164178
"[0, 1, 1, 1, 0, 0, 1, 1, 0, 0, 0, 1, 0, 1, 0]",108,57,51,8,7,0.14035087719298245,0.13725490196078433
"[1, 0, 1, 0, 1, 1, 0, 1, 0, 0, 1, 0, 1, 0, 0]",103,61,42,5,5,0.08196721311475409,0.11904761904761904
"[1, 1, 0, 0, 0, 0, 0, 0, 0, 1, 1, 1, 0, 0, 1]",244,137,107,12,13,0.08759124087591241,0.12149532710280374
"[1, 1, 1, 1, 0, 0, 0, 0, 0, 0, 0, 1, 1, 1, 0]",236,123,113,6,11,0.04878048780487805,0.09734513274336283
"[0, 0, 0, 1, 1, 1, 1, 1, 1, 1, 1, 1, 1, 0, 0]",2100,1543,557,131,43,0.084899546338302,0.07719928186714542
"[0, 0, 1, 1, 0, 0, 0, 1, 0, 1, 0, 0, 0, 1, 0]",267,175,92,15,13,0.08571428571428572,0.14130434782608695
"[1, 0, 1, 1, 1, 1, 0, 0, 1, 1, 0, 0, 0, 1, 0]",140,67,73,5,9,0.07462686567164178,0.1232876712328767
"[1, 0, 0, 0, 0, 1, 1, 0, 1, 0, 1, 1, 1, 1, 0]",153,56,97,5,11,0.08928571428571429,0.1134020618556701
"[0, 1, 0, 0, 0, 0, 1, 1, 0, 0, 0, 0, 1, 1, 0]",770,502,268,43,22,0.08565737051792828,0.08208955223880597
"[0, 1, 0, 1, 0, 0, 0, 0, 1, 1, 0, 0, 0, 0, 1]",450,294,156,29,11,0.09863945578231292,0.07051282051282051
"[0, 1, 0, 0, 0, 1, 1, 0, 1, 1, 1, 0, 0, 0, 1]",112,63,49,5,6,0.07936507936507936,0.12244897959183673
"[1, 1, 0, 0, 1, 1, 1, 1, 1, 1, 1, 1, 1, 1, 1]",29942,5566,24376,619,2245,0.11121092346388789,0.09209878569084345
"[1, 1, 1, 0, 1, 0, 0, 1, 1, 1, 1, 1, 1, 0, 0]",551,186,365,11,38,0.05913978494623656,0.10410958904109589
"[0, 1, 0, 1, 1, 1, 1, 0, 1, 1, 0, 1, 1, 0, 1]",206,65,141,6,18,0.09230769230769231,0.1276595744680851
"[0, 0, 0, 0, 1, 1, 1, 1, 1, 1, 1, 1, 0, 0, 1]",2007,854,1153,87,118,0.10187353629976581,0.1023417172593235
"[1, 1, 0, 1, 1, 1, 1, 1, 1, 1, 1, 1, 1, 0, 1]",6936,1224,5712,127,539,0.10375816993464053,0.09436274509803921
"[0, 0, 0, 0, 0, 0, 1, 1, 1, 0, 0, 0, 0, 0, 0]",3082,2328,754,198,61,0.08505154639175258,0.08090185676392574
"[1, 0, 0, 0, 0, 0, 0, 1, 0, 0, 0, 0, 0, 0, 0]",8194,6332,1862,582,179,0.09191408717624763,0.09613319011815252
"[1, 1, 1, 1, 1, 1, 1, 1, 1, 1, 1, 1, 1, 1, 0]",78027,9998,68029,994,6636,0.09941988397679535,0.09754663452351203
"[0, 1, 1, 1, 1, 0, 0, 1, 0, 0, 0, 1, 1, 1, 1]",296,148,148,16,17,0.10810810810810811,0.11486486486486487
"[0, 1, 0, 0, 0, 0, 0, 1, 1, 1, 1, 0, 1, 1, 0]",122,62,60,7,8,0.11290322580645161,0.13333333333333333
"[1, 1, 0, 1, 0, 0, 0, 1, 1, 1, 1, 1, 1, 1, 1]",1050,292,758,35,66,0.11986301369863013,0.0870712401055409
"[0, 1, 1, 0, 1, 1, 1, 1, 0, 1, 1, 1, 1, 1, 0]",537,168,369,27,50,0.16071428571428573,0.13550135501355012
"[0, 1, 1, 1, 0, 1, 1, 0, 1, 1, 1, 1, 0, 1, 1]",517,177,340,24,24,0.13559322033898305,0.07058823529411765
"[0, 1, 1, 1, 0, 1, 1, 1, 1, 0, 1, 1, 1, 1, 1]",1774,450,1324,37,120,0.08222222222222222,0.09063444108761329
"[1, 0, 1, 0, 1, 1, 0, 1, 1, 1, 0, 1, 1, 1, 1]",605,157,448,12,41,0.07643312101910828,0.09151785714285714
"[1, 1, 1, 0, 1, 0, 1, 1, 0, 1, 1, 1, 0, 1, 1]",528,160,368,16,32,0.1,0.08695652173913043
"[0, 1, 0, 1, 1, 1, 1, 0, 1, 0, 0, 1, 0, 1, 1]",149,64,85,5,12,0.078125,0.1411764705882353
"[1, 0, 1, 0, 1, 1, 1, 1, 0, 1, 0, 0, 1, 0, 1]",129,58,71,6,7,0.10344827586206896,0.09859154929577464
"[0, 0, 0, 1, 1, 1, 0, 1, 0, 1, 1, 1, 1, 0, 1]",146,77,69,4,6,0.05194805194805195,0.08695652173913043
"[1, 0, 0, 0, 1, 1, 1, 0, 1, 0, 1, 1, 1, 1, 0]",152,64,88,7,6,0.109375,0.06818181818181818
"[0, 1, 0, 1, 1, 1, 0, 0, 0, 1, 0, 1, 0, 0, 0]",151,89,62,12,5,0.1348314606741573,0.08064516129032258
"[0, 1, 0, 1, 0, 0, 0, 0, 1, 0, 1, 0, 1, 1, 1]",159,96,63,10,4,0.10416666666666667,0.06349206349206349
"[0, 0, 1, 0, 0, 0, 1, 0, 1, 0, 1, 0, 1, 1, 1]",151,84,67,5,10,0.05952380952380952,0.14925373134328357
"[0, 1, 0, 0, 0, 1, 1, 0, 0, 1, 1, 0, 0, 0, 0]",769,500,269,47,27,0.094,0.10037174721189591
"[0, 0, 0, 1, 0, 0, 0, 0, 1, 0, 1, 0, 1, 1, 0]",253,171,82,16,9,0.0935672514619883,0.10975609756097561
"[1, 1, 1, 1, 1, 0, 1, 1, 1, 0, 1, 1, 1, 1, 1]",8005,1397,6608,118,650,0.08446671438797423,0.09836561743341404
"[1, 0, 0, 0, 0, 1, 1, 1, 1, 1, 0, 1, 0, 0, 0]",165,59,106,4,12,0.06779661016949153,0.11320754716981132
"[0, 1, 1, 1, 1, 1, 0, 0, 0, 1, 0, 0, 1, 1, 0]",150,78,72,6,4,0.07692307692307693,0.05555555555555555
"[0, 0, 0, 1, 0, 0, 0, 0, 0, 1, 1, 1, 1, 1, 0]",234,147,87,15,8,0.10204081632653061,0.09195402298850575
"[0, 1, 1, 1, 0, 0, 0, 0, 0, 0, 0, 0, 1, 0, 0]",641,444,197,38,17,0.08558558558558559,0.08629441624365482
"[0, 0, 1, 1, 1, 0, 0, 0, 0, 0, 0, 0, 0, 1, 0]",625,437,188,47,11,0.10755148741418764,0.05851063829787234
"[1, 1, 1, 0, 0, 0, 1, 1, 0, 0, 1, 1, 0, 1, 0]",107,44,63,1,7,0.022727272727272728,0.1111111111111111
"[1, 0, 0, 0, 1, 0, 1, 1, 1, 1, 1, 1, 1, 1, 1]",944,260,684,24,62,0.09230769230769231,0.09064327485380116
"[1, 1, 1, 0, 1, 0, 1, 1, 0, 0, 1, 0, 1, 0, 1]",135,60,75,10,4,0.16666666666666666,0.05333333333333334
"[1, 0, 0, 0, 0, 1, 1, 0, 0, 0, 0, 0, 0, 0, 0]",6689,2898,3791,288,331,0.09937888198757763,0.08731205486678977
"[1, 0, 1, 0, 0, 0, 0, 1, 1, 0, 0, 0, 0, 0, 0]",1213,836,377,81,43,0.09688995215311005,0.11405835543766578
"[1, 1, 1, 0, 1, 0, 0, 0, 0, 1, 1, 0, 0, 0, 0]",345,184,161,15,16,0.08152173913043478,0.09937888198757763
"[0, 0, 0, 0, 1, 0, 0, 1, 1, 1, 0, 1, 0, 0, 0]",227,151,76,13,5,0.08609271523178808,0.06578947368421052
"[1, 0, 1, 1, 1, 0, 1, 0, 1, 1, 0, 0, 0, 0, 0]",167,90,77,4,7,0.044444444444444446,0.09090909090909091
"[0, 1, 0, 1, 1, 1, 0, 1, 0, 1, 1, 0, 0, 0, 0]",173,95,78,7,6,0.07368421052631578,0.07692307692307693
"[0, 0, 0, 1, 0, 1, 0, 0, 0, 0, 0, 0, 0, 0, 1]",2014,1515,499,144,48,0.09504950495049505,0.09619238476953908
"[1, 1, 1, 1, 0, 0, 0, 0, 1, 1, 0, 0, 0, 0, 1]",1718,821,897,77,95,0.09378806333739342,0.10590858416945373
"[0, 0, 1, 0, 1, 0, 0, 0, 1, 0, 0, 0, 0, 1, 0]",492,340,152,29,14,0.08529411764705883,0.09210526315789473
"[1, 1, 0, 0, 0, 0, 1, 0, 1, 0, 0, 0, 1, 0, 0]",265,175,90,23,5,0.13142857142857142,0.05555555555555555
"[0, 0, 0, 0, 0, 0, 0, 0, 1, 0, 0, 1, 0, 0, 0]",7864,6440,1424,624,143,0.0968944099378882,0.10042134831460674
"[1, 1, 1, 0, 1, 1, 0, 1, 1, 1, 0, 1, 1, 1, 1]",1771,428,1343,39,126,0.0911214953271028,0.09381980640357408
"[1, 1, 0, 1, 1, 1, 0, 1, 1, 1, 1, 1, 1, 0, 0]",805,198,607,17,48,0.08585858585858586,0.07907742998352553
"[1, 1, 1, 1, 0, 1, 1, 1, 1, 0, 1, 1, 0, 1, 1]",1663,405,1258,41,115,0.10123456790123457,0.09141494435612083
"[1, 1, 1, 0, 1, 0, 1, 1, 1, 1, 1, 1, 0, 1, 1]",1604,380,1224,33,87,0.0868421052631579,0.07107843137254902
"[1, 1, 1, 1, 0, 1, 0, 1, 1, 1, 1, 1, 1, 0, 1]",1504,326,1178,24,115,0.0736196319018405,0.09762308998302208
"[1, 1, 1, 1, 0, 1, 0, 1, 0, 0, 0, 1, 0, 1, 0]",102,50,52,9,7,0.18,0.1346153846153846
"[0, 0, 1, 0, 1, 0, 0, 1, 1, 0, 0, 1, 0, 1, 0]",133,83,50,4,6,0.04819277108433735,0.12
"[1, 0, 0, 0, 1, 1, 1, 0, 0, 0, 0, 0, 0, 1, 1]",388,213,175,23,20,0.107981220657277,0.11428571428571428
"[0, 0, 0, 1, 0, 1, 0, 0, 0, 0, 1, 1, 0, 0, 0]",882,634,248,60,23,0.0946372239747634,0.09274193548387097
"[0, 0, 0, 0, 0, 0, 0, 0, 0, 0, 1, 0, 1, 0, 0]",8028,6704,1324,667,116,0.0994928400954654,0.08761329305135952
"[1, 0, 1, 0, 0, 1, 1, 0, 0, 0, 0, 0, 0, 0, 0]",1164,809,355,85,41,0.10506798516687268,0.11549295774647887
"[0, 1, 0, 0, 1, 1, 1, 0, 1, 0, 0, 1, 1, 0, 0]",138,72,66,5,6,0.06944444444444445,0.09090909090909091
"[1, 0, 0, 1, 0, 0, 1, 1, 1, 0, 1, 0, 0, 1, 1]",132,61,71,5,10,0.08196721311475409,0.14084507042253522
"[0, 0, 1, 1, 0, 0, 1, 0, 0, 1, 1, 1, 0, 1, 0]",130,71,59,9,5,0.1267605633802817,0.0847457627118644
"[0, 0, 0, 0, 0, 0, 0, 0, 0, 1, 1, 1, 0, 0, 0]",3096,2459,637,225,63,0.09150061000406669,0.0989010989010989
"[1, 0, 0, 0, 0, 1, 0, 0, 0, 0, 1, 0, 0, 0, 0]",1738,1243,495,147,42,0.11826226870474658,0.08484848484848485
"[0, 0, 0, 1, 1, 0, 0, 0, 0, 0, 0, 0, 0, 1, 0]",2909,2426,483,234,50,0.09645507007419621,0.10351966873706005
"[0, 0, 0, 1, 0, 0, 0, 1, 1, 0, 0, 0, 0, 0, 0]",2765,2151,614,194,69,0.0901906090190609,0.11237785016286644
"[1, 0, 0, 0, 1, 0, 0, 0, 1, 1, 0, 0, 0, 0, 0]",784,521,263,41,28,0.07869481765834933,0.10646387832699619
"[0, 1, 0, 0, 0, 1, 0, 0, 0, 1, 1, 0, 0, 0, 0]",731,510,221,42,24,0.08235294117647059,0.1085972850678733
"[0, 0, 1, 0, 0, 0, 1, 0, 0, 0, 1, 1, 0, 0, 0]",665,485,180,48,18,0.09896907216494845,0.1
"[0, 0, 1, 0, 0, 0, 0, 1, 0, 0, 0, 1, 0, 0, 0]",1603,1228,375,118,30,0.09609120521172639,0.08
"[1, 1, 1, 1, 1, 1, 1, 1, 1, 0, 0, 1, 1, 1, 0]",2813,515,2298,47,218,0.0912621359223301,0.09486510008703221
"[0, 1, 1, 1, 1, 1, 1, 1, 1, 0, 0, 1, 1, 1, 1]",7194,3907,3287,358,312,0.09163040696186332,0.09491937937328872
"[0, 1, 1, 1, 1, 1, 0, 1, 1, 1, 1, 1, 1, 1, 0]",1808,477,1331,37,124,0.07756813417190776,0.09316303531179564
"[0, 1, 1, 0, 0, 1, 0, 1, 1, 1, 1, 0, 1, 1, 0]",123,54,69,4,5,0.07407407407407407,0.07246376811594203
"[1, 1, 0, 1, 1, 0, 0, 1, 0, 1, 1, 1, 1, 0, 1]",191,59,132,6,17,0.1016949152542373,0.12878787878787878
"[0, 1, 1, 0, 0, 1, 1, 0, 1, 0, 0, 1, 1, 1, 1]",269,132,137,14,11,0.10606060606060606,0.08029197080291971
"[0, 0, 1, 1, 0, 0, 1, 1, 0, 1, 0, 0, 1, 1, 1]",269,140,129,10,10,0.07142857142857142,0.07751937984496124
"[0, 0, 0, 0, 0, 0, 0, 0, 0, 0, 1, 1, 0, 0, 1]",7463,5664,1799,547,172,0.09657485875706215,0.09560867148415786
"[0, 1, 1, 1, 1, 0, 1, 0, 1, 0, 0, 0, 0, 0, 0]",247,163,84,15,10,0.09202453987730061,0.11904761904761904
"[1, 1, 1, 1, 1, 1, 1, 1, 0, 1, 1, 1, 1, 0, 1]",7365,1221,6144,106,564,0.08681408681408681,0.091796875
"[0, 1, 1, 1, 0, 1, 1, 1, 1, 1, 1, 1, 1, 0, 1]",1611,402,1209,37,114,0.09203980099502487,0.09429280397022333
"[0, 0, 1, 1, 0, 0, 0, 0, 0, 0, 1, 0, 0, 1, 0]",760,527,233,52,19,0.09867172675521822,0.0815450643776824
"[1, 1, 1, 1, 0, 0, 1, 1, 0, 0, 0, 0, 0, 0, 1]",1670,838,832,75,84,0.08949880668257756,0.10096153846153846
"[0, 0, 0, 1, 1, 1, 1, 1, 1, 0, 0, 1, 1, 0, 0]",1586,1290,296,104,39,0.08062015503875969,0.13175675675675674
"[1, 0, 0, 1, 0, 1, 1, 1, 0, 1, 0, 0, 0, 0, 0]",170,93,77,12,9,0.12903225806451613,0.11688311688311688
"[0, 0, 1, 0, 0, 1, 0, 0, 1, 0, 1, 1, 1, 0, 1]",87,53,34,3,6,0.05660377358490566,0.17647058823529413
"[0, 0, 0, 0, 1, 0, 0, 1, 0, 0, 1, 0, 1, 1, 1]",246,151,95,10,10,0.06622516556291391,0.10526315789473684
"[0, 0, 1, 0, 0, 0, 1, 0, 1, 0, 0, 0, 0, 0, 1]",557,399,158,30,14,0.07518796992481203,0.08860759493670886
"[0, 0, 0, 0, 0, 1, 0, 0, 0, 0, 1, 0, 1, 1, 0]",535,376,159,35,19,0.09308510638297872,0.11949685534591195
"[1, 0, 0, 1, 1, 0, 1, 0, 1, 1, 0, 0, 0, 1, 1]",127,52,75,5,13,0.09615384615384616,0.17333333333333334
"[0, 1, 0, 0, 1, 0, 0, 1, 0, 0, 1, 1, 1, 0, 0]",158,91,67,4,4,0.04395604395604396,0.05970149253731343
"[1, 1, 1, 1, 1, 0, 0, 0, 0, 1, 0, 0, 1, 0, 0]",171,64,107,6,13,0.09375,0.12149532710280374
"[1, 1, 1, 0, 1, 1, 1, 1, 1, 1, 1, 1, 0, 0, 0]",1112,336,776,30,80,0.08928571428571429,0.10309278350515463
"[0, 1, 1, 0, 1, 1, 1, 0, 1, 1, 0, 1, 0, 0, 1]",129,60,69,3,5,0.05,0.07246376811594203
"[0, 0, 0, 0, 1, 1, 0, 0, 0, 0, 1, 1, 0, 0, 1]",2332,1465,867,129,76,0.08805460750853242,0.08765859284890427
"[0, 0, 0, 1, 0, 0, 1, 1, 0, 1, 1, 0, 0, 1, 1]",159,96,63,10,5,0.10416666666666667,0.07936507936507936
"[0, 0, 0, 0, 1, 0, 0, 1, 1, 0, 1, 1, 0, 0, 1]",177,102,75,8,1,0.0784313725490196,0.013333333333333334
"[0, 0, 1, 0, 0, 1, 1, 0, 1, 1, 1, 1, 1, 1, 1]",354,138,216,13,16,0.09420289855072464,0.07407407407407407
"[0, 0, 0, 0, 1, 0, 0, 1, 1, 0, 1, 1, 1, 1, 1]",203,113,90,12,11,0.10619469026548672,0.12222222222222222
"[0, 1, 0, 1, 1, 1, 0, 0, 0, 1, 1, 0, 0, 0, 0]",231,132,99,11,11,0.08333333333333333,0.1111111111111111
"[1, 1, 1, 1, 0, 0, 0, 0, 1, 1, 0, 0, 0, 0, 0]",1944,1148,796,105,72,0.09146341463414634,0.09045226130653267
"[1, 1, 1, 1, 0, 1, 1, 1, 1, 1, 0, 0, 0, 1, 0]",230,82,148,7,16,0.08536585365853659,0.10810810810810811
"[1, 0, 1, 0, 0, 1, 0, 0, 0, 1, 0, 0, 1, 0, 0]",247,146,101,18,7,0.1232876712328767,0.06930693069306931
"[1, 1, 1, 1, 1, 1, 1, 0, 1, 1, 0, 0, 0, 1, 1]",786,209,577,16,53,0.07655502392344497,0.09185441941074524
"[1, 1, 0, 1, 1, 1, 0, 0, 0, 1, 1, 1, 1, 1, 1]",850,253,597,26,59,0.10276679841897234,0.09882747068676717
"[1, 0, 1, 1, 1, 1, 1, 0, 0, 0, 1, 1, 1, 1, 1]",759,242,517,20,45,0.08264462809917356,0.08704061895551257
"[0, 0, 1, 1, 1, 1, 1, 1, 0, 0, 0, 0, 1, 1, 0]",1512,806,706,107,63,0.1327543424317618,0.08923512747875353
"[1, 0, 1, 1, 1, 1, 1, 1, 1, 0, 1, 0, 0, 1, 0]",215,80,135,11,17,0.1375,0.1259259259259259
"[0, 0, 0, 0, 0, 0, 1, 1, 1, 1, 0, 0, 0, 1, 0]",629,419,210,48,13,0.11455847255369929,0.06190476190476191
"[0, 0, 0, 0, 1, 1, 0, 1, 1, 0, 1, 0, 1, 0, 1]",110,61,49,7,3,0.11475409836065574,0.061224489795918366
"[0, 0, 1, 0, 0, 0, 0, 1, 0, 0, 0, 0, 0, 0, 0]",8088,6636,1452,607,144,0.09147076552139843,0.09917355371900827
"[0, 0, 0, 0, 1, 1, 0, 0, 1, 0, 0, 0, 0, 1, 0]",633,458,175,46,15,0.10043668122270742,0.08571428571428572
"[0, 0, 0, 0, 0, 0, 1, 1, 0, 0, 1, 0, 0, 0, 0]",2401,1853,548,181,42,0.09767943874797626,0.07664233576642336
"[0, 0, 0, 1, 1, 1, 0, 0, 0, 0, 1, 0, 0, 1, 1]",249,156,93,13,14,0.08333333333333333,0.15053763440860216
"[1, 0, 0, 0, 1, 1, 1, 0, 0, 0, 0, 1, 0, 0, 1]",173,96,77,10,4,0.10416666666666667,0.05194805194805195
"[0, 1, 1, 0, 0, 0, 1, 1, 1, 0, 0, 0, 0, 1, 0]",149,97,52,7,5,0.07216494845360824,0.09615384615384616
"[0, 1, 1, 1, 0, 0, 1, 1, 1, 0, 1, 0, 1, 1, 1]",264,99,165,10,12,0.10101010101010101,0.07272727272727272
"[1, 0, 1, 1, 1, 1, 1, 1, 1, 0, 1, 1, 1, 0, 1]",1553,356,1197,38,115,0.10674157303370786,0.0960735171261487
"[0, 1, 1, 1, 1, 0, 0, 1, 1, 1, 1, 0, 0, 1, 1]",2308,1671,637,144,58,0.08617594254937164,0.09105180533751962
"[1, 1, 1, 1, 1, 1, 0, 0, 1, 1, 1, 1, 0, 0, 1]",4788,1394,3394,123,296,0.08823529411764706,0.08721272834413671
"[0, 0, 0, 1, 1, 1, 0, 1, 0, 0, 1, 0, 1, 1, 1]",160,99,61,9,2,0.09090909090909091,0.03278688524590164
"[1, 0, 0, 0, 0, 0, 0, 0, 0, 0, 0, 1, 1, 1, 0]",1019,547,472,52,49,0.09506398537477148,0.1038135593220339
"[1, 1, 1, 0, 1, 0, 1, 0, 1, 1, 1, 0, 1, 1, 0]",222,81,141,6,14,0.07407407407407407,0.09929078014184398
"[1, 0, 1, 0, 1, 1, 0, 1, 1, 1, 1, 1, 0, 1, 1]",515,154,361,10,32,0.06493506493506493,0.0886426592797784
"[0, 1, 0, 0, 0, 1, 0, 0, 1, 1, 1, 1, 1, 1, 1]",281,131,150,8,11,0.061068702290076333,0.07333333333333333
"[0, 1, 0, 0, 0, 0, 1, 1, 1, 1, 0, 1, 0, 1, 0]",111,50,61,4,7,0.08,0.11475409836065574
"[1, 1, 1, 0, 0, 1, 0, 1, 1, 1, 1, 1, 1, 1, 1]",2379,527,1852,44,154,0.08349146110056926,0.08315334773218143
"[0, 0, 0, 0, 1, 0, 1, 0, 0, 0, 0, 0, 0, 0, 1]",1937,1477,460,134,48,0.0907244414353419,0.10434782608695652
"[0, 0, 0, 0, 0, 0, 0, 1, 0, 1, 1, 0, 1, 0, 0]",566,413,153,40,18,0.09685230024213075,0.11764705882352941
"[0, 0, 1, 0, 1, 0, 0, 1, 0, 1, 1, 0, 1, 0, 0]",161,93,68,11,11,0.11827956989247312,0.16176470588235295
"[0, 1, 1, 1, 1, 1, 1, 1, 1, 1, 1, 1, 0, 0, 1]",3961,1293,2668,141,260,0.10904872389791183,0.09745127436281859
"[0, 0, 1, 1, 1, 1, 1, 1, 1, 1, 1, 1, 1, 0, 0]",1870,590,1280,51,141,0.08644067796610169,0.11015625
"[1, 1, 1, 0, 0, 1, 1, 1, 1, 1, 1, 1, 1, 0, 0]",4228,592,3636,61,343,0.10304054054054054,0.09433443344334433
"[0, 1, 0, 0, 0, 0, 1, 0, 0, 1, 1, 1, 0, 1, 0]",121,62,59,6,3,0.0967741935483871,0.05084745762711865
"[0, 1, 0, 0, 0, 0, 0, 0, 0, 0, 1, 0, 1, 1, 1]",524,385,139,47,17,0.12207792207792208,0.1223021582733813
"[1, 1, 1, 0, 0, 1, 1, 0, 1, 0, 0, 1, 1, 0, 0]",149,59,90,5,7,0.0847457627118644,0.07777777777777778
"[0, 1, 1, 1, 1, 1, 1, 1, 0, 0, 1, 1, 0, 1, 0]",271,104,167,9,20,0.08653846153846154,0.11976047904191617
"[1, 1, 0, 1, 0, 1, 1, 1, 1, 0, 1, 0, 1, 1, 1]",576,168,408,16,39,0.09523809523809523,0.09558823529411764
"[1, 1, 1, 1, 1, 1, 1, 1, 0, 0, 1, 1, 1, 0, 0]",1125,356,769,31,88,0.08707865168539326,0.11443433029908973
"[1, 1, 0, 0, 0, 0, 0, 0, 0, 0, 1, 1, 1, 0, 1]",404,238,166,26,21,0.1092436974789916,0.12650602409638553
"[0, 1, 1, 1, 1, 0, 0, 0, 0, 0, 0, 0, 0, 1, 1]",2271,1905,366,184,29,0.09658792650918635,0.07923497267759563
"[0, 1, 0, 0, 1, 1, 1, 1, 0, 0, 0, 0, 0, 0, 0]",778,512,266,53,26,0.103515625,0.09774436090225563
"[1, 1, 0, 1, 0, 0, 1, 1, 1, 1, 0, 0, 0, 0, 0]",272,136,136,10,14,0.07352941176470588,0.10294117647058823
"[0, 0, 0, 0, 1, 1, 1, 1, 0, 1, 0, 0, 1, 1, 1]",299,149,150,10,12,0.06711409395973154,0.08
"[1, 1, 1, 1, 1, 1, 1, 1, 0, 1, 0, 0, 0, 0, 1]",437,141,296,13,25,0.09219858156028368,0.08445945945945946
"[0, 0, 1, 1, 1, 1, 0, 1, 0, 1, 1, 1, 0, 0, 0]",163,69,94,9,15,0.13043478260869565,0.1595744680851064
"[1, 0, 1, 1, 1, 1, 1, 0, 1, 0, 1, 1, 1, 1, 1]",1723,426,1297,48,118,0.11267605633802817,0.09097918272937548
"[0, 0, 1, 0, 0, 0, 0, 0, 0, 0, 0, 1, 1, 1, 1]",1184,799,385,67,45,0.08385481852315395,0.11688311688311688
"[0, 1, 1, 0, 0, 0, 0, 0, 1, 0, 0, 1, 0, 0, 0]",585,429,156,39,13,0.09090909090909091,0.08333333333333333
"[0, 1, 1, 1, 0, 0, 0, 1, 1, 0, 0, 0, 0, 0, 1]",175,108,67,8,6,0.07407407407407407,0.08955223880597014
"[0, 0, 0, 0, 1, 1, 1, 0, 0, 0, 1, 1, 0, 0, 0]",361,245,116,26,5,0.10612244897959183,0.04310344827586207
"[0, 0, 0, 0, 0, 1, 1, 1, 0, 0, 0, 1, 1, 0, 0]",378,269,109,29,13,0.10780669144981413,0.11926605504587157
"[0, 0, 0, 1, 1, 0, 0, 0, 1, 1, 0, 1, 0, 0, 1]",182,124,58,10,3,0.08064516129032258,0.05172413793103448
"[0, 0, 0, 0, 0, 1, 0, 0, 1, 0, 0, 1, 0, 0, 0]",1618,1272,346,134,32,0.10534591194968554,0.09248554913294797
"[0, 0, 0, 0, 1, 1, 0, 0, 1, 1, 0, 0, 0, 1, 0]",612,409,203,40,24,0.097799511002445,0.11822660098522167
"[0, 0, 1, 1, 1, 1, 1, 1, 1, 1, 1, 1, 0, 1, 1]",3256,826,2430,73,263,0.08837772397094432,0.10823045267489712
"[1, 0, 1, 1, 0, 0, 0, 1, 1, 1, 1, 0, 0, 1, 1]",372,144,228,16,26,0.1111111111111111,0.11403508771929824
"[1, 1, 0, 1, 1, 0, 1, 1, 0, 0, 0, 0, 0, 0, 1]",205,108,97,6,6,0.05555555555555555,0.061855670103092786
"[0, 0, 0, 0, 0, 1, 1, 1, 0, 1, 1, 0, 1, 1, 0]",144,86,58,8,8,0.09302325581395349,0.13793103448275862
"[1, 0, 0, 1, 1, 0, 1, 1, 0, 0, 1, 1, 1, 0, 0]",140,55,85,7,8,0.12727272727272726,0.09411764705882353
"[1, 1, 1, 1, 1, 0, 1, 1, 0, 1, 0, 1, 1, 0, 0]",298,102,196,11,19,0.10784313725490197,0.09693877551020408
"[1, 0, 1, 1, 0, 1, 1, 1, 1, 0, 0, 1, 0, 0, 1]",151,61,90,3,8,0.04918032786885246,0.08888888888888889
"[0, 1, 1, 0, 0, 1, 0, 0, 1, 0, 0, 1, 1, 1, 1]",208,116,92,14,11,0.1206896551724138,0.11956521739130435
"[1, 0, 0, 1, 0, 1, 1, 0, 1, 1, 1, 0, 1, 1, 0]",128,42,86,6,8,0.14285714285714285,0.09302325581395349
"[0, 0, 1, 1, 0, 0, 0, 0, 1, 1, 1, 0, 0, 1, 1]",368,218,150,15,9,0.06880733944954129,0.06
"[1, 0, 0, 1, 1, 0, 0, 0, 0, 1, 1, 1, 0, 0, 1]",244,88,156,13,12,0.14772727272727273,0.07692307692307693
"[1, 1, 1, 1, 1, 1, 0, 0, 1, 1, 0, 0, 0, 0, 1]",2182,869,1313,93,120,0.10701956271576525,0.0913937547600914
"[0, 0, 0, 0, 1, 0, 1, 0, 0, 1, 0, 0, 0, 0, 0]",1714,1345,369,126,49,0.09368029739776952,0.13279132791327913
"[1, 1, 1, 0, 0, 0, 0, 0, 0, 0, 0, 0, 1, 1, 1]",1040,387,653,33,65,0.08527131782945736,0.0995405819295559
"[0, 0, 0, 1, 0, 0, 1, 0, 0, 0, 0, 1, 0, 1, 1]",273,178,95,22,13,0.12359550561797752,0.1368421052631579
"[0, 1, 0, 0, 0, 0, 0, 1, 0, 0, 0, 1, 0, 0, 1]",448,314,134,28,13,0.08917197452229299,0.09701492537313433
"[1, 1, 0, 0, 1, 0, 0, 0, 0, 0, 0, 1, 0, 0, 0]",563,390,173,35,15,0.08974358974358974,0.08670520231213873
"[0, 0, 1, 0, 0, 0, 0, 1, 1, 1, 0, 0, 1, 0, 0]",264,160,104,15,14,0.09375,0.1346153846153846
"[1, 0, 0, 1, 0, 1, 1, 0, 0, 1, 0, 1, 0, 0, 0]",150,85,65,10,6,0.11764705882352941,0.09230769230769231
"[0, 0, 0, 0, 0, 0, 1, 0, 0, 1, 1, 0, 0, 0, 0]",2643,2055,588,170,50,0.0827250608272506,0.08503401360544217
"[0, 0, 1, 0, 1, 0, 0, 0, 0, 0, 0, 0, 0, 0, 0]",9530,7710,1820,716,193,0.09286640726329443,0.10604395604395604
"[0, 0, 1, 0, 0, 0, 0, 1, 0, 1, 0, 0, 1, 0, 1]",230,157,73,17,8,0.10828025477707007,0.1095890410958904
"[0, 0, 0, 0, 1, 0, 0, 0, 0, 1, 0, 1, 0, 0, 1]",530,370,160,38,10,0.10270270270270271,0.0625
"[0, 0, 0, 0, 1, 1, 0, 1, 1, 1, 0, 1, 0, 0, 1]",127,71,56,8,6,0.11267605633802817,0.10714285714285714
"[0, 0, 0, 0, 0, 0, 0, 0, 1, 1, 0, 1, 1, 1, 0]",323,214,109,22,13,0.102803738317757,0.11926605504587157
"[1, 1, 0, 1, 0, 0, 0, 0, 0, 0, 1, 1, 1, 1, 0]",297,147,150,10,15,0.06802721088435375,0.1
"[0, 0, 1, 1, 0, 1, 0, 0, 0, 0, 0, 0, 1, 1, 1]",417,263,154,22,16,0.08365019011406843,0.1038961038961039
"[0, 0, 1, 0, 1, 1, 0, 0, 1, 1, 1, 0, 1, 0, 0]",128,62,66,6,6,0.0967741935483871,0.09090909090909091
"[0, 0, 1, 0, 0, 1, 0, 1, 1, 0, 0, 1, 1, 1, 0]",111,54,57,6,3,0.1111111111111111,0.05263157894736842
"[0, 1, 0, 1, 1, 0, 0, 0, 0, 1, 0, 0, 0, 1, 0]",230,149,81,14,6,0.09395973154362416,0.07407407407407407
"[0, 0, 0, 1, 0, 0, 1, 0, 0, 0, 0, 0, 0, 0, 1]",1881,1471,410,157,39,0.10673011556764106,0.0951219512195122
"[0, 1, 1, 1, 0, 0, 1, 1, 1, 1, 0, 1, 1, 1, 1]",619,196,423,14,44,0.07142857142857142,0.10401891252955082
"[1, 1, 0, 1, 1, 1, 0, 0, 1, 1, 1, 1, 0, 1, 1]",578,175,403,18,36,0.10285714285714286,0.08933002481389578
"[0, 1, 1, 1, 1, 0, 0, 0, 1, 0, 0, 0, 0, 1, 1]",206,116,90,12,5,0.10344827586206896,0.05555555555555555
"[0, 1, 0, 0, 0, 1, 1, 1, 1, 0, 1, 1, 0, 0, 1]",133,63,70,6,9,0.09523809523809523,0.12857142857142856
"[0, 0, 1, 1, 1, 0, 1, 0, 0, 0, 1, 1, 1, 1, 0]",175,95,80,5,12,0.05263157894736842,0.15
"[1, 0, 0, 1, 1, 1, 0, 1, 0, 0, 0, 1, 1, 1, 1]",252,92,160,11,14,0.11956521739130435,0.0875
"[0, 0, 0, 1, 0, 0, 0, 1, 0, 0, 1, 0, 1, 0, 1]",230,150,80,17,9,0.11333333333333333,0.1125
"[1, 0, 0, 0, 1, 1, 1, 1, 0, 0, 1, 0, 1, 0, 1]",127,66,61,5,3,0.07575757575757576,0.04918032786885246
"[1, 1, 0, 1, 1, 1, 1, 1, 0, 1, 0, 0, 0, 1, 0]",138,57,81,6,6,0.10526315789473684,0.07407407407407407
"[1, 1, 0, 1, 0, 0, 1, 0, 0, 0, 1, 1, 1, 1, 1]",211,111,100,15,17,0.13513513513513514,0.17
"[1, 1, 1, 1, 1, 0, 1, 0, 1, 0, 1, 1, 1, 1, 1]",1897,384,1513,46,146,0.11979166666666667,0.09649702577660278
"[0, 1, 1, 0, 0, 0, 1, 1, 1, 0, 1, 0, 1, 1, 1]",197,88,109,11,5,0.125,0.045871559633027525
"[0, 0, 1, 1, 0, 0, 0, 1, 1, 1, 0, 1, 0, 1, 1]",157,75,82,7,6,0.09333333333333334,0.07317073170731707
"[1, 1, 0, 1, 0, 0, 1, 1, 0, 0, 0, 1, 1, 1, 0]",132,63,69,4,5,0.06349206349206349,0.07246376811594203
"[1, 1, 1, 1, 0, 1, 0, 0, 1, 1, 0, 0, 0, 1, 1]",191,86,105,9,9,0.10465116279069768,0.08571428571428572
"[1, 1, 0, 0, 1, 0, 0, 0, 1, 1, 1, 1, 0, 1, 0]",121,48,73,3,9,0.0625,0.1232876712328767
"[0, 1, 1, 0, 0, 0, 0, 0, 0, 1, 0, 0, 0, 1, 1]",542,433,109,43,6,0.09930715935334873,0.05504587155963303
"[1, 0, 0, 1, 0, 1, 1, 1, 1, 1, 1, 0, 0, 1, 1]",471,168,303,11,29,0.06547619047619048,0.09570957095709572
"[1, 1, 1, 0, 0, 0, 1, 0, 0, 0, 1, 1, 1, 0, 1]",117,55,62,2,3,0.03636363636363636,0.04838709677419355
"[0, 1, 1, 1, 1, 1, 1, 1, 1, 1, 0, 1, 1, 1, 1]",8628,2196,6432,214,608,0.09744990892531877,0.0945273631840796
"[0, 1, 0, 0, 1, 0, 1, 1, 1, 0, 1, 1, 1, 1, 1]",276,118,158,11,15,0.09322033898305085,0.0949367088607595
"[1, 1, 1, 1, 0, 0, 1, 0, 0, 1, 0, 1, 1, 1, 0]",180,70,110,5,16,0.07142857142857142,0.14545454545454545
"[0, 1, 1, 1, 1, 1, 0, 1, 1, 1, 1, 0, 1, 1, 1]",1759,505,1254,44,105,0.08712871287128712,0.08373205741626795
"[0, 1, 1, 1, 0, 1, 0, 0, 0, 0, 0, 1, 0, 0, 0]",244,153,91,18,6,0.11764705882352941,0.06593406593406594
"[1, 1, 0, 0, 0, 1, 1, 0, 0, 1, 0, 1, 1, 1, 0]",133,60,73,6,7,0.1,0.0958904109589041
"[1, 0, 1, 1, 0, 0, 0, 0, 0, 0, 0, 1, 0, 1, 1]",161,93,68,5,7,0.053763440860215055,0.10294117647058823
"[1, 0, 0, 0, 1, 1, 0, 0, 1, 1, 1, 1, 0, 0, 0]",446,236,210,21,20,0.08898305084745763,0.09523809523809523
"[1, 1, 0, 0, 0, 1, 1, 0, 0, 1, 1, 1, 1, 0, 0]",437,210,227,13,24,0.06190476190476191,0.10572687224669604
"[0, 1, 1, 1, 0, 0, 0, 1, 1, 0, 0, 1, 1, 1, 1]",354,161,193,17,15,0.10559006211180125,0.07772020725388601
"[0, 1, 1, 0, 0, 0, 0, 1, 1, 0, 0, 0, 0, 0, 0]",4467,3892,575,374,52,0.09609455292908531,0.09043478260869565
"[1, 1, 0, 0, 0, 1, 1, 0, 1, 1, 1, 1, 1, 0, 0]",212,84,128,5,10,0.05952380952380952,0.078125
"[1, 1, 1, 1, 0, 0, 0, 1, 1, 0, 1, 1, 1, 1, 1]",824,235,589,26,60,0.11063829787234042,0.10186757215619695
"[0, 0, 0, 0, 1, 0, 0, 0, 0, 0, 0, 1, 0, 1, 0]",1606,1237,369,109,35,0.08811641067097817,0.0948509485094851
"[0, 0, 0, 0, 0, 1, 0, 0, 0, 0, 0, 0, 1, 0, 1]",1745,1355,390,130,37,0.0959409594095941,0.09487179487179487
"[0, 1, 1, 0, 1, 1, 0, 0, 0, 0, 0, 0, 1, 0, 0]",280,186,94,16,10,0.08602150537634409,0.10638297872340426
"[0, 0, 0, 1, 1, 0, 0, 0, 0, 0, 0, 0, 1, 1, 1]",1921,1648,273,138,26,0.08373786407766991,0.09523809523809523
"[1, 1, 1, 1, 1, 0, 1, 1, 0, 1, 1, 0, 0, 0, 0]",285,92,193,5,20,0.05434782608695652,0.10362694300518134
"[0, 0, 0, 1, 1, 0, 1, 1, 1, 1, 1, 1, 0, 1, 1]",277,115,162,12,17,0.10434782608695652,0.10493827160493827
"[0, 1, 0, 1, 0, 0, 0, 1, 1, 0, 1, 1, 1, 1, 1]",205,87,118,10,11,0.11494252873563218,0.09322033898305085
"[0, 1, 1, 0, 1, 0, 1, 0, 0, 0, 1, 1, 0, 1, 1]",123,60,63,7,13,0.11666666666666667,0.20634920634920634
"[1, 0, 0, 1, 1, 0, 1, 0, 1, 0, 0, 0, 1, 1, 0]",117,65,52,8,6,0.12307692307692308,0.11538461538461539
"[1, 0, 0, 0, 1, 1, 1, 0, 1, 0, 0, 1, 1, 0, 1]",100,48,52,6,5,0.125,0.09615384615384616
"[0, 1, 1, 0, 1, 0, 0, 0, 1, 1, 1, 0, 1, 0, 0]",104,56,48,2,2,0.03571428571428571,0.041666666666666664
"[1, 0, 1, 0, 0, 0, 1, 0, 1, 1, 0, 0, 1, 1, 0]",159,93,66,8,11,0.08602150537634409,0.16666666666666666
"[0, 0, 1, 1, 1, 0, 1, 0, 1, 0, 0, 0, 1, 0, 1]",115,66,49,5,5,0.07575757575757576,0.10204081632653061
"[0, 0, 1, 1, 0, 0, 0, 0, 1, 0, 0, 0, 0, 1, 1]",548,366,182,35,17,0.09562841530054644,0.09340659340659341
"[0, 0, 1, 0, 0, 0, 1, 1, 1, 1, 1, 1, 1, 1, 1]",604,233,371,17,28,0.07296137339055794,0.07547169811320754
"[0, 0, 0, 0, 1, 1, 0, 1, 1, 1, 0, 0, 1, 1, 0]",154,81,73,7,8,0.08641975308641975,0.1095890410958904
"[0, 1, 1, 0, 0, 0, 0, 1, 1, 1, 1, 1, 1, 1, 1]",2723,1984,739,217,66,0.109375,0.08930987821380243
"[1, 1, 1, 0, 1, 1, 0, 1, 1, 1, 0, 0, 0, 1, 1]",321,107,214,10,14,0.09345794392523364,0.06542056074766354
"[1, 1, 1, 0, 1, 1, 1, 0, 0, 1, 1, 0, 1, 1, 1]",624,189,435,15,59,0.07936507936507936,0.135632183908046
"[0, 0, 1, 1, 1, 0, 1, 1, 1, 0, 0, 1, 1, 0, 1]",146,69,77,7,4,0.10144927536231885,0.05194805194805195
"[0, 1, 0, 0, 1, 0, 0, 1, 1, 1, 0, 1, 1, 1, 0]",115,62,53,10,6,0.16129032258064516,0.11320754716981132
"[1, 0, 0, 1, 0, 1, 0, 0, 1, 0, 0, 1, 1, 1, 0]",103,50,53,6,3,0.12,0.05660377358490566
"[0, 0, 1, 0, 1, 0, 0, 1, 0, 0, 0, 0, 0, 1, 0]",515,368,147,44,16,0.11956521739130435,0.10884353741496598
"[1, 0, 0, 0, 1, 0, 0, 0, 1, 0, 1, 0, 0, 1, 0]",224,149,75,10,5,0.06711409395973154,0.06666666666666667
"[1, 0, 0, 0, 0, 0, 0, 0, 0, 0, 0, 0, 1, 1, 0]",4002,2736,1266,265,116,0.09685672514619884,0.09162717219589257
"[1, 1, 0, 0, 0, 0, 0, 0, 1, 0, 0, 0, 0, 0, 1]",794,569,225,51,22,0.08963093145869948,0.09777777777777778
"[0, 1, 0, 0, 0, 0, 0, 0, 1, 0, 0, 0, 1, 1, 0]",634,452,182,42,23,0.09292035398230089,0.12637362637362637
"[0, 0, 0, 0, 0, 1, 0, 1, 0, 0, 0, 0, 0, 0, 1]",1987,1540,447,168,46,0.10909090909090909,0.1029082774049217
"[1, 1, 1, 0, 0, 0, 0, 0, 0, 1, 1, 0, 0, 1, 1]",1659,358,1301,36,117,0.1005586592178771,0.08993082244427364
"[0, 1, 0, 1, 1, 0, 1, 1, 1, 0, 0, 0, 0, 1, 1]",200,88,112,9,7,0.10227272727272728,0.0625
"[1, 1, 1, 1, 0, 1, 0, 0, 0, 1, 0, 0, 1, 0, 1]",115,58,57,4,6,0.06896551724137931,0.10526315789473684
"[0, 1, 1, 1, 1, 1, 0, 1, 0, 0, 0, 1, 0, 0, 1]",113,55,58,2,5,0.03636363636363636,0.08620689655172414
"[0, 0, 0, 1, 0, 0, 1, 1, 1, 1, 1, 0, 1, 0, 0]",116,65,51,8,9,0.12307692307692308,0.17647058823529413
"[1, 0, 0, 0, 0, 0, 0, 0, 1, 0, 1, 0, 1, 1, 0]",261,159,102,16,11,0.10062893081761007,0.10784313725490197
"[0, 1, 1, 0, 0, 0, 1, 0, 0, 0, 1, 0, 0, 1, 1]",192,117,75,14,6,0.11965811965811966,0.08
"[1, 0, 0, 1, 1, 0, 0, 0, 1, 0, 0, 0, 1, 0, 0]",237,132,105,10,12,0.07575757575757576,0.11428571428571428
"[0, 0, 1, 1, 0, 0, 0, 1, 1, 1, 1, 1, 1, 1, 0]",258,117,141,6,12,0.05128205128205128,0.0851063829787234
"[0, 1, 0, 0, 1, 0, 1, 1, 0, 1, 1, 0, 1, 0, 1]",103,48,55,7,3,0.14583333333333334,0.05454545454545454
"[0, 0, 1, 1, 1, 0, 1, 0, 1, 1, 1, 0, 1, 0, 0]",95,51,44,5,5,0.09803921568627451,0.11363636363636363
"[1, 0, 1, 0, 0, 1, 0, 0, 0, 0, 0, 0, 1, 1, 0]",344,211,133,14,12,0.06635071090047394,0.09022556390977443
"[0, 1, 0, 1, 0, 0, 0, 0, 0, 1, 0, 1, 0, 0, 1]",221,148,73,11,8,0.07432432432432433,0.1095890410958904
"[0, 0, 0, 0, 1, 1, 1, 0, 1, 0, 0, 1, 0, 1, 0]",169,105,64,10,5,0.09523809523809523,0.078125
"[0, 1, 0, 0, 0, 0, 0, 1, 1, 1, 0, 1, 0, 0, 1]",149,92,57,6,8,0.06521739130434782,0.14035087719298245
"[1, 1, 1, 1, 0, 0, 0, 0, 0, 0, 0, 0, 1, 0, 0]",691,434,257,40,22,0.09216589861751152,0.08560311284046693
"[0, 1, 1, 0, 1, 1, 0, 0, 0, 1, 0, 1, 1, 1, 1]",199,94,105,16,7,0.1702127659574468,0.06666666666666667
"[0, 0, 1, 0, 0, 0, 1, 0, 0, 0, 0, 1, 1, 0, 1]",271,172,99,14,9,0.08139534883720931,0.09090909090909091
"[1, 1, 1, 0, 0, 0, 0, 1, 0, 0, 0, 1, 0, 0, 0]",287,159,128,11,13,0.06918238993710692,0.1015625
"[1, 1, 1, 0, 0, 1, 1, 0, 0, 0, 0, 1, 0, 1, 0]",235,76,159,6,17,0.07894736842105263,0.1069182389937107
"[0, 0, 0, 0, 0, 0, 0, 1, 0, 1, 1, 1, 0, 0, 1]",320,219,101,19,8,0.0867579908675799,0.07920792079207921
"[1, 0, 0, 1, 1, 0, 0, 0, 0, 0, 0, 0, 1, 0, 1]",431,193,238,17,25,0.08808290155440414,0.10504201680672269
"[0, 1, 0, 0, 1, 1, 0, 0, 0, 0, 0, 0, 0, 1, 0]",592,419,173,35,17,0.08353221957040573,0.09826589595375723
"[0, 1, 0, 0, 0, 1, 1, 1, 0, 1, 1, 0, 0, 0, 0]",184,112,72,14,6,0.125,0.08333333333333333
"[1, 0, 0, 0, 0, 1, 1, 0, 1, 1, 0, 0, 0, 0, 1]",199,90,109,9,5,0.1,0.045871559633027525
"[0, 1, 0, 0, 1, 0, 0, 0, 0, 1, 1, 0, 1, 1, 0]",131,84,47,7,5,0.08333333333333333,0.10638297872340426
"[0, 0, 1, 0, 0, 1, 0, 0, 0, 0, 1, 1, 0, 1, 1]",167,106,61,7,2,0.0660377358490566,0.03278688524590164
"[0, 0, 1, 1, 1, 0, 0, 0, 0, 1, 0, 0, 0, 0, 1]",281,193,88,20,7,0.10362694300518134,0.07954545454545454
"[0, 1, 0, 0, 0, 1, 1, 1, 0, 0, 0, 0, 1, 0, 0]",261,166,95,13,8,0.0783132530120482,0.08421052631578947
"[0, 1, 1, 1, 1, 1, 0, 1, 0, 0, 0, 1, 1, 1, 0]",141,70,71,6,4,0.08571428571428572,0.056338028169014086
"[1, 1, 1, 1, 0, 0, 1, 0, 1, 1, 1, 0, 0, 0, 1]",193,75,118,10,14,0.13333333333333333,0.11864406779661017
"[0, 0, 0, 1, 1, 0, 0, 0, 1, 1, 1, 1, 0, 0, 1]",252,156,96,7,12,0.04487179487179487,0.125
"[0, 1, 1, 1, 1, 0, 0, 0, 0, 1, 1, 0, 0, 0, 1]",415,315,100,28,9,0.08888888888888889,0.09
"[0, 0, 0, 0, 1, 1, 1, 0, 1, 0, 0, 0, 1, 1, 1]",270,160,110,8,17,0.05,0.15454545454545454
"[1, 0, 0, 0, 0, 0, 1, 1, 1, 0, 1, 0, 0, 0, 1]",155,84,71,8,6,0.09523809523809523,0.08450704225352113
"[1, 0, 1, 0, 0, 0, 1, 0, 0, 1, 0, 0, 0, 0, 0]",550,382,168,42,19,0.1099476439790576,0.1130952380952381
"[0, 1, 0, 1, 0, 0, 0, 1, 0, 0, 1, 0, 0, 1, 1]",172,101,71,9,4,0.0891089108910891,0.056338028169014086
"[0, 0, 0, 0, 1, 1, 1, 0, 0, 1, 0, 1, 0, 1, 0]",133,70,63,8,4,0.11428571428571428,0.06349206349206349
"[0, 0, 1, 0, 1, 1, 0, 1, 0, 0, 0, 0, 1, 0, 1]",137,90,47,6,2,0.06666666666666667,0.0425531914893617
"[1, 1, 0, 0, 0, 1, 0, 0, 1, 0, 0, 1, 0, 0, 0]",251,164,87,16,6,0.0975609756097561,0.06896551724137931
"[0, 0, 1, 0, 1, 0, 0, 0, 0, 0, 0, 0, 0, 1, 1]",1208,888,320,84,25,0.0945945945945946,0.078125
"[0, 0, 0, 0, 0, 0, 0, 0, 1, 1, 1, 0, 0, 1, 0]",765,556,209,56,19,0.10071942446043165,0.09090909090909091
"[0, 1, 1, 1, 1, 0, 0, 0, 0, 1, 1, 0, 1, 1, 0]",200,144,56,14,7,0.09722222222222222,0.125
"[1, 0, 0, 0, 0, 0, 0, 1, 0, 0, 1, 0, 0, 0, 0]",1744,1241,503,111,51,0.0894439967767929,0.10139165009940358
"[0, 0, 1, 0, 1, 1, 0, 0, 0, 1, 0, 0, 0, 0, 0]",595,420,175,36,15,0.08571428571428572,0.08571428571428572
"[0, 1, 0, 1, 1, 0, 1, 1, 0, 1, 0, 0, 1, 0, 1]",93,45,48,3,3,0.06666666666666667,0.0625
"[1, 0, 1, 1, 1, 0, 0, 0, 0, 1, 0, 0, 0, 0, 0]",281,174,107,17,7,0.09770114942528736,0.06542056074766354
"[0, 1, 1, 0, 0, 0, 0, 0, 0, 0, 0, 0, 1, 0, 0]",2374,1939,435,179,42,0.09231562661165549,0.09655172413793103
"[0, 1, 0, 1, 0, 0, 0, 1, 0, 1, 0, 1, 1, 0, 1]",113,53,60,5,4,0.09433962264150944,0.06666666666666667
"[1, 1, 0, 0, 0, 1, 0, 1, 0, 1, 0, 0, 0, 0, 1]",161,90,71,14,4,0.15555555555555556,0.056338028169014086
"[1, 0, 0, 1, 1, 0, 0, 0, 1, 1, 0, 0, 1, 0, 1]",156,73,83,5,4,0.0684931506849315,0.04819277108433735
"[0, 0, 0, 1, 0, 1, 0, 0, 1, 1, 0, 0, 0, 1, 1]",195,117,78,16,8,0.13675213675213677,0.10256410256410256
"[1, 0, 0, 0, 1, 0, 1, 0, 0, 0, 1, 0, 1, 0, 0]",244,161,83,18,10,0.11180124223602485,0.12048192771084337
"[0, 1, 0, 0, 0, 0, 0, 1, 0, 0, 0, 1, 0, 0, 0]",1524,1168,356,112,27,0.0958904109589041,0.07584269662921349
"[1, 0, 1, 1, 0, 1, 0, 0, 0, 0, 1, 1, 1, 1, 0]",174,74,100,8,9,0.10810810810810811,0.09
"[1, 0, 1, 1, 0, 1, 1, 0, 1, 0, 1, 0, 1, 1, 1]",233,76,157,7,17,0.09210526315789473,0.10828025477707007
"[0, 1, 0, 0, 1, 1, 1, 0, 1, 1, 0, 1, 1, 0, 1]",137,51,86,3,9,0.058823529411764705,0.10465116279069768
"[1, 1, 1, 0, 1, 0, 0, 1, 1, 1, 0, 1, 1, 0, 1]",229,74,155,7,10,0.0945945945945946,0.06451612903225806
"[1, 1, 1, 1, 1, 1, 1, 1, 1, 1, 1, 0, 1, 0, 0]",2378,496,1882,40,195,0.08064516129032258,0.10361317747077577
"[0, 1, 0, 1, 1, 0, 0, 0, 1, 1, 1, 1, 1, 1, 1]",420,171,249,19,19,0.1111111111111111,0.07630522088353414
"[1, 0, 1, 0, 1, 1, 1, 1, 0, 0, 0, 1, 0, 1, 1]",162,65,97,6,11,0.09230769230769231,0.1134020618556701
"[1, 0, 1, 1, 0, 0, 1, 0, 1, 1, 1, 0, 1, 0, 1]",124,57,67,3,4,0.05263157894736842,0.05970149253731343
"[1, 1, 0, 1, 0, 1, 1, 0, 0, 1, 0, 1, 1, 1, 0]",170,71,99,6,10,0.08450704225352113,0.10101010101010101
"[1, 0, 1, 0, 1, 1, 0, 1, 0, 1, 1, 0, 0, 1, 0]",120,48,72,8,6,0.16666666666666666,0.08333333333333333
"[1, 1, 1, 0, 0, 1, 1, 0, 0, 0, 1, 1, 1, 0, 1]",207,67,140,5,9,0.07462686567164178,0.06428571428571428
"[1, 1, 0, 1, 1, 0, 1, 1, 0, 1, 1, 1, 1, 1, 1]",1851,447,1404,43,128,0.09619686800894854,0.09116809116809117
"[0, 1, 1, 1, 1, 1, 1, 1, 0, 1, 1, 1, 0, 1, 1]",1708,484,1224,38,100,0.07851239669421488,0.08169934640522876
"[0, 0, 0, 1, 0, 0, 0, 0, 1, 1, 1, 1, 0, 0, 0]",691,450,241,41,25,0.09111111111111111,0.1037344398340249
"[1, 0, 0, 1, 1, 0, 0, 0, 1, 0, 0, 0, 0, 1, 1]",259,134,125,17,11,0.12686567164179105,0.088
"[0, 0, 1, 0, 1, 0, 1, 0, 0, 1, 1, 0, 0, 0, 1]",135,81,54,10,5,0.12345679012345678,0.09259259259259259
"[0, 1, 0, 0, 0, 0, 1, 0, 1, 0, 1, 0, 0, 1, 1]",180,120,60,14,6,0.11666666666666667,0.1
"[0, 0, 0, 1, 0, 0, 0, 1, 0, 0, 0, 0, 0, 1, 0]",1452,1102,350,127,29,0.11524500907441017,0.08285714285714285
"[0, 1, 1, 0, 0, 0, 0, 1, 0, 1, 1, 0, 0, 0, 0]",355,243,112,16,11,0.06584362139917696,0.09821428571428571
"[0, 0, 0, 0, 1, 1, 0, 0, 0, 0, 0, 1, 0, 1, 0]",715,538,177,51,21,0.09479553903345725,0.11864406779661017
"[0, 1, 0, 0, 0, 0, 0, 1, 1, 0, 0, 0, 0, 0, 0]",3363,2510,853,216,80,0.08605577689243028,0.09378663540445487
"[0, 1, 0, 0, 0, 0, 1, 0, 0, 1, 0, 0, 1, 0, 0]",515,354,161,40,18,0.11299435028248588,0.11180124223602485
"[1, 1, 1, 0, 0, 0, 1, 0, 0, 0, 0, 1, 0, 0, 1]",149,83,66,3,6,0.03614457831325301,0.09090909090909091
"[1, 1, 0, 1, 1, 0, 0, 0, 0, 1, 1, 0, 0, 0, 1]",170,84,86,9,8,0.10714285714285714,0.09302325581395349
"[0, 1, 1, 1, 1, 0, 1, 1, 0, 1, 1, 0, 1, 1, 0]",249,94,155,9,20,0.09574468085106383,0.12903225806451613
"[1, 0, 1, 1, 0, 1, 1, 0, 1, 1, 1, 1, 0, 1, 1]",492,165,327,19,31,0.11515151515151516,0.09480122324159021
"[1, 0, 1, 1, 0, 0, 1, 1, 0, 1, 1, 0, 1, 1, 0]",147,71,76,9,5,0.1267605633802817,0.06578947368421052
"[0, 1, 0, 1, 1, 0, 0, 1, 1, 0, 1, 1, 0, 1, 1]",172,74,98,8,5,0.10810810810810811,0.05102040816326531
"[0, 0, 1, 0, 0, 0, 1, 0, 0, 0, 1, 0, 0, 1, 0]",495,341,154,33,10,0.0967741935483871,0.06493506493506493
"[0, 1, 1, 1, 1, 1, 1, 1, 1, 1, 1, 0, 0, 0, 1]",1100,519,581,49,61,0.09441233140655106,0.10499139414802065
"[0, 0, 0, 0, 1, 0, 1, 0, 0, 0, 1, 1, 0, 0, 0]",715,506,209,42,16,0.08300395256916997,0.07655502392344497
"[1, 0, 0, 0, 0, 0, 0, 1, 0, 1, 0, 0, 0, 1, 1]",354,202,152,20,11,0.09900990099009901,0.07236842105263158
"[0, 1, 1, 0, 0, 1, 1, 1, 1, 1, 1, 1, 1, 1, 1]",7368,4412,2956,473,284,0.107207615593835,0.09607577807848444
"[1, 1, 1, 1, 1, 1, 1, 1, 0, 0, 1, 1, 0, 0, 1]",4949,1346,3603,110,328,0.08172362555720654,0.09103524840410769
"[1, 0, 0, 1, 1, 1, 1, 1, 1, 1, 1, 1, 1, 1, 0]",3384,595,2789,49,263,0.08235294117647059,0.09429903191107925
"[1, 1, 1, 1, 1, 0, 1, 0, 1, 0, 1, 1, 1, 0, 1]",508,150,358,22,26,0.14666666666666667,0.07262569832402235
"[0, 1, 0, 0, 1, 1, 1, 1, 1, 1, 1, 1, 1, 0, 1]",641,201,440,14,33,0.06965174129353234,0.075
"[0, 0, 0, 0, 0, 0, 1, 1, 0, 0, 0, 1, 0, 1, 1]",627,416,211,50,15,0.1201923076923077,0.07109004739336493
"[1, 0, 0, 1, 0, 1, 1, 1, 1, 1, 0, 1, 1, 1, 0]",244,73,171,12,15,0.1643835616438356,0.08771929824561403
"[0, 0, 0, 0, 0, 0, 1, 0, 0, 1, 0, 1, 1, 1, 1]",334,219,115,19,8,0.0867579908675799,0.06956521739130435
"[1, 1, 0, 0, 1, 1, 0, 0, 0, 1, 1, 0, 1, 1, 1]",331,140,191,13,24,0.09285714285714286,0.1256544502617801
"[0, 0, 0, 0, 1, 1, 0, 1, 1, 1, 1, 1, 1, 0, 1]",178,85,93,8,12,0.09411764705882353,0.12903225806451613
"[0, 0, 1, 0, 0, 0, 0, 0, 1, 1, 0, 1, 1, 1, 1]",166,110,56,15,4,0.13636363636363635,0.07142857142857142
"[1, 1, 1, 1, 0, 1, 0, 0, 1, 0, 1, 0, 0, 0, 1]",123,54,69,3,4,0.05555555555555555,0.057971014492753624
"[0, 1, 0, 1, 1, 1, 1, 0, 1, 0, 1, 0, 1, 1, 1]",250,83,167,15,19,0.18072289156626506,0.11377245508982035
"[0, 1, 0, 1, 1, 0, 1, 1, 1, 1, 1, 1, 1, 0, 1]",523,157,366,16,26,0.10191082802547771,0.07103825136612021
"[1, 1, 0, 0, 0, 0, 0, 0, 1, 1, 1, 1, 0, 1, 0]",315,153,162,20,13,0.13071895424836602,0.08024691358024691
"[0, 0, 0, 0, 0, 1, 0, 1, 0, 1, 0, 1, 0, 0, 0]",527,380,147,29,21,0.07631578947368421,0.14285714285714285
"[1, 1, 0, 0, 0, 0, 0, 1, 1, 0, 0, 0, 0, 0, 0]",1360,921,439,82,40,0.08903365906623235,0.09111617312072894
"[1, 0, 1, 1, 1, 1, 1, 0, 0, 0, 0, 0, 0, 0, 1]",205,99,106,11,9,0.1111111111111111,0.08490566037735849
"[0, 1, 0, 0, 1, 1, 1, 1, 0, 1, 1, 1, 1, 1, 0]",291,105,186,8,20,0.0761904761904762,0.10752688172043011
"[1, 1, 0, 1, 0, 0, 1, 1, 1, 1, 0, 1, 1, 1, 1]",658,192,466,17,50,0.08854166666666667,0.1072961373390558
"[1, 1, 0, 1, 1, 1, 0, 1, 1, 1, 1, 0, 0, 1, 1]",823,281,542,28,53,0.099644128113879,0.09778597785977859
"[1, 1, 0, 0, 1, 1, 1, 1, 1, 1, 0, 1, 1, 0, 1]",816,228,588,22,47,0.09649122807017543,0.07993197278911565
"[0, 0, 1, 1, 0, 1, 1, 1, 1, 0, 0, 1, 0, 1, 0]",124,50,74,3,7,0.06,0.0945945945945946
"[1, 0, 1, 0, 1, 1, 0, 1, 1, 0, 1, 0, 0, 0, 1]",109,49,60,7,9,0.14285714285714285,0.15
"[0, 1, 0, 1, 1, 1, 0, 0, 1, 0, 1, 0, 1, 0, 1]",106,54,52,4,6,0.07407407407407407,0.11538461538461539
"[1, 1, 0, 1, 1, 0, 0, 0, 1, 0, 1, 0, 1, 0, 1]",99,52,47,3,2,0.057692307692307696,0.0425531914893617
"[0, 1, 1, 0, 0, 0, 0, 1, 1, 0, 0, 0, 1, 0, 0]",436,345,91,23,11,0.06666666666666667,0.12087912087912088
"[0, 0, 1, 1, 0, 0, 0, 0, 1, 1, 0, 0, 0, 1, 0]",583,370,213,31,11,0.08378378378378379,0.051643192488262914
"[1, 0, 1, 0, 0, 1, 0, 0, 0, 1, 1, 0, 0, 1, 1]",185,100,85,9,9,0.09,0.10588235294117647
"[0, 1, 0, 1, 0, 0, 1, 0, 0, 0, 1, 1, 0, 0, 1]",164,91,73,8,9,0.08791208791208792,0.1232876712328767
"[1, 1, 0, 1, 1, 1, 0, 1, 1, 1, 0, 1, 1, 0, 1]",509,140,369,14,24,0.1,0.06504065040650407
"[0, 1, 0, 0, 1, 0, 0, 0, 1, 1, 1, 0, 1, 1, 1]",137,65,72,10,6,0.15384615384615385,0.08333333333333333
"[1, 0, 0, 0, 0, 0, 0, 1, 0, 1, 0, 0, 0, 0, 1]",615,394,221,41,29,0.10406091370558376,0.13122171945701358
"[1, 1, 0, 0, 1, 1, 1, 1, 0, 0, 1, 1, 0, 0, 0]",1549,756,793,49,65,0.06481481481481481,0.08196721311475409
"[0, 1, 1, 1, 0, 0, 0, 0, 1, 1, 0, 0, 1, 1, 1]",520,238,282,23,25,0.09663865546218488,0.08865248226950355
"[0, 1, 1, 1, 0, 0, 1, 1, 0, 0, 0, 0, 1, 0, 0]",190,102,88,9,6,0.08823529411764706,0.06818181818181818
"[1, 1, 1, 0, 1, 0, 0, 1, 1, 1, 1, 1, 0, 1, 0]",242,71,171,10,12,0.14084507042253522,0.07017543859649122
"[1, 1, 0, 1, 1, 1, 1, 0, 1, 0, 0, 1, 1, 1, 1]",706,210,496,15,48,0.07142857142857142,0.0967741935483871
"[0, 1, 1, 1, 0, 1, 1, 1, 1, 0, 1, 0, 0, 1, 1]",279,91,188,10,15,0.10989010989010989,0.0797872340425532
"[0, 1, 1, 1, 0, 1, 0, 1, 0, 0, 0, 0, 0, 0, 1]",187,108,79,8,7,0.07407407407407407,0.08860759493670886
"[0, 0, 0, 1, 0, 1, 0, 1, 0, 0, 0, 0, 1, 1, 1]",257,163,94,15,9,0.09202453987730061,0.09574468085106383
"[1, 0, 0, 0, 1, 0, 1, 0, 1, 0, 0, 0, 0, 1, 1]",198,117,81,13,5,0.1111111111111111,0.06172839506172839
"[0, 1, 1, 0, 0, 1, 0, 0, 1, 1, 0, 0, 0, 0, 0]",365,250,115,28,8,0.112,0.06956521739130435
"[1, 0, 1, 0, 1, 0, 1, 1, 0, 1, 0, 0, 0, 0, 0]",148,79,69,9,8,0.11392405063291139,0.11594202898550725
"[0, 0, 0, 0, 0, 0, 0, 1, 1, 0, 0, 0, 1, 1, 0]",1078,845,233,76,24,0.08994082840236686,0.10300429184549356
"[0, 1, 1, 1, 0, 1, 1, 0, 1, 1, 1, 1, 1, 1, 0]",567,175,392,9,40,0.05142857142857143,0.10204081632653061
"[1, 1, 0, 1, 1, 1, 1, 1, 1, 0, 1, 1, 1, 0, 1]",1439,344,1095,31,117,0.09011627906976744,0.10684931506849316
"[0, 1, 0, 1, 0, 1, 0, 0, 1, 1, 1, 1, 1, 1, 1]",464,172,292,10,32,0.05813953488372093,0.1095890410958904
"[1, 0, 0, 0, 0, 1, 1, 0, 0, 0, 1, 0, 1, 1, 0]",168,90,78,8,4,0.08888888888888889,0.05128205128205128
"[0, 1, 1, 0, 1, 1, 0, 0, 0, 0, 0, 0, 0, 1, 1]",270,165,105,19,7,0.11515151515151516,0.06666666666666667
"[0, 1, 1, 0, 0, 1, 1, 1, 1, 1, 1, 1, 0, 1, 1]",956,495,461,49,50,0.09898989898989899,0.10845986984815618
"[1, 1, 0, 1, 1, 0, 0, 1, 1, 1, 1, 1, 1, 1, 0]",708,218,490,18,45,0.08256880733944955,0.09183673469387756
"[0, 1, 1, 1, 1, 1, 0, 1, 1, 0, 0, 1, 1, 1, 1]",875,292,583,20,46,0.0684931506849315,0.07890222984562607
"[1, 0, 0, 0, 1, 1, 0, 1, 0, 1, 1, 0, 1, 0, 0]",121,55,66,3,8,0.05454545454545454,0.12121212121212122
"[1, 1, 0, 0, 0, 1, 1, 0, 1, 0, 1, 1, 0, 1, 0]",130,63,67,10,9,0.15873015873015872,0.13432835820895522
"[1, 0, 1, 0, 1, 0, 1, 1, 1, 1, 0, 1, 1, 1, 1]",571,167,404,10,39,0.059880239520958084,0.09653465346534654
"[0, 1, 1, 0, 0, 0, 0, 0, 0, 1, 0, 1, 0, 1, 1]",288,215,73,17,3,0.07906976744186046,0.0410958904109589
"[0, 1, 0, 0, 0, 0, 0, 0, 0, 1, 0, 0, 1, 0, 0]",1574,1199,375,113,45,0.09424520433694746,0.12
"[0, 1, 0, 1, 0, 0, 1, 0, 0, 0, 0, 1, 0, 0, 0]",523,385,138,36,12,0.09350649350649351,0.08695652173913043
"[1, 1, 0, 0, 0, 0, 0, 0, 0, 1, 0, 0, 0, 0, 0]",2254,1682,572,155,54,0.09215219976218787,0.0944055944055944
"[1, 1, 1, 0, 1, 0, 1, 1, 0, 0, 0, 1, 0, 1, 1]",154,61,93,5,11,0.08196721311475409,0.11827956989247312
"[1, 1, 1, 0, 1, 1, 0, 0, 0, 1, 1, 1, 1, 1, 0]",294,101,193,11,18,0.10891089108910891,0.09326424870466321
"[1, 0, 1, 0, 0, 1, 0, 0, 0, 1, 1, 1, 1, 1, 1]",225,88,137,5,12,0.056818181818181816,0.08759124087591241
"[1, 0, 1, 1, 1, 0, 0, 0, 0, 1, 0, 0, 1, 1, 1]",159,75,84,5,8,0.06666666666666667,0.09523809523809523
"[1, 1, 1, 1, 0, 1, 0, 1, 0, 1, 1, 1, 0, 0, 0]",192,74,118,4,12,0.05405405405405406,0.1016949152542373
"[0, 0, 1, 1, 0, 0, 0, 0, 1, 0, 0, 0, 1, 1, 1]",500,322,178,28,14,0.08695652173913043,0.07865168539325842
"[1, 0, 0, 1, 1, 0, 0, 0, 0, 1, 0, 0, 0, 1, 1]",295,115,180,11,14,0.09565217391304348,0.07777777777777778
"[0, 1, 0, 0, 1, 1, 0, 0, 0, 0, 1, 0, 0, 0, 1]",264,172,92,7,17,0.040697674418604654,0.18478260869565216
"[0, 0, 1, 0, 0, 1, 1, 0, 0, 0, 0, 1, 0, 0, 0]",598,432,166,44,10,0.10185185185185185,0.060240963855421686
"[0, 1, 1, 1, 0, 1, 0, 1, 1, 1, 1, 1, 1, 0, 1]",510,156,354,13,38,0.08333333333333333,0.10734463276836158
"[0, 0, 0, 1, 1, 1, 1, 1, 1, 1, 1, 1, 0, 0, 1]",772,415,357,38,35,0.09156626506024096,0.09803921568627451
"[0, 1, 0, 0, 1, 0, 1, 1, 0, 1, 1, 0, 0, 0, 0]",183,104,79,5,6,0.04807692307692308,0.0759493670886076
"[0, 1, 0, 1, 0, 1, 0, 0, 0, 0, 0, 0, 0, 0, 1]",731,527,204,40,19,0.07590132827324478,0.09313725490196079
"[1, 1, 1, 1, 1, 1, 1, 1, 0, 0, 0, 0, 0, 1, 1]",1000,352,648,35,58,0.09943181818181818,0.08950617283950617
"[1, 0, 0, 0, 0, 0, 1, 1, 1, 1, 1, 1, 1, 1, 1]",999,360,639,40,70,0.1111111111111111,0.10954616588419405
"[1, 0, 1, 1, 1, 1, 1, 0, 0, 0, 1, 0, 0, 0, 0]",113,64,49,6,3,0.09375,0.061224489795918366
"[0, 1, 1, 1, 0, 1, 1, 1, 1, 1, 1, 0, 1, 0, 1]",553,182,371,13,30,0.07142857142857142,0.08086253369272237
"[1, 0, 0, 1, 1, 1, 0, 1, 1, 1, 1, 1, 1, 0, 1]",558,143,415,12,37,0.08391608391608392,0.0891566265060241
"[1, 0, 1, 0, 0, 0, 0, 0, 0, 0, 1, 1, 0, 0, 0]",1007,689,318,63,46,0.09143686502177069,0.14465408805031446
"[1, 1, 1, 0, 1, 0, 1, 0, 0, 1, 0, 0, 1, 1, 0]",127,68,59,4,6,0.058823529411764705,0.1016949152542373
"[0, 0, 1, 0, 1, 1, 1, 0, 1, 0, 1, 0, 1, 0, 0]",89,47,42,4,2,0.0851063829787234,0.047619047619047616
"[0, 0, 1, 0, 0, 1, 1, 1, 1, 1, 1, 0, 0, 0, 1]",156,79,77,8,7,0.10126582278481013,0.09090909090909091
"[1, 0, 0, 1, 0, 0, 1, 1, 0, 1, 1, 1, 0, 1, 0]",117,63,54,5,4,0.07936507936507936,0.07407407407407407
"[0, 0, 1, 1, 1, 1, 1, 1, 1, 0, 1, 0, 1, 1, 1]",970,277,693,22,69,0.07942238267148015,0.09956709956709957
"[0, 1, 1, 1, 0, 1, 1, 1, 1, 1, 1, 0, 0, 0, 0]",352,146,206,11,20,0.07534246575342465,0.0970873786407767
"[1, 0, 0, 0, 1, 0, 0, 1, 1, 0, 0, 0, 0, 1, 0]",249,171,78,19,8,0.1111111111111111,0.10256410256410256
"[0, 0, 0, 0, 1, 1, 1, 1, 0, 0, 0, 0, 1, 0, 1]",468,264,204,18,22,0.06818181818181818,0.10784313725490197
"[0, 0, 1, 0, 1, 0, 1, 0, 0, 0, 0, 0, 1, 1, 0]",307,194,113,24,14,0.12371134020618557,0.12389380530973451
"[0, 0, 0, 0, 0, 0, 1, 0, 1, 0, 1, 0, 0, 0, 0]",1761,1359,402,115,37,0.08462104488594555,0.09203980099502487
"[1, 0, 1, 1, 0, 0, 1, 1, 0, 1, 1, 1, 1, 1, 1]",706,214,492,21,44,0.09813084112149532,0.08943089430894309
"[1, 1, 0, 1, 0, 0, 0, 0, 0, 1, 0, 1, 0, 1, 1]",120,55,65,5,10,0.09090909090909091,0.15384615384615385
"[1, 0, 1, 1, 1, 0, 1, 0, 0, 0, 0, 0, 1, 0, 1]",132,71,61,9,9,0.1267605633802817,0.14754098360655737
"[0, 1, 0, 0, 1, 0, 0, 1, 0, 0, 1, 0, 0, 0, 0]",515,355,160,32,22,0.09014084507042254,0.1375
"[1, 1, 0, 1, 0, 0, 0, 0, 0, 0, 0, 1, 0, 0, 1]",267,173,94,19,11,0.10982658959537572,0.11702127659574468
"[0, 0, 0, 0, 0, 0, 0, 0, 1, 1, 0, 1, 0, 1, 1]",615,443,172,42,11,0.09480812641083522,0.06395348837209303
"[1, 0, 0, 0, 0, 0, 1, 0, 0, 1, 0, 0, 0, 0, 1]",554,376,178,28,18,0.07446808510638298,0.10112359550561797
"[0, 0, 0, 0, 1, 0, 0, 0, 0, 1, 0, 0, 1, 0, 1]",573,401,172,50,16,0.12468827930174564,0.09302325581395349
"[0, 0, 0, 0, 1, 1, 0, 1, 0, 0, 0, 0, 0, 0, 0]",2186,1683,503,152,47,0.0903149138443256,0.09343936381709742
"[1, 1, 0, 1, 0, 0, 0, 1, 1, 1, 1, 0, 1, 1, 1]",275,105,170,7,16,0.06666666666666667,0.09411764705882353
"[0, 0, 1, 0, 0, 1, 1, 0, 1, 0, 0, 0, 1, 1, 1]",145,77,68,10,7,0.12987012987012986,0.10294117647058823
"[0, 1, 0, 0, 1, 0, 0, 1, 1, 0, 1, 1, 0, 1, 1]",116,60,56,3,7,0.05,0.125
"[0, 0, 0, 1, 0, 1, 1, 1, 1, 1, 1, 1, 0, 1, 0]",155,68,87,5,10,0.07352941176470588,0.11494252873563218
"[1, 0, 0, 1, 1, 0, 0, 1, 0, 0, 1, 0, 0, 1, 1]",179,85,94,8,8,0.09411764705882353,0.0851063829787234
"[1, 1, 1, 1, 1, 0, 0, 0, 0, 1, 0, 0, 1, 1, 0]",192,72,120,7,14,0.09722222222222222,0.11666666666666667
"[0, 1, 0, 0, 0, 0, 0, 0, 0, 0, 0, 1, 0, 1, 1]",791,554,237,52,24,0.09386281588447654,0.10126582278481013
"[0, 0, 0, 0, 1, 1, 1, 1, 1, 1, 0, 1, 0, 0, 0]",246,133,113,15,10,0.11278195488721804,0.08849557522123894
"[0, 1, 0, 0, 1, 0, 0, 0, 1, 0, 1, 0, 0, 1, 1]",173,99,74,6,8,0.06060606060606061,0.10810810810810811
"[0, 1, 0, 0, 0, 0, 1, 1, 1, 0, 0, 0, 0, 1, 0]",262,163,99,10,11,0.06134969325153374,0.1111111111111111
"[0, 1, 1, 0, 0, 0, 1, 0, 0, 0, 0, 1, 1, 1, 0]",180,108,72,8,5,0.07407407407407407,0.06944444444444445
"[1, 1, 1, 1, 1, 1, 1, 0, 1, 1, 0, 1, 0, 0, 1]",619,164,455,20,51,0.12195121951219512,0.11208791208791209
"[1, 1, 1, 1, 1, 0, 0, 0, 1, 1, 1, 1, 0, 0, 1]",573,170,403,15,35,0.08823529411764706,0.08684863523573201
"[1, 1, 1, 1, 0, 1, 0, 0, 0, 1, 1, 1, 0, 0, 1]",185,67,118,7,16,0.1044776119402985,0.13559322033898305
"[0, 1, 1, 1, 0, 1, 0, 0, 0, 1, 0, 1, 1, 1, 1]",191,97,94,5,11,0.05154639175257732,0.11702127659574468
"[0, 1, 1, 0, 0, 1, 0, 1, 0, 1, 1, 1, 0, 1, 0]",95,53,42,9,2,0.16981132075471697,0.047619047619047616
"[1, 0, 1, 1, 1, 1, 0, 1, 0, 0, 1, 1, 0, 0, 1]",204,69,135,10,13,0.14492753623188406,0.0962962962962963
"[0, 1, 0, 1, 1, 1, 1, 0, 1, 0, 0, 1, 1, 0, 0]",122,53,69,7,6,0.1320754716981132,0.08695652173913043
"[1, 1, 0, 0, 1, 1, 0, 1, 0, 1, 0, 1, 1, 1, 1]",358,128,230,9,28,0.0703125,0.12173913043478261
"[0, 0, 1, 1, 0, 1, 1, 0, 0, 0, 0, 0, 0, 1, 1]",389,252,137,26,11,0.10317460317460317,0.08029197080291971
"[1, 1, 0, 0, 1, 1, 0, 1, 1, 0, 0, 0, 0, 0, 0]",273,146,127,14,14,0.0958904109589041,0.11023622047244094
"[0, 1, 1, 0, 0, 1, 0, 0, 0, 0, 1, 1, 0, 0, 1]",252,148,104,22,10,0.14864864864864866,0.09615384615384616
"[1, 1, 0, 0, 0, 0, 0, 1, 0, 1, 0, 1, 1, 0, 0]",165,89,76,7,4,0.07865168539325842,0.05263157894736842
"[1, 1, 0, 0, 1, 1, 1, 0, 0, 1, 1, 1, 1, 1, 0]",330,126,204,10,21,0.07936507936507936,0.10294117647058823
"[0, 1, 1, 1, 0, 1, 1, 1, 1, 0, 0, 1, 1, 0, 0]",363,176,187,10,16,0.056818181818181816,0.0855614973262032
"[1, 1, 0, 1, 0, 0, 1, 1, 1, 0, 1, 1, 1, 1, 0]",223,77,146,12,9,0.15584415584415584,0.06164383561643835
"[1, 0, 1, 1, 1, 0, 1, 1, 0, 0, 1, 1, 1, 0, 0]",153,65,88,3,14,0.046153846153846156,0.1590909090909091
"[0, 1, 1, 1, 1, 0, 1, 0, 1, 1, 0, 1, 1, 1, 1]",650,244,406,17,40,0.06967213114754098,0.09852216748768473
"[1, 0, 1, 1, 1, 0, 1, 0, 0, 1, 0, 1, 0, 0, 0]",117,71,46,11,4,0.15492957746478872,0.08695652173913043
"[1, 0, 1, 0, 1, 1, 1, 0, 1, 0, 0, 1, 0, 1, 0]",84,47,37,6,4,0.1276595744680851,0.10810810810810811
"[1, 1, 1, 1, 0, 1, 1, 1, 1, 0, 1, 1, 1, 0, 1]",1591,358,1233,45,95,0.12569832402234637,0.0770478507704785
"[1, 0, 1, 1, 1, 0, 1, 1, 0, 1, 1, 0, 1, 1, 0]",223,84,139,7,14,0.08333333333333333,0.10071942446043165
"[1, 1, 0, 0, 0, 1, 1, 1, 1, 1, 1, 1, 1, 1, 0]",840,241,599,22,45,0.0912863070539419,0.07512520868113523
"[1, 1, 0, 1, 0, 1, 1, 1, 1, 1, 0, 1, 1, 1, 0]",530,161,369,9,36,0.055900621118012424,0.0975609756097561
"[0, 0, 0, 1, 0, 1, 0, 1, 1, 1, 1, 1, 1, 0, 0]",223,108,115,10,6,0.09259259259259259,0.05217391304347826
"[0, 1, 1, 1, 1, 1, 1, 0, 0, 1, 1, 0, 0, 1, 0]",384,249,135,32,9,0.1285140562248996,0.06666666666666667
"[1, 1, 1, 0, 0, 1, 0, 1, 1, 1, 0, 1, 0, 0, 1]",135,62,73,2,7,0.03225806451612903,0.0958904109589041
"[1, 1, 1, 0, 0, 1, 0, 0, 1, 1, 0, 1, 1, 0, 1]",164,65,99,2,14,0.03076923076923077,0.1414141414141414
"[0, 0, 1, 1, 1, 0, 0, 1, 0, 0, 0, 1, 0, 0, 0]",226,154,72,27,7,0.17532467532467533,0.09722222222222222
"[0, 0, 0, 0, 1, 1, 1, 0, 0, 1, 0, 0, 0, 1, 0]",259,183,76,24,7,0.13114754098360656,0.09210526315789473
"[1, 0, 1, 0, 0, 0, 1, 0, 0, 1, 0, 0, 1, 0, 1]",130,81,49,7,4,0.08641975308641975,0.08163265306122448
"[1, 1, 0, 1, 1, 0, 1, 1, 0, 1, 1, 0, 0, 1, 1]",321,127,194,10,17,0.07874015748031496,0.08762886597938144
"[1, 1, 1, 0, 1, 1, 0, 1, 1, 0, 1, 1, 0, 0, 1]",270,96,174,6,14,0.0625,0.08045977011494253
"[0, 1, 0, 0, 1, 1, 1, 1, 0, 0, 0, 0, 0, 0, 1]",499,295,204,19,20,0.06440677966101695,0.09803921568627451
"[0, 0, 1, 1, 1, 1, 1, 0, 0, 1, 0, 1, 1, 0, 1]",144,68,76,6,11,0.08823529411764706,0.14473684210526316
"[1, 0, 0, 1, 1, 1, 1, 1, 0, 0, 1, 0, 1, 1, 0]",143,52,91,4,9,0.07692307692307693,0.0989010989010989
"[0, 1, 0, 0, 0, 0, 1, 0, 0, 0, 1, 0, 0, 1, 0]",465,316,149,29,15,0.09177215189873418,0.10067114093959731
"[1, 0, 0, 0, 1, 0, 0, 1, 1, 1, 0, 0, 0, 0, 0]",341,222,119,15,7,0.06756756756756757,0.058823529411764705
"[1, 1, 0, 0, 0, 0, 0, 0, 0, 1, 0, 0, 0, 1, 1]",495,326,169,34,18,0.10429447852760736,0.10650887573964497
"[0, 0, 0, 1, 1, 1, 1, 1, 0, 0, 1, 1, 1, 1, 1]",696,348,348,30,36,0.08620689655172414,0.10344827586206896
"[1, 1, 1, 0, 0, 0, 0, 1, 1, 1, 1, 1, 0, 0, 1]",353,102,251,9,29,0.08823529411764706,0.11553784860557768
"[1, 0, 0, 1, 1, 1, 1, 1, 0, 1, 1, 0, 1, 1, 1]",693,172,521,21,42,0.12209302325581395,0.08061420345489444
"[1, 1, 0, 1, 0, 0, 0, 0, 0, 0, 0, 1, 1, 1, 0]",197,108,89,10,3,0.09259259259259259,0.033707865168539325
"[0, 1, 0, 1, 0, 1, 1, 1, 1, 0, 1, 0, 0, 0, 0]",143,80,63,7,7,0.0875,0.1111111111111111
"[1, 1, 1, 0, 1, 0, 1, 0, 1, 1, 1, 1, 1, 1, 0]",539,155,384,14,34,0.09032258064516129,0.08854166666666667
"[0, 0, 1, 1, 1, 1, 1, 1, 1, 0, 0, 0, 0, 1, 0]",216,115,101,10,9,0.08695652173913043,0.0891089108910891
"[1, 1, 0, 0, 1, 1, 1, 1, 1, 1, 1, 0, 0, 0, 0]",553,213,340,24,30,0.11267605633802817,0.08823529411764706
"[0, 1, 1, 1, 1, 1, 0, 1, 0, 1, 1, 1, 0, 0, 0]",199,91,108,8,11,0.08791208791208792,0.10185185185185185
"[0, 0, 0, 0, 1, 0, 0, 1, 0, 0, 0, 1, 0, 1, 0]",495,362,133,38,13,0.10497237569060773,0.09774436090225563
"[0, 0, 1, 1, 1, 1, 0, 0, 0, 0, 0, 1, 0, 1, 0]",271,150,121,12,9,0.08,0.0743801652892562
"[0, 1, 1, 1, 1, 0, 0, 0, 0, 0, 1, 1, 1, 1, 0]",260,156,104,14,11,0.08974358974358974,0.10576923076923077
"[1, 1, 1, 1, 0, 0, 0, 0, 0, 0, 0, 1, 1, 1, 1]",714,341,373,28,34,0.08211143695014662,0.09115281501340483
"[0, 1, 1, 1, 1, 1, 1, 0, 0, 0, 0, 0, 0, 0, 1]",503,379,124,45,14,0.11873350923482849,0.11290322580645161
"[1, 1, 0, 1, 1, 1, 0, 1, 0, 1, 1, 0, 0, 1, 1]",293,95,198,9,20,0.09473684210526316,0.10101010101010101
"[1, 1, 1, 1, 0, 1, 1, 1, 0, 1, 0, 1, 1, 0, 0]",277,81,196,8,23,0.09876543209876543,0.11734693877551021
"[1, 0, 1, 0, 0, 0, 0, 0, 0, 1, 1, 1, 1, 1, 1]",523,218,305,27,23,0.12385321100917432,0.07540983606557378
"[1, 0, 1, 0, 1, 0, 0, 0, 0, 0, 0, 1, 1, 1, 1]",322,158,164,24,15,0.1518987341772152,0.09146341463414634
"[1, 1, 0, 0, 0, 1, 0, 1, 0, 0, 1, 0, 1, 0, 1]",120,55,65,4,7,0.07272727272727272,0.1076923076923077
"[1, 1, 1, 1, 0, 0, 0, 1, 0, 1, 0, 0, 1, 0, 1]",102,42,60,7,13,0.16666666666666666,0.21666666666666667
"[1, 0, 1, 0, 1, 1, 0, 1, 1, 1, 1, 1, 1, 0, 0]",416,144,272,9,21,0.0625,0.07720588235294118
"[0, 1, 1, 0, 1, 1, 1, 0, 1, 1, 0, 0, 1, 1, 1]",336,132,204,15,27,0.11363636363636363,0.1323529411764706
"[1, 0, 1, 1, 0, 1, 1, 1, 0, 1, 1, 0, 0, 1, 1]",288,86,202,12,20,0.13953488372093023,0.09900990099009901
"[0, 1, 1, 0, 0, 0, 1, 1, 0, 1, 1, 0, 1, 1, 0]",122,62,60,6,6,0.0967741935483871,0.1
"[0, 1, 0, 0, 0, 0, 1, 0, 0, 0, 0, 0, 0, 1, 0]",1519,1160,359,100,35,0.08620689655172414,0.09749303621169916
"[1, 1, 1, 0, 0, 0, 0, 0, 0, 1, 0, 0, 0, 1, 1]",311,116,195,6,20,0.05172413793103448,0.10256410256410256
"[1, 0, 0, 1, 1, 0, 1, 0, 1, 0, 1, 0, 0, 0, 1]",105,51,54,2,6,0.0392156862745098,0.1111111111111111
"[0, 0, 1, 0, 0, 1, 1, 0, 1, 0, 1, 0, 1, 0, 0]",120,74,46,3,9,0.04054054054054054,0.1956521739130435
"[0, 1, 0, 0, 1, 0, 0, 1, 1, 0, 1, 0, 1, 0, 1]",109,59,50,5,10,0.0847457627118644,0.2
"[1, 0, 1, 0, 1, 1, 1, 0, 0, 1, 1, 0, 0, 1, 0]",138,67,71,4,9,0.05970149253731343,0.1267605633802817
"[1, 1, 1, 0, 0, 1, 0, 1, 0, 1, 1, 1, 0, 0, 1]",181,60,121,6,15,0.1,0.12396694214876033
"[0, 1, 1, 1, 1, 1, 0, 1, 1, 1, 1, 0, 1, 1, 0]",549,171,378,20,34,0.11695906432748537,0.08994708994708994
"[0, 0, 1, 1, 1, 1, 1, 0, 1, 1, 1, 1, 0, 1, 1]",663,196,467,14,41,0.07142857142857142,0.08779443254817987
"[1, 1, 0, 0, 1, 1, 0, 1, 1, 1, 0, 0, 0, 1, 1]",221,83,138,8,11,0.0963855421686747,0.07971014492753623
"[0, 1, 1, 0, 0, 0, 0, 0, 0, 1, 0, 0, 0, 0, 1]",831,654,177,63,21,0.0963302752293578,0.11864406779661017
"[1, 1, 1, 0, 0, 1, 0, 1, 0, 1, 1, 1, 1, 1, 1]",751,183,568,12,59,0.06557377049180328,0.10387323943661972
"[1, 1, 0, 1, 0, 1, 0, 0, 1, 1, 1, 1, 1, 1, 0]",374,128,246,13,25,0.1015625,0.1016260162601626
"[0, 0, 0, 1, 1, 0, 0, 0, 0, 1, 1, 0, 0, 1, 1]",2213,1860,353,170,35,0.0913978494623656,0.09915014164305949
"[0, 1, 0, 0, 0, 0, 1, 0, 1, 0, 0, 0, 1, 1, 0]",272,187,85,19,8,0.10160427807486631,0.09411764705882353
"[0, 1, 1, 0, 0, 1, 0, 1, 0, 1, 1, 0, 0, 0, 0]",171,120,51,13,9,0.10833333333333334,0.17647058823529413
"[1, 0, 0, 0, 0, 1, 1, 0, 0, 0, 0, 0, 0, 0, 1]",1245,576,669,43,53,0.07465277777777778,0.07922272047832586
"[0, 0, 0, 0, 1, 0, 0, 0, 0, 1, 0, 0, 0, 0, 1]",1656,1249,407,104,41,0.08326661329063251,0.10073710073710074
"[1, 0, 0, 0, 0, 0, 1, 0, 0, 0, 0, 1, 0, 0, 0]",1596,1173,423,107,26,0.09121909633418585,0.061465721040189124
"[0, 0, 1, 1, 1, 1, 1, 1, 0, 0, 1, 0, 1, 1, 1]",588,241,347,23,29,0.0954356846473029,0.08357348703170028
"[1, 1, 0, 0, 1, 0, 0, 1, 1, 1, 1, 1, 0, 1, 0]",149,63,86,6,9,0.09523809523809523,0.10465116279069768
"[0, 0, 1, 1, 1, 0, 0, 1, 1, 0, 1, 1, 1, 1, 1]",331,134,197,12,17,0.08955223880597014,0.08629441624365482
"[1, 0, 0, 0, 0, 1, 1, 1, 0, 0, 1, 1, 0, 1, 1]",145,51,94,4,6,0.0784313725490196,0.06382978723404255
"[0, 1, 0, 0, 0, 0, 1, 1, 1, 0, 0, 1, 1, 0, 1]",88,35,53,2,7,0.05714285714285714,0.1320754716981132
"[1, 0, 1, 0, 0, 0, 0, 1, 1, 1, 0, 0, 1, 1, 0]",159,85,74,15,7,0.17647058823529413,0.0945945945945946
"[0, 0, 1, 1, 0, 1, 1, 0, 1, 1, 1, 0, 1, 1, 1]",252,90,162,6,15,0.06666666666666667,0.09259259259259259
"[1, 0, 1, 1, 0, 0, 0, 1, 1, 1, 1, 1, 1, 1, 0]",319,115,204,7,15,0.06086956521739131,0.07352941176470588
"[0, 0, 0, 0, 0, 0, 0, 0, 1, 0, 1, 0, 1, 0, 0]",1754,1360,394,107,39,0.07867647058823529,0.09898477157360407
"[0, 1, 0, 0, 0, 0, 0, 1, 1, 1, 1, 0, 0, 0, 0]",882,571,311,58,30,0.10157618213660245,0.09646302250803858
"[0, 0, 1, 0, 1, 1, 1, 0, 0, 0, 0, 0, 1, 0, 0]",252,155,97,19,15,0.12258064516129032,0.15463917525773196
"[0, 0, 0, 1, 1, 0, 0, 1, 1, 0, 0, 0, 1, 1, 1]",505,387,118,26,15,0.06718346253229975,0.1271186440677966
"[0, 1, 1, 1, 0, 1, 1, 1, 0, 0, 0, 0, 1, 1, 1]",270,118,152,12,12,0.1016949152542373,0.07894736842105263
"[1, 1, 0, 1, 0, 0, 1, 1, 1, 0, 1, 1, 1, 0, 0]",158,59,99,7,5,0.11864406779661017,0.050505050505050504
"[1, 0, 0, 1, 1, 1, 0, 1, 1, 0, 1, 0, 0, 1, 1]",212,85,127,10,10,0.11764705882352941,0.07874015748031496
"[0, 0, 0, 0, 1, 1, 0, 1, 1, 1, 0, 1, 1, 1, 1]",241,121,120,10,10,0.08264462809917356,0.08333333333333333
"[1, 1, 0, 0, 0, 0, 0, 1, 1, 0, 1, 1, 1, 0, 1]",127,53,74,4,6,0.07547169811320754,0.08108108108108109
"[1, 1, 1, 1, 1, 0, 0, 0, 0, 0, 1, 1, 0, 1, 1]",295,85,210,7,25,0.08235294117647059,0.11904761904761904
"[1, 1, 0, 1, 0, 1, 0, 1, 1, 1, 0, 1, 1, 1, 0]",226,85,141,14,9,0.16470588235294117,0.06382978723404255
"[1, 0, 1, 1, 1, 0, 0, 1, 0, 1, 0, 1, 1, 1, 1]",258,112,146,9,20,0.08035714285714286,0.136986301369863
"[0, 0, 1, 0, 1, 0, 1, 0, 1, 1, 0, 0, 1, 0, 1]",94,44,50,2,4,0.045454545454545456,0.08
"[1, 1, 0, 0, 1, 0, 0, 0, 1, 0, 0, 1, 0, 1, 0]",141,82,59,10,7,0.12195121951219512,0.11864406779661017
"[1, 1, 1, 0, 0, 0, 0, 0, 1, 1, 1, 0, 0, 1, 0]",139,74,65,3,8,0.04054054054054054,0.12307692307692308
"[1, 0, 1, 1, 1, 0, 0, 0, 0, 0, 1, 1, 1, 0, 0]",142,77,65,9,5,0.11688311688311688,0.07692307692307693
"[0, 1, 0, 1, 1, 1, 1, 0, 0, 0, 1, 1, 0, 1, 0]",117,56,61,8,10,0.14285714285714285,0.16393442622950818
"[0, 1, 0, 0, 0, 1, 1, 1, 1, 0, 1, 0, 1, 1, 1]",180,64,116,6,18,0.09375,0.15517241379310345
"[1, 0, 1, 1, 1, 0, 1, 0, 1, 0, 0, 0, 1, 1, 1]",166,77,89,7,8,0.09090909090909091,0.0898876404494382
"[0, 0, 1, 1, 1, 0, 1, 0, 0, 0, 1, 1, 1, 0, 0]",146,87,59,7,5,0.08045977011494253,0.0847457627118644
"[1, 1, 0, 1, 1, 0, 0, 0, 0, 0, 0, 0, 0, 1, 1]",537,307,230,33,25,0.10749185667752444,0.10869565217391304
"[0, 0, 0, 0, 1, 1, 0, 1, 1, 0, 0, 0, 0, 0, 0]",946,672,274,61,28,0.09077380952380952,0.10218978102189781
"[1, 0, 0, 1, 0, 0, 0, 0, 0, 1, 0, 0, 0, 0, 0]",1732,1299,433,139,37,0.10700538876058506,0.08545034642032333
"[1, 1, 0, 1, 0, 1, 1, 1, 1, 1, 0, 0, 1, 1, 1]",853,255,598,28,52,0.10980392156862745,0.08695652173913043
"[0, 1, 0, 1, 1, 0, 1, 0, 1, 1, 1, 1, 1, 0, 0]",171,70,101,7,11,0.1,0.10891089108910891
"[0, 0, 1, 1, 1, 1, 1, 1, 1, 0, 1, 1, 0, 1, 0]",267,111,156,13,9,0.11711711711711711,0.057692307692307696
"[0, 0, 0, 0, 1, 0, 0, 0, 0, 0, 1, 1, 0, 0, 0]",2731,2139,592,191,55,0.08929406264609631,0.0929054054054054
"[1, 0, 0, 0, 1, 0, 1, 0, 0, 1, 1, 0, 0, 0, 0]",395,248,147,19,11,0.07661290322580645,0.07482993197278912
"[0, 1, 1, 0, 0, 0, 0, 0, 1, 0, 0, 0, 0, 1, 0]",559,411,148,37,13,0.09002433090024331,0.08783783783783784
"[0, 0, 0, 1, 1, 0, 1, 1, 1, 1, 0, 0, 1, 1, 0]",209,116,93,15,6,0.12931034482758622,0.06451612903225806
"[1, 1, 0, 1, 0, 0, 1, 1, 1, 1, 0, 0, 0, 1, 0]",126,61,65,6,7,0.09836065573770492,0.1076923076923077
"[1, 0, 1, 1, 1, 1, 0, 0, 0, 0, 1, 1, 1, 1, 1]",954,346,608,44,63,0.12716763005780346,0.10361842105263158
"[1, 0, 1, 1, 0, 0, 0, 1, 0, 1, 1, 1, 1, 0, 0]",132,55,77,4,7,0.07272727272727272,0.09090909090909091
"[0, 0, 0, 1, 1, 1, 1, 0, 1, 1, 1, 1, 0, 0, 1]",222,103,119,11,13,0.10679611650485436,0.1092436974789916
"[0, 0, 0, 0, 0, 1, 1, 1, 1, 0, 1, 1, 1, 1, 0]",197,119,78,8,12,0.06722689075630252,0.15384615384615385
"[1, 1, 1, 0, 1, 0, 0, 1, 1, 1, 0, 0, 0, 0, 0]",182,85,97,9,9,0.10588235294117647,0.09278350515463918
"[0, 1, 1, 0, 1, 1, 1, 0, 1, 1, 1, 0, 1, 0, 0]",127,58,69,4,6,0.06896551724137931,0.08695652173913043
"[0, 1, 1, 0, 1, 1, 0, 1, 1, 1, 0, 1, 1, 1, 0]",224,67,157,7,15,0.1044776119402985,0.09554140127388536
"[1, 1, 0, 1, 0, 1, 1, 0, 1, 1, 0, 1, 1, 1, 0]",206,74,132,8,16,0.10810810810810811,0.12121212121212122
"[1, 0, 0, 1, 1, 0, 0, 1, 1, 0, 0, 1, 1, 0, 0]",1465,326,1139,29,106,0.08895705521472393,0.09306409130816505
"[1, 0, 1, 0, 0, 0, 1, 0, 1, 1, 0, 0, 0, 0, 1]",187,118,69,9,10,0.07627118644067797,0.14492753623188406
"[0, 0, 1, 0, 0, 0, 1, 0, 0, 0, 0, 0, 0, 0, 0]",8431,6897,1534,676,142,0.09801362911410759,0.09256844850065189
"[0, 0, 1, 0, 1, 1, 0, 1, 1, 0, 0, 1, 1, 1, 0]",122,58,64,6,7,0.10344827586206896,0.109375
"[1, 1, 0, 0, 1, 1, 0, 0, 1, 1, 0, 0, 1, 1, 0]",1391,659,732,62,65,0.09408194233687406,0.08879781420765027
"[0, 1, 1, 1, 0, 0, 0, 1, 1, 0, 0, 1, 1, 0, 0]",245,144,101,23,6,0.1597222222222222,0.0594059405940594
"[0, 1, 0, 1, 1, 1, 0, 0, 0, 1, 1, 0, 0, 1, 1]",178,91,87,7,4,0.07692307692307693,0.04597701149425287
"[1, 1, 1, 1, 0, 1, 0, 0, 1, 1, 1, 0, 1, 0, 1]",240,94,146,9,20,0.09574468085106383,0.136986301369863
"[1, 0, 0, 1, 1, 0, 0, 0, 0, 1, 0, 1, 1, 0, 0]",203,100,103,10,16,0.1,0.1553398058252427
"[1, 0, 1, 0, 0, 0, 0, 1, 0, 1, 1, 1, 1, 0, 1]",115,56,59,5,7,0.08928571428571429,0.11864406779661017
"[1, 1, 1, 1, 1, 1, 1, 1, 0, 0, 1, 0, 0, 1, 0]",395,135,260,16,32,0.11851851851851852,0.12307692307692308
"[1, 0, 1, 0, 1, 1, 0, 1, 1, 1, 1, 1, 0, 1, 0]",196,74,122,7,14,0.0945945945945946,0.11475409836065574
"[1, 1, 0, 0, 0, 1, 1, 1, 0, 1, 1, 1, 0, 1, 0]",156,53,103,1,12,0.018867924528301886,0.11650485436893204
"[0, 1, 1, 0, 1, 0, 1, 1, 1, 0, 1, 1, 0, 0, 0]",123,52,71,4,5,0.07692307692307693,0.07042253521126761
"[0, 1, 0, 0, 1, 0, 1, 0, 0, 0, 1, 0, 0, 1, 1]",157,98,59,11,9,0.11224489795918367,0.15254237288135594
"[1, 0, 1, 1, 0, 1, 0, 1, 0, 0, 0, 0, 1, 1, 0]",123,62,61,11,8,0.1774193548387097,0.13114754098360656
"[1, 0, 1, 1, 0, 1, 1, 0, 1, 1, 1, 1, 1, 0, 0]",290,99,191,11,16,0.1111111111111111,0.08376963350785341
"[0, 0, 0, 1, 1, 0, 1, 0, 0, 0, 0, 1, 0, 0, 0]",515,361,154,39,18,0.10803324099722991,0.11688311688311688
"[1, 1, 1, 0, 0, 0, 1, 1, 1, 1, 1, 1, 0, 1, 1]",712,194,518,14,42,0.07216494845360824,0.08108108108108109
"[1, 1, 0, 0, 0, 0, 0, 0, 0, 0, 1, 1, 0, 0, 0]",4171,2906,1265,281,117,0.09669649002064694,0.09249011857707509
"[1, 1, 0, 0, 0, 0, 0, 1, 1, 1, 1, 0, 0, 1, 1]",528,247,281,26,28,0.10526315789473684,0.099644128113879
"[0, 1, 1, 0, 0, 0, 0, 0, 1, 1, 1, 1, 0, 0, 1]",343,198,145,16,15,0.08080808080808081,0.10344827586206896
"[0, 0, 0, 0, 1, 1, 0, 1, 1, 1, 0, 0, 0, 1, 0]",159,99,60,5,8,0.050505050505050504,0.13333333333333333
"[1, 0, 0, 0, 0, 0, 0, 1, 1, 0, 1, 1, 1, 0, 0]",197,96,101,8,6,0.08333333333333333,0.0594059405940594
"[0, 0, 1, 1, 1, 1, 0, 1, 1, 1, 1, 1, 1, 1, 1]",2727,704,2023,73,177,0.10369318181818182,0.0874938210578349
"[1, 1, 0, 0, 1, 1, 0, 0, 1, 1, 1, 0, 0, 0, 1]",227,96,131,8,8,0.08333333333333333,0.061068702290076333
"[0, 0, 1, 0, 0, 0, 0, 0, 1, 1, 1, 1, 0, 0, 1]",372,236,136,21,11,0.08898305084745763,0.08088235294117647
"[1, 0, 0, 1, 1, 1, 0, 0, 0, 1, 0, 0, 0, 0, 0]",319,181,138,11,18,0.06077348066298342,0.13043478260869565
"[1, 1, 0, 1, 0, 0, 0, 1, 0, 1, 0, 1, 1, 1, 0]",91,47,44,6,4,0.1276595744680851,0.09090909090909091
"[1, 0, 1, 1, 1, 1, 1, 1, 0, 1, 0, 0, 0, 1, 0]",91,43,48,5,7,0.11627906976744186,0.14583333333333334
"[1, 1, 0, 0, 1, 1, 0, 0, 1, 0, 0, 1, 0, 0, 0]",204,122,82,10,6,0.08196721311475409,0.07317073170731707
"[1, 1, 1, 0, 0, 1, 1, 0, 0, 0, 1, 0, 0, 1, 0]",143,54,89,2,10,0.037037037037037035,0.11235955056179775
"[0, 0, 0, 1, 0, 1, 0, 1, 1, 1, 0, 0, 1, 1, 0]",149,71,78,11,2,0.15492957746478872,0.02564102564102564
"[0, 1, 0, 1, 0, 0, 0, 1, 0, 1, 0, 1, 1, 1, 0]",112,65,47,5,5,0.07692307692307693,0.10638297872340426
"[0, 1, 1, 0, 1, 0, 1, 0, 1, 1, 1, 1, 0, 0, 1]",177,78,99,2,9,0.02564102564102564,0.09090909090909091
"[1, 0, 1, 0, 1, 0, 0, 0, 1, 1, 1, 0, 1, 1, 0]",131,59,72,7,5,0.11864406779661017,0.06944444444444445
"[1, 1, 1, 0, 1, 1, 0, 0, 0, 0, 1, 1, 1, 1, 0]",356,143,213,12,21,0.08391608391608392,0.09859154929577464
"[0, 0, 0, 0, 0, 0, 0, 1, 0, 1, 1, 1, 0, 1, 1]",238,146,92,12,11,0.0821917808219178,0.11956521739130435
"[0, 0, 0, 0, 0, 0, 0, 0, 1, 0, 1, 1, 1, 0, 1]",313,194,119,16,12,0.08247422680412371,0.10084033613445378
"[0, 1, 1, 1, 0, 1, 1, 0, 0, 1, 0, 0, 1, 1, 0]",99,51,48,7,7,0.13725490196078433,0.14583333333333334
"[0, 0, 1, 1, 1, 1, 0, 1, 1, 0, 1, 1, 0, 0, 1]",210,73,137,7,11,0.0958904109589041,0.08029197080291971
"[1, 1, 1, 1, 1, 0, 1, 0, 1, 1, 0, 0, 1, 1, 1]",814,216,598,25,58,0.11574074074074074,0.09698996655518395
"[1, 1, 1, 0, 1, 0, 0, 0, 0, 1, 1, 1, 1, 1, 0]",171,74,97,4,9,0.05405405405405406,0.09278350515463918
"[1, 1, 0, 0, 0, 1, 1, 0, 0, 1, 0, 1, 1, 1, 1]",216,85,131,8,26,0.09411764705882353,0.1984732824427481
"[0, 1, 1, 1, 1, 1, 0, 1, 1, 0, 0, 0, 1, 1, 0]",148,59,89,6,12,0.1016949152542373,0.1348314606741573
"[1, 0, 0, 0, 1, 1, 1, 1, 1, 0, 1, 1, 0, 0, 0]",151,72,79,4,7,0.05555555555555555,0.08860759493670886
"[1, 1, 0, 1, 0, 0, 0, 1, 1, 1, 1, 1, 0, 1, 1]",249,74,175,6,9,0.08108108108108109,0.05142857142857143
"[1, 1, 0, 0, 1, 0, 0, 0, 0, 0, 0, 1, 0, 1, 1]",200,124,76,17,7,0.13709677419354838,0.09210526315789473
"[0, 1, 1, 0, 0, 1, 0, 0, 0, 0, 0, 0, 0, 1, 0]",531,384,147,31,21,0.08072916666666667,0.14285714285714285
"[0, 0, 1, 0, 0, 1, 1, 0, 0, 0, 1, 1, 0, 0, 1]",202,125,77,19,8,0.152,0.1038961038961039
"[1, 1, 0, 1, 0, 0, 1, 0, 0, 0, 0, 0, 0, 0, 0]",789,544,245,53,19,0.0974264705882353,0.07755102040816327
"[1, 1, 0, 0, 0, 1, 1, 1, 0, 1, 1, 1, 1, 1, 1]",753,232,521,23,61,0.09913793103448276,0.11708253358925144
"[1, 1, 1, 0, 0, 1, 1, 1, 0, 1, 1, 1, 0, 1, 1]",570,130,440,14,36,0.1076923076923077,0.08181818181818182
"[1, 1, 1, 1, 1, 0, 1, 1, 0, 1, 1, 0, 1, 1, 1]",1728,363,1365,43,123,0.1184573002754821,0.09010989010989011
"[1, 1, 1, 1, 1, 1, 1, 1, 0, 1, 1, 0, 1, 1, 0]",1743,417,1326,30,143,0.07194244604316546,0.10784313725490197
"[1, 1, 1, 1, 0, 0, 0, 0, 0, 0, 1, 1, 1, 0, 1]",433,198,235,21,24,0.10606060606060606,0.10212765957446808
"[1, 1, 0, 0, 0, 0, 0, 1, 1, 0, 0, 1, 0, 1, 1]",190,97,93,9,5,0.09278350515463918,0.053763440860215055
"[0, 0, 0, 0, 0, 0, 1, 1, 1, 0, 0, 0, 0, 0, 1]",831,608,223,66,15,0.10855263157894737,0.06726457399103139
"[0, 1, 1, 0, 0, 0, 1, 0, 0, 0, 0, 1, 1, 0, 0]",386,257,129,27,17,0.10505836575875487,0.13178294573643412
"[1, 0, 0, 1, 0, 0, 1, 1, 0, 0, 0, 1, 1, 0, 0]",196,110,86,10,8,0.09090909090909091,0.09302325581395349
"[1, 1, 1, 0, 1, 0, 1, 1, 0, 1, 0, 0, 0, 1, 0]",104,51,53,7,3,0.13725490196078433,0.05660377358490566
"[1, 1, 1, 1, 1, 1, 1, 0, 1, 0, 0, 0, 1, 1, 0]",325,108,217,13,20,0.12037037037037036,0.09216589861751152
"[1, 0, 0, 0, 1, 1, 1, 1, 0, 1, 0, 0, 1, 0, 1]",104,61,43,5,4,0.08196721311475409,0.09302325581395349
"[1, 1, 1, 0, 0, 1, 1, 0, 1, 0, 1, 1, 0, 1, 1]",286,91,195,10,18,0.10989010989010989,0.09230769230769231
"[0, 1, 1, 0, 1, 1, 1, 1, 1, 1, 1, 1, 0, 1, 1]",1688,425,1263,42,114,0.0988235294117647,0.09026128266033254
"[1, 1, 1, 0, 1, 1, 1, 0, 1, 0, 0, 1, 1, 0, 1]",271,100,171,6,16,0.06,0.0935672514619883
"[1, 1, 1, 1, 1, 0, 1, 1, 0, 0, 0, 0, 0, 0, 1]",275,116,159,12,15,0.10344827586206896,0.09433962264150944
"[1, 1, 0, 0, 1, 1, 1, 1, 1, 1, 0, 1, 1, 0, 0]",425,164,261,13,23,0.07926829268292683,0.08812260536398467
"[1, 1, 1, 0, 0, 1, 1, 1, 1, 1, 1, 0, 1, 1, 0]",835,177,658,17,59,0.096045197740113,0.08966565349544073
"[0, 1, 1, 1, 0, 0, 0, 1, 0, 0, 0, 1, 0, 1, 1]",138,74,64,12,8,0.16216216216216217,0.125
"[1, 1, 1, 1, 1, 1, 0, 1, 1, 0, 1, 1, 1, 1, 0]",1737,376,1361,39,128,0.10372340425531915,0.0940484937545922
"[0, 1, 1, 0, 0, 1, 1, 1, 1, 0, 0, 0, 1, 0, 0]",244,170,74,19,10,0.11176470588235295,0.13513513513513514
"[0, 0, 0, 1, 0, 1, 1, 1, 1, 0, 1, 1, 0, 0, 1]",131,64,67,5,7,0.078125,0.1044776119402985
"[0, 1, 0, 0, 0, 1, 0, 1, 1, 1, 1, 0, 1, 1, 0]",103,42,61,4,6,0.09523809523809523,0.09836065573770492
"[1, 0, 0, 1, 0, 0, 0, 0, 1, 0, 1, 1, 0, 0, 0]",263,170,93,19,8,0.11176470588235295,0.08602150537634409
"[0, 0, 1, 1, 0, 1, 0, 0, 0, 1, 0, 0, 1, 0, 0]",234,153,81,13,11,0.08496732026143791,0.13580246913580246
"[1, 0, 1, 1, 1, 1, 0, 1, 1, 1, 1, 1, 1, 1, 0]",1773,363,1410,43,135,0.1184573002754821,0.09574468085106383
"[1, 1, 1, 1, 0, 1, 1, 1, 1, 1, 1, 1, 0, 1, 0]",1584,374,1210,41,109,0.10962566844919786,0.09008264462809917
"[0, 0, 0, 1, 1, 0, 0, 1, 1, 1, 1, 1, 1, 0, 0]",1544,1238,306,110,37,0.0888529886914378,0.12091503267973856
"[0, 1, 0, 0, 0, 0, 0, 0, 1, 0, 1, 0, 1, 1, 0]",273,175,98,16,15,0.09142857142857143,0.15306122448979592
"[1, 0, 0, 0, 0, 0, 0, 1, 0, 1, 1, 0, 1, 0, 0]",257,153,104,11,6,0.0718954248366013,0.057692307692307696
"[1, 1, 1, 0, 0, 0, 0, 0, 1, 0, 0, 0, 1, 1, 1]",229,99,130,9,16,0.09090909090909091,0.12307692307692308
"[0, 1, 1, 0, 0, 0, 1, 1, 0, 1, 1, 1, 0, 0, 0]",121,73,48,5,7,0.0684931506849315,0.14583333333333334
"[1, 0, 0, 0, 1, 0, 0, 1, 1, 0, 0, 0, 1, 1, 0]",181,101,80,9,9,0.0891089108910891,0.1125
"[0, 1, 0, 1, 0, 0, 1, 1, 0, 0, 1, 0, 0, 1, 0]",128,69,59,7,5,0.10144927536231885,0.0847457627118644
"[1, 0, 1, 0, 1, 1, 0, 1, 0, 1, 0, 0, 1, 1, 0]",102,58,44,6,3,0.10344827586206896,0.06818181818181818
"[1, 1, 0, 0, 1, 0, 1, 0, 1, 1, 0, 1, 0, 1, 0]",104,37,67,4,7,0.10810810810810811,0.1044776119402985
"[1, 0, 1, 1, 0, 1, 1, 0, 0, 1, 0, 0, 1, 0, 0]",115,64,51,2,6,0.03125,0.11764705882352941
"[0, 1, 1, 0, 1, 1, 0, 1, 1, 0, 0, 1, 0, 0, 1]",93,42,51,4,6,0.09523809523809523,0.11764705882352941
"[0, 1, 1, 1, 1, 1, 1, 1, 0, 0, 1, 1, 1, 1, 0]",1214,431,783,48,79,0.11136890951276102,0.10089399744572158
"[0, 1, 0, 1, 0, 1, 1, 1, 1, 1, 1, 1, 0, 0, 1]",372,143,229,16,15,0.11188811188811189,0.06550218340611354
"[1, 0, 1, 0, 1, 0, 1, 0, 1, 1, 1, 1, 1, 1, 1]",689,202,487,21,52,0.10396039603960396,0.10677618069815195
"[1, 1, 0, 1, 0, 1, 0, 1, 1, 0, 1, 1, 0, 0, 0]",115,57,58,6,7,0.10526315789473684,0.1206896551724138
"[0, 1, 1, 0, 1, 0, 1, 0, 1, 1, 0, 1, 1, 0, 0]",120,55,65,4,6,0.07272727272727272,0.09230769230769231
"[1, 1, 0, 0, 0, 0, 1, 1, 1, 1, 0, 0, 1, 1, 0]",1468,713,755,79,73,0.11079943899018233,0.09668874172185431
"[0, 0, 1, 1, 1, 0, 0, 1, 1, 1, 1, 1, 1, 1, 0]",384,141,243,12,20,0.0851063829787234,0.0823045267489712
"[1, 0, 1, 0, 1, 1, 1, 1, 1, 0, 1, 1, 0, 1, 0]",196,77,119,8,6,0.1038961038961039,0.05042016806722689
"[1, 1, 1, 0, 0, 0, 1, 0, 1, 0, 1, 0, 0, 0, 0]",152,85,67,5,6,0.058823529411764705,0.08955223880597014
"[1, 1, 1, 1, 1, 1, 1, 0, 1, 1, 1, 1, 0, 1, 0]",1597,360,1237,36,129,0.1,0.10428455941794665
"[0, 1, 1, 0, 1, 1, 1, 1, 1, 0, 0, 1, 1, 1, 1]",1009,348,661,36,68,0.10344827586206896,0.10287443267776097
"[1, 0, 0, 0, 0, 0, 0, 0, 1, 1, 1, 0, 1, 0, 0]",277,174,103,12,8,0.06896551724137931,0.07766990291262135
"[0, 0, 0, 0, 1, 0, 0, 0, 1, 1, 0, 1, 0, 0, 1]",233,150,83,18,5,0.12,0.060240963855421686
"[1, 1, 0, 1, 1, 1, 0, 0, 0, 1, 0, 0, 0, 0, 1]",110,55,55,7,3,0.12727272727272726,0.05454545454545454
"[1, 1, 0, 1, 0, 1, 1, 0, 1, 1, 1, 0, 0, 0, 1]",141,55,86,5,11,0.09090909090909091,0.12790697674418605
"[1, 1, 1, 1, 0, 1, 0, 1, 1, 0, 1, 1, 1, 0, 0]",256,87,169,9,21,0.10344827586206896,0.1242603550295858
"[1, 1, 1, 0, 0, 1, 1, 1, 1, 0, 1, 0, 1, 1, 1]",940,197,743,18,67,0.09137055837563451,0.0901749663526245
"[1, 1, 1, 1, 0, 0, 1, 0, 1, 1, 0, 1, 1, 1, 1]",686,200,486,27,44,0.135,0.09053497942386832
"[1, 1, 1, 0, 0, 1, 0, 1, 1, 0, 0, 0, 0, 0, 0]",267,144,123,14,11,0.09722222222222222,0.08943089430894309
"[1, 0, 0, 1, 0, 1, 1, 1, 1, 0, 0, 0, 1, 1, 0]",126,45,81,5,8,0.1111111111111111,0.09876543209876543
"[1, 0, 1, 1, 1, 1, 0, 0, 1, 0, 1, 1, 1, 1, 0]",246,82,164,6,11,0.07317073170731707,0.06707317073170732
"[0, 1, 0, 1, 0, 1, 1, 1, 1, 0, 0, 1, 0, 1, 1]",146,62,84,4,8,0.06451612903225806,0.09523809523809523
"[0, 0, 1, 1, 1, 1, 0, 1, 1, 0, 0, 1, 1, 1, 1]",493,195,298,21,43,0.1076923076923077,0.14429530201342283
"[1, 1, 1, 1, 1, 0, 1, 0, 0, 0, 0, 0, 1, 1, 1]",305,112,193,11,18,0.09821428571428571,0.09326424870466321
"[1, 0, 0, 1, 0, 1, 1, 0, 1, 1, 0, 1, 1, 1, 0]",145,61,84,3,5,0.04918032786885246,0.05952380952380952
"[1, 1, 1, 0, 0, 1, 0, 1, 1, 0, 1, 1, 0, 1, 1]",264,98,166,10,14,0.10204081632653061,0.08433734939759036
"[1, 0, 1, 0, 1, 0, 0, 0, 1, 1, 0, 1, 0, 0, 0]",138,87,51,4,4,0.04597701149425287,0.0784313725490196
"[1, 0, 0, 0, 0, 0, 0, 1, 0, 0, 1, 0, 1, 0, 1]",256,136,120,11,8,0.08088235294117647,0.06666666666666667
"[0, 1, 1, 0, 0, 0, 0, 1, 1, 1, 0, 1, 0, 0, 0]",211,139,72,13,6,0.09352517985611511,0.08333333333333333
"[0, 0, 0, 0, 0, 1, 1, 0, 0, 0, 1, 1, 1, 1, 0]",307,201,106,22,9,0.10945273631840796,0.08490566037735849
"[1, 0, 0, 0, 0, 1, 1, 0, 1, 1, 0, 1, 1, 1, 1]",258,78,180,5,24,0.0641025641025641,0.13333333333333333
"[0, 1, 1, 1, 0, 0, 0, 0, 1, 1, 0, 1, 1, 0, 1]",140,72,68,5,9,0.06944444444444445,0.1323529411764706
"[1, 0, 0, 0, 0, 0, 1, 1, 0, 0, 1, 1, 1, 1, 0]",438,215,223,37,21,0.17209302325581396,0.09417040358744394
"[0, 1, 0, 1, 0, 1, 0, 0, 1, 0, 0, 1, 0, 0, 0]",233,146,87,9,8,0.06164383561643835,0.09195402298850575
"[1, 1, 0, 1, 0, 0, 1, 0, 0, 1, 0, 1, 1, 1, 0]",90,46,44,5,2,0.10869565217391304,0.045454545454545456
"[0, 1, 1, 1, 0, 0, 1, 1, 0, 0, 1, 1, 1, 1, 1]",831,303,528,27,53,0.0891089108910891,0.10037878787878787
"[1, 0, 1, 0, 0, 0, 0, 0, 0, 0, 0, 1, 1, 1, 0]",329,218,111,12,15,0.05504587155963303,0.13513513513513514
"[0, 0, 0, 0, 0, 0, 1, 0, 1, 0, 1, 0, 1, 1, 0]",252,168,84,20,8,0.11904761904761904,0.09523809523809523
"[0, 0, 0, 0, 0, 1, 0, 0, 1, 1, 0, 0, 1, 1, 1]",420,276,144,22,13,0.07971014492753623,0.09027777777777778
"[1, 1, 1, 1, 0, 0, 1, 0, 0, 0, 0, 1, 1, 1, 1]",363,141,222,15,24,0.10638297872340426,0.10810810810810811
"[1, 1, 0, 0, 0, 0, 1, 0, 0, 0, 1, 0, 0, 0, 1]",251,150,101,13,8,0.08666666666666667,0.07920792079207921
"[1, 1, 0, 0, 1, 1, 0, 0, 0, 0, 1, 0, 0, 0, 1]",308,184,124,21,8,0.11413043478260869,0.06451612903225806
"[0, 0, 0, 0, 1, 0, 1, 0, 1, 0, 0, 1, 0, 0, 0]",514,371,143,40,16,0.1078167115902965,0.11188811188811189
"[1, 0, 0, 0, 0, 1, 0, 1, 0, 1, 0, 0, 1, 0, 0]",220,135,85,12,12,0.08888888888888889,0.1411764705882353
"[0, 0, 1, 0, 0, 1, 0, 0, 0, 1, 0, 0, 1, 1, 0]",271,194,77,20,6,0.10309278350515463,0.07792207792207792
"[1, 1, 1, 0, 1, 1, 1, 1, 1, 1, 1, 0, 0, 0, 0]",791,237,554,21,40,0.08860759493670886,0.07220216606498195
"[0, 1, 0, 1, 0, 1, 0, 0, 0, 1, 0, 1, 1, 0, 1]",109,59,50,4,4,0.06779661016949153,0.08
"[0, 1, 1, 0, 1, 0, 0, 1, 1, 1, 0, 0, 0, 0, 0]",192,114,78,11,7,0.09649122807017543,0.08974358974358974
"[1, 1, 0, 0, 1, 1, 1, 1, 0, 0, 1, 0, 0, 0, 0]",255,136,119,11,6,0.08088235294117647,0.05042016806722689
"[0, 1, 0, 0, 1, 0, 1, 0, 0, 1, 0, 1, 0, 1, 1]",110,62,48,8,10,0.12903225806451613,0.20833333333333334
"[0, 0, 0, 1, 0, 1, 1, 0, 0, 1, 0, 0, 0, 0, 0]",610,444,166,44,18,0.0990990990990991,0.10843373493975904
"[0, 1, 0, 1, 1, 0, 1, 0, 1, 1, 0, 1, 1, 1, 1]",266,100,166,8,18,0.08,0.10843373493975904
"[0, 0, 0, 1, 0, 1, 0, 0, 0, 1, 0, 1, 1, 0, 1]",142,83,59,11,4,0.13253012048192772,0.06779661016949153
"[1, 1, 0, 1, 0, 1, 1, 0, 0, 1, 1, 1, 1, 0, 0]",365,137,228,10,18,0.072992700729927,0.07894736842105263
"[1, 1, 1, 0, 1, 0, 1, 1, 0, 0, 1, 1, 1, 1, 0]",405,122,283,10,34,0.08196721311475409,0.12014134275618374
"[1, 1, 1, 0, 1, 0, 0, 0, 0, 1, 0, 1, 1, 1, 1]",205,59,146,8,20,0.13559322033898305,0.136986301369863
"[1, 1, 0, 0, 0, 1, 0, 1, 0, 0, 0, 0, 1, 0, 0]",269,186,83,22,11,0.11827956989247312,0.13253012048192772
"[0, 0, 1, 1, 1, 0, 0, 1, 0, 0, 1, 1, 1, 1, 0]",163,79,84,7,9,0.08860759493670886,0.10714285714285714
"[0, 1, 1, 0, 1, 0, 1, 0, 0, 0, 0, 1, 1, 1, 0]",132,76,56,10,6,0.13157894736842105,0.10714285714285714
"[0, 1, 0, 0, 0, 0, 0, 0, 1, 1, 1, 1, 0, 0, 0]",836,532,304,42,25,0.07894736842105263,0.08223684210526316
"[1, 1, 1, 0, 1, 1, 1, 1, 0, 1, 0, 0, 0, 1, 0]",136,59,77,9,13,0.15254237288135594,0.16883116883116883
"[1, 0, 0, 0, 1, 1, 1, 1, 0, 1, 0, 1, 0, 1, 0]",112,45,67,5,7,0.1111111111111111,0.1044776119402985
"[0, 1, 0, 0, 0, 0, 0, 0, 1, 1, 1, 0, 1, 1, 1]",180,104,76,10,3,0.09615384615384616,0.039473684210526314
"[0, 1, 0, 1, 1, 0, 0, 1, 0, 1, 0, 0, 1, 1, 0]",121,63,58,7,5,0.1111111111111111,0.08620689655172414
"[0, 1, 0, 1, 0, 1, 0, 1, 1, 0, 0, 1, 0, 1, 0]",87,43,44,9,6,0.20930232558139536,0.13636363636363635
"[1, 0, 1, 1, 1, 0, 1, 0, 1, 0, 1, 0, 1, 0, 1]",116,51,65,2,8,0.0392156862745098,0.12307692307692308
"[1, 1, 0, 1, 1, 1, 0, 1, 0, 1, 0, 1, 0, 1, 0]",133,51,82,8,6,0.1568627450980392,0.07317073170731707
"[0, 0, 1, 0, 1, 1, 1, 1, 0, 0, 1, 0, 1, 1, 1]",171,70,101,9,8,0.12857142857142856,0.07920792079207921
"[1, 0, 0, 0, 1, 1, 1, 0, 0, 0, 0, 0, 0, 0, 0]",1064,660,404,73,35,0.11060606060606061,0.08663366336633663
"[0, 1, 1, 1, 0, 0, 0, 0, 1, 0, 0, 1, 1, 0, 0]",217,147,70,10,8,0.06802721088435375,0.11428571428571428
"[1, 0, 0, 1, 1, 1, 0, 1, 1, 1, 1, 0, 0, 0, 1]",151,45,106,3,8,0.06666666666666667,0.07547169811320754
"[0, 1, 1, 1, 1, 0, 1, 1, 0, 1, 0, 1, 1, 0, 1]",250,78,172,10,21,0.1282051282051282,0.12209302325581395
"[0, 1, 1, 0, 1, 1, 1, 1, 0, 1, 1, 0, 1, 0, 1]",226,75,151,8,14,0.10666666666666667,0.09271523178807947
"[0, 0, 0, 1, 0, 0, 1, 1, 0, 1, 1, 0, 1, 1, 1]",142,71,71,7,7,0.09859154929577464,0.09859154929577464
"[1, 0, 0, 1, 0, 0, 0, 0, 0, 1, 1, 1, 0, 0, 0]",292,183,109,21,6,0.11475409836065574,0.05504587155963303
"[0, 1, 0, 0, 0, 0, 1, 1, 1, 1, 1, 1, 0, 1, 0]",173,84,89,10,8,0.11904761904761904,0.0898876404494382
"[1, 0, 0, 1, 1, 0, 1, 1, 1, 1, 0, 1, 1, 0, 0]",161,55,106,6,10,0.10909090909090909,0.09433962264150944
"[0, 0, 1, 1, 0, 1, 0, 1, 1, 1, 1, 1, 1, 1, 1]",872,302,570,32,61,0.10596026490066225,0.10701754385964912
"[0, 1, 1, 1, 1, 1, 1, 0, 1, 0, 0, 0, 1, 1, 0]",173,87,86,7,11,0.08045977011494253,0.12790697674418605
"[0, 1, 1, 0, 0, 1, 1, 1, 0, 1, 0, 1, 0, 1, 1]",162,85,77,4,3,0.047058823529411764,0.03896103896103896
"[0, 0, 0, 1, 1, 1, 1, 0, 1, 1, 1, 0, 1, 0, 1]",138,67,71,3,7,0.04477611940298507,0.09859154929577464
"[1, 0, 0, 0, 1, 0, 1, 1, 0, 1, 0, 0, 1, 1, 0]",133,67,66,6,7,0.08955223880597014,0.10606060606060606
"[1, 0, 1, 0, 0, 0, 0, 1, 0, 1, 1, 1, 1, 1, 1]",227,90,137,9,16,0.1,0.11678832116788321
"[1, 0, 1, 1, 1, 0, 1, 0, 1, 1, 1, 0, 0, 0, 0]",181,77,104,5,12,0.06493506493506493,0.11538461538461539
"[0, 1, 1, 1, 1, 1, 1, 0, 1, 1, 0, 1, 0, 0, 1]",263,124,139,16,7,0.12903225806451613,0.050359712230215826
"[0, 0, 1, 0, 0, 0, 0, 1, 1, 1, 1, 1, 0, 1, 1]",150,74,76,4,7,0.05405405405405406,0.09210526315789473
"[0, 1, 1, 1, 1, 1, 0, 0, 0, 1, 1, 0, 1, 1, 0]",161,83,78,7,9,0.08433734939759036,0.11538461538461539
"[1, 0, 1, 0, 1, 0, 0, 0, 0, 1, 1, 0, 1, 1, 1]",136,61,75,7,9,0.11475409836065574,0.12
"[1, 1, 1, 0, 1, 0, 1, 0, 0, 0, 0, 1, 1, 0, 1]",140,59,81,5,9,0.0847457627118644,0.1111111111111111
"[1, 0, 1, 1, 1, 1, 1, 0, 1, 0, 1, 0, 0, 0, 0]",134,67,67,12,3,0.1791044776119403,0.04477611940298507
"[0, 0, 1, 0, 0, 1, 0, 0, 0, 1, 0, 1, 1, 1, 1]",179,94,85,7,9,0.07446808510638298,0.10588235294117647
"[1, 1, 0, 1, 1, 0, 1, 1, 1, 0, 1, 0, 1, 0, 1]",235,82,153,10,17,0.12195121951219512,0.1111111111111111
"[0, 0, 0, 1, 1, 0, 1, 0, 1, 0, 1, 0, 0, 0, 0]",271,194,77,18,10,0.09278350515463918,0.12987012987012986
"[0, 0, 0, 0, 0, 0, 0, 0, 0, 1, 0, 0, 1, 0, 1]",1976,1536,440,155,47,0.10091145833333333,0.10681818181818181
"[1, 0, 1, 1, 1, 1, 0, 0, 1, 1, 0, 0, 0, 0, 1]",448,184,264,17,28,0.09239130434782608,0.10606060606060606
"[0, 1, 1, 0, 0, 0, 1, 1, 1, 0, 1, 1, 1, 1, 0]",155,84,71,3,5,0.03571428571428571,0.07042253521126761
"[1, 1, 1, 1, 0, 1, 1, 0, 1, 1, 0, 0, 0, 1, 1]",307,112,195,13,23,0.11607142857142858,0.11794871794871795
"[1, 0, 0, 0, 0, 0, 1, 1, 1, 0, 0, 0, 0, 0, 1]",327,206,121,24,7,0.11650485436893204,0.05785123966942149
"[0, 1, 1, 1, 0, 1, 1, 0, 1, 1, 1, 1, 1, 0, 1]",505,157,348,20,27,0.12738853503184713,0.07758620689655173
"[1, 0, 0, 0, 0, 1, 1, 0, 1, 0, 0, 1, 0, 0, 0]",294,169,125,10,11,0.05917159763313609,0.088
"[1, 0, 0, 1, 0, 1, 1, 0, 0, 1, 1, 1, 1, 1, 0]",156,70,86,3,11,0.04285714285714286,0.12790697674418605
"[1, 1, 0, 1, 1, 0, 0, 1, 0, 1, 1, 0, 0, 1, 1]",200,65,135,4,7,0.06153846153846154,0.05185185185185185
"[1, 1, 0, 0, 0, 1, 0, 1, 1, 0, 1, 1, 0, 1, 1]",172,69,103,5,10,0.07246376811594203,0.0970873786407767
"[0, 0, 0, 1, 1, 0, 0, 1, 1, 0, 0, 0, 1, 0, 1]",320,241,79,28,4,0.11618257261410789,0.05063291139240506
"[1, 0, 1, 1, 0, 1, 0, 0, 1, 0, 0, 0, 0, 0, 1]",160,89,71,8,8,0.0898876404494382,0.11267605633802817
"[0, 0, 1, 0, 1, 0, 0, 1, 0, 0, 1, 0, 1, 1, 0]",145,66,79,5,9,0.07575757575757576,0.11392405063291139
"[1, 0, 1, 0, 1, 0, 0, 1, 0, 1, 1, 1, 1, 0, 0]",141,69,72,4,7,0.057971014492753624,0.09722222222222222
"[0, 0, 1, 0, 0, 1, 1, 1, 0, 0, 0, 1, 0, 1, 0]",150,89,61,11,3,0.12359550561797752,0.04918032786885246
"[0, 0, 0, 0, 0, 0, 1, 1, 1, 0, 1, 1, 0, 0, 0]",373,252,121,29,13,0.11507936507936507,0.10743801652892562
"[0, 0, 1, 0, 0, 0, 0, 0, 0, 1, 1, 1, 0, 1, 1]",180,97,83,19,10,0.1958762886597938,0.12048192771084337
"[0, 0, 0, 1, 1, 0, 1, 0, 1, 0, 0, 0, 1, 0, 1]",141,96,45,15,3,0.15625,0.06666666666666667
"[0, 0, 0, 1, 0, 0, 1, 0, 1, 1, 1, 0, 0, 0, 1]",143,80,63,11,5,0.1375,0.07936507936507936
"[0, 0, 1, 0, 1, 0, 0, 1, 1, 0, 0, 1, 1, 1, 0]",122,61,61,8,6,0.13114754098360656,0.09836065573770492
"[1, 1, 0, 1, 1, 0, 0, 1, 0, 0, 1, 0, 1, 0, 0]",116,62,54,3,5,0.04838709677419355,0.09259259259259259
"[1, 1, 1, 1, 1, 1, 0, 1, 1, 0, 0, 1, 0, 0, 1]",277,85,192,8,27,0.09411764705882353,0.140625
"[0, 1, 0, 1, 1, 1, 1, 0, 1, 0, 0, 1, 1, 0, 1]",160,60,100,6,14,0.1,0.14
"[1, 1, 1, 1, 0, 1, 1, 0, 1, 0, 1, 0, 1, 0, 1]",236,86,150,5,12,0.05813953488372093,0.08
"[1, 1, 1, 1, 1, 1, 0, 1, 1, 0, 1, 0, 1, 0, 1]",550,163,387,10,37,0.06134969325153374,0.09560723514211886
"[0, 0, 1, 0, 0, 0, 0, 0, 1, 1, 0, 0, 0, 0, 1]",964,684,280,53,27,0.07748538011695906,0.09642857142857143
"[1, 1, 0, 1, 0, 0, 1, 0, 0, 1, 1, 0, 0, 1, 1]",202,115,87,12,4,0.10434782608695652,0.04597701149425287
"[0, 0, 1, 1, 1, 0, 1, 1, 1, 1, 1, 1, 0, 1, 1]",573,183,390,21,34,0.11475409836065574,0.08717948717948718
"[1, 1, 0, 1, 1, 1, 1, 1, 1, 0, 1, 0, 0, 1, 1]",621,169,452,16,47,0.09467455621301775,0.10398230088495575
"[0, 1, 0, 0, 0, 0, 0, 0, 1, 1, 0, 0, 0, 1, 1]",413,258,155,23,18,0.08914728682170543,0.11612903225806452
"[0, 0, 1, 0, 0, 1, 1, 1, 1, 0, 0, 1, 1, 1, 1]",508,222,286,23,16,0.1036036036036036,0.055944055944055944
"[1, 1, 1, 1, 0, 0, 1, 0, 0, 1, 1, 1, 1, 0, 0]",299,121,178,10,16,0.08264462809917356,0.0898876404494382
"[0, 1, 1, 0, 0, 1, 1, 1, 1, 0, 1, 1, 1, 1, 0]",332,158,174,13,13,0.08227848101265822,0.07471264367816093
"[0, 1, 0, 1, 0, 1, 0, 0, 1, 1, 1, 1, 1, 1, 0]",224,99,125,4,8,0.04040404040404041,0.064
"[0, 0, 1, 0, 0, 1, 0, 1, 0, 0, 0, 1, 0, 1, 1]",153,94,59,10,5,0.10638297872340426,0.0847457627118644
"[0, 1, 0, 0, 1, 0, 0, 0, 0, 0, 0, 1, 1, 0, 1]",269,180,89,13,4,0.07222222222222222,0.0449438202247191
"[0, 1, 1, 0, 1, 0, 0, 1, 0, 0, 0, 0, 0, 0, 1]",276,188,88,18,7,0.09574468085106383,0.07954545454545454
"[0, 1, 1, 0, 0, 0, 1, 1, 0, 1, 0, 1, 0, 0, 1]",117,69,48,6,5,0.08695652173913043,0.10416666666666667
"[1, 1, 0, 0, 1, 0, 0, 1, 0, 1, 1, 1, 1, 1, 0]",161,70,91,4,8,0.05714285714285714,0.08791208791208792
"[0, 0, 0, 1, 1, 1, 0, 0, 1, 0, 0, 0, 1, 0, 1]",167,99,68,9,5,0.09090909090909091,0.07352941176470588
"[1, 0, 0, 1, 1, 1, 1, 0, 0, 1, 1, 0, 0, 1, 1]",2035,329,1706,22,168,0.0668693009118541,0.0984759671746776
"[1, 0, 1, 1, 1, 1, 0, 1, 1, 1, 1, 0, 1, 1, 0]",494,144,350,12,41,0.08333333333333333,0.11714285714285715
"[1, 0, 1, 1, 1, 0, 0, 1, 0, 1, 1, 1, 1, 0, 0]",184,86,98,11,9,0.12790697674418605,0.09183673469387756
"[1, 1, 0, 1, 0, 0, 0, 1, 1, 1, 1, 1, 1, 1, 0]",312,100,212,6,24,0.06,0.11320754716981132
"[0, 1, 0, 0, 1, 0, 0, 0, 1, 0, 0, 0, 0, 0, 0]",1836,1377,459,122,48,0.08859840232389252,0.10457516339869281
"[0, 0, 0, 0, 0, 1, 1, 1, 0, 0, 1, 1, 1, 1, 0]",281,156,125,15,20,0.09615384615384616,0.16
"[0, 1, 0, 1, 1, 1, 0, 0, 0, 0, 1, 0, 1, 1, 0]",118,67,51,8,6,0.11940298507462686,0.11764705882352941
"[1, 0, 0, 0, 0, 1, 0, 0, 0, 1, 0, 1, 0, 1, 1]",165,93,72,11,11,0.11827956989247312,0.1527777777777778
"[1, 0, 1, 0, 1, 0, 0, 0, 0, 1, 0, 0, 0, 1, 0]",260,160,100,18,8,0.1125,0.08
"[0, 1, 1, 1, 0, 1, 0, 1, 0, 0, 0, 0, 1, 0, 0]",150,84,66,10,9,0.11904761904761904,0.13636363636363635
"[1, 1, 0, 1, 0, 1, 1, 0, 0, 0, 1, 1, 1, 0, 1]",136,49,87,5,5,0.10204081632653061,0.05747126436781609
"[0, 1, 1, 1, 1, 0, 1, 0, 1, 1, 0, 0, 0, 1, 1]",178,70,108,9,15,0.12857142857142856,0.1388888888888889
"[0, 1, 1, 1, 1, 0, 0, 1, 1, 1, 1, 0, 1, 1, 0]",369,200,169,14,18,0.07,0.10650887573964497
"[0, 1, 0, 0, 0, 0, 1, 1, 0, 1, 0, 1, 0, 1, 1]",111,60,51,8,4,0.13333333333333333,0.0784313725490196
"[1, 0, 1, 1, 1, 0, 0, 0, 0, 0, 0, 0, 0, 0, 0]",1180,812,368,89,38,0.10960591133004927,0.10326086956521739
"[1, 0, 1, 1, 0, 0, 1, 1, 0, 0, 0, 1, 0, 1, 1]",143,63,80,5,8,0.07936507936507936,0.1
"[0, 0, 1, 1, 0, 1, 0, 1, 0, 0, 0, 1, 1, 0, 0]",152,90,62,4,10,0.044444444444444446,0.16129032258064516
"[0, 0, 1, 0, 1, 0, 0, 1, 0, 1, 0, 0, 1, 1, 0]",165,102,63,7,8,0.06862745098039216,0.12698412698412698
"[0, 0, 0, 1, 0, 1, 0, 0, 1, 0, 1, 0, 0, 1, 1]",185,110,75,11,6,0.1,0.08
"[0, 0, 1, 0, 1, 1, 1, 0, 0, 0, 0, 1, 1, 1, 0]",151,88,63,11,6,0.125,0.09523809523809523
"[1, 0, 1, 0, 0, 0, 1, 0, 0, 1, 1, 0, 1, 1, 1]",114,58,56,5,4,0.08620689655172414,0.07142857142857142
"[0, 0, 1, 0, 1, 1, 1, 1, 1, 0, 1, 0, 0, 0, 1]",132,62,70,7,4,0.11290322580645161,0.05714285714285714
"[1, 1, 0, 0, 1, 0, 1, 1, 1, 1, 1, 0, 1, 0, 0]",147,65,82,3,11,0.046153846153846156,0.13414634146341464
"[0, 0, 1, 1, 1, 0, 0, 0, 0, 1, 0, 0, 1, 0, 1]",147,89,58,13,7,0.14606741573033707,0.1206896551724138
"[0, 1, 1, 0, 1, 0, 0, 0, 1, 1, 1, 0, 0, 0, 0]",206,113,93,13,11,0.11504424778761062,0.11827956989247312
"[0, 1, 1, 1, 0, 1, 1, 1, 1, 0, 0, 1, 1, 1, 0]",250,89,161,15,12,0.16853932584269662,0.07453416149068323
"[0, 0, 0, 1, 0, 1, 1, 1, 0, 0, 1, 1, 1, 0, 1]",112,52,60,4,7,0.07692307692307693,0.11666666666666667
"[0, 0, 1, 0, 1, 0, 0, 1, 1, 0, 1, 0, 0, 1, 1]",131,72,59,8,4,0.1111111111111111,0.06779661016949153
"[0, 0, 0, 1, 1, 0, 1, 1, 1, 0, 0, 1, 0, 0, 0]",155,89,66,9,10,0.10112359550561797,0.15151515151515152
"[0, 0, 0, 0, 0, 1, 1, 0, 1, 1, 1, 0, 0, 1, 0]",147,96,51,8,7,0.08333333333333333,0.13725490196078433
"[0, 1, 0, 0, 0, 0, 0, 0, 1, 1, 0, 1, 1, 1, 0]",158,87,71,3,6,0.034482758620689655,0.08450704225352113
"[1, 1, 1, 0, 0, 0, 0, 0, 0, 1, 1, 0, 0, 0, 1]",437,122,315,10,35,0.08196721311475409,0.1111111111111111
"[0, 1, 1, 1, 0, 1, 1, 1, 1, 1, 0, 0, 0, 0, 1]",295,117,178,10,18,0.08547008547008547,0.10112359550561797
"[1, 0, 1, 1, 1, 1, 1, 1, 0, 0, 0, 1, 1, 0, 0]",237,89,148,8,10,0.0898876404494382,0.06756756756756757
"[0, 0, 0, 0, 0, 1, 0, 1, 0, 0, 1, 0, 0, 1, 0]",512,370,142,31,13,0.08378378378378379,0.09154929577464789
"[0, 0, 0, 1, 0, 0, 0, 1, 0, 1, 0, 1, 0, 0, 1]",239,156,83,13,7,0.08333333333333333,0.08433734939759036
"[0, 1, 1, 0, 0, 0, 0, 0, 1, 1, 0, 0, 1, 0, 0]",285,202,83,26,13,0.12871287128712872,0.1566265060240964
"[0, 0, 1, 0, 1, 0, 0, 0, 1, 1, 0, 0, 0, 1, 1]",195,120,75,11,3,0.09166666666666666,0.04
"[0, 1, 1, 0, 0, 1, 0, 0, 1, 1, 1, 0, 1, 1, 1]",198,93,105,9,11,0.0967741935483871,0.10476190476190476
"[0, 1, 1, 1, 0, 0, 0, 1, 1, 1, 0, 1, 1, 0, 0]",130,64,66,6,7,0.09375,0.10606060606060606
"[0, 0, 1, 0, 1, 1, 1, 1, 1, 0, 1, 1, 0, 1, 0]",135,59,76,2,12,0.03389830508474576,0.15789473684210525
"[0, 1, 1, 1, 0, 1, 1, 0, 0, 0, 0, 0, 0, 0, 0]",478,322,156,28,11,0.08695652173913043,0.07051282051282051
"[0, 1, 1, 1, 0, 0, 0, 0, 0, 1, 1, 0, 0, 1, 1]",318,180,138,18,13,0.1,0.09420289855072464
"[0, 0, 1, 1, 0, 1, 1, 0, 0, 0, 1, 0, 0, 0, 0]",278,180,98,14,10,0.07777777777777778,0.10204081632653061
"[0, 1, 1, 0, 1, 0, 0, 1, 1, 1, 0, 0, 1, 0, 0]",101,57,44,3,6,0.05263157894736842,0.13636363636363635
"[1, 0, 1, 1, 0, 1, 1, 0, 1, 0, 0, 1, 1, 1, 0]",137,57,80,6,4,0.10526315789473684,0.05
"[1, 1, 0, 1, 0, 1, 1, 0, 1, 0, 0, 1, 1, 0, 0]",125,56,69,3,6,0.05357142857142857,0.08695652173913043
"[0, 1, 0, 1, 1, 0, 1, 0, 0, 0, 0, 0, 1, 0, 0]",235,157,78,19,10,0.12101910828025478,0.1282051282051282
"[1, 0, 1, 1, 0, 0, 0, 1, 1, 1, 1, 1, 1, 0, 1]",288,86,202,9,21,0.10465116279069768,0.10396039603960396
"[1, 1, 0, 1, 1, 0, 0, 0, 1, 1, 1, 1, 1, 1, 0]",381,147,234,24,24,0.16326530612244897,0.10256410256410256
"[1, 0, 1, 1, 1, 0, 0, 1, 0, 0, 1, 1, 1, 1, 1]",364,127,237,15,21,0.11811023622047244,0.08860759493670886
"[0, 0, 1, 0, 0, 0, 1, 0, 1, 1, 1, 0, 0, 0, 0]",294,191,103,16,10,0.08376963350785341,0.0970873786407767
"[1, 1, 1, 0, 1, 0, 0, 0, 1, 1, 1, 0, 0, 0, 1]",122,60,62,8,6,0.13333333333333333,0.0967741935483871
"[0, 0, 1, 0, 0, 0, 1, 0, 0, 0, 0, 1, 0, 0, 1]",486,348,138,30,13,0.08620689655172414,0.09420289855072464
"[1, 0, 1, 0, 0, 1, 1, 1, 1, 1, 0, 0, 1, 0, 0]",117,56,61,4,5,0.07142857142857142,0.08196721311475409
"[0, 1, 1, 0, 1, 0, 1, 0, 0, 1, 1, 1, 1, 1, 0]",143,67,76,6,6,0.08955223880597014,0.07894736842105263
"[1, 0, 0, 1, 1, 0, 1, 0, 1, 0, 0, 1, 1, 1, 1]",265,109,156,9,16,0.08256880733944955,0.10256410256410256
"[0, 1, 1, 0, 0, 1, 1, 0, 0, 0, 1, 1, 1, 1, 1]",350,189,161,17,6,0.08994708994708994,0.037267080745341616
"[0, 0, 0, 1, 1, 1, 0, 1, 1, 0, 0, 1, 1, 0, 0]",217,125,92,13,10,0.104,0.10869565217391304
"[0, 1, 1, 1, 0, 0, 0, 1, 1, 0, 0, 0, 0, 1, 0]",155,92,63,7,8,0.07608695652173914,0.12698412698412698
"[0, 0, 1, 0, 1, 0, 0, 0, 0, 1, 1, 1, 0, 0, 0]",286,189,97,18,9,0.09523809523809523,0.09278350515463918
"[0, 0, 1, 1, 1, 0, 0, 1, 0, 1, 0, 0, 0, 0, 1]",148,81,67,7,7,0.08641975308641975,0.1044776119402985
"[1, 0, 0, 1, 0, 0, 0, 1, 1, 1, 0, 0, 1, 0, 1]",129,63,66,9,8,0.14285714285714285,0.12121212121212122
"[1, 1, 0, 0, 0, 1, 1, 0, 1, 0, 1, 0, 0, 0, 0]",181,114,67,10,8,0.08771929824561403,0.11940298507462686
"[1, 0, 0, 0, 0, 1, 1, 1, 0, 1, 1, 1, 0, 1, 1]",176,56,120,6,9,0.10714285714285714,0.075
"[1, 1, 0, 1, 1, 1, 0, 1, 1, 0, 0, 1, 1, 0, 0]",251,84,167,8,17,0.09523809523809523,0.10179640718562874
"[0, 1, 1, 0, 0, 0, 1, 1, 0, 1, 1, 1, 0, 1, 1]",152,75,77,7,6,0.09333333333333334,0.07792207792207792
"[1, 1, 1, 1, 0, 0, 0, 1, 1, 0, 1, 0, 1, 1, 1]",332,121,211,12,17,0.09917355371900827,0.08056872037914692
"[0, 0, 0, 1, 0, 1, 0, 0, 1, 1, 0, 1, 1, 1, 0]",97,50,47,3,6,0.06,0.1276595744680851
"[1, 1, 0, 0, 0, 1, 0, 1, 0, 0, 1, 1, 0, 1, 1]",135,66,69,6,4,0.09090909090909091,0.057971014492753624
"[0, 1, 1, 1, 0, 0, 0, 1, 1, 0, 1, 1, 1, 1, 1]",318,135,183,10,17,0.07407407407407407,0.09289617486338798
"[1, 0, 1, 1, 1, 0, 0, 0, 1, 1, 0, 1, 1, 1, 1]",268,83,185,7,15,0.08433734939759036,0.08108108108108109
"[0, 1, 0, 0, 1, 1, 1, 0, 1, 1, 1, 1, 1, 0, 0]",187,75,112,10,8,0.13333333333333333,0.07142857142857142
"[0, 0, 1, 1, 0, 1, 0, 1, 1, 1, 1, 1, 0, 0, 1]",193,88,105,7,13,0.07954545454545454,0.12380952380952381
"[1, 0, 1, 0, 0, 1, 0, 0, 0, 0, 1, 0, 0, 0, 1]",242,165,77,16,4,0.09696969696969697,0.05194805194805195
"[1, 0, 0, 1, 1, 0, 1, 0, 1, 1, 0, 1, 0, 0, 0]",121,59,62,6,7,0.1016949152542373,0.11290322580645161
"[1, 0, 1, 0, 0, 0, 1, 0, 0, 0, 0, 1, 0, 0, 1]",185,126,59,14,4,0.1111111111111111,0.06779661016949153
"[1, 0, 0, 1, 1, 1, 0, 1, 0, 0, 1, 0, 1, 1, 1]",187,74,113,10,6,0.13513513513513514,0.05309734513274336
"[0, 0, 1, 1, 1, 0, 0, 0, 0, 0, 0, 1, 0, 1, 0]",255,163,92,13,7,0.07975460122699386,0.07608695652173914
"[0, 0, 0, 1, 1, 1, 0, 0, 0, 0, 0, 0, 1, 0, 1]",290,199,91,24,7,0.12060301507537688,0.07692307692307693
"[0, 0, 0, 1, 1, 1, 1, 1, 1, 0, 0, 1, 1, 1, 0]",447,307,140,22,18,0.07166123778501629,0.12857142857142856
"[1, 1, 0, 1, 1, 0, 0, 1, 1, 0, 1, 0, 1, 1, 1]",293,107,186,6,12,0.056074766355140186,0.06451612903225806
"[0, 0, 0, 1, 0, 0, 0, 0, 0, 0, 1, 1, 0, 1, 0]",545,392,153,36,19,0.09183673469387756,0.12418300653594772
"[0, 1, 1, 0, 0, 0, 0, 1, 0, 0, 1, 0, 0, 1, 1]",245,175,70,21,4,0.12,0.05714285714285714
"[0, 1, 0, 0, 0, 1, 1, 0, 0, 0, 0, 1, 0, 0, 1]",259,162,97,15,9,0.09259259259259259,0.09278350515463918
"[0, 1, 0, 0, 1, 1, 1, 0, 1, 1, 1, 0, 1, 0, 1]",103,38,65,6,7,0.15789473684210525,0.1076923076923077
"[1, 1, 0, 1, 0, 0, 1, 0, 0, 1, 1, 1, 1, 1, 1]",400,143,257,16,17,0.11188811188811189,0.06614785992217899
"[1, 0, 0, 0, 1, 1, 1, 1, 0, 1, 0, 0, 1, 0, 0]",123,67,56,6,2,0.08955223880597014,0.03571428571428571
"[1, 1, 0, 1, 1, 1, 0, 0, 0, 1, 1, 1, 1, 0, 1]",257,94,163,9,21,0.09574468085106383,0.12883435582822086
"[1, 0, 0, 1, 1, 1, 0, 0, 1, 0, 1, 0, 1, 1, 0]",107,39,68,4,6,0.10256410256410256,0.08823529411764706
"[0, 0, 0, 0, 0, 1, 0, 1, 1, 1, 1, 1, 1, 1, 1]",395,204,191,13,22,0.06372549019607843,0.11518324607329843
"[1, 0, 0, 1, 0, 0, 0, 0, 0, 0, 0, 0, 1, 1, 0]",999,679,320,67,28,0.09867452135493372,0.0875
"[0, 0, 1, 1, 0, 1, 1, 1, 1, 1, 1, 0, 0, 0, 0]",316,166,150,11,10,0.06626506024096386,0.06666666666666667
"[0, 1, 0, 0, 1, 0, 1, 0, 0, 1, 0, 1, 0, 0, 1]",129,80,49,8,0,0.1,0.0
"[0, 0, 0, 0, 1, 0, 1, 0, 0, 1, 1, 0, 0, 1, 1]",313,173,140,24,14,0.13872832369942195,0.1
"[1, 1, 0, 1, 0, 1, 1, 0, 0, 0, 0, 1, 1, 0, 1]",129,65,64,9,5,0.13846153846153847,0.078125
"[0, 1, 0, 0, 0, 0, 0, 1, 1, 0, 0, 1, 1, 0, 1]",189,102,87,12,4,0.11764705882352941,0.04597701149425287
"[1, 1, 1, 1, 1, 1, 1, 1, 0, 0, 1, 0, 0, 1, 1]",1061,332,729,30,71,0.09036144578313253,0.09739368998628258
"[0, 0, 1, 0, 1, 1, 1, 1, 1, 1, 1, 0, 1, 1, 1]",580,191,389,10,31,0.05235602094240838,0.07969151670951156
"[1, 1, 0, 1, 0, 1, 1, 0, 1, 0, 0, 1, 0, 1, 1]",141,71,70,5,8,0.07042253521126761,0.11428571428571428
"[0, 0, 1, 0, 1, 1, 1, 1, 1, 1, 1, 1, 0, 1, 0]",269,103,166,9,13,0.08737864077669903,0.0783132530120482
"[1, 1, 0, 1, 0, 1, 1, 0, 0, 1, 1, 0, 1, 1, 1]",251,80,171,11,10,0.1375,0.05847953216374269
"[1, 1, 1, 0, 1, 0, 1, 1, 0, 0, 1, 0, 0, 0, 1]",124,57,67,6,3,0.10526315789473684,0.04477611940298507
"[1, 1, 1, 1, 1, 1, 0, 1, 1, 0, 0, 1, 1, 1, 0]",590,177,413,13,43,0.07344632768361582,0.10411622276029056
"[1, 0, 0, 1, 1, 0, 1, 1, 1, 1, 1, 1, 1, 1, 0]",721,196,525,12,41,0.061224489795918366,0.07809523809523809
"[1, 0, 0, 1, 0, 0, 1, 1, 0, 0, 1, 0, 0, 1, 1]",128,63,65,8,3,0.12698412698412698,0.046153846153846156
"[0, 0, 1, 0, 1, 0, 0, 1, 0, 1, 0, 0, 0, 0, 1]",211,136,75,4,6,0.029411764705882353,0.08
"[1, 0, 1, 1, 0, 0, 0, 0, 0, 0, 0, 0, 1, 1, 0]",700,430,270,50,33,0.11627906976744186,0.12222222222222222
"[0, 1, 0, 0, 1, 0, 0, 0, 1, 1, 0, 1, 1, 0, 1]",103,54,49,4,5,0.07407407407407407,0.10204081632653061
"[0, 0, 1, 0, 1, 0, 1, 0, 0, 1, 0, 0, 0, 1, 1]",165,104,61,7,5,0.0673076923076923,0.08196721311475409
"[0, 1, 1, 1, 1, 1, 1, 0, 1, 1, 1, 1, 0, 0, 0]",384,154,230,15,20,0.09740259740259741,0.08695652173913043
"[0, 0, 1, 1, 1, 1, 1, 1, 0, 1, 1, 1, 1, 0, 0]",433,157,276,16,31,0.10191082802547771,0.11231884057971014
"[1, 0, 0, 1, 1, 0, 1, 1, 1, 0, 1, 1, 1, 0, 0]",183,69,114,13,15,0.18840579710144928,0.13157894736842105
"[0, 0, 1, 0, 0, 0, 0, 1, 1, 0, 1, 1, 1, 1, 1]",165,81,84,7,12,0.08641975308641975,0.14285714285714285
"[0, 1, 0, 0, 1, 0, 0, 0, 0, 1, 1, 0, 1, 1, 1]",148,85,63,5,5,0.058823529411764705,0.07936507936507936
"[0, 1, 0, 0, 1, 1, 1, 0, 0, 0, 1, 0, 1, 1, 1]",145,68,77,5,6,0.07352941176470588,0.07792207792207792
"[0, 1, 1, 1, 0, 1, 0, 0, 1, 1, 1, 0, 0, 0, 1]",111,57,54,7,7,0.12280701754385964,0.12962962962962962
"[0, 1, 0, 0, 0, 1, 1, 0, 1, 1, 0, 1, 0, 1, 1]",107,47,60,6,3,0.1276595744680851,0.05
"[0, 0, 0, 1, 0, 0, 0, 1, 1, 0, 1, 1, 0, 1, 0]",129,75,54,9,3,0.12,0.05555555555555555
"[1, 1, 1, 1, 0, 1, 1, 0, 1, 0, 0, 1, 1, 0, 0]",194,79,115,7,14,0.08860759493670886,0.12173913043478261
"[1, 1, 1, 1, 1, 0, 1, 0, 0, 1, 1, 0, 0, 1, 1]",482,159,323,10,22,0.06289308176100629,0.06811145510835913
"[0, 1, 0, 0, 0, 1, 0, 0, 0, 1, 0, 1, 0, 1, 1]",165,92,73,10,8,0.10869565217391304,0.1095890410958904
"[0, 1, 0, 1, 1, 0, 1, 0, 1, 0, 0, 0, 1, 0, 0]",141,91,50,8,6,0.08791208791208792,0.12
"[0, 1, 1, 1, 1, 0, 0, 0, 1, 0, 0, 0, 0, 0, 0]",413,296,117,37,15,0.125,0.1282051282051282
"[0, 1, 0, 0, 0, 1, 0, 0, 0, 0, 1, 1, 0, 1, 0]",232,157,75,15,2,0.09554140127388536,0.02666666666666667
"[1, 1, 0, 0, 1, 1, 0, 1, 0, 0, 0, 1, 1, 1, 1]",245,102,143,12,10,0.11764705882352941,0.06993006993006994
"[1, 1, 0, 1, 0, 0, 1, 1, 0, 1, 1, 0, 1, 0, 1]",142,53,89,5,14,0.09433962264150944,0.15730337078651685
"[0, 1, 1, 0, 0, 0, 1, 0, 1, 0, 1, 0, 1, 0, 0]",142,87,55,8,7,0.09195402298850575,0.12727272727272726
"[0, 0, 0, 0, 0, 1, 1, 0, 0, 0, 1, 0, 1, 0, 1]",320,208,112,11,11,0.052884615384615384,0.09821428571428571
"[1, 1, 0, 1, 0, 0, 1, 1, 1, 0, 0, 0, 0, 1, 0]",93,52,41,2,6,0.038461538461538464,0.14634146341463414
"[0, 1, 1, 0, 1, 0, 0, 1, 1, 1, 0, 0, 0, 0, 1]",145,87,58,7,6,0.08045977011494253,0.10344827586206896
"[0, 1, 1, 1, 1, 1, 0, 0, 0, 0, 0, 0, 1, 1, 0]",425,233,192,27,17,0.11587982832618025,0.08854166666666667
"[1, 1, 0, 0, 0, 0, 1, 0, 0, 0, 1, 1, 1, 1, 1]",288,136,152,15,11,0.11029411764705882,0.07236842105263158
"[0, 1, 1, 1, 1, 0, 0, 1, 0, 0, 1, 0, 0, 1, 0]",121,71,50,7,5,0.09859154929577464,0.1
"[0, 0, 1, 0, 0, 0, 0, 1, 0, 0, 1, 0, 1, 0, 1]",216,139,77,15,4,0.1079136690647482,0.05194805194805195
"[1, 0, 0, 0, 1, 0, 1, 0, 1, 1, 0, 0, 1, 1, 1]",168,77,91,7,4,0.09090909090909091,0.04395604395604396
"[1, 0, 1, 0, 0, 1, 1, 1, 0, 0, 0, 0, 0, 0, 1]",254,139,115,11,11,0.07913669064748201,0.09565217391304348
"[0, 0, 1, 1, 0, 0, 1, 0, 1, 1, 1, 1, 0, 0, 0]",181,99,82,9,8,0.09090909090909091,0.0975609756097561
"[1, 0, 0, 1, 0, 1, 1, 1, 1, 1, 0, 0, 1, 0, 1]",135,52,83,5,8,0.09615384615384616,0.0963855421686747
"[0, 1, 1, 1, 0, 1, 1, 1, 0, 1, 1, 1, 1, 0, 1]",516,161,355,13,30,0.08074534161490683,0.08450704225352113
"[1, 1, 1, 1, 0, 0, 1, 1, 1, 0, 0, 0, 1, 0, 1]",186,77,109,9,4,0.11688311688311688,0.03669724770642202
"[1, 1, 1, 1, 1, 1, 0, 0, 1, 1, 1, 0, 0, 0, 1]",398,154,244,16,20,0.1038961038961039,0.08196721311475409
"[1, 0, 0, 0, 1, 0, 1, 1, 1, 1, 1, 1, 0, 1, 1]",258,70,188,3,19,0.04285714285714286,0.10106382978723404
"[1, 0, 0, 1, 1, 1, 1, 1, 1, 1, 0, 0, 0, 1, 0]",216,86,130,9,12,0.10465116279069768,0.09230769230769231
"[1, 1, 0, 0, 0, 1, 1, 0, 1, 0, 1, 1, 1, 1, 1]",335,117,218,12,20,0.10256410256410256,0.09174311926605505
"[0, 1, 1, 0, 0, 1, 0, 0, 1, 1, 1, 1, 0, 1, 1]",177,92,85,7,12,0.07608695652173914,0.1411764705882353
"[0, 1, 0, 0, 0, 1, 1, 1, 1, 0, 1, 1, 1, 1, 1]",332,124,208,10,15,0.08064516129032258,0.07211538461538461
"[1, 0, 1, 0, 0, 0, 1, 1, 1, 1, 0, 1, 1, 1, 1]",297,121,176,7,11,0.05785123966942149,0.0625
"[1, 0, 1, 1, 1, 1, 0, 1, 0, 0, 0, 1, 1, 1, 1]",334,116,218,9,22,0.07758620689655173,0.10091743119266056
"[1, 1, 1, 1, 1, 1, 1, 1, 0, 0, 0, 1, 1, 0, 1]",863,263,600,26,58,0.09885931558935361,0.09666666666666666
"[1, 1, 0, 1, 1, 1, 1, 1, 1, 1, 0, 1, 0, 0, 0]",270,95,175,7,19,0.07368421052631578,0.10857142857142857
"[1, 1, 1, 1, 1, 1, 0, 0, 1, 0, 1, 0, 0, 1, 1]",402,132,270,13,24,0.09848484848484848,0.08888888888888889
"[1, 1, 1, 0, 1, 1, 1, 1, 0, 1, 0, 0, 0, 0, 1]",174,65,109,9,12,0.13846153846153847,0.11009174311926606
"[1, 1, 0, 0, 0, 0, 1, 0, 1, 0, 0, 0, 1, 1, 0]",200,119,81,13,11,0.1092436974789916,0.13580246913580246
"[0, 0, 0, 1, 0, 1, 1, 1, 1, 0, 0, 1, 1, 0, 0]",305,176,129,20,9,0.11363636363636363,0.06976744186046512
"[1, 0, 0, 1, 0, 1, 0, 0, 1, 0, 1, 1, 0, 1, 1]",129,60,69,4,10,0.06666666666666667,0.14492753623188406
"[0, 1, 1, 0, 0, 1, 1, 1, 1, 1, 0, 0, 1, 1, 1]",631,331,300,24,17,0.07250755287009064,0.056666666666666664
"[0, 0, 1, 1, 0, 1, 1, 0, 0, 0, 0, 0, 1, 1, 1]",236,133,103,9,11,0.06766917293233082,0.10679611650485436
"[1, 0, 1, 1, 1, 1, 0, 0, 0, 1, 1, 1, 0, 1, 1]",252,97,155,8,22,0.08247422680412371,0.14193548387096774
"[1, 1, 1, 1, 1, 0, 0, 0, 1, 0, 0, 0, 0, 0, 0]",249,113,136,9,12,0.07964601769911504,0.08823529411764706
"[1, 0, 0, 0, 0, 0, 1, 1, 0, 0, 0, 1, 0, 0, 1]",285,178,107,24,7,0.1348314606741573,0.06542056074766354
"[1, 0, 1, 1, 1, 1, 0, 0, 1, 1, 0, 1, 1, 1, 1]",657,193,464,20,43,0.10362694300518134,0.09267241379310345
"[0, 0, 1, 1, 0, 1, 0, 1, 1, 0, 0, 1, 0, 0, 0]",142,89,53,10,6,0.11235955056179775,0.11320754716981132
"[1, 1, 0, 1, 1, 1, 0, 1, 1, 1, 1, 0, 0, 0, 1]",270,91,179,11,17,0.12087912087912088,0.09497206703910614
"[0, 0, 0, 1, 1, 0, 1, 1, 1, 0, 1, 1, 1, 0, 1]",143,66,77,6,9,0.09090909090909091,0.11688311688311688
"[1, 1, 0, 1, 0, 1, 0, 1, 1, 0, 1, 0, 1, 1, 1]",279,85,194,7,15,0.08235294117647059,0.07731958762886598
"[0, 1, 1, 1, 1, 0, 1, 0, 1, 0, 1, 1, 0, 1, 0]",136,57,79,1,6,0.017543859649122806,0.0759493670886076
"[0, 0, 1, 0, 0, 0, 0, 1, 1, 0, 0, 0, 1, 0, 0]",537,377,160,37,14,0.09814323607427056,0.0875
"[1, 1, 1, 1, 1, 0, 0, 1, 0, 1, 0, 1, 1, 1, 0]",273,95,178,10,22,0.10526315789473684,0.12359550561797752
"[1, 0, 1, 1, 0, 1, 0, 0, 0, 1, 0, 1, 1, 1, 1]",136,71,65,11,7,0.15492957746478872,0.1076923076923077
"[1, 0, 1, 1, 0, 1, 0, 1, 0, 1, 1, 0, 1, 0, 0]",107,47,60,3,2,0.06382978723404255,0.03333333333333333
"[0, 0, 1, 0, 1, 1, 1, 0, 0, 0, 1, 1, 1, 1, 1]",229,103,126,12,13,0.11650485436893204,0.10317460317460317
"[1, 0, 0, 1, 0, 1, 0, 0, 1, 0, 1, 1, 1, 0, 0]",121,61,60,9,7,0.14754098360655737,0.11666666666666667
"[1, 1, 1, 1, 1, 1, 0, 1, 1, 0, 0, 0, 0, 0, 1]",229,83,146,12,17,0.14457831325301204,0.11643835616438356
"[1, 0, 1, 1, 0, 0, 1, 0, 0, 1, 0, 1, 0, 1, 1]",118,47,71,6,8,0.1276595744680851,0.11267605633802817
"[0, 1, 0, 1, 0, 0, 0, 1, 1, 0, 0, 0, 1, 0, 0]",218,136,82,16,5,0.11764705882352941,0.06097560975609756
"[0, 0, 1, 0, 0, 0, 1, 0, 0, 0, 0, 1, 0, 1, 0]",527,370,157,43,12,0.11621621621621622,0.07643312101910828
"[1, 1, 1, 1, 1, 0, 0, 1, 0, 0, 0, 0, 1, 0, 0]",112,48,64,4,4,0.08333333333333333,0.0625
"[1, 0, 1, 0, 0, 0, 1, 1, 1, 1, 0, 0, 0, 1, 0]",114,61,53,4,6,0.06557377049180328,0.11320754716981132
"[1, 1, 1, 0, 1, 0, 1, 0, 0, 1, 1, 1, 1, 0, 1]",247,99,148,10,16,0.10101010101010101,0.10810810810810811
"[1, 1, 1, 0, 0, 1, 1, 0, 0, 1, 1, 1, 0, 1, 0]",271,75,196,4,21,0.05333333333333334,0.10714285714285714
"[1, 1, 1, 1, 0, 1, 1, 1, 1, 0, 1, 0, 1, 0, 1]",509,144,365,18,29,0.125,0.07945205479452055
"[1, 0, 1, 0, 0, 0, 0, 1, 1, 1, 1, 0, 1, 1, 1]",187,83,104,8,10,0.0963855421686747,0.09615384615384616
"[0, 0, 0, 1, 0, 1, 0, 0, 1, 1, 1, 0, 1, 1, 0]",111,63,48,5,5,0.07936507936507936,0.10416666666666667
"[0, 1, 1, 0, 1, 1, 0, 0, 0, 1, 0, 0, 1, 0, 0]",149,87,62,12,4,0.13793103448275862,0.06451612903225806
"[1, 1, 1, 0, 0, 0, 1, 0, 1, 0, 0, 0, 1, 0, 0]",149,78,71,5,2,0.0641025641025641,0.028169014084507043
"[1, 1, 1, 1, 1, 0, 0, 1, 1, 0, 1, 0, 0, 0, 1]",195,67,128,2,9,0.029850746268656716,0.0703125
"[0, 0, 0, 0, 1, 0, 1, 1, 1, 1, 1, 0, 0, 1, 1]",244,146,98,11,8,0.07534246575342465,0.08163265306122448
"[0, 0, 0, 0, 0, 1, 0, 0, 1, 1, 1, 1, 1, 0, 1]",133,73,60,7,7,0.0958904109589041,0.11666666666666667
"[1, 0, 1, 0, 0, 0, 0, 0, 1, 0, 0, 1, 1, 1, 1]",197,107,90,12,7,0.11214953271028037,0.07777777777777778
"[0, 0, 0, 0, 1, 0, 0, 0, 1, 1, 0, 1, 0, 1, 1]",150,97,53,16,4,0.16494845360824742,0.07547169811320754
"[0, 0, 1, 1, 1, 1, 0, 1, 0, 1, 0, 0, 1, 1, 0]",150,70,80,4,9,0.05714285714285714,0.1125
"[1, 0, 0, 1, 0, 0, 1, 0, 0, 0, 0, 1, 1, 0, 0]",334,197,137,27,13,0.13705583756345177,0.0948905109489051
"[1, 1, 1, 0, 1, 1, 0, 0, 0, 1, 0, 0, 0, 0, 0]",161,103,58,7,0,0.06796116504854369,0.0
"[1, 0, 1, 1, 1, 0, 1, 1, 0, 0, 0, 1, 0, 0, 0]",100,53,47,5,6,0.09433962264150944,0.1276595744680851
"[1, 1, 0, 0, 1, 1, 1, 1, 0, 1, 0, 1, 0, 1, 0]",185,79,106,9,10,0.11392405063291139,0.09433962264150944
"[1, 0, 0, 1, 0, 0, 0, 0, 0, 1, 1, 1, 1, 1, 1]",369,186,183,11,19,0.05913978494623656,0.10382513661202186
"[0, 1, 0, 0, 1, 0, 0, 0, 0, 0, 1, 1, 1, 1, 1]",288,170,118,17,13,0.1,0.11016949152542373
"[1, 0, 1, 1, 0, 1, 0, 1, 0, 1, 0, 0, 1, 1, 0]",118,56,62,5,6,0.08928571428571429,0.0967741935483871
"[0, 1, 0, 1, 1, 1, 0, 1, 0, 1, 1, 0, 1, 0, 1]",124,51,73,5,10,0.09803921568627451,0.136986301369863
"[1, 0, 0, 1, 0, 0, 1, 0, 0, 1, 0, 1, 1, 1, 0]",102,53,49,6,5,0.11320754716981132,0.10204081632653061
"[0, 0, 0, 1, 0, 0, 1, 1, 1, 1, 1, 0, 0, 0, 1]",149,92,57,13,9,0.14130434782608695,0.15789473684210525
"[1, 1, 0, 1, 1, 0, 1, 1, 0, 0, 1, 1, 0, 0, 0]",229,101,128,6,9,0.0594059405940594,0.0703125
"[1, 0, 0, 0, 0, 0, 0, 0, 1, 0, 0, 1, 1, 1, 0]",251,154,97,17,11,0.11038961038961038,0.1134020618556701
"[0, 0, 0, 1, 1, 0, 1, 0, 0, 0, 0, 0, 0, 0, 1]",671,497,174,50,17,0.1006036217303823,0.09770114942528736
"[1, 1, 0, 1, 1, 0, 0, 0, 1, 1, 0, 1, 0, 0, 0]",117,67,50,6,5,0.08955223880597014,0.1
"[0, 1, 0, 1, 1, 1, 1, 1, 1, 0, 1, 0, 0, 0, 0]",151,68,83,7,8,0.10294117647058823,0.0963855421686747
"[0, 0, 1, 1, 0, 1, 0, 1, 1, 1, 1, 1, 1, 0, 1]",278,81,197,6,24,0.07407407407407407,0.1218274111675127
"[0, 1, 1, 0, 0, 1, 0, 0, 1, 1, 1, 0, 0, 1, 1]",170,87,83,6,8,0.06896551724137931,0.0963855421686747
"[1, 0, 1, 0, 1, 0, 1, 0, 0, 1, 0, 0, 0, 0, 0]",257,164,93,14,13,0.08536585365853659,0.13978494623655913
"[1, 0, 1, 1, 0, 1, 0, 1, 0, 1, 0, 1, 0, 1, 1]",127,64,63,8,4,0.125,0.06349206349206349
"[0, 0, 1, 1, 1, 0, 0, 1, 1, 0, 1, 1, 0, 1, 0]",115,57,58,6,6,0.10526315789473684,0.10344827586206896
"[0, 1, 0, 1, 1, 1, 0, 1, 0, 0, 1, 1, 1, 0, 1]",141,61,80,7,8,0.11475409836065574,0.1
"[1, 1, 0, 0, 0, 1, 0, 0, 1, 1, 0, 0, 0, 0, 0]",428,274,154,25,15,0.09124087591240876,0.09740259740259741
"[0, 1, 1, 1, 0, 0, 0, 0, 1, 0, 1, 1, 0, 0, 0]",179,112,67,7,5,0.0625,0.07462686567164178
"[1, 0, 0, 1, 0, 0, 0, 1, 0, 0, 0, 1, 1, 1, 0]",137,92,45,5,4,0.05434782608695652,0.08888888888888889
"[1, 0, 1, 0, 0, 1, 0, 0, 0, 0, 0, 1, 0, 0, 0]",530,370,160,23,21,0.062162162162162166,0.13125
"[1, 1, 1, 0, 1, 0, 0, 1, 0, 0, 0, 0, 0, 1, 0]",138,83,55,9,5,0.10843373493975904,0.09090909090909091
"[1, 0, 0, 0, 0, 1, 1, 1, 1, 0, 1, 0, 1, 1, 1]",313,77,236,6,22,0.07792207792207792,0.09322033898305085
"[1, 1, 1, 0, 0, 0, 0, 1, 1, 1, 1, 0, 1, 0, 1]",299,70,229,4,20,0.05714285714285714,0.08733624454148471
"[1, 0, 1, 1, 0, 0, 1, 0, 0, 1, 0, 1, 1, 1, 0]",93,51,42,2,2,0.0392156862745098,0.047619047619047616
"[1, 1, 1, 1, 1, 1, 1, 0, 0, 1, 0, 1, 1, 0, 0]",373,117,256,12,23,0.10256410256410256,0.08984375
"[1, 1, 0, 0, 1, 1, 0, 1, 0, 1, 1, 1, 0, 1, 0]",143,73,70,7,6,0.0958904109589041,0.08571428571428572
"[1, 1, 0, 0, 1, 0, 0, 1, 1, 0, 1, 1, 1, 0, 1]",144,65,79,12,10,0.18461538461538463,0.12658227848101267
"[1, 0, 0, 1, 0, 1, 0, 0, 1, 1, 0, 0, 0, 1, 1]",135,71,64,7,3,0.09859154929577464,0.046875
"[1, 1, 1, 1, 0, 0, 0, 1, 1, 0, 0, 1, 0, 1, 0]",119,51,68,2,4,0.0392156862745098,0.058823529411764705
"[1, 1, 0, 0, 0, 0, 1, 0, 0, 0, 1, 1, 0, 1, 0]",149,84,65,9,13,0.10714285714285714,0.2
"[0, 0, 0, 1, 1, 0, 0, 0, 0, 1, 0, 0, 0, 1, 1]",523,399,124,35,10,0.08771929824561403,0.08064516129032258
"[0, 1, 1, 1, 0, 1, 0, 0, 1, 1, 1, 1, 0, 0, 1]",255,105,150,12,13,0.11428571428571428,0.08666666666666667
"[0, 0, 1, 0, 0, 0, 1, 1, 1, 1, 0, 1, 1, 0, 1]",112,63,49,3,7,0.047619047619047616,0.14285714285714285
"[0, 0, 1, 0, 1, 0, 1, 0, 0, 1, 0, 1, 1, 0, 0]",164,90,74,6,5,0.06666666666666667,0.06756756756756757
"[1, 0, 0, 0, 0, 0, 0, 0, 1, 0, 1, 0, 1, 0, 0]",545,358,187,40,14,0.11173184357541899,0.0748663101604278
"[0, 0, 0, 1, 0, 0, 0, 1, 1, 0, 1, 1, 0, 0, 0]",273,175,98,19,11,0.10857142857142857,0.11224489795918367
"[0, 0, 0, 0, 1, 1, 0, 0, 1, 0, 0, 1, 1, 1, 1]",367,208,159,25,15,0.1201923076923077,0.09433962264150944
"[1, 0, 1, 1, 0, 1, 0, 0, 0, 1, 1, 0, 1, 1, 1]",169,70,99,3,11,0.04285714285714286,0.1111111111111111
"[0, 1, 1, 1, 0, 1, 0, 0, 0, 0, 1, 0, 0, 1, 1]",126,77,49,14,4,0.18181818181818182,0.08163265306122448
"[1, 0, 1, 1, 0, 1, 1, 0, 1, 0, 1, 1, 0, 0, 1]",138,52,86,1,11,0.019230769230769232,0.12790697674418605
"[1, 0, 0, 1, 0, 0, 1, 0, 0, 0, 1, 0, 1, 0, 1]",138,73,65,10,4,0.136986301369863,0.06153846153846154
"[0, 0, 0, 0, 1, 1, 1, 1, 1, 0, 0, 1, 1, 1, 0]",152,76,76,8,7,0.10526315789473684,0.09210526315789473
"[1, 0, 1, 0, 1, 1, 1, 0, 0, 1, 0, 1, 0, 1, 1]",142,57,85,3,9,0.05263157894736842,0.10588235294117647
"[1, 1, 0, 0, 0, 0, 1, 0, 1, 0, 0, 0, 0, 1, 0]",230,151,79,14,10,0.09271523178807947,0.12658227848101267
"[0, 0, 1, 0, 1, 0, 1, 1, 0, 1, 0, 0, 1, 1, 0]",113,57,56,5,7,0.08771929824561403,0.125
"[0, 0, 0, 0, 1, 0, 0, 0, 0, 1, 0, 0, 1, 0, 0]",1514,1154,360,115,33,0.09965337954939342,0.09166666666666666
"[1, 1, 1, 1, 1, 0, 0, 0, 1, 1, 1, 0, 0, 1, 1]",418,133,285,10,29,0.07518796992481203,0.10175438596491228
"[0, 0, 0, 0, 1, 0, 1, 0, 0, 0, 1, 0, 0, 0, 1]",552,390,162,28,18,0.07179487179487179,0.1111111111111111
"[0, 1, 0, 1, 0, 0, 1, 0, 0, 0, 1, 1, 1, 1, 0]",137,79,58,3,8,0.0379746835443038,0.13793103448275862
"[1, 1, 1, 1, 1, 0, 0, 0, 0, 1, 0, 1, 1, 1, 0]",208,70,138,6,11,0.08571428571428572,0.07971014492753623
"[1, 1, 0, 0, 0, 1, 0, 0, 0, 0, 0, 0, 0, 1, 1]",537,358,179,36,20,0.1005586592178771,0.11173184357541899
"[0, 0, 0, 0, 1, 0, 0, 0, 1, 1, 1, 1, 0, 1, 1]",157,84,73,6,3,0.07142857142857142,0.0410958904109589
"[1, 0, 0, 0, 0, 1, 0, 0, 0, 1, 1, 1, 1, 0, 1]",125,67,58,5,6,0.07462686567164178,0.10344827586206896
"[0, 0, 1, 1, 1, 1, 1, 0, 0, 0, 0, 0, 1, 1, 1]",281,139,142,15,11,0.1079136690647482,0.07746478873239436
"[0, 1, 0, 1, 0, 1, 1, 0, 0, 0, 0, 1, 1, 0, 1]",127,65,62,4,7,0.06153846153846154,0.11290322580645161
"[1, 1, 0, 1, 0, 1, 0, 1, 1, 0, 0, 0, 0, 1, 1]",199,96,103,10,5,0.10416666666666667,0.04854368932038835
"[0, 1, 0, 1, 0, 0, 1, 1, 1, 0, 0, 0, 0, 1, 1]",209,107,102,6,9,0.056074766355140186,0.08823529411764706
"[1, 0, 0, 1, 1, 1, 1, 0, 1, 1, 1, 0, 0, 1, 1]",375,101,274,6,23,0.0594059405940594,0.08394160583941605
"[0, 1, 0, 0, 0, 1, 0, 0, 1, 1, 1, 1, 0, 1, 1]",145,62,83,5,8,0.08064516129032258,0.0963855421686747
"[1, 0, 1, 1, 1, 0, 1, 0, 1, 0, 0, 0, 1, 0, 0]",109,54,55,6,12,0.1111111111111111,0.21818181818181817
"[1, 1, 1, 0, 1, 0, 1, 1, 0, 1, 1, 1, 0, 0, 1]",235,79,156,5,12,0.06329113924050633,0.07692307692307693
"[1, 0, 0, 0, 0, 1, 0, 1, 1, 1, 0, 0, 0, 0, 0]",340,188,152,13,14,0.06914893617021277,0.09210526315789473
"[1, 0, 1, 1, 0, 0, 0, 0, 0, 0, 1, 1, 1, 0, 1]",142,79,63,7,4,0.08860759493670886,0.06349206349206349
"[1, 1, 0, 1, 0, 1, 0, 1, 1, 0, 1, 1, 0, 1, 1]",209,78,131,3,21,0.038461538461538464,0.16030534351145037
"[1, 1, 0, 1, 1, 1, 0, 1, 0, 0, 0, 1, 1, 1, 1]",318,125,193,17,17,0.136,0.08808290155440414
"[1, 0, 0, 0, 0, 1, 1, 1, 1, 1, 0, 1, 1, 0, 1]",230,68,162,11,13,0.16176470588235295,0.08024691358024691
"[0, 0, 0, 0, 0, 1, 1, 0, 1, 1, 0, 1, 0, 0, 0]",291,201,90,16,3,0.07960199004975124,0.03333333333333333
"[1, 0, 0, 0, 0, 1, 1, 1, 0, 1, 1, 0, 1, 0, 1]",125,46,79,3,9,0.06521739130434782,0.11392405063291139
"[0, 1, 1, 1, 0, 1, 1, 0, 1, 1, 1, 1, 1, 0, 0]",342,130,212,18,16,0.13846153846153847,0.07547169811320754
"[0, 0, 0, 0, 1, 0, 0, 0, 0, 1, 1, 1, 1, 1, 1]",439,274,165,21,21,0.07664233576642336,0.12727272727272726
"[1, 0, 0, 1, 1, 0, 0, 1, 0, 0, 0, 0, 1, 1, 1]",254,102,152,12,12,0.11764705882352941,0.07894736842105263
"[1, 1, 0, 0, 1, 1, 1, 1, 1, 0, 0, 0, 0, 0, 0]",425,211,214,26,22,0.12322274881516587,0.102803738317757
"[0, 0, 1, 1, 0, 1, 0, 1, 1, 0, 0, 1, 1, 0, 0]",200,105,95,10,9,0.09523809523809523,0.09473684210526316
"[0, 1, 0, 1, 0, 1, 0, 0, 1, 1, 0, 1, 1, 1, 1]",151,73,78,9,12,0.1232876712328767,0.15384615384615385
"[0, 0, 1, 0, 1, 1, 0, 0, 0, 1, 1, 0, 0, 0, 0]",376,228,148,16,14,0.07017543859649122,0.0945945945945946
"[1, 0, 0, 0, 1, 0, 1, 1, 0, 0, 0, 1, 1, 0, 0]",199,112,87,9,8,0.08035714285714286,0.09195402298850575
"[0, 0, 1, 0, 1, 0, 0, 0, 0, 1, 0, 0, 1, 0, 0]",503,355,148,33,14,0.09295774647887324,0.0945945945945946
"[0, 1, 0, 0, 0, 0, 0, 0, 1, 1, 1, 1, 0, 0, 1]",522,298,224,33,14,0.11073825503355705,0.0625
"[1, 1, 0, 1, 0, 0, 0, 0, 0, 0, 1, 1, 1, 0, 1]",135,64,71,10,8,0.15625,0.11267605633802817
"[0, 0, 1, 0, 1, 1, 1, 1, 1, 0, 0, 0, 0, 1, 1]",300,148,152,14,19,0.0945945945945946,0.125
"[1, 0, 0, 1, 0, 0, 0, 0, 1, 0, 0, 0, 0, 1, 0]",521,358,163,42,26,0.11731843575418995,0.15950920245398773
"[0, 1, 0, 0, 1, 1, 1, 1, 1, 0, 1, 1, 1, 0, 0]",183,76,107,9,13,0.11842105263157894,0.12149532710280374
"[0, 1, 1, 0, 1, 1, 0, 1, 1, 0, 0, 0, 0, 1, 1]",199,107,92,11,10,0.102803738317757,0.10869565217391304
"[0, 0, 0, 0, 1, 1, 1, 0, 1, 1, 0, 1, 1, 0, 1]",138,73,65,8,5,0.1095890410958904,0.07692307692307693
"[1, 0, 0, 0, 1, 1, 0, 0, 1, 0, 1, 1, 0, 0, 1]",132,65,67,4,5,0.06153846153846154,0.07462686567164178
"[1, 0, 0, 1, 1, 1, 0, 1, 0, 0, 0, 1, 1, 0, 0]",178,83,95,8,11,0.0963855421686747,0.11578947368421053
"[0, 0, 0, 1, 1, 1, 0, 0, 0, 1, 0, 0, 0, 1, 1]",205,129,76,11,6,0.08527131782945736,0.07894736842105263
"[0, 1, 0, 1, 0, 1, 0, 0, 1, 0, 0, 0, 0, 0, 1]",263,172,91,12,7,0.06976744186046512,0.07692307692307693
"[0, 1, 0, 0, 0, 1, 0, 1, 0, 0, 1, 1, 0, 1, 1]",93,53,40,6,4,0.11320754716981132,0.1
"[1, 1, 1, 0, 0, 0, 1, 1, 1, 1, 1, 0, 0, 1, 1]",425,135,290,12,27,0.08888888888888889,0.09310344827586207
"[1, 0, 0, 0, 0, 1, 1, 0, 1, 0, 0, 0, 0, 0, 1]",286,164,122,20,10,0.12195121951219512,0.08196721311475409
"[1, 1, 1, 1, 1, 1, 0, 0, 0, 1, 1, 1, 1, 0, 1]",705,208,497,24,57,0.11538461538461539,0.11468812877263582
"[1, 0, 1, 0, 1, 1, 0, 0, 1, 0, 1, 0, 1, 0, 0]",110,56,54,12,5,0.21428571428571427,0.09259259259259259
"[1, 0, 0, 1, 1, 0, 1, 0, 0, 1, 1, 1, 1, 1, 0]",178,69,109,6,10,0.08695652173913043,0.09174311926605505
"[0, 1, 1, 0, 0, 1, 0, 0, 1, 0, 0, 1, 1, 0, 0]",211,130,81,11,7,0.08461538461538462,0.08641975308641975
"[0, 1, 0, 1, 0, 1, 1, 0, 1, 0, 1, 1, 0, 0, 0]",116,59,57,2,3,0.03389830508474576,0.05263157894736842
"[1, 0, 0, 0, 0, 1, 1, 0, 0, 0, 0, 1, 0, 1, 0]",379,179,200,20,30,0.11173184357541899,0.15
"[1, 0, 0, 0, 0, 0, 1, 1, 0, 1, 0, 1, 1, 1, 0]",114,54,60,1,3,0.018518518518518517,0.05
"[0, 1, 1, 1, 0, 1, 1, 0, 0, 0, 0, 0, 1, 1, 0]",176,99,77,12,11,0.12121212121212122,0.14285714285714285
"[0, 0, 1, 0, 1, 0, 0, 0, 1, 0, 1, 1, 0, 0, 1]",175,102,73,7,13,0.06862745098039216,0.1780821917808219
"[1, 0, 0, 1, 0, 1, 0, 0, 0, 1, 0, 1, 1, 0, 0]",166,84,82,11,6,0.13095238095238096,0.07317073170731707
"[1, 0, 0, 0, 0, 0, 1, 0, 0, 1, 0, 1, 1, 1, 0]",153,92,61,8,3,0.08695652173913043,0.04918032786885246
"[1, 1, 1, 0, 0, 1, 0, 0, 0, 0, 0, 0, 0, 1, 0]",281,176,105,19,7,0.10795454545454546,0.06666666666666667
"[0, 1, 1, 0, 0, 1, 0, 1, 1, 0, 0, 1, 0, 1, 1]",115,60,55,8,3,0.13333333333333333,0.05454545454545454
"[0, 0, 0, 1, 0, 0, 1, 1, 0, 1, 0, 1, 0, 1, 0]",119,72,47,8,9,0.1111111111111111,0.19148936170212766
"[0, 1, 0, 0, 0, 1, 0, 0, 0, 1, 0, 0, 0, 1, 0]",462,312,150,33,13,0.10576923076923077,0.08666666666666667
"[1, 0, 1, 1, 1, 1, 0, 1, 1, 0, 0, 0, 1, 1, 1]",318,113,205,13,15,0.11504424778761062,0.07317073170731707
"[0, 0, 1, 1, 0, 0, 0, 1, 1, 0, 1, 1, 1, 1, 0]",181,84,97,11,11,0.13095238095238096,0.1134020618556701
"[0, 1, 1, 1, 1, 1, 1, 1, 1, 0, 0, 1, 0, 1, 0]",355,195,160,13,14,0.06666666666666667,0.0875
"[0, 0, 1, 1, 0, 0, 1, 0, 0, 0, 1, 1, 0, 0, 0]",365,228,137,20,13,0.08771929824561403,0.0948905109489051
"[0, 1, 0, 0, 0, 1, 1, 0, 0, 1, 0, 0, 0, 1, 1]",152,101,51,6,6,0.0594059405940594,0.11764705882352941
"[0, 0, 1, 0, 0, 0, 1, 0, 1, 0, 0, 1, 0, 0, 1]",236,137,99,21,11,0.15328467153284672,0.1111111111111111
"[1, 1, 1, 1, 0, 1, 0, 0, 1, 0, 0, 0, 1, 1, 0]",99,51,48,5,4,0.09803921568627451,0.08333333333333333
"[0, 0, 0, 1, 0, 1, 0, 0, 1, 0, 1, 0, 1, 1, 1]",135,76,59,6,4,0.07894736842105263,0.06779661016949153
"[0, 1, 0, 1, 1, 1, 0, 0, 0, 1, 0, 1, 0, 0, 1]",109,56,53,4,10,0.07142857142857142,0.18867924528301888
"[1, 0, 1, 0, 0, 1, 0, 1, 1, 0, 0, 0, 1, 1, 1]",151,69,82,11,11,0.15942028985507245,0.13414634146341464
"[0, 1, 0, 1, 0, 1, 0, 0, 1, 0, 1, 1, 0, 0, 0]",180,109,71,13,7,0.11926605504587157,0.09859154929577464
"[1, 0, 0, 1, 0, 0, 0, 0, 0, 1, 0, 1, 1, 0, 0]",264,166,98,15,5,0.09036144578313253,0.05102040816326531
"[1, 0, 0, 1, 0, 0, 1, 1, 0, 0, 1, 0, 1, 0, 0]",162,100,62,7,5,0.07,0.08064516129032258
"[1, 0, 1, 0, 0, 1, 0, 0, 0, 0, 0, 0, 1, 0, 1]",239,151,88,16,14,0.10596026490066225,0.1590909090909091
"[1, 1, 0, 1, 1, 1, 0, 0, 1, 0, 1, 0, 1, 1, 0]",137,57,80,7,10,0.12280701754385964,0.125
"[1, 1, 0, 1, 0, 0, 0, 1, 1, 1, 1, 1, 1, 0, 0]",329,134,195,11,13,0.08208955223880597,0.06666666666666667
"[1, 1, 1, 0, 1, 1, 0, 1, 0, 0, 0, 1, 1, 1, 1]",357,131,226,17,10,0.1297709923664122,0.04424778761061947
"[0, 1, 1, 1, 0, 0, 1, 1, 0, 0, 0, 1, 0, 0, 0]",165,106,59,14,4,0.1320754716981132,0.06779661016949153
"[0, 0, 1, 1, 0, 1, 1, 0, 0, 1, 0, 0, 0, 0, 0]",295,195,100,10,8,0.05128205128205128,0.08
"[0, 0, 1, 1, 0, 0, 0, 1, 1, 0, 1, 1, 0, 0, 1]",152,77,75,9,9,0.11688311688311688,0.12
"[0, 0, 1, 1, 1, 0, 0, 0, 0, 0, 0, 0, 1, 1, 0]",403,280,123,27,14,0.09642857142857143,0.11382113821138211
"[1, 0, 0, 1, 1, 1, 0, 0, 0, 0, 0, 0, 0, 1, 1]",265,132,133,13,19,0.09848484848484848,0.14285714285714285
"[0, 1, 1, 1, 0, 0, 1, 1, 1, 1, 0, 1, 1, 0, 0]",167,75,92,12,15,0.16,0.16304347826086957
"[1, 1, 1, 0, 0, 0, 1, 0, 1, 1, 1, 0, 0, 1, 1]",203,67,136,6,15,0.08955223880597014,0.11029411764705882
"[0, 1, 0, 1, 1, 0, 0, 0, 0, 0, 1, 0, 0, 1, 1]",190,109,81,9,6,0.08256880733944955,0.07407407407407407
"[0, 0, 0, 1, 0, 1, 1, 0, 1, 0, 0, 0, 1, 1, 0]",190,110,80,4,6,0.03636363636363636,0.075
"[0, 0, 0, 0, 0, 0, 1, 0, 1, 0, 1, 1, 1, 0, 0]",298,206,92,33,4,0.16019417475728157,0.043478260869565216
"[1, 1, 1, 1, 0, 1, 0, 1, 1, 1, 1, 0, 0, 0, 0]",319,115,204,13,26,0.11304347826086956,0.12745098039215685
"[1, 1, 0, 0, 0, 1, 1, 1, 0, 1, 1, 1, 1, 0, 1]",229,81,148,7,16,0.08641975308641975,0.10810810810810811
"[1, 0, 0, 1, 1, 0, 0, 1, 0, 1, 0, 1, 1, 0, 0]",137,59,78,5,7,0.0847457627118644,0.08974358974358974
"[0, 1, 0, 1, 1, 1, 1, 1, 0, 1, 1, 1, 0, 1, 1]",546,171,375,17,37,0.09941520467836257,0.09866666666666667
"[1, 1, 0, 1, 1, 1, 1, 1, 0, 0, 1, 0, 0, 0, 0]",146,64,82,5,10,0.078125,0.12195121951219512
"[1, 1, 1, 0, 1, 1, 1, 1, 0, 0, 1, 0, 1, 0, 1]",238,71,167,8,17,0.11267605633802817,0.10179640718562874
"[1, 0, 0, 1, 1, 1, 0, 0, 0, 1, 1, 0, 1, 1, 1]",211,73,138,5,10,0.0684931506849315,0.07246376811594203
"[0, 1, 1, 1, 0, 0, 1, 1, 1, 0, 0, 0, 1, 1, 0]",138,62,76,8,4,0.12903225806451613,0.05263157894736842
"[1, 0, 1, 1, 1, 0, 0, 0, 0, 1, 1, 1, 0, 0, 0]",142,87,55,11,5,0.12643678160919541,0.09090909090909091
"[0, 1, 0, 1, 1, 1, 0, 0, 0, 0, 1, 1, 1, 0, 0]",141,82,59,6,4,0.07317073170731707,0.06779661016949153
"[1, 0, 1, 1, 1, 0, 0, 0, 1, 1, 0, 0, 0, 1, 0]",108,46,62,4,8,0.08695652173913043,0.12903225806451613
"[0, 1, 1, 0, 1, 1, 0, 1, 0, 0, 1, 1, 1, 1, 0]",182,79,103,7,9,0.08860759493670886,0.08737864077669903
"[1, 1, 1, 0, 1, 0, 0, 1, 0, 0, 1, 0, 0, 1, 1]",134,63,71,3,7,0.047619047619047616,0.09859154929577464
"[1, 0, 1, 0, 0, 1, 1, 1, 1, 1, 1, 1, 0, 0, 0]",276,111,165,13,11,0.11711711711711711,0.06666666666666667
"[0, 1, 1, 0, 0, 0, 1, 1, 1, 0, 1, 0, 1, 1, 0]",124,70,54,8,3,0.11428571428571428,0.05555555555555555
"[1, 0, 1, 0, 0, 0, 0, 1, 0, 1, 0, 1, 1, 0, 1]",107,60,47,5,6,0.08333333333333333,0.1276595744680851
"[0, 0, 0, 1, 0, 0, 1, 0, 1, 0, 1, 0, 0, 1, 1]",147,98,49,8,5,0.08163265306122448,0.10204081632653061
"[0, 0, 1, 0, 1, 0, 0, 0, 1, 0, 1, 1, 0, 1, 1]",114,67,47,9,6,0.13432835820895522,0.1276595744680851
"[1, 1, 0, 0, 1, 0, 1, 0, 0, 0, 1, 0, 1, 1, 0]",120,61,59,4,5,0.06557377049180328,0.0847457627118644
"[1, 0, 0, 0, 1, 1, 0, 1, 0, 0, 1, 0, 0, 1, 0]",119,66,53,8,5,0.12121212121212122,0.09433962264150944
"[0, 1, 1, 0, 1, 0, 1, 0, 0, 0, 0, 0, 0, 0, 1]",324,212,112,25,13,0.1179245283018868,0.11607142857142858
"[0, 0, 0, 0, 1, 0, 0, 0, 0, 1, 1, 0, 1, 0, 1]",239,177,62,15,7,0.0847457627118644,0.11290322580645161
"[0, 0, 1, 1, 1, 0, 1, 1, 0, 0, 0, 0, 1, 0, 1]",144,74,70,12,4,0.16216216216216217,0.05714285714285714
"[0, 0, 1, 0, 1, 1, 0, 0, 1, 1, 0, 1, 1, 1, 1]",217,96,121,8,9,0.08333333333333333,0.0743801652892562
"[0, 0, 0, 1, 0, 0, 1, 0, 1, 0, 0, 1, 1, 1, 0]",130,81,49,3,4,0.037037037037037035,0.08163265306122448
"[0, 1, 1, 0, 1, 0, 0, 0, 1, 1, 0, 0, 0, 1, 0]",143,89,54,12,7,0.1348314606741573,0.12962962962962962
"[1, 0, 0, 1, 1, 1, 0, 0, 1, 0, 0, 1, 1, 0, 1]",110,45,65,7,5,0.15555555555555556,0.07692307692307693
"[1, 0, 1, 1, 1, 0, 1, 1, 0, 1, 1, 1, 0, 1, 0]",226,74,152,7,24,0.0945945945945946,0.15789473684210525
"[1, 0, 1, 0, 1, 0, 1, 0, 1, 0, 0, 0, 1, 1, 1]",165,85,80,9,3,0.10588235294117647,0.0375
"[1, 1, 0, 1, 0, 1, 1, 1, 0, 1, 1, 0, 1, 1, 0]",225,76,149,5,21,0.06578947368421052,0.14093959731543623
"[0, 0, 0, 0, 0, 0, 1, 0, 0, 0, 1, 0, 1, 1, 1]",588,425,163,27,10,0.06352941176470588,0.06134969325153374
"[1, 0, 1, 0, 0, 0, 1, 1, 0, 0, 0, 0, 1, 1, 1]",343,185,158,18,18,0.0972972972972973,0.11392405063291139
"[0, 1, 1, 0, 0, 1, 1, 1, 1, 0, 0, 1, 1, 0, 1]",460,319,141,24,13,0.07523510971786834,0.09219858156028368
"[1, 0, 0, 0, 0, 1, 0, 1, 1, 1, 1, 0, 1, 0, 0]",110,58,52,5,6,0.08620689655172414,0.11538461538461539
"[1, 1, 1, 1, 0, 0, 1, 1, 0, 1, 1, 0, 1, 0, 0]",168,72,96,6,8,0.08333333333333333,0.08333333333333333
"[0, 1, 0, 0, 0, 1, 0, 0, 1, 1, 0, 0, 1, 1, 1]",227,126,101,14,12,0.1111111111111111,0.1188118811881188
"[0, 0, 0, 0, 0, 0, 1, 1, 0, 1, 1, 0, 0, 1, 0]",329,199,130,23,9,0.11557788944723618,0.06923076923076923
"[1, 1, 1, 1, 0, 0, 0, 0, 1, 0, 0, 0, 0, 0, 1]",273,149,124,7,7,0.04697986577181208,0.056451612903225805
"[1, 1, 0, 0, 0, 1, 1, 0, 1, 0, 0, 1, 0, 1, 0]",111,61,50,7,4,0.11475409836065574,0.08
"[1, 0, 1, 1, 1, 0, 1, 1, 1, 0, 0, 1, 1, 0, 0]",273,104,169,12,13,0.11538461538461539,0.07692307692307693
"[0, 0, 1, 0, 1, 1, 0, 1, 1, 0, 1, 1, 1, 0, 1]",148,67,81,7,6,0.1044776119402985,0.07407407407407407
"[0, 0, 1, 1, 0, 1, 0, 0, 1, 0, 1, 0, 1, 1, 1]",157,79,78,4,8,0.05063291139240506,0.10256410256410256
"[1, 0, 1, 0, 1, 0, 0, 0, 1, 1, 0, 1, 0, 0, 1]",120,71,49,11,4,0.15492957746478872,0.08163265306122448
"[1, 0, 1, 1, 0, 1, 0, 0, 0, 0, 0, 0, 0, 1, 1]",281,145,136,14,10,0.09655172413793103,0.07352941176470588
"[0, 0, 1, 1, 1, 1, 0, 1, 0, 1, 1, 0, 0, 0, 0]",187,96,91,10,10,0.10416666666666667,0.10989010989010989
"[1, 1, 1, 0, 1, 0, 0, 0, 0, 1, 1, 1, 0, 0, 1]",149,70,79,4,9,0.05714285714285714,0.11392405063291139
"[1, 1, 0, 0, 1, 1, 1, 1, 1, 0, 1, 0, 1, 0, 0]",170,69,101,11,7,0.15942028985507245,0.06930693069306931
"[1, 1, 1, 0, 1, 0, 0, 1, 1, 1, 1, 0, 0, 1, 0]",156,63,93,6,14,0.09523809523809523,0.15053763440860216
"[1, 1, 1, 1, 0, 0, 0, 1, 1, 1, 0, 1, 1, 0, 1]",304,104,200,7,20,0.0673076923076923,0.1
"[1, 1, 0, 0, 1, 0, 0, 0, 0, 0, 1, 1, 1, 0, 1]",129,64,65,7,6,0.109375,0.09230769230769231
"[1, 0, 1, 1, 0, 0, 1, 0, 0, 0, 0, 0, 1, 1, 1]",178,96,82,9,6,0.09375,0.07317073170731707
"[0, 1, 1, 1, 1, 0, 1, 0, 0, 0, 1, 0, 0, 1, 0]",108,59,49,3,4,0.05084745762711865,0.08163265306122448
"[1, 1, 1, 1, 1, 1, 1, 0, 0, 1, 1, 0, 0, 1, 0]",579,128,451,11,46,0.0859375,0.10199556541019955
"[0, 1, 0, 1, 0, 0, 1, 0, 0, 0, 0, 1, 0, 0, 1]",209,126,83,12,11,0.09523809523809523,0.13253012048192772
"[0, 1, 0, 0, 1, 1, 0, 1, 1, 0, 1, 0, 1, 0, 0]",104,54,50,6,8,0.1111111111111111,0.16
"[0, 0, 1, 1, 0, 0, 1, 1, 0, 0, 1, 0, 0, 0, 1]",295,168,127,16,12,0.09523809523809523,0.09448818897637795
"[1, 1, 0, 0, 1, 1, 0, 0, 1, 1, 0, 0, 1, 0, 0]",341,200,141,17,13,0.085,0.09219858156028368
"[0, 0, 1, 0, 0, 1, 1, 1, 1, 1, 1, 1, 0, 0, 1]",273,122,151,11,20,0.09016393442622951,0.13245033112582782
"[0, 0, 1, 0, 0, 1, 1, 0, 1, 0, 1, 1, 0, 0, 0]",158,94,64,9,7,0.09574468085106383,0.109375
"[0, 1, 1, 1, 1, 0, 1, 0, 0, 0, 0, 0, 0, 1, 1]",261,130,131,16,14,0.12307692307692308,0.10687022900763359
"[0, 0, 1, 0, 1, 0, 0, 0, 1, 0, 1, 0, 0, 1, 0]",226,148,78,8,9,0.05405405405405406,0.11538461538461539
"[0, 1, 0, 1, 1, 0, 1, 1, 1, 1, 0, 1, 0, 0, 0]",127,67,60,4,8,0.05970149253731343,0.13333333333333333
"[0, 0, 0, 1, 1, 0, 1, 0, 1, 1, 1, 0, 1, 0, 1]",108,54,54,5,6,0.09259259259259259,0.1111111111111111
"[0, 0, 0, 0, 0, 0, 1, 1, 0, 1, 0, 1, 1, 1, 0]",203,125,78,17,12,0.136,0.15384615384615385
"[0, 1, 0, 0, 0, 0, 1, 0, 1, 1, 1, 0, 0, 0, 1]",136,73,63,4,4,0.0547945205479452,0.06349206349206349
"[0, 1, 1, 1, 1, 0, 0, 1, 0, 1, 1, 0, 1, 0, 1]",146,74,72,8,4,0.10810810810810811,0.05555555555555555
"[1, 0, 1, 0, 0, 1, 1, 1, 1, 1, 0, 1, 1, 1, 1]",634,190,444,13,33,0.06842105263157895,0.07432432432432433
"[0, 0, 0, 0, 1, 1, 0, 1, 1, 0, 1, 0, 1, 1, 0]",113,63,50,9,5,0.14285714285714285,0.1
"[1, 0, 0, 0, 1, 1, 1, 0, 1, 0, 0, 0, 0, 0, 1]",149,75,74,9,8,0.12,0.10810810810810811
"[0, 1, 0, 1, 0, 0, 1, 0, 0, 1, 1, 1, 1, 1, 1]",264,115,149,10,18,0.08695652173913043,0.12080536912751678
"[0, 0, 0, 0, 0, 1, 1, 1, 1, 1, 0, 0, 1, 1, 0]",324,196,128,22,10,0.11224489795918367,0.078125
"[0, 0, 1, 0, 0, 1, 1, 1, 1, 1, 1, 1, 0, 1, 1]",321,112,209,14,18,0.125,0.0861244019138756
"[1, 1, 0, 0, 0, 1, 0, 0, 0, 1, 0, 0, 0, 1, 1]",188,114,74,9,4,0.07894736842105263,0.05405405405405406
"[0, 0, 0, 1, 0, 1, 0, 0, 0, 1, 1, 0, 0, 1, 1]",313,195,118,14,11,0.07179487179487179,0.09322033898305085
"[0, 1, 0, 0, 1, 1, 1, 1, 1, 0, 1, 0, 0, 1, 1]",151,57,94,5,9,0.08771929824561403,0.09574468085106383
"[0, 0, 1, 1, 1, 1, 1, 0, 1, 1, 1, 0, 1, 1, 0]",262,99,163,9,18,0.09090909090909091,0.11042944785276074
"[1, 0, 0, 1, 0, 1, 1, 1, 0, 1, 0, 1, 0, 0, 0]",104,61,43,6,5,0.09836065573770492,0.11627906976744186
"[0, 0, 0, 0, 1, 1, 1, 0, 1, 0, 1, 1, 1, 1, 0]",167,83,84,6,9,0.07228915662650602,0.10714285714285714
"[0, 1, 0, 0, 1, 0, 1, 1, 0, 0, 0, 1, 1, 1, 0]",103,54,49,6,9,0.1111111111111111,0.1836734693877551
"[0, 1, 0, 1, 1, 0, 0, 0, 0, 0, 1, 0, 0, 1, 0]",248,153,95,20,9,0.13071895424836602,0.09473684210526316
"[1, 0, 0, 0, 1, 1, 1, 0, 0, 1, 0, 1, 0, 0, 1]",114,58,56,6,5,0.10344827586206896,0.08928571428571429
"[1, 1, 0, 0, 0, 0, 1, 1, 1, 0, 0, 0, 0, 0, 0]",540,303,237,29,30,0.09570957095709572,0.12658227848101267
"[0, 1, 1, 1, 1, 1, 1, 0, 0, 1, 1, 1, 0, 0, 0]",286,157,129,17,14,0.10828025477707007,0.10852713178294573
"[1, 0, 0, 0, 1, 1, 0, 1, 1, 0, 0, 0, 1, 0, 1]",107,56,51,6,1,0.10714285714285714,0.0196078431372549
"[0, 1, 1, 0, 1, 1, 0, 1, 0, 0, 0, 1, 1, 0, 1]",103,51,52,8,3,0.1568627450980392,0.057692307692307696
"[1, 0, 1, 0, 0, 0, 0, 1, 1, 1, 0, 0, 0, 0, 0]",325,212,113,19,12,0.08962264150943396,0.10619469026548672
"[1, 0, 1, 0, 1, 1, 1, 0, 1, 0, 0, 0, 0, 1, 1]",138,63,75,9,6,0.14285714285714285,0.08
"[1, 0, 0, 1, 0, 1, 1, 1, 0, 1, 0, 1, 1, 1, 0]",141,50,91,3,7,0.06,0.07692307692307693
"[0, 1, 0, 0, 0, 0, 1, 0, 1, 0, 0, 1, 0, 0, 1]",247,165,82,14,9,0.08484848484848485,0.10975609756097561
"[1, 1, 0, 0, 1, 1, 0, 1, 0, 0, 1, 1, 0, 1, 0]",118,52,66,2,8,0.038461538461538464,0.12121212121212122
"[1, 0, 1, 1, 1, 0, 0, 1, 1, 0, 1, 0, 0, 1, 1]",165,74,91,8,10,0.10810810810810811,0.10989010989010989
"[1, 1, 0, 1, 1, 0, 1, 0, 1, 0, 1, 1, 0, 0, 1]",167,74,93,4,9,0.05405405405405406,0.0967741935483871
"[1, 1, 1, 0, 0, 1, 0, 0, 1, 1, 1, 0, 1, 1, 0]",155,70,85,6,6,0.08571428571428572,0.07058823529411765
"[1, 1, 1, 1, 0, 0, 1, 0, 0, 1, 1, 1, 0, 1, 1]",278,99,179,8,24,0.08080808080808081,0.1340782122905028
"[0, 1, 1, 1, 1, 1, 0, 1, 1, 0, 0, 0, 0, 1, 0]",126,65,61,6,2,0.09230769230769231,0.03278688524590164
"[1, 0, 1, 1, 1, 0, 0, 1, 1, 1, 0, 0, 0, 0, 0]",163,81,82,6,13,0.07407407407407407,0.15853658536585366
"[1, 1, 0, 0, 0, 1, 0, 1, 0, 1, 0, 1, 0, 1, 1]",117,49,68,3,6,0.061224489795918366,0.08823529411764706
"[1, 1, 0, 0, 0, 0, 1, 1, 0, 0, 0, 0, 1, 0, 1]",400,240,160,25,18,0.10416666666666667,0.1125
"[1, 1, 1, 1, 1, 1, 0, 1, 1, 0, 1, 1, 1, 0, 0]",698,185,513,25,60,0.13513513513513514,0.11695906432748537
"[1, 1, 0, 0, 1, 1, 0, 1, 0, 0, 1, 0, 1, 0, 0]",117,65,52,4,4,0.06153846153846154,0.07692307692307693
"[1, 1, 1, 0, 1, 0, 0, 1, 0, 1, 1, 0, 1, 1, 1]",248,85,163,12,18,0.1411764705882353,0.11042944785276074
"[1, 0, 1, 0, 0, 1, 0, 1, 1, 1, 0, 1, 0, 1, 0]",86,40,46,3,6,0.075,0.13043478260869565
"[1, 0, 1, 1, 1, 0, 0, 0, 0, 0, 0, 1, 1, 1, 1]",486,221,265,27,25,0.12217194570135746,0.09433962264150944
"[0, 1, 1, 0, 0, 1, 0, 1, 1, 1, 0, 0, 0, 0, 0]",210,133,77,10,6,0.07518796992481203,0.07792207792207792
"[0, 1, 0, 1, 0, 1, 0, 1, 0, 0, 1, 0, 1, 0, 1]",115,58,57,7,7,0.1206896551724138,0.12280701754385964
"[0, 0, 0, 0, 0, 0, 1, 1, 0, 0, 1, 0, 0, 1, 0]",703,491,212,55,19,0.1120162932790224,0.08962264150943396
"[0, 0, 0, 0, 1, 1, 1, 0, 1, 0, 1, 0, 0, 1, 0]",120,76,44,5,8,0.06578947368421052,0.18181818181818182
"[1, 0, 1, 1, 0, 1, 1, 1, 0, 1, 1, 0, 0, 0, 0]",177,87,90,9,7,0.10344827586206896,0.07777777777777778
"[0, 0, 0, 0, 1, 0, 0, 1, 0, 1, 1, 0, 1, 1, 1]",161,97,64,7,6,0.07216494845360824,0.09375
"[0, 1, 1, 1, 0, 1, 1, 0, 1, 1, 0, 1, 0, 0, 0]",106,58,48,5,1,0.08620689655172414,0.020833333333333332
"[1, 0, 0, 1, 1, 0, 1, 1, 1, 0, 1, 1, 1, 0, 1]",214,79,135,9,8,0.11392405063291139,0.05925925925925926
"[1, 1, 0, 1, 0, 1, 0, 0, 1, 0, 0, 0, 0, 0, 0]",309,200,109,12,5,0.06,0.045871559633027525
"[1, 0, 1, 0, 1, 0, 1, 0, 0, 0, 0, 0, 0, 1, 0]",218,147,71,13,4,0.08843537414965986,0.056338028169014086
"[1, 1, 0, 1, 0, 1, 0, 1, 0, 0, 0, 0, 0, 0, 1]",157,86,71,10,8,0.11627906976744186,0.11267605633802817
"[0, 0, 1, 1, 1, 0, 1, 0, 1, 0, 1, 0, 0, 0, 0]",169,95,74,5,4,0.05263157894736842,0.05405405405405406
"[1, 0, 0, 1, 1, 1, 0, 1, 0, 1, 0, 1, 0, 0, 0]",122,68,54,6,2,0.08823529411764706,0.037037037037037035
"[0, 1, 0, 0, 1, 1, 1, 0, 0, 1, 1, 0, 1, 0, 0]",115,72,43,11,2,0.1527777777777778,0.046511627906976744
"[0, 1, 0, 0, 0, 1, 0, 0, 1, 1, 1, 0, 0, 0, 1]",170,105,65,6,6,0.05714285714285714,0.09230769230769231
"[1, 1, 0, 1, 1, 1, 1, 0, 1, 0, 1, 0, 1, 0, 1]",245,74,171,6,21,0.08108108108108109,0.12280701754385964
"[1, 1, 0, 0, 1, 1, 0, 0, 1, 0, 1, 1, 1, 0, 1]",194,72,122,9,17,0.125,0.13934426229508196
"[1, 0, 1, 1, 1, 0, 1, 1, 1, 1, 0, 0, 0, 0, 0]",211,93,118,10,10,0.10752688172043011,0.0847457627118644
"[0, 0, 1, 0, 1, 1, 0, 0, 1, 0, 0, 0, 1, 1, 0]",165,98,67,8,8,0.08163265306122448,0.11940298507462686
"[1, 0, 0, 1, 0, 1, 1, 1, 1, 0, 0, 1, 0, 0, 0]",136,83,53,10,2,0.12048192771084337,0.03773584905660377
"[1, 1, 1, 0, 0, 0, 0, 0, 1, 0, 0, 1, 0, 1, 1]",152,64,88,6,7,0.09375,0.07954545454545454
"[0, 0, 0, 0, 1, 1, 0, 0, 1, 0, 0, 0, 1, 1, 0]",341,241,100,22,10,0.0912863070539419,0.1
"[0, 0, 0, 0, 0, 1, 1, 0, 0, 1, 0, 0, 0, 1, 1]",538,422,116,28,12,0.06635071090047394,0.10344827586206896
"[1, 0, 0, 1, 0, 0, 1, 1, 0, 1, 1, 0, 1, 1, 0]",117,50,67,5,4,0.1,0.05970149253731343
"[1, 1, 0, 1, 0, 1, 0, 0, 1, 0, 1, 1, 0, 0, 1]",131,51,80,5,8,0.09803921568627451,0.1
"[0, 1, 1, 0, 1, 0, 0, 1, 0, 0, 1, 0, 1, 1, 1]",135,74,61,9,10,0.12162162162162163,0.16393442622950818
"[1, 0, 0, 1, 0, 1, 0, 1, 1, 0, 0, 0, 0, 1, 0]",157,94,63,9,8,0.09574468085106383,0.12698412698412698
"[1, 0, 1, 1, 0, 0, 1, 1, 1, 0, 1, 0, 1, 0, 1]",138,56,82,3,7,0.05357142857142857,0.08536585365853659
"[0, 1, 1, 1, 0, 1, 1, 0, 1, 1, 1, 0, 1, 1, 1]",585,174,411,10,46,0.05747126436781609,0.11192214111922141
"[1, 1, 1, 1, 0, 0, 0, 1, 1, 1, 0, 1, 1, 1, 1]",708,202,506,24,49,0.1188118811881188,0.09683794466403162
"[0, 1, 0, 1, 1, 0, 1, 0, 1, 1, 1, 1, 1, 1, 0]",264,104,160,5,9,0.04807692307692308,0.05625
"[1, 1, 1, 1, 0, 0, 1, 1, 0, 0, 0, 1, 0, 1, 1]",332,143,189,15,24,0.1048951048951049,0.12698412698412698
"[0, 0, 0, 0, 1, 0, 0, 1, 0, 1, 0, 0, 0, 1, 1]",335,215,120,18,13,0.08372093023255814,0.10833333333333334
"[1, 1, 0, 1, 1, 1, 1, 0, 0, 0, 1, 0, 0, 0, 1]",122,64,58,7,8,0.109375,0.13793103448275862
"[0, 0, 1, 1, 0, 1, 1, 1, 1, 0, 0, 0, 1, 0, 0]",109,68,41,7,2,0.10294117647058823,0.04878048780487805
"[1, 1, 0, 0, 0, 1, 1, 0, 1, 1, 1, 1, 0, 0, 0]",184,90,94,11,9,0.12222222222222222,0.09574468085106383
"[1, 0, 0, 1, 0, 0, 1, 1, 1, 1, 1, 1, 1, 0, 1]",296,106,190,7,19,0.0660377358490566,0.1
"[0, 1, 1, 0, 0, 0, 1, 1, 1, 1, 1, 0, 0, 1, 1]",272,117,155,15,18,0.1282051282051282,0.11612903225806452
"[1, 1, 1, 1, 1, 0, 1, 1, 0, 0, 1, 1, 0, 0, 0]",305,107,198,6,30,0.056074766355140186,0.15151515151515152
"[1, 0, 1, 0, 0, 1, 0, 0, 0, 0, 1, 1, 1, 1, 1]",201,92,109,8,12,0.08695652173913043,0.11009174311926606
"[1, 1, 0, 0, 1, 1, 0, 0, 1, 0, 1, 1, 0, 0, 1]",175,73,102,7,16,0.0958904109589041,0.1568627450980392
"[0, 1, 0, 0, 1, 1, 1, 1, 1, 1, 0, 1, 0, 0, 0]",150,78,72,5,7,0.0641025641025641,0.09722222222222222
"[0, 1, 0, 1, 0, 0, 1, 1, 1, 1, 1, 1, 0, 1, 0]",153,63,90,3,6,0.047619047619047616,0.06666666666666667
"[1, 1, 1, 0, 1, 1, 0, 1, 1, 1, 1, 1, 0, 0, 0]",337,126,211,12,25,0.09523809523809523,0.11848341232227488
"[1, 1, 1, 1, 0, 0, 1, 0, 1, 0, 1, 1, 0, 1, 0]",147,66,81,4,5,0.06060606060606061,0.06172839506172839
"[0, 0, 1, 1, 1, 1, 1, 0, 0, 0, 1, 1, 1, 1, 1]",437,166,271,14,34,0.08433734939759036,0.12546125461254612
"[1, 0, 0, 0, 1, 0, 1, 1, 1, 0, 0, 1, 0, 1, 1]",117,52,65,5,8,0.09615384615384616,0.12307692307692308
"[0, 0, 0, 1, 0, 1, 0, 0, 1, 1, 1, 1, 1, 1, 1]",317,134,183,11,16,0.08208955223880597,0.08743169398907104
"[1, 1, 1, 1, 1, 1, 1, 1, 0, 0, 0, 0, 1, 0, 1]",630,217,413,19,46,0.08755760368663594,0.11138014527845036
"[0, 1, 1, 0, 1, 1, 0, 0, 1, 0, 0, 0, 1, 1, 0]",135,73,62,5,6,0.0684931506849315,0.0967741935483871
"[1, 0, 1, 0, 1, 0, 1, 1, 0, 0, 1, 0, 1, 0, 1]",98,43,55,7,7,0.16279069767441862,0.12727272727272726
"[1, 1, 0, 0, 1, 1, 1, 0, 0, 1, 1, 1, 0, 0, 1]",201,81,120,6,6,0.07407407407407407,0.05
"[1, 0, 0, 1, 0, 1, 0, 0, 1, 1, 1, 1, 0, 1, 0]",119,53,66,4,9,0.07547169811320754,0.13636363636363635
"[1, 1, 0, 0, 1, 0, 1, 0, 0, 1, 1, 1, 1, 0, 1]",160,55,105,5,12,0.09090909090909091,0.11428571428571428
"[1, 1, 1, 0, 1, 1, 1, 1, 0, 0, 1, 0, 1, 1, 1]",579,178,401,11,30,0.06179775280898876,0.07481296758104738
"[1, 1, 0, 1, 1, 0, 0, 1, 1, 0, 0, 0, 0, 0, 1]",178,85,93,9,11,0.10588235294117647,0.11827956989247312
"[0, 0, 0, 1, 1, 1, 1, 1, 1, 1, 1, 0, 1, 0, 0]",256,159,97,19,4,0.11949685534591195,0.041237113402061855
"[1, 1, 1, 0, 1, 0, 0, 0, 0, 1, 1, 0, 1, 1, 1]",167,64,103,5,7,0.078125,0.06796116504854369
"[0, 1, 0, 1, 0, 1, 0, 0, 1, 1, 1, 0, 1, 0, 0]",107,57,50,7,5,0.12280701754385964,0.1
"[1, 0, 0, 0, 0, 0, 1, 0, 0, 1, 1, 1, 1, 0, 1]",111,57,54,4,2,0.07017543859649122,0.037037037037037035
"[1, 1, 0, 1, 0, 1, 0, 0, 0, 1, 0, 1, 0, 0, 0]",141,88,53,8,2,0.09090909090909091,0.03773584905660377
"[1, 0, 0, 0, 1, 0, 0, 0, 1, 1, 0, 1, 0, 1, 0]",131,82,49,8,5,0.0975609756097561,0.10204081632653061
"[1, 0, 0, 1, 0, 0, 0, 1, 0, 0, 0, 1, 1, 0, 1]",141,73,68,7,6,0.0958904109589041,0.08823529411764706
"[0, 1, 1, 1, 0, 1, 0, 0, 0, 1, 0, 1, 0, 1, 0]",107,60,47,3,4,0.05,0.0851063829787234
"[1, 1, 0, 1, 1, 1, 0, 1, 0, 0, 0, 1, 0, 1, 0]",102,48,54,5,4,0.10416666666666667,0.07407407407407407
"[1, 1, 1, 0, 1, 1, 1, 0, 1, 0, 0, 0, 1, 0, 1]",137,44,93,6,14,0.13636363636363635,0.15053763440860216
"[0, 0, 1, 1, 1, 1, 1, 0, 0, 1, 1, 1, 0, 0, 0]",150,64,86,7,12,0.109375,0.13953488372093023
"[0, 0, 0, 1, 1, 1, 1, 1, 0, 0, 1, 1, 1, 0, 0]",151,66,85,7,10,0.10606060606060606,0.11764705882352941
"[0, 1, 0, 0, 0, 0, 1, 0, 0, 0, 1, 0, 1, 1, 1]",193,119,74,11,6,0.09243697478991597,0.08108108108108109
"[1, 1, 0, 0, 1, 1, 1, 0, 1, 1, 0, 0, 1, 1, 0]",218,84,134,8,10,0.09523809523809523,0.07462686567164178
"[0, 0, 1, 1, 1, 0, 1, 1, 0, 1, 1, 1, 0, 0, 1]",178,68,110,6,6,0.08823529411764706,0.05454545454545454
"[1, 1, 1, 0, 0, 0, 1, 1, 1, 0, 1, 1, 0, 1, 1]",281,78,203,7,23,0.08974358974358974,0.11330049261083744
"[1, 1, 1, 1, 1, 1, 0, 0, 1, 0, 1, 0, 1, 1, 0]",286,108,178,4,15,0.037037037037037035,0.08426966292134831
"[0, 0, 0, 1, 1, 1, 0, 1, 0, 0, 1, 1, 1, 1, 0]",160,92,68,7,9,0.07608695652173914,0.1323529411764706
"[1, 0, 0, 0, 0, 1, 1, 0, 0, 0, 1, 1, 1, 0, 1]",164,74,90,6,6,0.08108108108108109,0.06666666666666667
"[1, 0, 1, 0, 0, 1, 0, 0, 0, 1, 0, 0, 0, 0, 0]",589,406,183,41,22,0.10098522167487685,0.12021857923497267
"[1, 0, 0, 1, 1, 0, 0, 0, 0, 0, 1, 0, 0, 1, 1]",299,119,180,13,21,0.1092436974789916,0.11666666666666667
"[0, 1, 1, 0, 0, 0, 1, 1, 1, 0, 1, 1, 0, 1, 1]",167,74,93,5,11,0.06756756756756757,0.11827956989247312
"[1, 0, 1, 1, 0, 0, 0, 1, 1, 1, 0, 1, 1, 0, 1]",139,57,82,5,8,0.08771929824561403,0.0975609756097561
"[1, 0, 1, 0, 1, 1, 1, 1, 1, 0, 0, 0, 0, 1, 1]",340,145,195,9,22,0.06206896551724138,0.11282051282051282
"[1, 1, 1, 1, 0, 1, 0, 1, 0, 1, 0, 1, 0, 0, 0]",114,62,52,7,9,0.11290322580645161,0.17307692307692307
"[1, 1, 1, 1, 1, 0, 1, 1, 1, 0, 0, 0, 0, 1, 0]",159,72,87,5,5,0.06944444444444445,0.05747126436781609
"[0, 0, 1, 0, 0, 1, 1, 0, 0, 1, 1, 1, 1, 1, 0]",154,73,81,8,10,0.1095890410958904,0.12345679012345678
"[1, 1, 0, 0, 0, 1, 1, 0, 0, 0, 0, 1, 0, 0, 1]",174,93,81,8,7,0.08602150537634409,0.08641975308641975
"[1, 0, 0, 0, 1, 0, 1, 1, 0, 1, 1, 0, 0, 0, 0]",204,111,93,8,4,0.07207207207207207,0.043010752688172046
"[0, 1, 1, 1, 1, 0, 0, 0, 1, 0, 1, 1, 0, 1, 1]",209,96,113,11,16,0.11458333333333333,0.1415929203539823
"[0, 1, 0, 0, 1, 1, 0, 1, 1, 1, 1, 0, 0, 0, 1]",115,56,59,6,6,0.10714285714285714,0.1016949152542373
"[0, 0, 1, 0, 0, 1, 1, 1, 1, 1, 0, 1, 1, 1, 0]",158,54,104,3,10,0.05555555555555555,0.09615384615384616
"[0, 0, 0, 1, 0, 0, 1, 1, 1, 1, 1, 0, 1, 1, 1]",188,87,101,3,8,0.034482758620689655,0.07920792079207921
"[1, 0, 0, 1, 0, 1, 0, 1, 1, 0, 1, 1, 0, 0, 0]",111,51,60,2,6,0.0392156862745098,0.1
"[0, 1, 0, 0, 1, 0, 0, 0, 0, 1, 1, 1, 1, 0, 0]",365,224,141,28,9,0.125,0.06382978723404255
"[1, 0, 1, 0, 0, 1, 0, 0, 0, 0, 1, 1, 1, 1, 0]",199,108,91,10,6,0.09259259259259259,0.06593406593406594
"[1, 0, 1, 1, 1, 0, 0, 1, 1, 0, 1, 0, 0, 0, 0]",130,70,60,5,5,0.07142857142857142,0.08333333333333333
"[0, 1, 0, 1, 1, 0, 0, 1, 1, 1, 0, 1, 1, 1, 1]",277,101,176,10,20,0.09900990099009901,0.11363636363636363
"[1, 0, 0, 0, 1, 1, 0, 1, 1, 0, 1, 1, 1, 0, 1]",131,55,76,3,5,0.05454545454545454,0.06578947368421052
"[0, 1, 0, 0, 0, 1, 1, 0, 1, 1, 0, 1, 1, 1, 0]",111,54,57,6,5,0.1111111111111111,0.08771929824561403
"[1, 0, 1, 0, 1, 0, 0, 0, 0, 1, 0, 0, 0, 1, 1]",165,111,54,10,6,0.09009009009009009,0.1111111111111111
"[0, 1, 0, 0, 0, 0, 0, 1, 0, 1, 0, 1, 0, 0, 0]",547,385,162,36,15,0.09350649350649351,0.09259259259259259
"[0, 0, 0, 0, 1, 0, 0, 0, 0, 0, 1, 0, 1, 0, 1]",579,413,166,41,12,0.09927360774818401,0.07228915662650602
"[1, 0, 0, 0, 0, 1, 0, 0, 1, 0, 1, 1, 1, 1, 1]",169,63,106,5,11,0.07936507936507936,0.10377358490566038
"[0, 1, 1, 0, 1, 0, 0, 0, 0, 1, 1, 1, 1, 1, 0]",130,51,79,6,6,0.11764705882352941,0.0759493670886076
"[1, 1, 0, 1, 1, 0, 1, 0, 0, 0, 0, 1, 1, 1, 1]",313,116,197,13,12,0.11206896551724138,0.06091370558375635
"[1, 0, 1, 1, 0, 1, 1, 0, 1, 0, 0, 0, 0, 1, 1]",158,68,90,4,13,0.058823529411764705,0.14444444444444443
"[0, 0, 0, 0, 0, 1, 1, 1, 1, 0, 1, 0, 0, 0, 1]",232,157,75,11,7,0.07006369426751592,0.09333333333333334
"[1, 0, 1, 0, 1, 1, 1, 0, 0, 1, 0, 1, 1, 0, 0]",129,65,64,7,6,0.1076923076923077,0.09375
"[1, 0, 0, 0, 0, 0, 1, 0, 1, 0, 1, 1, 0, 1, 1]",119,61,58,5,2,0.08196721311475409,0.034482758620689655
"[0, 1, 0, 1, 1, 0, 0, 1, 1, 0, 0, 1, 0, 0, 0]",157,84,73,8,4,0.09523809523809523,0.0547945205479452
"[0, 0, 1, 0, 1, 0, 0, 1, 0, 1, 1, 1, 0, 1, 0]",102,57,45,6,4,0.10526315789473684,0.08888888888888889
"[0, 1, 1, 1, 0, 1, 0, 1, 1, 0, 0, 0, 1, 1, 1]",189,88,101,10,10,0.11363636363636363,0.09900990099009901
"[1, 1, 1, 1, 1, 0, 1, 0, 1, 0, 0, 1, 1, 1, 0]",246,77,169,6,8,0.07792207792207792,0.047337278106508875
"[1, 0, 1, 1, 1, 1, 1, 0, 1, 0, 1, 0, 0, 1, 1]",265,90,175,9,13,0.1,0.07428571428571429
"[1, 0, 1, 0, 0, 1, 1, 0, 0, 1, 1, 0, 0, 0, 1]",144,74,70,8,4,0.10810810810810811,0.05714285714285714
"[1, 1, 0, 1, 0, 0, 1, 0, 1, 0, 0, 1, 1, 0, 0]",132,79,53,4,7,0.05063291139240506,0.1320754716981132
"[0, 1, 1, 1, 0, 0, 0, 1, 0, 1, 1, 1, 0, 0, 0]",144,87,57,10,2,0.11494252873563218,0.03508771929824561
"[0, 0, 0, 0, 1, 1, 0, 1, 1, 0, 1, 0, 0, 0, 0]",314,204,110,16,17,0.0784313725490196,0.15454545454545454
"[0, 0, 1, 1, 0, 1, 0, 0, 0, 0, 0, 1, 1, 0, 1]",166,108,58,10,7,0.09259259259259259,0.1206896551724138
"[1, 0, 0, 0, 0, 0, 1, 0, 0, 1, 1, 1, 1, 1, 1]",273,110,163,21,14,0.19090909090909092,0.08588957055214724
"[1, 1, 1, 0, 0, 1, 0, 1, 0, 1, 1, 1, 1, 0, 1]",235,88,147,9,11,0.10227272727272728,0.07482993197278912
"[0, 1, 0, 0, 1, 1, 1, 0, 0, 1, 0, 0, 1, 0, 0]",139,74,65,6,8,0.08108108108108109,0.12307692307692308
"[0, 0, 0, 1, 1, 0, 0, 0, 0, 0, 0, 1, 0, 1, 1]",679,538,141,46,14,0.08550185873605948,0.09929078014184398
"[1, 0, 0, 0, 0, 0, 0, 1, 0, 1, 1, 0, 0, 0, 1]",281,174,107,18,11,0.10344827586206896,0.102803738317757
"[1, 1, 1, 0, 1, 0, 0, 1, 0, 1, 1, 1, 0, 1, 0]",138,49,89,4,6,0.08163265306122448,0.06741573033707865
"[1, 0, 1, 1, 0, 1, 1, 0, 0, 1, 1, 1, 1, 0, 0]",328,125,203,3,20,0.024,0.09852216748768473
"[0, 0, 0, 0, 0, 1, 1, 0, 1, 0, 0, 1, 1, 1, 1]",269,170,99,24,12,0.1411764705882353,0.12121212121212122
"[1, 1, 0, 1, 0, 0, 1, 0, 1, 1, 0, 0, 0, 0, 1]",154,89,65,12,6,0.1348314606741573,0.09230769230769231
"[0, 0, 0, 0, 0, 1, 0, 1, 1, 0, 0, 0, 1, 1, 0]",272,187,85,14,6,0.0748663101604278,0.07058823529411765
"[0, 0, 0, 1, 0, 1, 0, 1, 1, 0, 1, 1, 1, 1, 1]",198,88,110,11,10,0.125,0.09090909090909091
"[0, 0, 1, 0, 1, 0, 1, 0, 0, 0, 1, 0, 0, 0, 1]",249,160,89,12,11,0.075,0.12359550561797752
"[1, 0, 0, 1, 1, 0, 1, 1, 1, 1, 1, 0, 0, 0, 0]",233,103,130,3,16,0.02912621359223301,0.12307692307692308
"[1, 0, 0, 1, 0, 1, 1, 1, 1, 1, 0, 0, 1, 1, 0]",246,108,138,9,22,0.08333333333333333,0.15942028985507245
"[0, 1, 0, 0, 0, 0, 0, 0, 1, 0, 0, 1, 1, 1, 1]",297,185,112,17,9,0.0918918918918919,0.08035714285714286
"[0, 0, 1, 1, 1, 0, 0, 1, 1, 0, 1, 1, 1, 0, 0]",145,72,73,9,10,0.125,0.136986301369863
"[0, 0, 0, 1, 1, 1, 0, 0, 1, 1, 0, 1, 1, 1, 0]",126,57,69,4,5,0.07017543859649122,0.07246376811594203
"[0, 1, 0, 0, 1, 0, 1, 0, 1, 1, 0, 1, 0, 0, 0]",124,75,49,7,5,0.09333333333333334,0.10204081632653061
"[1, 0, 1, 1, 0, 1, 1, 0, 0, 1, 0, 1, 0, 1, 1]",142,57,85,6,11,0.10526315789473684,0.12941176470588237
"[1, 1, 1, 0, 1, 1, 0, 1, 1, 0, 0, 1, 0, 1, 0]",131,43,88,4,15,0.09302325581395349,0.17045454545454544
"[0, 0, 0, 1, 1, 0, 0, 0, 1, 0, 1, 1, 0, 1, 1]",150,83,67,8,8,0.0963855421686747,0.11940298507462686
"[0, 0, 0, 0, 1, 1, 0, 0, 0, 1, 0, 1, 1, 0, 1]",168,90,78,9,3,0.1,0.038461538461538464
"[1, 1, 1, 1, 0, 1, 1, 1, 0, 0, 0, 0, 1, 1, 0]",315,131,184,12,18,0.0916030534351145,0.09782608695652174
"[0, 1, 0, 0, 0, 1, 0, 0, 1, 1, 1, 0, 0, 1, 0]",125,78,47,10,7,0.1282051282051282,0.14893617021276595
"[0, 1, 0, 0, 1, 0, 0, 0, 1, 0, 1, 1, 1, 0, 1]",105,55,50,4,1,0.07272727272727272,0.02
"[1, 0, 0, 1, 1, 0, 1, 1, 1, 1, 1, 0, 1, 0, 0]",162,61,101,4,8,0.06557377049180328,0.07920792079207921
"[1, 0, 1, 1, 1, 0, 0, 1, 1, 1, 1, 0, 1, 0, 1]",249,88,161,14,19,0.1590909090909091,0.11801242236024845
"[1, 1, 0, 1, 1, 0, 1, 0, 0, 0, 1, 1, 0, 0, 1]",148,66,82,4,5,0.06060606060606061,0.06097560975609756
"[0, 1, 0, 0, 0, 1, 0, 1, 1, 1, 0, 0, 1, 0, 0]",147,87,60,8,2,0.09195402298850575,0.03333333333333333
"[0, 1, 1, 0, 1, 1, 0, 0, 0, 1, 1, 1, 1, 1, 0]",165,66,99,8,10,0.12121212121212122,0.10101010101010101
"[0, 1, 1, 0, 1, 0, 1, 0, 1, 0, 1, 0, 1, 0, 1]",110,53,57,3,6,0.05660377358490566,0.10526315789473684
"[1, 1, 1, 0, 1, 1, 1, 0, 1, 1, 0, 0, 0, 1, 1]",296,96,200,7,23,0.07291666666666667,0.115
"[1, 1, 0, 0, 1, 0, 0, 0, 0, 0, 0, 0, 1, 1, 1]",401,229,172,19,14,0.08296943231441048,0.08139534883720931
"[0, 1, 0, 1, 1, 0, 1, 0, 0, 1, 1, 1, 1, 1, 1]",382,138,244,14,21,0.10144927536231885,0.0860655737704918
"[0, 0, 1, 1, 1, 0, 1, 0, 1, 1, 0, 0, 1, 0, 0]",101,58,43,5,3,0.08620689655172414,0.06976744186046512
"[0, 1, 0, 0, 0, 0, 0, 1, 0, 1, 0, 0, 1, 0, 1]",240,157,83,20,5,0.12738853503184713,0.060240963855421686
"[0, 1, 1, 1, 0, 0, 1, 1, 1, 0, 0, 1, 0, 0, 1]",150,74,76,5,6,0.06756756756756757,0.07894736842105263
"[0, 1, 0, 1, 1, 0, 1, 1, 1, 0, 1, 0, 0, 1, 1]",144,60,84,6,7,0.1,0.08333333333333333
"[0, 1, 0, 0, 1, 1, 0, 1, 1, 1, 0, 1, 0, 1, 1]",156,75,81,5,9,0.06666666666666667,0.1111111111111111
"[0, 1, 1, 0, 1, 0, 1, 0, 1, 1, 0, 0, 1, 0, 0]",104,52,52,3,2,0.057692307692307696,0.038461538461538464
"[1, 0, 1, 1, 0, 0, 0, 1, 1, 0, 0, 1, 0, 1, 0]",98,52,46,4,1,0.07692307692307693,0.021739130434782608
"[0, 0, 1, 1, 0, 1, 1, 0, 0, 0, 1, 1, 0, 0, 1]",178,88,90,5,10,0.056818181818181816,0.1111111111111111
"[1, 0, 0, 0, 1, 0, 1, 1, 1, 0, 1, 0, 0, 1, 1]",128,48,80,1,8,0.020833333333333332,0.1
"[0, 0, 1, 1, 1, 0, 0, 1, 1, 1, 0, 1, 0, 0, 0]",116,55,61,9,9,0.16363636363636364,0.14754098360655737
"[1, 0, 0, 0, 0, 0, 1, 1, 1, 1, 1, 0, 0, 1, 0]",169,76,93,6,8,0.07894736842105263,0.08602150537634409
"[0, 0, 1, 0, 1, 0, 1, 0, 1, 1, 0, 1, 0, 1, 0]",103,62,41,6,1,0.0967741935483871,0.024390243902439025
"[0, 1, 1, 1, 1, 1, 0, 0, 0, 1, 1, 1, 1, 0, 0]",274,126,148,17,10,0.1349206349206349,0.06756756756756757
"[1, 0, 1, 1, 0, 0, 0, 1, 1, 0, 0, 0, 0, 1, 1]",276,130,146,9,15,0.06923076923076923,0.10273972602739725
"[0, 1, 0, 0, 0, 1, 0, 1, 0, 1, 0, 1, 1, 1, 0]",119,63,56,6,6,0.09523809523809523,0.10714285714285714
"[0, 1, 0, 0, 1, 0, 1, 1, 0, 0, 1, 0, 0, 0, 1]",115,73,42,5,2,0.0684931506849315,0.047619047619047616
"[0, 1, 0, 0, 1, 1, 1, 0, 1, 0, 0, 0, 1, 0, 1]",123,64,59,6,4,0.09375,0.06779661016949153
"[0, 0, 1, 1, 0, 0, 1, 0, 1, 0, 0, 0, 1, 1, 1]",245,136,109,8,13,0.058823529411764705,0.11926605504587157
"[0, 1, 0, 0, 0, 0, 1, 0, 1, 1, 1, 1, 0, 0, 1]",167,85,82,11,7,0.12941176470588237,0.08536585365853659
"[1, 0, 0, 0, 0, 0, 1, 0, 1, 1, 0, 0, 0, 1, 0]",234,153,81,9,7,0.058823529411764705,0.08641975308641975
"[1, 1, 0, 0, 0, 1, 0, 0, 0, 1, 1, 0, 0, 1, 0]",142,85,57,11,7,0.12941176470588237,0.12280701754385964
"[1, 0, 1, 1, 0, 1, 0, 0, 1, 0, 0, 1, 0, 1, 1]",105,42,63,4,3,0.09523809523809523,0.047619047619047616
"[1, 0, 1, 1, 0, 1, 1, 0, 1, 0, 0, 1, 0, 0, 1]",117,52,65,5,4,0.09615384615384616,0.06153846153846154
"[1, 0, 0, 1, 0, 1, 1, 1, 1, 1, 0, 0, 0, 1, 1]",198,76,122,11,20,0.14473684210526316,0.16393442622950818
"[1, 1, 1, 1, 0, 1, 1, 1, 0, 0, 1, 0, 1, 0, 0]",150,76,74,9,11,0.11842105263157894,0.14864864864864866
"[0, 0, 1, 1, 1, 1, 1, 0, 1, 0, 0, 0, 0, 1, 0]",120,57,63,8,2,0.14035087719298245,0.031746031746031744
"[0, 0, 0, 1, 1, 1, 1, 1, 0, 1, 0, 0, 0, 0, 1]",153,88,65,11,5,0.125,0.07692307692307693
"[0, 0, 0, 0, 1, 0, 1, 1, 1, 0, 0, 0, 1, 1, 1]",183,118,65,15,2,0.1271186440677966,0.03076923076923077
"[1, 1, 0, 1, 1, 1, 1, 1, 0, 0, 1, 0, 0, 1, 1]",285,100,185,11,20,0.11,0.10810810810810811
"[1, 0, 1, 1, 1, 0, 1, 0, 0, 1, 1, 1, 0, 1, 0]",141,61,80,6,8,0.09836065573770492,0.1
"[0, 0, 1, 1, 1, 0, 0, 1, 1, 1, 1, 0, 0, 1, 0]",140,67,73,7,8,0.1044776119402985,0.1095890410958904
"[0, 1, 1, 1, 0, 0, 0, 0, 0, 0, 1, 0, 0, 1, 0]",268,178,90,15,9,0.08426966292134831,0.1
"[1, 0, 1, 1, 0, 1, 0, 1, 1, 0, 0, 0, 1, 0, 0]",100,54,46,4,7,0.07407407407407407,0.15217391304347827
"[1, 1, 0, 1, 1, 0, 1, 0, 1, 1, 0, 0, 0, 1, 0]",108,48,60,4,4,0.08333333333333333,0.06666666666666667
"[1, 1, 0, 0, 0, 0, 1, 1, 0, 1, 0, 1, 1, 0, 1]",137,63,74,6,8,0.09523809523809523,0.10810810810810811
"[0, 0, 0, 1, 0, 1, 1, 1, 1, 0, 1, 0, 0, 1, 0]",104,60,44,8,4,0.13333333333333333,0.09090909090909091
"[0, 0, 0, 1, 0, 0, 1, 1, 1, 0, 1, 0, 1, 0, 1]",100,50,50,5,7,0.1,0.14
"[0, 1, 1, 0, 0, 0, 1, 0, 1, 1, 0, 0, 0, 0, 1]",199,111,88,13,8,0.11711711711711711,0.09090909090909091
"[1, 0, 1, 0, 0, 0, 1, 1, 1, 1, 1, 1, 0, 1, 0]",159,68,91,9,4,0.1323529411764706,0.04395604395604396
"[0, 1, 1, 1, 1, 1, 1, 1, 1, 0, 1, 0, 0, 0, 1]",315,144,171,10,21,0.06944444444444445,0.12280701754385964
"[1, 1, 1, 1, 0, 0, 0, 0, 1, 0, 0, 0, 1, 0, 1]",159,84,75,7,3,0.08333333333333333,0.04
"[1, 0, 1, 1, 1, 0, 1, 0, 0, 1, 0, 1, 1, 1, 1]",286,96,190,13,11,0.13541666666666666,0.05789473684210526
"[1, 0, 1, 1, 0, 0, 1, 0, 1, 1, 0, 1, 1, 1, 1]",280,109,171,12,18,0.11009174311926606,0.10526315789473684
"[1, 1, 1, 0, 0, 0, 1, 1, 1, 1, 1, 0, 0, 0, 0]",266,128,138,8,15,0.0625,0.10869565217391304
"[1, 1, 0, 1, 0, 1, 1, 1, 1, 0, 1, 0, 1, 0, 0]",134,51,83,5,10,0.09803921568627451,0.12048192771084337
"[0, 0, 1, 0, 1, 1, 1, 0, 1, 0, 1, 1, 1, 1, 1]",287,100,187,12,23,0.12,0.12299465240641712
"[1, 0, 1, 0, 0, 0, 1, 0, 1, 1, 1, 1, 0, 0, 1]",132,52,80,4,4,0.07692307692307693,0.05
"[1, 0, 1, 0, 1, 0, 1, 0, 0, 1, 1, 1, 1, 0, 1]",123,44,79,2,10,0.045454545454545456,0.12658227848101267
"[1, 0, 1, 1, 0, 1, 0, 0, 0, 1, 0, 0, 0, 0, 0]",255,174,81,24,9,0.13793103448275862,0.1111111111111111
"[1, 0, 1, 1, 1, 0, 0, 1, 1, 0, 1, 1, 0, 1, 0]",142,62,80,6,5,0.0967741935483871,0.0625
"[0, 0, 0, 1, 0, 1, 1, 0, 1, 0, 0, 1, 1, 1, 0]",112,49,63,5,6,0.10204081632653061,0.09523809523809523
"[1, 0, 1, 1, 1, 0, 0, 0, 1, 1, 0, 0, 1, 1, 1]",268,103,165,7,10,0.06796116504854369,0.06060606060606061
"[0, 0, 0, 1, 0, 1, 1, 1, 0, 0, 0, 1, 1, 0, 0]",192,105,87,6,7,0.05714285714285714,0.08045977011494253
"[1, 1, 1, 1, 0, 1, 1, 0, 1, 0, 1, 1, 0, 0, 0]",194,85,109,7,9,0.08235294117647059,0.08256880733944955
"[1, 0, 1, 1, 1, 1, 1, 0, 0, 1, 0, 0, 1, 0, 0]",119,42,77,2,4,0.047619047619047616,0.05194805194805195
"[1, 0, 1, 1, 1, 0, 1, 1, 0, 0, 1, 0, 1, 0, 1]",146,61,85,6,6,0.09836065573770492,0.07058823529411765
"[0, 0, 0, 0, 0, 0, 1, 1, 1, 1, 0, 0, 1, 0, 0]",641,422,219,40,32,0.0947867298578199,0.1461187214611872
"[1, 0, 1, 0, 0, 1, 1, 1, 1, 0, 1, 1, 0, 0, 0]",133,62,71,6,13,0.0967741935483871,0.18309859154929578
"[0, 1, 0, 0, 0, 0, 1, 0, 1, 1, 1, 1, 1, 1, 0]",148,75,73,9,4,0.12,0.0547945205479452
"[0, 1, 0, 0, 1, 0, 0, 1, 1, 1, 1, 0, 1, 0, 0]",136,80,56,8,6,0.1,0.10714285714285714
"[1, 1, 0, 1, 0, 1, 0, 1, 1, 0, 0, 1, 1, 1, 1]",420,169,251,12,17,0.07100591715976332,0.06772908366533864
"[1, 1, 1, 0, 1, 1, 1, 1, 0, 1, 1, 1, 0, 1, 0]",492,128,364,12,39,0.09375,0.10714285714285714
"[1, 0, 1, 0, 0, 0, 1, 1, 0, 1, 0, 1, 1, 1, 1]",175,66,109,10,14,0.15151515151515152,0.12844036697247707
"[0, 0, 1, 0, 0, 1, 1, 0, 1, 0, 1, 0, 0, 0, 1]",151,100,51,11,6,0.11,0.11764705882352941
"[0, 1, 1, 1, 0, 0, 1, 1, 0, 1, 0, 1, 1, 1, 1]",293,120,173,9,14,0.075,0.08092485549132948
"[1, 1, 0, 1, 1, 1, 0, 1, 1, 1, 0, 0, 0, 1, 1]",259,93,166,10,15,0.10752688172043011,0.09036144578313253
"[1, 0, 0, 1, 1, 0, 0, 1, 1, 1, 1, 0, 0, 0, 1]",346,79,267,6,27,0.0759493670886076,0.10112359550561797
"[1, 1, 0, 1, 0, 0, 1, 1, 0, 1, 1, 1, 0, 0, 0]",144,62,82,5,4,0.08064516129032258,0.04878048780487805
"[1, 1, 1, 0, 0, 1, 0, 1, 1, 0, 1, 0, 0, 0, 1]",117,46,71,4,10,0.08695652173913043,0.14084507042253522
"[1, 1, 0, 0, 1, 1, 1, 1, 0, 0, 1, 0, 1, 1, 0]",224,89,135,8,14,0.0898876404494382,0.1037037037037037
"[1, 1, 1, 0, 1, 0, 1, 1, 1, 0, 0, 0, 0, 1, 0]",112,53,59,6,4,0.11320754716981132,0.06779661016949153
"[1, 1, 1, 0, 0, 1, 0, 1, 0, 1, 0, 0, 1, 1, 1]",199,72,127,7,8,0.09722222222222222,0.06299212598425197
"[0, 1, 1, 1, 0, 0, 1, 1, 1, 0, 1, 1, 1, 0, 1]",203,72,131,9,11,0.125,0.08396946564885496
"[1, 1, 0, 1, 0, 0, 0, 0, 0, 1, 1, 1, 0, 0, 1]",151,78,73,4,5,0.05128205128205128,0.0684931506849315
"[1, 1, 1, 1, 0, 1, 1, 0, 0, 0, 0, 1, 0, 0, 0]",116,53,63,5,8,0.09433962264150944,0.12698412698412698
"[1, 1, 1, 0, 0, 1, 1, 1, 0, 0, 0, 0, 1, 1, 1]",367,130,237,12,26,0.09230769230769231,0.10970464135021098
"[0, 1, 0, 1, 1, 1, 0, 0, 1, 1, 1, 0, 0, 0, 0]",149,69,80,3,2,0.043478260869565216,0.025
"[1, 0, 0, 1, 0, 1, 1, 0, 1, 0, 0, 0, 1, 1, 0]",118,65,53,6,5,0.09230769230769231,0.09433962264150944
"[0, 1, 1, 1, 0, 0, 1, 0, 1, 1, 0, 1, 0, 0, 0]",105,58,47,2,6,0.034482758620689655,0.1276595744680851
"[0, 1, 1, 1, 1, 0, 0, 1, 1, 1, 0, 0, 1, 0, 1]",208,116,92,7,12,0.0603448275862069,0.13043478260869565
"[1, 0, 1, 0, 1, 0, 0, 1, 0, 1, 0, 0, 1, 1, 1]",153,72,81,10,8,0.1388888888888889,0.09876543209876543
"[1, 0, 1, 1, 1, 0, 1, 0, 1, 0, 1, 0, 0, 1, 0]",107,47,60,4,8,0.0851063829787234,0.13333333333333333
"[0, 1, 1, 1, 0, 1, 1, 1, 0, 1, 0, 1, 0, 1, 0]",138,50,88,8,5,0.16,0.056818181818181816
"[1, 0, 0, 1, 1, 1, 0, 1, 1, 1, 0, 1, 0, 1, 0]",119,40,79,4,8,0.1,0.10126582278481013
"[0, 1, 0, 0, 1, 1, 0, 1, 1, 0, 0, 0, 1, 0, 1]",115,54,61,6,3,0.1111111111111111,0.04918032786885246
"[1, 0, 1, 0, 0, 1, 1, 0, 1, 1, 0, 0, 0, 1, 0]",110,62,48,4,4,0.06451612903225806,0.08333333333333333
"[0, 1, 1, 0, 1, 1, 0, 1, 1, 0, 1, 1, 1, 0, 1]",195,69,126,5,12,0.07246376811594203,0.09523809523809523
"[1, 0, 1, 0, 1, 1, 0, 1, 1, 0, 1, 1, 0, 1, 1]",199,80,119,6,8,0.075,0.06722689075630252
"[1, 1, 0, 0, 1, 1, 1, 1, 0, 1, 1, 0, 1, 0, 1]",278,100,178,4,22,0.04,0.12359550561797752
"[0, 0, 1, 0, 0, 0, 1, 1, 1, 1, 1, 1, 0, 0, 0]",340,215,125,21,16,0.09767441860465116,0.128
"[1, 0, 0, 0, 0, 0, 0, 1, 1, 0, 1, 1, 0, 1, 0]",178,87,91,9,8,0.10344827586206896,0.08791208791208792
"[0, 0, 1, 1, 1, 0, 0, 0, 0, 1, 0, 1, 0, 0, 0]",246,164,82,17,7,0.10365853658536585,0.08536585365853659
"[0, 0, 1, 0, 1, 1, 0, 1, 1, 1, 1, 1, 1, 1, 0]",286,103,183,10,18,0.0970873786407767,0.09836065573770492
"[1, 1, 1, 1, 1, 0, 1, 0, 0, 1, 0, 1, 1, 0, 1]",217,62,155,7,10,0.11290322580645161,0.06451612903225806
"[0, 0, 1, 0, 1, 0, 0, 1, 0, 0, 1, 1, 0, 0, 0]",328,211,117,24,14,0.11374407582938388,0.11965811965811966
"[1, 0, 1, 0, 1, 1, 1, 1, 1, 1, 1, 0, 0, 0, 0]",422,169,253,15,32,0.08875739644970414,0.12648221343873517
"[1, 1, 1, 0, 0, 1, 0, 0, 0, 1, 0, 0, 0, 1, 0]",156,85,71,13,10,0.15294117647058825,0.14084507042253522
"[0, 0, 1, 0, 1, 1, 0, 1, 1, 1, 0, 0, 1, 1, 1]",239,109,130,16,8,0.14678899082568808,0.06153846153846154
"[0, 0, 0, 1, 1, 0, 1, 0, 0, 1, 0, 1, 1, 1, 1]",158,92,66,7,8,0.07608695652173914,0.12121212121212122
"[0, 0, 1, 0, 1, 0, 1, 0, 1, 1, 0, 1, 1, 0, 0]",130,76,54,6,2,0.07894736842105263,0.037037037037037035
"[1, 0, 1, 1, 1, 1, 0, 1, 1, 1, 0, 0, 1, 0, 1]",213,80,133,11,15,0.1375,0.11278195488721804
"[1, 1, 1, 1, 0, 1, 0, 1, 0, 0, 0, 1, 1, 1, 1]",351,120,231,8,22,0.06666666666666667,0.09523809523809523
"[0, 1, 1, 0, 1, 0, 0, 1, 1, 0, 1, 1, 1, 1, 1]",301,108,193,7,22,0.06481481481481481,0.11398963730569948
"[0, 1, 0, 0, 1, 0, 1, 0, 1, 1, 0, 1, 0, 1, 0]",112,66,46,7,3,0.10606060606060606,0.06521739130434782
"[1, 0, 0, 0, 1, 1, 0, 0, 1, 1, 1, 1, 0, 1, 0]",152,76,76,10,9,0.13157894736842105,0.11842105263157894
"[0, 0, 1, 1, 0, 0, 1, 1, 1, 1, 0, 0, 1, 0, 0]",309,171,138,19,14,0.1111111111111111,0.10144927536231885
"[0, 1, 1, 0, 0, 1, 0, 0, 0, 1, 0, 0, 1, 1, 1]",193,115,78,10,17,0.08695652173913043,0.21794871794871795
"[1, 0, 0, 1, 1, 0, 1, 0, 1, 0, 0, 0, 1, 0, 0]",155,85,70,10,6,0.11764705882352941,0.08571428571428572
"[1, 1, 0, 1, 0, 0, 0, 0, 0, 0, 1, 1, 0, 0, 1]",314,176,138,21,11,0.11931818181818182,0.07971014492753623
"[1, 0, 1, 0, 0, 0, 1, 1, 0, 0, 0, 0, 0, 1, 0]",262,157,105,10,12,0.06369426751592357,0.11428571428571428
"[0, 0, 1, 0, 1, 0, 0, 1, 0, 1, 0, 0, 1, 0, 1]",126,69,57,8,13,0.11594202898550725,0.22807017543859648
"[1, 1, 0, 1, 1, 0, 0, 0, 1, 0, 1, 1, 0, 0, 1]",128,64,64,5,7,0.078125,0.109375
"[0, 1, 0, 1, 1, 1, 0, 1, 0, 0, 0, 0, 1, 0, 0]",133,83,50,6,7,0.07228915662650602,0.14
"[0, 1, 1, 0, 1, 0, 1, 1, 0, 0, 0, 1, 0, 0, 1]",122,66,56,10,5,0.15151515151515152,0.08928571428571429
"[1, 0, 0, 1, 0, 0, 0, 1, 1, 1, 1, 1, 0, 0, 0]",173,92,81,8,11,0.08695652173913043,0.13580246913580246
"[0, 1, 0, 1, 0, 0, 1, 1, 1, 1, 0, 1, 0, 0, 1]",106,43,63,3,6,0.06976744186046512,0.09523809523809523
"[1, 1, 1, 1, 0, 0, 1, 0, 0, 0, 1, 1, 1, 0, 1]",127,52,75,6,10,0.11538461538461539,0.13333333333333333
"[0, 0, 1, 1, 0, 1, 1, 0, 0, 0, 1, 1, 1, 0, 1]",110,51,59,4,5,0.0784313725490196,0.0847457627118644
"[1, 0, 0, 1, 1, 0, 1, 1, 0, 0, 0, 1, 1, 1, 0]",117,57,60,4,2,0.07017543859649122,0.03333333333333333
"[1, 0, 0, 1, 1, 0, 0, 1, 0, 1, 0, 1, 0, 0, 0]",168,89,79,13,11,0.14606741573033707,0.13924050632911392
"[1, 0, 0, 0, 1, 1, 0, 1, 1, 0, 1, 1, 1, 1, 1]",307,103,204,18,23,0.17475728155339806,0.11274509803921569
"[1, 0, 0, 1, 0, 1, 1, 0, 0, 1, 0, 0, 1, 1, 1]",157,69,88,7,4,0.10144927536231885,0.045454545454545456
"[0, 0, 1, 1, 0, 0, 1, 0, 1, 1, 0, 0, 1, 0, 0]",173,115,58,11,6,0.09565217391304348,0.10344827586206896
"[1, 0, 0, 1, 1, 0, 0, 1, 0, 1, 1, 0, 0, 1, 0]",112,60,52,8,6,0.13333333333333333,0.11538461538461539
"[0, 0, 0, 1, 0, 1, 0, 0, 0, 0, 1, 0, 1, 0, 1]",250,145,105,18,12,0.12413793103448276,0.11428571428571428
"[1, 0, 0, 1, 1, 1, 0, 1, 1, 0, 0, 0, 0, 1, 1]",219,79,140,11,11,0.13924050632911392,0.07857142857142857
"[1, 0, 0, 0, 1, 1, 0, 1, 1, 0, 1, 1, 0, 1, 1]",156,62,94,8,9,0.12903225806451613,0.09574468085106383
"[1, 0, 0, 1, 0, 1, 1, 0, 1, 0, 1, 0, 1, 0, 0]",93,56,37,8,4,0.14285714285714285,0.10810810810810811
"[1, 1, 0, 0, 1, 0, 1, 0, 1, 0, 0, 1, 1, 0, 0]",175,92,83,9,11,0.09782608695652174,0.13253012048192772
"[0, 1, 1, 1, 1, 1, 1, 0, 1, 0, 0, 0, 1, 0, 0]",109,55,54,5,8,0.09090909090909091,0.14814814814814814
"[0, 0, 1, 1, 1, 1, 1, 1, 0, 1, 0, 0, 0, 1, 0]",128,58,70,7,7,0.1206896551724138,0.1
"[0, 0, 0, 0, 1, 1, 1, 1, 1, 0, 0, 0, 0, 1, 1]",436,249,187,15,14,0.060240963855421686,0.0748663101604278
"[0, 1, 0, 1, 0, 0, 1, 1, 0, 1, 0, 0, 0, 1, 0]",131,79,52,9,3,0.11392405063291139,0.057692307692307696
"[0, 1, 1, 0, 0, 1, 1, 1, 1, 1, 1, 0, 0, 0, 1]",400,259,141,30,15,0.11583011583011583,0.10638297872340426
"[1, 0, 1, 1, 1, 1, 0, 0, 1, 0, 1, 1, 0, 0, 1]",165,55,110,4,13,0.07272727272727272,0.11818181818181818
"[1, 1, 1, 0, 1, 0, 0, 0, 1, 0, 1, 1, 0, 1, 1]",144,72,72,6,9,0.08333333333333333,0.125
"[0, 1, 1, 1, 1, 0, 1, 1, 0, 1, 0, 1, 0, 1, 0]",137,69,68,8,4,0.11594202898550725,0.058823529411764705
"[1, 0, 0, 1, 0, 1, 0, 0, 0, 1, 1, 1, 0, 0, 1]",127,65,62,5,10,0.07692307692307693,0.16129032258064516
"[1, 0, 1, 0, 0, 0, 0, 1, 0, 1, 0, 0, 1, 1, 1]",154,86,68,6,5,0.06976744186046512,0.07352941176470588
"[0, 1, 1, 0, 1, 1, 0, 1, 0, 0, 1, 0, 0, 1, 1]",138,68,70,6,7,0.08823529411764706,0.1
"[0, 1, 0, 0, 1, 1, 0, 0, 1, 0, 0, 1, 0, 1, 0]",140,95,45,6,3,0.06315789473684211,0.06666666666666667
"[1, 0, 0, 1, 1, 0, 0, 1, 1, 0, 1, 0, 0, 1, 0]",148,61,87,4,7,0.06557377049180328,0.08045977011494253
"[1, 0, 1, 1, 1, 1, 0, 0, 0, 1, 0, 1, 0, 1, 0]",100,45,55,8,5,0.17777777777777778,0.09090909090909091
"[0, 1, 0, 0, 0, 1, 1, 1, 0, 0, 0, 1, 0, 0, 0]",244,146,98,14,7,0.0958904109589041,0.07142857142857142
"[0, 1, 0, 1, 1, 1, 0, 1, 0, 1, 0, 1, 1, 1, 1]",278,101,177,7,17,0.06930693069306931,0.096045197740113
"[1, 0, 1, 0, 1, 1, 1, 0, 1, 0, 1, 0, 1, 1, 1]",234,72,162,8,14,0.1111111111111111,0.08641975308641975
"[0, 0, 0, 0, 0, 1, 0, 0, 0, 1, 0, 1, 1, 1, 1]",266,183,83,10,6,0.0546448087431694,0.07228915662650602
"[0, 1, 1, 1, 1, 0, 1, 0, 0, 0, 1, 1, 1, 0, 1]",152,67,85,7,9,0.1044776119402985,0.10588235294117647
"[1, 1, 0, 0, 0, 1, 1, 1, 0, 0, 1, 1, 1, 0, 1]",157,60,97,4,10,0.06666666666666667,0.10309278350515463
"[0, 1, 0, 0, 1, 1, 0, 1, 0, 0, 1, 1, 1, 1, 0]",157,78,79,3,5,0.038461538461538464,0.06329113924050633
"[1, 0, 0, 0, 1, 0, 0, 1, 1, 0, 1, 0, 0, 1, 1]",136,66,70,3,3,0.045454545454545456,0.04285714285714286
"[1, 1, 0, 1, 1, 1, 0, 1, 0, 0, 0, 1, 1, 0, 0]",146,60,86,9,8,0.15,0.09302325581395349
"[1, 1, 0, 1, 0, 0, 1, 0, 1, 1, 1, 0, 1, 0, 1]",137,54,83,4,5,0.07407407407407407,0.060240963855421686
"[0, 1, 0, 0, 1, 0, 0, 1, 1, 1, 1, 0, 1, 1, 0]",116,58,58,1,5,0.017241379310344827,0.08620689655172414
"[1, 0, 1, 0, 0, 0, 0, 0, 0, 1, 0, 1, 0, 1, 1]",168,93,75,8,6,0.08602150537634409,0.08
"[0, 1, 1, 0, 0, 1, 1, 0, 0, 1, 1, 0, 1, 1, 1]",460,317,143,23,15,0.07255520504731862,0.1048951048951049
"[0, 1, 1, 1, 0, 1, 0, 1, 0, 0, 0, 0, 1, 0, 1]",103,60,43,10,3,0.16666666666666666,0.06976744186046512
"[1, 0, 0, 1, 1, 0, 0, 1, 0, 0, 0, 1, 0, 1, 0]",129,67,62,8,4,0.11940298507462686,0.06451612903225806
"[1, 0, 1, 0, 0, 1, 1, 0, 0, 1, 1, 0, 0, 1, 1]",404,200,204,21,14,0.105,0.06862745098039216
"[0, 0, 0, 1, 1, 1, 0, 1, 0, 0, 1, 1, 0, 0, 1]",149,90,59,9,6,0.1,0.1016949152542373
"[0, 1, 0, 0, 0, 0, 1, 0, 0, 0, 0, 1, 1, 1, 0]",256,161,95,15,8,0.09316770186335403,0.08421052631578947
"[0, 1, 1, 0, 1, 1, 0, 0, 0, 1, 1, 0, 0, 1, 1]",232,119,113,8,14,0.06722689075630252,0.12389380530973451
"[0, 0, 1, 0, 1, 1, 0, 1, 1, 0, 1, 1, 0, 0, 0]",116,62,54,3,1,0.04838709677419355,0.018518518518518517
"[1, 0, 0, 0, 1, 1, 1, 0, 0, 0, 1, 1, 1, 1, 1]",315,100,215,7,11,0.07,0.05116279069767442
"[0, 0, 1, 1, 0, 1, 0, 0, 0, 0, 0, 0, 1, 0, 1]",250,166,84,19,8,0.1144578313253012,0.09523809523809523
"[0, 1, 0, 1, 1, 1, 0, 0, 0, 1, 1, 0, 0, 1, 0]",101,52,49,7,8,0.1346153846153846,0.16326530612244897
"[0, 0, 0, 0, 1, 1, 1, 0, 0, 0, 0, 1, 0, 0, 1]",304,191,113,18,10,0.09424083769633508,0.08849557522123894
"[1, 1, 0, 0, 0, 0, 1, 1, 1, 0, 0, 0, 0, 1, 0]",180,101,79,14,8,0.13861386138613863,0.10126582278481013
"[0, 0, 0, 1, 1, 1, 0, 0, 0, 0, 1, 0, 1, 1, 0]",163,87,76,6,3,0.06896551724137931,0.039473684210526314
"[1, 0, 0, 0, 1, 0, 1, 1, 1, 0, 1, 1, 0, 1, 1]",158,56,102,4,7,0.07142857142857142,0.06862745098039216
"[1, 1, 1, 1, 0, 0, 0, 0, 0, 0, 0, 1, 1, 0, 1]",235,117,118,10,8,0.08547008547008547,0.06779661016949153
"[0, 0, 0, 0, 1, 1, 0, 1, 0, 1, 0, 1, 1, 1, 1]",182,84,98,5,8,0.05952380952380952,0.08163265306122448
"[0, 1, 0, 0, 0, 1, 1, 1, 0, 1, 1, 0, 0, 1, 1]",143,75,68,6,7,0.08,0.10294117647058823
"[0, 0, 0, 0, 1, 0, 1, 0, 0, 1, 1, 0, 0, 0, 1]",287,173,114,30,12,0.17341040462427745,0.10526315789473684
"[1, 0, 1, 0, 1, 0, 1, 1, 1, 0, 1, 0, 0, 1, 1]",154,64,90,5,12,0.078125,0.13333333333333333
"[0, 0, 1, 0, 1, 1, 0, 1, 1, 0, 0, 0, 0, 0, 0]",340,222,118,16,7,0.07207207207207207,0.059322033898305086
"[1, 0, 0, 1, 1, 1, 1, 0, 1, 0, 0, 1, 1, 0, 1]",163,62,101,6,10,0.0967741935483871,0.09900990099009901
"[1, 0, 1, 0, 0, 1, 1, 0, 1, 0, 0, 1, 1, 1, 0]",106,48,58,6,9,0.125,0.15517241379310345
"[0, 0, 1, 0, 0, 0, 1, 1, 1, 1, 1, 1, 0, 0, 1]",253,122,131,9,10,0.07377049180327869,0.07633587786259542
"[1, 0, 0, 0, 1, 1, 1, 0, 1, 0, 1, 0, 0, 0, 0]",164,96,68,8,3,0.08333333333333333,0.04411764705882353
"[0, 1, 1, 1, 1, 0, 0, 1, 1, 1, 0, 1, 1, 0, 1]",320,134,186,14,13,0.1044776119402985,0.06989247311827956
"[1, 0, 0, 0, 0, 1, 0, 1, 1, 0, 1, 0, 1, 0, 0]",140,82,58,6,7,0.07317073170731707,0.1206896551724138
"[0, 1, 1, 1, 0, 1, 0, 0, 1, 0, 0, 1, 0, 1, 0]",98,48,50,5,3,0.10416666666666667,0.06
"[1, 1, 0, 0, 1, 1, 1, 0, 1, 0, 0, 1, 0, 0, 1]",139,69,70,9,8,0.13043478260869565,0.11428571428571428
"[0, 1, 0, 1, 1, 0, 0, 1, 1, 1, 0, 1, 0, 0, 1]",121,64,57,8,9,0.125,0.15789473684210525
"[1, 1, 1, 0, 0, 0, 0, 0, 0, 0, 1, 1, 1, 0, 1]",194,82,112,5,16,0.06097560975609756,0.14285714285714285
"[0, 0, 1, 1, 0, 1, 0, 0, 1, 0, 1, 0, 0, 1, 1]",126,74,52,10,4,0.13513513513513514,0.07692307692307693
"[0, 0, 1, 1, 0, 1, 0, 0, 1, 0, 1, 1, 1, 0, 0]",133,71,62,5,6,0.07042253521126761,0.0967741935483871
"[0, 1, 1, 0, 0, 1, 0, 1, 0, 1, 1, 0, 0, 1, 1]",195,96,99,8,9,0.08333333333333333,0.09090909090909091
"[0, 1, 1, 0, 0, 1, 0, 1, 0, 0, 1, 1, 0, 1, 1]",119,60,59,7,4,0.11666666666666667,0.06779661016949153
"[1, 0, 0, 1, 0, 0, 1, 0, 0, 1, 1, 1, 0, 0, 0]",163,99,64,7,8,0.0707070707070707,0.125
"[0, 1, 0, 1, 1, 1, 1, 0, 1, 0, 0, 1, 1, 1, 0]",137,57,80,5,10,0.08771929824561403,0.125
"[1, 0, 1, 0, 1, 0, 1, 0, 1, 0, 1, 1, 1, 1, 1]",281,110,171,10,18,0.09090909090909091,0.10526315789473684
"[0, 0, 0, 0, 1, 1, 1, 0, 0, 0, 1, 0, 1, 1, 0]",159,92,67,8,4,0.08695652173913043,0.05970149253731343
"[1, 1, 0, 1, 1, 0, 1, 1, 0, 0, 0, 1, 0, 1, 0]",105,50,55,5,7,0.1,0.12727272727272726
"[1, 1, 1, 0, 1, 1, 0, 1, 1, 0, 0, 0, 1, 0, 1]",141,50,91,2,7,0.04,0.07692307692307693
"[1, 0, 1, 1, 1, 0, 1, 1, 0, 0, 1, 0, 1, 0, 0]",113,53,60,5,3,0.09433962264150944,0.05
"[1, 0, 0, 1, 1, 1, 0, 1, 1, 1, 0, 0, 1, 0, 1]",164,57,107,4,12,0.07017543859649122,0.11214953271028037
"[1, 1, 0, 0, 0, 0, 1, 0, 1, 1, 1, 1, 1, 0, 0]",174,85,89,4,3,0.047058823529411764,0.033707865168539325
"[0, 0, 1, 1, 1, 0, 1, 0, 1, 0, 1, 0, 1, 1, 1]",171,72,99,12,11,0.16666666666666666,0.1111111111111111
"[1, 0, 1, 1, 1, 1, 1, 1, 1, 0, 0, 0, 0, 0, 1]",262,110,152,11,16,0.1,0.10526315789473684
"[0, 0, 0, 1, 1, 0, 1, 0, 0, 0, 1, 1, 0, 1, 1]",147,91,56,8,7,0.08791208791208792,0.125
"[1, 0, 1, 1, 0, 1, 1, 1, 1, 1, 0, 0, 0, 1, 0]",119,54,65,5,3,0.09259259259259259,0.046153846153846156
"[1, 0, 0, 1, 1, 0, 1, 0, 0, 1, 1, 0, 1, 0, 0]",115,53,62,6,6,0.11320754716981132,0.0967741935483871
"[0, 1, 1, 0, 1, 0, 1, 1, 1, 1, 0, 0, 1, 0, 1]",147,52,95,3,7,0.057692307692307696,0.07368421052631578
"[1, 1, 0, 0, 1, 0, 1, 1, 0, 0, 0, 0, 1, 1, 0]",182,98,84,9,7,0.09183673469387756,0.08333333333333333
"[0, 1, 1, 0, 0, 1, 0, 1, 1, 0, 0, 0, 0, 1, 1]",206,125,81,14,10,0.112,0.12345679012345678
"[1, 0, 0, 0, 0, 1, 0, 0, 0, 1, 0, 1, 1, 1, 0]",151,88,63,9,7,0.10227272727272728,0.1111111111111111
"[0, 1, 0, 1, 1, 1, 0, 1, 1, 1, 0, 1, 1, 1, 1]",575,181,394,22,34,0.12154696132596685,0.08629441624365482
"[1, 1, 1, 0, 1, 1, 0, 1, 1, 1, 1, 0, 1, 0, 0]",246,83,163,8,22,0.0963855421686747,0.13496932515337423
"[1, 1, 0, 1, 1, 1, 0, 0, 0, 1, 1, 0, 0, 1, 1]",238,96,142,16,13,0.16666666666666666,0.09154929577464789
"[1, 0, 0, 0, 1, 1, 0, 0, 0, 0, 0, 1, 1, 0, 0]",405,235,170,19,12,0.08085106382978724,0.07058823529411765
"[0, 0, 1, 1, 0, 0, 1, 0, 0, 0, 1, 1, 1, 0, 0]",197,110,87,5,5,0.045454545454545456,0.05747126436781609
"[1, 1, 1, 0, 1, 1, 1, 1, 1, 1, 0, 0, 1, 0, 1]",540,135,405,15,30,0.1111111111111111,0.07407407407407407
"[0, 1, 0, 1, 1, 1, 1, 0, 1, 1, 0, 0, 1, 0, 1]",130,39,91,1,11,0.02564102564102564,0.12087912087912088
"[1, 1, 0, 1, 0, 0, 1, 0, 0, 0, 1, 0, 0, 0, 1]",144,81,63,7,9,0.08641975308641975,0.14285714285714285
"[1, 0, 1, 0, 0, 0, 0, 1, 0, 0, 0, 1, 1, 0, 0]",299,194,105,15,3,0.07731958762886598,0.02857142857142857
"[0, 0, 1, 1, 0, 0, 0, 0, 1, 1, 1, 0, 1, 1, 0]",214,120,94,12,9,0.1,0.09574468085106383
"[1, 1, 1, 1, 1, 0, 1, 0, 0, 0, 1, 0, 0, 0, 1]",110,46,64,5,13,0.10869565217391304,0.203125
"[1, 1, 1, 1, 1, 1, 1, 1, 0, 1, 0, 0, 0, 1, 0]",294,106,188,9,21,0.08490566037735849,0.11170212765957446
"[0, 1, 0, 0, 1, 1, 1, 1, 0, 1, 1, 1, 1, 0, 1]",251,85,166,9,17,0.10588235294117647,0.10240963855421686
"[1, 0, 1, 0, 0, 1, 0, 1, 0, 0, 0, 1, 0, 1, 0]",120,62,58,6,4,0.0967741935483871,0.06896551724137931
"[1, 0, 0, 0, 0, 1, 0, 1, 1, 0, 1, 0, 0, 1, 0]",113,66,47,6,7,0.09090909090909091,0.14893617021276595
"[1, 0, 1, 1, 1, 0, 1, 0, 1, 0, 1, 1, 0, 0, 0]",128,56,72,3,5,0.05357142857142857,0.06944444444444445
"[0, 1, 0, 0, 0, 0, 1, 1, 0, 0, 0, 1, 0, 1, 0]",276,182,94,20,8,0.10989010989010989,0.0851063829787234
"[0, 0, 0, 0, 1, 1, 1, 0, 1, 0, 0, 1, 1, 1, 1]",258,122,136,7,13,0.05737704918032787,0.09558823529411764
"[0, 1, 1, 0, 0, 1, 0, 0, 0, 1, 1, 1, 0, 1, 1]",128,69,59,4,5,0.057971014492753624,0.0847457627118644
"[1, 1, 1, 1, 0, 0, 0, 0, 1, 0, 0, 1, 0, 1, 0]",128,65,63,6,3,0.09230769230769231,0.047619047619047616
"[1, 1, 0, 0, 0, 0, 1, 1, 1, 0, 0, 1, 0, 0, 1]",189,94,95,9,11,0.09574468085106383,0.11578947368421053
"[1, 1, 0, 0, 1, 0, 0, 0, 0, 1, 0, 1, 1, 0, 1]",127,65,62,6,4,0.09230769230769231,0.06451612903225806
"[0, 1, 0, 1, 0, 1, 1, 1, 0, 0, 1, 0, 0, 1, 1]",129,68,61,5,7,0.07352941176470588,0.11475409836065574
"[0, 1, 0, 1, 0, 1, 1, 0, 0, 0, 0, 0, 1, 1, 1]",202,110,92,15,8,0.13636363636363635,0.08695652173913043
"[0, 0, 0, 0, 0, 1, 1, 0, 1, 1, 1, 1, 0, 1, 1]",160,90,70,10,5,0.1111111111111111,0.07142857142857142
"[0, 0, 0, 0, 0, 0, 1, 1, 0, 1, 1, 1, 1, 0, 1]",168,88,80,6,11,0.06818181818181818,0.1375
"[0, 0, 1, 1, 0, 1, 0, 0, 1, 1, 0, 1, 0, 1, 0]",105,65,40,4,2,0.06153846153846154,0.05
"[0, 0, 1, 0, 0, 1, 0, 0, 1, 1, 1, 1, 0, 1, 1]",128,58,70,8,7,0.13793103448275862,0.1
"[1, 0, 1, 1, 1, 0, 0, 0, 1, 0, 0, 1, 0, 0, 1]",120,54,66,1,6,0.018518518518518517,0.09090909090909091
"[0, 1, 1, 1, 1, 0, 0, 0, 1, 1, 0, 0, 1, 1, 0]",238,130,108,21,12,0.16153846153846155,0.1111111111111111
"[0, 0, 1, 1, 1, 1, 0, 0, 0, 1, 1, 0, 0, 1, 1]",321,154,167,13,17,0.08441558441558442,0.10179640718562874
"[1, 1, 0, 0, 1, 1, 0, 0, 1, 1, 1, 0, 0, 1, 1]",403,158,245,12,17,0.0759493670886076,0.06938775510204082
"[1, 0, 0, 0, 0, 1, 0, 0, 1, 0, 0, 1, 0, 1, 0]",229,132,97,9,9,0.06818181818181818,0.09278350515463918
"[0, 0, 0, 1, 1, 1, 1, 1, 0, 0, 0, 1, 0, 0, 0]",175,111,64,12,11,0.10810810810810811,0.171875
"[1, 0, 1, 0, 0, 1, 0, 1, 0, 1, 1, 1, 0, 0, 1]",120,53,67,2,3,0.03773584905660377,0.04477611940298507
"[1, 1, 0, 1, 1, 0, 0, 1, 0, 0, 0, 0, 0, 0, 1]",198,118,80,12,10,0.1016949152542373,0.125
"[1, 1, 1, 0, 0, 0, 1, 1, 0, 0, 1, 0, 0, 0, 1]",115,59,56,9,11,0.15254237288135594,0.19642857142857142
"[0, 0, 1, 1, 1, 1, 0, 1, 0, 1, 1, 0, 0, 1, 0]",112,59,53,6,5,0.1016949152542373,0.09433962264150944
"[0, 1, 0, 0, 0, 0, 0, 1, 0, 0, 0, 1, 1, 1, 1]",293,182,111,24,13,0.13186813186813187,0.11711711711711711
"[0, 1, 0, 0, 0, 0, 0, 1, 1, 0, 1, 0, 1, 0, 0]",250,164,86,20,8,0.12195121951219512,0.09302325581395349
"[0, 0, 1, 0, 1, 1, 0, 0, 0, 0, 0, 0, 1, 0, 1]",243,167,76,14,7,0.08383233532934131,0.09210526315789473
"[0, 0, 0, 1, 1, 1, 1, 0, 1, 1, 0, 0, 0, 1, 1]",186,114,72,15,10,0.13157894736842105,0.1388888888888889
"[0, 1, 0, 1, 1, 1, 1, 1, 0, 1, 0, 0, 0, 0, 1]",133,62,71,6,3,0.0967741935483871,0.04225352112676056
"[0, 0, 1, 1, 0, 1, 0, 1, 0, 1, 1, 0, 1, 0, 1]",92,40,52,2,3,0.05,0.057692307692307696
"[1, 1, 0, 0, 1, 1, 0, 1, 1, 1, 0, 1, 0, 1, 0]",160,68,92,4,11,0.058823529411764705,0.11956521739130435
"[1, 1, 0, 1, 1, 0, 0, 0, 0, 1, 1, 1, 0, 1, 1]",180,69,111,8,10,0.11594202898550725,0.09009009009009009
"[0, 1, 0, 0, 1, 0, 0, 1, 1, 0, 1, 0, 1, 1, 1]",134,68,66,8,8,0.11764705882352941,0.12121212121212122
"[1, 0, 1, 0, 0, 1, 0, 0, 1, 1, 0, 1, 0, 1, 1]",126,74,52,6,9,0.08108108108108109,0.17307692307692307
"[0, 1, 1, 0, 1, 0, 1, 0, 1, 1, 1, 0, 0, 1, 0]",116,55,61,6,8,0.10909090909090909,0.13114754098360656
"[0, 0, 1, 0, 1, 0, 1, 1, 0, 0, 0, 1, 0, 0, 1]",136,77,59,12,2,0.15584415584415584,0.03389830508474576
"[0, 0, 1, 0, 0, 1, 1, 0, 1, 1, 1, 1, 1, 0, 0]",148,68,80,10,8,0.14705882352941177,0.1
"[1, 0, 0, 1, 0, 0, 0, 0, 1, 1, 1, 1, 0, 0, 0]",388,223,165,18,20,0.08071748878923767,0.12121212121212122
"[1, 0, 1, 1, 0, 1, 0, 1, 0, 1, 0, 0, 1, 0, 0]",105,57,48,8,4,0.14035087719298245,0.08333333333333333
"[1, 1, 1, 0, 1, 1, 1, 0, 1, 0, 1, 0, 0, 1, 0]",132,56,76,6,9,0.10714285714285714,0.11842105263157894
"[1, 0, 0, 0, 0, 0, 0, 1, 1, 1, 0, 1, 1, 1, 0]",169,62,107,12,8,0.1935483870967742,0.07476635514018691
"[0, 1, 0, 0, 0, 1, 0, 1, 1, 0, 0, 1, 0, 1, 0]",123,73,50,9,3,0.1232876712328767,0.06
"[1, 0, 1, 1, 0, 0, 0, 1, 0, 0, 0, 1, 0, 1, 1]",117,63,54,4,6,0.06349206349206349,0.1111111111111111
"[1, 0, 1, 0, 0, 0, 1, 1, 0, 1, 0, 0, 1, 1, 0]",125,73,52,6,5,0.0821917808219178,0.09615384615384616
"[0, 1, 1, 1, 1, 0, 1, 1, 0, 1, 0, 0, 0, 1, 1]",169,72,97,10,12,0.1388888888888889,0.12371134020618557
"[1, 0, 1, 0, 1, 1, 0, 0, 1, 0, 0, 1, 1, 1, 1]",200,84,116,7,13,0.08333333333333333,0.11206896551724138
"[0, 1, 0, 1, 1, 1, 1, 1, 0, 0, 0, 0, 0, 0, 1]",294,149,145,6,16,0.040268456375838924,0.1103448275862069
"[0, 0, 0, 1, 1, 1, 0, 1, 1, 1, 0, 0, 0, 1, 1]",146,75,71,3,4,0.04,0.056338028169014086
"[1, 0, 0, 0, 1, 1, 1, 0, 1, 1, 1, 0, 0, 0, 1]",114,52,62,6,5,0.11538461538461539,0.08064516129032258
"[1, 1, 0, 0, 1, 0, 0, 1, 0, 1, 1, 0, 0, 0, 1]",106,51,55,5,7,0.09803921568627451,0.12727272727272726
"[0, 1, 0, 1, 1, 0, 1, 1, 0, 0, 1, 0, 0, 1, 0]",111,53,58,4,5,0.07547169811320754,0.08620689655172414
"[1, 0, 1, 1, 0, 0, 1, 0, 0, 1, 1, 1, 0, 0, 1]",143,60,83,7,9,0.11666666666666667,0.10843373493975904
"[1, 0, 1, 1, 1, 1, 0, 0, 1, 0, 0, 0, 1, 0, 0]",93,59,34,12,8,0.2033898305084746,0.23529411764705882
"[0, 1, 1, 1, 0, 0, 0, 0, 0, 1, 1, 1, 0, 1, 1]",154,84,70,12,9,0.14285714285714285,0.12857142857142856
"[1, 1, 1, 1, 1, 0, 0, 1, 1, 1, 0, 1, 1, 0, 0]",369,108,261,14,32,0.12962962962962962,0.12260536398467432
"[1, 1, 1, 0, 0, 1, 0, 0, 0, 1, 0, 0, 1, 0, 0]",138,78,60,6,10,0.07692307692307693,0.16666666666666666
"[1, 1, 1, 1, 1, 0, 0, 1, 0, 0, 0, 1, 0, 0, 1]",138,57,81,5,4,0.08771929824561403,0.04938271604938271
"[0, 0, 1, 1, 0, 0, 1, 0, 0, 0, 0, 1, 0, 1, 1]",203,116,87,16,6,0.13793103448275862,0.06896551724137931
"[1, 0, 1, 1, 0, 0, 1, 1, 1, 1, 0, 0, 1, 0, 1]",183,72,111,6,10,0.08333333333333333,0.09009009009009009
"[0, 1, 1, 0, 0, 1, 1, 1, 1, 0, 1, 1, 1, 0, 1]",294,129,165,18,13,0.13953488372093023,0.07878787878787878
"[1, 0, 0, 0, 1, 0, 0, 0, 0, 0, 0, 1, 1, 1, 0]",281,171,110,15,9,0.08771929824561403,0.08181818181818182
"[1, 1, 0, 0, 0, 1, 0, 1, 0, 0, 1, 0, 0, 1, 0]",141,80,61,6,6,0.075,0.09836065573770492
"[1, 0, 1, 1, 0, 0, 1, 1, 0, 1, 0, 1, 0, 1, 1]",161,63,98,3,11,0.047619047619047616,0.11224489795918367
"[0, 0, 1, 0, 1, 1, 0, 1, 1, 0, 1, 0, 1, 1, 1]",160,58,102,7,13,0.1206896551724138,0.12745098039215685
"[0, 0, 1, 0, 0, 1, 0, 1, 1, 0, 1, 1, 0, 1, 0]",118,64,54,3,6,0.046875,0.1111111111111111
"[1, 1, 0, 0, 1, 0, 0, 1, 0, 1, 1, 0, 1, 1, 0]",130,54,76,7,5,0.12962962962962962,0.06578947368421052
"[0, 0, 1, 1, 1, 0, 0, 1, 0, 0, 1, 0, 1, 1, 0]",121,75,46,9,1,0.12,0.021739130434782608
"[0, 0, 0, 1, 0, 1, 0, 0, 1, 0, 1, 0, 0, 0, 1]",219,150,69,15,4,0.1,0.057971014492753624
"[1, 0, 1, 1, 0, 1, 0, 0, 1, 0, 0, 0, 1, 1, 0]",145,83,62,7,3,0.08433734939759036,0.04838709677419355
"[0, 1, 0, 0, 0, 1, 1, 0, 1, 0, 0, 0, 1, 0, 1]",124,69,55,6,6,0.08695652173913043,0.10909090909090909
"[0, 0, 0, 1, 0, 0, 1, 0, 0, 1, 0, 1, 0, 1, 0]",222,148,74,18,5,0.12162162162162163,0.06756756756756757
"[0, 0, 0, 0, 1, 1, 0, 1, 1, 1, 1, 1, 0, 1, 1]",183,74,109,8,15,0.10810810810810811,0.13761467889908258
"[1, 0, 0, 1, 0, 0, 0, 1, 1, 1, 0, 1, 1, 1, 1]",169,81,88,9,13,0.1111111111111111,0.14772727272727273
"[1, 1, 1, 0, 1, 1, 0, 1, 0, 1, 1, 0, 0, 0, 0]",176,75,101,8,7,0.10666666666666667,0.06930693069306931
"[1, 1, 1, 0, 0, 0, 0, 1, 1, 1, 0, 0, 1, 0, 0]",192,76,116,10,16,0.13157894736842105,0.13793103448275862
"[1, 0, 0, 1, 0, 0, 0, 1, 0, 0, 0, 1, 0, 1, 0]",219,144,75,13,8,0.09027777777777778,0.10666666666666667
"[0, 0, 1, 1, 0, 1, 0, 0, 1, 0, 0, 1, 1, 1, 0]",124,63,61,5,2,0.07936507936507936,0.03278688524590164
"[1, 1, 0, 0, 1, 0, 0, 0, 0, 0, 1, 1, 1, 0, 0]",172,108,64,8,7,0.07407407407407407,0.109375
"[0, 0, 1, 1, 0, 0, 1, 1, 1, 1, 1, 0, 1, 0, 0]",204,97,107,8,10,0.08247422680412371,0.09345794392523364
"[0, 1, 0, 1, 0, 0, 1, 1, 1, 0, 1, 0, 0, 1, 1]",115,58,57,6,3,0.10344827586206896,0.05263157894736842
"[1, 1, 0, 0, 0, 0, 0, 1, 0, 0, 0, 1, 0, 1, 1]",209,115,94,13,10,0.11304347826086956,0.10638297872340426
"[0, 1, 0, 0, 1, 0, 1, 0, 0, 1, 1, 0, 0, 1, 0]",139,72,67,11,7,0.1527777777777778,0.1044776119402985
"[1, 1, 1, 0, 1, 0, 0, 1, 0, 1, 0, 0, 1, 1, 0]",112,46,66,7,4,0.15217391304347827,0.06060606060606061
"[1, 1, 1, 0, 1, 1, 0, 1, 0, 0, 0, 0, 0, 1, 0]",92,50,42,3,2,0.06,0.047619047619047616
"[0, 0, 1, 1, 1, 0, 1, 1, 0, 1, 0, 0, 0, 0, 0]",164,94,70,3,11,0.031914893617021274,0.15714285714285714
"[0, 0, 1, 0, 1, 1, 0, 1, 1, 0, 0, 1, 1, 1, 1]",235,95,140,9,16,0.09473684210526316,0.11428571428571428
"[0, 1, 0, 0, 1, 1, 0, 1, 1, 0, 0, 1, 1, 1, 0]",106,52,54,6,6,0.11538461538461539,0.1111111111111111
"[1, 0, 1, 0, 1, 0, 1, 0, 0, 1, 1, 0, 1, 1, 0]",112,54,58,6,7,0.1111111111111111,0.1206896551724138
"[0, 1, 1, 0, 1, 1, 0, 1, 0, 1, 1, 0, 0, 0, 0]",150,76,74,10,5,0.13157894736842105,0.06756756756756757
"[0, 0, 0, 1, 1, 1, 1, 1, 0, 0, 1, 1, 0, 1, 1]",225,115,110,10,15,0.08695652173913043,0.13636363636363635
"[0, 1, 0, 1, 1, 1, 0, 0, 0, 1, 1, 1, 1, 0, 0]",181,87,94,9,12,0.10344827586206896,0.1276595744680851
"[0, 1, 0, 1, 0, 0, 1, 0, 1, 1, 0, 1, 1, 1, 1]",193,81,112,7,10,0.08641975308641975,0.08928571428571429
"[0, 1, 1, 1, 0, 1, 1, 1, 1, 0, 0, 1, 1, 0, 1]",268,96,172,11,8,0.11458333333333333,0.046511627906976744
"[1, 1, 0, 0, 1, 0, 0, 1, 1, 1, 1, 0, 1, 0, 1]",147,68,79,10,11,0.14705882352941177,0.13924050632911392
"[1, 1, 0, 0, 0, 1, 0, 0, 0, 1, 1, 1, 1, 1, 0]",140,74,66,5,3,0.06756756756756757,0.045454545454545456
"[0, 1, 1, 1, 1, 1, 0, 1, 1, 1, 0, 0, 0, 1, 0]",154,69,85,5,12,0.07246376811594203,0.1411764705882353
"[0, 1, 0, 0, 0, 1, 0, 0, 1, 1, 1, 1, 0, 0, 1]",190,113,77,17,12,0.1504424778761062,0.15584415584415584
"[0, 1, 1, 0, 1, 0, 1, 1, 0, 1, 1, 1, 0, 0, 0]",127,65,62,4,4,0.06153846153846154,0.06451612903225806
"[1, 0, 0, 0, 1, 1, 1, 0, 1, 1, 0, 1, 1, 1, 1]",321,100,221,12,22,0.12,0.09954751131221719
"[0, 1, 0, 1, 1, 1, 0, 0, 0, 1, 1, 1, 0, 0, 1]",134,60,74,3,4,0.05,0.05405405405405406
"[0, 0, 1, 0, 1, 0, 0, 1, 0, 0, 1, 0, 1, 1, 1]",119,61,58,6,4,0.09836065573770492,0.06896551724137931
"[0, 0, 1, 0, 0, 1, 1, 0, 1, 1, 1, 0, 0, 0, 1]",112,65,47,6,5,0.09230769230769231,0.10638297872340426
"[1, 1, 0, 0, 0, 0, 0, 0, 1, 0, 0, 1, 1, 1, 1]",405,229,176,20,21,0.08733624454148471,0.11931818181818182
"[1, 1, 1, 0, 1, 1, 0, 0, 0, 1, 0, 1, 1, 0, 0]",121,57,64,3,9,0.05263157894736842,0.140625
"[0, 0, 1, 1, 1, 0, 1, 1, 0, 0, 0, 1, 0, 1, 1]",123,61,62,6,6,0.09836065573770492,0.0967741935483871
"[1, 0, 1, 1, 1, 1, 0, 0, 1, 1, 1, 0, 1, 1, 0]",283,104,179,12,16,0.11538461538461539,0.0893854748603352
"[0, 1, 0, 1, 0, 1, 0, 0, 1, 0, 0, 1, 1, 1, 0]",125,70,55,11,6,0.15714285714285714,0.10909090909090909
"[1, 1, 0, 0, 1, 0, 1, 0, 1, 0, 0, 1, 0, 0, 1]",112,60,52,8,6,0.13333333333333333,0.11538461538461539
"[0, 0, 1, 0, 1, 0, 1, 1, 0, 0, 1, 0, 1, 0, 1]",95,57,38,4,3,0.07017543859649122,0.07894736842105263
"[0, 0, 0, 0, 1, 1, 0, 0, 0, 0, 0, 1, 1, 1, 0]",372,235,137,27,12,0.1148936170212766,0.08759124087591241
"[1, 1, 0, 1, 1, 1, 1, 0, 1, 1, 0, 0, 0, 0, 1]",227,89,138,15,13,0.16853932584269662,0.09420289855072464
"[0, 1, 1, 0, 1, 0, 1, 1, 1, 1, 1, 0, 1, 0, 1]",231,96,135,8,15,0.08333333333333333,0.1111111111111111
"[1, 1, 1, 0, 1, 1, 1, 0, 0, 0, 1, 1, 1, 0, 0]",177,64,113,7,15,0.109375,0.13274336283185842
"[0, 0, 0, 1, 0, 1, 0, 1, 1, 1, 1, 1, 0, 1, 1]",136,54,82,4,7,0.07407407407407407,0.08536585365853659
"[1, 1, 1, 1, 0, 0, 0, 1, 1, 0, 1, 0, 1, 0, 1]",161,71,90,12,8,0.16901408450704225,0.08888888888888889
"[0, 1, 0, 0, 0, 0, 1, 0, 1, 1, 0, 1, 1, 1, 1]",136,68,68,5,9,0.07352941176470588,0.1323529411764706
"[0, 0, 0, 1, 0, 0, 1, 1, 1, 0, 0, 0, 0, 1, 1]",313,202,111,19,9,0.09405940594059406,0.08108108108108109
"[1, 0, 1, 1, 1, 1, 0, 1, 0, 0, 0, 1, 0, 0, 0]",125,71,54,13,6,0.18309859154929578,0.1111111111111111
"[1, 0, 0, 1, 0, 0, 0, 1, 0, 1, 0, 1, 1, 0, 0]",132,84,48,6,6,0.07142857142857142,0.125
"[1, 1, 1, 1, 0, 0, 1, 0, 0, 0, 1, 0, 1, 0, 1]",102,44,58,5,6,0.11363636363636363,0.10344827586206896
"[0, 1, 1, 1, 1, 1, 0, 0, 1, 1, 0, 1, 1, 0, 1]",255,102,153,15,13,0.14705882352941177,0.08496732026143791
"[0, 0, 1, 0, 1, 0, 0, 0, 1, 1, 0, 1, 0, 0, 1]",142,75,67,5,5,0.06666666666666667,0.07462686567164178
"[1, 0, 1, 0, 0, 1, 1, 1, 0, 1, 1, 1, 0, 1, 1]",243,93,150,8,12,0.08602150537634409,0.08
"[0, 0, 0, 1, 0, 0, 0, 1, 0, 1, 1, 1, 0, 1, 1]",120,58,62,4,6,0.06896551724137931,0.0967741935483871
"[1, 0, 0, 1, 0, 1, 0, 1, 0, 1, 0, 0, 1, 0, 1]",95,47,48,1,13,0.02127659574468085,0.2708333333333333
"[1, 1, 0, 1, 1, 1, 0, 0, 0, 0, 0, 0, 0, 1, 1]",237,121,116,13,11,0.10743801652892562,0.09482758620689655
"[1, 1, 1, 0, 1, 1, 1, 0, 0, 0, 0, 0, 0, 0, 1]",179,88,91,16,6,0.18181818181818182,0.06593406593406594
"[0, 1, 0, 1, 0, 1, 1, 0, 1, 1, 0, 0, 1, 1, 0]",154,84,70,7,2,0.08333333333333333,0.02857142857142857
"[1, 0, 1, 0, 0, 1, 1, 0, 0, 0, 1, 0, 1, 0, 1]",120,72,48,6,5,0.08333333333333333,0.10416666666666667
"[0, 0, 1, 0, 1, 1, 0, 0, 0, 0, 0, 1, 1, 1, 1]",266,171,95,17,9,0.09941520467836257,0.09473684210526316
"[1, 0, 1, 0, 0, 0, 0, 1, 1, 0, 1, 1, 0, 1, 1]",124,57,67,7,7,0.12280701754385964,0.1044776119402985
"[1, 0, 1, 0, 0, 0, 1, 1, 0, 0, 0, 1, 0, 1, 1]",141,72,69,8,7,0.1111111111111111,0.10144927536231885
"[1, 0, 0, 1, 0, 1, 1, 0, 0, 0, 0, 1, 0, 0, 1]",147,86,61,7,12,0.08139534883720931,0.19672131147540983
"[1, 1, 0, 0, 1, 0, 0, 0, 1, 1, 0, 1, 0, 0, 0]",165,105,60,13,4,0.12380952380952381,0.06666666666666667
"[0, 1, 1, 1, 1, 0, 1, 0, 0, 0, 0, 0, 1, 1, 1]",210,116,94,6,12,0.05172413793103448,0.1276595744680851
"[0, 1, 1, 1, 0, 1, 1, 1, 1, 0, 1, 1, 0, 0, 1]",281,94,187,10,16,0.10638297872340426,0.0855614973262032
"[1, 0, 0, 1, 1, 1, 0, 1, 1, 1, 1, 0, 1, 1, 0]",247,83,164,7,19,0.08433734939759036,0.11585365853658537
"[1, 1, 0, 0, 1, 1, 1, 0, 0, 0, 1, 1, 1, 0, 0]",148,69,79,10,9,0.14492753623188406,0.11392405063291139
"[0, 0, 0, 1, 0, 1, 1, 1, 1, 0, 1, 1, 1, 1, 0]",161,65,96,4,11,0.06153846153846154,0.11458333333333333
"[1, 1, 0, 1, 1, 0, 0, 0, 0, 1, 0, 1, 0, 1, 1]",119,47,72,6,9,0.1276595744680851,0.125
"[0, 0, 1, 0, 0, 1, 1, 0, 1, 1, 0, 0, 0, 1, 0]",124,70,54,3,8,0.04285714285714286,0.14814814814814814
"[1, 0, 0, 0, 0, 0, 1, 1, 0, 1, 1, 0, 0, 1, 1]",196,97,99,9,13,0.09278350515463918,0.13131313131313133
"[0, 0, 1, 1, 0, 1, 0, 1, 0, 1, 1, 0, 0, 0, 1]",143,76,67,3,8,0.039473684210526314,0.11940298507462686
"[0, 1, 1, 1, 0, 0, 1, 1, 1, 0, 1, 0, 0, 0, 0]",142,67,75,4,10,0.05970149253731343,0.13333333333333333
"[1, 0, 1, 0, 1, 1, 1, 0, 0, 0, 1, 1, 0, 1, 0]",99,41,58,2,4,0.04878048780487805,0.06896551724137931
"[0, 0, 1, 0, 1, 0, 0, 1, 1, 0, 0, 0, 0, 1, 1]",360,221,139,31,6,0.14027149321266968,0.04316546762589928
"[0, 0, 0, 1, 1, 1, 0, 1, 0, 1, 0, 1, 0, 0, 1]",108,60,48,8,3,0.13333333333333333,0.0625
"[0, 1, 1, 1, 0, 0, 1, 0, 0, 0, 1, 1, 0, 1, 0]",100,64,36,8,4,0.125,0.1111111111111111
"[1, 0, 1, 0, 0, 0, 1, 1, 1, 0, 0, 1, 0, 0, 0]",152,83,69,6,9,0.07228915662650602,0.13043478260869565
"[0, 0, 0, 1, 1, 0, 1, 0, 0, 1, 0, 1, 1, 0, 1]",102,64,38,6,4,0.09375,0.10526315789473684
"[0, 0, 0, 0, 1, 1, 0, 1, 0, 0, 1, 0, 1, 1, 0]",150,86,64,6,5,0.06976744186046512,0.078125
"[0, 0, 1, 0, 0, 1, 0, 1, 0, 0, 1, 1, 1, 0, 0]",157,95,62,13,7,0.1368421052631579,0.11290322580645161
"[1, 0, 1, 0, 1, 0, 0, 0, 0, 0, 1, 0, 1, 1, 0]",138,65,73,10,4,0.15384615384615385,0.0547945205479452
"[0, 1, 0, 1, 1, 0, 1, 1, 1, 0, 1, 0, 0, 0, 1]",114,50,64,5,10,0.1,0.15625
"[0, 0, 1, 1, 1, 1, 1, 0, 0, 0, 1, 0, 1, 1, 0]",153,75,78,9,7,0.12,0.08974358974358974
"[1, 0, 0, 0, 1, 1, 0, 1, 0, 1, 1, 1, 1, 0, 0]",152,81,71,2,6,0.024691358024691357,0.08450704225352113
"[0, 0, 0, 1, 1, 1, 1, 1, 0, 1, 0, 1, 0, 0, 0]",132,78,54,7,5,0.08974358974358974,0.09259259259259259
"[1, 1, 0, 0, 0, 0, 1, 1, 0, 1, 1, 0, 1, 0, 0]",151,77,74,9,6,0.11688311688311688,0.08108108108108109
"[1, 1, 0, 1, 1, 0, 0, 0, 1, 1, 1, 1, 0, 1, 0]",146,55,91,5,11,0.09090909090909091,0.12087912087912088
"[1, 0, 0, 1, 1, 1, 1, 1, 0, 1, 1, 1, 0, 1, 0]",281,97,184,5,25,0.05154639175257732,0.1358695652173913
"[1, 1, 0, 0, 0, 1, 1, 1, 0, 1, 0, 0, 0, 0, 1]",102,47,55,9,5,0.19148936170212766,0.09090909090909091
"[1, 0, 1, 1, 0, 0, 1, 0, 1, 1, 0, 1, 0, 1, 1]",135,51,84,2,3,0.0392156862745098,0.03571428571428571
"[1, 1, 0, 1, 1, 0, 1, 0, 1, 1, 0, 0, 0, 0, 1]",154,67,87,8,4,0.11940298507462686,0.04597701149425287
"[0, 1, 0, 0, 1, 0, 1, 0, 1, 0, 1, 0, 0, 1, 0]",129,78,51,7,1,0.08974358974358974,0.0196078431372549
"[1, 1, 1, 1, 1, 1, 0, 1, 1, 1, 1, 0, 0, 0, 0]",595,179,416,18,39,0.1005586592178771,0.09375
"[0, 1, 1, 1, 1, 1, 1, 0, 1, 0, 1, 1, 0, 0, 0]",191,88,103,5,8,0.056818181818181816,0.07766990291262135
"[1, 1, 0, 0, 1, 1, 0, 1, 0, 0, 0, 1, 0, 0, 0]",163,99,64,5,4,0.050505050505050504,0.0625
"[0, 0, 0, 1, 0, 0, 1, 0, 1, 1, 0, 1, 0, 0, 0]",213,129,84,13,3,0.10077519379844961,0.03571428571428571
"[0, 1, 1, 1, 1, 0, 1, 1, 1, 0, 0, 0, 1, 0, 1]",140,61,79,5,10,0.08196721311475409,0.12658227848101267
"[1, 0, 1, 0, 1, 1, 1, 0, 1, 0, 0, 0, 0, 0, 1]",123,62,61,9,6,0.14516129032258066,0.09836065573770492
"[1, 0, 1, 1, 0, 0, 0, 1, 1, 0, 0, 0, 1, 1, 1]",149,73,76,5,7,0.0684931506849315,0.09210526315789473
"[0, 1, 1, 0, 1, 1, 0, 0, 0, 1, 1, 0, 0, 0, 1]",125,68,57,8,2,0.11764705882352941,0.03508771929824561
"[1, 0, 0, 0, 0, 0, 0, 1, 0, 1, 1, 1, 1, 1, 1]",272,111,161,10,15,0.09009009009009009,0.09316770186335403
"[0, 1, 0, 1, 1, 0, 0, 0, 1, 1, 0, 0, 1, 0, 1]",99,63,36,3,3,0.047619047619047616,0.08333333333333333
"[1, 1, 0, 0, 0, 1, 0, 1, 1, 0, 0, 0, 1, 1, 0]",131,75,56,12,3,0.16,0.05357142857142857
"[0, 1, 0, 0, 0, 1, 0, 0, 0, 0, 1, 0, 1, 1, 0]",220,137,83,10,5,0.072992700729927,0.060240963855421686
"[1, 0, 0, 0, 1, 1, 1, 1, 1, 1, 1, 0, 0, 0, 1]",220,85,135,5,12,0.058823529411764705,0.08888888888888889
"[1, 1, 0, 0, 0, 0, 0, 1, 1, 1, 1, 0, 0, 1, 0]",176,99,77,8,8,0.08080808080808081,0.1038961038961039
"[1, 1, 1, 1, 0, 0, 1, 1, 1, 0, 1, 0, 0, 0, 0]",203,83,120,13,12,0.1566265060240964,0.1
"[0, 1, 1, 1, 0, 1, 1, 0, 0, 1, 1, 1, 1, 0, 0]",310,141,169,15,17,0.10638297872340426,0.10059171597633136
"[1, 1, 1, 1, 0, 1, 1, 0, 0, 0, 0, 0, 0, 1, 0]",138,76,62,11,7,0.14473684210526316,0.11290322580645161
"[1, 1, 0, 1, 1, 1, 0, 0, 1, 0, 0, 0, 0, 1, 1]",168,73,95,6,7,0.0821917808219178,0.07368421052631578
"[1, 0, 1, 1, 1, 1, 0, 0, 1, 1, 0, 1, 1, 1, 0]",266,107,159,6,20,0.056074766355140186,0.12578616352201258
"[1, 1, 1, 1, 0, 0, 1, 0, 0, 1, 0, 0, 0, 1, 1]",156,78,78,7,12,0.08974358974358974,0.15384615384615385
"[0, 0, 0, 0, 1, 0, 0, 0, 0, 1, 0, 1, 0, 1, 1]",292,190,102,22,7,0.11578947368421053,0.06862745098039216
"[1, 0, 0, 0, 1, 0, 0, 1, 1, 0, 0, 1, 1, 1, 0]",134,80,54,6,9,0.075,0.16666666666666666
"[1, 0, 0, 0, 1, 0, 0, 0, 1, 1, 1, 0, 0, 1, 0]",149,90,59,8,3,0.08888888888888889,0.05084745762711865
"[0, 1, 1, 0, 0, 1, 0, 1, 1, 0, 0, 0, 1, 0, 0]",134,86,48,5,5,0.05813953488372093,0.10416666666666667
"[1, 1, 1, 0, 0, 1, 0, 1, 0, 1, 1, 0, 0, 1, 0]",101,44,57,2,5,0.045454545454545456,0.08771929824561403
"[0, 0, 0, 0, 0, 0, 1, 1, 1, 1, 0, 1, 1, 0, 1]",246,126,120,16,9,0.12698412698412698,0.075
"[0, 1, 1, 0, 1, 1, 0, 0, 0, 0, 1, 0, 1, 0, 1]",110,65,45,9,5,0.13846153846153847,0.1111111111111111
"[1, 1, 0, 0, 0, 1, 0, 1, 1, 0, 1, 1, 0, 1, 0]",109,56,53,6,6,0.10714285714285714,0.11320754716981132
"[0, 0, 1, 0, 0, 0, 1, 1, 1, 0, 0, 0, 1, 1, 0]",169,100,69,6,4,0.06,0.057971014492753624
"[0, 0, 1, 0, 1, 0, 1, 1, 0, 1, 1, 0, 0, 1, 0]",103,53,50,3,3,0.05660377358490566,0.06
"[1, 0, 1, 1, 1, 1, 0, 1, 0, 1, 1, 1, 0, 1, 0]",206,67,139,7,15,0.1044776119402985,0.1079136690647482
"[1, 0, 1, 1, 1, 0, 1, 1, 1, 0, 0, 0, 0, 1, 1]",237,101,136,11,12,0.10891089108910891,0.08823529411764706
"[1, 0, 0, 0, 1, 0, 1, 0, 1, 1, 0, 0, 1, 0, 0]",129,73,56,9,4,0.1232876712328767,0.07142857142857142
"[0, 1, 0, 0, 0, 0, 1, 1, 1, 0, 1, 1, 0, 0, 0]",155,90,65,9,8,0.1,0.12307692307692308
"[0, 1, 0, 0, 0, 1, 1, 1, 0, 0, 1, 0, 0, 0, 0]",293,189,104,22,7,0.1164021164021164,0.0673076923076923
"[0, 0, 0, 0, 0, 1, 1, 1, 1, 1, 0, 1, 1, 0, 0]",182,123,59,13,7,0.10569105691056911,0.11864406779661017
"[0, 1, 0, 1, 1, 1, 0, 0, 0, 0, 1, 0, 1, 0, 1]",102,50,52,7,5,0.14,0.09615384615384616
"[1, 0, 0, 1, 1, 0, 0, 1, 0, 1, 0, 0, 1, 0, 1]",105,51,54,4,4,0.0784313725490196,0.07407407407407407
"[1, 0, 1, 1, 0, 0, 1, 0, 0, 0, 0, 0, 0, 1, 0]",265,167,98,13,9,0.07784431137724551,0.09183673469387756
"[1, 0, 0, 0, 0, 1, 1, 0, 0, 1, 0, 0, 0, 1, 1]",265,105,160,8,14,0.0761904761904762,0.0875
"[1, 0, 0, 1, 0, 1, 1, 0, 0, 0, 1, 1, 0, 1, 1]",128,64,64,7,3,0.109375,0.046875
"[0, 1, 1, 1, 1, 1, 1, 1, 0, 1, 1, 0, 1, 0, 0]",252,102,150,9,11,0.08823529411764706,0.07333333333333333
"[0, 1, 0, 0, 1, 1, 0, 0, 1, 1, 1, 1, 0, 1, 0]",146,59,87,5,3,0.0847457627118644,0.034482758620689655
"[1, 1, 1, 1, 0, 1, 0, 0, 0, 1, 1, 0, 0, 1, 0]",107,57,50,4,6,0.07017543859649122,0.12
"[0, 1, 0, 1, 1, 1, 0, 1, 0, 1, 1, 0, 0, 0, 1]",105,58,47,3,5,0.05172413793103448,0.10638297872340426
"[1, 1, 1, 1, 1, 0, 1, 0, 1, 0, 0, 1, 0, 0, 0]",142,65,77,6,7,0.09230769230769231,0.09090909090909091
"[0, 0, 0, 1, 1, 1, 1, 1, 1, 1, 0, 1, 0, 1, 0]",203,98,105,11,10,0.11224489795918367,0.09523809523809523
"[0, 0, 1, 0, 0, 0, 1, 1, 1, 1, 1, 1, 1, 0, 1]",169,85,84,13,8,0.15294117647058825,0.09523809523809523
"[1, 1, 1, 1, 0, 1, 0, 0, 1, 0, 1, 1, 0, 0, 1]",171,69,102,10,2,0.14492753623188406,0.0196078431372549
"[0, 1, 1, 1, 1, 0, 1, 0, 0, 0, 0, 1, 0, 1, 0]",104,59,45,4,0,0.06779661016949153,0.0
"[1, 0, 0, 0, 0, 0, 1, 1, 0, 1, 1, 1, 0, 0, 0]",190,100,90,7,9,0.07,0.1
"[1, 0, 1, 1, 1, 0, 1, 0, 1, 1, 0, 0, 1, 0, 1]",145,51,94,4,9,0.0784313725490196,0.09574468085106383
"[1, 0, 0, 1, 1, 1, 0, 1, 1, 0, 0, 1, 1, 0, 0]",204,79,125,5,6,0.06329113924050633,0.048
"[0, 1, 1, 1, 1, 0, 0, 1, 1, 1, 0, 1, 1, 0, 0]",211,107,104,11,12,0.102803738317757,0.11538461538461539
"[1, 0, 1, 0, 0, 1, 1, 1, 0, 1, 0, 1, 0, 0, 0]",122,61,61,3,8,0.04918032786885246,0.13114754098360656
"[0, 0, 1, 1, 1, 0, 0, 1, 1, 0, 1, 1, 1, 0, 1]",148,61,87,6,8,0.09836065573770492,0.09195402298850575
"[1, 1, 0, 0, 1, 1, 1, 0, 0, 0, 0, 1, 1, 1, 0]",147,65,82,3,6,0.046153846153846156,0.07317073170731707
"[0, 0, 1, 1, 1, 0, 1, 0, 1, 0, 0, 0, 0, 1, 1]",195,104,91,11,4,0.10576923076923077,0.04395604395604396
"[1, 1, 0, 1, 1, 0, 0, 0, 0, 1, 0, 1, 1, 1, 0]",121,59,62,2,6,0.03389830508474576,0.0967741935483871
"[1, 1, 1, 0, 0, 0, 0, 1, 0, 0, 1, 0, 1, 0, 1]",112,56,56,1,5,0.017857142857142856,0.08928571428571429
"[0, 0, 1, 1, 1, 0, 1, 1, 1, 0, 0, 0, 0, 1, 0]",106,53,53,1,7,0.018867924528301886,0.1320754716981132
"[1, 0, 1, 1, 0, 1, 1, 1, 1, 0, 0, 1, 1, 1, 0]",246,72,174,7,15,0.09722222222222222,0.08620689655172414
"[0, 1, 0, 1, 0, 1, 0, 1, 1, 1, 0, 1, 0, 0, 0]",107,50,57,4,4,0.08,0.07017543859649122
"[0, 1, 0, 0, 1, 0, 1, 1, 1, 1, 0, 1, 1, 0, 0]",117,47,70,3,7,0.06382978723404255,0.1
"[1, 1, 1, 0, 1, 1, 1, 1, 0, 0, 0, 0, 0, 0, 1]",335,131,204,19,19,0.1450381679389313,0.09313725490196079
"[0, 1, 0, 0, 1, 0, 1, 0, 0, 0, 0, 1, 1, 0, 1]",132,82,50,4,6,0.04878048780487805,0.12
"[0, 1, 0, 0, 1, 0, 1, 1, 0, 1, 0, 1, 0, 0, 1]",111,48,63,1,7,0.020833333333333332,0.1111111111111111
"[0, 1, 1, 1, 0, 1, 0, 1, 0, 1, 0, 0, 1, 1, 0]",106,57,49,7,5,0.12280701754385964,0.10204081632653061
"[1, 0, 1, 1, 0, 0, 1, 0, 1, 0, 1, 0, 0, 0, 1]",102,58,44,5,2,0.08620689655172414,0.045454545454545456
"[0, 1, 1, 1, 0, 1, 0, 0, 0, 1, 1, 0, 1, 0, 0]",110,57,53,4,3,0.07017543859649122,0.05660377358490566
"[1, 0, 1, 0, 0, 0, 1, 1, 0, 0, 0, 1, 1, 0, 1]",120,65,55,4,0,0.06153846153846154,0.0
"[1, 0, 1, 0, 1, 0, 0, 0, 1, 1, 0, 0, 0, 1, 1]",118,61,57,8,6,0.13114754098360656,0.10526315789473684
"[0, 1, 1, 1, 0, 0, 0, 0, 0, 1, 0, 0, 0, 1, 0]",247,168,79,26,8,0.15476190476190477,0.10126582278481013
"[0, 1, 0, 0, 1, 1, 1, 1, 1, 0, 1, 0, 1, 0, 1]",141,52,89,3,11,0.057692307692307696,0.12359550561797752
"[1, 0, 1, 0, 1, 0, 0, 0, 0, 1, 0, 0, 1, 1, 0]",179,101,78,11,6,0.10891089108910891,0.07692307692307693
"[1, 1, 0, 0, 0, 1, 0, 0, 0, 0, 1, 0, 0, 0, 1]",261,178,83,12,8,0.06741573033707865,0.0963855421686747
"[0, 1, 1, 0, 1, 0, 0, 1, 0, 1, 1, 0, 0, 1, 0]",105,56,49,6,6,0.10714285714285714,0.12244897959183673
"[0, 1, 0, 1, 0, 1, 1, 0, 1, 0, 0, 1, 0, 1, 1]",110,54,56,4,5,0.07407407407407407,0.08928571428571429
"[1, 0, 1, 1, 0, 0, 0, 1, 0, 0, 0, 0, 1, 0, 0]",253,171,82,17,5,0.09941520467836257,0.06097560975609756
"[0, 0, 0, 1, 1, 0, 1, 1, 1, 0, 1, 0, 1, 0, 1]",123,59,64,7,10,0.11864406779661017,0.15625
"[0, 0, 1, 1, 1, 1, 0, 1, 1, 0, 1, 0, 0, 1, 1]",189,75,114,7,14,0.09333333333333334,0.12280701754385964
"[1, 1, 0, 0, 1, 1, 0, 1, 0, 1, 1, 0, 0, 1, 1]",225,97,128,6,12,0.061855670103092786,0.09375
"[0, 1, 1, 0, 1, 1, 0, 1, 1, 0, 0, 1, 1, 1, 0]",140,61,79,6,6,0.09836065573770492,0.0759493670886076
"[0, 0, 1, 0, 1, 0, 0, 1, 1, 1, 1, 1, 1, 0, 0]",255,127,128,9,16,0.07086614173228346,0.125
"[0, 0, 1, 1, 0, 0, 1, 0, 1, 1, 1, 1, 1, 0, 1]",174,74,100,8,5,0.10810810810810811,0.05
"[1, 1, 1, 0, 1, 1, 1, 0, 1, 1, 0, 0, 1, 0, 0]",152,56,96,1,8,0.017857142857142856,0.08333333333333333
"[0, 1, 1, 0, 0, 0, 0, 1, 1, 1, 0, 1, 0, 1, 1]",235,154,81,17,14,0.11038961038961038,0.1728395061728395
"[1, 0, 0, 1, 1, 1, 0, 1, 1, 1, 1, 1, 0, 0, 1]",328,107,221,13,19,0.12149532710280374,0.08597285067873303
"[1, 0, 0, 0, 0, 0, 0, 1, 0, 1, 1, 0, 0, 1, 0]",226,136,90,13,5,0.09558823529411764,0.05555555555555555
"[1, 1, 0, 1, 0, 0, 0, 0, 0, 1, 0, 1, 0, 0, 0]",256,154,102,12,9,0.07792207792207792,0.08823529411764706
"[0, 1, 0, 1, 0, 1, 0, 0, 1, 1, 0, 1, 0, 0, 1]",101,56,45,5,6,0.08928571428571429,0.13333333333333333
"[1, 0, 0, 1, 0, 1, 1, 1, 1, 1, 0, 1, 0, 1, 1]",224,79,145,7,16,0.08860759493670886,0.1103448275862069
"[1, 1, 1, 0, 0, 1, 0, 0, 0, 0, 1, 0, 0, 1, 0]",131,77,54,7,4,0.09090909090909091,0.07407407407407407
"[1, 0, 0, 0, 0, 1, 1, 1, 1, 1, 0, 1, 1, 1, 0]",226,74,152,8,15,0.10810810810810811,0.09868421052631579
"[0, 0, 1, 1, 1, 1, 0, 1, 0, 1, 1, 0, 1, 0, 0]",114,54,60,6,9,0.1111111111111111,0.15
"[1, 1, 0, 0, 0, 1, 1, 1, 1, 1, 0, 1, 1, 0, 0]",180,75,105,7,7,0.09333333333333334,0.06666666666666667
"[0, 1, 1, 0, 1, 0, 1, 1, 1, 0, 0, 1, 1, 0, 1]",143,55,88,10,6,0.18181818181818182,0.06818181818181818
"[0, 0, 1, 1, 0, 0, 1, 1, 0, 0, 1, 0, 1, 0, 1]",189,94,95,10,4,0.10638297872340426,0.042105263157894736
"[1, 0, 0, 1, 0, 1, 0, 1, 0, 1, 0, 0, 0, 1, 0]",120,71,49,7,4,0.09859154929577464,0.08163265306122448
"[0, 0, 1, 1, 1, 0, 1, 1, 0, 0, 0, 0, 1, 0, 0]",126,71,55,11,7,0.15492957746478872,0.12727272727272726
"[1, 1, 1, 0, 0, 0, 1, 0, 0, 1, 0, 0, 1, 0, 0]",147,94,53,7,3,0.07446808510638298,0.05660377358490566
"[1, 1, 1, 1, 0, 0, 1, 1, 1, 0, 1, 1, 0, 0, 0]",251,100,151,7,21,0.07,0.1390728476821192
"[0, 0, 1, 1, 0, 1, 1, 1, 0, 1, 1, 1, 1, 0, 1]",262,90,172,9,13,0.1,0.0755813953488372
"[0, 0, 1, 1, 1, 0, 1, 1, 1, 0, 1, 0, 0, 0, 1]",108,53,55,6,6,0.11320754716981132,0.10909090909090909
"[1, 1, 0, 0, 1, 0, 0, 0, 1, 0, 1, 0, 0, 1, 1]",137,73,64,5,9,0.0684931506849315,0.140625
"[0, 1, 1, 1, 1, 0, 1, 1, 0, 1, 0, 1, 1, 1, 0]",268,111,157,11,12,0.0990990990990991,0.07643312101910828
"[0, 0, 0, 0, 1, 1, 1, 0, 1, 1, 0, 1, 1, 1, 1]",246,102,144,12,21,0.11764705882352941,0.14583333333333334
"[0, 1, 1, 0, 0, 0, 1, 0, 1, 1, 0, 1, 0, 0, 1]",126,59,67,3,7,0.05084745762711865,0.1044776119402985
"[1, 1, 1, 1, 0, 0, 1, 1, 1, 0, 0, 1, 1, 0, 1]",279,103,176,6,13,0.05825242718446602,0.07386363636363637
"[1, 0, 1, 1, 0, 0, 0, 1, 1, 0, 1, 0, 1, 1, 1]",168,72,96,8,12,0.1111111111111111,0.125
"[0, 1, 0, 1, 0, 1, 1, 0, 0, 0, 0, 1, 0, 0, 1]",149,85,64,14,8,0.16470588235294117,0.125
"[1, 1, 1, 1, 0, 1, 0, 1, 0, 1, 0, 0, 0, 1, 0]",120,58,62,4,5,0.06896551724137931,0.08064516129032258
"[1, 0, 0, 1, 1, 0, 1, 0, 0, 0, 1, 1, 1, 0, 1]",116,50,66,7,6,0.14,0.09090909090909091
"[0, 1, 1, 1, 1, 1, 0, 0, 1, 0, 0, 1, 1, 0, 1]",151,79,72,8,9,0.10126582278481013,0.125
"[0, 0, 1, 0, 1, 0, 1, 1, 0, 0, 1, 1, 0, 0, 1]",183,105,78,13,5,0.12380952380952381,0.0641025641025641
"[1, 0, 0, 1, 0, 1, 0, 1, 1, 0, 0, 1, 1, 0, 0]",168,77,91,8,14,0.1038961038961039,0.15384615384615385
"[1, 1, 0, 0, 1, 0, 0, 0, 0, 0, 1, 0, 1, 1, 1]",169,96,73,11,10,0.11458333333333333,0.136986301369863
"[1, 0, 0, 1, 1, 0, 0, 1, 1, 1, 0, 1, 0, 0, 0]",185,62,123,5,13,0.08064516129032258,0.10569105691056911
"[0, 0, 1, 1, 0, 1, 0, 1, 0, 1, 1, 0, 1, 0, 0]",97,50,47,7,6,0.14,0.1276595744680851
"[1, 1, 0, 0, 0, 0, 0, 1, 0, 0, 0, 1, 1, 0, 0]",338,205,133,28,18,0.13658536585365855,0.13533834586466165
"[1, 0, 0, 1, 0, 1, 0, 0, 0, 0, 1, 0, 1, 0, 1]",126,71,55,12,2,0.16901408450704225,0.03636363636363636
"[0, 0, 1, 1, 1, 0, 0, 0, 1, 0, 0, 0, 0, 1, 1]",221,139,82,15,6,0.1079136690647482,0.07317073170731707
"[1, 1, 1, 0, 0, 1, 0, 0, 0, 1, 0, 1, 1, 0, 1]",118,52,66,2,4,0.038461538461538464,0.06060606060606061
"[1, 0, 1, 0, 1, 0, 1, 0, 1, 0, 1, 0, 1, 0, 0]",106,57,49,5,3,0.08771929824561403,0.061224489795918366
"[0, 1, 0, 1, 0, 0, 1, 0, 1, 0, 1, 1, 1, 0, 0]",114,55,59,3,7,0.05454545454545454,0.11864406779661017
"[1, 0, 1, 0, 1, 1, 1, 0, 1, 0, 1, 0, 1, 0, 0]",109,51,58,3,4,0.058823529411764705,0.06896551724137931
"[1, 0, 0, 0, 1, 0, 0, 1, 1, 1, 0, 1, 1, 1, 1]",183,75,108,9,17,0.12,0.1574074074074074
"[0, 0, 1, 1, 1, 0, 1, 1, 1, 0, 1, 0, 0, 0, 0]",140,64,76,6,6,0.09375,0.07894736842105263
"[0, 0, 1, 0, 0, 1, 1, 1, 0, 1, 1, 1, 0, 1, 0]",94,43,51,7,8,0.16279069767441862,0.1568627450980392
"[0, 0, 1, 0, 1, 0, 1, 0, 0, 1, 1, 0, 0, 1, 1]",201,95,106,10,10,0.10526315789473684,0.09433962264150944
"[1, 0, 1, 0, 0, 0, 1, 1, 0, 1, 1, 0, 1, 1, 0]",121,51,70,4,4,0.0784313725490196,0.05714285714285714
"[1, 0, 1, 0, 0, 1, 0, 1, 1, 0, 1, 0, 1, 1, 1]",150,67,83,3,9,0.04477611940298507,0.10843373493975904
"[0, 0, 0, 0, 0, 1, 1, 1, 0, 1, 0, 1, 1, 0, 1]",141,79,62,4,8,0.05063291139240506,0.12903225806451613
"[1, 0, 1, 1, 1, 0, 0, 1, 0, 0, 0, 0, 0, 0, 1]",169,102,67,10,4,0.09803921568627451,0.05970149253731343
"[1, 1, 0, 1, 1, 1, 0, 0, 1, 0, 0, 1, 0, 1, 0]",95,45,50,6,6,0.13333333333333333,0.12
"[0, 0, 1, 1, 0, 1, 1, 0, 0, 1, 0, 0, 1, 0, 0]",149,71,78,5,3,0.07042253521126761,0.038461538461538464
"[1, 0, 0, 1, 1, 0, 1, 1, 0, 0, 1, 0, 0, 1, 0]",130,62,68,6,6,0.0967741935483871,0.08823529411764706
"[1, 0, 1, 1, 1, 0, 1, 1, 1, 1, 0, 0, 1, 0, 0]",164,67,97,7,10,0.1044776119402985,0.10309278350515463
"[0, 1, 0, 0, 1, 0, 0, 1, 1, 1, 1, 0, 0, 0, 1]",125,65,60,8,4,0.12307692307692308,0.06666666666666667
"[0, 0, 0, 0, 1, 1, 0, 0, 0, 1, 1, 1, 1, 0, 1]",180,93,87,10,8,0.10752688172043011,0.09195402298850575
"[1, 0, 0, 0, 1, 0, 0, 0, 1, 0, 0, 1, 1, 0, 1]",129,70,59,1,7,0.014285714285714285,0.11864406779661017
"[1, 0, 1, 1, 1, 1, 1, 0, 0, 0, 1, 0, 0, 0, 1]",125,61,64,6,6,0.09836065573770492,0.09375
"[1, 0, 1, 0, 1, 0, 1, 1, 0, 1, 0, 1, 1, 0, 1]",125,50,75,9,7,0.18,0.09333333333333334
"[0, 0, 1, 0, 0, 1, 1, 1, 1, 1, 0, 0, 0, 1, 1]",155,80,75,8,8,0.1,0.10666666666666667
"[1, 1, 0, 0, 0, 0, 1, 0, 0, 1, 0, 1, 1, 0, 1]",126,67,59,3,8,0.04477611940298507,0.13559322033898305
"[0, 1, 1, 0, 0, 1, 1, 1, 0, 0, 0, 0, 1, 1, 0]",200,126,74,13,10,0.10317460317460317,0.13513513513513514
"[1, 0, 0, 0, 1, 0, 1, 0, 1, 0, 0, 1, 0, 0, 1]",155,83,72,7,2,0.08433734939759036,0.027777777777777776
"[0, 0, 1, 0, 0, 1, 0, 1, 0, 0, 1, 1, 1, 1, 0]",163,79,84,4,14,0.05063291139240506,0.16666666666666666
"[1, 0, 0, 1, 1, 1, 0, 1, 1, 1, 1, 0, 0, 1, 0]",159,52,107,8,2,0.15384615384615385,0.018691588785046728
"[1, 1, 1, 0, 1, 1, 0, 0, 0, 1, 0, 0, 1, 0, 0]",112,65,47,2,4,0.03076923076923077,0.0851063829787234
"[0, 0, 0, 0, 0, 0, 1, 0, 1, 1, 0, 1, 1, 1, 0]",160,105,55,13,7,0.12380952380952381,0.12727272727272726
"[1, 1, 1, 0, 1, 0, 1, 1, 1, 0, 0, 0, 1, 1, 1]",287,100,187,11,15,0.11,0.08021390374331551
"[0, 1, 0, 0, 0, 1, 1, 0, 0, 0, 0, 0, 1, 1, 0]",331,213,118,20,12,0.09389671361502347,0.1016949152542373
"[0, 0, 1, 1, 1, 0, 1, 1, 1, 0, 0, 0, 1, 1, 1]",233,85,148,9,18,0.10588235294117647,0.12162162162162163
"[1, 0, 0, 0, 1, 0, 0, 1, 0, 1, 1, 0, 1, 0, 1]",94,50,44,7,5,0.14,0.11363636363636363
"[1, 1, 1, 0, 1, 1, 0, 0, 0, 1, 0, 0, 1, 0, 1]",109,38,71,3,3,0.07894736842105263,0.04225352112676056
"[0, 1, 1, 1, 1, 1, 0, 0, 0, 0, 1, 0, 1, 0, 1]",125,66,59,3,2,0.045454545454545456,0.03389830508474576
"[0, 1, 0, 1, 1, 0, 0, 0, 1, 1, 1, 0, 0, 1, 0]",117,61,56,7,5,0.11475409836065574,0.08928571428571429
"[0, 0, 0, 0, 1, 1, 1, 0, 0, 0, 1, 0, 0, 1, 0]",267,178,89,10,12,0.056179775280898875,0.1348314606741573
"[1, 1, 0, 1, 0, 0, 0, 0, 1, 1, 0, 1, 0, 0, 1]",101,54,47,5,3,0.09259259259259259,0.06382978723404255
"[1, 1, 1, 0, 0, 0, 1, 0, 0, 0, 1, 0, 0, 1, 0]",136,71,65,6,5,0.08450704225352113,0.07692307692307693
"[1, 1, 1, 0, 1, 0, 1, 0, 0, 0, 1, 0, 0, 0, 1]",125,77,48,5,7,0.06493506493506493,0.14583333333333334
"[0, 1, 0, 0, 0, 1, 1, 0, 1, 1, 0, 0, 1, 0, 0]",149,91,58,10,10,0.10989010989010989,0.1724137931034483
"[1, 1, 0, 1, 0, 0, 1, 1, 0, 0, 1, 0, 1, 1, 0]",109,60,49,6,4,0.1,0.08163265306122448
"[0, 0, 0, 1, 1, 1, 0, 0, 1, 1, 0, 1, 1, 0, 0]",139,75,64,7,6,0.09333333333333334,0.09375
"[1, 0, 1, 0, 0, 1, 1, 1, 1, 1, 0, 0, 0, 1, 1]",174,73,101,5,8,0.0684931506849315,0.07920792079207921
"[1, 1, 0, 1, 1, 1, 0, 0, 0, 0, 0, 0, 1, 1, 0]",254,133,121,7,11,0.05263157894736842,0.09090909090909091
"[0, 0, 1, 0, 1, 0, 1, 1, 1, 1, 1, 0, 1, 1, 0]",133,41,92,4,10,0.0975609756097561,0.10869565217391304
"[0, 0, 1, 1, 1, 0, 1, 0, 1, 0, 0, 1, 0, 0, 0]",142,87,55,11,3,0.12643678160919541,0.05454545454545454
"[0, 1, 0, 1, 1, 0, 0, 0, 1, 1, 1, 0, 1, 0, 1]",101,48,53,6,3,0.125,0.05660377358490566
"[1, 1, 1, 0, 1, 0, 1, 0, 1, 1, 0, 0, 0, 1, 1]",173,72,101,4,9,0.05555555555555555,0.0891089108910891
"[0, 0, 0, 1, 0, 1, 1, 0, 1, 1, 1, 1, 0, 1, 1]",150,47,103,2,12,0.0425531914893617,0.11650485436893204
"[0, 1, 1, 0, 1, 1, 0, 1, 1, 0, 1, 0, 1, 1, 0]",120,43,77,4,5,0.09302325581395349,0.06493506493506493
"[0, 1, 0, 0, 1, 1, 0, 1, 1, 0, 1, 1, 0, 1, 0]",84,39,45,3,1,0.07692307692307693,0.022222222222222223
"[1, 1, 1, 0, 1, 0, 0, 0, 1, 1, 0, 1, 1, 0, 0]",119,53,66,4,3,0.07547169811320754,0.045454545454545456
"[1, 0, 1, 1, 0, 0, 0, 0, 1, 1, 1, 1, 0, 1, 0]",132,55,77,2,4,0.03636363636363636,0.05194805194805195
"[0, 1, 1, 1, 0, 1, 1, 0, 0, 0, 1, 1, 0, 1, 0]",97,41,56,4,5,0.0975609756097561,0.08928571428571429
"[1, 1, 0, 1, 1, 1, 0, 1, 1, 0, 0, 0, 1, 1, 0]",144,54,90,6,11,0.1111111111111111,0.12222222222222222
"[1, 1, 1, 0, 0, 0, 1, 1, 0, 1, 1, 1, 1, 0, 1]",244,91,153,10,20,0.10989010989010989,0.13071895424836602
"[0, 0, 1, 1, 0, 0, 0, 1, 1, 1, 0, 0, 0, 1, 1]",193,103,90,10,6,0.0970873786407767,0.06666666666666667
"[1, 0, 0, 0, 0, 1, 1, 0, 1, 0, 1, 1, 0, 0, 1]",154,55,99,6,10,0.10909090909090909,0.10101010101010101
"[1, 1, 1, 0, 1, 0, 0, 1, 0, 1, 0, 1, 0, 0, 1]",115,63,52,8,4,0.12698412698412698,0.07692307692307693
"[0, 1, 0, 0, 1, 1, 0, 1, 1, 1, 0, 1, 1, 1, 0]",144,62,82,6,9,0.0967741935483871,0.10975609756097561
"[1, 1, 0, 0, 0, 1, 1, 0, 1, 1, 0, 1, 0, 0, 0]",127,60,67,5,7,0.08333333333333333,0.1044776119402985
"[1, 1, 1, 1, 0, 1, 1, 1, 1, 0, 0, 0, 0, 1, 0]",174,76,98,10,12,0.13157894736842105,0.12244897959183673
"[0, 1, 0, 1, 0, 0, 0, 0, 1, 0, 1, 0, 1, 0, 1]",132,80,52,4,3,0.05,0.057692307692307696
"[1, 0, 0, 1, 1, 1, 1, 0, 1, 0, 0, 1, 1, 1, 0]",181,70,111,5,9,0.07142857142857142,0.08108108108108109
"[0, 1, 1, 1, 0, 0, 0, 0, 1, 0, 1, 0, 0, 1, 1]",158,97,61,12,9,0.12371134020618557,0.14754098360655737
"[0, 0, 1, 1, 0, 1, 0, 0, 0, 1, 1, 0, 1, 0, 0]",137,87,50,9,4,0.10344827586206896,0.08
"[0, 0, 0, 1, 1, 0, 0, 1, 1, 0, 0, 1, 0, 1, 0]",248,187,61,18,7,0.0962566844919786,0.11475409836065574
"[1, 1, 0, 0, 1, 0, 1, 1, 1, 0, 0, 1, 0, 0, 1]",112,52,60,3,3,0.057692307692307696,0.05
"[0, 1, 0, 0, 1, 1, 0, 1, 1, 1, 1, 0, 0, 1, 0]",126,63,63,8,5,0.12698412698412698,0.07936507936507936
"[1, 1, 1, 0, 1, 1, 0, 1, 0, 1, 0, 0, 1, 0, 0]",120,59,61,4,3,0.06779661016949153,0.04918032786885246
"[1, 1, 1, 0, 0, 1, 0, 0, 0, 1, 0, 1, 1, 1, 1]",198,84,114,9,7,0.10714285714285714,0.06140350877192982
"[1, 0, 1, 0, 1, 0, 0, 1, 1, 1, 0, 0, 1, 0, 1]",104,44,60,3,6,0.06818181818181818,0.1
"[0, 1, 1, 1, 0, 1, 1, 0, 1, 1, 1, 1, 0, 1, 0]",242,83,159,7,11,0.08433734939759036,0.06918238993710692
"[1, 0, 0, 1, 1, 0, 1, 0, 1, 0, 0, 1, 1, 0, 0]",166,75,91,10,12,0.13333333333333333,0.13186813186813187
"[0, 0, 1, 1, 0, 1, 1, 0, 0, 1, 1, 1, 1, 1, 0]",165,64,101,8,10,0.125,0.09900990099009901
"[0, 0, 1, 0, 0, 1, 1, 0, 0, 1, 0, 0, 0, 1, 1]",199,122,77,10,13,0.08196721311475409,0.16883116883116883
"[0, 0, 0, 1, 1, 1, 0, 1, 0, 0, 0, 0, 0, 1, 0]",229,159,70,21,6,0.1320754716981132,0.08571428571428572
"[0, 0, 1, 1, 0, 1, 0, 0, 1, 1, 0, 1, 1, 1, 0]",96,45,51,8,0,0.17777777777777778,0.0
"[1, 0, 0, 0, 1, 1, 0, 0, 1, 1, 0, 1, 0, 0, 1]",139,67,72,6,4,0.08955223880597014,0.05555555555555555
"[0, 0, 0, 1, 1, 0, 0, 1, 1, 1, 0, 1, 0, 0, 1]",179,124,55,13,3,0.10483870967741936,0.05454545454545454
"[1, 0, 1, 0, 1, 0, 0, 0, 0, 0, 1, 1, 1, 0, 0]",184,104,80,12,13,0.11538461538461539,0.1625
"[0, 1, 1, 0, 0, 0, 1, 1, 0, 1, 1, 1, 0, 1, 0]",103,48,55,7,7,0.14583333333333334,0.12727272727272726
"[1, 0, 1, 1, 0, 1, 0, 0, 0, 1, 0, 0, 1, 1, 0]",110,53,57,4,10,0.07547169811320754,0.17543859649122806
"[1, 0, 0, 0, 1, 0, 0, 0, 1, 1, 0, 1, 1, 0, 1]",97,52,45,8,2,0.15384615384615385,0.044444444444444446
"[1, 0, 0, 0, 0, 0, 0, 1, 1, 0, 1, 1, 1, 1, 0]",186,78,108,11,9,0.14102564102564102,0.08333333333333333
"[0, 1, 1, 0, 1, 0, 0, 1, 1, 1, 1, 0, 1, 1, 1]",280,127,153,17,12,0.13385826771653545,0.0784313725490196
"[0, 0, 1, 1, 0, 1, 0, 0, 1, 1, 1, 1, 0, 1, 1]",186,75,111,10,11,0.13333333333333333,0.0990990990990991
"[1, 0, 0, 0, 1, 0, 1, 0, 1, 1, 0, 1, 0, 0, 1]",126,59,67,5,9,0.0847457627118644,0.13432835820895522
"[0, 1, 1, 0, 1, 1, 0, 1, 0, 0, 0, 1, 0, 1, 0]",105,51,54,5,5,0.09803921568627451,0.09259259259259259
"[0, 0, 1, 1, 1, 1, 0, 0, 1, 0, 1, 0, 0, 1, 0]",147,66,81,4,8,0.06060606060606061,0.09876543209876543
"[0, 1, 0, 1, 1, 1, 1, 0, 0, 1, 0, 0, 1, 0, 1]",109,43,66,2,8,0.046511627906976744,0.12121212121212122
"[0, 1, 0, 1, 0, 1, 1, 1, 0, 0, 0, 1, 1, 1, 1]",203,77,126,7,12,0.09090909090909091,0.09523809523809523
"[1, 1, 1, 1, 0, 1, 0, 0, 1, 0, 0, 1, 1, 1, 0]",140,58,82,6,10,0.10344827586206896,0.12195121951219512
"[1, 1, 0, 1, 0, 0, 1, 1, 0, 1, 0, 1, 1, 0, 1]",119,46,73,8,5,0.17391304347826086,0.0684931506849315
"[1, 1, 1, 0, 0, 0, 0, 1, 0, 1, 0, 1, 0, 0, 1]",117,47,70,4,6,0.0851063829787234,0.08571428571428572
"[0, 0, 1, 0, 1, 1, 1, 0, 1, 0, 1, 1, 0, 1, 1]",137,48,89,2,2,0.041666666666666664,0.02247191011235955
"[1, 0, 0, 1, 0, 1, 0, 1, 0, 0, 0, 1, 1, 1, 1]",172,85,87,13,7,0.15294117647058825,0.08045977011494253
"[0, 1, 0, 0, 1, 1, 0, 1, 0, 0, 1, 0, 1, 1, 1]",152,77,75,10,8,0.12987012987012986,0.10666666666666667
"[1, 0, 1, 0, 0, 1, 1, 0, 1, 0, 0, 1, 0, 1, 1]",131,63,68,5,5,0.07936507936507936,0.07352941176470588
"[0, 1, 0, 1, 0, 0, 1, 1, 0, 1, 0, 0, 1, 0, 1]",102,45,57,1,6,0.022222222222222223,0.10526315789473684
"[0, 1, 1, 0, 1, 1, 0, 0, 1, 1, 0, 1, 0, 0, 1]",135,66,69,4,7,0.06060606060606061,0.10144927536231885
"[1, 1, 1, 1, 0, 0, 1, 1, 1, 0, 1, 0, 0, 1, 0]",168,66,102,5,13,0.07575757575757576,0.12745098039215685
"[0, 0, 0, 1, 0, 1, 1, 0, 0, 0, 1, 0, 1, 1, 0]",149,94,55,7,6,0.07446808510638298,0.10909090909090909
"[1, 0, 0, 0, 1, 0, 0, 0, 1, 0, 1, 1, 1, 0, 0]",146,86,60,7,6,0.08139534883720931,0.1
"[0, 0, 0, 0, 1, 0, 1, 1, 1, 1, 1, 0, 0, 1, 0]",124,65,59,7,4,0.1076923076923077,0.06779661016949153
"[0, 0, 1, 1, 0, 1, 1, 1, 0, 1, 1, 1, 1, 0, 0]",204,94,110,7,14,0.07446808510638298,0.12727272727272726
"[0, 0, 1, 0, 0, 0, 0, 1, 1, 0, 0, 0, 1, 0, 1]",298,199,99,23,10,0.11557788944723618,0.10101010101010101
"[1, 0, 0, 1, 1, 1, 0, 0, 1, 1, 0, 0, 1, 0, 1]",144,68,76,7,5,0.10294117647058823,0.06578947368421052
"[1, 1, 1, 0, 1, 0, 0, 0, 0, 0, 1, 0, 0, 1, 0]",124,71,53,6,6,0.08450704225352113,0.11320754716981132
"[1, 1, 0, 0, 0, 0, 1, 0, 0, 0, 1, 1, 1, 1, 0]",167,78,89,6,12,0.07692307692307693,0.1348314606741573
"[1, 0, 0, 1, 1, 1, 0, 1, 0, 1, 0, 0, 1, 1, 0]",122,47,75,2,6,0.0425531914893617,0.08
"[1, 1, 1, 0, 1, 1, 1, 0, 0, 1, 0, 0, 0, 1, 0]",108,47,61,3,7,0.06382978723404255,0.11475409836065574
"[1, 0, 1, 1, 1, 0, 1, 0, 0, 1, 0, 1, 0, 0, 1]",85,35,50,2,5,0.05714285714285714,0.1
"[0, 0, 1, 0, 0, 1, 0, 1, 0, 0, 1, 0, 0, 1, 1]",165,105,60,8,6,0.0761904761904762,0.1
"[1, 0, 1, 0, 0, 1, 0, 1, 0, 1, 1, 1, 1, 1, 0]",133,55,78,4,6,0.07272727272727272,0.07692307692307693
"[0, 1, 1, 0, 1, 0, 0, 1, 1, 1, 1, 0, 0, 1, 0]",125,57,68,2,6,0.03508771929824561,0.08823529411764706
"[0, 0, 0, 1, 1, 0, 1, 0, 1, 0, 1, 1, 0, 0, 1]",130,71,59,2,3,0.028169014084507043,0.05084745762711865
"[0, 0, 0, 1, 1, 1, 1, 1, 0, 0, 0, 1, 1, 0, 1]",143,76,67,5,7,0.06578947368421052,0.1044776119402985
"[0, 0, 1, 0, 0, 0, 0, 0, 1, 0, 0, 1, 1, 0, 1]",234,145,89,11,8,0.07586206896551724,0.0898876404494382
"[1, 1, 0, 0, 0, 0, 0, 1, 1, 0, 1, 0, 1, 0, 0]",176,106,70,7,10,0.0660377358490566,0.14285714285714285
"[0, 1, 1, 0, 1, 1, 1, 1, 0, 0, 0, 0, 1, 0, 0]",124,61,63,7,6,0.11475409836065574,0.09523809523809523
"[1, 0, 1, 0, 1, 1, 0, 1, 1, 1, 0, 1, 1, 0, 1]",206,83,123,6,10,0.07228915662650602,0.08130081300813008
"[1, 1, 0, 1, 1, 1, 1, 0, 0, 1, 0, 0, 1, 1, 0]",157,63,94,6,6,0.09523809523809523,0.06382978723404255
"[0, 1, 1, 0, 0, 1, 1, 1, 1, 1, 0, 1, 1, 0, 0]",184,103,81,10,6,0.0970873786407767,0.07407407407407407
"[1, 0, 0, 0, 0, 1, 0, 1, 0, 0, 1, 1, 0, 0, 0]",372,209,163,20,14,0.09569377990430622,0.08588957055214724
"[0, 1, 0, 0, 1, 1, 1, 0, 0, 0, 1, 1, 0, 1, 1]",114,51,63,4,11,0.0784313725490196,0.1746031746031746
"[0, 1, 0, 1, 0, 1, 0, 0, 0, 0, 1, 1, 0, 0, 0]",360,246,114,15,10,0.06097560975609756,0.08771929824561403
"[0, 1, 0, 1, 0, 1, 0, 0, 0, 0, 1, 0, 1, 1, 0]",150,102,48,11,3,0.10784313725490197,0.0625
"[1, 1, 1, 0, 0, 0, 0, 0, 0, 1, 0, 1, 0, 1, 1]",197,67,130,8,15,0.11940298507462686,0.11538461538461539
"[1, 1, 0, 0, 1, 0, 0, 0, 1, 1, 0, 0, 0, 1, 1]",162,88,74,9,7,0.10227272727272728,0.0945945945945946
"[1, 1, 0, 0, 1, 0, 0, 1, 1, 0, 0, 1, 0, 0, 0]",157,91,66,12,6,0.13186813186813187,0.09090909090909091
"[0, 1, 0, 0, 1, 0, 1, 1, 0, 0, 1, 1, 0, 1, 1]",120,68,52,6,0,0.08823529411764706,0.0
"[0, 0, 0, 1, 0, 0, 1, 0, 1, 0, 0, 1, 0, 0, 1]",220,149,71,27,5,0.18120805369127516,0.07042253521126761
"[1, 0, 0, 0, 0, 1, 1, 1, 0, 1, 1, 1, 1, 0, 1]",162,59,103,5,16,0.0847457627118644,0.1553398058252427
"[1, 0, 1, 1, 0, 1, 1, 0, 1, 0, 0, 0, 1, 0, 1]",102,48,54,3,8,0.0625,0.14814814814814814
"[1, 1, 1, 1, 1, 0, 0, 1, 0, 0, 0, 1, 0, 1, 0]",129,55,74,6,7,0.10909090909090909,0.0945945945945946
"[1, 0, 1, 0, 0, 1, 0, 0, 0, 0, 0, 1, 1, 1, 1]",228,125,103,13,12,0.104,0.11650485436893204
"[0, 1, 1, 1, 1, 0, 0, 1, 0, 1, 0, 0, 1, 1, 0]",128,69,59,6,9,0.08695652173913043,0.15254237288135594
"[1, 1, 0, 1, 1, 0, 0, 0, 0, 1, 0, 0, 1, 1, 0]",119,59,60,4,6,0.06779661016949153,0.1
"[0, 0, 1, 1, 1, 0, 0, 1, 1, 0, 1, 1, 0, 0, 0]",156,84,72,8,6,0.09523809523809523,0.08333333333333333
"[1, 0, 0, 1, 0, 1, 0, 1, 1, 0, 0, 1, 0, 0, 1]",131,74,57,6,10,0.08108108108108109,0.17543859649122806
"[0, 1, 1, 0, 0, 0, 1, 0, 0, 0, 1, 1, 1, 1, 1]",204,115,89,8,6,0.06956521739130435,0.06741573033707865
"[1, 0, 0, 1, 0, 1, 1, 0, 0, 1, 1, 1, 1, 0, 1]",148,61,87,5,6,0.08196721311475409,0.06896551724137931
"[1, 0, 0, 1, 0, 0, 1, 1, 0, 1, 0, 1, 1, 0, 1]",120,61,59,4,5,0.06557377049180328,0.0847457627118644
"[1, 0, 0, 1, 0, 1, 0, 0, 1, 0, 0, 0, 1, 0, 1]",133,84,49,3,6,0.03571428571428571,0.12244897959183673
"[1, 1, 0, 1, 0, 1, 1, 1, 0, 0, 1, 0, 1, 0, 0]",113,51,62,5,4,0.09803921568627451,0.06451612903225806
"[0, 1, 0, 1, 0, 0, 1, 1, 0, 1, 0, 0, 1, 0, 0]",125,72,53,4,10,0.05555555555555555,0.18867924528301888
"[1, 0, 1, 0, 1, 0, 0, 1, 0, 1, 0, 0, 1, 0, 0]",117,60,57,6,5,0.1,0.08771929824561403
"[0, 1, 0, 1, 0, 1, 0, 1, 0, 0, 1, 0, 1, 0, 0]",126,81,45,10,6,0.12345679012345678,0.13333333333333333
"[0, 0, 0, 1, 0, 0, 1, 1, 1, 1, 1, 0, 1, 0, 1]",123,48,75,5,5,0.10416666666666667,0.06666666666666667
"[1, 0, 0, 0, 1, 0, 1, 1, 0, 1, 1, 1, 1, 0, 1]",161,71,90,8,8,0.11267605633802817,0.08888888888888889
"[1, 1, 0, 1, 0, 1, 1, 0, 1, 0, 1, 0, 1, 0, 1]",150,62,88,7,8,0.11290322580645161,0.09090909090909091
"[1, 0, 1, 0, 1, 1, 0, 1, 1, 0, 0, 1, 0, 1, 0]",104,53,51,4,6,0.07547169811320754,0.11764705882352941
"[0, 0, 1, 1, 0, 1, 1, 0, 1, 0, 0, 1, 1, 0, 0]",171,90,81,9,11,0.1,0.13580246913580246
"[1, 1, 0, 0, 0, 0, 1, 1, 1, 0, 0, 1, 0, 1, 1]",197,85,112,8,9,0.09411764705882353,0.08035714285714286
"[1, 1, 1, 1, 1, 0, 0, 0, 1, 0, 1, 0, 0, 1, 1]",235,76,159,8,19,0.10526315789473684,0.11949685534591195
"[1, 0, 0, 1, 1, 0, 0, 1, 0, 1, 0, 0, 0, 1, 1]",167,70,97,6,13,0.08571428571428572,0.13402061855670103
"[1, 0, 1, 0, 0, 1, 1, 1, 1, 0, 0, 0, 1, 0, 1]",125,55,70,7,8,0.12727272727272726,0.11428571428571428
"[0, 1, 0, 0, 1, 0, 1, 0, 1, 0, 0, 1, 1, 0, 0]",170,86,84,12,11,0.13953488372093023,0.13095238095238096
"[0, 0, 1, 0, 0, 1, 0, 0, 1, 0, 0, 1, 0, 1, 0]",210,149,61,18,6,0.12080536912751678,0.09836065573770492
"[1, 0, 1, 0, 1, 0, 0, 1, 0, 0, 1, 0, 0, 1, 0]",127,81,46,10,3,0.12345679012345678,0.06521739130434782
"[0, 0, 0, 1, 0, 1, 1, 0, 0, 0, 1, 0, 0, 1, 0]",231,153,78,9,10,0.058823529411764705,0.1282051282051282
"[1, 1, 1, 0, 0, 1, 0, 1, 1, 0, 1, 0, 1, 1, 0]",170,74,96,7,8,0.0945945945945946,0.08333333333333333
"[1, 0, 1, 1, 0, 1, 0, 1, 1, 1, 0, 1, 0, 1, 1]",229,80,149,9,9,0.1125,0.06040268456375839
"[0, 0, 0, 1, 0, 1, 1, 1, 1, 0, 1, 1, 1, 0, 0]",121,48,73,5,7,0.10416666666666667,0.0958904109589041
"[0, 0, 1, 0, 0, 0, 1, 0, 1, 1, 0, 1, 1, 0, 1]",105,66,39,3,7,0.045454545454545456,0.1794871794871795
"[1, 1, 1, 0, 1, 0, 0, 1, 0, 0, 1, 1, 1, 0, 1]",116,45,71,9,6,0.2,0.08450704225352113
"[1, 0, 1, 1, 0, 1, 1, 0, 1, 0, 1, 1, 1, 0, 0]",148,56,92,4,9,0.07142857142857142,0.09782608695652174
"[1, 0, 1, 1, 0, 1, 0, 0, 1, 1, 0, 0, 1, 0, 1]",109,53,56,2,1,0.03773584905660377,0.017857142857142856
"[0, 0, 1, 1, 0, 0, 1, 1, 1, 0, 1, 1, 1, 0, 0]",173,77,96,8,13,0.1038961038961039,0.13541666666666666
"[0, 1, 1, 1, 1, 1, 0, 1, 0, 1, 0, 0, 1, 1, 0]",171,71,100,4,6,0.056338028169014086,0.06
"[0, 1, 1, 0, 0, 1, 1, 1, 1, 0, 1, 0, 1, 1, 0]",189,108,81,12,10,0.1111111111111111,0.12345679012345678
"[1, 0, 1, 1, 0, 0, 0, 0, 1, 0, 1, 0, 0, 0, 1]",179,102,77,9,5,0.08823529411764706,0.06493506493506493
"[1, 0, 1, 1, 0, 1, 0, 0, 1, 0, 1, 0, 1, 1, 0]",90,45,45,7,3,0.15555555555555556,0.06666666666666667
"[1, 1, 0, 1, 1, 0, 1, 0, 0, 1, 0, 1, 0, 1, 1]",131,54,77,3,7,0.05555555555555555,0.09090909090909091
"[0, 1, 1, 0, 1, 0, 0, 0, 0, 0, 1, 1, 0, 0, 1]",243,144,99,12,9,0.08333333333333333,0.09090909090909091
"[1, 0, 1, 0, 0, 0, 0, 0, 1, 1, 1, 0, 1, 1, 0]",119,63,56,11,1,0.1746031746031746,0.017857142857142856
"[0, 1, 0, 1, 1, 0, 1, 0, 0, 1, 0, 1, 0, 1, 0]",90,43,47,5,4,0.11627906976744186,0.0851063829787234
"[1, 0, 0, 1, 1, 1, 0, 0, 0, 1, 1, 1, 1, 0, 1]",163,59,104,6,12,0.1016949152542373,0.11538461538461539
"[0, 1, 0, 1, 0, 1, 1, 0, 1, 1, 0, 1, 1, 1, 0]",142,59,83,5,11,0.0847457627118644,0.13253012048192772
"[1, 0, 0, 1, 0, 1, 1, 0, 1, 0, 1, 1, 0, 0, 0]",134,64,70,6,13,0.09375,0.18571428571428572
"[0, 1, 0, 1, 0, 1, 0, 1, 1, 0, 1, 0, 1, 1, 0]",100,47,53,4,4,0.0851063829787234,0.07547169811320754
"[1, 0, 0, 1, 0, 1, 0, 1, 0, 1, 0, 1, 0, 1, 1]",132,60,72,4,4,0.06666666666666667,0.05555555555555555
"[0, 0, 0, 1, 1, 1, 0, 1, 0, 1, 1, 1, 0, 0, 0]",128,72,56,3,7,0.041666666666666664,0.125
"[0, 1, 0, 0, 0, 1, 0, 1, 1, 1, 0, 0, 0, 1, 1]",140,72,68,5,5,0.06944444444444445,0.07352941176470588
"[1, 1, 0, 1, 0, 1, 0, 0, 1, 1, 0, 1, 0, 0, 0]",110,59,51,10,7,0.1694915254237288,0.13725490196078433
"[0, 1, 0, 0, 1, 0, 0, 1, 0, 0, 1, 0, 1, 0, 0]",219,144,75,13,5,0.09027777777777778,0.06666666666666667
"[1, 1, 1, 1, 0, 0, 0, 0, 1, 0, 0, 1, 1, 1, 0]",163,85,78,10,6,0.11764705882352941,0.07692307692307693
"[0, 0, 1, 0, 0, 1, 1, 0, 1, 0, 0, 0, 1, 0, 1]",120,70,50,6,2,0.08571428571428572,0.04
"[0, 1, 1, 0, 1, 1, 1, 1, 0, 0, 0, 1, 0, 1, 0]",131,54,77,9,4,0.16666666666666666,0.05194805194805195
"[0, 0, 1, 1, 0, 1, 0, 1, 1, 0, 0, 1, 1, 0, 1]",121,58,63,5,8,0.08620689655172414,0.12698412698412698
"[1, 0, 0, 0, 1, 1, 0, 1, 1, 1, 0, 0, 0, 1, 0]",109,51,58,5,5,0.09803921568627451,0.08620689655172414
"[0, 0, 1, 0, 0, 0, 1, 1, 1, 1, 1, 0, 0, 1, 0]",129,71,58,7,8,0.09859154929577464,0.13793103448275862
"[0, 1, 0, 1, 1, 0, 1, 1, 1, 1, 0, 0, 0, 0, 0]",216,97,119,7,8,0.07216494845360824,0.06722689075630252
"[0, 1, 1, 0, 1, 0, 0, 1, 0, 1, 0, 1, 1, 0, 0]",122,71,51,6,6,0.08450704225352113,0.11764705882352941
"[1, 0, 1, 0, 0, 1, 0, 0, 1, 1, 0, 1, 1, 0, 0]",117,51,66,3,7,0.058823529411764705,0.10606060606060606
"[1, 1, 1, 1, 0, 1, 0, 0, 0, 0, 1, 0, 0, 1, 0]",101,50,51,5,5,0.1,0.09803921568627451
"[1, 1, 0, 1, 0, 0, 0, 0, 1, 0, 1, 0, 1, 0, 1]",108,64,44,5,3,0.078125,0.06818181818181818
"[0, 1, 1, 0, 1, 0, 1, 1, 0, 1, 0, 1, 0, 0, 1]",103,46,57,3,9,0.06521739130434782,0.15789473684210525
"[0, 1, 0, 1, 0, 1, 0, 0, 0, 1, 0, 1, 0, 0, 1]",148,86,62,5,7,0.05813953488372093,0.11290322580645161
"[0, 1, 0, 1, 0, 1, 1, 1, 0, 1, 0, 0, 1, 1, 0]",116,49,67,6,3,0.12244897959183673,0.04477611940298507
"[1, 1, 0, 1, 0, 0, 0, 0, 1, 1, 0, 0, 1, 0, 1]",127,60,67,6,4,0.1,0.05970149253731343
"[1, 0, 0, 0, 1, 0, 0, 1, 1, 1, 0, 1, 0, 0, 1]",107,53,54,4,3,0.07547169811320754,0.05555555555555555
"[1, 0, 1, 0, 1, 0, 1, 1, 0, 1, 1, 1, 0, 1, 0]",132,45,87,3,10,0.06666666666666667,0.11494252873563218
"[1, 0, 1, 0, 1, 1, 0, 0, 1, 0, 1, 1, 0, 0, 1]",123,55,68,10,11,0.18181818181818182,0.16176470588235295
"[0, 0, 0, 1, 1, 1, 0, 1, 1, 1, 1, 0, 0, 1, 0]",114,65,49,4,2,0.06153846153846154,0.04081632653061224
"[0, 1, 0, 1, 0, 1, 1, 0, 0, 1, 1, 0, 1, 1, 0]",107,49,58,8,6,0.16326530612244897,0.10344827586206896
"[1, 0, 1, 0, 1, 1, 1, 0, 0, 0, 1, 1, 1, 0, 1]",136,64,72,3,7,0.046875,0.09722222222222222
"[0, 1, 0, 0, 1, 1, 0, 1, 0, 0, 0, 0, 0, 1, 0]",216,134,82,16,10,0.11940298507462686,0.12195121951219512
"[0, 0, 0, 0, 1, 1, 1, 0, 1, 1, 1, 0, 1, 0, 0]",131,69,62,8,3,0.11594202898550725,0.04838709677419355
"[1, 0, 1, 1, 1, 1, 1, 0, 0, 0, 1, 0, 1, 0, 1]",134,65,69,8,6,0.12307692307692308,0.08695652173913043
"[0, 1, 0, 1, 1, 0, 0, 1, 0, 0, 0, 1, 0, 0, 1]",135,70,65,5,4,0.07142857142857142,0.06153846153846154
"[0, 0, 1, 1, 0, 0, 0, 1, 1, 0, 0, 1, 1, 1, 0]",161,89,72,8,12,0.0898876404494382,0.16666666666666666
"[0, 0, 0, 1, 0, 0, 1, 1, 1, 1, 1, 1, 0, 1, 0]",112,74,38,6,3,0.08108108108108109,0.07894736842105263
"[0, 1, 1, 1, 0, 1, 0, 1, 0, 1, 1, 1, 0, 0, 0]",123,57,66,7,3,0.12280701754385964,0.045454545454545456
"[0, 0, 1, 1, 1, 0, 1, 0, 0, 0, 0, 1, 0, 1, 1]",122,54,68,2,10,0.037037037037037035,0.14705882352941177
"[1, 1, 0, 1, 0, 1, 0, 0, 0, 0, 1, 0, 1, 1, 0]",117,59,58,5,8,0.0847457627118644,0.13793103448275862
"[0, 1, 1, 1, 0, 0, 0, 1, 0, 1, 0, 1, 0, 1, 1]",112,59,53,0,7,0.0,0.1320754716981132
"[0, 1, 1, 1, 0, 1, 1, 0, 0, 1, 1, 0, 0, 1, 0]",109,60,49,10,6,0.16666666666666666,0.12244897959183673
"[1, 0, 1, 0, 0, 0, 0, 1, 0, 0, 1, 0, 1, 0, 1]",119,71,48,7,3,0.09859154929577464,0.0625
"[0, 1, 0, 1, 0, 0, 1, 0, 0, 1, 0, 1, 0, 1, 0]",128,68,60,6,10,0.08823529411764706,0.16666666666666666
"[1, 0, 0, 0, 1, 1, 1, 0, 0, 1, 0, 0, 1, 0, 0]",148,96,52,9,4,0.09375,0.07692307692307693
"[1, 1, 0, 1, 0, 0, 0, 0, 0, 1, 0, 1, 1, 0, 1]",106,51,55,5,6,0.09803921568627451,0.10909090909090909
"[0, 0, 1, 0, 1, 0, 1, 1, 1, 1, 1, 0, 0, 1, 0]",115,58,57,4,8,0.06896551724137931,0.14035087719298245
"[1, 0, 1, 1, 1, 1, 1, 1, 0, 0, 0, 1, 0, 0, 0]",156,73,83,5,6,0.0684931506849315,0.07228915662650602
"[1, 0, 0, 0, 1, 0, 1, 1, 1, 1, 0, 1, 1, 1, 0]",152,57,95,7,6,0.12280701754385964,0.06315789473684211
"[0, 1, 1, 0, 0, 1, 0, 1, 0, 0, 1, 0, 0, 1, 0]",136,86,50,9,4,0.10465116279069768,0.08
"[0, 1, 1, 0, 0, 1, 0, 0, 1, 1, 0, 0, 1, 0, 0]",142,83,59,4,3,0.04819277108433735,0.05084745762711865
"[0, 1, 1, 1, 0, 1, 0, 0, 1, 1, 1, 0, 1, 0, 0]",122,63,59,3,9,0.047619047619047616,0.15254237288135594
"[0, 1, 0, 1, 1, 1, 0, 0, 1, 1, 1, 0, 0, 1, 0]",105,45,60,4,6,0.08888888888888889,0.1
"[0, 1, 1, 0, 0, 0, 1, 0, 1, 0, 1, 1, 1, 0, 0]",139,79,60,5,8,0.06329113924050633,0.13333333333333333
"[0, 0, 0, 0, 0, 1, 1, 1, 0, 1, 1, 1, 0, 1, 0]",132,78,54,11,4,0.14102564102564102,0.07407407407407407
"[0, 0, 1, 1, 0, 1, 1, 1, 0, 1, 0, 0, 1, 0, 1]",103,43,60,8,5,0.18604651162790697,0.08333333333333333
"[1, 1, 0, 0, 1, 0, 0, 1, 1, 0, 1, 0, 1, 0, 1]",106,47,59,8,5,0.1702127659574468,0.0847457627118644
"[1, 0, 0, 1, 1, 0, 1, 0, 0, 1, 0, 1, 0, 1, 1]",135,59,76,3,4,0.05084745762711865,0.05263157894736842
"[1, 0, 1, 0, 1, 0, 0, 1, 1, 0, 1, 0, 1, 1, 0]",112,54,58,6,3,0.1111111111111111,0.05172413793103448
"[1, 0, 1, 0, 0, 1, 1, 0, 1, 0, 1, 0, 1, 1, 1]",154,61,93,7,11,0.11475409836065574,0.11827956989247312
"[0, 0, 1, 0, 1, 0, 0, 1, 1, 0, 1, 0, 1, 0, 1]",107,55,52,5,7,0.09090909090909091,0.1346153846153846
"[1, 0, 1, 0, 0, 0, 1, 0, 0, 1, 1, 1, 0, 1, 0]",98,56,42,4,8,0.07142857142857142,0.19047619047619047
"[1, 0, 0, 1, 0, 0, 0, 1, 0, 0, 1, 0, 1, 0, 0]",260,164,96,33,12,0.20121951219512196,0.125
"[1, 1, 0, 1, 0, 0, 0, 1, 0, 0, 1, 1, 0, 0, 1]",135,62,73,6,4,0.0967741935483871,0.0547945205479452
"[1, 1, 1, 0, 0, 0, 0, 1, 0, 1, 0, 1, 1, 0, 1]",111,48,63,3,4,0.0625,0.06349206349206349
"[1, 0, 0, 1, 0, 1, 1, 0, 1, 0, 0, 1, 0, 0, 1]",114,59,55,3,4,0.05084745762711865,0.07272727272727272
"[0, 1, 1, 0, 1, 1, 1, 1, 0, 1, 0, 0, 0, 1, 0]",101,48,53,6,4,0.125,0.07547169811320754
"[0, 1, 1, 0, 1, 0, 1, 1, 1, 1, 1, 0, 1, 0, 0]",139,63,76,7,4,0.1111111111111111,0.05263157894736842
"[0, 0, 0, 1, 1, 1, 0, 1, 1, 1, 0, 1, 0, 0, 0]",116,65,51,4,3,0.06153846153846154,0.058823529411764705
"[0, 1, 1, 0, 0, 0, 1, 0, 1, 1, 1, 1, 0, 0, 1]",126,72,54,6,8,0.08333333333333333,0.14814814814814814
"[0, 1, 0, 0, 0, 1, 1, 0, 1, 0, 1, 1, 0, 1, 0]",92,40,52,3,7,0.075,0.1346153846153846
"[0, 0, 0, 1, 1, 1, 0, 1, 1, 0, 0, 1, 0, 0, 0]",160,90,70,8,9,0.08888888888888889,0.12857142857142856
"[1, 0, 1, 0, 1, 1, 0, 1, 0, 1, 0, 1, 1, 1, 0]",139,65,74,4,7,0.06153846153846154,0.0945945945945946
"[0, 1, 1, 0, 0, 0, 1, 1, 1, 0, 1, 0, 0, 1, 0]",86,47,39,7,8,0.14893617021276595,0.20512820512820512
"[0, 1, 1, 1, 0, 1, 0, 0, 0, 0, 1, 0, 1, 1, 0]",100,54,46,5,4,0.09259259259259259,0.08695652173913043
"[1, 0, 1, 0, 1, 1, 0, 0, 1, 0, 1, 0, 0, 1, 0]",97,51,46,7,5,0.13725490196078433,0.10869565217391304
"[0, 1, 1, 1, 1, 0, 0, 0, 1, 1, 1, 0, 0, 0, 1]",164,76,88,5,6,0.06578947368421052,0.06818181818181818
"[0, 1, 1, 1, 1, 0, 1, 0, 0, 1, 0, 0, 0, 1, 0]",125,73,52,4,6,0.0547945205479452,0.11538461538461539
"[0, 1, 0, 0, 0, 1, 1, 0, 1, 1, 1, 0, 1, 1, 0]",118,50,68,4,5,0.08,0.07352941176470588
"[1, 0, 0, 1, 1, 0, 0, 0, 1, 0, 0, 1, 1, 1, 0]",128,59,69,6,6,0.1016949152542373,0.08695652173913043
"[1, 0, 0, 1, 0, 0, 0, 1, 0, 1, 1, 0, 0, 1, 1]",185,97,88,8,7,0.08247422680412371,0.07954545454545454
"[1, 0, 0, 0, 0, 0, 1, 0, 1, 1, 1, 1, 0, 0, 1]",164,84,80,7,12,0.08333333333333333,0.15
"[1, 0, 0, 0, 1, 1, 0, 1, 1, 0, 1, 1, 0, 0, 1]",116,55,61,4,5,0.07272727272727272,0.08196721311475409
"[0, 1, 0, 1, 1, 0, 0, 0, 0, 1, 0, 0, 1, 0, 1]",148,79,69,5,5,0.06329113924050633,0.07246376811594203
"[0, 0, 0, 0, 1, 0, 0, 1, 1, 1, 0, 1, 1, 1, 0]",107,58,49,5,8,0.08620689655172414,0.16326530612244897
"[0, 1, 0, 0, 0, 0, 1, 0, 1, 1, 0, 1, 1, 1, 0]",108,65,43,8,6,0.12307692307692308,0.13953488372093023
"[0, 1, 1, 1, 0, 1, 0, 1, 0, 1, 0, 1, 0, 0, 0]",112,54,58,5,3,0.09259259259259259,0.05172413793103448
"[1, 0, 0, 0, 1, 0, 1, 1, 1, 1, 0, 0, 1, 0, 0]",103,57,46,6,3,0.10526315789473684,0.06521739130434782
"[1, 0, 0, 1, 1, 0, 1, 1, 0, 0, 0, 0, 1, 0, 1]",110,55,55,5,5,0.09090909090909091,0.09090909090909091
"[0, 0, 0, 0, 0, 0, 0, 1, 1, 1, 0, 0, 1, 0, 0]",705,532,173,49,15,0.09210526315789473,0.08670520231213873
"[0, 0, 1, 1, 0, 0, 0, 1, 1, 1, 1, 1, 1, 1, 1]",697,289,408,34,32,0.11764705882352941,0.0784313725490196
"[1, 0, 0, 0, 1, 0, 1, 0, 0, 0, 1, 0, 0, 1, 1]",159,95,64,7,8,0.07368421052631578,0.125
"[1, 1, 0, 0, 0, 0, 1, 1, 0, 1, 0, 1, 1, 1, 1]",375,157,218,17,19,0.10828025477707007,0.0871559633027523
"[0, 0, 0, 0, 1, 1, 0, 1, 0, 1, 0, 0, 0, 0, 1]",327,224,103,17,8,0.07589285714285714,0.07766990291262135
"[1, 0, 1, 0, 0, 1, 1, 1, 1, 1, 1, 0, 0, 1, 1]",725,278,447,18,44,0.06474820143884892,0.09843400447427293
"[0, 1, 1, 1, 0, 1, 0, 0, 1, 1, 1, 1, 1, 1, 0]",321,138,183,14,18,0.10144927536231885,0.09836065573770492
"[1, 0, 1, 1, 1, 0, 1, 0, 0, 1, 1, 1, 1, 1, 1]",736,224,512,18,43,0.08035714285714286,0.083984375
"[1, 0, 1, 1, 0, 1, 1, 1, 1, 1, 0, 1, 0, 1, 1]",526,161,365,13,36,0.08074534161490683,0.09863013698630137
"[1, 0, 1, 0, 1, 0, 1, 1, 1, 1, 0, 1, 1, 0, 1]",238,88,150,4,16,0.045454545454545456,0.10666666666666667
"[0, 1, 1, 1, 1, 1, 1, 1, 1, 0, 0, 1, 1, 0, 1]",970,517,453,50,39,0.09671179883945841,0.08609271523178808
"[1, 0, 0, 0, 0, 0, 0, 0, 0, 0, 0, 1, 1, 1, 1]",3105,1036,2069,95,215,0.0916988416988417,0.10391493475108748
"[1, 1, 1, 1, 0, 0, 0, 0, 0, 0, 0, 0, 0, 0, 1]",2468,1448,1020,156,110,0.10773480662983426,0.10784313725490197
"[1, 0, 1, 1, 1, 1, 1, 1, 1, 1, 1, 0, 0, 0, 0]",916,333,583,27,47,0.08108108108108109,0.08061749571183534
"[1, 1, 1, 1, 0, 1, 1, 1, 1, 1, 1, 1, 1, 1, 0]",7944,1406,6538,120,611,0.08534850640113797,0.09345365555215662
"[0, 1, 0, 0, 0, 0, 0, 0, 0, 0, 1, 1, 1, 0, 0]",681,460,221,35,27,0.07608695652173914,0.12217194570135746
"[0, 1, 1, 0, 0, 1, 0, 1, 0, 0, 0, 0, 0, 0, 1]",332,230,102,21,3,0.09130434782608696,0.029411764705882353
"[0, 1, 1, 0, 0, 0, 0, 0, 0, 0, 0, 0, 0, 0, 0]",25682,23128,2554,2182,256,0.09434451746800415,0.10023492560689115
"[1, 1, 0, 0, 0, 1, 1, 1, 1, 0, 0, 1, 1, 1, 1]",821,310,511,31,48,0.1,0.09393346379647749
"[1, 1, 0, 1, 1, 1, 1, 0, 0, 1, 0, 0, 0, 1, 1]",212,79,133,8,11,0.10126582278481013,0.08270676691729323
"[1, 1, 0, 1, 1, 1, 1, 0, 1, 1, 1, 1, 1, 0, 1]",1500,352,1148,28,103,0.07954545454545454,0.0897212543554007
"[1, 0, 1, 1, 0, 1, 1, 1, 0, 1, 1, 1, 1, 0, 1]",500,136,364,16,37,0.11764705882352941,0.10164835164835165
"[1, 1, 0, 0, 0, 1, 0, 1, 0, 0, 0, 1, 1, 1, 0]",125,61,64,5,5,0.08196721311475409,0.078125
"[1, 0, 1, 0, 0, 1, 1, 1, 0, 1, 1, 0, 0, 1, 0]",146,67,79,7,8,0.1044776119402985,0.10126582278481013
"[1, 1, 0, 1, 0, 0, 0, 1, 1, 0, 0, 1, 1, 0, 0]",279,151,128,19,13,0.12582781456953643,0.1015625
"[0, 1, 1, 0, 0, 0, 0, 1, 1, 1, 1, 1, 0, 1, 0]",207,142,65,13,4,0.09154929577464789,0.06153846153846154
"[0, 1, 0, 0, 1, 1, 0, 0, 0, 0, 1, 1, 1, 1, 1]",522,249,273,24,24,0.0963855421686747,0.08791208791208792
"[0, 0, 1, 0, 0, 1, 1, 0, 0, 0, 0, 1, 1, 1, 1]",514,280,234,22,21,0.07857142857142857,0.08974358974358974
"[0, 0, 0, 0, 0, 0, 0, 1, 0, 0, 0, 1, 0, 0, 0]",7331,6121,1210,596,137,0.09736971083156347,0.11322314049586776
"[0, 0, 0, 1, 0, 0, 0, 0, 1, 1, 1, 0, 0, 0, 0]",712,505,207,45,22,0.0891089108910891,0.10628019323671498
"[1, 0, 0, 1, 0, 0, 0, 0, 0, 0, 0, 0, 0, 1, 0]",1635,1209,426,98,38,0.08105872622001654,0.0892018779342723
"[0, 1, 0, 0, 1, 0, 0, 0, 1, 0, 0, 1, 0, 0, 0]",494,340,154,25,18,0.07352941176470588,0.11688311688311688
"[0, 0, 0, 0, 1, 1, 1, 1, 1, 1, 1, 1, 0, 1, 1]",863,333,530,42,58,0.12612612612612611,0.10943396226415095
"[1, 1, 0, 0, 0, 0, 0, 1, 1, 1, 1, 1, 1, 1, 1]",997,354,643,33,60,0.09322033898305085,0.09331259720062209
"[1, 1, 1, 1, 1, 1, 1, 1, 1, 1, 0, 0, 0, 1, 1]",3607,792,2815,78,302,0.09848484848484848,0.10728241563055062
"[0, 0, 0, 0, 0, 0, 0, 0, 1, 1, 1, 1, 0, 0, 1]",2563,1630,933,154,80,0.09447852760736196,0.0857449088960343
"[0, 0, 1, 1, 1, 0, 1, 0, 0, 0, 0, 1, 1, 0, 0]",268,156,112,18,8,0.11538461538461539,0.07142857142857142
"[0, 1, 0, 0, 1, 1, 1, 0, 1, 0, 0, 0, 0, 1, 1]",153,69,84,4,10,0.057971014492753624,0.11904761904761904
"[1, 1, 1, 1, 0, 1, 0, 0, 0, 1, 1, 1, 0, 1, 0]",134,60,74,7,8,0.11666666666666667,0.10810810810810811
"[0, 0, 1, 0, 1, 0, 0, 0, 0, 0, 0, 0, 0, 1, 0]",1573,1167,406,109,37,0.0934018851756641,0.09113300492610837
"[1, 1, 0, 0, 1, 1, 0, 0, 1, 1, 1, 1, 0, 0, 0]",1467,731,736,60,84,0.08207934336525308,0.11413043478260869
"[0, 0, 1, 1, 0, 1, 1, 1, 0, 0, 0, 0, 1, 0, 1]",136,74,62,5,5,0.06756756756756757,0.08064516129032258
"[1, 0, 1, 1, 1, 1, 0, 1, 1, 0, 1, 1, 1, 1, 1]",1744,421,1323,39,102,0.09263657957244656,0.07709750566893424
"[0, 0, 1, 1, 1, 1, 1, 1, 1, 0, 1, 1, 1, 1, 1]",2871,736,2135,67,200,0.09103260869565218,0.0936768149882904
"[1, 0, 1, 1, 1, 0, 1, 1, 1, 1, 1, 1, 0, 0, 1]",802,232,570,20,58,0.08620689655172414,0.10175438596491228
"[1, 0, 1, 1, 1, 1, 1, 1, 0, 1, 1, 1, 1, 1, 0]",1572,382,1190,37,106,0.0968586387434555,0.08907563025210084
"[0, 1, 1, 1, 0, 0, 0, 0, 0, 1, 0, 1, 0, 1, 1]",134,68,66,10,8,0.14705882352941177,0.12121212121212122
"[1, 0, 0, 1, 1, 1, 0, 0, 0, 0, 0, 1, 0, 1, 0]",154,83,71,5,11,0.060240963855421686,0.15492957746478872
"[0, 1, 0, 1, 0, 1, 1, 1, 1, 0, 1, 0, 1, 0, 0]",103,47,56,7,7,0.14893617021276595,0.125
"[0, 0, 0, 0, 1, 0, 0, 1, 0, 0, 0, 0, 0, 0, 1]",1932,1517,415,142,41,0.0936058009228741,0.09879518072289156
"[1, 0, 0, 0, 0, 0, 0, 1, 1, 1, 1, 1, 1, 1, 0]",437,123,314,8,21,0.06504065040650407,0.06687898089171974
"[0, 1, 0, 0, 1, 1, 0, 0, 0, 0, 0, 0, 0, 0, 0]",3341,2513,828,214,92,0.08515718265021886,0.1111111111111111
"[0, 0, 1, 0, 0, 1, 1, 1, 0, 1, 0, 0, 1, 1, 0]",114,54,60,5,4,0.09259259259259259,0.06666666666666667
"[0, 1, 1, 0, 0, 1, 0, 0, 1, 1, 1, 0, 1, 0, 0]",128,70,58,6,6,0.08571428571428572,0.10344827586206896
"[0, 0, 0, 0, 0, 0, 1, 0, 0, 0, 0, 0, 0, 1, 1]",4035,3287,748,303,64,0.09218132035290538,0.0855614973262032
"[1, 0, 0, 0, 0, 0, 0, 0, 1, 1, 1, 0, 0, 0, 0]",802,531,271,59,25,0.1111111111111111,0.09225092250922509
"[0, 1, 0, 0, 0, 1, 1, 0, 0, 0, 0, 0, 0, 0, 0]",3106,2344,762,213,72,0.0908703071672355,0.09448818897637795
"[1, 1, 1, 1, 0, 0, 1, 1, 1, 1, 1, 1, 0, 0, 0]",2149,813,1336,72,109,0.08856088560885608,0.0815868263473054
"[1, 0, 1, 1, 0, 0, 1, 1, 1, 1, 1, 1, 1, 1, 0]",1020,338,682,34,63,0.10059171597633136,0.09237536656891496
"[1, 1, 1, 1, 1, 0, 1, 1, 1, 0, 0, 1, 1, 1, 1]",2684,582,2102,77,206,0.1323024054982818,0.09800190294957184
"[0, 1, 1, 1, 1, 0, 1, 1, 0, 1, 1, 1, 1, 1, 0]",559,181,378,14,36,0.07734806629834254,0.09523809523809523
"[1, 1, 1, 1, 1, 1, 1, 1, 0, 1, 1, 0, 0, 1, 0]",613,169,444,15,52,0.08875739644970414,0.11711711711711711
"[0, 0, 0, 0, 0, 1, 1, 0, 0, 1, 1, 0, 1, 0, 0]",420,317,103,27,19,0.08517350157728706,0.18446601941747573
"[1, 0, 1, 0, 0, 0, 0, 0, 0, 0, 0, 0, 0, 0, 0]",10575,8401,2174,796,192,0.0947506249256041,0.08831646734130635
"[1, 1, 1, 0, 1, 0, 1, 0, 0, 0, 0, 0, 0, 0, 0]",395,224,171,22,14,0.09821428571428571,0.08187134502923976
"[1, 1, 1, 1, 0, 1, 0, 1, 0, 0, 0, 0, 0, 0, 0]",242,138,104,14,11,0.10144927536231885,0.10576923076923077
"[0, 1, 1, 0, 0, 0, 0, 1, 1, 1, 1, 0, 1, 0, 1]",248,174,74,23,4,0.13218390804597702,0.05405405405405406
"[1, 0, 0, 1, 0, 0, 0, 1, 1, 0, 1, 0, 1, 1, 0]",111,54,57,9,4,0.16666666666666666,0.07017543859649122
"[1, 0, 0, 1, 1, 0, 0, 0, 0, 0, 0, 1, 0, 0, 1]",441,193,248,18,24,0.09326424870466321,0.0967741935483871
"[0, 0, 0, 0, 0, 1, 1, 1, 1, 1, 1, 0, 0, 1, 1]",1831,1469,362,146,30,0.09938733832539143,0.08287292817679558
"[0, 0, 1, 0, 0, 1, 0, 1, 1, 1, 0, 1, 0, 0, 0]",141,87,54,13,10,0.14942528735632185,0.18518518518518517
"[1, 0, 1, 0, 0, 0, 0, 0, 1, 0, 0, 1, 0, 0, 1]",238,153,85,18,10,0.11764705882352941,0.11764705882352941
"[0, 1, 0, 0, 0, 0, 1, 0, 0, 0, 1, 0, 1, 0, 0]",510,347,163,31,11,0.0893371757925072,0.06748466257668712
"[0, 0, 1, 1, 1, 0, 0, 1, 1, 0, 1, 0, 1, 1, 0]",121,55,66,6,7,0.10909090909090909,0.10606060606060606
"[0, 1, 1, 1, 0, 1, 1, 0, 1, 0, 0, 1, 1, 1, 0]",130,66,64,8,3,0.12121212121212122,0.046875
"[0, 0, 0, 1, 0, 0, 0, 0, 0, 0, 1, 1, 0, 0, 0]",3047,2381,666,213,69,0.08945821083578329,0.1036036036036036
"[1, 1, 0, 1, 0, 0, 0, 1, 0, 0, 0, 0, 0, 0, 0]",696,475,221,32,20,0.06736842105263158,0.09049773755656108
"[0, 0, 1, 0, 0, 0, 1, 1, 0, 1, 0, 0, 0, 1, 0]",205,125,80,17,7,0.136,0.0875
"[0, 0, 0, 0, 1, 0, 0, 0, 1, 1, 0, 1, 0, 0, 0]",542,365,177,40,15,0.1095890410958904,0.0847457627118644
"[1, 0, 1, 0, 1, 1, 1, 0, 0, 0, 1, 1, 0, 0, 0]",149,80,69,4,9,0.05,0.13043478260869565
"[1, 1, 1, 1, 0, 1, 1, 1, 1, 1, 1, 1, 0, 0, 1]",2734,616,2118,62,161,0.10064935064935066,0.07601510859301228
"[1, 1, 1, 1, 1, 0, 1, 1, 0, 1, 1, 1, 1, 1, 0]",1598,365,1233,33,104,0.09041095890410959,0.08434712084347121
"[1, 0, 0, 0, 1, 1, 1, 1, 1, 1, 1, 1, 1, 1, 1]",3883,887,2996,75,279,0.08455467869222097,0.0931241655540721
"[0, 1, 1, 1, 0, 0, 0, 1, 1, 1, 1, 1, 1, 1, 1]",1102,423,679,38,55,0.08983451536643026,0.08100147275405008
"[1, 0, 1, 1, 1, 0, 0, 0, 1, 1, 1, 1, 1, 1, 1]",883,273,610,28,53,0.10256410256410256,0.08688524590163935
"[1, 1, 1, 1, 1, 1, 1, 0, 1, 1, 1, 0, 0, 0, 1]",706,194,512,15,38,0.07731958762886598,0.07421875
"[0, 1, 1, 0, 1, 1, 1, 1, 1, 0, 0, 0, 1, 1, 1]",324,124,200,10,20,0.08064516129032258,0.1
"[0, 0, 1, 1, 0, 1, 1, 1, 1, 1, 0, 0, 0, 1, 1]",182,79,103,5,16,0.06329113924050633,0.1553398058252427
"[0, 1, 0, 1, 0, 0, 1, 0, 1, 0, 0, 1, 0, 0, 1]",142,93,49,12,6,0.12903225806451613,0.12244897959183673
"[0, 0, 1, 0, 1, 0, 0, 1, 0, 1, 0, 0, 1, 0, 0]",226,144,82,14,7,0.09722222222222222,0.08536585365853659
"[0, 0, 0, 0, 0, 1, 0, 1, 0, 0, 1, 0, 1, 0, 0]",559,401,158,44,11,0.10972568578553615,0.06962025316455696
"[0, 0, 0, 0, 0, 0, 0, 1, 1, 1, 1, 0, 0, 0, 1]",821,646,175,75,19,0.11609907120743033,0.10857142857142857
"[1, 0, 1, 0, 0, 0, 0, 0, 0, 0, 1, 1, 1, 1, 0]",349,200,149,19,9,0.095,0.06040268456375839
"[1, 1, 1, 0, 0, 0, 0, 1, 0, 0, 1, 0, 0, 0, 1]",178,90,88,10,7,0.1111111111111111,0.07954545454545454
"[1, 1, 0, 0, 0, 0, 1, 0, 0, 1, 1, 1, 1, 1, 0]",147,70,77,3,6,0.04285714285714286,0.07792207792207792
"[0, 1, 0, 1, 1, 0, 0, 0, 1, 1, 1, 0, 0, 0, 0]",194,113,81,12,9,0.10619469026548672,0.1111111111111111
"[1, 0, 0, 1, 0, 1, 1, 0, 0, 0, 1, 1, 1, 0, 0]",133,61,72,9,4,0.14754098360655737,0.05555555555555555
"[0, 1, 0, 1, 1, 1, 1, 1, 0, 1, 1, 1, 1, 1, 1]",1912,481,1431,48,143,0.0997920997920998,0.09993011879804332
"[1, 0, 0, 1, 1, 1, 0, 1, 0, 1, 1, 1, 1, 1, 0]",236,82,154,7,14,0.08536585365853659,0.09090909090909091
"[1, 1, 0, 0, 1, 1, 1, 0, 1, 0, 1, 1, 1, 1, 1]",743,213,530,18,51,0.08450704225352113,0.09622641509433963
"[1, 0, 1, 1, 1, 1, 1, 1, 0, 0, 0, 1, 1, 1, 1]",795,243,552,26,55,0.10699588477366255,0.09963768115942029
"[1, 0, 1, 0, 1, 1, 1, 1, 1, 1, 0, 0, 0, 1, 1]",312,98,214,4,17,0.04081632653061224,0.0794392523364486
"[1, 0, 0, 1, 1, 1, 1, 0, 0, 1, 1, 1, 1, 1, 1]",5073,625,4448,68,449,0.1088,0.10094424460431654
"[1, 1, 1, 0, 0, 1, 1, 1, 1, 0, 0, 1, 1, 1, 1]",5184,704,4480,65,426,0.09232954545454546,0.09508928571428571
"[1, 1, 0, 1, 1, 0, 1, 1, 1, 0, 1, 1, 1, 0, 1]",477,119,358,12,40,0.10084033613445378,0.11173184357541899
"[1, 1, 1, 1, 1, 1, 1, 1, 1, 1, 0, 1, 1, 0, 1]",7941,1356,6585,118,638,0.08702064896755163,0.09688686408504177
"[1, 1, 0, 1, 1, 1, 1, 1, 1, 0, 0, 0, 0, 1, 1]",857,282,575,27,52,0.09574468085106383,0.09043478260869565
"[1, 1, 1, 0, 0, 1, 0, 1, 1, 1, 1, 0, 1, 1, 1]",606,157,449,15,33,0.09554140127388536,0.07349665924276169
"[1, 1, 1, 0, 1, 1, 1, 0, 1, 0, 1, 0, 1, 1, 1]",535,160,375,17,42,0.10625,0.112
"[1, 1, 1, 0, 1, 0, 1, 1, 0, 1, 1, 1, 1, 1, 0]",518,160,358,12,31,0.075,0.08659217877094973
"[0, 1, 1, 1, 0, 0, 1, 0, 1, 1, 1, 1, 1, 1, 1]",728,245,483,27,43,0.11020408163265306,0.08902691511387163
"[1, 1, 1, 0, 0, 1, 1, 1, 0, 0, 1, 0, 1, 1, 1]",366,97,269,12,28,0.12371134020618557,0.10408921933085502
"[1, 1, 1, 1, 0, 0, 1, 1, 0, 1, 1, 1, 0, 0, 1]",348,111,237,12,18,0.10810810810810811,0.0759493670886076
"[1, 1, 0, 0, 1, 1, 0, 1, 0, 1, 1, 1, 0, 1, 1]",276,99,177,7,14,0.0707070707070707,0.07909604519774012
"[1, 0, 0, 0, 0, 0, 1, 1, 0, 1, 1, 0, 1, 1, 1]",169,73,96,4,9,0.0547945205479452,0.09375
"[0, 0, 0, 0, 1, 0, 0, 0, 0, 0, 1, 1, 0, 1, 1]",344,234,110,17,9,0.07264957264957266,0.08181818181818182
"[1, 0, 1, 1, 0, 1, 0, 0, 0, 0, 1, 0, 0, 0, 0]",234,133,101,14,8,0.10526315789473684,0.07920792079207921
"[1, 0, 0, 0, 0, 1, 1, 1, 1, 1, 1, 1, 1, 1, 1]",5546,604,4942,60,490,0.09933774834437085,0.09915014164305949
"[1, 1, 1, 0, 0, 0, 0, 1, 1, 1, 1, 1, 1, 1, 1]",5717,745,4972,77,505,0.10335570469798658,0.10156878519710379
"[1, 1, 1, 1, 1, 1, 1, 1, 0, 0, 0, 0, 1, 1, 1]",5915,1625,4290,145,408,0.08923076923076922,0.0951048951048951
"[1, 0, 1, 0, 1, 1, 0, 1, 1, 1, 1, 0, 1, 1, 1]",557,152,405,16,40,0.10526315789473684,0.09876543209876543
"[1, 1, 1, 0, 1, 0, 1, 1, 0, 1, 1, 1, 1, 0, 1]",516,154,362,18,34,0.11688311688311688,0.09392265193370165
"[0, 1, 0, 0, 0, 1, 0, 1, 1, 1, 1, 1, 0, 0, 0]",171,100,71,10,4,0.1,0.056338028169014086
"[1, 1, 1, 0, 1, 0, 0, 0, 0, 0, 0, 0, 0, 0, 0]",973,636,337,75,32,0.1179245283018868,0.09495548961424333
"[0, 0, 0, 0, 1, 1, 1, 0, 0, 0, 1, 0, 0, 0, 0]",668,484,184,39,13,0.08057851239669421,0.07065217391304347
"[0, 0, 0, 0, 1, 0, 1, 0, 0, 0, 1, 0, 1, 0, 0]",515,365,150,41,6,0.11232876712328767,0.04
"[1, 1, 1, 0, 1, 0, 1, 1, 1, 1, 1, 1, 1, 0, 0]",870,235,635,18,56,0.07659574468085106,0.08818897637795275
"[0, 0, 0, 1, 1, 1, 1, 0, 1, 0, 0, 1, 1, 1, 1]",298,169,129,8,9,0.047337278106508875,0.06976744186046512
"[0, 0, 0, 0, 0, 0, 1, 1, 1, 1, 1, 1, 0, 1, 1]",568,295,273,29,19,0.09830508474576272,0.0695970695970696
"[0, 1, 1, 1, 0, 0, 0, 0, 0, 0, 0, 0, 1, 1, 1]",638,403,235,35,19,0.08684863523573201,0.08085106382978724
"[0, 1, 0, 1, 1, 1, 0, 0, 0, 1, 0, 0, 0, 1, 1]",148,75,73,7,6,0.09333333333333334,0.0821917808219178
"[0, 0, 1, 1, 1, 1, 1, 1, 1, 1, 0, 1, 1, 1, 1]",3063,788,2275,88,204,0.1116751269035533,0.08967032967032967
"[0, 1, 1, 0, 0, 0, 0, 0, 0, 0, 0, 0, 1, 1, 1]",2011,1714,297,176,26,0.10268378063010501,0.08754208754208755
"[1, 1, 1, 0, 0, 0, 0, 1, 0, 0, 0, 0, 1, 1, 0]",217,114,103,10,10,0.08771929824561403,0.0970873786407767
"[0, 0, 0, 0, 1, 0, 0, 1, 0, 0, 1, 0, 0, 0, 0]",1646,1249,397,95,38,0.07606084867894315,0.09571788413098237
"[1, 1, 0, 0, 0, 1, 0, 0, 0, 0, 0, 0, 0, 0, 0]",2471,1865,606,188,54,0.10080428954423593,0.0891089108910891
"[1, 1, 0, 1, 0, 1, 1, 1, 1, 1, 1, 1, 0, 1, 0]",490,143,347,14,36,0.0979020979020979,0.1037463976945245
"[0, 0, 0, 0, 0, 0, 0, 0, 1, 1, 1, 0, 1, 1, 0]",402,272,130,20,10,0.07352941176470588,0.07692307692307693
"[1, 0, 0, 1, 0, 1, 1, 0, 0, 1, 1, 0, 0, 0, 0]",328,167,161,10,17,0.059880239520958084,0.10559006211180125
"[1, 1, 1, 1, 1, 1, 1, 1, 1, 0, 0, 0, 1, 1, 1]",3661,755,2906,81,302,0.10728476821192053,0.10392291810048176
"[1, 0, 0, 1, 1, 1, 0, 0, 1, 1, 0, 0, 0, 0, 0]",378,213,165,26,16,0.12206572769953052,0.09696969696969697
"[0, 1, 1, 0, 0, 1, 1, 0, 1, 1, 0, 0, 1, 1, 1]",279,156,123,11,9,0.07051282051282051,0.07317073170731707
"[0, 1, 1, 0, 1, 0, 1, 1, 0, 0, 1, 1, 0, 1, 1]",130,56,74,6,9,0.10714285714285714,0.12162162162162163
"[1, 0, 1, 1, 1, 0, 1, 1, 0, 0, 1, 0, 0, 1, 0]",114,55,59,2,9,0.03636363636363636,0.15254237288135594
"[0, 0, 0, 1, 1, 1, 0, 0, 1, 1, 0, 0, 0, 0, 1]",339,213,126,22,10,0.10328638497652583,0.07936507936507936
"[0, 1, 1, 1, 1, 1, 1, 1, 1, 1, 1, 0, 0, 1, 1]",6793,3615,3178,343,295,0.09488243430152143,0.09282567652611705
"[0, 1, 0, 0, 0, 0, 0, 0, 0, 1, 0, 1, 0, 0, 1]",568,394,174,35,15,0.08883248730964467,0.08620689655172414
"[0, 0, 0, 0, 1, 1, 1, 1, 1, 0, 1, 1, 1, 1, 1]",600,228,372,19,32,0.08333333333333333,0.08602150537634409
"[1, 1, 1, 1, 0, 0, 0, 0, 1, 1, 1, 1, 1, 0, 1]",718,243,475,22,48,0.09053497942386832,0.10105263157894737
"[1, 1, 1, 1, 1, 1, 1, 1, 1, 1, 0, 0, 0, 0, 1]",5389,1422,3967,125,399,0.08790436005625879,0.10057978321149483
"[1, 0, 0, 0, 0, 0, 1, 0, 1, 1, 0, 0, 0, 0, 0]",735,478,257,46,25,0.09623430962343096,0.09727626459143969
"[1, 0, 1, 1, 1, 0, 0, 0, 0, 0, 0, 0, 0, 0, 1]",401,243,158,19,15,0.07818930041152264,0.0949367088607595
"[1, 0, 1, 0, 1, 1, 1, 0, 0, 0, 0, 0, 0, 0, 0]",546,310,236,32,28,0.1032258064516129,0.11864406779661017
"[0, 0, 1, 0, 0, 0, 1, 0, 0, 1, 0, 0, 0, 0, 1]",579,434,145,38,17,0.08755760368663594,0.11724137931034483
"[0, 1, 0, 0, 0, 1, 1, 0, 0, 1, 0, 0, 0, 0, 0]",586,403,183,39,14,0.0967741935483871,0.07650273224043716
"[0, 1, 1, 1, 0, 0, 0, 0, 1, 1, 0, 1, 1, 0, 0]",149,83,66,8,7,0.0963855421686747,0.10606060606060606
"[1, 0, 1, 1, 1, 1, 1, 1, 1, 0, 0, 1, 1, 1, 1]",3566,873,2693,94,232,0.10767468499427263,0.08614927590048273
"[0, 0, 0, 0, 0, 1, 0, 0, 1, 1, 0, 0, 0, 0, 0]",2598,2007,591,170,57,0.08470353761833582,0.09644670050761421
"[1, 1, 1, 1, 0, 0, 0, 0, 0, 0, 1, 0, 0, 0, 0]",552,354,198,36,21,0.1016949152542373,0.10606060606060606
"[0, 0, 0, 1, 1, 1, 1, 1, 1, 1, 1, 0, 0, 0, 0]",1678,1320,358,140,39,0.10606060606060606,0.10893854748603352
"[1, 0, 0, 1, 1, 0, 0, 1, 1, 1, 1, 1, 0, 1, 1]",551,124,427,17,39,0.13709677419354838,0.09133489461358314
"[1, 1, 1, 0, 1, 0, 0, 0, 0, 0, 0, 0, 0, 1, 1]",412,205,207,16,14,0.07804878048780488,0.06763285024154589
"[1, 1, 1, 1, 0, 1, 0, 0, 0, 0, 0, 0, 0, 0, 1]",303,169,134,11,9,0.0650887573964497,0.06716417910447761
"[0, 0, 0, 0, 0, 0, 1, 1, 1, 1, 0, 1, 0, 0, 0]",446,278,168,26,12,0.09352517985611511,0.07142857142857142
"[0, 1, 0, 0, 0, 0, 0, 0, 1, 1, 1, 1, 0, 1, 0]",209,123,86,7,9,0.056910569105691054,0.10465116279069768
"[0, 0, 0, 0, 1, 1, 1, 1, 0, 0, 1, 1, 1, 1, 0]",1604,828,776,80,63,0.0966183574879227,0.08118556701030928
"[1, 0, 0, 0, 0, 1, 0, 0, 0, 1, 0, 0, 1, 0, 1]",219,137,82,10,7,0.072992700729927,0.08536585365853659
"[0, 0, 0, 1, 1, 1, 1, 0, 0, 0, 1, 0, 0, 1, 1]",256,182,74,19,12,0.1043956043956044,0.16216216216216217
"[1, 1, 0, 0, 0, 1, 0, 0, 0, 0, 1, 1, 0, 1, 1]",126,67,59,6,5,0.08955223880597014,0.0847457627118644
"[0, 0, 1, 1, 1, 1, 0, 1, 1, 0, 0, 1, 0, 0, 1]",129,60,69,4,7,0.06666666666666667,0.10144927536231885
"[0, 1, 1, 1, 1, 1, 0, 1, 0, 1, 0, 0, 1, 0, 0]",101,45,56,5,3,0.1111111111111111,0.05357142857142857
"[0, 0, 0, 0, 1, 1, 1, 1, 1, 0, 1, 1, 0, 0, 0]",175,96,79,12,11,0.125,0.13924050632911392
"[1, 0, 0, 1, 0, 1, 0, 1, 0, 0, 0, 0, 1, 1, 1]",177,99,78,8,9,0.08080808080808081,0.11538461538461539
"[1, 0, 0, 0, 1, 0, 0, 1, 0, 1, 0, 1, 0, 0, 0]",255,161,94,14,7,0.08695652173913043,0.07446808510638298
"[0, 1, 0, 1, 1, 1, 0, 0, 0, 0, 1, 0, 0, 0, 1]",138,78,60,11,9,0.14102564102564102,0.15
"[1, 1, 0, 0, 1, 0, 1, 0, 1, 1, 1, 0, 0, 0, 0]",156,67,89,10,9,0.14925373134328357,0.10112359550561797
"[0, 0, 1, 1, 1, 0, 1, 1, 0, 1, 0, 1, 0, 0, 0]",131,71,60,9,5,0.1267605633802817,0.08333333333333333
"[0, 1, 1, 1, 1, 1, 0, 1, 0, 0, 0, 1, 0, 1, 0]",116,58,58,8,6,0.13793103448275862,0.10344827586206896
"[1, 1, 1, 0, 0, 1, 1, 0, 1, 0, 0, 1, 0, 0, 0]",123,47,76,8,9,0.1702127659574468,0.11842105263157894
"[1, 0, 0, 0, 1, 1, 1, 0, 1, 0, 1, 1, 1, 1, 1]",305,100,205,11,20,0.11,0.0975609756097561
"[0, 0, 0, 1, 1, 1, 1, 0, 1, 0, 0, 1, 1, 0, 0]",204,118,86,7,9,0.059322033898305086,0.10465116279069768
"[1, 1, 1, 1, 1, 0, 0, 1, 0, 0, 0, 1, 1, 1, 1]",461,131,330,16,35,0.12213740458015267,0.10606060606060606
"[0, 0, 0, 0, 0, 0, 0, 1, 1, 0, 1, 0, 1, 0, 0]",698,526,172,57,19,0.10836501901140684,0.11046511627906977
"[0, 0, 0, 0, 1, 1, 0, 0, 0, 1, 0, 0, 0, 0, 0]",2152,1673,479,158,41,0.09444112372982666,0.08559498956158663
"[0, 0, 1, 0, 1, 1, 1, 1, 1, 1, 0, 0, 1, 1, 1]",530,201,329,18,26,0.08955223880597014,0.0790273556231003
"[1, 1, 0, 0, 0, 0, 0, 1, 1, 1, 0, 0, 1, 1, 0]",147,76,71,5,9,0.06578947368421052,0.1267605633802817
"[1, 0, 1, 1, 1, 0, 1, 0, 0, 0, 0, 0, 1, 0, 0]",137,73,64,7,4,0.0958904109589041,0.0625
"[1, 0, 1, 0, 1, 0, 1, 1, 1, 0, 0, 1, 0, 1, 1]",160,67,93,9,9,0.13432835820895522,0.0967741935483871
"[0, 0, 0, 0, 1, 0, 0, 1, 0, 1, 1, 1, 1, 0, 1]",108,62,46,4,3,0.06451612903225806,0.06521739130434782
"[1, 1, 0, 0, 1, 1, 1, 1, 0, 0, 0, 0, 0, 1, 0]",338,193,145,19,20,0.09844559585492228,0.13793103448275862
"[0, 0, 1, 1, 0, 0, 1, 1, 1, 1, 0, 0, 0, 0, 0]",2007,1220,787,95,84,0.0778688524590164,0.10673443456162643
"[1, 0, 1, 0, 0, 1, 1, 1, 0, 0, 0, 1, 1, 0, 0]",130,71,59,7,3,0.09859154929577464,0.05084745762711865
"[0, 1, 0, 1, 0, 0, 1, 1, 1, 0, 0, 0, 1, 1, 0]",111,68,43,4,1,0.058823529411764705,0.023255813953488372
"[1, 0, 0, 0, 0, 0, 0, 0, 0, 0, 0, 1, 1, 0, 1]",1054,558,496,65,49,0.11648745519713262,0.09879032258064516
"[1, 0, 0, 1, 1, 1, 1, 1, 1, 1, 1, 1, 1, 0, 0]",3967,515,3452,48,308,0.09320388349514563,0.08922363847045191
"[0, 0, 1, 0, 1, 0, 1, 1, 1, 0, 0, 1, 1, 1, 1]",255,118,137,13,14,0.11016949152542373,0.10218978102189781
"[1, 0, 0, 0, 0, 0, 1, 0, 1, 0, 1, 1, 1, 0, 0]",160,92,68,8,10,0.08695652173913043,0.14705882352941177
"[0, 1, 0, 1, 0, 0, 1, 1, 0, 0, 0, 0, 0, 1, 0]",273,162,111,9,13,0.05555555555555555,0.11711711711711711
"[0, 0, 1, 0, 0, 0, 0, 1, 1, 0, 0, 1, 1, 1, 0]",188,109,79,11,11,0.10091743119266056,0.13924050632911392
"[0, 0, 1, 0, 0, 0, 0, 1, 0, 0, 0, 0, 1, 1, 0]",666,466,200,47,15,0.10085836909871244,0.075
"[0, 1, 1, 1, 1, 0, 0, 0, 1, 1, 0, 0, 1, 0, 0]",129,75,54,7,9,0.09333333333333334,0.16666666666666666
"[0, 0, 0, 0, 0, 1, 0, 1, 0, 0, 1, 1, 1, 1, 0]",220,132,88,13,8,0.09848484848484848,0.09090909090909091
"[0, 0, 1, 0, 1, 0, 1, 1, 1, 1, 1, 0, 1, 0, 0]",113,63,50,7,7,0.1111111111111111,0.14
"[0, 0, 0, 1, 0, 0, 0, 0, 1, 0, 1, 0, 1, 1, 1]",206,129,77,16,8,0.12403100775193798,0.1038961038961039
"[1, 1, 1, 0, 0, 1, 1, 0, 0, 0, 1, 0, 0, 0, 0]",217,102,115,13,13,0.12745098039215685,0.11304347826086956
"[1, 0, 0, 0, 0, 0, 0, 0, 0, 0, 0, 0, 0, 1, 0]",8156,5860,2296,557,208,0.09505119453924915,0.09059233449477352
"[0, 0, 0, 0, 1, 0, 1, 1, 0, 0, 1, 0, 0, 1, 1]",166,109,57,13,2,0.11926605504587157,0.03508771929824561
"[0, 0, 0, 0, 0, 1, 0, 1, 1, 0, 0, 1, 0, 0, 1]",252,159,93,23,13,0.14465408805031446,0.13978494623655913
"[1, 0, 1, 1, 0, 0, 0, 0, 0, 0, 0, 0, 0, 0, 1]",1062,703,359,72,29,0.10241820768136557,0.0807799442896936
"[1, 1, 0, 1, 1, 1, 1, 1, 1, 0, 1, 1, 0, 1, 1]",1578,375,1203,31,121,0.08266666666666667,0.10058187863674148
"[0, 0, 1, 1, 0, 1, 1, 1, 1, 1, 1, 0, 1, 1, 0]",225,82,143,8,20,0.0975609756097561,0.13986013986013987
"[1, 0, 1, 0, 1, 0, 0, 0, 1, 1, 0, 1, 1, 1, 1]",180,71,109,4,12,0.056338028169014086,0.11009174311926606
"[0, 0, 0, 1, 1, 1, 0, 1, 0, 0, 1, 1, 0, 1, 0]",92,54,38,5,2,0.09259259259259259,0.05263157894736842
"[0, 1, 0, 1, 0, 0, 0, 1, 0, 1, 1, 0, 0, 1, 1]",188,92,96,9,6,0.09782608695652174,0.0625
"[1, 1, 0, 0, 0, 0, 1, 0, 0, 0, 0, 1, 1, 1, 0]",150,93,57,7,7,0.07526881720430108,0.12280701754385964
"[0, 0, 0, 1, 1, 0, 0, 0, 0, 1, 0, 0, 0, 0, 1]",794,618,176,63,15,0.10194174757281553,0.08522727272727272
"[1, 1, 0, 1, 1, 1, 0, 0, 1, 1, 0, 1, 0, 0, 1]",146,64,82,5,9,0.078125,0.10975609756097561
"[0, 0, 0, 1, 1, 0, 1, 1, 1, 0, 0, 1, 1, 0, 1]",124,66,58,5,9,0.07575757575757576,0.15517241379310345
"[1, 1, 1, 1, 1, 1, 1, 0, 0, 0, 1, 0, 0, 0, 1]",212,77,135,7,20,0.09090909090909091,0.14814814814814814
"[1, 1, 0, 0, 1, 1, 0, 1, 1, 1, 1, 1, 0, 1, 1]",615,195,420,17,41,0.08717948717948718,0.09761904761904762
"[0, 1, 1, 1, 0, 1, 1, 1, 0, 0, 1, 1, 0, 1, 1]",271,96,175,5,12,0.052083333333333336,0.06857142857142857
"[0, 0, 1, 0, 0, 1, 1, 1, 0, 1, 1, 1, 0, 0, 1]",127,61,66,4,4,0.06557377049180328,0.06060606060606061
"[1, 0, 0, 0, 0, 0, 1, 0, 1, 1, 1, 1, 0, 0, 0]",209,127,82,11,8,0.08661417322834646,0.0975609756097561
"[1, 0, 0, 1, 1, 1, 0, 0, 0, 0, 0, 1, 0, 1, 1]",141,74,67,7,5,0.0945945945945946,0.07462686567164178
"[0, 0, 0, 1, 0, 0, 1, 0, 0, 1, 1, 1, 0, 0, 0]",292,180,112,17,11,0.09444444444444444,0.09821428571428571
"[0, 0, 0, 0, 0, 0, 0, 0, 1, 1, 0, 0, 0, 1, 0]",2564,1943,621,194,66,0.09984559958826557,0.10628019323671498
"[1, 1, 1, 1, 0, 0, 0, 1, 0, 1, 1, 0, 0, 0, 0]",158,82,76,8,4,0.0975609756097561,0.05263157894736842
"[0, 1, 1, 1, 1, 1, 1, 0, 0, 0, 1, 0, 1, 1, 0]",199,110,89,6,10,0.05454545454545454,0.11235955056179775
"[0, 0, 1, 1, 0, 0, 0, 1, 0, 0, 1, 0, 0, 0, 0]",642,447,195,40,23,0.0894854586129754,0.11794871794871795
"[0, 0, 0, 0, 1, 0, 0, 1, 0, 0, 0, 0, 1, 1, 1]",634,478,156,42,27,0.08786610878661087,0.17307692307692307
"[1, 1, 1, 1, 1, 1, 1, 1, 1, 1, 1, 0, 0, 1, 0]",2684,535,2149,57,218,0.10654205607476636,0.10144253140995813
"[1, 1, 1, 0, 0, 0, 0, 1, 1, 1, 0, 1, 1, 1, 1]",598,142,456,14,38,0.09859154929577464,0.08333333333333333
"[0, 1, 1, 0, 0, 0, 0, 1, 0, 0, 1, 1, 1, 1, 1]",265,170,95,14,10,0.08235294117647059,0.10526315789473684
"[0, 1, 0, 0, 1, 1, 0, 0, 0, 0, 0, 0, 1, 0, 0]",627,430,197,41,15,0.09534883720930233,0.07614213197969544
"[0, 0, 1, 1, 1, 1, 1, 1, 1, 0, 0, 1, 1, 1, 1]",1790,580,1210,58,115,0.1,0.09504132231404959
"[0, 1, 1, 1, 0, 0, 0, 0, 1, 1, 0, 0, 0, 1, 1]",170,97,73,11,5,0.1134020618556701,0.0684931506849315
"[0, 0, 1, 0, 1, 1, 0, 1, 1, 0, 1, 0, 1, 0, 0]",92,48,44,8,4,0.16666666666666666,0.09090909090909091
"[0, 1, 1, 1, 0, 1, 0, 0, 1, 0, 1, 1, 0, 1, 1]",145,53,92,3,9,0.05660377358490566,0.09782608695652174
"[1, 0, 1, 1, 1, 0, 1, 0, 0, 1, 0, 1, 1, 0, 1]",141,52,89,10,10,0.19230769230769232,0.11235955056179775
"[1, 1, 1, 0, 1, 0, 1, 1, 1, 0, 1, 0, 0, 1, 0]",130,51,79,5,8,0.09803921568627451,0.10126582278481013
"[0, 1, 0, 0, 1, 1, 1, 0, 1, 0, 1, 1, 1, 0, 1]",137,50,87,7,11,0.14,0.12643678160919541
"[0, 1, 1, 0, 1, 0, 1, 0, 0, 1, 0, 0, 1, 1, 1]",157,80,77,12,6,0.15,0.07792207792207792
"[0, 1, 1, 0, 0, 0, 0, 1, 0, 1, 0, 0, 0, 0, 1]",304,212,92,16,12,0.07547169811320754,0.13043478260869565
"[0, 0, 0, 0, 1, 0, 1, 1, 1, 1, 0, 0, 0, 0, 1]",272,175,97,18,7,0.10285714285714286,0.07216494845360824
"[1, 1, 0, 0, 0, 0, 0, 0, 0, 0, 1, 0, 1, 1, 1]",693,424,269,41,14,0.09669811320754718,0.05204460966542751
"[1, 0, 0, 0, 0, 1, 1, 0, 1, 1, 0, 0, 0, 1, 0]",179,97,82,5,6,0.05154639175257732,0.07317073170731707
"[0, 1, 1, 0, 0, 0, 0, 1, 0, 1, 0, 1, 0, 0, 0]",277,189,88,18,11,0.09523809523809523,0.125
"[0, 1, 1, 0, 0, 0, 0, 0, 1, 0, 1, 0, 0, 1, 1]",233,160,73,18,7,0.1125,0.0958904109589041
"[1, 0, 0, 0, 1, 1, 1, 0, 1, 1, 0, 0, 0, 0, 0]",199,108,91,7,8,0.06481481481481481,0.08791208791208792
"[1, 0, 1, 1, 0, 0, 0, 0, 1, 0, 0, 0, 1, 1, 1]",149,79,70,10,8,0.12658227848101267,0.11428571428571428
"[0, 1, 1, 0, 0, 1, 1, 0, 0, 1, 1, 0, 1, 0, 1]",222,150,72,11,6,0.07333333333333333,0.08333333333333333
"[0, 0, 0, 0, 1, 1, 0, 0, 1, 1, 0, 0, 1, 1, 0]",1907,1145,762,126,65,0.11004366812227075,0.08530183727034121
"[0, 0, 1, 0, 0, 0, 0, 1, 1, 0, 0, 1, 1, 0, 0]",761,502,259,47,30,0.09362549800796813,0.11583011583011583
"[1, 1, 1, 1, 1, 0, 1, 0, 0, 0, 1, 1, 1, 0, 0]",203,72,131,5,20,0.06944444444444445,0.15267175572519084
"[0, 1, 1, 1, 1, 1, 1, 0, 1, 1, 1, 0, 0, 0, 1]",299,115,184,10,14,0.08695652173913043,0.07608695652173914
"[0, 1, 1, 0, 0, 1, 0, 0, 0, 0, 1, 0, 0, 1, 0]",212,139,73,20,5,0.14388489208633093,0.0684931506849315
"[0, 1, 0, 0, 0, 0, 1, 1, 1, 0, 0, 1, 0, 1, 0]",128,75,53,8,7,0.10666666666666667,0.1320754716981132
"[0, 1, 0, 0, 1, 0, 0, 0, 1, 0, 1, 1, 0, 1, 0]",132,70,62,9,8,0.12857142857142856,0.12903225806451613
"[0, 0, 0, 0, 0, 1, 1, 1, 0, 0, 1, 0, 1, 0, 0]",272,176,96,13,11,0.07386363636363637,0.11458333333333333
"[1, 1, 0, 0, 1, 0, 1, 0, 1, 0, 1, 1, 0, 1, 1]",150,62,88,7,5,0.11290322580645161,0.056818181818181816
"[0, 0, 0, 0, 1, 0, 1, 1, 0, 0, 1, 0, 1, 0, 1]",127,81,46,10,7,0.12345679012345678,0.15217391304347827
"[0, 1, 0, 0, 0, 0, 0, 0, 0, 1, 0, 1, 1, 0, 0]",586,438,148,37,9,0.08447488584474885,0.060810810810810814
"[1, 0, 0, 0, 1, 0, 0, 0, 0, 0, 0, 1, 0, 0, 1]",554,387,167,38,15,0.09819121447028424,0.08982035928143713
"[0, 1, 0, 0, 1, 0, 1, 1, 0, 1, 1, 0, 1, 0, 0]",129,71,58,11,7,0.15492957746478872,0.1206896551724138
"[1, 0, 0, 0, 0, 0, 0, 0, 1, 1, 0, 0, 0, 0, 0]",3777,2716,1061,241,104,0.08873343151693668,0.09802073515551367
"[0, 0, 0, 0, 1, 0, 0, 0, 0, 0, 0, 0, 1, 1, 0]",2737,2111,626,208,59,0.098531501657982,0.09424920127795527
"[1, 1, 0, 0, 0, 0, 0, 0, 0, 0, 0, 1, 0, 0, 0]",2439,1779,660,185,55,0.10399100618324901,0.08333333333333333
"[0, 1, 0, 0, 0, 1, 1, 0, 0, 0, 0, 1, 1, 0, 0]",746,463,283,45,28,0.09719222462203024,0.0989399293286219
"[0, 0, 0, 1, 0, 0, 0, 1, 1, 0, 0, 0, 0, 1, 1]",654,431,223,59,21,0.1368909512761021,0.09417040358744394
"[0, 1, 0, 0, 0, 0, 1, 0, 0, 0, 0, 1, 0, 1, 1]",272,180,92,15,14,0.08333333333333333,0.15217391304347827
"[1, 0, 0, 1, 0, 1, 0, 0, 0, 0, 1, 0, 0, 0, 0]",536,359,177,36,21,0.10027855153203342,0.11864406779661017
"[0, 0, 0, 1, 1, 0, 0, 1, 0, 1, 0, 0, 0, 0, 1]",326,227,99,27,10,0.11894273127753303,0.10101010101010101
"[0, 1, 0, 1, 0, 0, 1, 1, 0, 0, 0, 1, 1, 0, 0]",196,127,69,10,8,0.07874015748031496,0.11594202898550725
"[0, 0, 0, 1, 0, 0, 0, 1, 0, 1, 0, 0, 0, 1, 0]",514,362,152,31,15,0.0856353591160221,0.09868421052631579
"[1, 1, 0, 1, 1, 0, 1, 1, 0, 0, 1, 0, 1, 1, 1]",257,83,174,5,14,0.060240963855421686,0.08045977011494253
"[0, 1, 0, 1, 1, 0, 1, 1, 0, 1, 1, 0, 0, 1, 0]",92,49,43,7,3,0.14285714285714285,0.06976744186046512
"[0, 1, 0, 1, 1, 0, 1, 0, 0, 0, 0, 1, 1, 1, 1]",195,106,89,6,5,0.05660377358490566,0.056179775280898875
"[1, 0, 1, 0, 1, 0, 1, 1, 1, 1, 1, 1, 1, 1, 1]",2105,538,1567,52,151,0.09665427509293681,0.09636247606892151
"[0, 0, 1, 0, 1, 1, 0, 0, 0, 1, 1, 1, 1, 1, 1]",260,116,144,14,6,0.1206896551724138,0.041666666666666664
"[1, 0, 0, 0, 1, 0, 1, 1, 0, 0, 0, 1, 1, 1, 1]",166,82,84,7,5,0.08536585365853659,0.05952380952380952
"[0, 1, 1, 0, 1, 0, 1, 1, 0, 0, 1, 0, 1, 1, 1]",163,75,88,14,11,0.18666666666666668,0.125
"[0, 1, 1, 0, 0, 0, 1, 1, 1, 0, 1, 0, 1, 0, 1]",97,49,48,6,8,0.12244897959183673,0.16666666666666666
"[0, 0, 1, 1, 1, 1, 0, 0, 1, 1, 0, 0, 0, 1, 1]",530,277,253,21,15,0.07581227436823104,0.05928853754940711
"[1, 0, 0, 0, 1, 0, 0, 0, 0, 0, 1, 0, 0, 0, 0]",1617,1206,411,119,51,0.09867330016583747,0.12408759124087591
"[0, 0, 1, 1, 0, 0, 0, 1, 0, 0, 0, 1, 0, 0, 0]",574,417,157,40,20,0.09592326139088729,0.12738853503184713
"[0, 1, 0, 1, 1, 0, 0, 0, 0, 1, 0, 1, 1, 0, 0]",161,99,62,11,8,0.1111111111111111,0.12903225806451613
"[1, 0, 1, 0, 1, 0, 1, 0, 1, 1, 0, 0, 0, 0, 1]",152,77,75,1,4,0.012987012987012988,0.05333333333333334
"[0, 1, 0, 1, 0, 1, 0, 1, 0, 1, 1, 0, 0, 0, 0]",189,111,78,4,4,0.036036036036036036,0.05128205128205128
"[0, 0, 0, 1, 1, 0, 0, 0, 0, 0, 1, 0, 1, 0, 1]",326,235,91,23,5,0.09787234042553192,0.054945054945054944
"[0, 0, 0, 1, 1, 1, 0, 0, 0, 1, 0, 0, 0, 0, 1]",291,189,102,16,9,0.08465608465608465,0.08823529411764706
"[0, 1, 0, 0, 0, 0, 0, 1, 1, 1, 0, 0, 0, 1, 0]",253,170,83,18,10,0.10588235294117647,0.12048192771084337
"[0, 0, 0, 1, 1, 0, 1, 0, 0, 0, 0, 0, 1, 1, 1]",296,213,83,19,11,0.0892018779342723,0.13253012048192772
"[1, 1, 0, 1, 1, 0, 1, 1, 0, 1, 1, 1, 1, 0, 1]",454,122,332,9,37,0.07377049180327869,0.11144578313253012
"[0, 1, 0, 0, 0, 0, 0, 1, 1, 1, 0, 0, 0, 0, 0]",695,468,227,44,23,0.09401709401709402,0.1013215859030837
"[1, 1, 1, 0, 0, 0, 0, 1, 1, 1, 1, 0, 1, 1, 1]",751,148,603,14,59,0.0945945945945946,0.0978441127694859
"[0, 1, 1, 1, 1, 1, 0, 0, 1, 1, 0, 0, 1, 0, 0]",167,86,81,11,7,0.12790697674418605,0.08641975308641975
"[0, 1, 1, 1, 1, 1, 1, 0, 1, 1, 1, 1, 0, 1, 1]",1755,521,1234,44,124,0.08445297504798464,0.10048622366288493
"[1, 1, 1, 0, 0, 1, 1, 0, 0, 1, 1, 1, 1, 1, 1]",5373,658,4715,58,427,0.08814589665653495,0.09056203605514317
"[0, 1, 1, 0, 0, 0, 1, 0, 1, 1, 1, 0, 0, 0, 0]",219,134,85,11,11,0.08208955223880597,0.12941176470588237
"[0, 1, 0, 1, 0, 1, 1, 1, 0, 1, 1, 1, 1, 1, 1]",652,195,457,9,49,0.046153846153846156,0.10722100656455143
"[1, 0, 1, 0, 1, 0, 1, 1, 1, 0, 1, 1, 1, 1, 1]",640,191,449,20,48,0.10471204188481675,0.10690423162583519
"[1, 1, 1, 1, 1, 1, 0, 0, 1, 1, 0, 0, 1, 1, 0]",2158,832,1326,74,142,0.0889423076923077,0.10708898944193061
"[0, 0, 1, 1, 1, 0, 0, 1, 1, 0, 0, 1, 0, 0, 1]",137,77,60,10,5,0.12987012987012986,0.08333333333333333
"[0, 1, 0, 1, 0, 1, 0, 1, 0, 0, 0, 0, 0, 0, 0]",701,481,220,44,20,0.09147609147609148,0.09090909090909091
"[0, 1, 0, 0, 1, 0, 1, 0, 0, 0, 1, 1, 1, 1, 0]",153,93,60,12,1,0.12903225806451613,0.016666666666666666
"[0, 1, 1, 1, 0, 0, 0, 0, 0, 0, 1, 1, 0, 0, 0]",724,473,251,47,23,0.09936575052854123,0.09163346613545817
"[0, 0, 0, 0, 0, 0, 0, 1, 1, 0, 1, 1, 1, 1, 0]",249,174,75,15,11,0.08620689655172414,0.14666666666666667
"[0, 0, 0, 1, 1, 0, 0, 1, 1, 0, 0, 1, 1, 1, 0]",346,261,85,24,10,0.09195402298850575,0.11764705882352941
"[1, 1, 0, 1, 1, 0, 1, 0, 0, 0, 1, 0, 0, 1, 0]",100,53,47,4,2,0.07547169811320754,0.0425531914893617
"[1, 0, 1, 1, 1, 0, 0, 1, 0, 1, 0, 1, 0, 1, 1]",153,63,90,9,9,0.14285714285714285,0.1
"[0, 0, 1, 0, 1, 0, 1, 0, 1, 1, 0, 1, 0, 1, 1]",115,55,60,2,5,0.03636363636363636,0.08333333333333333
"[1, 1, 0, 0, 0, 1, 0, 1, 0, 1, 0, 1, 1, 0, 1]",114,56,58,5,7,0.08928571428571429,0.1206896551724138
"[0, 0, 1, 1, 0, 0, 1, 0, 0, 1, 1, 0, 1, 0, 1]",118,64,54,7,5,0.109375,0.09259259259259259
"[1, 1, 0, 1, 0, 1, 0, 0, 0, 1, 0, 0, 1, 0, 1]",102,54,48,3,7,0.05555555555555555,0.14583333333333334
"[1, 0, 0, 0, 0, 0, 1, 0, 1, 1, 0, 1, 0, 1, 0]",121,59,62,5,4,0.0847457627118644,0.06451612903225806
"[1, 1, 1, 0, 0, 0, 0, 0, 1, 0, 1, 1, 0, 1, 0]",141,66,75,3,9,0.045454545454545456,0.12
"[0, 1, 0, 1, 0, 0, 0, 0, 1, 1, 0, 0, 1, 1, 1]",316,173,143,13,9,0.07514450867052024,0.06293706293706294
"[1, 1, 0, 1, 1, 1, 0, 1, 1, 0, 1, 0, 1, 1, 0]",272,93,179,5,25,0.053763440860215055,0.13966480446927373
"[1, 0, 1, 0, 0, 1, 0, 0, 0, 1, 1, 1, 0, 1, 1]",126,60,66,8,3,0.13333333333333333,0.045454545454545456
"[1, 1, 1, 1, 0, 0, 1, 0, 1, 0, 1, 0, 0, 0, 0]",159,78,81,11,9,0.14102564102564102,0.1111111111111111
"[1, 1, 0, 0, 0, 0, 0, 0, 1, 0, 1, 0, 0, 0, 0]",724,529,195,46,27,0.08695652173913043,0.13846153846153847
"[0, 0, 1, 1, 0, 0, 0, 0, 0, 0, 1, 0, 1, 0, 0]",776,555,221,40,19,0.07207207207207207,0.08597285067873303
"[1, 0, 0, 0, 0, 0, 0, 1, 1, 1, 0, 0, 0, 0, 1]",429,204,225,23,22,0.11274509803921569,0.09777777777777778
"[1, 1, 0, 0, 0, 0, 0, 0, 1, 1, 1, 0, 0, 0, 0]",636,371,265,33,18,0.0889487870619946,0.06792452830188679
"[1, 0, 1, 1, 1, 1, 1, 0, 0, 1, 0, 1, 1, 1, 0]",235,88,147,9,14,0.10227272727272728,0.09523809523809523
"[1, 0, 1, 1, 1, 1, 0, 1, 1, 1, 1, 1, 0, 0, 1]",686,187,499,17,48,0.09090909090909091,0.09619238476953908
"[0, 1, 0, 1, 1, 0, 1, 0, 1, 1, 1, 1, 0, 1, 1]",233,87,146,12,13,0.13793103448275862,0.08904109589041095
"[0, 0, 0, 1, 1, 1, 1, 1, 1, 0, 0, 1, 1, 1, 1]",2484,1850,634,174,63,0.09405405405405405,0.09936908517350158
"[0, 1, 0, 0, 1, 0, 1, 1, 1, 1, 0, 0, 0, 0, 1]",180,85,95,10,10,0.11764705882352941,0.10526315789473684
"[1, 0, 1, 0, 0, 1, 0, 1, 1, 1, 1, 0, 0, 0, 0]",174,80,94,4,9,0.05,0.09574468085106383
"[0, 1, 0, 1, 0, 0, 1, 0, 1, 1, 1, 1, 0, 0, 0]",121,59,62,4,8,0.06779661016949153,0.12903225806451613
"[0, 0, 1, 1, 1, 1, 1, 0, 1, 0, 0, 0, 0, 0, 0]",254,144,110,12,10,0.08333333333333333,0.09090909090909091
"[1, 0, 0, 1, 1, 1, 1, 1, 0, 1, 0, 0, 0, 0, 0]",186,80,106,8,7,0.1,0.0660377358490566
"[1, 1, 1, 0, 0, 1, 1, 1, 0, 1, 1, 1, 1, 0, 1]",558,140,418,10,40,0.07142857142857142,0.09569377990430622
"[0, 0, 1, 0, 0, 0, 1, 1, 1, 1, 0, 1, 0, 0, 0]",161,96,65,6,2,0.0625,0.03076923076923077
"[1, 0, 1, 0, 0, 0, 1, 0, 0, 0, 1, 1, 1, 1, 0]",143,79,64,6,4,0.0759493670886076,0.0625
"[1, 1, 0, 0, 1, 0, 0, 1, 1, 0, 0, 0, 0, 0, 0]",459,269,190,20,12,0.07434944237918216,0.06315789473684211
"[1, 0, 1, 0, 0, 0, 0, 0, 0, 0, 0, 0, 1, 1, 0]",946,647,299,56,28,0.0865533230293663,0.09364548494983277
"[0, 0, 0, 1, 1, 0, 0, 1, 0, 0, 0, 1, 0, 0, 0]",549,401,148,29,18,0.07231920199501247,0.12162162162162163
"[0, 0, 1, 1, 0, 0, 0, 1, 1, 0, 0, 1, 0, 0, 0]",293,185,108,26,11,0.14054054054054055,0.10185185185185185
"[1, 1, 1, 0, 1, 1, 0, 1, 1, 1, 1, 1, 1, 0, 0]",871,234,637,21,52,0.08974358974358974,0.08163265306122448
"[1, 0, 0, 1, 1, 1, 1, 1, 1, 1, 1, 1, 0, 1, 1]",2717,483,2234,38,216,0.07867494824016563,0.09668755595344673
"[0, 0, 0, 1, 0, 0, 0, 0, 0, 1, 0, 1, 1, 1, 0]",285,198,87,20,6,0.10101010101010101,0.06896551724137931
"[0, 1, 1, 0, 0, 0, 1, 0, 0, 0, 0, 0, 1, 0, 1]",229,152,77,14,5,0.09210526315789473,0.06493506493506493
"[1, 0, 0, 0, 1, 0, 1, 1, 0, 0, 0, 1, 0, 0, 0]",269,184,85,14,8,0.07608695652173914,0.09411764705882353
"[1, 1, 0, 0, 1, 1, 1, 1, 1, 0, 1, 1, 0, 1, 1]",682,201,481,21,36,0.1044776119402985,0.07484407484407485
"[0, 1, 1, 1, 1, 1, 1, 0, 0, 1, 1, 1, 1, 1, 0]",996,513,483,48,41,0.0935672514619883,0.08488612836438923
"[0, 1, 0, 1, 1, 0, 1, 0, 0, 1, 1, 1, 1, 1, 0]",158,71,87,6,9,0.08450704225352113,0.10344827586206896
"[0, 0, 1, 1, 0, 1, 0, 1, 1, 0, 1, 0, 0, 1, 1]",128,63,65,4,4,0.06349206349206349,0.06153846153846154
"[1, 0, 1, 0, 0, 0, 0, 0, 0, 0, 0, 1, 0, 0, 1]",618,430,188,45,19,0.10465116279069768,0.10106382978723404
"[1, 1, 0, 0, 0, 0, 1, 1, 1, 1, 1, 1, 1, 1, 0]",2163,828,1335,93,138,0.11231884057971014,0.10337078651685393
"[0, 0, 0, 1, 1, 1, 1, 1, 1, 1, 1, 1, 0, 1, 1]",967,521,446,49,43,0.09404990403071017,0.09641255605381166
"[0, 1, 1, 0, 1, 0, 0, 1, 1, 1, 1, 0, 1, 0, 0]",117,50,67,2,5,0.04,0.07462686567164178
"[0, 0, 0, 1, 1, 0, 0, 1, 1, 1, 1, 1, 1, 0, 1]",438,307,131,32,14,0.10423452768729642,0.10687022900763359
"[0, 1, 1, 1, 0, 1, 1, 0, 0, 0, 1, 1, 0, 0, 1]",171,88,83,10,5,0.11363636363636363,0.060240963855421686
"[0, 1, 0, 0, 0, 1, 1, 1, 0, 1, 1, 0, 0, 0, 1]",107,51,56,3,9,0.058823529411764705,0.16071428571428573
"[1, 1, 1, 0, 1, 0, 1, 1, 1, 1, 1, 1, 0, 1, 0]",468,145,323,16,36,0.1103448275862069,0.11145510835913312
"[1, 0, 1, 1, 0, 0, 0, 0, 0, 1, 0, 0, 0, 1, 1]",185,107,78,12,9,0.11214953271028037,0.11538461538461539
"[0, 0, 1, 0, 0, 1, 0, 1, 1, 0, 1, 1, 0, 0, 0]",171,90,81,7,7,0.07777777777777778,0.08641975308641975
"[0, 1, 0, 1, 0, 1, 1, 0, 0, 0, 1, 0, 0, 0, 1]",149,83,66,6,6,0.07228915662650602,0.09090909090909091
"[1, 1, 1, 1, 0, 0, 1, 1, 1, 1, 1, 1, 0, 1, 1]",3235,775,2460,78,242,0.10064516129032258,0.0983739837398374
"[1, 1, 0, 1, 1, 1, 1, 0, 1, 1, 1, 1, 1, 1, 0]",1652,374,1278,37,136,0.09893048128342247,0.10641627543035993
"[1, 0, 0, 0, 1, 0, 0, 0, 1, 0, 0, 0, 0, 1, 1]",318,200,118,23,6,0.115,0.05084745762711865
"[1, 0, 1, 1, 1, 1, 1, 1, 0, 1, 0, 1, 1, 1, 1]",1702,425,1277,40,133,0.09411764705882353,0.10415035238841033
"[0, 1, 1, 0, 1, 0, 0, 0, 0, 0, 0, 0, 1, 1, 0]",406,254,152,32,12,0.12598425196850394,0.07894736842105263
"[0, 0, 1, 0, 0, 0, 0, 0, 1, 0, 0, 1, 0, 0, 1]",560,398,162,40,17,0.10050251256281408,0.10493827160493827
"[0, 1, 1, 0, 0, 1, 0, 0, 0, 0, 0, 1, 0, 0, 1]",279,188,91,16,10,0.0851063829787234,0.10989010989010989
"[0, 1, 0, 1, 0, 0, 1, 0, 0, 1, 1, 0, 0, 1, 1]",193,98,95,12,5,0.12244897959183673,0.05263157894736842
"[1, 1, 1, 0, 0, 0, 1, 0, 1, 0, 1, 1, 1, 0, 1]",150,64,86,5,7,0.078125,0.08139534883720931
"[0, 1, 0, 0, 1, 1, 0, 1, 1, 1, 0, 1, 0, 0, 0]",125,65,60,3,3,0.046153846153846156,0.05
"[1, 0, 1, 1, 1, 1, 0, 0, 1, 1, 1, 1, 1, 1, 1]",3675,884,2791,82,267,0.09276018099547512,0.09566463633106413
"[0, 1, 0, 1, 0, 0, 1, 1, 1, 1, 0, 0, 1, 1, 1]",360,162,198,10,16,0.06172839506172839,0.08080808080808081
"[0, 0, 0, 0, 1, 1, 1, 1, 1, 1, 0, 0, 0, 0, 0]",2257,1417,840,131,77,0.09244883556810163,0.09166666666666666
"[0, 1, 0, 0, 1, 1, 0, 0, 0, 0, 1, 0, 0, 0, 0]",629,446,183,44,12,0.09865470852017937,0.06557377049180328
"[0, 1, 0, 0, 0, 1, 0, 0, 1, 1, 0, 0, 0, 0, 1]",375,241,134,26,10,0.1078838174273859,0.07462686567164178
"[1, 0, 1, 0, 0, 0, 1, 0, 0, 1, 1, 0, 0, 0, 0]",347,218,129,23,10,0.10550458715596331,0.07751937984496124
"[1, 0, 0, 0, 0, 0, 1, 1, 0, 0, 0, 0, 0, 0, 1]",1238,813,425,80,36,0.0984009840098401,0.08470588235294117
"[0, 1, 0, 1, 0, 0, 0, 0, 0, 1, 1, 0, 0, 0, 0]",979,699,280,86,30,0.12303290414878398,0.10714285714285714
"[0, 1, 1, 1, 1, 0, 1, 1, 1, 0, 1, 0, 0, 0, 0]",149,80,69,8,9,0.1,0.13043478260869565
"[0, 0, 0, 0, 1, 0, 0, 1, 0, 0, 1, 0, 0, 1, 0]",485,338,147,24,14,0.07100591715976332,0.09523809523809523
"[0, 0, 0, 1, 0, 0, 1, 1, 1, 1, 1, 1, 0, 1, 1]",195,87,108,11,8,0.12643678160919541,0.07407407407407407
"[0, 0, 1, 1, 1, 0, 1, 0, 0, 0, 0, 0, 0, 0, 1]",346,231,115,28,10,0.12121212121212122,0.08695652173913043
"[0, 1, 1, 1, 0, 0, 0, 0, 1, 1, 1, 0, 1, 0, 0]",121,58,63,11,8,0.1896551724137931,0.12698412698412698
"[0, 0, 0, 0, 0, 1, 1, 0, 1, 0, 1, 1, 0, 0, 0]",369,246,123,33,11,0.13414634146341464,0.08943089430894309
"[0, 0, 0, 0, 0, 0, 1, 1, 0, 1, 0, 1, 1, 0, 0]",380,247,133,27,18,0.10931174089068826,0.13533834586466165
"[0, 0, 0, 0, 0, 0, 0, 0, 0, 0, 1, 1, 0, 1, 0]",2498,1893,605,181,54,0.09561542525092445,0.08925619834710743
"[0, 1, 0, 0, 0, 1, 0, 0, 0, 0, 1, 0, 0, 0, 0]",1694,1289,405,112,39,0.08688906128782002,0.0962962962962963
"[0, 0, 0, 0, 0, 1, 1, 0, 0, 1, 0, 0, 0, 0, 0]",2295,1811,484,181,49,0.09994478188845941,0.1012396694214876
"[1, 0, 0, 0, 0, 1, 0, 0, 1, 0, 1, 0, 0, 0, 0]",602,421,181,42,22,0.0997624703087886,0.12154696132596685
"[0, 0, 0, 1, 0, 0, 0, 0, 1, 0, 0, 1, 0, 1, 0]",527,399,128,42,11,0.10526315789473684,0.0859375
"[1, 0, 0, 0, 0, 0, 0, 0, 1, 1, 0, 0, 1, 0, 0]",653,430,223,50,22,0.11627906976744186,0.09865470852017937
"[1, 0, 0, 0, 1, 1, 1, 1, 0, 1, 1, 1, 0, 0, 1]",179,77,102,9,11,0.11688311688311688,0.10784313725490197
"[1, 0, 0, 1, 0, 1, 0, 0, 1, 0, 0, 1, 1, 0, 1]",110,48,62,4,7,0.08333333333333333,0.11290322580645161
"[0, 0, 1, 0, 1, 1, 1, 1, 1, 1, 1, 0, 1, 0, 0]",143,65,78,6,7,0.09230769230769231,0.08974358974358974
"[1, 0, 0, 0, 1, 0, 1, 1, 1, 1, 1, 1, 1, 0, 1]",240,74,166,8,14,0.10810810810810811,0.08433734939759036
"[1, 0, 1, 0, 1, 1, 0, 0, 0, 1, 0, 1, 1, 1, 1]",178,79,99,8,11,0.10126582278481013,0.1111111111111111
"[1, 1, 0, 1, 0, 0, 1, 0, 1, 0, 1, 0, 1, 1, 0]",107,50,57,3,4,0.06,0.07017543859649122
"[1, 0, 1, 0, 0, 1, 1, 0, 0, 1, 0, 0, 0, 0, 0]",293,201,92,17,11,0.0845771144278607,0.11956521739130435
"[0, 0, 1, 0, 0, 1, 0, 0, 0, 1, 0, 1, 0, 0, 1]",249,159,90,19,10,0.11949685534591195,0.1111111111111111
"[0, 1, 0, 0, 1, 1, 1, 1, 1, 1, 1, 1, 1, 1, 1]",3406,973,2433,100,212,0.10277492291880781,0.08713522400328812
"[1, 1, 1, 0, 1, 1, 0, 1, 0, 0, 1, 1, 1, 1, 1]",743,221,522,20,41,0.09049773755656108,0.07854406130268199
"[1, 1, 0, 1, 0, 1, 1, 1, 1, 1, 0, 0, 0, 1, 1]",292,110,182,10,19,0.09090909090909091,0.1043956043956044
"[1, 0, 1, 0, 1, 1, 1, 1, 0, 1, 0, 0, 1, 1, 0]",167,69,98,10,6,0.14492753623188406,0.061224489795918366
"[1, 1, 1, 1, 0, 0, 1, 1, 0, 1, 1, 0, 0, 0, 0]",243,123,120,12,19,0.0975609756097561,0.15833333333333333
"[0, 1, 1, 1, 1, 1, 1, 0, 0, 1, 1, 0, 1, 1, 0]",356,192,164,27,9,0.140625,0.054878048780487805
"[1, 0, 1, 1, 1, 1, 1, 1, 0, 0, 1, 1, 0, 1, 1]",625,193,432,19,42,0.09844559585492228,0.09722222222222222
"[1, 0, 0, 0, 0, 1, 1, 0, 0, 1, 1, 0, 1, 1, 1]",390,85,305,4,35,0.047058823529411764,0.11475409836065574
"[0, 1, 1, 1, 1, 1, 0, 0, 0, 0, 0, 1, 0, 1, 0]",135,81,54,4,6,0.04938271604938271,0.1111111111111111
"[0, 0, 0, 1, 0, 0, 1, 1, 0, 0, 1, 1, 1, 0, 0]",190,112,78,13,11,0.11607142857142858,0.14102564102564102
"[0, 0, 1, 1, 0, 1, 0, 0, 1, 1, 1, 0, 1, 1, 1]",166,70,96,7,11,0.1,0.11458333333333333
"[1, 1, 0, 0, 1, 0, 0, 0, 0, 0, 1, 1, 0, 1, 0]",139,76,63,6,6,0.07894736842105263,0.09523809523809523
"[1, 0, 0, 1, 1, 1, 1, 0, 1, 0, 1, 1, 0, 1, 1]",318,101,217,20,18,0.19801980198019803,0.08294930875576037
"[1, 1, 1, 1, 0, 1, 1, 1, 0, 0, 1, 1, 1, 0, 1]",568,180,388,16,48,0.08888888888888889,0.12371134020618557
"[0, 0, 0, 1, 1, 1, 1, 0, 1, 0, 1, 0, 1, 1, 1]",242,126,116,8,12,0.06349206349206349,0.10344827586206896
"[0, 1, 1, 0, 1, 1, 0, 1, 1, 1, 1, 1, 0, 1, 1]",508,170,338,18,32,0.10588235294117647,0.09467455621301775
"[0, 1, 0, 0, 1, 1, 1, 1, 1, 1, 1, 0, 1, 0, 0]",178,70,108,10,11,0.14285714285714285,0.10185185185185185
"[1, 0, 1, 1, 1, 0, 1, 1, 1, 1, 1, 0, 1, 1, 1]",1718,400,1318,41,109,0.1025,0.082701062215478
"[1, 1, 0, 0, 1, 1, 1, 1, 0, 0, 0, 1, 1, 1, 1]",744,267,477,29,50,0.10861423220973783,0.10482180293501048
"[1, 1, 1, 1, 0, 1, 1, 1, 0, 0, 0, 0, 1, 1, 1]",577,192,385,20,27,0.10416666666666667,0.07012987012987013
"[1, 1, 0, 0, 1, 1, 1, 1, 0, 1, 1, 1, 1, 1, 1]",2694,645,2049,50,200,0.07751937984496124,0.09760858955588092
"[0, 0, 0, 0, 0, 1, 1, 0, 0, 1, 1, 0, 0, 1, 1]",2176,1839,337,193,31,0.10494834148994019,0.09198813056379822
"[1, 0, 0, 0, 0, 1, 1, 1, 1, 1, 1, 0, 0, 0, 1]",402,117,285,13,30,0.1111111111111111,0.10526315789473684
"[1, 1, 1, 1, 0, 0, 0, 1, 0, 1, 0, 1, 1, 1, 1]",364,128,236,8,28,0.0625,0.11864406779661017
"[0, 0, 1, 1, 1, 1, 1, 1, 0, 0, 1, 1, 0, 0, 1]",1930,770,1160,69,111,0.08961038961038961,0.09568965517241379
"[1, 1, 0, 0, 1, 0, 1, 1, 1, 0, 1, 0, 0, 1, 1]",150,60,90,9,9,0.15,0.1
"[0, 0, 1, 0, 0, 1, 0, 1, 1, 1, 0, 1, 1, 1, 0]",117,57,60,8,8,0.14035087719298245,0.13333333333333333
"[0, 1, 1, 0, 0, 0, 1, 1, 1, 0, 1, 0, 0, 0, 1]",124,71,53,4,3,0.056338028169014086,0.05660377358490566
"[1, 1, 0, 1, 1, 1, 1, 1, 1, 0, 1, 1, 0, 0, 0]",330,126,204,14,18,0.1111111111111111,0.08823529411764706
"[0, 0, 0, 1, 1, 0, 1, 1, 0, 0, 1, 1, 0, 0, 0]",278,171,107,12,9,0.07017543859649122,0.08411214953271028
"[0, 0, 0, 0, 1, 1, 1, 0, 0, 1, 0, 0, 1, 0, 1]",166,96,70,12,9,0.125,0.12857142857142856
"[1, 0, 1, 0, 0, 0, 1, 0, 1, 0, 0, 0, 1, 0, 1]",139,76,63,7,4,0.09210526315789473,0.06349206349206349
"[1, 1, 1, 0, 1, 0, 1, 1, 0, 0, 0, 1, 0, 1, 0]",86,38,48,5,6,0.13157894736842105,0.125
"[0, 1, 0, 0, 1, 1, 1, 1, 0, 1, 0, 1, 1, 0, 0]",143,55,88,1,9,0.01818181818181818,0.10227272727272728
"[1, 0, 0, 0, 1, 0, 0, 1, 1, 1, 1, 1, 0, 0, 1]",159,65,94,6,6,0.09230769230769231,0.06382978723404255
"[1, 0, 0, 1, 0, 1, 1, 0, 1, 1, 1, 1, 0, 1, 0]",143,54,89,5,9,0.09259259259259259,0.10112359550561797
"[1, 0, 1, 0, 0, 1, 1, 0, 0, 1, 0, 0, 0, 0, 1]",158,93,65,13,6,0.13978494623655913,0.09230769230769231
"[0, 1, 1, 1, 1, 1, 0, 0, 0, 0, 1, 1, 1, 1, 1]",1015,415,600,38,62,0.09156626506024096,0.10333333333333333
"[0, 0, 1, 1, 1, 1, 1, 0, 0, 0, 0, 1, 1, 1, 1]",690,305,385,26,33,0.08524590163934426,0.08571428571428572
"[1, 0, 0, 1, 1, 1, 1, 1, 0, 0, 0, 0, 1, 1, 1]",508,184,324,15,39,0.08152173913043478,0.12037037037037036
"[1, 1, 1, 1, 0, 0, 1, 1, 1, 1, 0, 0, 1, 0, 0]",374,167,207,8,16,0.04790419161676647,0.07729468599033816
"[1, 1, 1, 0, 1, 0, 0, 0, 0, 1, 0, 0, 1, 1, 1]",173,69,104,6,13,0.08695652173913043,0.125
"[1, 0, 1, 1, 1, 1, 1, 1, 0, 1, 0, 1, 0, 1, 1]",547,152,395,18,24,0.11842105263157894,0.060759493670886074
"[1, 0, 1, 1, 1, 1, 1, 0, 0, 1, 1, 1, 1, 0, 1]",679,193,486,16,39,0.08290155440414508,0.08024691358024691
"[1, 1, 0, 0, 0, 0, 1, 0, 1, 0, 1, 1, 1, 0, 1]",120,61,59,10,6,0.16393442622950818,0.1016949152542373
"[1, 1, 1, 0, 0, 0, 0, 1, 0, 1, 0, 1, 1, 1, 0]",120,44,76,5,6,0.11363636363636363,0.07894736842105263
"[0, 1, 1, 1, 0, 0, 1, 1, 1, 1, 1, 1, 1, 0, 0]",432,187,245,18,20,0.0962566844919786,0.08163265306122448
"[1, 0, 1, 1, 0, 1, 0, 1, 1, 1, 1, 1, 0, 1, 1]",571,166,405,17,33,0.10240963855421686,0.08148148148148149
"[0, 0, 1, 0, 0, 0, 1, 0, 1, 0, 0, 0, 1, 0, 0]",491,352,139,37,8,0.10511363636363637,0.05755395683453238
"[1, 1, 1, 1, 0, 1, 0, 1, 0, 0, 0, 0, 0, 1, 0]",106,53,53,4,3,0.07547169811320754,0.05660377358490566
"[1, 1, 1, 1, 0, 1, 1, 1, 1, 1, 0, 1, 1, 0, 0]",676,181,495,22,38,0.12154696132596685,0.07676767676767676
"[1, 0, 1, 1, 1, 1, 0, 1, 1, 1, 1, 1, 0, 1, 1]",1585,361,1224,42,103,0.11634349030470914,0.08415032679738563
"[1, 0, 1, 1, 1, 1, 1, 0, 1, 1, 1, 1, 1, 1, 0]",1615,384,1231,38,109,0.09895833333333333,0.08854589764419171
"[1, 0, 1, 0, 1, 0, 1, 0, 0, 0, 0, 0, 0, 1, 1]",212,118,94,12,5,0.1016949152542373,0.05319148936170213
"[1, 1, 1, 1, 1, 0, 0, 0, 1, 0, 1, 0, 0, 1, 0]",123,47,76,4,10,0.0851063829787234,0.13157894736842105
"[0, 0, 1, 1, 1, 1, 1, 0, 0, 1, 0, 0, 0, 0, 0]",218,134,84,15,7,0.11194029850746269,0.08333333333333333
"[0, 1, 1, 0, 1, 1, 0, 1, 0, 1, 0, 0, 0, 0, 0]",178,108,70,12,4,0.1111111111111111,0.05714285714285714
"[1, 1, 0, 0, 0, 1, 1, 0, 1, 1, 0, 1, 1, 0, 1]",149,62,87,6,8,0.0967741935483871,0.09195402298850575
"[0, 1, 1, 0, 1, 0, 1, 1, 0, 0, 0, 1, 1, 0, 1]",131,58,73,5,9,0.08620689655172414,0.1232876712328767
"[1, 0, 1, 0, 0, 1, 1, 0, 1, 0, 1, 1, 0, 0, 0]",130,71,59,6,3,0.08450704225352113,0.05084745762711865
"[1, 0, 0, 0, 0, 1, 0, 0, 0, 0, 0, 0, 1, 0, 1]",564,373,191,30,18,0.08042895442359249,0.09424083769633508
"[0, 1, 1, 1, 1, 0, 0, 1, 1, 1, 1, 0, 0, 0, 0]",1572,1233,339,117,32,0.0948905109489051,0.0943952802359882
"[0, 0, 0, 1, 1, 1, 1, 0, 1, 1, 1, 0, 1, 1, 1]",344,167,177,12,18,0.0718562874251497,0.1016949152542373
"[0, 0, 1, 0, 1, 1, 1, 1, 1, 1, 1, 1, 1, 0, 0]",497,205,292,13,32,0.06341463414634146,0.1095890410958904
"[1, 1, 0, 0, 0, 0, 1, 0, 0, 1, 0, 0, 0, 0, 1]",317,205,112,21,16,0.1024390243902439,0.14285714285714285
"[1, 0, 0, 0, 0, 0, 0, 1, 0, 0, 0, 1, 1, 1, 0]",271,162,109,10,6,0.06172839506172839,0.05504587155963303
"[1, 0, 0, 1, 1, 1, 0, 0, 0, 1, 1, 1, 0, 0, 0]",169,76,93,17,10,0.2236842105263158,0.10752688172043011
"[1, 0, 0, 0, 1, 1, 1, 1, 0, 1, 0, 1, 0, 0, 0]",124,59,65,4,4,0.06779661016949153,0.06153846153846154
"[0, 1, 0, 1, 0, 1, 1, 1, 0, 0, 0, 0, 0, 0, 1]",217,124,93,15,5,0.12096774193548387,0.053763440860215055
"[0, 1, 0, 1, 1, 0, 0, 0, 1, 0, 1, 0, 1, 0, 1]",99,49,50,6,3,0.12244897959183673,0.06
"[0, 1, 0, 1, 0, 0, 1, 0, 0, 1, 1, 0, 1, 0, 1]",132,76,56,7,9,0.09210526315789473,0.16071428571428573
"[0, 1, 0, 1, 0, 1, 1, 1, 0, 0, 1, 1, 0, 0, 1]",186,95,91,6,6,0.06315789473684211,0.06593406593406594
"[1, 1, 0, 1, 1, 0, 1, 1, 1, 1, 1, 0, 0, 1, 1]",808,237,571,26,57,0.10970464135021098,0.09982486865148861
"[0, 1, 1, 1, 1, 0, 1, 1, 0, 0, 1, 1, 0, 1, 1]",274,102,172,10,15,0.09803921568627451,0.0872093023255814
"[0, 0, 0, 0, 0, 0, 1, 0, 0, 0, 1, 0, 0, 1, 0]",1567,1195,372,119,35,0.099581589958159,0.09408602150537634
"[0, 0, 0, 0, 0, 1, 1, 0, 0, 1, 1, 0, 1, 1, 0]",292,204,88,14,8,0.06862745098039216,0.09090909090909091
"[1, 0, 0, 0, 1, 0, 0, 1, 0, 1, 1, 1, 1, 1, 1]",226,88,138,6,11,0.06818181818181818,0.07971014492753623
"[1, 0, 0, 1, 0, 1, 1, 1, 1, 0, 0, 1, 1, 1, 1]",496,188,308,13,24,0.06914893617021277,0.07792207792207792
"[0, 0, 0, 0, 1, 1, 0, 0, 1, 0, 1, 0, 1, 1, 0]",204,112,92,11,8,0.09821428571428571,0.08695652173913043
"[1, 0, 1, 0, 1, 1, 0, 0, 0, 0, 1, 1, 1, 1, 1]",400,180,220,19,22,0.10555555555555556,0.1
"[1, 1, 1, 0, 1, 1, 0, 0, 1, 0, 0, 1, 1, 1, 1]",360,132,228,9,25,0.06818181818181818,0.10964912280701754
"[1, 0, 0, 1, 1, 1, 1, 1, 0, 1, 1, 0, 0, 1, 0]",168,61,107,8,9,0.13114754098360656,0.08411214953271028
"[1, 0, 1, 1, 0, 0, 1, 0, 1, 0, 0, 0, 0, 1, 1]",151,72,79,11,7,0.1527777777777778,0.08860759493670886
"[1, 0, 1, 0, 0, 1, 1, 0, 1, 1, 0, 1, 1, 1, 0]",133,53,80,4,5,0.07547169811320754,0.0625
"[0, 1, 1, 1, 1, 1, 0, 0, 0, 1, 0, 0, 1, 0, 1]",116,58,58,3,4,0.05172413793103448,0.06896551724137931
"[0, 1, 1, 0, 0, 1, 1, 0, 0, 0, 1, 1, 1, 0, 0]",186,119,67,8,6,0.06722689075630252,0.08955223880597014
"[0, 0, 0, 0, 0, 1, 1, 1, 1, 1, 1, 1, 0, 0, 0]",407,234,173,13,18,0.05555555555555555,0.10404624277456648
"[0, 0, 1, 0, 0, 1, 0, 0, 1, 1, 0, 0, 0, 0, 0]",819,593,226,51,26,0.08600337268128162,0.11504424778761062
"[1, 0, 1, 0, 1, 0, 1, 1, 0, 0, 1, 0, 1, 1, 1]",152,65,87,3,10,0.046153846153846156,0.11494252873563218
"[1, 0, 0, 0, 0, 1, 1, 1, 0, 1, 1, 1, 0, 0, 0]",136,63,73,4,6,0.06349206349206349,0.0821917808219178
"[0, 0, 1, 1, 0, 0, 0, 0, 1, 1, 1, 0, 1, 1, 1]",412,194,218,21,28,0.10824742268041238,0.12844036697247707
"[1, 0, 1, 0, 1, 0, 1, 1, 1, 0, 0, 1, 1, 0, 0]",169,73,96,7,9,0.0958904109589041,0.09375
"[1, 0, 1, 0, 1, 0, 1, 1, 1, 1, 0, 0, 0, 1, 1]",175,65,110,10,16,0.15384615384615385,0.14545454545454545
"[0, 0, 1, 1, 1, 1, 0, 1, 0, 1, 1, 1, 1, 0, 1]",284,92,192,10,25,0.10869565217391304,0.13020833333333334
"[0, 0, 0, 1, 1, 1, 1, 0, 1, 0, 1, 1, 1, 1, 0]",175,81,94,7,11,0.08641975308641975,0.11702127659574468
"[0, 1, 1, 0, 0, 0, 0, 1, 0, 1, 1, 0, 1, 1, 1]",186,108,78,14,6,0.12962962962962962,0.07692307692307693
"[0, 0, 1, 1, 0, 0, 0, 0, 1, 0, 1, 1, 0, 1, 1]",181,99,82,17,7,0.1717171717171717,0.08536585365853659
"[1, 1, 1, 1, 1, 1, 0, 0, 0, 0, 0, 1, 0, 0, 0]",259,125,134,12,9,0.096,0.06716417910447761
"[0, 1, 1, 1, 0, 0, 0, 1, 1, 1, 0, 1, 0, 0, 0]",132,79,53,6,11,0.0759493670886076,0.20754716981132076
"[0, 1, 0, 0, 1, 1, 1, 0, 0, 0, 1, 1, 1, 0, 1]",109,52,57,3,5,0.057692307692307696,0.08771929824561403
"[0, 0, 0, 1, 0, 0, 0, 0, 1, 0, 0, 0, 1, 0, 1]",503,378,125,39,6,0.10317460317460317,0.048
"[0, 0, 0, 0, 0, 0, 1, 1, 0, 0, 0, 0, 0, 1, 1]",2284,1684,600,166,64,0.09857482185273159,0.10666666666666667
"[0, 0, 1, 1, 1, 1, 0, 0, 1, 1, 0, 1, 1, 0, 0]",245,116,129,10,11,0.08620689655172414,0.08527131782945736
"[0, 0, 0, 1, 1, 1, 1, 1, 0, 0, 1, 0, 1, 0, 1]",128,68,60,9,11,0.1323529411764706,0.18333333333333332
"[1, 0, 1, 0, 1, 1, 1, 1, 1, 0, 0, 1, 1, 1, 1]",964,290,674,20,57,0.06896551724137931,0.08456973293768547
"[1, 0, 1, 0, 1, 1, 0, 1, 0, 1, 1, 1, 1, 1, 0]",249,90,159,3,14,0.03333333333333333,0.0880503144654088
"[0, 1, 1, 0, 1, 0, 1, 1, 0, 1, 0, 1, 1, 1, 1]",293,104,189,10,14,0.09615384615384616,0.07407407407407407
"[1, 1, 1, 1, 0, 1, 1, 0, 1, 0, 1, 1, 0, 1, 0]",224,99,125,14,9,0.1414141414141414,0.072
"[0, 0, 1, 1, 0, 0, 0, 0, 1, 1, 1, 1, 1, 0, 0]",387,191,196,21,14,0.1099476439790576,0.07142857142857142
"[1, 1, 1, 1, 1, 0, 0, 0, 0, 1, 1, 1, 1, 0, 0]",2037,345,1692,27,163,0.0782608695652174,0.09633569739952719
"[0, 1, 1, 0, 0, 1, 1, 0, 0, 0, 0, 0, 1, 0, 1]",319,240,79,18,7,0.075,0.08860759493670886
"[1, 1, 1, 1, 0, 1, 1, 1, 0, 0, 0, 1, 1, 0, 1]",234,81,153,9,16,0.1111111111111111,0.10457516339869281
"[0, 1, 1, 1, 1, 1, 0, 1, 0, 0, 1, 0, 1, 1, 1]",296,114,182,16,17,0.14035087719298245,0.09340659340659341
"[0, 1, 1, 1, 1, 1, 0, 1, 0, 1, 1, 1, 1, 1, 0]",542,177,365,24,31,0.13559322033898305,0.08493150684931507
"[1, 0, 0, 0, 1, 1, 1, 1, 1, 1, 1, 1, 0, 0, 1]",742,282,460,23,45,0.08156028368794327,0.09782608695652174
"[0, 1, 1, 1, 1, 0, 1, 1, 1, 1, 0, 0, 1, 1, 0]",432,195,237,20,27,0.10256410256410256,0.11392405063291139
"[0, 1, 1, 1, 0, 1, 1, 1, 0, 1, 0, 0, 1, 1, 1]",279,115,164,8,19,0.06956521739130435,0.11585365853658537
"[0, 1, 0, 1, 0, 1, 1, 1, 1, 1, 1, 1, 1, 0, 1]",546,152,394,19,36,0.125,0.09137055837563451
"[0, 0, 0, 0, 1, 1, 1, 0, 0, 0, 1, 1, 1, 0, 0]",240,160,80,13,8,0.08125,0.1
"[0, 0, 1, 0, 0, 1, 1, 0, 0, 1, 1, 0, 0, 1, 1]",464,269,195,20,13,0.07434944237918216,0.06666666666666667
"[0, 1, 0, 0, 0, 0, 0, 1, 0, 1, 0, 0, 0, 1, 0]",475,348,127,33,8,0.09482758620689655,0.06299212598425197
"[1, 1, 0, 0, 0, 1, 0, 0, 0, 0, 0, 1, 0, 0, 0]",564,387,177,30,18,0.07751937984496124,0.1016949152542373
"[0, 0, 1, 1, 1, 1, 0, 1, 1, 1, 0, 1, 1, 1, 0]",296,107,189,14,15,0.1308411214953271,0.07936507936507936
"[0, 0, 0, 0, 0, 0, 0, 0, 0, 1, 1, 1, 1, 0, 1]",782,587,195,58,21,0.09880749574105621,0.1076923076923077
"[1, 0, 1, 1, 0, 0, 0, 0, 1, 0, 1, 1, 0, 1, 1]",117,53,64,6,4,0.11320754716981132,0.0625
"[0, 1, 1, 1, 1, 1, 0, 0, 0, 0, 1, 0, 0, 0, 0]",207,130,77,14,4,0.1076923076923077,0.05194805194805195
"[1, 0, 0, 0, 1, 1, 1, 1, 0, 1, 0, 0, 0, 1, 1]",150,67,83,7,7,0.1044776119402985,0.08433734939759036
"[1, 0, 0, 1, 1, 0, 0, 1, 1, 0, 0, 0, 1, 1, 1]",408,83,325,10,25,0.12048192771084337,0.07692307692307693
"[0, 0, 1, 1, 1, 0, 1, 0, 1, 1, 1, 0, 0, 0, 1]",103,47,56,4,4,0.0851063829787234,0.07142857142857142
"[0, 0, 1, 1, 1, 1, 1, 0, 1, 0, 0, 1, 1, 1, 0]",166,77,89,12,6,0.15584415584415584,0.06741573033707865
"[1, 1, 0, 0, 1, 1, 1, 1, 1, 0, 1, 0, 0, 1, 1]",398,139,259,11,32,0.07913669064748201,0.12355212355212356
"[0, 0, 1, 1, 1, 1, 1, 1, 1, 1, 0, 0, 0, 1, 0]",386,167,219,16,15,0.09580838323353294,0.0684931506849315
"[0, 0, 0, 0, 0, 1, 1, 0, 0, 1, 1, 1, 1, 1, 1]",1897,1510,387,136,41,0.09006622516556291,0.10594315245478036
"[1, 0, 0, 1, 0, 0, 1, 1, 0, 0, 0, 0, 1, 0, 1]",138,94,44,6,4,0.06382978723404255,0.09090909090909091
"[1, 0, 1, 1, 0, 1, 0, 0, 1, 0, 0, 1, 1, 0, 0]",168,73,95,9,10,0.1232876712328767,0.10526315789473684
"[0, 0, 1, 0, 0, 1, 0, 0, 0, 1, 1, 0, 0, 1, 0]",228,152,76,17,8,0.1118421052631579,0.10526315789473684
"[1, 0, 0, 1, 0, 0, 1, 0, 0, 0, 1, 1, 0, 0, 1]",187,121,66,15,10,0.12396694214876033,0.15151515151515152
"[0, 0, 1, 0, 0, 1, 0, 1, 0, 1, 1, 0, 1, 1, 1]",123,56,67,10,3,0.17857142857142858,0.04477611940298507
"[0, 1, 1, 1, 0, 1, 1, 1, 0, 1, 0, 1, 1, 0, 1]",226,88,138,9,11,0.10227272727272728,0.07971014492753623
"[0, 1, 0, 1, 1, 0, 1, 1, 0, 0, 1, 1, 1, 1, 1]",415,145,270,22,21,0.15172413793103448,0.07777777777777778
"[1, 1, 1, 1, 0, 0, 0, 0, 0, 1, 0, 1, 1, 1, 1]",336,140,196,17,18,0.12142857142857143,0.09183673469387756
"[1, 0, 0, 0, 0, 0, 0, 0, 1, 1, 0, 0, 0, 1, 0]",651,432,219,46,19,0.10648148148148148,0.0867579908675799
"[0, 0, 0, 1, 1, 1, 1, 0, 0, 0, 0, 0, 0, 0, 1]",967,784,183,64,14,0.08163265306122448,0.07650273224043716
"[0, 0, 0, 1, 0, 0, 1, 1, 0, 0, 1, 1, 0, 0, 0]",591,414,177,34,22,0.0821256038647343,0.12429378531073447
"[1, 0, 1, 0, 0, 1, 0, 1, 0, 0, 0, 1, 0, 0, 1]",137,81,56,8,9,0.09876543209876543,0.16071428571428573
"[1, 1, 0, 1, 1, 0, 0, 0, 1, 1, 1, 1, 1, 1, 1]",945,298,647,27,55,0.09060402684563758,0.08500772797527048
"[1, 1, 1, 0, 1, 1, 0, 0, 0, 1, 1, 1, 1, 1, 1]",900,259,641,22,60,0.08494208494208494,0.093603744149766
"[1, 1, 0, 0, 1, 1, 1, 1, 1, 1, 1, 1, 1, 0, 0]",1710,498,1212,47,115,0.09437751004016064,0.09488448844884488
"[1, 0, 0, 0, 0, 1, 1, 1, 1, 1, 1, 1, 0, 0, 1]",452,134,318,7,34,0.05223880597014925,0.1069182389937107
"[1, 1, 0, 1, 1, 0, 1, 0, 1, 0, 0, 0, 0, 1, 1]",154,72,82,5,10,0.06944444444444445,0.12195121951219512
"[1, 0, 1, 1, 1, 0, 1, 1, 0, 1, 0, 1, 0, 0, 0]",117,57,60,5,5,0.08771929824561403,0.08333333333333333
"[1, 0, 0, 0, 0, 1, 0, 1, 1, 1, 0, 1, 1, 0, 1]",115,52,63,9,8,0.17307692307692307,0.12698412698412698
"[1, 1, 0, 0, 0, 0, 1, 0, 1, 1, 1, 0, 1, 1, 0]",115,52,63,3,5,0.057692307692307696,0.07936507936507936
"[1, 1, 1, 0, 1, 1, 0, 1, 1, 1, 0, 0, 1, 1, 1]",737,201,536,18,44,0.08955223880597014,0.08208955223880597
"[1, 0, 1, 1, 1, 0, 1, 1, 0, 1, 1, 1, 0, 0, 1]",278,86,192,3,13,0.03488372093023256,0.06770833333333333
"[1, 1, 0, 1, 1, 1, 0, 1, 1, 0, 1, 1, 1, 0, 0]",272,104,168,8,15,0.07692307692307693,0.08928571428571429
"[0, 1, 1, 0, 1, 1, 1, 0, 1, 1, 0, 1, 1, 1, 0]",234,90,144,15,8,0.16666666666666666,0.05555555555555555
"[0, 1, 0, 1, 1, 0, 1, 1, 1, 0, 1, 1, 0, 1, 1]",215,74,141,7,16,0.0945945945945946,0.11347517730496454
"[0, 1, 0, 0, 1, 1, 1, 1, 1, 1, 1, 0, 0, 1, 1]",531,207,324,22,34,0.10628019323671498,0.10493827160493827
"[0, 1, 1, 1, 1, 0, 1, 0, 0, 1, 1, 1, 1, 1, 1]",864,306,558,32,62,0.10457516339869281,0.1111111111111111
"[1, 0, 0, 0, 1, 0, 0, 0, 1, 1, 0, 1, 0, 0, 0]",224,137,87,10,3,0.072992700729927,0.034482758620689655
"[0, 0, 1, 0, 0, 0, 1, 0, 0, 0, 1, 1, 0, 1, 0]",208,136,72,9,10,0.0661764705882353,0.1388888888888889
"[0, 1, 1, 0, 1, 0, 1, 0, 1, 0, 1, 1, 1, 1, 0]",138,63,75,5,8,0.07936507936507936,0.10666666666666667
"[1, 0, 0, 0, 1, 0, 1, 0, 1, 1, 0, 1, 0, 1, 0]",90,48,42,8,2,0.16666666666666666,0.047619047619047616
"[1, 0, 1, 1, 1, 0, 0, 0, 1, 0, 1, 0, 1, 1, 0]",107,49,58,7,2,0.14285714285714285,0.034482758620689655
"[1, 1, 1, 0, 0, 1, 1, 0, 0, 1, 1, 1, 0, 0, 0]",265,85,180,9,14,0.10588235294117647,0.07777777777777778
"[1, 0, 0, 0, 1, 0, 0, 0, 0, 0, 1, 1, 1, 1, 0]",296,176,120,20,15,0.11363636363636363,0.125
"[1, 0, 1, 0, 0, 0, 1, 0, 1, 0, 1, 1, 1, 0, 0]",105,60,45,4,9,0.06666666666666667,0.2
"[1, 0, 0, 1, 1, 0, 0, 0, 1, 0, 0, 1, 0, 1, 1]",154,59,95,4,10,0.06779661016949153,0.10526315789473684
"[0, 1, 0, 1, 1, 1, 0, 0, 1, 1, 0, 0, 0, 1, 0]",100,56,44,6,1,0.10714285714285714,0.022727272727272728
"[1, 0, 1, 0, 1, 0, 1, 1, 1, 1, 0, 0, 1, 0, 1]",138,58,80,2,5,0.034482758620689655,0.0625
"[0, 0, 1, 1, 0, 0, 1, 1, 0, 1, 0, 0, 0, 1, 0]",184,101,83,10,9,0.09900990099009901,0.10843373493975904
"[0, 0, 0, 1, 1, 0, 0, 1, 1, 0, 1, 0, 0, 0, 1]",209,144,65,18,4,0.125,0.06153846153846154
"[0, 0, 1, 0, 0, 1, 1, 0, 1, 0, 0, 0, 1, 1, 0]",182,110,72,9,9,0.08181818181818182,0.125
"[0, 0, 1, 1, 0, 1, 1, 1, 0, 1, 1, 0, 0, 1, 0]",106,44,62,1,5,0.022727272727272728,0.08064516129032258
"[0, 1, 1, 0, 1, 1, 0, 0, 1, 1, 0, 1, 1, 1, 0]",156,59,97,3,8,0.05084745762711865,0.08247422680412371
"[0, 1, 0, 1, 1, 1, 1, 0, 1, 0, 0, 0, 0, 1, 1]",154,72,82,11,12,0.1527777777777778,0.14634146341463414
"[1, 0, 1, 0, 1, 1, 1, 1, 1, 1, 0, 1, 0, 0, 0]",153,64,89,6,4,0.09375,0.0449438202247191
"[0, 0, 1, 1, 1, 0, 1, 1, 1, 1, 1, 1, 0, 0, 0]",242,109,133,9,7,0.08256880733944955,0.05263157894736842
"[0, 1, 1, 1, 1, 0, 0, 1, 1, 1, 0, 1, 1, 1, 0]",283,135,148,9,15,0.06666666666666667,0.10135135135135136
"[0, 1, 1, 1, 1, 1, 1, 1, 1, 0, 1, 1, 0, 1, 1]",1823,597,1226,48,127,0.08040201005025126,0.10358890701468189
"[0, 0, 0, 0, 0, 0, 1, 1, 1, 0, 1, 1, 0, 0, 1]",241,140,101,12,12,0.08571428571428572,0.1188118811881188
"[0, 1, 1, 1, 1, 1, 1, 1, 0, 0, 0, 0, 0, 0, 1]",532,237,295,22,33,0.09282700421940929,0.11186440677966102
"[1, 1, 0, 1, 1, 1, 1, 1, 1, 1, 0, 0, 0, 0, 0]",441,157,284,16,23,0.10191082802547771,0.08098591549295775
"[0, 1, 0, 1, 1, 0, 1, 1, 1, 1, 1, 1, 1, 0, 0]",324,133,191,11,23,0.08270676691729323,0.12041884816753927
"[0, 0, 0, 1, 1, 0, 0, 1, 0, 1, 1, 0, 0, 0, 0]",330,231,99,21,12,0.09090909090909091,0.12121212121212122
"[1, 0, 0, 0, 1, 1, 0, 0, 0, 0, 0, 0, 0, 1, 1]",545,322,223,32,24,0.09937888198757763,0.10762331838565023
"[1, 1, 1, 1, 1, 1, 1, 1, 0, 1, 0, 0, 0, 1, 1]",860,215,645,22,54,0.10232558139534884,0.08372093023255814
"[0, 1, 1, 1, 0, 1, 1, 1, 1, 0, 0, 0, 0, 1, 1]",384,189,195,14,9,0.07407407407407407,0.046153846153846156
"[0, 1, 0, 1, 1, 1, 0, 1, 1, 1, 0, 1, 0, 0, 1]",144,59,85,7,10,0.11864406779661017,0.11764705882352941
"[1, 1, 1, 0, 1, 0, 1, 1, 1, 0, 1, 1, 1, 0, 1]",528,141,387,20,34,0.14184397163120568,0.08785529715762273
"[1, 1, 1, 1, 1, 1, 0, 1, 1, 0, 0, 0, 0, 0, 0]",323,136,187,11,21,0.08088235294117647,0.11229946524064172
"[1, 1, 0, 0, 0, 1, 0, 0, 1, 1, 1, 0, 1, 1, 0]",106,49,57,4,5,0.08163265306122448,0.08771929824561403
"[0, 0, 1, 0, 0, 0, 0, 0, 1, 0, 1, 1, 0, 0, 0]",613,442,171,38,13,0.08597285067873303,0.07602339181286549
"[1, 1, 1, 0, 0, 0, 1, 0, 0, 0, 0, 0, 1, 0, 1]",161,89,72,5,3,0.056179775280898875,0.041666666666666664
"[0, 1, 0, 1, 1, 0, 0, 0, 0, 1, 1, 1, 0, 0, 1]",145,80,65,8,5,0.1,0.07692307692307693
"[0, 1, 1, 0, 0, 0, 0, 0, 0, 1, 1, 1, 1, 1, 0]",365,270,95,30,6,0.1111111111111111,0.06315789473684211
"[0, 0, 0, 1, 1, 0, 0, 1, 1, 1, 0, 0, 1, 1, 0]",224,150,74,16,8,0.10666666666666667,0.10810810810810811
"[1, 1, 1, 1, 0, 0, 1, 0, 0, 0, 0, 0, 0, 1, 1]",311,144,167,14,14,0.09722222222222222,0.08383233532934131
"[0, 0, 0, 0, 1, 1, 0, 1, 1, 0, 0, 0, 0, 1, 1]",324,200,124,21,12,0.105,0.0967741935483871
"[0, 1, 1, 0, 0, 0, 0, 1, 1, 0, 1, 1, 0, 0, 0]",261,170,91,9,6,0.052941176470588235,0.06593406593406594
"[0, 0, 0, 1, 0, 0, 0, 1, 0, 0, 1, 1, 0, 0, 1]",300,195,105,13,10,0.06666666666666667,0.09523809523809523
"[1, 1, 1, 0, 0, 0, 0, 0, 1, 0, 0, 1, 0, 0, 0]",290,176,114,17,10,0.09659090909090909,0.08771929824561403
"[1, 1, 0, 1, 1, 1, 0, 0, 0, 0, 0, 1, 0, 0, 0]",170,95,75,13,10,0.1368421052631579,0.13333333333333333
"[0, 0, 1, 0, 0, 1, 1, 0, 0, 0, 1, 1, 0, 1, 1]",141,69,72,9,5,0.13043478260869565,0.06944444444444445
"[1, 1, 0, 0, 0, 1, 0, 0, 1, 1, 0, 0, 0, 1, 1]",164,88,76,10,8,0.11363636363636363,0.10526315789473684
"[1, 1, 1, 1, 1, 1, 0, 0, 1, 1, 0, 0, 0, 1, 0]",357,153,204,17,17,0.1111111111111111,0.08333333333333333
"[0, 0, 1, 0, 1, 0, 0, 0, 1, 1, 0, 0, 1, 0, 1]",122,74,48,7,7,0.0945945945945946,0.14583333333333334
"[1, 0, 1, 1, 0, 1, 1, 0, 1, 1, 0, 0, 1, 0, 0]",110,47,63,6,4,0.1276595744680851,0.06349206349206349
"[0, 1, 0, 1, 0, 0, 1, 0, 1, 1, 0, 0, 1, 0, 1]",103,46,57,7,6,0.15217391304347827,0.10526315789473684
"[1, 0, 1, 1, 1, 0, 1, 0, 1, 0, 0, 0, 1, 0, 1]",105,44,61,4,1,0.09090909090909091,0.01639344262295082
"[1, 1, 1, 0, 0, 1, 1, 1, 1, 0, 1, 1, 1, 0, 1]",657,147,510,14,60,0.09523809523809523,0.11764705882352941
"[0, 0, 0, 1, 0, 1, 0, 1, 1, 0, 0, 0, 0, 1, 1]",275,168,107,18,11,0.10714285714285714,0.102803738317757
"[1, 1, 0, 1, 1, 0, 1, 0, 1, 0, 1, 1, 0, 1, 1]",205,58,147,2,13,0.034482758620689655,0.08843537414965986
"[1, 1, 0, 0, 0, 0, 0, 1, 1, 0, 1, 1, 0, 1, 0]",108,65,43,6,3,0.09230769230769231,0.06976744186046512
"[1, 0, 0, 1, 1, 1, 1, 1, 0, 1, 0, 1, 1, 1, 1]",839,180,659,13,56,0.07222222222222222,0.08497723823975721
"[0, 0, 0, 1, 0, 0, 0, 0, 0, 0, 1, 0, 0, 0, 1]",1609,1224,385,126,41,0.10294117647058823,0.10649350649350649
"[1, 1, 0, 1, 1, 0, 1, 0, 0, 1, 0, 1, 1, 0, 0]",131,64,67,4,11,0.0625,0.16417910447761194
"[1, 1, 1, 0, 1, 1, 0, 1, 0, 0, 1, 0, 1, 1, 0]",143,53,90,7,7,0.1320754716981132,0.07777777777777778
"[0, 1, 1, 0, 1, 0, 1, 1, 0, 1, 0, 1, 0, 1, 1]",121,54,67,5,3,0.09259259259259259,0.04477611940298507
"[0, 0, 1, 0, 0, 0, 0, 0, 0, 1, 1, 1, 0, 0, 0]",697,495,202,32,21,0.06464646464646465,0.10396039603960396
"[0, 0, 0, 1, 0, 1, 0, 1, 0, 0, 1, 0, 0, 0, 0]",561,376,185,42,25,0.11170212765957446,0.13513513513513514
"[1, 0, 0, 0, 0, 0, 0, 1, 0, 0, 1, 1, 0, 1, 0]",235,143,92,9,15,0.06293706293706294,0.16304347826086957
"[0, 1, 0, 0, 0, 1, 0, 0, 1, 0, 0, 1, 1, 1, 1]",163,105,58,8,6,0.0761904761904762,0.10344827586206896
"[0, 0, 1, 0, 0, 0, 1, 0, 0, 1, 0, 0, 1, 1, 1]",242,147,95,18,7,0.12244897959183673,0.07368421052631578
"[1, 0, 1, 0, 0, 0, 0, 1, 0, 0, 1, 0, 0, 0, 1]",229,147,82,15,10,0.10204081632653061,0.12195121951219512
"[0, 1, 1, 0, 0, 0, 1, 0, 1, 1, 0, 0, 0, 0, 0]",355,247,108,18,10,0.0728744939271255,0.09259259259259259
"[0, 1, 0, 0, 0, 1, 1, 0, 1, 0, 1, 1, 1, 0, 0]",113,60,53,4,4,0.06666666666666667,0.07547169811320754
"[1, 1, 1, 1, 1, 0, 1, 1, 1, 1, 0, 1, 0, 1, 1]",1624,374,1250,33,127,0.08823529411764706,0.1016
"[0, 1, 1, 0, 1, 0, 0, 1, 1, 0, 0, 0, 0, 0, 1]",187,118,69,5,7,0.0423728813559322,0.10144927536231885
"[0, 1, 0, 0, 0, 1, 1, 0, 1, 0, 0, 1, 1, 0, 0]",184,109,75,14,8,0.12844036697247707,0.10666666666666667
"[1, 1, 1, 0, 1, 0, 1, 1, 0, 1, 1, 1, 0, 0, 0]",181,73,108,11,9,0.1506849315068493,0.08333333333333333
"[1, 1, 1, 1, 0, 1, 0, 1, 1, 1, 0, 0, 1, 1, 0]",353,131,222,15,24,0.11450381679389313,0.10810810810810811
"[1, 1, 1, 0, 0, 0, 0, 0, 1, 0, 1, 1, 1, 0, 0]",141,62,79,4,8,0.06451612903225806,0.10126582278481013
"[0, 0, 0, 1, 0, 0, 0, 1, 1, 0, 0, 0, 0, 0, 1]",634,456,178,50,8,0.10964912280701754,0.0449438202247191
"[0, 1, 1, 0, 0, 0, 1, 0, 1, 1, 1, 1, 1, 0, 0]",169,91,78,6,10,0.06593406593406594,0.1282051282051282
"[0, 1, 0, 1, 0, 1, 1, 1, 1, 1, 0, 1, 1, 1, 0]",244,79,165,9,16,0.11392405063291139,0.09696969696969697
"[1, 0, 1, 1, 1, 0, 0, 1, 1, 1, 1, 0, 0, 1, 1]",778,281,497,24,52,0.08540925266903915,0.10462776659959759
"[0, 0, 0, 1, 0, 1, 0, 0, 1, 1, 0, 1, 0, 1, 1]",132,64,68,3,7,0.046875,0.10294117647058823
"[0, 0, 1, 1, 0, 0, 0, 0, 1, 0, 1, 0, 0, 1, 1]",297,177,120,22,5,0.12429378531073447,0.041666666666666664
"[1, 1, 1, 1, 0, 0, 0, 0, 0, 1, 1, 0, 0, 0, 0]",461,267,194,32,18,0.1198501872659176,0.09278350515463918
"[0, 1, 0, 0, 1, 0, 0, 0, 1, 0, 0, 0, 0, 1, 0]",459,302,157,20,21,0.06622516556291391,0.1337579617834395
"[0, 0, 1, 0, 0, 1, 0, 1, 1, 1, 0, 0, 1, 1, 0]",135,68,67,11,8,0.16176470588235295,0.11940298507462686
"[0, 0, 0, 0, 0, 0, 1, 1, 0, 0, 0, 1, 1, 1, 1]",752,512,240,56,24,0.109375,0.1
"[1, 0, 1, 1, 0, 1, 1, 1, 0, 0, 0, 0, 1, 1, 0]",215,91,124,6,8,0.06593406593406594,0.06451612903225806
"[0, 0, 1, 1, 1, 1, 0, 1, 1, 1, 0, 1, 1, 0, 1]",244,87,157,15,19,0.1724137931034483,0.12101910828025478
"[0, 0, 0, 0, 1, 0, 0, 1, 1, 0, 0, 0, 0, 0, 1]",664,491,173,47,19,0.09572301425661914,0.10982658959537572
"[1, 0, 0, 0, 0, 1, 0, 1, 0, 1, 0, 1, 0, 0, 1]",149,79,70,11,12,0.13924050632911392,0.17142857142857143
"[0, 0, 1, 1, 0, 0, 0, 0, 1, 0, 1, 0, 1, 0, 1]",209,116,93,16,9,0.13793103448275862,0.0967741935483871
"[0, 0, 0, 0, 0, 0, 0, 1, 1, 1, 0, 0, 1, 1, 0]",470,334,136,41,10,0.12275449101796407,0.07352941176470588
"[0, 1, 1, 0, 1, 0, 0, 0, 0, 0, 0, 0, 0, 1, 1]",533,354,179,27,13,0.07627118644067797,0.07262569832402235
"[1, 0, 1, 1, 0, 0, 0, 0, 1, 1, 1, 1, 0, 1, 1]",214,72,142,3,17,0.041666666666666664,0.11971830985915492
"[1, 1, 1, 1, 1, 0, 1, 1, 0, 0, 0, 0, 1, 1, 1]",593,159,434,11,47,0.06918238993710692,0.10829493087557604
"[0, 0, 1, 1, 0, 1, 1, 1, 1, 1, 1, 1, 0, 1, 1]",553,187,366,21,44,0.11229946524064172,0.12021857923497267
"[1, 0, 1, 1, 1, 1, 1, 0, 1, 1, 0, 0, 0, 1, 1]",269,82,187,9,22,0.10975609756097561,0.11764705882352941
"[1, 0, 1, 0, 1, 1, 1, 0, 1, 1, 0, 0, 1, 1, 0]",168,66,102,7,10,0.10606060606060606,0.09803921568627451
"[0, 1, 1, 1, 1, 1, 0, 1, 0, 1, 1, 1, 0, 1, 1]",519,183,336,17,30,0.09289617486338798,0.08928571428571429
"[1, 1, 0, 0, 1, 1, 1, 0, 0, 0, 0, 0, 1, 0, 0]",150,95,55,6,1,0.06315789473684211,0.01818181818181818
"[1, 0, 1, 1, 1, 0, 1, 1, 1, 0, 1, 0, 1, 0, 0]",137,52,85,6,4,0.11538461538461539,0.047058823529411764
"[1, 1, 1, 1, 0, 1, 1, 1, 0, 1, 1, 1, 1, 0, 1]",1515,364,1151,26,129,0.07142857142857142,0.11207645525629888
"[1, 0, 1, 0, 0, 1, 0, 0, 0, 0, 1, 1, 0, 0, 1]",217,117,100,10,11,0.08547008547008547,0.11
"[0, 1, 0, 0, 1, 1, 0, 0, 0, 0, 1, 0, 1, 0, 1]",155,84,71,10,5,0.11904761904761904,0.07042253521126761
"[0, 0, 1, 0, 0, 1, 1, 0, 0, 0, 0, 1, 0, 1, 0]",220,149,71,12,7,0.08053691275167785,0.09859154929577464
"[1, 0, 1, 0, 1, 1, 1, 1, 0, 1, 1, 0, 0, 0, 0]",157,73,84,6,6,0.0821917808219178,0.07142857142857142
"[0, 1, 0, 1, 1, 1, 1, 0, 0, 0, 1, 1, 1, 1, 1]",371,137,234,15,16,0.10948905109489052,0.06837606837606838
"[1, 1, 1, 0, 0, 1, 1, 1, 1, 1, 0, 1, 0, 1, 0]",266,78,188,4,17,0.05128205128205128,0.09042553191489362
"[1, 0, 1, 0, 0, 0, 0, 1, 1, 1, 1, 0, 0, 0, 0]",497,307,190,28,14,0.09120521172638436,0.07368421052631578
"[0, 1, 1, 1, 0, 0, 0, 0, 0, 0, 0, 0, 1, 1, 0]",697,442,255,31,20,0.07013574660633484,0.0784313725490196
"[0, 0, 1, 0, 0, 0, 0, 1, 1, 0, 1, 0, 0, 1, 1]",191,101,90,5,3,0.04950495049504951,0.03333333333333333
"[0, 1, 1, 0, 0, 0, 1, 1, 0, 0, 0, 0, 1, 1, 0]",357,223,134,20,9,0.08968609865470852,0.06716417910447761
"[1, 1, 1, 1, 0, 1, 0, 1, 1, 0, 0, 1, 1, 1, 1]",868,261,607,31,58,0.11877394636015326,0.09555189456342669
"[1, 1, 1, 1, 1, 1, 0, 1, 0, 1, 1, 0, 0, 1, 1]",807,203,604,17,54,0.08374384236453201,0.08940397350993377
"[0, 1, 0, 1, 0, 1, 1, 1, 1, 1, 1, 1, 1, 1, 0]",633,215,418,25,50,0.11627906976744186,0.11961722488038277
"[0, 0, 0, 1, 1, 0, 0, 0, 1, 1, 1, 0, 0, 0, 0]",385,271,114,26,10,0.0959409594095941,0.08771929824561403
"[1, 0, 0, 1, 1, 1, 1, 1, 0, 0, 0, 0, 0, 0, 0]",438,218,220,24,16,0.11009174311926606,0.07272727272727272
"[1, 0, 1, 1, 1, 0, 0, 0, 0, 0, 0, 0, 0, 1, 0]",299,191,108,19,4,0.09947643979057591,0.037037037037037035
"[1, 0, 1, 1, 1, 0, 1, 1, 1, 0, 0, 0, 0, 0, 0]",201,109,92,14,10,0.12844036697247707,0.10869565217391304
"[1, 0, 1, 1, 1, 1, 0, 1, 0, 0, 0, 1, 0, 1, 1]",142,56,86,2,8,0.03571428571428571,0.09302325581395349
"[1, 0, 1, 1, 0, 0, 0, 1, 1, 1, 0, 0, 0, 1, 1]",122,48,74,4,9,0.08333333333333333,0.12162162162162163
"[1, 0, 1, 1, 1, 1, 0, 1, 1, 1, 0, 1, 0, 1, 0]",202,66,136,5,11,0.07575757575757576,0.08088235294117647
"[0, 1, 1, 1, 1, 0, 0, 1, 0, 1, 1, 1, 1, 0, 1]",252,113,139,18,13,0.1592920353982301,0.09352517985611511
"[1, 1, 1, 1, 0, 0, 0, 1, 1, 1, 0, 0, 0, 0, 1]",224,103,121,9,18,0.08737864077669903,0.1487603305785124
"[1, 1, 0, 1, 1, 1, 1, 0, 0, 0, 1, 1, 1, 0, 0]",172,73,99,4,13,0.0547945205479452,0.13131313131313133
"[0, 0, 0, 1, 1, 1, 1, 1, 1, 0, 1, 0, 0, 1, 0]",170,109,61,11,5,0.10091743119266056,0.08196721311475409
"[1, 1, 0, 0, 0, 1, 0, 0, 1, 1, 0, 1, 0, 1, 1]",131,59,72,9,11,0.15254237288135594,0.1527777777777778
"[1, 0, 1, 0, 1, 1, 1, 0, 0, 0, 1, 0, 0, 1, 1]",121,58,63,7,4,0.1206896551724138,0.06349206349206349
"[1, 0, 0, 1, 1, 0, 0, 1, 1, 1, 0, 1, 0, 1, 0]",126,52,74,4,11,0.07692307692307693,0.14864864864864866
"[1, 1, 1, 0, 1, 1, 0, 1, 0, 0, 1, 1, 0, 0, 1]",186,69,117,2,13,0.028985507246376812,0.1111111111111111
"[0, 0, 1, 1, 1, 1, 0, 1, 0, 0, 0, 1, 1, 0, 0]",169,102,67,10,6,0.09803921568627451,0.08955223880597014
"[0, 0, 0, 0, 0, 1, 0, 0, 1, 0, 0, 0, 1, 1, 1]",619,483,136,46,14,0.09523809523809523,0.10294117647058823
"[0, 0, 0, 0, 0, 0, 1, 0, 0, 1, 0, 0, 0, 1, 1]",932,687,245,78,31,0.11353711790393013,0.12653061224489795
"[1, 0, 0, 0, 1, 1, 0, 0, 0, 0, 0, 0, 0, 0, 0]",3364,2430,934,199,94,0.08189300411522633,0.1006423982869379
"[1, 1, 1, 1, 0, 1, 0, 1, 1, 0, 1, 1, 0, 1, 0]",226,79,147,7,18,0.08860759493670886,0.12244897959183673
"[0, 1, 0, 0, 1, 1, 0, 1, 1, 0, 0, 0, 0, 1, 1]",221,125,96,9,6,0.072,0.0625
"[0, 1, 1, 0, 1, 1, 0, 1, 0, 0, 1, 1, 0, 1, 1]",149,73,76,8,9,0.1095890410958904,0.11842105263157894
"[0, 0, 1, 0, 1, 0, 0, 1, 0, 1, 1, 1, 1, 1, 1]",236,101,135,18,12,0.1782178217821782,0.08888888888888889
"[0, 0, 0, 1, 1, 0, 1, 1, 1, 0, 1, 1, 1, 0, 0]",121,69,52,4,7,0.057971014492753624,0.1346153846153846
"[0, 0, 1, 0, 0, 0, 1, 0, 1, 1, 1, 1, 1, 0, 1]",102,57,45,6,3,0.10526315789473684,0.06666666666666667
"[1, 0, 1, 0, 1, 0, 0, 1, 0, 1, 0, 1, 1, 1, 1]",141,71,70,5,7,0.07042253521126761,0.1
"[1, 1, 1, 1, 1, 1, 1, 0, 0, 1, 0, 1, 1, 0, 1]",667,191,476,21,44,0.1099476439790576,0.09243697478991597
"[1, 1, 1, 0, 1, 1, 0, 1, 1, 1, 0, 1, 0, 1, 0]",240,76,164,8,16,0.10526315789473684,0.0975609756097561
"[1, 0, 0, 0, 0, 0, 0, 0, 0, 0, 1, 0, 0, 0, 1]",1947,1325,622,124,59,0.09358490566037736,0.09485530546623794
"[0, 0, 1, 0, 0, 0, 0, 0, 0, 0, 1, 0, 1, 0, 0]",1569,1195,374,108,28,0.09037656903765691,0.0748663101604278
"[0, 0, 0, 1, 0, 0, 0, 1, 0, 0, 0, 1, 0, 0, 1]",529,382,147,37,13,0.0968586387434555,0.08843537414965986
"[1, 1, 1, 0, 0, 0, 0, 0, 0, 1, 0, 0, 0, 1, 0]",297,160,137,14,14,0.0875,0.10218978102189781
"[0, 0, 0, 0, 1, 0, 1, 1, 1, 0, 0, 0, 0, 0, 0]",836,604,232,59,15,0.09768211920529801,0.06465517241379311
"[1, 0, 1, 0, 0, 1, 0, 0, 0, 1, 0, 0, 1, 1, 1]",136,64,72,7,6,0.109375,0.08333333333333333
"[0, 0, 0, 0, 1, 1, 0, 1, 0, 0, 1, 0, 0, 0, 1]",287,188,99,20,9,0.10638297872340426,0.09090909090909091
"[0, 1, 0, 1, 1, 0, 0, 1, 1, 1, 1, 1, 0, 0, 1]",213,90,123,9,10,0.1,0.08130081300813008
"[1, 1, 1, 1, 0, 1, 1, 0, 0, 1, 0, 1, 1, 0, 0]",184,65,119,10,7,0.15384615384615385,0.058823529411764705
"[0, 1, 0, 1, 1, 1, 1, 1, 1, 0, 1, 1, 0, 0, 1]",291,110,181,10,15,0.09090909090909091,0.08287292817679558
"[0, 0, 1, 0, 1, 1, 1, 1, 1, 1, 0, 1, 1, 0, 0]",174,70,104,4,11,0.05714285714285714,0.10576923076923077
"[1, 0, 0, 1, 0, 1, 1, 1, 1, 1, 1, 0, 1, 1, 0]",251,103,148,15,8,0.14563106796116504,0.05405405405405406
"[0, 1, 0, 0, 1, 0, 1, 1, 1, 1, 1, 1, 0, 1, 1]",267,89,178,11,24,0.12359550561797752,0.1348314606741573
"[0, 0, 1, 1, 0, 0, 0, 1, 0, 1, 1, 0, 1, 1, 0]",134,70,64,7,3,0.1,0.046875
"[0, 1, 0, 0, 1, 0, 0, 0, 1, 0, 1, 0, 0, 0, 0]",568,387,181,44,16,0.11369509043927649,0.08839779005524862
"[0, 1, 0, 1, 0, 1, 1, 0, 1, 0, 0, 1, 0, 0, 0]",145,83,62,6,6,0.07228915662650602,0.0967741935483871
"[1, 0, 1, 0, 1, 0, 1, 0, 1, 1, 0, 1, 0, 0, 1]",107,53,54,7,4,0.1320754716981132,0.07407407407407407
"[1, 0, 0, 1, 0, 0, 1, 0, 1, 1, 0, 1, 0, 1, 0]",103,57,46,4,5,0.07017543859649122,0.10869565217391304
"[1, 0, 1, 0, 1, 0, 0, 0, 0, 1, 0, 0, 1, 1, 1]",164,87,77,10,12,0.11494252873563218,0.15584415584415584
"[0, 1, 1, 1, 0, 0, 0, 1, 0, 0, 0, 0, 0, 0, 1]",283,187,96,18,8,0.0962566844919786,0.08333333333333333
"[0, 1, 1, 0, 0, 0, 0, 0, 0, 0, 1, 1, 1, 1, 0]",439,301,138,22,13,0.07308970099667775,0.09420289855072464
"[1, 0, 1, 0, 1, 0, 0, 0, 0, 0, 0, 0, 0, 0, 1]",693,455,238,39,17,0.08571428571428572,0.07142857142857142
"[0, 1, 0, 0, 1, 0, 1, 0, 1, 0, 0, 0, 0, 0, 1]",254,171,83,14,11,0.08187134502923976,0.13253012048192772
"[1, 0, 1, 0, 0, 0, 0, 1, 1, 0, 0, 1, 0, 0, 1]",175,104,71,8,6,0.07692307692307693,0.08450704225352113
"[0, 1, 1, 1, 1, 1, 0, 0, 1, 0, 1, 0, 0, 1, 1]",183,96,87,14,7,0.14583333333333334,0.08045977011494253
"[1, 0, 1, 1, 1, 0, 0, 0, 1, 1, 0, 1, 0, 1, 0]",103,52,51,9,5,0.17307692307692307,0.09803921568627451
"[0, 0, 1, 1, 1, 0, 0, 0, 1, 0, 0, 0, 1, 1, 1]",179,101,78,10,5,0.09900990099009901,0.0641025641025641
"[1, 1, 0, 0, 0, 0, 0, 1, 1, 1, 1, 1, 1, 0, 1]",238,100,138,14,14,0.14,0.10144927536231885
"[1, 0, 1, 0, 1, 0, 1, 1, 1, 0, 0, 1, 0, 1, 0]",102,41,61,2,7,0.04878048780487805,0.11475409836065574
"[0, 1, 0, 1, 0, 1, 0, 1, 1, 1, 0, 0, 1, 1, 1]",200,84,116,8,12,0.09523809523809523,0.10344827586206896
"[0, 0, 0, 1, 1, 1, 1, 1, 0, 0, 1, 1, 1, 0, 1]",205,88,117,8,11,0.09090909090909091,0.09401709401709402
"[1, 0, 0, 0, 0, 1, 0, 0, 1, 1, 0, 1, 0, 1, 1]",129,60,69,7,9,0.11666666666666667,0.13043478260869565
"[1, 1, 1, 0, 1, 1, 1, 1, 1, 1, 0, 1, 1, 0, 1]",1518,357,1161,40,98,0.11204481792717087,0.08440999138673558
"[1, 0, 1, 1, 1, 1, 1, 1, 0, 1, 0, 0, 1, 1, 1]",644,186,458,23,46,0.12365591397849462,0.10043668122270742
"[0, 1, 0, 1, 1, 1, 0, 0, 1, 1, 1, 1, 1, 1, 0]",418,163,255,18,23,0.11042944785276074,0.09019607843137255
"[0, 1, 1, 0, 1, 0, 1, 0, 0, 1, 1, 1, 1, 0, 1]",166,88,78,12,10,0.13636363636363635,0.1282051282051282
"[1, 0, 1, 1, 0, 1, 0, 1, 0, 0, 1, 1, 1, 1, 0]",178,75,103,11,12,0.14666666666666667,0.11650485436893204
"[0, 0, 0, 1, 0, 1, 1, 0, 1, 0, 1, 0, 0, 1, 1]",123,66,57,4,7,0.06060606060606061,0.12280701754385964
"[1, 1, 1, 0, 0, 1, 0, 1, 0, 1, 0, 1, 0, 1, 0]",116,55,61,3,4,0.05454545454545454,0.06557377049180328
"[0, 0, 0, 1, 0, 0, 0, 0, 0, 1, 1, 0, 1, 0, 0]",542,397,145,31,17,0.07808564231738035,0.11724137931034483
"[0, 0, 1, 0, 0, 0, 0, 1, 0, 1, 0, 1, 0, 1, 0]",214,140,74,7,10,0.05,0.13513513513513514
"[0, 1, 0, 1, 1, 0, 1, 0, 0, 1, 0, 1, 1, 0, 1]",102,49,53,4,6,0.08163265306122448,0.11320754716981132
"[0, 0, 0, 1, 0, 1, 1, 0, 1, 0, 0, 1, 0, 1, 1]",129,65,64,6,4,0.09230769230769231,0.0625
"[0, 0, 0, 0, 1, 0, 0, 0, 1, 0, 1, 1, 0, 1, 0]",225,135,90,12,7,0.08888888888888889,0.07777777777777778
"[0, 1, 1, 1, 1, 1, 1, 0, 1, 1, 0, 1, 1, 1, 1]",1882,598,1284,68,116,0.11371237458193979,0.09034267912772585
"[1, 0, 1, 0, 0, 1, 1, 1, 1, 1, 1, 1, 0, 1, 1]",595,185,410,25,43,0.13513513513513514,0.1048780487804878
"[0, 0, 0, 1, 1, 0, 0, 0, 1, 0, 1, 0, 0, 0, 1]",292,206,86,12,10,0.05825242718446602,0.11627906976744186
"[1, 1, 0, 0, 0, 1, 1, 0, 1, 0, 1, 0, 0, 1, 0]",99,47,52,6,2,0.1276595744680851,0.038461538461538464
"[1, 1, 0, 1, 1, 0, 1, 0, 1, 0, 1, 0, 0, 1, 1]",171,74,97,5,6,0.06756756756756757,0.061855670103092786
"[1, 1, 1, 0, 1, 1, 0, 1, 0, 1, 0, 1, 0, 0, 1]",170,73,97,3,9,0.0410958904109589,0.09278350515463918
"[0, 1, 1, 1, 1, 1, 1, 0, 0, 1, 1, 1, 0, 0, 1]",469,252,217,23,19,0.09126984126984126,0.08755760368663594
"[0, 1, 0, 0, 0, 1, 0, 0, 1, 0, 0, 0, 0, 1, 1]",346,237,109,23,12,0.0970464135021097,0.11009174311926606
"[1, 1, 1, 0, 0, 1, 1, 0, 0, 1, 1, 0, 1, 1, 1]",726,128,598,11,53,0.0859375,0.08862876254180602
"[0, 0, 1, 1, 1, 0, 0, 0, 0, 0, 1, 1, 1, 0, 0]",189,124,65,10,8,0.08064516129032258,0.12307692307692308
"[1, 0, 1, 1, 1, 0, 0, 0, 0, 1, 0, 1, 1, 0, 1]",120,58,62,6,4,0.10344827586206896,0.06451612903225806
"[1, 1, 1, 0, 1, 0, 1, 0, 0, 0, 0, 1, 0, 0, 0]",153,96,57,6,6,0.0625,0.10526315789473684
"[0, 1, 0, 1, 1, 0, 0, 0, 1, 1, 1, 0, 1, 1, 1]",171,70,101,7,7,0.1,0.06930693069306931
"[0, 0, 0, 0, 0, 0, 1, 0, 0, 1, 0, 0, 1, 1, 0]",677,472,205,47,20,0.09957627118644068,0.0975609756097561
"[0, 0, 0, 1, 0, 0, 0, 0, 1, 0, 1, 0, 0, 0, 0]",1674,1276,398,112,37,0.0877742946708464,0.09296482412060302
"[0, 1, 0, 1, 0, 0, 0, 1, 1, 0, 0, 1, 1, 1, 1]",293,168,125,15,13,0.08928571428571429,0.104
"[1, 0, 1, 0, 1, 1, 1, 0, 1, 0, 0, 1, 1, 0, 1]",135,60,75,3,4,0.05,0.05333333333333334
"[0, 0, 1, 0, 1, 0, 0, 1, 1, 0, 1, 0, 1, 1, 0]",109,56,53,5,5,0.08928571428571429,0.09433962264150944
"[1, 0, 0, 1, 1, 1, 0, 0, 1, 0, 1, 1, 1, 0, 0]",117,54,63,10,9,0.18518518518518517,0.14285714285714285
"[1, 1, 0, 0, 1, 1, 0, 0, 1, 1, 1, 0, 0, 1, 0]",198,90,108,10,7,0.1111111111111111,0.06481481481481481
"[0, 1, 0, 1, 1, 1, 1, 1, 0, 1, 0, 0, 0, 1, 0]",112,48,64,1,9,0.020833333333333332,0.140625
"[0, 0, 1, 1, 1, 0, 0, 1, 0, 1, 1, 1, 1, 1, 0]",169,70,99,3,19,0.04285714285714286,0.1919191919191919
"[0, 0, 0, 1, 0, 1, 0, 0, 1, 1, 0, 1, 0, 0, 1]",135,88,47,8,4,0.09090909090909091,0.0851063829787234
"[1, 0, 1, 0, 0, 1, 0, 1, 0, 0, 0, 0, 0, 1, 1]",215,116,99,16,8,0.13793103448275862,0.08080808080808081
"[0, 0, 1, 0, 0, 0, 1, 0, 1, 0, 1, 0, 0, 1, 0]",217,140,77,12,8,0.08571428571428572,0.1038961038961039
"[1, 1, 1, 1, 1, 1, 1, 1, 0, 1, 0, 1, 1, 0, 0]",793,223,570,14,49,0.06278026905829596,0.08596491228070176
"[1, 0, 1, 0, 0, 0, 0, 1, 1, 0, 0, 0, 0, 0, 1]",299,194,105,13,9,0.06701030927835051,0.08571428571428572
"[0, 0, 0, 0, 1, 0, 0, 0, 0, 0, 1, 0, 1, 1, 1]",550,388,162,35,17,0.09020618556701031,0.10493827160493827
"[0, 1, 0, 0, 1, 1, 1, 1, 1, 1, 1, 1, 0, 0, 0]",516,214,302,20,25,0.09345794392523364,0.08278145695364239
"[1, 1, 1, 0, 1, 0, 1, 1, 0, 0, 0, 0, 0, 0, 1]",260,121,139,14,20,0.11570247933884298,0.14388489208633093
"[1, 0, 0, 0, 1, 1, 1, 1, 0, 1, 1, 1, 0, 1, 0]",124,48,76,7,10,0.14583333333333334,0.13157894736842105
"[1, 1, 0, 0, 0, 1, 1, 1, 1, 0, 1, 1, 1, 0, 1]",237,82,155,9,15,0.10975609756097561,0.0967741935483871
"[1, 0, 0, 0, 1, 1, 0, 0, 0, 1, 1, 1, 1, 0, 1]",109,40,69,6,6,0.15,0.08695652173913043
"[1, 0, 0, 1, 1, 1, 0, 0, 1, 1, 1, 1, 1, 1, 1]",1256,329,927,32,102,0.0972644376899696,0.11003236245954692
"[0, 0, 1, 1, 1, 0, 1, 1, 0, 0, 1, 0, 0, 1, 1]",155,63,92,5,12,0.07936507936507936,0.13043478260869565
"[1, 1, 0, 0, 0, 0, 0, 1, 1, 0, 0, 1, 1, 1, 0]",183,81,102,6,10,0.07407407407407407,0.09803921568627451
"[1, 1, 1, 0, 0, 0, 0, 0, 1, 1, 0, 0, 1, 1, 1]",433,177,256,20,22,0.11299435028248588,0.0859375
"[1, 1, 1, 0, 0, 1, 0, 0, 0, 1, 0, 1, 0, 1, 0]",108,60,48,6,8,0.1,0.16666666666666666
"[1, 0, 1, 0, 0, 1, 1, 1, 0, 0, 1, 0, 0, 0, 1]",121,62,59,5,8,0.08064516129032258,0.13559322033898305
"[1, 0, 1, 0, 1, 1, 0, 1, 0, 0, 1, 1, 0, 0, 0]",132,68,64,4,5,0.058823529411764705,0.078125
"[0, 1, 0, 0, 0, 0, 0, 1, 1, 1, 0, 0, 0, 0, 1]",337,204,133,17,11,0.08333333333333333,0.08270676691729323
"[0, 0, 1, 0, 1, 1, 0, 1, 0, 0, 0, 0, 0, 1, 0]",216,131,85,13,9,0.09923664122137404,0.10588235294117647
"[0, 0, 0, 1, 0, 1, 1, 0, 1, 0, 0, 0, 0, 0, 1]",262,175,87,18,7,0.10285714285714286,0.08045977011494253
"[1, 0, 0, 0, 1, 1, 1, 1, 1, 1, 0, 1, 1, 1, 1]",792,234,558,17,53,0.07264957264957266,0.09498207885304659
"[0, 1, 1, 1, 0, 1, 1, 1, 1, 1, 0, 1, 1, 0, 0]",282,110,172,10,13,0.09090909090909091,0.0755813953488372
"[1, 0, 1, 1, 1, 1, 1, 1, 1, 0, 1, 0, 1, 1, 0]",518,159,359,17,30,0.1069182389937107,0.08356545961002786
"[0, 1, 1, 1, 0, 0, 0, 0, 0, 1, 1, 0, 0, 0, 0]",458,305,153,27,10,0.08852459016393442,0.06535947712418301
"[0, 0, 1, 0, 1, 1, 0, 0, 1, 0, 0, 0, 1, 0, 1]",120,75,45,7,1,0.09333333333333334,0.022222222222222223
"[1, 0, 0, 0, 0, 0, 0, 0, 0, 0, 1, 0, 1, 0, 0]",1794,1220,574,97,54,0.07950819672131147,0.09407665505226481
"[0, 0, 1, 1, 1, 0, 0, 0, 1, 0, 1, 0, 0, 1, 1]",148,95,53,4,7,0.042105263157894736,0.1320754716981132
"[0, 1, 0, 0, 0, 1, 1, 1, 0, 0, 0, 1, 0, 1, 0]",145,88,57,10,6,0.11363636363636363,0.10526315789473684
"[1, 1, 0, 1, 1, 1, 0, 0, 0, 1, 1, 1, 0, 1, 0]",154,58,96,7,5,0.1206896551724138,0.052083333333333336
"[0, 1, 0, 1, 0, 0, 1, 1, 0, 0, 0, 1, 1, 1, 0]",116,61,55,7,9,0.11475409836065574,0.16363636363636364
"[0, 1, 0, 1, 0, 1, 0, 0, 0, 1, 0, 0, 1, 0, 1]",133,75,58,10,7,0.13333333333333333,0.1206896551724138
"[1, 0, 1, 0, 1, 0, 1, 0, 1, 1, 0, 1, 1, 0, 1]",130,46,84,6,8,0.13043478260869565,0.09523809523809523
"[1, 1, 1, 1, 1, 0, 1, 0, 1, 0, 1, 0, 1, 1, 0]",235,85,150,11,13,0.12941176470588237,0.08666666666666667
"[0, 1, 0, 1, 0, 1, 1, 0, 0, 0, 1, 1, 0, 1, 0]",105,56,49,6,7,0.10714285714285714,0.14285714285714285
"[1, 1, 0, 1, 1, 0, 1, 0, 1, 0, 1, 0, 1, 1, 0]",147,69,78,5,8,0.07246376811594203,0.10256410256410256
"[0, 1, 1, 0, 1, 1, 0, 1, 0, 1, 0, 1, 0, 1, 1]",161,66,95,5,6,0.07575757575757576,0.06315789473684211
"[1, 1, 1, 0, 1, 0, 1, 0, 0, 0, 0, 1, 1, 1, 0]",153,80,73,4,7,0.05,0.0958904109589041
"[1, 1, 0, 1, 1, 0, 0, 1, 1, 0, 0, 0, 0, 1, 0]",132,74,58,9,8,0.12162162162162163,0.13793103448275862
"[0, 1, 1, 1, 1, 0, 0, 1, 1, 0, 0, 0, 1, 1, 0]",254,166,88,8,9,0.04819277108433735,0.10227272727272728
"[0, 1, 1, 0, 0, 1, 1, 1, 1, 0, 1, 1, 1, 1, 1]",922,454,468,43,46,0.0947136563876652,0.09829059829059829
"[0, 0, 1, 1, 0, 0, 1, 1, 1, 1, 0, 1, 1, 1, 1]",754,258,496,15,39,0.05813953488372093,0.07862903225806452
"[1, 0, 0, 1, 1, 1, 1, 1, 1, 1, 0, 0, 1, 1, 0]",572,185,387,16,39,0.08648648648648649,0.10077519379844961
"[1, 0, 1, 1, 0, 0, 1, 1, 1, 1, 1, 1, 1, 0, 0]",460,160,300,15,26,0.09375,0.08666666666666667
"[0, 0, 0, 1, 1, 0, 1, 0, 1, 1, 1, 1, 0, 1, 1]",159,80,79,9,9,0.1125,0.11392405063291139
"[1, 1, 1, 0, 1, 1, 1, 1, 1, 1, 0, 0, 1, 1, 0]",979,292,687,30,59,0.10273972602739725,0.0858806404657933
"[1, 0, 0, 0, 0, 1, 1, 0, 0, 0, 1, 0, 0, 1, 1]",282,107,175,6,23,0.056074766355140186,0.13142857142857142
"[0, 1, 0, 1, 0, 1, 1, 1, 0, 1, 0, 1, 0, 0, 0]",116,58,58,6,7,0.10344827586206896,0.1206896551724138
"[0, 0, 0, 1, 1, 0, 0, 1, 0, 1, 1, 0, 1, 0, 1]",122,65,57,4,6,0.06153846153846154,0.10526315789473684
"[0, 1, 0, 0, 1, 0, 0, 0, 1, 1, 1, 0, 0, 0, 0]",310,222,88,23,4,0.1036036036036036,0.045454545454545456
"[0, 0, 1, 0, 0, 1, 0, 0, 0, 1, 1, 1, 0, 0, 0]",309,203,106,26,5,0.12807881773399016,0.04716981132075472
"[0, 1, 0, 0, 1, 0, 0, 1, 0, 0, 0, 1, 1, 1, 0]",151,87,64,11,2,0.12643678160919541,0.03125
"[0, 0, 0, 1, 0, 1, 0, 0, 1, 0, 0, 1, 0, 0, 0]",541,393,148,33,7,0.08396946564885496,0.0472972972972973
"[0, 0, 0, 1, 1, 0, 0, 0, 0, 1, 0, 1, 0, 1, 0]",297,208,89,15,8,0.07211538461538461,0.0898876404494382
"[1, 1, 1, 0, 1, 0, 0, 1, 0, 0, 0, 0, 0, 0, 0]",362,211,151,23,12,0.10900473933649289,0.07947019867549669
"[0, 1, 1, 1, 1, 0, 1, 0, 0, 1, 0, 0, 0, 0, 0]",220,139,81,9,10,0.06474820143884892,0.12345679012345678
"[0, 1, 0, 0, 1, 0, 1, 1, 1, 1, 0, 1, 0, 0, 1]",100,47,53,4,11,0.0851063829787234,0.20754716981132076
"[0, 1, 1, 1, 0, 1, 0, 0, 1, 0, 1, 1, 1, 1, 0]",152,66,86,7,12,0.10606060606060606,0.13953488372093023
"[0, 1, 1, 0, 0, 1, 1, 0, 1, 0, 1, 1, 1, 1, 1]",383,177,206,16,12,0.0903954802259887,0.05825242718446602
"[0, 0, 0, 1, 0, 0, 0, 1, 1, 0, 0, 0, 0, 1, 0]",554,382,172,38,19,0.09947643979057591,0.11046511627906977
"[1, 1, 1, 0, 1, 0, 0, 1, 1, 1, 0, 1, 1, 1, 0]",231,73,158,6,13,0.0821917808219178,0.08227848101265822
"[1, 1, 1, 0, 1, 1, 1, 1, 1, 0, 1, 0, 0, 1, 1]",648,159,489,14,45,0.0880503144654088,0.09202453987730061
"[1, 0, 0, 0, 1, 1, 1, 0, 0, 1, 0, 0, 1, 1, 1]",157,71,86,4,7,0.056338028169014086,0.08139534883720931
"[1, 1, 1, 1, 1, 1, 1, 1, 1, 0, 0, 0, 1, 0, 1]",926,221,705,20,77,0.09049773755656108,0.10921985815602837
"[0, 1, 0, 0, 1, 1, 0, 1, 1, 1, 1, 0, 1, 1, 0]",139,59,80,2,10,0.03389830508474576,0.125
"[1, 0, 0, 1, 1, 1, 0, 1, 0, 1, 0, 0, 1, 0, 0]",102,59,43,2,3,0.03389830508474576,0.06976744186046512
"[0, 0, 0, 1, 1, 0, 1, 1, 1, 1, 1, 1, 0, 0, 0]",242,124,118,10,16,0.08064516129032258,0.13559322033898305
"[1, 0, 1, 1, 0, 0, 0, 1, 1, 0, 0, 0, 0, 0, 1]",174,104,70,5,7,0.04807692307692308,0.1
"[0, 0, 1, 0, 1, 1, 0, 1, 1, 0, 0, 1, 0, 1, 0]",108,73,35,7,2,0.0958904109589041,0.05714285714285714
"[0, 0, 1, 1, 1, 0, 0, 1, 1, 0, 0, 1, 1, 0, 1]",141,61,80,5,9,0.08196721311475409,0.1125
"[1, 1, 1, 0, 0, 1, 0, 0, 1, 1, 1, 0, 0, 1, 1]",206,80,126,6,16,0.075,0.12698412698412698
"[1, 1, 1, 0, 0, 1, 0, 1, 0, 1, 1, 1, 1, 0, 0]",221,85,136,12,15,0.1411764705882353,0.11029411764705882
"[1, 0, 1, 0, 1, 1, 0, 1, 1, 1, 0, 0, 1, 0, 1]",139,62,77,5,9,0.08064516129032258,0.11688311688311688
"[1, 0, 0, 1, 0, 1, 0, 1, 0, 1, 0, 1, 1, 0, 1]",93,48,45,5,2,0.10416666666666667,0.044444444444444446
"[0, 1, 1, 1, 1, 1, 1, 1, 0, 0, 1, 0, 1, 0, 1]",290,117,173,17,14,0.1452991452991453,0.08092485549132948
"[1, 0, 1, 1, 1, 1, 0, 0, 1, 1, 0, 1, 1, 0, 1]",271,98,173,10,20,0.10204081632653061,0.11560693641618497
"[1, 1, 0, 1, 0, 1, 1, 0, 0, 1, 0, 0, 0, 1, 1]",134,57,77,6,5,0.10526315789473684,0.06493506493506493
"[0, 1, 1, 0, 0, 1, 0, 0, 1, 1, 1, 1, 1, 1, 0]",256,127,129,14,8,0.11023622047244094,0.06201550387596899
"[1, 0, 1, 1, 0, 0, 1, 0, 0, 1, 1, 0, 1, 1, 1]",156,79,77,11,5,0.13924050632911392,0.06493506493506493
"[1, 0, 1, 0, 1, 0, 1, 1, 0, 0, 1, 0, 0, 1, 1]",142,64,78,2,3,0.03125,0.038461538461538464
"[1, 0, 1, 0, 0, 1, 0, 0, 1, 1, 0, 0, 1, 0, 0]",149,78,71,4,8,0.05128205128205128,0.11267605633802817
"[0, 0, 0, 0, 0, 1, 0, 1, 0, 1, 0, 1, 0, 1, 0]",246,156,90,15,10,0.09615384615384616,0.1111111111111111
"[0, 0, 0, 1, 0, 0, 0, 1, 0, 1, 0, 0, 1, 0, 1]",227,155,72,10,6,0.06451612903225806,0.08333333333333333
"[1, 0, 0, 1, 0, 0, 1, 0, 0, 0, 1, 1, 0, 1, 1]",96,51,45,6,7,0.11764705882352941,0.15555555555555556
"[0, 0, 1, 1, 0, 0, 0, 0, 0, 1, 1, 0, 0, 0, 0]",1207,862,345,91,34,0.10556844547563805,0.09855072463768116
"[0, 1, 0, 0, 0, 0, 0, 0, 0, 0, 1, 0, 0, 0, 1]",1620,1277,343,133,35,0.10415035238841033,0.10204081632653061
"[1, 0, 1, 0, 0, 1, 0, 0, 0, 1, 1, 0, 0, 0, 0]",332,208,124,21,10,0.10096153846153846,0.08064516129032258
"[0, 0, 0, 1, 0, 1, 0, 0, 0, 1, 1, 1, 1, 0, 0]",256,170,86,12,10,0.07058823529411765,0.11627906976744186
"[1, 0, 0, 0, 1, 1, 0, 0, 0, 0, 1, 1, 1, 1, 0]",437,223,214,13,23,0.05829596412556054,0.10747663551401869
"[1, 1, 0, 1, 0, 0, 1, 0, 0, 1, 0, 1, 1, 1, 1]",181,78,103,7,13,0.08974358974358974,0.1262135922330097
"[1, 1, 0, 1, 1, 1, 0, 0, 1, 1, 0, 1, 1, 0, 1]",258,87,171,12,13,0.13793103448275862,0.07602339181286549
"[1, 1, 1, 0, 1, 1, 0, 1, 1, 1, 0, 0, 1, 1, 0]",333,132,201,13,17,0.09848484848484848,0.0845771144278607
"[0, 1, 0, 1, 1, 0, 1, 0, 1, 0, 0, 0, 0, 0, 1]",160,93,67,10,5,0.10752688172043011,0.07462686567164178
"[1, 0, 1, 0, 0, 0, 1, 0, 1, 1, 0, 1, 0, 1, 0]",103,57,46,7,7,0.12280701754385964,0.15217391304347827
"[0, 0, 1, 0, 0, 1, 1, 1, 1, 0, 0, 1, 1, 0, 0]",463,280,183,22,14,0.07857142857142857,0.07650273224043716
"[1, 0, 1, 0, 0, 1, 1, 1, 0, 0, 0, 1, 0, 1, 1]",118,53,65,5,5,0.09433962264150944,0.07692307692307693
"[1, 0, 0, 0, 0, 1, 0, 0, 0, 1, 1, 0, 1, 1, 0]",141,86,55,6,4,0.06976744186046512,0.07272727272727272
"[1, 1, 0, 0, 1, 1, 0, 1, 1, 1, 0, 1, 1, 0, 1]",246,71,175,9,26,0.1267605633802817,0.14857142857142858
"[1, 1, 1, 1, 1, 0, 0, 1, 1, 0, 1, 1, 1, 0, 1]",683,160,523,12,53,0.075,0.10133843212237094
"[1, 1, 1, 1, 1, 0, 0, 1, 1, 0, 1, 1, 0, 1, 1]",780,178,602,19,55,0.10674157303370786,0.09136212624584718
"[1, 0, 1, 1, 0, 0, 1, 1, 0, 0, 0, 0, 1, 1, 1]",480,210,270,17,24,0.08095238095238096,0.08888888888888889
"[1, 1, 1, 0, 0, 1, 1, 0, 1, 1, 0, 1, 1, 0, 0]",209,76,133,6,14,0.07894736842105263,0.10526315789473684
"[1, 1, 0, 0, 0, 0, 1, 1, 1, 0, 1, 0, 1, 0, 1]",149,70,79,8,6,0.11428571428571428,0.0759493670886076
"[0, 0, 0, 1, 1, 1, 1, 1, 1, 0, 1, 0, 0, 1, 1]",243,153,90,18,6,0.11764705882352941,0.06666666666666667
"[0, 1, 0, 0, 0, 1, 0, 1, 0, 1, 0, 0, 0, 1, 0]",239,157,82,11,8,0.07006369426751592,0.0975609756097561
"[0, 1, 0, 1, 0, 1, 0, 0, 0, 1, 0, 1, 0, 1, 0]",115,61,54,4,6,0.06557377049180328,0.1111111111111111
"[0, 0, 0, 1, 1, 0, 1, 0, 0, 1, 1, 0, 1, 1, 0]",113,64,49,4,3,0.0625,0.061224489795918366
"[0, 0, 0, 0, 1, 1, 0, 1, 0, 0, 1, 1, 0, 1, 1]",129,64,65,4,6,0.0625,0.09230769230769231
"[0, 0, 0, 1, 1, 1, 1, 1, 0, 0, 0, 0, 0, 0, 0]",737,507,230,51,24,0.10059171597633136,0.10434782608695652
"[0, 0, 1, 1, 0, 1, 1, 0, 1, 0, 1, 1, 1, 1, 0]",169,68,101,8,14,0.11764705882352941,0.13861386138613863
"[0, 0, 1, 1, 0, 1, 0, 0, 1, 1, 0, 1, 1, 0, 1]",100,55,45,5,7,0.09090909090909091,0.15555555555555556
"[1, 0, 1, 0, 0, 0, 0, 0, 1, 0, 0, 1, 0, 0, 0]",512,368,144,43,19,0.11684782608695653,0.13194444444444445
"[1, 1, 0, 1, 0, 1, 0, 0, 0, 0, 0, 1, 0, 0, 1]",159,95,64,10,4,0.10526315789473684,0.0625
"[1, 0, 0, 0, 1, 0, 1, 0, 1, 0, 1, 0, 0, 0, 0]",235,140,95,7,12,0.05,0.12631578947368421
"[0, 1, 1, 0, 0, 0, 0, 1, 0, 1, 0, 0, 0, 0, 0]",724,509,215,46,15,0.09037328094302555,0.06976744186046512
"[0, 1, 1, 1, 0, 0, 0, 1, 0, 0, 1, 0, 0, 0, 0]",285,183,102,16,10,0.08743169398907104,0.09803921568627451
"[0, 0, 0, 1, 0, 1, 0, 1, 1, 0, 0, 1, 1, 1, 1]",239,127,112,10,13,0.07874015748031496,0.11607142857142858
"[0, 1, 1, 1, 0, 0, 0, 0, 0, 1, 0, 0, 0, 0, 1]",306,209,97,18,12,0.0861244019138756,0.12371134020618557
"[0, 0, 0, 0, 1, 1, 0, 0, 1, 0, 1, 1, 1, 1, 0]",174,96,78,11,9,0.11458333333333333,0.11538461538461539
"[0, 1, 1, 0, 0, 1, 1, 0, 0, 1, 0, 0, 0, 0, 1]",234,180,54,10,5,0.05555555555555555,0.09259259259259259
"[1, 0, 0, 0, 0, 1, 1, 0, 0, 1, 1, 1, 1, 0, 1]",393,95,298,8,26,0.08421052631578947,0.087248322147651
"[1, 1, 1, 0, 1, 1, 0, 1, 1, 0, 1, 1, 1, 1, 0]",513,162,351,19,35,0.11728395061728394,0.09971509971509972
"[0, 1, 0, 0, 1, 0, 0, 0, 0, 0, 1, 0, 0, 0, 0]",1638,1262,376,124,46,0.098256735340729,0.12234042553191489
"[1, 1, 1, 1, 0, 0, 0, 0, 0, 0, 0, 0, 0, 1, 1]",1012,587,425,58,45,0.09880749574105621,0.10588235294117647
"[1, 1, 0, 1, 1, 0, 0, 0, 0, 1, 1, 1, 1, 1, 1]",864,316,548,33,55,0.10443037974683544,0.10036496350364964
"[1, 0, 1, 0, 0, 0, 1, 1, 0, 1, 1, 0, 0, 0, 0]",187,104,83,13,6,0.125,0.07228915662650602
"[0, 0, 1, 1, 0, 1, 0, 1, 1, 1, 0, 0, 0, 0, 1]",177,89,88,5,9,0.056179775280898875,0.10227272727272728
"[1, 0, 0, 0, 0, 1, 0, 1, 1, 1, 1, 0, 0, 1, 1]",232,101,131,9,10,0.0891089108910891,0.07633587786259542
"[0, 1, 0, 1, 1, 0, 1, 1, 0, 1, 0, 0, 0, 1, 1]",128,62,66,8,7,0.12903225806451613,0.10606060606060606
"[0, 0, 0, 0, 0, 1, 0, 0, 1, 1, 1, 0, 0, 1, 0]",221,161,60,16,4,0.09937888198757763,0.06666666666666667
"[0, 0, 0, 0, 0, 0, 1, 0, 0, 1, 1, 1, 0, 0, 1]",321,207,114,20,12,0.0966183574879227,0.10526315789473684
"[0, 1, 0, 1, 1, 1, 1, 0, 1, 0, 0, 1, 1, 1, 1]",327,117,210,9,23,0.07692307692307693,0.10952380952380952
"[0, 0, 0, 1, 1, 1, 0, 1, 1, 0, 0, 0, 0, 1, 1]",228,129,99,12,10,0.09302325581395349,0.10101010101010101
"[1, 1, 0, 1, 1, 1, 1, 0, 0, 0, 1, 1, 1, 0, 1]",246,82,164,6,19,0.07317073170731707,0.11585365853658537
"[1, 1, 1, 0, 1, 0, 0, 0, 0, 0, 1, 1, 0, 0, 0]",266,151,115,12,9,0.07947019867549669,0.0782608695652174
"[0, 1, 0, 0, 0, 1, 1, 1, 1, 1, 1, 1, 0, 1, 0]",174,70,104,3,14,0.04285714285714286,0.1346153846153846
"[0, 0, 0, 0, 0, 1, 0, 1, 0, 0, 0, 1, 1, 1, 1]",358,236,122,34,10,0.1440677966101695,0.08196721311475409
"[0, 0, 1, 0, 0, 0, 1, 1, 0, 0, 1, 0, 1, 1, 1]",148,80,68,6,10,0.075,0.14705882352941177
"[0, 1, 1, 0, 0, 1, 0, 1, 0, 0, 0, 0, 0, 1, 1]",255,162,93,18,10,0.1111111111111111,0.10752688172043011
"[0, 1, 0, 1, 0, 1, 1, 1, 0, 0, 1, 1, 0, 1, 1]",159,64,95,3,10,0.046875,0.10526315789473684
"[0, 0, 1, 0, 0, 0, 0, 0, 1, 1, 0, 0, 0, 1, 0]",557,411,146,38,7,0.09245742092457421,0.04794520547945205
"[0, 0, 0, 1, 0, 0, 0, 0, 0, 1, 1, 0, 0, 0, 1]",655,468,187,38,20,0.0811965811965812,0.10695187165775401
"[1, 0, 0, 1, 0, 1, 1, 1, 1, 1, 0, 1, 0, 0, 1]",157,69,88,8,8,0.11594202898550725,0.09090909090909091
"[1, 0, 0, 0, 0, 1, 1, 1, 1, 0, 1, 0, 1, 0, 1]",172,51,121,4,6,0.0784313725490196,0.049586776859504134
"[1, 1, 0, 1, 0, 1, 1, 1, 1, 1, 0, 0, 1, 1, 0]",376,139,237,21,28,0.1510791366906475,0.11814345991561181
"[0, 0, 1, 0, 1, 0, 1, 0, 1, 1, 1, 1, 0, 1, 0]",119,49,70,6,8,0.12244897959183673,0.11428571428571428
"[1, 0, 0, 1, 0, 0, 0, 0, 1, 1, 0, 0, 0, 1, 0]",252,164,88,19,6,0.11585365853658537,0.06818181818181818
"[1, 1, 0, 0, 0, 0, 1, 1, 1, 0, 1, 0, 1, 0, 0]",141,64,77,9,14,0.140625,0.18181818181818182
"[0, 0, 0, 0, 0, 1, 1, 1, 1, 1, 1, 0, 1, 0, 1]",285,184,101,15,8,0.08152173913043478,0.07920792079207921
"[1, 0, 0, 0, 0, 0, 1, 1, 1, 1, 1, 1, 0, 1, 0]",183,75,108,7,15,0.09333333333333334,0.1388888888888889
"[0, 0, 1, 0, 0, 1, 0, 1, 0, 1, 1, 1, 0, 0, 1]",127,66,61,4,6,0.06060606060606061,0.09836065573770492
"[1, 0, 1, 0, 1, 0, 0, 0, 1, 1, 0, 0, 0, 1, 0]",129,82,47,11,4,0.13414634146341464,0.0851063829787234
"[0, 0, 1, 0, 0, 0, 0, 0, 0, 0, 1, 1, 0, 1, 0]",562,380,182,43,12,0.11315789473684211,0.06593406593406594
"[1, 1, 1, 0, 0, 1, 0, 0, 0, 0, 1, 0, 0, 0, 0]",271,169,102,14,8,0.08284023668639054,0.0784313725490196
"[0, 1, 0, 0, 0, 1, 1, 0, 0, 1, 0, 0, 1, 1, 1]",169,97,72,9,6,0.09278350515463918,0.08333333333333333
"[1, 0, 1, 0, 0, 1, 0, 1, 0, 1, 0, 0, 0, 1, 1]",130,70,60,6,2,0.08571428571428572,0.03333333333333333
"[1, 0, 0, 0, 1, 1, 0, 1, 0, 0, 1, 0, 1, 0, 1]",102,49,53,3,5,0.061224489795918366,0.09433962264150944
"[1, 1, 1, 0, 1, 1, 1, 1, 0, 1, 0, 1, 0, 1, 1]",501,145,356,13,37,0.0896551724137931,0.10393258426966293
"[0, 1, 1, 1, 1, 1, 1, 0, 1, 0, 0, 1, 0, 0, 0]",128,69,59,7,7,0.10144927536231885,0.11864406779661017
"[0, 1, 0, 0, 1, 0, 0, 1, 1, 0, 1, 1, 0, 0, 0]",177,105,72,11,5,0.10476190476190476,0.06944444444444445
"[0, 1, 1, 1, 0, 1, 1, 0, 0, 0, 1, 1, 0, 1, 1]",158,70,88,4,8,0.05714285714285714,0.09090909090909091
"[0, 0, 1, 1, 1, 1, 0, 0, 0, 1, 0, 1, 0, 0, 0]",223,127,96,7,4,0.05511811023622047,0.041666666666666664
"[1, 1, 0, 1, 0, 0, 0, 0, 0, 1, 0, 0, 1, 1, 1]",173,84,89,12,10,0.14285714285714285,0.11235955056179775
"[0, 1, 1, 0, 1, 0, 0, 0, 0, 0, 1, 0, 0, 1, 1]",177,102,75,14,11,0.13725490196078433,0.14666666666666667
"[1, 1, 0, 1, 0, 0, 1, 1, 0, 0, 1, 0, 0, 0, 1]",125,65,60,11,6,0.16923076923076924,0.1
"[1, 1, 1, 1, 1, 1, 1, 0, 1, 0, 0, 1, 1, 0, 0]",441,142,299,17,22,0.11971830985915492,0.07357859531772576
"[1, 1, 0, 1, 0, 1, 0, 0, 1, 1, 0, 0, 0, 0, 0]",265,161,104,19,13,0.11801242236024845,0.125
"[0, 1, 1, 1, 1, 0, 1, 0, 1, 0, 0, 1, 1, 0, 0]",136,73,63,6,9,0.0821917808219178,0.14285714285714285
"[0, 1, 1, 0, 0, 0, 1, 0, 0, 0, 0, 0, 0, 0, 1]",687,498,189,54,23,0.10843373493975904,0.12169312169312169
"[0, 0, 1, 0, 1, 1, 1, 0, 1, 1, 0, 0, 0, 1, 0]",96,57,39,8,4,0.14035087719298245,0.10256410256410256
"[1, 1, 0, 1, 0, 1, 1, 0, 1, 0, 1, 0, 1, 0, 0]",97,45,52,4,3,0.08888888888888889,0.057692307692307696
"[0, 0, 0, 1, 0, 0, 1, 0, 0, 1, 0, 0, 1, 0, 1]",241,152,89,8,10,0.05263157894736842,0.11235955056179775
"[1, 1, 0, 0, 0, 0, 0, 0, 1, 0, 0, 1, 0, 0, 1]",346,230,116,16,11,0.06956521739130435,0.09482758620689655
"[0, 1, 0, 1, 1, 0, 1, 0, 0, 0, 1, 1, 1, 1, 1]",192,89,103,7,5,0.07865168539325842,0.04854368932038835
"[1, 0, 0, 1, 0, 1, 0, 1, 1, 0, 1, 0, 0, 0, 1]",112,55,57,10,4,0.18181818181818182,0.07017543859649122
"[0, 1, 0, 1, 1, 0, 1, 0, 1, 0, 0, 1, 1, 0, 1]",93,47,46,5,5,0.10638297872340426,0.10869565217391304
"[1, 1, 1, 1, 1, 0, 0, 0, 1, 1, 1, 0, 0, 0, 0]",263,85,178,6,26,0.07058823529411765,0.14606741573033707
"[1, 1, 1, 1, 1, 1, 0, 0, 0, 1, 1, 1, 0, 0, 0]",356,161,195,10,26,0.062111801242236024,0.13333333333333333
"[1, 1, 1, 1, 0, 1, 0, 0, 0, 0, 1, 1, 1, 0, 1]",151,61,90,10,10,0.16393442622950818,0.1111111111111111
"[0, 0, 1, 1, 0, 0, 0, 1, 1, 1, 0, 1, 1, 0, 0]",135,77,58,4,6,0.05194805194805195,0.10344827586206896
"[0, 1, 1, 0, 1, 1, 0, 0, 1, 0, 0, 0, 1, 1, 1]",148,75,73,4,4,0.05333333333333334,0.0547945205479452
"[0, 1, 0, 1, 0, 1, 1, 0, 1, 1, 0, 0, 1, 0, 0]",114,59,55,2,5,0.03389830508474576,0.09090909090909091
"[1, 1, 0, 1, 0, 1, 1, 0, 1, 1, 0, 1, 0, 1, 0]",138,55,83,5,13,0.09090909090909091,0.1566265060240964
"[1, 0, 0, 0, 1, 1, 1, 0, 0, 1, 1, 0, 1, 1, 0]",123,53,70,4,5,0.07547169811320754,0.07142857142857142
"[0, 0, 1, 0, 0, 0, 1, 1, 0, 1, 1, 0, 0, 1, 1]",158,101,57,11,7,0.10891089108910891,0.12280701754385964
"[1, 1, 0, 1, 0, 0, 0, 1, 0, 1, 0, 0, 1, 0, 0]",124,72,52,7,3,0.09722222222222222,0.057692307692307696
"[0, 0, 1, 0, 1, 1, 1, 0, 1, 0, 0, 1, 1, 1, 0]",122,61,61,6,11,0.09836065573770492,0.18032786885245902
"[0, 0, 1, 0, 0, 1, 1, 0, 0, 0, 0, 1, 1, 1, 0]",193,131,62,13,4,0.09923664122137404,0.06451612903225806
"[0, 0, 1, 0, 1, 0, 1, 1, 0, 1, 0, 1, 1, 1, 0]",122,58,64,10,8,0.1724137931034483,0.125
"[1, 1, 1, 1, 0, 0, 0, 0, 1, 1, 1, 1, 0, 1, 0]",390,174,216,12,21,0.06896551724137931,0.09722222222222222
"[0, 0, 1, 1, 0, 1, 0, 1, 1, 1, 0, 1, 0, 1, 1]",157,58,99,6,8,0.10344827586206896,0.08080808080808081
"[1, 0, 1, 1, 1, 1, 0, 0, 1, 1, 0, 0, 1, 1, 0]",450,194,256,17,31,0.08762886597938144,0.12109375
"[1, 0, 1, 1, 1, 0, 0, 0, 0, 1, 0, 0, 0, 1, 1]",139,63,76,7,2,0.1111111111111111,0.02631578947368421
"[1, 1, 1, 0, 0, 1, 0, 0, 1, 1, 0, 1, 1, 1, 0]",132,41,91,3,5,0.07317073170731707,0.054945054945054944
"[0, 0, 0, 1, 0, 0, 1, 1, 1, 0, 1, 1, 0, 0, 1]",142,83,59,4,7,0.04819277108433735,0.11864406779661017
"[0, 0, 1, 1, 1, 0, 1, 0, 0, 1, 1, 1, 1, 0, 0]",197,96,101,14,10,0.14583333333333334,0.09900990099009901
"[0, 0, 1, 0, 1, 0, 0, 0, 1, 0, 0, 1, 0, 0, 0]",482,352,130,38,13,0.10795454545454546,0.1
"[0, 0, 0, 0, 1, 0, 1, 0, 0, 0, 0, 1, 0, 1, 0]",488,352,136,36,11,0.10227272727272728,0.08088235294117647
"[0, 1, 0, 1, 0, 0, 1, 0, 1, 1, 0, 0, 1, 1, 1]",176,87,89,7,7,0.08045977011494253,0.07865168539325842
"[1, 1, 0, 1, 1, 0, 0, 0, 1, 0, 0, 0, 1, 0, 0]",160,91,69,9,6,0.0989010989010989,0.08695652173913043
"[1, 1, 1, 0, 0, 1, 0, 0, 0, 0, 1, 1, 1, 1, 1]",375,146,229,18,21,0.1232876712328767,0.09170305676855896
"[0, 0, 1, 1, 0, 1, 0, 1, 1, 1, 0, 1, 1, 0, 1]",148,56,92,5,8,0.08928571428571429,0.08695652173913043
"[0, 0, 1, 0, 0, 1, 1, 1, 1, 1, 1, 1, 1, 1, 0]",412,168,244,8,23,0.047619047619047616,0.0942622950819672
"[1, 1, 1, 0, 1, 1, 1, 0, 0, 1, 1, 1, 1, 0, 1]",561,166,395,13,44,0.0783132530120482,0.11139240506329114
"[1, 0, 0, 1, 1, 0, 0, 0, 0, 0, 1, 1, 0, 0, 0]",480,236,244,26,21,0.11016949152542373,0.0860655737704918
"[0, 0, 1, 1, 1, 1, 1, 0, 0, 0, 0, 0, 0, 0, 1]",273,157,116,15,10,0.09554140127388536,0.08620689655172414
"[1, 1, 1, 0, 1, 0, 0, 0, 0, 1, 0, 0, 1, 1, 0]",117,58,59,5,8,0.08620689655172414,0.13559322033898305
"[0, 0, 1, 0, 0, 0, 0, 1, 1, 0, 1, 1, 1, 0, 1]",98,43,55,5,3,0.11627906976744186,0.05454545454545454
"[0, 0, 1, 1, 1, 0, 0, 1, 0, 1, 1, 0, 1, 0, 1]",126,56,70,4,2,0.07142857142857142,0.02857142857142857
"[0, 1, 1, 1, 1, 1, 0, 0, 1, 1, 1, 0, 1, 0, 0]",172,70,102,6,10,0.08571428571428572,0.09803921568627451
"[1, 0, 0, 1, 0, 1, 0, 1, 1, 0, 1, 0, 1, 1, 0]",90,34,56,2,5,0.058823529411764705,0.08928571428571429
"[1, 0, 1, 1, 0, 0, 0, 1, 1, 1, 1, 0, 1, 1, 1]",287,99,188,8,26,0.08080808080808081,0.13829787234042554
"[1, 1, 0, 0, 0, 0, 0, 1, 0, 1, 1, 1, 0, 1, 0]",98,53,45,4,3,0.07547169811320754,0.06666666666666667
"[0, 1, 1, 1, 1, 0, 0, 0, 1, 1, 1, 0, 0, 1, 0]",116,66,50,9,1,0.13636363636363635,0.02
"[0, 1, 1, 0, 1, 0, 0, 0, 0, 1, 0, 1, 0, 0, 0]",270,179,91,23,8,0.12849162011173185,0.08791208791208792
"[1, 0, 0, 1, 1, 0, 1, 0, 0, 0, 0, 1, 0, 1, 0]",149,85,64,10,6,0.11764705882352941,0.09375
"[0, 1, 0, 1, 0, 0, 1, 1, 0, 1, 0, 0, 0, 0, 1]",150,89,61,5,4,0.056179775280898875,0.06557377049180328
"[1, 0, 1, 0, 1, 0, 0, 1, 1, 0, 1, 0, 0, 0, 0]",152,88,64,9,9,0.10227272727272728,0.140625
"[1, 1, 1, 0, 0, 0, 1, 0, 0, 0, 1, 0, 0, 0, 0]",274,161,113,20,13,0.12422360248447205,0.11504424778761062
"[0, 0, 1, 1, 1, 1, 0, 0, 0, 1, 0, 0, 0, 1, 0]",168,100,68,8,6,0.08,0.08823529411764706
"[0, 1, 0, 1, 0, 0, 0, 0, 0, 1, 0, 0, 1, 1, 0]",257,162,95,19,11,0.11728395061728394,0.11578947368421053
"[1, 0, 1, 1, 0, 1, 1, 0, 0, 1, 1, 1, 1, 1, 0]",292,106,186,10,12,0.09433962264150944,0.06451612903225806
"[0, 0, 1, 1, 0, 1, 0, 1, 0, 1, 1, 0, 0, 0, 0]",202,119,83,9,6,0.07563025210084033,0.07228915662650602
"[1, 0, 1, 0, 0, 1, 1, 1, 0, 0, 0, 0, 1, 1, 0]",201,108,93,8,12,0.07407407407407407,0.12903225806451613
"[1, 1, 1, 0, 1, 1, 0, 0, 1, 1, 0, 0, 1, 1, 0]",346,124,222,12,26,0.0967741935483871,0.11711711711711711
"[1, 1, 1, 1, 1, 0, 1, 1, 0, 0, 1, 1, 0, 0, 1]",553,186,367,18,34,0.0967741935483871,0.09264305177111716
"[0, 0, 1, 0, 0, 1, 1, 1, 1, 0, 1, 1, 1, 0, 0]",124,61,63,3,4,0.04918032786885246,0.06349206349206349
"[0, 1, 1, 1, 1, 1, 0, 1, 1, 1, 0, 0, 1, 0, 1]",227,90,137,6,14,0.06666666666666667,0.10218978102189781
"[1, 0, 0, 1, 1, 1, 1, 1, 0, 1, 1, 1, 0, 0, 1]",322,104,218,5,22,0.04807692307692308,0.10091743119266056
"[0, 0, 1, 1, 1, 0, 0, 0, 0, 1, 1, 1, 0, 1, 1]",165,82,83,7,9,0.08536585365853659,0.10843373493975904
"[0, 0, 0, 0, 1, 1, 1, 1, 1, 0, 1, 1, 0, 1, 1]",259,105,154,6,10,0.05714285714285714,0.06493506493506493
"[0, 0, 0, 0, 1, 0, 0, 1, 1, 0, 0, 1, 0, 0, 0]",582,419,163,50,11,0.11933174224343675,0.06748466257668712
"[0, 0, 0, 0, 0, 0, 0, 0, 1, 0, 1, 0, 0, 1, 1]",1078,828,250,75,18,0.09057971014492754,0.072
"[0, 1, 1, 1, 1, 1, 1, 0, 0, 0, 1, 0, 0, 0, 1]",186,102,84,8,10,0.0784313725490196,0.11904761904761904
"[1, 1, 0, 0, 1, 1, 1, 1, 1, 1, 0, 0, 0, 1, 0]",331,127,204,17,11,0.13385826771653545,0.05392156862745098
"[0, 1, 0, 0, 1, 0, 1, 1, 1, 0, 1, 1, 0, 1, 0]",104,50,54,6,6,0.12,0.1111111111111111
"[0, 0, 1, 1, 0, 1, 1, 0, 1, 0, 0, 0, 1, 1, 1]",140,69,71,6,6,0.08695652173913043,0.08450704225352113
"[0, 0, 0, 0, 1, 1, 0, 0, 1, 1, 1, 0, 1, 0, 1]",225,118,107,9,17,0.07627118644067797,0.1588785046728972
"[1, 1, 1, 0, 0, 0, 0, 1, 1, 1, 0, 1, 1, 0, 1]",226,67,159,6,15,0.08955223880597014,0.09433962264150944
"[0, 0, 0, 1, 0, 1, 0, 0, 1, 0, 0, 0, 1, 1, 0]",246,165,81,12,8,0.07272727272727272,0.09876543209876543
"[1, 1, 0, 0, 1, 1, 0, 0, 1, 1, 1, 1, 1, 0, 0]",460,202,258,27,24,0.13366336633663367,0.09302325581395349
"[0, 1, 0, 0, 0, 0, 0, 0, 1, 1, 0, 1, 0, 1, 1]",195,112,83,15,9,0.13392857142857142,0.10843373493975904
"[0, 1, 0, 1, 1, 0, 0, 0, 1, 1, 0, 0, 0, 0, 0]",390,250,140,27,9,0.108,0.06428571428571428
"[0, 1, 0, 0, 0, 1, 0, 1, 1, 0, 0, 0, 1, 1, 0]",165,89,76,10,7,0.11235955056179775,0.09210526315789473
"[1, 0, 1, 0, 0, 0, 0, 1, 0, 0, 1, 0, 0, 0, 0]",527,388,139,33,14,0.08505154639175258,0.10071942446043165
"[1, 1, 1, 0, 1, 0, 0, 0, 0, 0, 0, 1, 1, 1, 1]",379,161,218,20,21,0.12422360248447205,0.0963302752293578
"[1, 1, 0, 0, 0, 0, 1, 0, 1, 1, 1, 1, 1, 1, 1]",559,203,356,15,39,0.07389162561576355,0.10955056179775281
"[0, 1, 0, 1, 1, 1, 0, 1, 0, 0, 1, 1, 0, 0, 1]",134,53,81,6,5,0.11320754716981132,0.06172839506172839
"[1, 1, 0, 0, 1, 0, 1, 1, 0, 0, 1, 1, 1, 0, 1]",174,74,100,8,13,0.10810810810810811,0.13
"[1, 1, 0, 1, 0, 1, 1, 0, 0, 1, 1, 1, 0, 1, 0]",152,60,92,6,11,0.1,0.11956521739130435
"[1, 1, 1, 1, 0, 1, 0, 1, 1, 1, 1, 0, 0, 0, 1]",282,103,179,8,18,0.07766990291262135,0.1005586592178771
"[1, 0, 0, 0, 1, 1, 0, 0, 0, 1, 1, 1, 1, 1, 0]",117,55,62,6,8,0.10909090909090909,0.12903225806451613
"[0, 0, 1, 0, 1, 1, 1, 1, 0, 0, 0, 1, 1, 1, 1]",224,109,115,11,12,0.10091743119266056,0.10434782608695652
"[0, 0, 1, 1, 1, 1, 1, 1, 1, 0, 0, 0, 1, 1, 0]",226,104,122,16,12,0.15384615384615385,0.09836065573770492
"[0, 0, 1, 1, 1, 0, 1, 1, 1, 1, 0, 1, 1, 1, 0]",229,82,147,10,19,0.12195121951219512,0.1292517006802721
"[0, 1, 1, 1, 0, 0, 1, 0, 0, 1, 1, 1, 0, 1, 1]",181,79,102,11,7,0.13924050632911392,0.06862745098039216
"[1, 1, 0, 0, 0, 1, 1, 1, 1, 0, 1, 1, 0, 0, 0]",148,68,80,4,9,0.058823529411764705,0.1125
"[1, 1, 0, 0, 0, 1, 1, 1, 0, 1, 0, 0, 1, 1, 1]",205,80,125,6,9,0.075,0.072
"[0, 1, 0, 1, 1, 0, 0, 0, 1, 1, 1, 0, 1, 0, 0]",97,51,46,4,3,0.0784313725490196,0.06521739130434782
"[1, 0, 0, 0, 1, 0, 1, 1, 0, 0, 0, 1, 1, 1, 0]",102,53,49,3,10,0.05660377358490566,0.20408163265306123
"[1, 0, 1, 0, 0, 1, 1, 1, 1, 1, 0, 1, 0, 1, 1]",234,79,155,8,14,0.10126582278481013,0.09032258064516129
"[1, 1, 0, 1, 0, 0, 1, 1, 1, 1, 1, 0, 1, 0, 1]",225,69,156,8,13,0.11594202898550725,0.08333333333333333
"[0, 1, 1, 0, 1, 0, 0, 1, 1, 1, 1, 1, 0, 1, 0]",117,56,61,3,6,0.05357142857142857,0.09836065573770492
"[1, 0, 0, 0, 1, 1, 0, 0, 0, 0, 1, 0, 1, 0, 1]",165,101,64,15,7,0.1485148514851485,0.109375
"[0, 1, 1, 0, 0, 0, 1, 1, 0, 0, 0, 0, 1, 0, 1]",155,91,64,13,5,0.14285714285714285,0.078125
"[1, 0, 0, 1, 1, 0, 0, 0, 1, 1, 0, 0, 0, 0, 1]",254,124,130,15,17,0.12096774193548387,0.13076923076923078
"[0, 1, 0, 1, 1, 1, 1, 1, 0, 1, 1, 0, 0, 1, 1]",311,106,205,10,14,0.09433962264150944,0.06829268292682927
"[1, 1, 1, 1, 0, 1, 1, 1, 0, 0, 0, 0, 0, 0, 0]",273,140,133,16,9,0.11428571428571428,0.06766917293233082
"[1, 1, 0, 0, 0, 0, 1, 0, 1, 0, 1, 1, 0, 1, 1]",140,77,63,5,3,0.06493506493506493,0.047619047619047616
"[1, 1, 0, 1, 0, 1, 1, 1, 0, 0, 0, 1, 1, 1, 1]",327,119,208,12,16,0.10084033613445378,0.07692307692307693
"[0, 0, 0, 0, 0, 1, 1, 0, 1, 0, 1, 1, 1, 0, 0]",200,138,62,13,8,0.09420289855072464,0.12903225806451613
"[0, 1, 1, 0, 0, 0, 0, 0, 1, 1, 0, 1, 0, 1, 1]",162,95,67,12,6,0.12631578947368421,0.08955223880597014
"[1, 1, 1, 0, 1, 1, 1, 1, 1, 0, 1, 0, 1, 0, 1]",454,143,311,18,31,0.1258741258741259,0.09967845659163987
"[1, 0, 0, 1, 0, 1, 1, 1, 0, 0, 1, 0, 0, 0, 0]",181,109,72,13,6,0.11926605504587157,0.08333333333333333
"[0, 1, 0, 1, 0, 0, 0, 1, 1, 0, 0, 1, 0, 1, 1]",108,64,44,6,5,0.09375,0.11363636363636363
"[1, 0, 1, 0, 1, 1, 0, 0, 0, 0, 0, 1, 0, 0, 0]",241,140,101,16,7,0.11428571428571428,0.06930693069306931
"[0, 0, 0, 1, 0, 1, 1, 1, 0, 1, 0, 1, 0, 0, 1]",100,53,47,5,4,0.09433962264150944,0.0851063829787234
"[1, 0, 1, 0, 0, 1, 1, 0, 1, 1, 1, 0, 0, 1, 0]",92,36,56,3,5,0.08333333333333333,0.08928571428571429
"[1, 1, 0, 1, 0, 0, 1, 0, 1, 0, 0, 0, 0, 1, 0]",127,75,52,6,8,0.08,0.15384615384615385
"[1, 0, 1, 0, 0, 1, 0, 1, 0, 0, 1, 1, 1, 0, 1]",96,49,47,2,1,0.04081632653061224,0.02127659574468085
"[0, 0, 1, 0, 0, 0, 0, 0, 1, 1, 1, 1, 0, 1, 1]",141,80,61,11,3,0.1375,0.04918032786885246
"[1, 0, 0, 1, 1, 0, 1, 1, 0, 1, 1, 0, 1, 1, 0]",134,58,76,7,8,0.1206896551724138,0.10526315789473684
"[0, 0, 0, 1, 1, 0, 0, 0, 1, 1, 1, 0, 1, 0, 0]",140,93,47,4,5,0.043010752688172046,0.10638297872340426
"[0, 1, 1, 1, 0, 1, 1, 1, 1, 1, 0, 0, 0, 0, 0]",250,134,116,12,9,0.08955223880597014,0.07758620689655173
"[0, 0, 1, 1, 1, 1, 1, 1, 1, 0, 1, 0, 0, 1, 1]",393,153,240,13,25,0.08496732026143791,0.10416666666666667
"[1, 0, 0, 0, 1, 0, 1, 0, 0, 1, 0, 1, 0, 1, 1]",116,57,59,7,4,0.12280701754385964,0.06779661016949153
"[0, 0, 0, 0, 0, 1, 0, 1, 1, 1, 0, 0, 0, 1, 0]",270,180,90,13,7,0.07222222222222222,0.07777777777777778
"[0, 1, 0, 1, 1, 0, 0, 0, 0, 0, 0, 0, 0, 1, 0]",579,394,185,50,15,0.12690355329949238,0.08108108108108109
"[0, 1, 0, 1, 0, 0, 0, 1, 0, 0, 1, 1, 1, 0, 1]",118,58,60,10,2,0.1724137931034483,0.03333333333333333
"[0, 0, 1, 1, 1, 1, 1, 0, 0, 0, 1, 0, 1, 0, 1]",130,65,65,9,7,0.13846153846153847,0.1076923076923077
"[1, 0, 1, 0, 0, 0, 0, 1, 1, 1, 1, 1, 0, 0, 0]",160,98,62,10,9,0.10204081632653061,0.14516129032258066
"[1, 1, 1, 1, 0, 1, 1, 1, 0, 1, 1, 0, 1, 0, 0]",236,71,165,6,24,0.08450704225352113,0.14545454545454545
"[1, 1, 0, 0, 1, 1, 0, 0, 0, 1, 0, 0, 0, 1, 1]",229,130,99,17,12,0.13076923076923078,0.12121212121212122
"[1, 0, 0, 0, 0, 0, 1, 0, 1, 0, 1, 0, 1, 0, 0]",220,138,82,21,6,0.15217391304347827,0.07317073170731707
"[0, 1, 1, 0, 0, 0, 1, 1, 0, 1, 1, 0, 0, 1, 0]",97,54,43,4,4,0.07407407407407407,0.09302325581395349
"[1, 1, 0, 0, 1, 1, 0, 0, 0, 1, 1, 0, 1, 1, 0]",157,79,78,13,6,0.16455696202531644,0.07692307692307693
"[1, 1, 1, 1, 1, 0, 1, 1, 1, 0, 0, 1, 0, 0, 1]",288,108,180,13,18,0.12037037037037036,0.1
"[0, 0, 1, 0, 0, 0, 1, 1, 0, 1, 1, 0, 0, 0, 0]",277,177,100,16,12,0.0903954802259887,0.12
"[1, 1, 1, 0, 0, 0, 1, 0, 0, 0, 1, 1, 0, 1, 1]",139,56,83,6,4,0.10714285714285714,0.04819277108433735
"[0, 1, 0, 1, 0, 0, 1, 1, 1, 0, 1, 1, 1, 0, 0]",129,59,70,8,7,0.13559322033898305,0.1
"[1, 0, 1, 0, 1, 0, 0, 1, 1, 1, 0, 1, 1, 1, 0]",154,64,90,1,12,0.015625,0.13333333333333333
"[1, 1, 1, 1, 0, 0, 0, 1, 0, 1, 1, 1, 0, 0, 1]",196,75,121,7,12,0.09333333333333334,0.09917355371900827
"[1, 0, 0, 1, 1, 0, 0, 0, 1, 1, 1, 1, 1, 0, 1]",189,70,119,8,13,0.11428571428571428,0.1092436974789916
"[0, 1, 1, 0, 0, 0, 0, 1, 0, 0, 0, 0, 1, 0, 0]",654,490,164,49,12,0.1,0.07317073170731707
"[1, 0, 0, 0, 0, 0, 1, 1, 1, 1, 0, 0, 1, 0, 0]",226,127,99,8,8,0.06299212598425197,0.08080808080808081
"[0, 0, 0, 0, 0, 1, 0, 0, 0, 1, 0, 1, 0, 0, 1]",546,398,148,37,13,0.09296482412060302,0.08783783783783784
"[1, 1, 0, 1, 1, 1, 1, 0, 1, 1, 0, 1, 1, 0, 0]",278,101,177,12,18,0.1188118811881188,0.1016949152542373
"[1, 0, 1, 1, 0, 0, 0, 1, 0, 0, 0, 1, 1, 1, 1]",154,84,70,9,3,0.10714285714285714,0.04285714285714286
"[0, 0, 1, 1, 0, 0, 0, 1, 1, 1, 0, 0, 1, 1, 0]",168,88,80,4,9,0.045454545454545456,0.1125
"[0, 1, 1, 0, 0, 1, 1, 1, 0, 0, 1, 0, 0, 1, 1]",179,95,84,11,4,0.11578947368421053,0.047619047619047616
"[0, 0, 1, 1, 0, 0, 1, 0, 1, 1, 0, 1, 1, 0, 0]",138,76,62,5,3,0.06578947368421052,0.04838709677419355
"[0, 1, 1, 1, 0, 1, 1, 0, 1, 1, 0, 0, 1, 1, 0]",192,84,108,9,11,0.10714285714285714,0.10185185185185185
"[0, 1, 1, 0, 0, 1, 1, 1, 1, 0, 1, 1, 0, 1, 1]",360,195,165,11,10,0.05641025641025641,0.06060606060606061
"[0, 0, 1, 1, 0, 0, 1, 1, 1, 1, 0, 1, 1, 0, 1]",278,105,173,10,13,0.09523809523809523,0.07514450867052024
"[1, 1, 1, 1, 0, 0, 1, 1, 1, 0, 1, 0, 1, 0, 0]",176,66,110,13,4,0.19696969696969696,0.03636363636363636
"[1, 1, 0, 0, 1, 1, 1, 1, 1, 0, 0, 1, 1, 1, 0]",354,135,219,13,23,0.0962962962962963,0.1050228310502283
"[0, 0, 1, 1, 0, 0, 1, 0, 1, 1, 0, 1, 1, 0, 1]",141,65,76,6,7,0.09230769230769231,0.09210526315789473
"[0, 0, 0, 1, 0, 0, 0, 0, 1, 1, 0, 0, 1, 0, 1]",290,180,110,23,14,0.12777777777777777,0.12727272727272726
"[1, 1, 1, 1, 0, 1, 1, 1, 1, 0, 0, 1, 0, 1, 0]",243,75,168,10,7,0.13333333333333333,0.041666666666666664
"[0, 1, 1, 0, 1, 1, 1, 0, 0, 1, 1, 1, 0, 0, 0]",136,68,68,8,7,0.11764705882352941,0.10294117647058823
"[1, 1, 1, 0, 1, 1, 0, 1, 0, 0, 0, 0, 0, 0, 1]",187,83,104,8,13,0.0963855421686747,0.125
"[0, 0, 1, 1, 1, 1, 1, 1, 1, 0, 0, 0, 1, 1, 1]",531,216,315,27,40,0.125,0.12698412698412698
"[0, 1, 1, 1, 1, 1, 1, 1, 0, 1, 0, 0, 0, 1, 1]",345,158,187,15,12,0.0949367088607595,0.06417112299465241
"[1, 1, 0, 0, 1, 1, 1, 1, 0, 1, 1, 1, 1, 0, 0]",404,148,256,9,30,0.060810810810810814,0.1171875
"[1, 0, 1, 0, 1, 1, 0, 0, 1, 1, 0, 0, 0, 1, 1]",170,86,84,7,7,0.08139534883720931,0.08333333333333333
"[1, 1, 0, 1, 0, 0, 0, 0, 1, 0, 1, 0, 1, 1, 0]",108,65,43,9,3,0.13846153846153847,0.06976744186046512
"[1, 0, 1, 0, 0, 0, 1, 0, 1, 1, 0, 1, 1, 1, 1]",173,82,91,4,11,0.04878048780487805,0.12087912087912088
"[0, 0, 1, 0, 0, 1, 1, 1, 1, 1, 1, 1, 0, 0, 0]",253,122,131,16,12,0.13114754098360656,0.0916030534351145
"[1, 0, 0, 1, 0, 0, 1, 1, 1, 1, 1, 1, 1, 0, 0]",279,100,179,9,13,0.09,0.07262569832402235
"[0, 0, 0, 1, 1, 1, 1, 0, 0, 0, 0, 0, 1, 0, 0]",506,410,96,34,8,0.08292682926829269,0.08333333333333333
"[0, 1, 0, 0, 0, 0, 0, 1, 0, 1, 1, 0, 0, 1, 1]",213,118,95,8,10,0.06779661016949153,0.10526315789473684
"[0, 1, 1, 0, 0, 1, 0, 1, 0, 0, 0, 0, 0, 1, 0]",245,166,79,13,6,0.0783132530120482,0.0759493670886076
"[0, 1, 1, 1, 1, 0, 0, 0, 0, 0, 1, 1, 1, 1, 1]",441,244,197,18,19,0.07377049180327869,0.09644670050761421
"[1, 0, 1, 0, 0, 0, 0, 0, 0, 0, 1, 1, 0, 1, 0]",283,182,101,14,7,0.07692307692307693,0.06930693069306931
"[0, 0, 0, 1, 0, 0, 0, 0, 1, 1, 0, 1, 0, 1, 0]",212,135,77,12,8,0.08888888888888889,0.1038961038961039
"[1, 0, 0, 1, 1, 0, 1, 1, 1, 1, 1, 1, 1, 0, 0]",388,113,275,15,22,0.13274336283185842,0.08
"[0, 1, 0, 0, 1, 0, 1, 0, 0, 1, 1, 1, 0, 1, 1]",106,55,51,11,5,0.2,0.09803921568627451
"[1, 1, 1, 1, 0, 0, 1, 1, 1, 0, 0, 1, 0, 0, 0]",176,81,95,10,12,0.12345679012345678,0.12631578947368421
"[0, 1, 1, 0, 1, 1, 0, 0, 1, 1, 1, 1, 1, 0, 1]",267,96,171,13,11,0.13541666666666666,0.06432748538011696
"[0, 1, 0, 1, 0, 1, 0, 1, 0, 1, 0, 0, 0, 1, 1]",156,76,80,6,8,0.07894736842105263,0.1
"[1, 0, 1, 0, 1, 0, 1, 0, 1, 0, 1, 0, 0, 0, 1]",118,61,57,10,5,0.16393442622950818,0.08771929824561403
"[0, 1, 0, 0, 0, 0, 0, 0, 1, 0, 1, 1, 0, 0, 0]",619,451,168,50,19,0.11086474501108648,0.1130952380952381
"[1, 0, 0, 1, 1, 1, 1, 0, 0, 1, 1, 0, 1, 0, 0]",213,68,145,5,11,0.07352941176470588,0.07586206896551724
"[0, 0, 1, 1, 0, 1, 1, 0, 0, 1, 1, 0, 0, 1, 1]",305,162,143,16,12,0.09876543209876543,0.08391608391608392
"[0, 0, 1, 0, 1, 0, 0, 1, 1, 1, 1, 1, 1, 0, 1]",167,78,89,12,9,0.15384615384615385,0.10112359550561797
"[0, 1, 1, 0, 1, 1, 0, 1, 0, 0, 0, 0, 0, 1, 1]",158,83,75,2,4,0.024096385542168676,0.05333333333333334
"[0, 1, 1, 1, 1, 0, 0, 1, 1, 0, 1, 1, 0, 1, 0]",169,78,91,6,6,0.07692307692307693,0.06593406593406594
"[1, 0, 0, 1, 1, 1, 1, 0, 0, 1, 1, 0, 1, 1, 0]",296,81,215,10,14,0.12345679012345678,0.06511627906976744
"[0, 0, 1, 1, 0, 1, 1, 0, 0, 1, 0, 1, 0, 0, 0]",175,96,79,11,6,0.11458333333333333,0.0759493670886076
"[1, 0, 0, 0, 1, 0, 1, 0, 1, 0, 0, 0, 0, 0, 1]",245,160,85,22,12,0.1375,0.1411764705882353
"[0, 0, 1, 0, 0, 1, 0, 0, 0, 1, 1, 0, 0, 0, 1]",271,159,112,11,8,0.06918238993710692,0.07142857142857142
"[1, 0, 1, 1, 0, 0, 1, 0, 0, 1, 0, 0, 0, 1, 1]",131,74,57,8,7,0.10810810810810811,0.12280701754385964
"[1, 0, 1, 0, 0, 0, 0, 0, 0, 1, 1, 0, 1, 1, 1]",184,95,89,4,9,0.042105263157894736,0.10112359550561797
"[0, 1, 0, 0, 0, 0, 0, 1, 0, 0, 0, 1, 0, 1, 1]",237,164,73,13,5,0.07926829268292683,0.0684931506849315
"[0, 0, 1, 0, 0, 0, 0, 0, 1, 0, 0, 0, 1, 0, 1]",481,336,145,26,12,0.07738095238095238,0.08275862068965517
"[0, 1, 0, 1, 1, 0, 0, 1, 1, 1, 1, 0, 1, 0, 0]",126,61,65,3,6,0.04918032786885246,0.09230769230769231
"[1, 1, 1, 0, 1, 1, 1, 0, 0, 1, 1, 0, 0, 0, 0]",315,134,181,12,20,0.08955223880597014,0.11049723756906077
"[1, 1, 0, 0, 1, 1, 1, 0, 0, 0, 1, 1, 0, 0, 1]",174,85,89,9,7,0.10588235294117647,0.07865168539325842
"[1, 1, 0, 1, 1, 0, 0, 0, 0, 0, 1, 0, 1, 1, 0]",127,73,54,9,4,0.1232876712328767,0.07407407407407407
"[1, 0, 0, 1, 0, 1, 1, 0, 1, 0, 1, 0, 0, 0, 1]",104,55,49,6,2,0.10909090909090909,0.04081632653061224
"[1, 1, 1, 0, 1, 0, 0, 0, 0, 1, 0, 0, 1, 0, 0]",151,85,66,8,3,0.09411764705882353,0.045454545454545456
"[0, 0, 0, 0, 1, 0, 0, 1, 0, 0, 0, 1, 0, 1, 1]",291,202,89,17,8,0.08415841584158416,0.0898876404494382
"[1, 0, 0, 1, 0, 1, 0, 1, 0, 0, 0, 0, 0, 0, 1]",272,165,107,18,9,0.10909090909090909,0.08411214953271028
"[1, 1, 1, 0, 1, 0, 1, 0, 1, 0, 0, 1, 0, 1, 1]",153,60,93,6,12,0.1,0.12903225806451613
"[1, 1, 1, 1, 0, 1, 0, 1, 0, 1, 0, 0, 1, 0, 1]",139,58,81,10,5,0.1724137931034483,0.06172839506172839
"[1, 1, 0, 1, 1, 1, 1, 1, 0, 0, 0, 1, 1, 1, 0]",269,96,173,10,21,0.10416666666666667,0.12138728323699421
"[0, 1, 0, 1, 0, 0, 0, 0, 0, 1, 0, 1, 0, 1, 0]",240,157,83,13,9,0.08280254777070063,0.10843373493975904
"[0, 0, 1, 1, 0, 0, 1, 0, 1, 1, 1, 1, 1, 1, 1]",467,174,293,21,29,0.1206896551724138,0.09897610921501707
"[1, 1, 1, 0, 0, 1, 1, 0, 0, 1, 0, 1, 1, 1, 1]",522,127,395,12,31,0.09448818897637795,0.07848101265822785
"[1, 0, 0, 0, 1, 1, 0, 1, 1, 0, 0, 1, 0, 1, 0]",122,71,51,8,2,0.11267605633802817,0.0392156862745098
"[0, 1, 0, 1, 1, 0, 0, 0, 0, 1, 0, 0, 1, 1, 0]",155,93,62,14,1,0.15053763440860216,0.016129032258064516
"[1, 0, 1, 1, 1, 1, 0, 1, 0, 0, 0, 0, 0, 0, 1]",185,91,94,8,9,0.08791208791208792,0.09574468085106383
"[0, 1, 1, 0, 1, 0, 0, 1, 1, 1, 1, 0, 0, 0, 0]",258,144,114,20,10,0.1388888888888889,0.08771929824561403
"[1, 0, 1, 1, 0, 1, 0, 0, 1, 1, 1, 1, 0, 0, 0]",194,83,111,9,12,0.10843373493975904,0.10810810810810811
"[0, 1, 0, 0, 0, 1, 1, 0, 1, 0, 1, 0, 1, 1, 1]",123,52,71,5,2,0.09615384615384616,0.028169014084507043
"[0, 1, 0, 0, 1, 0, 1, 1, 1, 1, 1, 0, 0, 0, 0]",228,121,107,13,14,0.10743801652892562,0.1308411214953271
"[1, 0, 1, 0, 0, 1, 0, 1, 1, 1, 1, 1, 0, 0, 0]",175,81,94,9,7,0.1111111111111111,0.07446808510638298
"[1, 0, 0, 1, 0, 1, 0, 0, 0, 1, 0, 1, 0, 0, 1]",134,85,49,11,3,0.12941176470588237,0.061224489795918366
"[1, 0, 1, 1, 1, 0, 1, 0, 1, 1, 1, 0, 1, 1, 0]",259,109,150,14,19,0.12844036697247707,0.12666666666666668
"[1, 1, 0, 1, 1, 0, 1, 1, 1, 1, 0, 0, 1, 1, 0]",342,128,214,15,24,0.1171875,0.11214953271028037
"[0, 0, 1, 1, 0, 1, 1, 0, 1, 1, 1, 1, 0, 0, 1]",213,85,128,7,9,0.08235294117647059,0.0703125
"[0, 0, 0, 1, 1, 0, 1, 0, 0, 1, 0, 0, 0, 0, 1]",301,218,83,18,12,0.08256880733944955,0.14457831325301204
"[0, 0, 0, 0, 0, 1, 1, 0, 1, 1, 0, 0, 0, 1, 1]",261,178,83,18,10,0.10112359550561797,0.12048192771084337
"[0, 0, 0, 0, 1, 0, 1, 1, 1, 0, 0, 0, 1, 0, 0]",258,178,80,16,6,0.0898876404494382,0.075
"[1, 0, 1, 1, 0, 0, 0, 0, 1, 0, 0, 0, 0, 1, 0]",242,158,84,9,6,0.056962025316455694,0.07142857142857142
"[1, 1, 1, 0, 0, 0, 0, 0, 1, 0, 1, 0, 0, 0, 0]",328,167,161,18,13,0.10778443113772455,0.08074534161490683
"[1, 1, 1, 0, 0, 0, 0, 1, 1, 1, 1, 1, 0, 1, 0]",295,73,222,7,24,0.0958904109589041,0.10810810810810811
"[0, 0, 1, 0, 1, 1, 1, 1, 0, 1, 0, 0, 1, 1, 0]",111,50,61,5,12,0.1,0.19672131147540983
"[0, 0, 1, 1, 1, 0, 1, 0, 0, 0, 0, 0, 1, 1, 0]",231,139,92,14,4,0.10071942446043165,0.043478260869565216
"[0, 1, 0, 0, 1, 0, 0, 1, 1, 1, 1, 1, 1, 0, 0]",259,135,124,11,8,0.08148148148148149,0.06451612903225806
"[0, 1, 0, 0, 0, 1, 0, 0, 0, 1, 0, 1, 0, 0, 1]",246,173,73,13,6,0.07514450867052024,0.0821917808219178
"[1, 1, 0, 0, 1, 1, 0, 0, 0, 1, 1, 0, 0, 0, 0]",324,181,143,15,17,0.08287292817679558,0.11888111888111888
"[0, 1, 1, 1, 1, 1, 0, 0, 1, 1, 0, 0, 0, 1, 1]",215,90,125,8,10,0.08888888888888889,0.08
"[0, 0, 0, 0, 1, 1, 1, 1, 1, 0, 0, 1, 1, 0, 0]",380,224,156,26,14,0.11607142857142858,0.08974358974358974
"[0, 0, 0, 1, 1, 0, 0, 1, 1, 1, 0, 1, 1, 1, 1]",362,223,139,26,14,0.11659192825112108,0.10071942446043165
"[1, 1, 0, 0, 1, 1, 0, 1, 0, 0, 1, 0, 1, 1, 1]",223,104,119,6,14,0.057692307692307696,0.11764705882352941
"[1, 0, 0, 0, 1, 0, 0, 0, 1, 0, 0, 0, 1, 1, 1]",215,117,98,16,8,0.13675213675213677,0.08163265306122448
"[0, 0, 0, 1, 1, 1, 1, 1, 0, 0, 0, 0, 1, 0, 1]",154,88,66,8,8,0.09090909090909091,0.12121212121212122
"[1, 0, 0, 1, 1, 1, 0, 1, 1, 0, 1, 1, 1, 0, 0]",179,67,112,4,4,0.05970149253731343,0.03571428571428571
"[0, 1, 1, 1, 0, 0, 1, 1, 1, 0, 1, 1, 0, 1, 1]",279,110,169,13,18,0.11818181818181818,0.10650887573964497
"[0, 0, 0, 0, 0, 0, 0, 0, 1, 1, 1, 0, 1, 0, 1]",435,289,146,28,8,0.09688581314878893,0.0547945205479452
"[0, 0, 0, 1, 0, 1, 0, 1, 0, 1, 1, 1, 0, 0, 1]",128,75,53,7,6,0.09333333333333334,0.11320754716981132
"[1, 0, 1, 0, 0, 1, 1, 0, 0, 0, 0, 1, 0, 0, 0]",270,198,72,16,6,0.08080808080808081,0.08333333333333333
"[0, 0, 0, 1, 1, 1, 0, 0, 1, 0, 1, 0, 0, 1, 1]",136,78,58,8,4,0.10256410256410256,0.06896551724137931
"[0, 0, 1, 0, 1, 0, 0, 0, 1, 1, 1, 0, 0, 1, 0]",136,76,60,10,5,0.13157894736842105,0.08333333333333333
"[0, 0, 0, 0, 0, 0, 0, 1, 0, 0, 1, 1, 1, 0, 0]",716,544,172,55,17,0.10110294117647059,0.09883720930232558
"[1, 1, 1, 1, 0, 0, 0, 1, 0, 1, 1, 1, 0, 1, 0]",153,59,94,7,9,0.11864406779661017,0.09574468085106383
"[1, 1, 0, 1, 1, 0, 1, 0, 0, 0, 1, 1, 0, 1, 1]",150,59,91,11,6,0.1864406779661017,0.06593406593406594
"[0, 1, 0, 1, 1, 1, 0, 1, 0, 0, 0, 0, 1, 1, 1]",176,87,89,10,8,0.11494252873563218,0.0898876404494382
"[1, 0, 0, 0, 0, 0, 0, 1, 0, 0, 0, 1, 0, 1, 0]",523,358,165,33,16,0.09217877094972067,0.09696969696969697
"[1, 1, 0, 0, 0, 0, 0, 0, 1, 0, 0, 0, 1, 0, 1]",321,207,114,19,5,0.09178743961352658,0.043859649122807015
"[0, 1, 0, 1, 0, 1, 1, 1, 0, 0, 0, 0, 1, 1, 0]",188,96,92,10,5,0.10416666666666667,0.05434782608695652
"[0, 1, 1, 0, 1, 1, 1, 0, 1, 0, 1, 0, 1, 0, 1]",134,59,75,6,7,0.1016949152542373,0.09333333333333334
"[1, 0, 0, 0, 0, 0, 1, 0, 0, 1, 1, 0, 1, 1, 0]",158,84,74,6,4,0.07142857142857142,0.05405405405405406
"[0, 1, 0, 1, 1, 0, 0, 1, 0, 1, 1, 1, 1, 1, 1]",313,119,194,11,16,0.09243697478991597,0.08247422680412371
"[0, 1, 1, 0, 1, 0, 1, 0, 1, 1, 0, 0, 1, 0, 1]",86,44,42,2,5,0.045454545454545456,0.11904761904761904
"[1, 0, 1, 1, 0, 0, 0, 0, 1, 0, 1, 1, 0, 1, 0]",99,47,52,6,4,0.1276595744680851,0.07692307692307693
"[0, 1, 1, 1, 1, 1, 0, 0, 1, 0, 1, 0, 0, 0, 0]",140,72,68,4,3,0.05555555555555555,0.04411764705882353
"[1, 0, 0, 0, 0, 1, 1, 1, 1, 1, 0, 0, 1, 0, 1]",157,48,109,5,10,0.10416666666666667,0.09174311926605505
"[1, 1, 0, 0, 1, 1, 1, 0, 0, 0, 0, 0, 1, 1, 1]",251,129,122,15,15,0.11627906976744186,0.12295081967213115
"[0, 1, 1, 1, 0, 0, 1, 1, 1, 0, 0, 0, 0, 0, 1]",128,68,60,8,9,0.11764705882352941,0.15
"[1, 0, 0, 0, 0, 1, 0, 1, 1, 1, 0, 1, 0, 1, 1]",108,40,68,5,8,0.125,0.11764705882352941
"[0, 0, 1, 0, 0, 0, 0, 1, 0, 1, 1, 1, 0, 1, 0]",137,82,55,7,4,0.08536585365853659,0.07272727272727272
"[1, 0, 0, 0, 1, 0, 1, 0, 1, 1, 0, 1, 1, 0, 0]",105,52,53,4,7,0.07692307692307693,0.1320754716981132
"[0, 1, 0, 0, 1, 0, 1, 1, 0, 1, 1, 1, 0, 0, 1]",125,61,64,4,11,0.06557377049180328,0.171875
"[0, 0, 1, 1, 1, 1, 0, 0, 1, 0, 1, 0, 1, 0, 1]",141,76,65,6,8,0.07894736842105263,0.12307692307692308
"[0, 1, 0, 0, 1, 0, 1, 0, 1, 0, 0, 1, 0, 1, 1]",119,59,60,4,4,0.06779661016949153,0.06666666666666667
"[0, 1, 0, 1, 0, 0, 1, 0, 1, 0, 1, 0, 0, 1, 0]",150,103,47,16,4,0.1553398058252427,0.0851063829787234
"[1, 0, 0, 1, 1, 0, 0, 1, 0, 1, 1, 1, 0, 0, 0]",164,83,81,3,6,0.03614457831325301,0.07407407407407407
"[0, 1, 1, 0, 0, 1, 1, 1, 0, 1, 0, 0, 1, 1, 0]",175,98,77,9,11,0.09183673469387756,0.14285714285714285
"[1, 0, 1, 0, 1, 0, 1, 0, 0, 1, 0, 1, 0, 1, 1]",122,60,62,8,7,0.13333333333333333,0.11290322580645161
"[1, 1, 0, 0, 0, 1, 1, 0, 1, 1, 1, 0, 0, 1, 1]",233,91,142,12,17,0.13186813186813187,0.11971830985915492
"[1, 0, 0, 0, 1, 0, 1, 0, 1, 0, 1, 0, 1, 0, 0]",137,73,64,8,8,0.1095890410958904,0.125
"[1, 1, 0, 0, 0, 1, 0, 1, 0, 1, 0, 1, 0, 1, 0]",110,61,49,8,5,0.13114754098360656,0.10204081632653061
"[1, 1, 0, 0, 1, 0, 0, 1, 1, 1, 0, 0, 0, 0, 0]",240,136,104,12,9,0.08823529411764706,0.08653846153846154
"[1, 1, 1, 0, 0, 1, 0, 0, 1, 1, 1, 0, 0, 0, 0]",192,93,99,13,12,0.13978494623655913,0.12121212121212122
"[1, 1, 0, 1, 1, 1, 0, 0, 1, 0, 0, 1, 1, 1, 0]",141,65,76,10,3,0.15384615384615385,0.039473684210526314
"[0, 0, 0, 1, 0, 0, 1, 0, 1, 1, 0, 1, 1, 1, 0]",117,69,48,3,4,0.043478260869565216,0.08333333333333333
"[0, 1, 0, 1, 0, 0, 0, 0, 0, 0, 1, 0, 0, 1, 1]",304,192,112,18,11,0.09375,0.09821428571428571
"[1, 0, 0, 1, 1, 0, 0, 1, 1, 0, 1, 0, 1, 0, 0]",149,59,90,10,9,0.1694915254237288,0.1
"[0, 1, 0, 0, 0, 1, 0, 0, 1, 0, 0, 0, 1, 0, 0]",488,348,140,31,11,0.08908045977011494,0.07857142857142857
"[0, 0, 1, 0, 0, 0, 1, 0, 0, 1, 0, 0, 0, 1, 0]",485,346,139,39,13,0.11271676300578035,0.09352517985611511
"[0, 1, 1, 0, 1, 1, 1, 1, 0, 1, 1, 1, 1, 0, 0]",306,113,193,10,11,0.08849557522123894,0.05699481865284974
"[0, 0, 0, 0, 1, 1, 0, 0, 1, 1, 0, 0, 1, 0, 1]",431,242,189,26,12,0.10743801652892562,0.06349206349206349
"[0, 1, 0, 1, 0, 1, 1, 1, 0, 1, 1, 1, 1, 0, 0]",205,73,132,7,17,0.0958904109589041,0.12878787878787878
"[1, 1, 0, 0, 0, 0, 0, 1, 0, 0, 1, 0, 1, 1, 0]",160,94,66,5,8,0.05319148936170213,0.12121212121212122
"[1, 1, 1, 1, 0, 0, 0, 0, 0, 1, 0, 0, 1, 0, 1]",160,94,66,8,5,0.0851063829787234,0.07575757575757576
"[0, 0, 0, 1, 1, 0, 0, 1, 0, 0, 0, 1, 1, 0, 1]",154,101,53,6,10,0.0594059405940594,0.18867924528301888
"[1, 0, 0, 1, 1, 0, 0, 1, 1, 1, 0, 0, 0, 0, 0]",318,143,175,16,16,0.11188811188811189,0.09142857142857143
"[0, 1, 0, 0, 1, 1, 1, 0, 1, 1, 1, 0, 1, 1, 0]",145,61,84,4,10,0.06557377049180328,0.11904761904761904
"[1, 1, 1, 1, 1, 0, 0, 0, 0, 1, 1, 1, 0, 0, 1]",344,87,257,13,29,0.14942528735632185,0.11284046692607004
"[1, 1, 1, 1, 0, 1, 1, 0, 0, 1, 1, 1, 1, 0, 1]",627,181,446,20,38,0.11049723756906077,0.08520179372197309
"[0, 1, 0, 0, 0, 0, 0, 0, 0, 1, 1, 1, 0, 0, 1]",305,204,101,20,13,0.09803921568627451,0.12871287128712872
"[1, 1, 0, 0, 0, 0, 1, 0, 0, 1, 0, 1, 0, 0, 0]",278,179,99,17,8,0.09497206703910614,0.08080808080808081
"[0, 1, 1, 1, 0, 0, 0, 0, 1, 0, 0, 1, 0, 1, 0]",143,84,59,10,3,0.11904761904761904,0.05084745762711865
"[1, 0, 1, 1, 1, 0, 0, 0, 0, 1, 0, 0, 1, 0, 1]",113,50,63,7,7,0.14,0.1111111111111111
"[0, 0, 1, 0, 1, 1, 1, 0, 0, 0, 0, 1, 0, 0, 1]",136,85,51,12,5,0.1411764705882353,0.09803921568627451
"[1, 1, 0, 0, 1, 0, 1, 1, 1, 0, 0, 0, 0, 1, 0]",108,48,60,6,7,0.125,0.11666666666666667
"[1, 0, 1, 0, 0, 0, 1, 1, 0, 1, 0, 1, 1, 0, 0]",114,53,61,4,5,0.07547169811320754,0.08196721311475409
"[0, 1, 1, 0, 1, 1, 1, 1, 0, 0, 0, 1, 0, 0, 0]",133,64,69,6,6,0.09375,0.08695652173913043
"[1, 0, 1, 1, 1, 1, 0, 1, 1, 1, 0, 1, 1, 0, 0]",257,86,171,4,16,0.046511627906976744,0.0935672514619883
"[0, 1, 0, 0, 1, 1, 1, 1, 1, 1, 1, 0, 1, 0, 1]",253,105,148,8,8,0.0761904761904762,0.05405405405405406
"[0, 1, 1, 0, 0, 0, 0, 0, 1, 0, 0, 0, 0, 0, 1]",640,488,152,40,9,0.08196721311475409,0.05921052631578947
"[0, 1, 1, 0, 1, 1, 1, 1, 1, 0, 1, 0, 1, 0, 0]",131,50,81,3,5,0.06,0.06172839506172839
"[0, 0, 1, 1, 1, 0, 1, 1, 1, 0, 1, 1, 0, 0, 1]",147,59,88,9,7,0.15254237288135594,0.07954545454545454
"[0, 1, 0, 1, 0, 0, 1, 0, 0, 0, 0, 1, 1, 1, 1]",211,123,88,17,15,0.13821138211382114,0.17045454545454544
"[1, 0, 1, 0, 1, 0, 0, 1, 0, 0, 0, 0, 1, 1, 1]",159,82,77,6,10,0.07317073170731707,0.12987012987012986
"[1, 1, 1, 0, 1, 1, 0, 1, 1, 1, 1, 0, 0, 0, 0]",320,118,202,19,19,0.16101694915254236,0.09405940594059406
"[1, 0, 0, 0, 1, 0, 0, 1, 1, 0, 1, 0, 0, 0, 0]",269,165,104,14,14,0.08484848484848485,0.1346153846153846
"[0, 1, 0, 1, 0, 0, 0, 1, 0, 0, 1, 1, 0, 1, 0]",138,79,59,12,3,0.1518987341772152,0.05084745762711865
"[0, 0, 1, 0, 0, 1, 1, 0, 0, 1, 0, 1, 0, 0, 0]",258,156,102,12,10,0.07692307692307693,0.09803921568627451
"[0, 0, 0, 1, 1, 0, 0, 1, 0, 1, 0, 0, 1, 1, 1]",242,182,60,19,4,0.1043956043956044,0.06666666666666667
"[1, 1, 1, 1, 0, 1, 0, 0, 1, 0, 0, 0, 1, 0, 1]",127,61,66,4,4,0.06557377049180328,0.06060606060606061
"[1, 0, 1, 0, 1, 1, 0, 0, 1, 1, 0, 0, 1, 1, 0]",262,135,127,17,13,0.1259259259259259,0.10236220472440945
"[0, 1, 0, 0, 0, 1, 0, 1, 1, 1, 1, 1, 1, 1, 1]",400,173,227,19,18,0.10982658959537572,0.07929515418502203
"[0, 1, 1, 0, 1, 0, 1, 1, 1, 0, 0, 0, 1, 0, 0]",122,64,58,5,4,0.078125,0.06896551724137931
"[1, 0, 1, 0, 1, 0, 1, 0, 1, 1, 0, 1, 0, 1, 1]",133,47,86,5,8,0.10638297872340426,0.09302325581395349
"[1, 1, 0, 0, 0, 1, 0, 1, 0, 0, 0, 0, 0, 0, 0]",775,527,248,56,26,0.1062618595825427,0.10483870967741936
"[0, 0, 1, 1, 1, 1, 1, 0, 1, 0, 1, 0, 0, 0, 0]",133,64,69,3,5,0.046875,0.07246376811594203
"[1, 0, 1, 0, 1, 1, 1, 1, 1, 0, 1, 1, 1, 1, 0]",549,181,368,20,32,0.11049723756906077,0.08695652173913043
"[1, 1, 1, 1, 1, 0, 1, 1, 0, 0, 1, 0, 1, 0, 1]",249,84,165,8,13,0.09523809523809523,0.07878787878787878
"[1, 0, 0, 1, 1, 0, 1, 1, 0, 0, 1, 0, 0, 0, 1]",110,52,58,4,3,0.07692307692307693,0.05172413793103448
"[0, 0, 1, 1, 1, 1, 0, 0, 1, 0, 0, 1, 1, 0, 1]",155,70,85,4,7,0.05714285714285714,0.08235294117647059
"[1, 1, 0, 1, 0, 1, 0, 1, 1, 0, 0, 1, 0, 1, 0]",110,42,68,3,7,0.07142857142857142,0.10294117647058823
"[0, 0, 0, 1, 0, 1, 0, 0, 0, 1, 1, 1, 1, 1, 0]",141,83,58,8,7,0.0963855421686747,0.1206896551724138
"[1, 1, 0, 0, 1, 1, 0, 0, 1, 1, 0, 1, 0, 0, 0]",222,130,92,17,8,0.13076923076923078,0.08695652173913043
"[1, 1, 1, 0, 0, 1, 1, 0, 0, 1, 1, 0, 1, 0, 0]",202,66,136,5,11,0.07575757575757576,0.08088235294117647
"[0, 1, 1, 1, 0, 1, 0, 0, 1, 0, 1, 0, 0, 1, 1]",102,57,45,8,3,0.14035087719298245,0.06666666666666667
"[0, 0, 0, 1, 1, 0, 0, 0, 1, 1, 0, 1, 0, 0, 0]",288,203,85,22,6,0.10837438423645321,0.07058823529411765
"[1, 0, 0, 0, 1, 0, 1, 1, 0, 0, 1, 0, 1, 0, 1]",109,52,57,5,6,0.09615384615384616,0.10526315789473684
"[0, 0, 1, 1, 0, 0, 1, 1, 0, 1, 1, 0, 1, 1, 0]",158,83,75,5,11,0.060240963855421686,0.14666666666666667
"[1, 1, 0, 0, 0, 1, 0, 1, 0, 1, 0, 0, 1, 1, 1]",179,77,102,9,11,0.11688311688311688,0.10784313725490197
"[0, 1, 1, 0, 0, 1, 1, 0, 1, 0, 0, 0, 0, 0, 0]",383,277,106,37,10,0.13357400722021662,0.09433962264150944
"[0, 0, 1, 0, 1, 1, 0, 1, 0, 1, 0, 0, 1, 1, 0]",114,65,49,9,7,0.13846153846153847,0.14285714285714285
"[0, 0, 0, 1, 1, 0, 1, 1, 0, 0, 1, 0, 1, 1, 1]",155,104,51,13,6,0.125,0.11764705882352941
"[0, 1, 1, 0, 1, 1, 0, 0, 1, 0, 1, 0, 1, 1, 1]",187,92,95,17,10,0.18478260869565216,0.10526315789473684
"[0, 1, 1, 1, 1, 0, 1, 1, 1, 0, 0, 1, 1, 0, 1]",255,94,161,10,19,0.10638297872340426,0.11801242236024845
"[1, 1, 0, 1, 0, 1, 0, 0, 0, 0, 1, 1, 1, 1, 1]",318,128,190,16,13,0.125,0.06842105263157895
"[0, 1, 1, 1, 1, 1, 0, 1, 1, 1, 1, 0, 1, 0, 1]",501,159,342,12,42,0.07547169811320754,0.12280701754385964
"[1, 1, 0, 0, 1, 0, 0, 0, 1, 1, 1, 1, 1, 0, 1]",178,81,97,6,9,0.07407407407407407,0.09278350515463918
"[1, 0, 1, 0, 0, 1, 0, 0, 0, 1, 0, 0, 0, 1, 1]",165,95,70,7,5,0.07368421052631578,0.07142857142857142
"[1, 1, 1, 0, 0, 1, 1, 1, 0, 0, 0, 0, 0, 0, 1]",266,116,150,11,7,0.09482758620689655,0.04666666666666667
"[0, 0, 0, 1, 1, 0, 0, 0, 1, 1, 1, 0, 0, 1, 1]",189,99,90,9,8,0.09090909090909091,0.08888888888888889
"[1, 1, 1, 0, 0, 0, 1, 1, 1, 1, 1, 1, 1, 0, 0]",497,157,340,10,30,0.06369426751592357,0.08823529411764706
"[0, 1, 1, 0, 0, 1, 0, 0, 0, 1, 0, 0, 0, 1, 0]",239,158,81,13,11,0.08227848101265822,0.13580246913580246
"[1, 1, 0, 1, 1, 0, 0, 1, 0, 0, 0, 1, 0, 0, 0]",151,85,66,9,6,0.10588235294117647,0.09090909090909091
"[1, 1, 1, 1, 0, 0, 0, 0, 0, 1, 1, 0, 1, 0, 1]",167,71,96,11,7,0.15492957746478872,0.07291666666666667
"[0, 1, 1, 0, 1, 1, 1, 0, 0, 0, 1, 0, 1, 1, 0]",117,57,60,9,3,0.15789473684210525,0.05
"[1, 0, 1, 1, 0, 0, 0, 0, 0, 0, 1, 0, 0, 0, 1]",278,167,111,14,7,0.08383233532934131,0.06306306306306306
"[1, 1, 0, 1, 0, 1, 1, 1, 1, 1, 0, 0, 0, 0, 1]",263,98,165,7,19,0.07142857142857142,0.11515151515151516
"[0, 1, 1, 0, 1, 1, 1, 0, 1, 0, 0, 1, 0, 0, 1]",112,66,46,6,5,0.09090909090909091,0.10869565217391304
"[1, 1, 0, 1, 0, 1, 0, 1, 0, 1, 0, 0, 0, 1, 1]",121,49,72,6,4,0.12244897959183673,0.05555555555555555
"[0, 0, 1, 1, 1, 1, 0, 1, 0, 1, 0, 1, 0, 1, 0]",120,57,63,4,9,0.07017543859649122,0.14285714285714285
"[0, 1, 1, 0, 0, 0, 0, 1, 0, 0, 1, 1, 0, 0, 1]",215,151,64,10,7,0.06622516556291391,0.109375
"[1, 0, 0, 0, 0, 0, 1, 1, 1, 0, 0, 0, 1, 1, 0]",173,96,77,11,6,0.11458333333333333,0.07792207792207792
"[1, 1, 0, 0, 0, 0, 0, 1, 1, 1, 0, 0, 0, 1, 1]",175,84,91,10,9,0.11904761904761904,0.0989010989010989
"[0, 1, 1, 0, 0, 0, 0, 0, 1, 1, 1, 0, 0, 0, 1]",179,107,72,10,4,0.09345794392523364,0.05555555555555555
"[1, 0, 1, 0, 0, 1, 1, 0, 1, 1, 1, 1, 0, 0, 0]",142,58,84,3,6,0.05172413793103448,0.07142857142857142
"[1, 0, 1, 1, 0, 0, 1, 1, 0, 1, 0, 0, 1, 1, 1]",201,80,121,5,13,0.0625,0.10743801652892562
"[0, 1, 0, 1, 1, 0, 0, 1, 1, 0, 1, 0, 0, 1, 1]",140,69,71,4,3,0.057971014492753624,0.04225352112676056
"[1, 0, 1, 0, 1, 1, 0, 0, 1, 1, 0, 1, 0, 0, 1]",130,61,69,7,8,0.11475409836065574,0.11594202898550725
"[0, 0, 1, 0, 0, 0, 1, 0, 0, 1, 1, 0, 1, 1, 1]",140,67,73,6,7,0.08955223880597014,0.0958904109589041
"[0, 0, 1, 0, 1, 0, 0, 1, 1, 1, 1, 1, 0, 0, 1]",144,62,82,8,10,0.12903225806451613,0.12195121951219512
"[1, 1, 0, 0, 1, 1, 1, 0, 1, 1, 1, 1, 0, 0, 0]",238,94,144,10,14,0.10638297872340426,0.09722222222222222
"[1, 0, 1, 0, 1, 0, 1, 1, 0, 1, 1, 1, 1, 1, 0]",222,76,146,13,18,0.17105263157894737,0.1232876712328767
"[1, 0, 1, 0, 1, 1, 0, 1, 1, 0, 1, 1, 0, 1, 0]",125,48,77,2,3,0.041666666666666664,0.03896103896103896
"[1, 1, 1, 1, 0, 1, 1, 0, 1, 1, 1, 0, 1, 0, 1]",542,163,379,15,29,0.09202453987730061,0.07651715039577836
"[1, 1, 0, 0, 1, 0, 0, 0, 1, 1, 0, 1, 1, 0, 1]",118,58,60,4,6,0.06896551724137931,0.1
"[1, 1, 1, 1, 0, 1, 0, 1, 0, 0, 1, 0, 1, 1, 1]",287,99,188,9,18,0.09090909090909091,0.09574468085106383
"[0, 0, 0, 0, 1, 0, 0, 1, 0, 1, 1, 1, 1, 1, 1]",234,119,115,9,9,0.07563025210084033,0.0782608695652174
"[1, 1, 0, 1, 1, 1, 0, 1, 1, 1, 1, 1, 1, 0, 1]",1448,343,1105,31,111,0.09037900874635568,0.10045248868778281
"[1, 0, 0, 0, 1, 0, 1, 0, 1, 0, 0, 0, 1, 1, 1]",169,85,84,6,12,0.07058823529411765,0.14285714285714285
"[1, 0, 0, 1, 0, 1, 1, 0, 0, 0, 0, 1, 0, 1, 1]",142,75,67,7,6,0.09333333333333334,0.08955223880597014
"[0, 1, 1, 1, 1, 1, 1, 1, 1, 0, 1, 0, 1, 0, 1]",591,224,367,24,24,0.10714285714285714,0.0653950953678474
"[1, 0, 0, 0, 1, 0, 1, 1, 0, 1, 1, 1, 1, 1, 0]",154,66,88,3,9,0.045454545454545456,0.10227272727272728
"[1, 1, 1, 0, 1, 1, 0, 1, 0, 0, 1, 0, 1, 0, 0]",110,49,61,2,7,0.04081632653061224,0.11475409836065574
"[0, 1, 1, 1, 0, 1, 1, 0, 1, 0, 0, 1, 0, 1, 0]",115,46,69,5,8,0.10869565217391304,0.11594202898550725
"[0, 0, 0, 1, 1, 1, 0, 0, 0, 1, 0, 1, 1, 1, 0]",109,57,52,5,9,0.08771929824561403,0.17307692307692307
"[1, 1, 1, 1, 0, 0, 0, 0, 0, 1, 0, 0, 1, 1, 1]",315,149,166,15,21,0.10067114093959731,0.12650602409638553
"[0, 0, 1, 1, 0, 0, 1, 0, 1, 0, 1, 1, 1, 0, 0]",131,68,63,5,8,0.07352941176470588,0.12698412698412698
"[1, 1, 0, 1, 1, 1, 0, 0, 1, 1, 0, 0, 1, 0, 1]",157,60,97,3,11,0.05,0.1134020618556701
"[0, 0, 1, 1, 0, 1, 1, 0, 1, 0, 1, 1, 1, 1, 1]",319,120,199,16,26,0.13333333333333333,0.1306532663316583
"[0, 0, 0, 1, 1, 0, 1, 1, 0, 1, 0, 1, 1, 1, 1]",204,113,91,7,8,0.061946902654867256,0.08791208791208792
"[0, 0, 0, 0, 1, 1, 0, 1, 1, 0, 1, 0, 1, 1, 1]",202,100,102,14,10,0.14,0.09803921568627451
"[1, 0, 1, 0, 1, 1, 0, 0, 0, 0, 0, 0, 0, 0, 1]",434,262,172,27,13,0.10305343511450382,0.0755813953488372
"[1, 1, 0, 0, 1, 0, 1, 0, 0, 0, 0, 0, 0, 1, 0]",241,160,81,11,7,0.06875,0.08641975308641975
"[0, 0, 1, 0, 1, 0, 1, 1, 0, 1, 1, 1, 0, 0, 1]",145,64,81,5,10,0.078125,0.12345679012345678
"[0, 0, 1, 0, 1, 1, 1, 0, 1, 1, 0, 0, 1, 1, 1]",196,77,119,9,7,0.11688311688311688,0.058823529411764705
"[1, 1, 1, 0, 0, 0, 0, 0, 0, 1, 0, 1, 1, 1, 0]",159,65,94,7,11,0.1076923076923077,0.11702127659574468
"[1, 1, 0, 0, 1, 1, 0, 1, 1, 1, 0, 0, 0, 0, 1]",193,86,107,12,8,0.13953488372093023,0.07476635514018691
"[0, 1, 0, 0, 0, 1, 1, 1, 0, 0, 1, 1, 0, 1, 1]",131,65,66,6,9,0.09230769230769231,0.13636363636363635
"[1, 0, 0, 1, 0, 0, 1, 0, 1, 0, 1, 0, 1, 0, 0]",127,82,45,8,4,0.0975609756097561,0.08888888888888889
"[0, 1, 0, 0, 1, 0, 0, 1, 0, 1, 0, 1, 0, 1, 0]",131,80,51,9,3,0.1125,0.058823529411764705
"[1, 0, 1, 0, 0, 1, 1, 0, 1, 0, 0, 0, 1, 1, 1]",128,67,61,8,5,0.11940298507462686,0.08196721311475409
"[0, 0, 0, 0, 1, 0, 1, 1, 1, 0, 0, 0, 0, 0, 1]",296,187,109,23,11,0.12299465240641712,0.10091743119266056
"[1, 1, 1, 0, 0, 0, 1, 0, 1, 0, 0, 0, 0, 0, 1]",185,97,88,14,8,0.14432989690721648,0.09090909090909091
"[0, 0, 0, 0, 0, 1, 1, 1, 0, 1, 1, 0, 1, 0, 0]",155,97,58,6,4,0.061855670103092786,0.06896551724137931
"[0, 0, 0, 0, 0, 0, 1, 1, 1, 0, 1, 1, 0, 1, 0]",170,108,62,12,7,0.1111111111111111,0.11290322580645161
"[0, 0, 1, 1, 1, 0, 0, 0, 1, 0, 0, 1, 0, 0, 0]",266,170,96,14,10,0.08235294117647059,0.10416666666666667
"[1, 0, 1, 0, 1, 0, 1, 1, 1, 0, 0, 1, 1, 1, 0]",158,61,97,7,9,0.11475409836065574,0.09278350515463918
"[0, 1, 1, 1, 0, 0, 1, 1, 1, 1, 0, 1, 0, 1, 0]",165,76,89,5,10,0.06578947368421052,0.11235955056179775
"[0, 0, 0, 1, 1, 0, 1, 0, 0, 1, 0, 0, 1, 1, 1]",195,126,69,12,10,0.09523809523809523,0.14492753623188406
"[0, 0, 1, 0, 0, 0, 0, 1, 1, 0, 1, 1, 0, 0, 1]",187,123,64,9,7,0.07317073170731707,0.109375
"[0, 0, 1, 1, 1, 0, 0, 0, 0, 0, 1, 1, 0, 1, 1]",149,84,65,7,7,0.08333333333333333,0.1076923076923077
"[1, 1, 0, 0, 1, 0, 0, 0, 1, 1, 1, 1, 0, 1, 1]",162,66,96,8,9,0.12121212121212122,0.09375
"[1, 0, 0, 1, 1, 0, 1, 0, 0, 1, 1, 0, 1, 1, 1]",147,50,97,4,6,0.08,0.061855670103092786
"[0, 0, 0, 0, 1, 0, 0, 1, 1, 0, 1, 0, 0, 1, 1]",195,115,80,10,10,0.08695652173913043,0.125
"[1, 0, 1, 1, 0, 0, 0, 1, 0, 0, 1, 1, 0, 0, 1]",140,80,60,7,5,0.0875,0.08333333333333333
"[0, 1, 0, 0, 0, 1, 1, 1, 0, 1, 0, 1, 1, 0, 1]",104,36,68,6,3,0.16666666666666666,0.04411764705882353
"[0, 1, 1, 1, 1, 0, 1, 0, 0, 0, 1, 0, 0, 0, 0]",179,110,69,9,8,0.08181818181818182,0.11594202898550725
"[0, 0, 1, 1, 1, 0, 1, 0, 0, 1, 1, 1, 0, 1, 1]",158,70,88,2,8,0.02857142857142857,0.09090909090909091
"[0, 0, 0, 0, 0, 1, 1, 1, 0, 1, 0, 0, 1, 1, 1]",254,165,89,12,10,0.07272727272727272,0.11235955056179775
"[0, 1, 1, 1, 1, 0, 0, 1, 0, 0, 1, 1, 1, 0, 1]",156,68,88,8,8,0.11764705882352941,0.09090909090909091
"[1, 0, 0, 0, 0, 0, 1, 1, 0, 1, 1, 0, 1, 1, 0]",96,43,53,2,8,0.046511627906976744,0.1509433962264151
"[1, 0, 1, 1, 0, 1, 0, 1, 0, 1, 0, 1, 0, 1, 0]",110,50,60,6,6,0.12,0.1
"[1, 1, 1, 1, 0, 0, 0, 0, 1, 0, 1, 0, 1, 1, 0]",147,69,78,6,8,0.08695652173913043,0.10256410256410256
"[1, 0, 1, 0, 0, 0, 0, 1, 0, 1, 1, 0, 1, 0, 0]",129,73,56,10,5,0.136986301369863,0.08928571428571429
"[0, 0, 1, 1, 0, 0, 0, 1, 0, 0, 1, 1, 1, 0, 0]",180,108,72,11,9,0.10185185185185185,0.125
"[1, 1, 0, 1, 1, 1, 1, 0, 0, 1, 0, 0, 0, 0, 0]",167,85,82,9,9,0.10588235294117647,0.10975609756097561
"[1, 0, 0, 0, 1, 1, 0, 0, 0, 1, 1, 1, 0, 0, 0]",182,102,80,8,8,0.0784313725490196,0.1
"[1, 0, 1, 1, 1, 1, 0, 1, 0, 1, 1, 0, 1, 0, 0]",128,47,81,5,7,0.10638297872340426,0.08641975308641975
"[0, 1, 0, 0, 1, 1, 1, 0, 1, 0, 1, 1, 0, 0, 1]",104,48,56,2,5,0.041666666666666664,0.08928571428571429
"[0, 1, 0, 0, 0, 0, 1, 1, 0, 0, 1, 0, 1, 0, 0]",257,181,76,17,7,0.09392265193370165,0.09210526315789473
"[1, 0, 1, 1, 0, 0, 1, 0, 0, 0, 0, 1, 1, 1, 0]",108,65,43,7,4,0.1076923076923077,0.09302325581395349
"[0, 0, 0, 0, 1, 1, 1, 0, 1, 0, 1, 1, 0, 0, 1]",154,78,76,9,8,0.11538461538461539,0.10526315789473684
"[0, 0, 1, 0, 1, 1, 0, 1, 1, 1, 0, 1, 0, 0, 1]",93,46,47,1,2,0.021739130434782608,0.0425531914893617
"[0, 1, 1, 0, 1, 0, 1, 1, 0, 1, 1, 0, 1, 1, 1]",239,90,149,8,17,0.08888888888888889,0.11409395973154363
"[1, 0, 0, 1, 1, 0, 0, 1, 1, 1, 0, 1, 1, 0, 1]",176,51,125,5,11,0.09803921568627451,0.088
"[0, 1, 0, 1, 0, 0, 0, 0, 0, 1, 0, 1, 1, 0, 0]",253,172,81,17,6,0.09883720930232558,0.07407407407407407
"[1, 0, 1, 0, 0, 0, 0, 1, 1, 0, 1, 1, 0, 0, 1]",143,75,68,8,5,0.10666666666666667,0.07352941176470588
"[0, 0, 1, 1, 1, 0, 1, 0, 0, 0, 0, 1, 1, 0, 1]",107,53,54,5,8,0.09433962264150944,0.14814814814814814
"[1, 0, 1, 0, 0, 1, 1, 1, 0, 1, 0, 0, 0, 0, 1]",133,70,63,3,11,0.04285714285714286,0.1746031746031746
"[0, 0, 0, 1, 0, 1, 0, 0, 1, 1, 1, 0, 1, 0, 0]",137,77,60,8,5,0.1038961038961039,0.08333333333333333
"[1, 1, 0, 0, 0, 0, 0, 0, 1, 0, 1, 1, 1, 0, 0]",209,127,82,12,10,0.09448818897637795,0.12195121951219512
"[1, 1, 0, 0, 1, 1, 1, 0, 1, 0, 1, 1, 0, 0, 1]",225,96,129,6,12,0.0625,0.09302325581395349
"[1, 0, 1, 0, 0, 0, 0, 1, 1, 0, 1, 0, 1, 0, 0]",157,96,61,14,8,0.14583333333333334,0.13114754098360656
"[1, 1, 0, 1, 0, 0, 0, 0, 1, 1, 0, 1, 0, 1, 0]",100,56,44,7,5,0.125,0.11363636363636363
"[1, 1, 0, 0, 0, 1, 1, 1, 1, 0, 0, 1, 0, 0, 1]",133,60,73,7,10,0.11666666666666667,0.136986301369863
"[0, 1, 0, 1, 1, 1, 1, 0, 1, 0, 1, 1, 1, 1, 0]",249,89,160,13,13,0.14606741573033707,0.08125
"[1, 0, 1, 1, 1, 0, 1, 1, 0, 0, 0, 0, 0, 1, 0]",101,52,49,8,3,0.15384615384615385,0.061224489795918366
"[1, 0, 0, 1, 0, 1, 0, 1, 0, 1, 1, 1, 0, 1, 1]",135,57,78,4,11,0.07017543859649122,0.14102564102564102
"[1, 0, 0, 0, 1, 0, 0, 0, 0, 1, 0, 0, 0, 1, 1]",323,206,117,21,9,0.10194174757281553,0.07692307692307693
"[0, 0, 1, 0, 1, 0, 0, 0, 1, 0, 1, 0, 1, 0, 1]",121,66,55,9,5,0.13636363636363635,0.09090909090909091
"[0, 1, 1, 0, 0, 1, 0, 0, 1, 0, 1, 1, 0, 0, 1]",135,70,65,5,11,0.07142857142857142,0.16923076923076924
"[1, 0, 1, 1, 1, 0, 0, 0, 1, 1, 1, 1, 1, 1, 0]",358,126,232,8,25,0.06349206349206349,0.10775862068965517
"[0, 0, 1, 0, 0, 0, 1, 1, 1, 0, 1, 0, 0, 0, 0]",229,145,84,14,8,0.09655172413793103,0.09523809523809523
"[1, 1, 1, 0, 0, 1, 0, 0, 1, 1, 0, 0, 0, 0, 0]",255,135,120,13,7,0.0962962962962963,0.058333333333333334
"[0, 0, 1, 1, 0, 0, 0, 0, 1, 0, 1, 0, 0, 1, 0]",276,190,86,17,6,0.08947368421052632,0.06976744186046512
"[0, 0, 1, 0, 0, 0, 1, 0, 1, 1, 0, 0, 0, 0, 1]",285,192,93,17,7,0.08854166666666667,0.07526881720430108
"[1, 1, 0, 0, 1, 0, 1, 0, 1, 0, 0, 0, 0, 0, 1]",169,106,63,6,6,0.05660377358490566,0.09523809523809523
"[0, 1, 0, 1, 1, 1, 1, 1, 0, 1, 1, 1, 1, 1, 0]",575,180,395,22,34,0.12222222222222222,0.08607594936708861
"[1, 1, 0, 0, 0, 1, 1, 1, 1, 1, 1, 0, 0, 0, 0]",520,220,300,20,19,0.09090909090909091,0.06333333333333334
"[1, 0, 1, 1, 1, 1, 1, 1, 0, 0, 1, 0, 1, 1, 1]",602,172,430,9,41,0.05232558139534884,0.09534883720930233
"[1, 0, 1, 0, 0, 0, 1, 1, 1, 0, 0, 1, 0, 1, 1]",114,53,61,5,2,0.09433962264150944,0.03278688524590164
"[0, 1, 1, 0, 1, 0, 0, 0, 1, 1, 1, 0, 0, 1, 0]",117,58,59,6,6,0.10344827586206896,0.1016949152542373
"[0, 1, 1, 1, 1, 1, 0, 1, 0, 0, 0, 0, 1, 0, 0]",125,56,69,4,6,0.07142857142857142,0.08695652173913043
"[1, 0, 0, 1, 1, 1, 1, 1, 1, 0, 0, 0, 0, 0, 1]",360,88,272,6,31,0.06818181818181818,0.11397058823529412
"[0, 0, 0, 0, 0, 1, 0, 1, 0, 1, 0, 0, 1, 1, 0]",263,183,80,20,8,0.1092896174863388,0.1
"[1, 1, 0, 0, 1, 0, 1, 0, 1, 0, 0, 0, 1, 0, 1]",100,56,44,3,3,0.05357142857142857,0.06818181818181818
"[0, 0, 1, 1, 0, 0, 1, 0, 1, 0, 1, 0, 0, 0, 1]",156,92,64,7,11,0.07608695652173914,0.171875
"[1, 1, 1, 0, 1, 0, 1, 1, 1, 0, 1, 1, 0, 1, 1]",526,161,365,19,33,0.11801242236024845,0.09041095890410959
"[0, 0, 1, 1, 1, 0, 1, 0, 1, 1, 1, 0, 1, 1, 0]",123,53,70,6,9,0.11320754716981132,0.12857142857142856
"[1, 0, 0, 1, 0, 0, 1, 0, 1, 1, 1, 1, 1, 1, 1]",377,121,256,11,32,0.09090909090909091,0.125
"[1, 0, 0, 1, 1, 0, 0, 0, 1, 0, 1, 1, 1, 0, 1]",133,59,74,7,4,0.11864406779661017,0.05405405405405406
"[0, 0, 1, 0, 0, 0, 0, 1, 0, 0, 0, 0, 1, 1, 1]",507,345,162,38,18,0.11014492753623188,0.1111111111111111
"[1, 0, 1, 1, 0, 0, 0, 0, 1, 1, 0, 1, 0, 1, 1]",123,64,59,2,7,0.03125,0.11864406779661017
"[1, 0, 0, 1, 0, 1, 1, 0, 0, 0, 0, 1, 1, 0, 1]",134,76,58,7,5,0.09210526315789473,0.08620689655172414
"[1, 0, 0, 1, 1, 1, 1, 1, 1, 0, 0, 1, 0, 0, 1]",312,70,242,7,27,0.1,0.1115702479338843
"[0, 1, 0, 0, 0, 0, 0, 1, 0, 0, 1, 1, 0, 0, 1]",342,232,110,23,7,0.09913793103448276,0.06363636363636363
"[1, 0, 1, 0, 0, 0, 1, 0, 0, 0, 1, 0, 0, 1, 1]",158,97,61,6,7,0.061855670103092786,0.11475409836065574
"[0, 1, 0, 1, 0, 0, 0, 1, 0, 0, 0, 1, 0, 0, 1]",230,150,80,9,12,0.06,0.15
"[0, 1, 0, 1, 1, 0, 0, 1, 0, 0, 0, 0, 1, 1, 0]",179,118,61,12,9,0.1016949152542373,0.14754098360655737
"[0, 0, 0, 1, 1, 1, 0, 1, 0, 0, 1, 0, 0, 1, 1]",134,75,59,3,2,0.04,0.03389830508474576
"[1, 0, 0, 1, 0, 1, 1, 0, 0, 0, 0, 0, 1, 1, 0]",173,100,73,10,5,0.1,0.0684931506849315
"[1, 0, 0, 1, 0, 0, 1, 0, 1, 1, 0, 0, 0, 0, 0]",312,189,123,15,9,0.07936507936507936,0.07317073170731707
"[1, 0, 1, 0, 1, 1, 1, 0, 0, 1, 0, 0, 1, 0, 1]",107,48,59,3,7,0.0625,0.11864406779661017
"[0, 1, 0, 1, 0, 1, 1, 1, 0, 0, 1, 0, 0, 1, 0]",112,58,54,4,3,0.06896551724137931,0.05555555555555555
"[1, 1, 0, 1, 1, 1, 1, 0, 1, 0, 0, 1, 1, 1, 0]",237,79,158,8,11,0.10126582278481013,0.06962025316455696
"[0, 1, 1, 0, 1, 1, 1, 1, 0, 1, 0, 0, 1, 1, 1]",295,110,185,6,15,0.05454545454545454,0.08108108108108109
"[0, 0, 1, 1, 0, 0, 0, 1, 1, 0, 0, 0, 1, 0, 0]",266,174,92,12,12,0.06896551724137931,0.13043478260869565
"[0, 0, 0, 1, 1, 0, 0, 0, 1, 1, 0, 0, 0, 1, 0]",274,190,84,15,15,0.07894736842105263,0.17857142857142858
"[0, 0, 0, 1, 1, 1, 1, 1, 0, 0, 0, 0, 1, 1, 0]",334,190,144,17,11,0.08947368421052632,0.0763888888888889
"[1, 0, 1, 1, 1, 1, 0, 0, 0, 1, 0, 0, 1, 1, 0]",113,51,62,6,5,0.11764705882352941,0.08064516129032258
"[0, 1, 0, 1, 1, 1, 1, 0, 0, 0, 1, 0, 0, 1, 1]",132,58,74,2,8,0.034482758620689655,0.10810810810810811
"[0, 1, 1, 0, 1, 1, 0, 0, 0, 0, 1, 0, 1, 1, 1]",153,84,69,14,4,0.16666666666666666,0.057971014492753624
"[0, 1, 0, 1, 1, 1, 1, 0, 1, 0, 1, 0, 0, 1, 1]",146,68,78,7,9,0.10294117647058823,0.11538461538461539
"[1, 1, 0, 0, 1, 0, 1, 0, 1, 0, 1, 0, 0, 1, 1]",129,73,56,10,7,0.136986301369863,0.125
"[0, 1, 0, 1, 1, 0, 1, 0, 0, 0, 1, 0, 0, 0, 0]",244,159,85,18,4,0.11320754716981132,0.047058823529411764
"[1, 0, 1, 1, 1, 0, 1, 1, 0, 0, 0, 1, 0, 1, 0]",99,41,58,3,10,0.07317073170731707,0.1724137931034483
"[0, 0, 1, 1, 1, 0, 0, 1, 1, 1, 1, 0, 0, 0, 1]",184,107,77,6,14,0.056074766355140186,0.18181818181818182
"[0, 0, 1, 1, 1, 0, 0, 0, 1, 1, 0, 1, 0, 0, 0]",149,83,66,8,7,0.0963855421686747,0.10606060606060606
"[0, 0, 0, 1, 1, 1, 0, 0, 0, 1, 1, 0, 1, 0, 0]",142,91,51,2,4,0.02197802197802198,0.0784313725490196
"[0, 0, 0, 0, 1, 0, 1, 0, 0, 0, 0, 1, 1, 1, 0]",268,161,107,17,14,0.10559006211180125,0.1308411214953271
"[0, 1, 0, 0, 1, 0, 0, 0, 0, 1, 1, 1, 1, 1, 0]",126,83,43,6,10,0.07228915662650602,0.23255813953488372
"[1, 0, 0, 0, 0, 0, 0, 1, 1, 1, 1, 0, 0, 1, 0]",379,129,250,13,22,0.10077519379844961,0.088
"[1, 1, 1, 0, 0, 1, 0, 0, 1, 0, 0, 1, 0, 0, 1]",101,53,48,2,1,0.03773584905660377,0.020833333333333332
"[1, 0, 0, 1, 0, 0, 0, 0, 1, 0, 1, 1, 1, 1, 1]",191,99,92,12,6,0.12121212121212122,0.06521739130434782
"[0, 0, 1, 0, 0, 1, 1, 1, 1, 0, 1, 0, 0, 0, 0]",172,91,81,10,8,0.10989010989010989,0.09876543209876543
"[0, 1, 0, 0, 0, 1, 1, 0, 1, 0, 1, 1, 1, 1, 1]",193,90,103,8,4,0.08888888888888889,0.038834951456310676
"[1, 1, 1, 1, 0, 0, 0, 1, 0, 0, 1, 1, 0, 1, 0]",115,63,52,6,4,0.09523809523809523,0.07692307692307693
"[1, 0, 1, 1, 1, 1, 1, 0, 0, 0, 1, 0, 0, 1, 1]",172,84,88,9,8,0.10714285714285714,0.09090909090909091
"[0, 1, 0, 0, 1, 0, 1, 1, 1, 1, 0, 0, 0, 0, 0]",244,162,82,19,5,0.11728395061728394,0.06097560975609756
"[0, 1, 1, 0, 1, 0, 1, 0, 1, 1, 1, 0, 1, 1, 1]",260,106,154,7,10,0.0660377358490566,0.06493506493506493
"[1, 0, 0, 1, 1, 0, 1, 0, 1, 0, 1, 1, 1, 0, 1]",125,43,82,6,7,0.13953488372093023,0.08536585365853659
"[0, 1, 1, 0, 0, 0, 1, 1, 0, 1, 1, 0, 1, 0, 0]",116,76,40,8,3,0.10526315789473684,0.075
"[1, 0, 0, 1, 1, 1, 1, 0, 0, 1, 0, 1, 1, 0, 1]",198,60,138,9,7,0.15,0.050724637681159424
"[1, 0, 1, 1, 1, 0, 0, 0, 0, 1, 0, 1, 1, 0, 0]",122,63,59,6,7,0.09523809523809523,0.11864406779661017
"[0, 1, 1, 1, 0, 1, 1, 0, 1, 0, 0, 1, 1, 1, 1]",321,130,191,8,14,0.06153846153846154,0.07329842931937172
"[0, 1, 1, 0, 0, 1, 0, 1, 0, 1, 1, 1, 0, 0, 1]",137,70,67,4,7,0.05714285714285714,0.1044776119402985
"[0, 0, 1, 0, 1, 0, 1, 1, 1, 0, 0, 0, 0, 0, 1]",167,89,78,4,10,0.0449438202247191,0.1282051282051282
"[0, 1, 1, 0, 0, 1, 1, 0, 0, 1, 0, 0, 1, 1, 1]",329,233,96,28,6,0.12017167381974249,0.0625
"[1, 0, 0, 0, 0, 0, 0, 1, 0, 0, 1, 1, 0, 1, 1]",201,103,98,11,8,0.10679611650485436,0.08163265306122448
"[1, 0, 0, 0, 1, 1, 0, 1, 0, 0, 0, 1, 0, 1, 1]",101,46,55,5,5,0.10869565217391304,0.09090909090909091
"[0, 1, 0, 0, 1, 1, 0, 0, 0, 0, 1, 1, 1, 1, 0]",412,232,180,18,14,0.07758620689655173,0.07777777777777778
"[0, 0, 1, 1, 1, 0, 1, 1, 1, 0, 1, 0, 0, 1, 1]",188,82,106,3,12,0.036585365853658534,0.11320754716981132
"[0, 0, 1, 0, 1, 1, 0, 1, 0, 1, 0, 1, 0, 1, 0]",130,73,57,5,3,0.0684931506849315,0.05263157894736842
"[0, 1, 1, 1, 0, 1, 1, 0, 0, 1, 0, 1, 1, 0, 1]",134,48,86,5,8,0.10416666666666667,0.09302325581395349
"[1, 1, 0, 1, 1, 1, 1, 0, 1, 0, 1, 1, 1, 0, 1]",508,141,367,13,38,0.09219858156028368,0.10354223433242507
"[1, 1, 1, 0, 1, 1, 0, 0, 0, 0, 1, 0, 0, 0, 1]",134,76,58,8,8,0.10526315789473684,0.13793103448275862
"[0, 1, 1, 0, 0, 1, 1, 1, 0, 0, 1, 1, 1, 1, 0]",226,109,117,3,12,0.027522935779816515,0.10256410256410256
"[1, 1, 1, 1, 0, 0, 1, 0, 1, 1, 1, 0, 1, 0, 1]",258,88,170,5,22,0.056818181818181816,0.12941176470588237
"[0, 1, 1, 1, 0, 0, 1, 1, 1, 0, 0, 0, 0, 1, 1]",230,113,117,15,14,0.13274336283185842,0.11965811965811966
"[0, 0, 1, 1, 0, 0, 0, 1, 1, 1, 1, 0, 0, 0, 1]",160,89,71,7,5,0.07865168539325842,0.07042253521126761
"[0, 1, 1, 0, 1, 0, 0, 1, 1, 1, 0, 0, 0, 1, 0]",101,57,44,3,2,0.05263157894736842,0.045454545454545456
"[0, 1, 1, 0, 1, 0, 0, 0, 1, 1, 0, 1, 0, 0, 1]",116,55,61,5,3,0.09090909090909091,0.04918032786885246
"[0, 0, 0, 1, 1, 1, 0, 0, 0, 1, 1, 1, 0, 0, 1]",136,77,59,8,8,0.1038961038961039,0.13559322033898305
"[0, 0, 1, 0, 1, 0, 0, 1, 0, 0, 0, 1, 0, 1, 0]",199,128,71,9,5,0.0703125,0.07042253521126761
"[1, 1, 0, 1, 1, 1, 0, 0, 0, 0, 0, 1, 0, 1, 1]",126,42,84,4,16,0.09523809523809523,0.19047619047619047
"[0, 0, 1, 0, 0, 0, 1, 1, 0, 0, 0, 0, 1, 0, 1]",280,179,101,22,7,0.12290502793296089,0.06930693069306931
"[1, 1, 0, 1, 1, 0, 1, 0, 1, 1, 0, 1, 1, 0, 0]",180,63,117,4,7,0.06349206349206349,0.05982905982905983
"[1, 1, 0, 1, 0, 0, 1, 1, 0, 1, 1, 0, 0, 0, 1]",110,40,70,3,4,0.075,0.05714285714285714
"[0, 1, 0, 0, 0, 1, 1, 1, 1, 1, 1, 0, 0, 0, 0]",467,256,211,28,20,0.109375,0.0947867298578199
"[0, 1, 0, 0, 0, 1, 0, 1, 0, 0, 0, 0, 1, 1, 0]",310,210,100,15,12,0.07142857142857142,0.12
"[1, 0, 1, 0, 0, 0, 1, 1, 0, 0, 0, 1, 0, 1, 0]",107,71,36,8,4,0.11267605633802817,0.1111111111111111
"[0, 1, 1, 0, 1, 0, 1, 1, 0, 1, 0, 1, 1, 0, 0]",122,51,71,3,4,0.058823529411764705,0.056338028169014086
"[1, 1, 0, 0, 1, 1, 0, 1, 0, 1, 1, 0, 1, 0, 1]",137,54,83,3,7,0.05555555555555555,0.08433734939759036
"[1, 1, 1, 0, 0, 0, 0, 0, 0, 1, 0, 0, 1, 0, 1]",192,80,112,5,12,0.0625,0.10714285714285714
"[0, 1, 0, 1, 1, 0, 0, 1, 1, 0, 0, 0, 1, 0, 0]",163,98,65,11,4,0.11224489795918367,0.06153846153846154
"[1, 1, 0, 1, 0, 1, 0, 1, 1, 0, 0, 0, 0, 1, 0]",125,69,56,4,1,0.057971014492753624,0.017857142857142856
"[1, 0, 0, 0, 1, 1, 0, 0, 0, 1, 1, 0, 1, 1, 1]",149,63,86,3,8,0.047619047619047616,0.09302325581395349
"[1, 1, 1, 1, 0, 0, 1, 0, 1, 0, 0, 0, 0, 0, 0]",285,162,123,14,10,0.08641975308641975,0.08130081300813008
"[1, 0, 0, 0, 1, 0, 0, 0, 1, 0, 0, 0, 1, 1, 0]",264,170,94,21,9,0.12352941176470589,0.09574468085106383
"[1, 0, 0, 1, 0, 0, 0, 0, 0, 1, 1, 0, 1, 1, 1]",138,80,58,8,6,0.1,0.10344827586206896
"[1, 0, 0, 1, 1, 1, 1, 0, 1, 1, 1, 0, 0, 1, 0]",147,65,82,6,7,0.09230769230769231,0.08536585365853659
"[0, 1, 0, 1, 1, 1, 1, 0, 1, 1, 1, 0, 0, 1, 0]",124,47,77,4,9,0.0851063829787234,0.11688311688311688
"[1, 0, 1, 1, 1, 1, 0, 0, 1, 1, 1, 1, 0, 0, 0]",466,200,266,25,30,0.125,0.11278195488721804
"[1, 0, 1, 1, 1, 1, 1, 0, 1, 0, 1, 0, 0, 0, 1]",148,48,100,3,6,0.0625,0.06
"[1, 1, 0, 0, 0, 1, 1, 0, 1, 0, 0, 1, 1, 0, 1]",104,48,56,7,6,0.14583333333333334,0.10714285714285714
"[1, 1, 1, 1, 0, 0, 1, 0, 0, 1, 0, 1, 0, 1, 1]",184,62,122,6,6,0.0967741935483871,0.04918032786885246
"[0, 1, 1, 1, 1, 1, 0, 1, 1, 1, 1, 0, 0, 1, 0]",246,86,160,9,9,0.10465116279069768,0.05625
"[0, 0, 1, 0, 0, 0, 1, 1, 0, 0, 0, 1, 1, 0, 0]",352,234,118,20,12,0.08547008547008547,0.1016949152542373
"[0, 0, 0, 1, 0, 0, 0, 1, 1, 0, 0, 0, 1, 1, 0]",305,190,115,9,11,0.04736842105263158,0.09565217391304348
"[1, 1, 0, 0, 1, 0, 0, 0, 1, 0, 0, 1, 1, 1, 0]",104,52,52,4,7,0.07692307692307693,0.1346153846153846
"[1, 0, 1, 1, 0, 0, 1, 1, 0, 0, 1, 0, 0, 0, 1]",125,71,54,7,4,0.09859154929577464,0.07407407407407407
"[0, 0, 0, 0, 0, 1, 1, 1, 1, 1, 0, 1, 0, 0, 1]",180,126,54,10,9,0.07936507936507936,0.16666666666666666
"[0, 1, 1, 0, 1, 1, 1, 1, 0, 1, 0, 0, 1, 0, 0]",114,59,55,3,5,0.05084745762711865,0.09090909090909091
"[0, 0, 0, 0, 0, 0, 0, 1, 1, 0, 1, 1, 0, 1, 1]",280,207,73,26,6,0.12560386473429952,0.0821917808219178
"[1, 1, 0, 0, 1, 1, 1, 0, 0, 1, 1, 1, 0, 0, 0]",180,85,95,7,12,0.08235294117647059,0.12631578947368421
"[0, 1, 1, 0, 0, 1, 0, 0, 0, 0, 1, 1, 1, 1, 0]",234,133,101,12,9,0.09022556390977443,0.0891089108910891
"[0, 1, 0, 1, 0, 0, 0, 1, 1, 1, 0, 0, 1, 1, 0]",133,68,65,9,3,0.1323529411764706,0.046153846153846156
"[0, 0, 1, 0, 1, 0, 0, 0, 1, 1, 1, 0, 0, 1, 1]",161,93,68,6,12,0.06451612903225806,0.17647058823529413
"[0, 1, 0, 1, 0, 0, 1, 0, 1, 1, 0, 0, 1, 1, 0]",147,91,56,1,7,0.01098901098901099,0.125
"[1, 1, 0, 1, 0, 1, 0, 0, 1, 0, 1, 0, 0, 1, 0]",89,43,46,3,2,0.06976744186046512,0.043478260869565216
"[0, 1, 1, 0, 1, 0, 1, 0, 0, 1, 0, 1, 0, 0, 1]",101,59,42,3,4,0.05084745762711865,0.09523809523809523
"[1, 0, 1, 1, 0, 1, 1, 0, 0, 0, 0, 0, 1, 1, 0]",135,70,65,6,2,0.08571428571428572,0.03076923076923077
"[1, 0, 1, 1, 1, 1, 0, 0, 0, 1, 0, 1, 1, 1, 0]",130,53,77,5,5,0.09433962264150944,0.06493506493506493
"[0, 1, 0, 1, 1, 1, 1, 0, 0, 0, 1, 0, 1, 1, 1]",159,59,100,6,10,0.1016949152542373,0.1
"[0, 1, 1, 1, 0, 0, 1, 1, 0, 0, 0, 0, 1, 1, 0]",384,201,183,29,25,0.14427860696517414,0.1366120218579235
"[0, 0, 1, 0, 1, 1, 0, 0, 0, 1, 0, 1, 0, 1, 1]",124,58,66,2,3,0.034482758620689655,0.045454545454545456
"[1, 0, 0, 1, 0, 1, 1, 0, 0, 0, 1, 0, 1, 0, 1]",101,60,41,6,3,0.1,0.07317073170731707
"[0, 1, 0, 1, 0, 1, 1, 0, 1, 1, 0, 1, 0, 1, 0]",97,44,53,7,5,0.1590909090909091,0.09433962264150944
"[1, 0, 0, 1, 1, 1, 0, 1, 0, 1, 0, 1, 0, 1, 1]",153,57,96,4,8,0.07017543859649122,0.08333333333333333
"[1, 0, 0, 1, 1, 1, 0, 1, 1, 1, 0, 0, 0, 0, 0]",195,100,95,14,7,0.14,0.07368421052631578
"[0, 0, 1, 0, 0, 0, 1, 1, 1, 0, 1, 0, 0, 1, 0]",129,68,61,4,6,0.058823529411764705,0.09836065573770492
"[1, 1, 1, 0, 0, 1, 1, 1, 1, 0, 0, 1, 0, 0, 0]",208,59,149,5,9,0.0847457627118644,0.06040268456375839
"[0, 1, 1, 1, 0, 0, 1, 0, 1, 0, 0, 1, 1, 1, 0]",96,45,51,1,6,0.022222222222222223,0.11764705882352941
"[0, 1, 0, 1, 0, 1, 0, 1, 1, 1, 1, 1, 1, 0, 1]",231,83,148,12,14,0.14457831325301204,0.0945945945945946
"[1, 1, 0, 0, 1, 1, 0, 1, 0, 1, 0, 1, 0, 1, 1]",168,78,90,4,8,0.05128205128205128,0.08888888888888889
"[0, 1, 1, 0, 1, 1, 1, 1, 1, 0, 1, 1, 1, 0, 0]",254,88,166,11,15,0.125,0.09036144578313253
"[1, 1, 0, 1, 1, 1, 0, 1, 0, 0, 1, 0, 0, 0, 1]",100,42,58,6,6,0.14285714285714285,0.10344827586206896
"[1, 1, 1, 0, 0, 0, 0, 1, 1, 0, 1, 1, 0, 0, 0]",198,80,118,6,12,0.075,0.1016949152542373
"[0, 1, 0, 1, 1, 1, 1, 1, 0, 0, 0, 0, 1, 0, 1]",124,56,68,5,5,0.08928571428571429,0.07352941176470588
"[1, 0, 0, 1, 1, 0, 0, 1, 1, 1, 0, 1, 1, 0, 0]",160,56,104,5,10,0.08928571428571429,0.09615384615384616
"[0, 0, 0, 1, 1, 0, 1, 1, 0, 1, 1, 0, 1, 1, 1]",186,86,100,8,7,0.09302325581395349,0.07
"[0, 1, 0, 0, 0, 1, 0, 1, 0, 0, 1, 1, 1, 1, 1]",169,89,80,7,12,0.07865168539325842,0.15
"[1, 1, 0, 0, 0, 1, 0, 0, 0, 0, 0, 1, 0, 1, 0]",226,133,93,14,8,0.10526315789473684,0.08602150537634409
"[1, 1, 1, 0, 0, 1, 0, 1, 0, 1, 0, 0, 1, 1, 0]",145,68,77,9,7,0.1323529411764706,0.09090909090909091
"[1, 1, 1, 0, 1, 1, 0, 1, 1, 1, 0, 1, 0, 0, 0]",152,60,92,6,12,0.1,0.13043478260869565
"[0, 0, 1, 0, 0, 1, 0, 1, 0, 1, 1, 1, 1, 0, 0]",150,83,67,6,4,0.07228915662650602,0.05970149253731343
"[1, 1, 1, 0, 0, 1, 1, 0, 0, 0, 1, 1, 1, 0, 0]",183,68,115,6,10,0.08823529411764706,0.08695652173913043
"[1, 1, 0, 0, 1, 0, 1, 1, 0, 0, 1, 1, 0, 1, 1]",163,66,97,3,11,0.045454545454545456,0.1134020618556701
"[1, 1, 0, 1, 0, 1, 0, 1, 1, 1, 1, 0, 1, 0, 1]",239,86,153,9,13,0.10465116279069768,0.08496732026143791
"[0, 1, 0, 1, 0, 1, 1, 1, 0, 0, 1, 1, 1, 0, 1]",160,58,102,6,11,0.10344827586206896,0.10784313725490197
"[1, 1, 1, 0, 1, 1, 1, 0, 1, 0, 0, 1, 0, 1, 1]",248,92,156,7,17,0.07608695652173914,0.10897435897435898
"[1, 0, 1, 0, 0, 1, 0, 1, 1, 1, 0, 0, 1, 1, 0]",149,75,74,12,8,0.16,0.10810810810810811
"[0, 1, 0, 0, 1, 0, 1, 0, 0, 0, 1, 0, 0, 1, 0]",232,148,84,16,10,0.10810810810810811,0.11904761904761904
"[1, 1, 1, 0, 1, 1, 0, 1, 0, 1, 0, 0, 1, 0, 1]",121,42,79,4,10,0.09523809523809523,0.12658227848101267
"[1, 1, 0, 1, 0, 0, 1, 1, 1, 0, 0, 0, 0, 1, 1]",198,98,100,6,11,0.061224489795918366,0.11
"[0, 1, 1, 0, 1, 1, 0, 1, 0, 0, 1, 1, 1, 0, 1]",124,54,70,3,2,0.05555555555555555,0.02857142857142857
"[1, 0, 0, 1, 1, 0, 1, 1, 0, 1, 0, 0, 1, 1, 1]",191,70,121,3,9,0.04285714285714286,0.0743801652892562
"[0, 1, 0, 1, 1, 0, 0, 1, 1, 0, 1, 0, 1, 1, 1]",174,71,103,6,7,0.08450704225352113,0.06796116504854369
"[0, 0, 0, 1, 0, 0, 1, 1, 0, 1, 1, 0, 1, 0, 0]",149,89,60,12,8,0.1348314606741573,0.13333333333333333
"[0, 1, 0, 1, 0, 1, 0, 1, 0, 1, 0, 1, 1, 0, 1]",104,47,57,3,5,0.06382978723404255,0.08771929824561403
"[0, 0, 1, 0, 1, 0, 1, 0, 1, 0, 1, 0, 1, 1, 0]",118,55,63,8,5,0.14545454545454545,0.07936507936507936
"[1, 0, 1, 0, 0, 0, 0, 0, 1, 0, 1, 1, 1, 0, 0]",159,98,61,11,3,0.11224489795918367,0.04918032786885246
"[0, 1, 0, 1, 0, 0, 0, 0, 0, 1, 0, 1, 1, 1, 0]",137,87,50,5,7,0.05747126436781609,0.14
"[0, 0, 0, 1, 1, 1, 1, 1, 1, 0, 1, 1, 1, 0, 0]",222,113,109,11,9,0.09734513274336283,0.08256880733944955
"[0, 0, 0, 0, 1, 1, 1, 1, 1, 1, 0, 1, 1, 1, 0]",263,111,152,14,20,0.12612612612612611,0.13157894736842105
"[1, 1, 0, 1, 1, 0, 0, 1, 1, 1, 0, 1, 0, 0, 0]",143,63,80,7,8,0.1111111111111111,0.1
"[1, 0, 1, 1, 1, 0, 0, 0, 1, 1, 1, 1, 0, 0, 1]",218,86,132,5,11,0.05813953488372093,0.08333333333333333
"[0, 0, 0, 0, 0, 0, 1, 1, 0, 0, 0, 1, 1, 0, 1]",441,308,133,30,12,0.09740259740259741,0.09022556390977443
"[0, 0, 0, 1, 0, 1, 0, 1, 0, 1, 0, 0, 1, 1, 1]",163,95,68,10,7,0.10526315789473684,0.10294117647058823
"[1, 1, 0, 0, 0, 1, 0, 1, 0, 1, 0, 1, 0, 0, 1]",121,61,60,6,5,0.09836065573770492,0.08333333333333333
"[0, 1, 0, 1, 1, 0, 1, 1, 1, 1, 1, 0, 0, 0, 1]",146,52,94,5,5,0.09615384615384616,0.05319148936170213
"[1, 0, 0, 0, 0, 1, 0, 0, 1, 0, 1, 0, 1, 1, 0]",157,80,77,7,10,0.0875,0.12987012987012986
"[0, 0, 0, 0, 0, 0, 1, 0, 1, 1, 0, 1, 0, 0, 1]",257,156,101,14,7,0.08974358974358974,0.06930693069306931
"[1, 0, 1, 1, 1, 0, 0, 1, 0, 0, 0, 0, 1, 0, 0]",161,99,62,5,6,0.050505050505050504,0.0967741935483871
"[0, 1, 0, 1, 0, 1, 0, 1, 1, 1, 0, 1, 0, 1, 1]",134,58,76,7,8,0.1206896551724138,0.10526315789473684
"[1, 0, 0, 0, 0, 1, 0, 1, 1, 1, 1, 1, 1, 0, 1]",147,61,86,7,11,0.11475409836065574,0.12790697674418605
"[1, 1, 0, 0, 1, 1, 1, 0, 1, 0, 1, 0, 0, 0, 0]",157,92,65,5,12,0.05434782608695652,0.18461538461538463
"[0, 1, 0, 1, 1, 0, 0, 1, 1, 1, 0, 1, 0, 1, 0]",110,47,63,1,4,0.02127659574468085,0.06349206349206349
"[0, 1, 0, 0, 0, 0, 1, 1, 1, 0, 0, 0, 1, 0, 1]",168,103,65,13,7,0.1262135922330097,0.1076923076923077
"[0, 1, 1, 0, 1, 1, 0, 1, 1, 0, 0, 0, 1, 1, 0]",135,70,65,4,7,0.05714285714285714,0.1076923076923077
"[0, 1, 1, 1, 1, 1, 1, 0, 0, 0, 0, 0, 1, 0, 0]",234,172,62,19,8,0.11046511627906977,0.12903225806451613
"[0, 0, 1, 1, 1, 0, 1, 1, 1, 1, 1, 0, 1, 0, 1]",206,71,135,10,13,0.14084507042253522,0.0962962962962963
"[1, 0, 1, 0, 0, 1, 1, 1, 0, 1, 0, 0, 1, 1, 1]",165,55,110,5,15,0.09090909090909091,0.13636363636363635
"[0, 1, 1, 1, 0, 1, 0, 0, 1, 0, 1, 1, 0, 0, 0]",120,61,59,6,2,0.09836065573770492,0.03389830508474576
"[1, 0, 0, 0, 1, 0, 0, 1, 1, 0, 0, 1, 1, 1, 1]",281,125,156,12,13,0.096,0.08333333333333333
"[0, 0, 1, 0, 0, 0, 1, 0, 0, 1, 1, 0, 1, 0, 0]",210,138,72,11,5,0.07971014492753623,0.06944444444444445
"[0, 1, 0, 1, 0, 0, 0, 1, 1, 1, 0, 1, 1, 0, 0]",128,60,68,4,7,0.06666666666666667,0.10294117647058823
"[0, 1, 0, 0, 1, 0, 0, 0, 1, 1, 1, 1, 0, 0, 1]",172,87,85,4,9,0.04597701149425287,0.10588235294117647
"[1, 0, 0, 1, 1, 0, 0, 0, 0, 1, 1, 0, 1, 0, 1]",265,91,174,8,10,0.08791208791208792,0.05747126436781609
"[0, 1, 1, 0, 0, 1, 0, 1, 1, 1, 0, 0, 1, 1, 0]",143,72,71,8,10,0.1111111111111111,0.14084507042253522
"[0, 1, 0, 1, 1, 1, 1, 1, 0, 1, 1, 0, 1, 1, 0]",218,83,135,12,8,0.14457831325301204,0.05925925925925926
"[0, 1, 0, 1, 1, 0, 1, 1, 1, 1, 0, 1, 1, 1, 0]",238,88,150,13,18,0.14772727272727273,0.12
"[1, 0, 1, 1, 0, 1, 0, 1, 0, 0, 1, 1, 0, 1, 0]",90,40,50,3,6,0.075,0.12
"[0, 0, 0, 1, 1, 1, 1, 1, 1, 0, 0, 1, 0, 1, 0]",216,131,85,13,6,0.09923664122137404,0.07058823529411765
"[1, 1, 1, 0, 1, 0, 0, 0, 0, 0, 0, 1, 0, 1, 0]",143,86,57,8,11,0.09302325581395349,0.19298245614035087
"[0, 0, 1, 1, 1, 0, 1, 0, 0, 0, 0, 0, 0, 1, 0]",245,157,88,13,7,0.08280254777070063,0.07954545454545454
"[1, 1, 0, 1, 0, 0, 1, 0, 0, 1, 0, 1, 0, 0, 1]",98,48,50,5,4,0.10416666666666667,0.08
"[1, 0, 0, 1, 1, 1, 0, 1, 0, 0, 1, 0, 0, 1, 0]",108,44,64,2,8,0.045454545454545456,0.125
"[0, 0, 0, 1, 1, 0, 1, 0, 0, 1, 0, 1, 1, 1, 0]",122,74,48,6,5,0.08108108108108109,0.10416666666666667
"[1, 1, 0, 0, 0, 1, 0, 1, 0, 0, 1, 0, 1, 1, 1]",126,67,59,8,7,0.11940298507462686,0.11864406779661017
"[1, 1, 1, 0, 0, 0, 0, 0, 0, 1, 0, 1, 1, 0, 1]",155,61,94,4,10,0.06557377049180328,0.10638297872340426
"[1, 1, 1, 0, 0, 1, 0, 0, 1, 0, 0, 1, 1, 1, 0]",112,46,66,2,8,0.043478260869565216,0.12121212121212122
"[0, 0, 1, 1, 1, 0, 0, 1, 0, 1, 0, 1, 0, 0, 1]",118,67,51,4,2,0.05970149253731343,0.0392156862745098
"[1, 1, 1, 0, 0, 0, 0, 0, 0, 1, 1, 1, 0, 0, 1]",276,78,198,7,17,0.08974358974358974,0.08585858585858586
"[1, 1, 0, 1, 0, 0, 0, 1, 0, 1, 1, 0, 1, 1, 1]",142,56,86,5,9,0.08928571428571429,0.10465116279069768
"[0, 0, 1, 0, 1, 1, 1, 0, 1, 0, 0, 0, 1, 0, 1]",112,49,63,4,7,0.08163265306122448,0.1111111111111111
"[1, 0, 1, 1, 0, 0, 1, 1, 0, 1, 0, 0, 1, 0, 1]",118,60,58,4,5,0.06666666666666667,0.08620689655172414
"[0, 1, 1, 1, 0, 0, 0, 1, 1, 1, 1, 0, 1, 1, 1]",313,122,191,11,18,0.09016393442622951,0.09424083769633508
"[1, 0, 1, 1, 1, 0, 0, 0, 1, 1, 1, 1, 0, 1, 1]",266,88,178,9,22,0.10227272727272728,0.12359550561797752
"[1, 0, 0, 1, 0, 1, 1, 0, 1, 1, 1, 1, 1, 0, 1]",235,74,161,6,18,0.08108108108108109,0.11180124223602485
"[1, 1, 0, 0, 0, 1, 0, 1, 0, 1, 1, 0, 1, 0, 0]",123,67,56,8,6,0.11940298507462686,0.10714285714285714
"[0, 0, 1, 0, 1, 0, 0, 0, 1, 1, 0, 0, 1, 0, 0]",254,174,80,16,4,0.09195402298850575,0.05
"[0, 1, 0, 1, 0, 0, 1, 0, 1, 0, 1, 1, 1, 0, 1]",100,49,51,5,8,0.10204081632653061,0.1568627450980392
"[1, 0, 1, 0, 1, 0, 1, 0, 1, 0, 1, 1, 1, 1, 0]",168,75,93,4,14,0.05333333333333334,0.15053763440860216
"[1, 1, 1, 0, 0, 0, 0, 1, 0, 1, 1, 1, 1, 1, 0]",186,76,110,11,5,0.14473684210526316,0.045454545454545456
"[0, 0, 0, 0, 0, 1, 1, 1, 0, 1, 0, 1, 0, 1, 0]",162,101,61,9,6,0.0891089108910891,0.09836065573770492
"[1, 0, 1, 1, 1, 1, 0, 0, 0, 0, 1, 1, 0, 1, 1]",201,86,115,7,11,0.08139534883720931,0.09565217391304348
"[0, 1, 0, 1, 0, 0, 1, 1, 0, 1, 0, 1, 0, 1, 1]",105,50,55,5,6,0.1,0.10909090909090909
"[1, 1, 1, 0, 1, 1, 0, 1, 0, 1, 0, 0, 1, 1, 0]",172,64,108,6,8,0.09375,0.07407407407407407
"[0, 1, 1, 1, 1, 1, 1, 1, 0, 0, 0, 0, 0, 1, 0]",179,91,88,7,7,0.07692307692307693,0.07954545454545454
"[0, 1, 1, 0, 0, 0, 0, 1, 1, 0, 1, 1, 1, 1, 0]",164,99,65,10,10,0.10101010101010101,0.15384615384615385
"[1, 0, 0, 0, 1, 1, 0, 1, 1, 0, 0, 0, 0, 0, 1]",176,85,91,10,5,0.11764705882352941,0.054945054945054944
"[1, 0, 0, 0, 0, 1, 0, 0, 0, 0, 1, 1, 0, 1, 0]",210,131,79,14,6,0.10687022900763359,0.0759493670886076
"[1, 1, 1, 0, 1, 0, 0, 0, 1, 1, 1, 0, 1, 1, 0]",126,51,75,8,6,0.1568627450980392,0.08
"[1, 1, 1, 0, 1, 0, 1, 0, 0, 1, 0, 1, 0, 1, 0]",104,38,66,4,3,0.10526315789473684,0.045454545454545456
"[0, 1, 0, 0, 1, 1, 0, 1, 0, 0, 0, 1, 0, 1, 1]",107,55,52,3,5,0.05454545454545454,0.09615384615384616
"[0, 1, 0, 0, 1, 0, 0, 0, 1, 0, 1, 0, 0, 1, 0]",236,154,82,17,6,0.11038961038961038,0.07317073170731707
"[0, 0, 1, 0, 0, 0, 1, 0, 1, 1, 1, 0, 0, 1, 1]",139,82,57,8,6,0.0975609756097561,0.10526315789473684
"[0, 0, 1, 0, 1, 1, 1, 1, 1, 1, 0, 0, 0, 1, 0]",134,70,64,8,7,0.11428571428571428,0.109375
"[0, 0, 0, 1, 0, 1, 0, 0, 1, 1, 1, 0, 1, 1, 1]",150,76,74,7,8,0.09210526315789473,0.10810810810810811
"[0, 1, 0, 1, 0, 0, 0, 1, 1, 1, 1, 1, 1, 0, 0]",290,157,133,12,10,0.07643312101910828,0.07518796992481203
"[1, 1, 1, 0, 0, 1, 1, 1, 0, 0, 1, 0, 1, 0, 0]",136,57,79,5,10,0.08771929824561403,0.12658227848101267
"[0, 0, 1, 0, 0, 1, 1, 0, 0, 1, 0, 1, 1, 0, 1]",127,64,63,4,4,0.0625,0.06349206349206349
"[1, 1, 1, 1, 0, 0, 0, 1, 1, 0, 1, 0, 0, 0, 0]",157,84,73,10,6,0.11904761904761904,0.0821917808219178
"[1, 1, 0, 0, 0, 1, 1, 0, 0, 0, 0, 0, 1, 1, 0]",237,138,99,10,11,0.07246376811594203,0.1111111111111111
"[0, 0, 1, 1, 1, 0, 1, 1, 0, 0, 1, 1, 1, 0, 1]",147,62,85,9,12,0.14516129032258066,0.1411764705882353
"[1, 0, 0, 1, 1, 1, 0, 1, 1, 0, 0, 1, 1, 1, 0]",152,64,88,5,8,0.078125,0.09090909090909091
"[1, 0, 1, 0, 1, 0, 0, 1, 0, 0, 0, 1, 0, 1, 0]",135,77,58,3,5,0.03896103896103896,0.08620689655172414
"[1, 1, 1, 0, 1, 0, 0, 0, 1, 1, 0, 0, 0, 0, 1]",209,101,108,8,10,0.07920792079207921,0.09259259259259259
"[0, 1, 1, 0, 0, 1, 0, 0, 0, 1, 1, 1, 0, 0, 0]",187,117,70,12,4,0.10256410256410256,0.05714285714285714
"[0, 1, 1, 1, 1, 0, 1, 1, 0, 0, 1, 0, 1, 0, 1]",153,76,77,8,3,0.10526315789473684,0.03896103896103896
"[0, 1, 1, 1, 0, 0, 1, 1, 1, 0, 1, 0, 0, 1, 1]",176,80,96,12,12,0.15,0.125
"[0, 1, 0, 1, 1, 1, 0, 0, 0, 0, 0, 0, 1, 0, 1]",140,83,57,15,6,0.18072289156626506,0.10526315789473684
"[0, 1, 0, 0, 1, 1, 0, 1, 0, 1, 0, 0, 1, 1, 0]",120,59,61,7,7,0.11864406779661017,0.11475409836065574
"[1, 1, 0, 1, 0, 0, 1, 0, 0, 1, 1, 1, 1, 0, 0]",174,73,101,5,6,0.0684931506849315,0.0594059405940594
"[1, 1, 1, 1, 1, 1, 1, 0, 1, 0, 0, 0, 1, 0, 0]",170,68,102,7,13,0.10294117647058823,0.12745098039215685
"[1, 1, 0, 0, 0, 1, 1, 0, 1, 0, 0, 1, 0, 0, 0]",175,100,75,7,7,0.07,0.09333333333333334
"[1, 0, 1, 1, 0, 1, 1, 1, 0, 0, 0, 1, 1, 0, 1]",151,62,89,8,7,0.12903225806451613,0.07865168539325842
"[0, 1, 1, 1, 1, 0, 1, 1, 0, 0, 0, 1, 1, 0, 1]",148,55,93,6,6,0.10909090909090909,0.06451612903225806
"[0, 0, 1, 0, 1, 0, 0, 0, 0, 1, 1, 0, 0, 1, 1]",383,249,134,29,11,0.11646586345381527,0.08208955223880597
"[1, 0, 0, 0, 1, 0, 0, 1, 1, 1, 1, 0, 1, 1, 0]",119,63,56,7,5,0.1111111111111111,0.08928571428571429
"[1, 1, 1, 0, 0, 1, 1, 1, 0, 1, 1, 0, 1, 1, 0]",276,89,187,9,13,0.10112359550561797,0.06951871657754011
"[0, 1, 0, 0, 1, 1, 0, 0, 1, 1, 0, 0, 0, 1, 0]",173,98,75,11,7,0.11224489795918367,0.09333333333333334
"[1, 0, 1, 0, 1, 0, 1, 0, 0, 1, 0, 0, 1, 1, 0]",124,63,61,5,5,0.07936507936507936,0.08196721311475409
"[0, 0, 0, 0, 1, 1, 1, 1, 1, 0, 0, 0, 0, 0, 1]",266,161,105,8,7,0.049689440993788817,0.06666666666666667
"[1, 1, 1, 0, 0, 0, 0, 1, 1, 1, 0, 1, 0, 0, 1]",167,46,121,7,9,0.15217391304347827,0.0743801652892562
"[1, 1, 1, 0, 1, 1, 0, 0, 1, 0, 0, 0, 1, 1, 1]",200,86,114,7,7,0.08139534883720931,0.06140350877192982
"[0, 1, 1, 1, 1, 1, 1, 1, 0, 1, 1, 1, 0, 0, 0]",328,128,200,16,16,0.125,0.08
"[1, 1, 0, 1, 0, 1, 0, 1, 1, 1, 0, 0, 1, 0, 0]",115,57,58,6,4,0.10526315789473684,0.06896551724137931
"[1, 0, 0, 1, 0, 1, 1, 1, 1, 1, 1, 0, 1, 0, 1]",254,75,179,7,18,0.09333333333333334,0.1005586592178771
"[1, 0, 1, 1, 1, 0, 0, 0, 0, 0, 1, 0, 0, 1, 1]",155,74,81,6,10,0.08108108108108109,0.12345679012345678
"[0, 0, 0, 1, 1, 0, 1, 0, 0, 1, 1, 0, 1, 0, 1]",103,60,43,5,3,0.08333333333333333,0.06976744186046512
"[1, 0, 0, 0, 1, 1, 1, 1, 1, 0, 0, 0, 1, 0, 0]",128,67,61,13,4,0.19402985074626866,0.06557377049180328
"[1, 0, 0, 0, 1, 0, 1, 0, 0, 1, 0, 0, 1, 1, 0]",153,90,63,7,3,0.07777777777777778,0.047619047619047616
"[0, 1, 0, 0, 0, 0, 0, 1, 1, 0, 1, 0, 0, 1, 0]",246,157,89,15,5,0.09554140127388536,0.056179775280898875
"[1, 0, 1, 0, 0, 0, 1, 1, 0, 0, 1, 1, 0, 1, 1]",137,67,70,4,9,0.05970149253731343,0.12857142857142856
"[0, 0, 0, 1, 1, 1, 1, 1, 0, 0, 1, 0, 1, 1, 0]",130,68,62,9,7,0.1323529411764706,0.11290322580645161
"[1, 1, 0, 0, 0, 1, 1, 1, 1, 1, 0, 0, 1, 0, 1]",151,63,88,6,14,0.09523809523809523,0.1590909090909091
"[0, 0, 1, 0, 0, 0, 1, 0, 1, 0, 1, 1, 1, 1, 0]",133,81,52,6,6,0.07407407407407407,0.11538461538461539
"[0, 1, 0, 0, 0, 1, 1, 0, 1, 0, 1, 1, 0, 1, 1]",112,49,63,1,4,0.02040816326530612,0.06349206349206349
"[1, 0, 0, 0, 1, 0, 0, 0, 1, 1, 0, 1, 0, 1, 1]",115,65,50,6,6,0.09230769230769231,0.12
"[1, 0, 1, 1, 1, 1, 1, 0, 1, 0, 0, 0, 0, 1, 1]",185,81,104,8,7,0.09876543209876543,0.0673076923076923
"[1, 0, 0, 1, 0, 1, 0, 0, 1, 1, 1, 0, 0, 0, 0]",169,96,73,7,7,0.07291666666666667,0.0958904109589041
"[1, 0, 1, 0, 1, 0, 0, 0, 0, 1, 1, 0, 1, 0, 0]",162,96,66,12,8,0.125,0.12121212121212122
"[1, 0, 1, 0, 0, 0, 1, 1, 1, 0, 1, 0, 0, 0, 0]",148,81,67,8,4,0.09876543209876543,0.05970149253731343
"[0, 1, 0, 0, 1, 1, 1, 0, 1, 1, 1, 0, 0, 1, 0]",113,43,70,3,9,0.06976744186046512,0.12857142857142856
"[0, 0, 1, 0, 0, 1, 1, 0, 0, 0, 1, 1, 0, 1, 0]",123,73,50,8,8,0.1095890410958904,0.16
"[1, 0, 0, 1, 0, 0, 1, 1, 0, 1, 0, 1, 1, 1, 0]",117,60,57,7,5,0.11666666666666667,0.08771929824561403
"[0, 1, 0, 0, 1, 0, 0, 1, 1, 0, 1, 1, 1, 0, 0]",107,56,51,4,6,0.07142857142857142,0.11764705882352941
"[1, 1, 0, 1, 1, 1, 0, 1, 0, 1, 0, 0, 1, 0, 0]",104,47,57,0,5,0.0,0.08771929824561403
"[0, 0, 0, 0, 0, 0, 1, 0, 1, 0, 1, 1, 1, 0, 1]",145,93,52,9,1,0.0967741935483871,0.019230769230769232
"[1, 1, 1, 1, 0, 1, 1, 0, 1, 1, 0, 1, 0, 1, 0]",220,88,132,5,10,0.056818181818181816,0.07575757575757576
"[0, 0, 0, 0, 1, 0, 1, 1, 1, 1, 0, 1, 0, 1, 0]",101,55,46,7,4,0.12727272727272726,0.08695652173913043
"[1, 0, 0, 1, 0, 1, 1, 0, 1, 0, 0, 0, 1, 1, 1]",138,62,76,4,4,0.06451612903225806,0.05263157894736842
"[1, 0, 1, 1, 0, 0, 0, 1, 0, 1, 1, 1, 1, 0, 1]",143,55,88,5,9,0.09090909090909091,0.10227272727272728
"[1, 1, 1, 1, 1, 0, 1, 1, 0, 0, 0, 1, 0, 1, 1]",261,84,177,10,21,0.11904761904761904,0.11864406779661017
"[1, 0, 1, 1, 1, 1, 1, 0, 1, 1, 0, 0, 0, 1, 0]",122,42,80,2,9,0.047619047619047616,0.1125
"[1, 1, 1, 0, 0, 1, 1, 1, 0, 1, 1, 1, 1, 1, 0]",596,161,435,10,36,0.062111801242236024,0.08275862068965517
"[0, 0, 1, 0, 1, 1, 0, 1, 0, 0, 0, 0, 0, 0, 1]",286,183,103,22,9,0.12021857923497267,0.08737864077669903
"[1, 0, 1, 1, 0, 0, 1, 0, 0, 1, 0, 1, 1, 0, 0]",137,73,64,6,3,0.0821917808219178,0.046875
"[1, 1, 0, 0, 1, 0, 1, 1, 0, 1, 1, 0, 0, 1, 0]",85,38,47,2,5,0.05263157894736842,0.10638297872340426
"[0, 0, 1, 1, 1, 1, 0, 0, 0, 1, 0, 1, 1, 1, 0]",149,74,75,6,7,0.08108108108108109,0.09333333333333334
"[1, 1, 1, 0, 0, 0, 1, 0, 1, 1, 1, 0, 1, 1, 0]",151,58,93,6,9,0.10344827586206896,0.0967741935483871
"[1, 0, 1, 1, 1, 0, 0, 1, 0, 1, 0, 1, 1, 0, 0]",129,58,71,6,9,0.10344827586206896,0.1267605633802817
"[0, 1, 0, 1, 1, 0, 1, 0, 0, 0, 1, 1, 0, 1, 1]",123,58,65,4,13,0.06896551724137931,0.2
"[0, 1, 1, 1, 1, 1, 1, 0, 0, 1, 0, 0, 0, 1, 0]",161,93,68,9,4,0.0967741935483871,0.058823529411764705
"[1, 0, 0, 1, 1, 1, 0, 1, 0, 0, 0, 1, 0, 1, 0]",105,55,50,4,2,0.07272727272727272,0.04
"[1, 0, 0, 0, 0, 0, 0, 1, 0, 1, 0, 0, 1, 0, 1]",227,130,97,7,8,0.05384615384615385,0.08247422680412371
"[0, 0, 0, 0, 1, 0, 1, 1, 1, 1, 1, 0, 1, 0, 0]",132,65,67,5,5,0.07692307692307693,0.07462686567164178
"[1, 0, 1, 0, 1, 0, 1, 0, 0, 0, 0, 1, 1, 1, 1]",195,95,100,11,5,0.11578947368421053,0.05
"[0, 0, 0, 1, 1, 0, 1, 1, 0, 0, 1, 1, 0, 1, 0]",123,80,43,6,5,0.075,0.11627906976744186
"[0, 1, 1, 0, 1, 0, 1, 1, 1, 1, 0, 0, 0, 0, 0]",230,119,111,9,7,0.07563025210084033,0.06306306306306306
"[1, 1, 1, 0, 0, 1, 0, 0, 1, 0, 1, 1, 0, 1, 1]",156,70,86,4,6,0.05714285714285714,0.06976744186046512
"[0, 1, 1, 1, 1, 1, 0, 1, 1, 1, 0, 1, 0, 1, 1]",547,179,368,15,33,0.08379888268156424,0.08967391304347826
"[1, 0, 1, 1, 1, 1, 0, 1, 0, 1, 0, 1, 0, 0, 0]",129,57,72,6,11,0.10526315789473684,0.1527777777777778
"[0, 0, 0, 1, 1, 0, 1, 1, 1, 1, 1, 0, 1, 1, 1]",306,122,184,13,15,0.10655737704918032,0.08152173913043478
"[1, 0, 1, 1, 0, 1, 0, 1, 1, 0, 0, 0, 0, 0, 1]",146,79,67,5,5,0.06329113924050633,0.07462686567164178
"[0, 1, 0, 1, 1, 1, 0, 1, 1, 0, 1, 0, 1, 1, 0]",139,55,84,5,13,0.09090909090909091,0.15476190476190477
"[0, 0, 1, 0, 1, 0, 1, 0, 1, 0, 1, 1, 1, 0, 1]",111,58,53,3,8,0.05172413793103448,0.1509433962264151
"[0, 1, 1, 1, 0, 1, 1, 1, 0, 0, 0, 0, 1, 1, 0]",183,94,89,10,9,0.10638297872340426,0.10112359550561797
"[0, 1, 0, 0, 0, 1, 0, 1, 1, 0, 0, 1, 0, 0, 1]",139,82,57,6,5,0.07317073170731707,0.08771929824561403
"[1, 1, 1, 1, 0, 0, 1, 1, 0, 1, 1, 0, 1, 0, 1]",290,100,190,6,10,0.06,0.05263157894736842
"[0, 1, 0, 1, 0, 0, 0, 1, 1, 0, 1, 1, 1, 1, 0]",100,43,57,3,5,0.06976744186046512,0.08771929824561403
"[0, 0, 0, 0, 0, 1, 1, 1, 0, 1, 0, 1, 1, 1, 0]",141,87,54,11,3,0.12643678160919541,0.05555555555555555
"[1, 0, 1, 0, 0, 1, 1, 0, 0, 0, 0, 1, 0, 0, 1]",147,90,57,15,8,0.16666666666666666,0.14035087719298245
"[1, 0, 1, 1, 1, 1, 1, 0, 1, 0, 0, 0, 0, 1, 0]",121,57,64,1,5,0.017543859649122806,0.078125
"[0, 1, 1, 0, 0, 1, 1, 0, 1, 1, 0, 1, 0, 0, 0]",120,73,47,4,2,0.0547945205479452,0.0425531914893617
"[0, 1, 1, 0, 0, 1, 1, 1, 1, 1, 0, 1, 0, 0, 0]",177,96,81,10,8,0.10416666666666667,0.09876543209876543
"[0, 1, 1, 0, 0, 1, 1, 1, 1, 1, 0, 1, 0, 0, 1]",194,111,83,6,9,0.05405405405405406,0.10843373493975904
"[1, 0, 1, 0, 1, 1, 0, 0, 1, 1, 1, 1, 1, 0, 1]",226,106,120,8,10,0.07547169811320754,0.08333333333333333
"[1, 0, 1, 1, 0, 1, 1, 0, 1, 1, 1, 0, 0, 0, 1]",128,52,76,8,2,0.15384615384615385,0.02631578947368421
"[0, 0, 0, 0, 0, 0, 0, 1, 1, 1, 1, 0, 1, 1, 0]",327,230,97,31,13,0.13478260869565217,0.13402061855670103
"[1, 1, 1, 0, 1, 0, 0, 0, 0, 1, 0, 0, 1, 0, 1]",89,53,36,5,3,0.09433962264150944,0.08333333333333333
"[1, 1, 1, 0, 1, 0, 0, 0, 1, 0, 1, 1, 0, 1, 0]",100,46,54,3,8,0.06521739130434782,0.14814814814814814
"[1, 1, 1, 1, 0, 0, 1, 0, 0, 1, 0, 0, 1, 0, 1]",120,59,61,5,3,0.0847457627118644,0.04918032786885246
"[1, 1, 0, 0, 0, 0, 0, 0, 1, 1, 1, 0, 0, 1, 1]",375,197,178,18,12,0.09137055837563451,0.06741573033707865
"[0, 1, 0, 1, 1, 1, 0, 1, 0, 0, 1, 1, 1, 1, 0]",140,65,75,4,4,0.06153846153846154,0.05333333333333334
"[1, 1, 0, 1, 1, 1, 0, 1, 0, 1, 1, 1, 0, 1, 0]",220,85,135,11,14,0.12941176470588237,0.1037037037037037
"[0, 1, 1, 0, 1, 0, 1, 1, 1, 0, 0, 1, 1, 0, 0]",195,96,99,9,9,0.09375,0.09090909090909091
"[0, 0, 1, 1, 0, 0, 0, 1, 1, 0, 0, 1, 1, 0, 1]",152,74,78,6,11,0.08108108108108109,0.14102564102564102
"[0, 0, 0, 1, 1, 1, 0, 1, 1, 1, 1, 1, 0, 0, 0]",182,92,90,14,9,0.15217391304347827,0.1
"[1, 0, 0, 0, 1, 0, 1, 1, 0, 1, 0, 0, 1, 0, 0]",135,87,48,8,6,0.09195402298850575,0.125
"[1, 1, 0, 0, 0, 0, 1, 1, 0, 0, 1, 1, 1, 0, 0]",342,189,153,17,8,0.08994708994708994,0.05228758169934641
"[0, 1, 0, 0, 0, 1, 0, 0, 0, 1, 1, 1, 1, 1, 1]",218,119,99,13,10,0.1092436974789916,0.10101010101010101
"[0, 1, 1, 0, 1, 0, 0, 1, 1, 0, 0, 1, 0, 0, 0]",163,108,55,8,3,0.07407407407407407,0.05454545454545454
"[1, 0, 0, 1, 0, 1, 0, 1, 1, 0, 0, 1, 1, 0, 1]",117,47,70,8,8,0.1702127659574468,0.11428571428571428
"[1, 0, 1, 1, 0, 0, 1, 1, 1, 1, 0, 1, 1, 0, 0]",178,62,116,3,12,0.04838709677419355,0.10344827586206896
"[1, 0, 0, 0, 1, 0, 0, 1, 1, 1, 1, 0, 0, 1, 1]",297,120,177,12,22,0.1,0.12429378531073447
"[0, 0, 0, 1, 0, 0, 1, 1, 0, 1, 1, 1, 0, 0, 0]",168,106,62,11,1,0.10377358490566038,0.016129032258064516
"[0, 1, 1, 1, 0, 0, 1, 0, 0, 0, 0, 1, 0, 0, 0]",253,160,93,17,11,0.10625,0.11827956989247312
"[1, 0, 0, 1, 0, 0, 1, 1, 1, 0, 1, 1, 0, 1, 0]",114,48,66,2,6,0.041666666666666664,0.09090909090909091
"[1, 0, 0, 1, 0, 0, 0, 1, 1, 0, 1, 1, 1, 1, 1]",161,66,95,5,12,0.07575757575757576,0.12631578947368421
"[0, 1, 1, 1, 1, 0, 1, 1, 1, 0, 1, 0, 0, 1, 1]",277,91,186,2,12,0.02197802197802198,0.06451612903225806
"[1, 0, 0, 1, 0, 1, 0, 1, 1, 0, 1, 1, 0, 1, 0]",97,43,54,4,4,0.09302325581395349,0.07407407407407407
"[0, 1, 1, 0, 0, 0, 0, 0, 1, 0, 1, 1, 0, 1, 0]",156,94,62,9,3,0.09574468085106383,0.04838709677419355
"[0, 1, 1, 1, 0, 0, 1, 0, 0, 1, 0, 0, 0, 1, 0]",145,83,62,10,6,0.12048192771084337,0.0967741935483871
"[0, 0, 1, 0, 0, 0, 1, 1, 1, 1, 0, 0, 1, 1, 0]",312,174,138,23,14,0.13218390804597702,0.10144927536231885
"[1, 0, 0, 0, 0, 0, 1, 0, 1, 1, 0, 0, 1, 0, 0]",250,166,84,10,13,0.060240963855421686,0.15476190476190477
"[1, 1, 0, 0, 0, 1, 1, 1, 0, 0, 0, 1, 0, 1, 0]",115,57,58,5,3,0.08771929824561403,0.05172413793103448
"[1, 1, 1, 0, 0, 0, 1, 1, 0, 1, 0, 1, 0, 1, 0]",100,43,57,4,9,0.09302325581395349,0.15789473684210525
"[1, 1, 0, 1, 1, 1, 0, 0, 0, 0, 0, 0, 1, 1, 1]",359,174,185,18,17,0.10344827586206896,0.0918918918918919
"[1, 1, 0, 1, 0, 1, 1, 1, 1, 0, 1, 0, 0, 0, 1]",169,57,112,7,10,0.12280701754385964,0.08928571428571429
"[0, 1, 0, 0, 1, 1, 0, 0, 1, 0, 1, 0, 1, 0, 0]",153,104,49,8,2,0.07692307692307693,0.04081632653061224
"[0, 1, 0, 1, 0, 0, 0, 1, 0, 1, 1, 1, 0, 0, 1]",132,67,65,9,6,0.13432835820895522,0.09230769230769231
"[1, 1, 0, 0, 1, 1, 1, 0, 1, 0, 0, 0, 0, 0, 1]",171,103,68,6,7,0.05825242718446602,0.10294117647058823
"[1, 0, 1, 1, 1, 0, 1, 1, 1, 0, 0, 0, 0, 0, 1]",129,64,65,4,6,0.0625,0.09230769230769231
"[1, 0, 0, 1, 1, 0, 0, 0, 0, 0, 1, 0, 0, 1, 0]",313,171,142,15,10,0.08771929824561403,0.07042253521126761
"[0, 1, 0, 1, 0, 0, 0, 1, 1, 1, 1, 1, 0, 1, 1]",138,55,83,4,6,0.07272727272727272,0.07228915662650602
"[0, 0, 1, 0, 0, 0, 1, 0, 1, 1, 1, 0, 1, 1, 0]",103,54,49,5,3,0.09259259259259259,0.061224489795918366
"[1, 1, 0, 0, 1, 0, 1, 1, 0, 1, 0, 0, 0, 0, 0]",171,98,73,11,7,0.11224489795918367,0.0958904109589041
"[1, 0, 0, 0, 1, 0, 0, 1, 0, 1, 1, 1, 1, 1, 0]",145,66,79,4,6,0.06060606060606061,0.0759493670886076
"[1, 1, 1, 0, 0, 0, 0, 1, 1, 0, 1, 0, 1, 1, 1]",363,90,273,6,23,0.06666666666666667,0.08424908424908426
"[1, 0, 1, 0, 1, 0, 0, 1, 1, 0, 0, 0, 1, 0, 1]",113,67,46,4,5,0.05970149253731343,0.10869565217391304
"[1, 1, 1, 0, 1, 0, 0, 0, 1, 0, 0, 0, 0, 1, 0]",129,76,53,9,7,0.11842105263157894,0.1320754716981132
"[1, 1, 1, 1, 0, 1, 0, 0, 0, 1, 0, 0, 0, 0, 1]",128,70,58,5,9,0.07142857142857142,0.15517241379310345
"[0, 0, 0, 1, 1, 1, 1, 1, 0, 1, 0, 0, 0, 1, 0]",112,71,41,7,5,0.09859154929577464,0.12195121951219512
"[0, 0, 0, 1, 0, 1, 0, 0, 0, 0, 1, 1, 0, 1, 1]",163,91,72,8,7,0.08791208791208792,0.09722222222222222
"[1, 1, 0, 1, 0, 0, 0, 1, 1, 0, 0, 0, 1, 0, 1]",102,47,55,6,6,0.1276595744680851,0.10909090909090909
"[0, 1, 1, 1, 0, 1, 0, 0, 1, 1, 0, 0, 1, 0, 0]",109,56,53,7,4,0.125,0.07547169811320754
"[0, 0, 0, 1, 1, 1, 1, 1, 0, 0, 0, 0, 1, 0, 0]",181,116,65,11,6,0.09482758620689655,0.09230769230769231
"[0, 1, 0, 1, 1, 0, 0, 0, 0, 1, 0, 0, 1, 1, 1]",162,96,66,4,12,0.041666666666666664,0.18181818181818182
"[1, 1, 1, 1, 0, 0, 1, 0, 1, 1, 0, 0, 0, 0, 1]",175,80,95,12,10,0.15,0.10526315789473684
"[1, 1, 1, 1, 0, 0, 1, 0, 0, 0, 1, 1, 0, 1, 0]",119,66,53,11,3,0.16666666666666666,0.05660377358490566
"[0, 0, 0, 1, 1, 1, 0, 1, 1, 1, 1, 1, 0, 0, 1]",216,116,100,8,12,0.06896551724137931,0.12
"[1, 0, 0, 0, 1, 1, 1, 0, 1, 1, 1, 1, 1, 0, 0]",186,74,112,8,10,0.10810810810810811,0.08928571428571429
"[1, 0, 1, 0, 0, 1, 0, 0, 1, 1, 0, 0, 0, 1, 0]",146,90,56,5,7,0.05555555555555555,0.125
"[1, 0, 0, 1, 1, 1, 0, 0, 0, 1, 1, 0, 1, 0, 0]",117,60,57,6,5,0.1,0.08771929824561403
"[0, 1, 0, 0, 1, 1, 1, 0, 1, 1, 1, 1, 0, 1, 1]",222,84,138,13,14,0.15476190476190477,0.10144927536231885
"[0, 1, 1, 1, 0, 1, 1, 0, 0, 0, 0, 1, 0, 0, 1]",102,52,50,7,8,0.1346153846153846,0.16
"[0, 1, 0, 1, 1, 1, 0, 1, 1, 1, 0, 1, 1, 0, 1]",224,57,167,3,19,0.05263157894736842,0.11377245508982035
"[0, 1, 1, 0, 1, 0, 1, 1, 1, 0, 0, 1, 0, 0, 1]",107,53,54,10,7,0.18867924528301888,0.12962962962962962
"[1, 0, 1, 1, 1, 1, 0, 0, 1, 1, 0, 1, 0, 1, 1]",245,80,165,8,10,0.1,0.06060606060606061
"[0, 1, 0, 1, 0, 1, 1, 1, 1, 1, 0, 0, 0, 0, 0]",219,119,100,13,11,0.1092436974789916,0.11
"[1, 0, 1, 1, 1, 0, 0, 1, 1, 0, 0, 0, 0, 0, 1]",169,86,83,6,7,0.06976744186046512,0.08433734939759036
"[1, 0, 1, 1, 0, 1, 1, 1, 0, 0, 1, 1, 0, 0, 0]",180,84,96,11,5,0.13095238095238096,0.052083333333333336
"[0, 1, 0, 1, 1, 0, 0, 0, 1, 1, 1, 1, 1, 0, 1]",158,62,96,7,12,0.11290322580645161,0.125
"[1, 1, 0, 1, 0, 0, 1, 1, 1, 0, 0, 1, 1, 0, 1]",164,74,90,8,7,0.10810810810810811,0.07777777777777778
"[0, 0, 1, 1, 1, 0, 0, 1, 0, 1, 0, 1, 1, 1, 0]",121,60,61,6,7,0.1,0.11475409836065574
"[1, 0, 0, 1, 0, 1, 1, 0, 0, 1, 1, 0, 1, 0, 1]",109,47,62,4,6,0.0851063829787234,0.0967741935483871
"[1, 1, 0, 1, 1, 0, 0, 0, 0, 1, 1, 1, 1, 1, 0]",207,90,117,6,7,0.06666666666666667,0.05982905982905983
"[1, 1, 0, 1, 0, 0, 1, 0, 1, 1, 0, 1, 0, 0, 0]",127,72,55,5,5,0.06944444444444445,0.09090909090909091
"[1, 0, 1, 0, 0, 1, 1, 1, 1, 0, 1, 0, 0, 0, 0]",138,75,63,5,6,0.06666666666666667,0.09523809523809523
"[0, 0, 0, 0, 1, 1, 1, 1, 0, 1, 0, 1, 1, 1, 0]",167,90,77,7,6,0.07777777777777778,0.07792207792207792
"[0, 0, 0, 1, 1, 1, 1, 0, 1, 1, 1, 1, 1, 0, 0]",248,110,138,10,13,0.09090909090909091,0.09420289855072464
"[1, 1, 0, 1, 1, 0, 0, 1, 0, 0, 0, 0, 1, 0, 1]",111,65,46,6,7,0.09230769230769231,0.15217391304347827
"[1, 1, 1, 0, 0, 1, 0, 0, 0, 0, 0, 0, 0, 0, 1]",454,268,186,22,15,0.08208955223880597,0.08064516129032258
"[0, 0, 1, 1, 0, 0, 0, 1, 0, 1, 0, 0, 0, 0, 1]",330,226,104,27,8,0.11946902654867257,0.07692307692307693
"[1, 0, 0, 0, 1, 0, 0, 0, 0, 1, 1, 0, 0, 1, 0]",245,151,94,18,13,0.11920529801324503,0.13829787234042554
"[1, 0, 0, 0, 0, 1, 1, 1, 0, 0, 1, 0, 1, 1, 0]",128,63,65,4,4,0.06349206349206349,0.06153846153846154
"[0, 1, 1, 0, 1, 1, 0, 0, 1, 0, 0, 0, 0, 1, 1]",169,96,73,8,10,0.08333333333333333,0.136986301369863
"[1, 0, 1, 0, 1, 1, 0, 0, 0, 0, 0, 1, 0, 0, 1]",173,95,78,12,4,0.12631578947368421,0.05128205128205128
"[0, 1, 0, 0, 0, 0, 1, 1, 0, 1, 0, 1, 1, 1, 1]",150,72,78,9,10,0.125,0.1282051282051282
"[0, 0, 0, 1, 0, 1, 1, 1, 0, 0, 1, 1, 0, 1, 1]",121,56,65,5,5,0.08928571428571429,0.07692307692307693
"[0, 0, 0, 1, 1, 1, 0, 1, 0, 0, 0, 0, 1, 1, 0]",204,135,69,14,9,0.1037037037037037,0.13043478260869565
"[1, 0, 0, 0, 1, 1, 1, 0, 1, 0, 0, 0, 0, 1, 1]",144,77,67,7,11,0.09090909090909091,0.16417910447761194
"[0, 0, 0, 0, 1, 1, 0, 1, 1, 1, 1, 1, 0, 0, 1]",169,77,92,5,7,0.06493506493506493,0.07608695652173914
"[1, 1, 0, 0, 0, 1, 1, 0, 1, 1, 0, 0, 0, 1, 1]",140,68,72,5,3,0.07352941176470588,0.041666666666666664
"[1, 1, 0, 1, 0, 0, 0, 0, 0, 1, 1, 0, 1, 0, 1]",130,53,77,2,9,0.03773584905660377,0.11688311688311688
"[1, 1, 0, 1, 0, 1, 1, 1, 0, 1, 0, 0, 1, 0, 0]",113,55,58,6,6,0.10909090909090909,0.10344827586206896
"[0, 0, 1, 1, 1, 0, 1, 0, 0, 1, 0, 1, 0, 1, 0]",95,55,40,2,2,0.03636363636363636,0.05
"[0, 0, 0, 0, 1, 0, 1, 0, 1, 1, 1, 1, 0, 1, 1]",134,66,68,9,8,0.13636363636363635,0.11764705882352941
"[1, 1, 0, 0, 1, 0, 0, 1, 0, 0, 0, 0, 1, 0, 1]",125,78,47,5,7,0.0641025641025641,0.14893617021276595
"[1, 0, 1, 1, 1, 0, 0, 0, 1, 1, 1, 0, 0, 0, 0]",156,83,73,11,7,0.13253012048192772,0.0958904109589041
"[1, 0, 1, 0, 0, 0, 0, 0, 1, 0, 1, 0, 1, 0, 0]",247,156,91,16,14,0.10256410256410256,0.15384615384615385
"[0, 0, 1, 0, 0, 1, 0, 1, 0, 0, 1, 1, 0, 0, 0]",316,227,89,17,5,0.07488986784140969,0.056179775280898875
"[0, 0, 1, 0, 0, 0, 1, 0, 1, 0, 1, 1, 0, 0, 0]",222,150,72,11,7,0.07333333333333333,0.09722222222222222
"[1, 1, 1, 0, 0, 0, 1, 0, 1, 1, 0, 1, 1, 0, 1]",153,53,100,4,9,0.07547169811320754,0.09
"[0, 1, 1, 1, 1, 0, 1, 1, 0, 0, 0, 0, 1, 1, 1]",305,126,179,11,8,0.0873015873015873,0.0446927374301676
"[0, 0, 0, 1, 1, 0, 0, 1, 1, 1, 0, 0, 0, 0, 1]",303,203,100,16,6,0.07881773399014778,0.06
"[1, 1, 0, 0, 1, 0, 0, 0, 1, 0, 0, 0, 0, 1, 0]",262,164,98,14,10,0.08536585365853659,0.10204081632653061
"[0, 0, 1, 0, 0, 1, 1, 0, 1, 0, 0, 1, 0, 0, 0]",251,161,90,13,8,0.08074534161490683,0.08888888888888889
"[0, 1, 1, 1, 0, 1, 0, 0, 1, 1, 1, 1, 1, 0, 0]",226,96,130,13,14,0.13541666666666666,0.1076923076923077
"[0, 1, 0, 1, 0, 1, 0, 1, 1, 0, 1, 0, 0, 1, 1]",122,62,60,9,5,0.14516129032258066,0.08333333333333333
"[1, 0, 1, 1, 1, 0, 0, 1, 0, 1, 0, 0, 0, 1, 1]",163,75,88,9,3,0.12,0.03409090909090909
"[1, 0, 1, 1, 0, 0, 0, 0, 1, 0, 0, 1, 1, 1, 0]",130,78,52,8,3,0.10256410256410256,0.057692307692307696
"[1, 0, 1, 1, 1, 1, 1, 1, 0, 0, 1, 0, 0, 1, 1]",280,104,176,9,16,0.08653846153846154,0.09090909090909091
"[0, 0, 0, 1, 1, 0, 0, 1, 0, 0, 1, 0, 1, 1, 1]",220,145,75,17,8,0.11724137931034483,0.10666666666666667
"[1, 1, 1, 1, 0, 1, 1, 0, 1, 1, 1, 0, 0, 1, 0]",249,72,177,9,14,0.125,0.07909604519774012
"[1, 1, 0, 1, 0, 1, 0, 0, 0, 1, 0, 0, 0, 0, 1]",143,90,53,12,3,0.13333333333333333,0.05660377358490566
"[1, 1, 0, 0, 0, 1, 1, 0, 0, 1, 1, 1, 0, 1, 0]",124,54,70,4,11,0.07407407407407407,0.15714285714285714
"[0, 1, 1, 0, 1, 1, 1, 0, 0, 1, 1, 0, 0, 1, 0]",100,46,54,4,3,0.08695652173913043,0.05555555555555555
"[0, 0, 0, 0, 1, 0, 1, 1, 0, 1, 1, 0, 0, 0, 1]",166,93,73,8,8,0.08602150537634409,0.1095890410958904
"[0, 1, 0, 1, 1, 0, 0, 1, 0, 1, 1, 0, 0, 0, 1]",125,68,57,6,10,0.08823529411764706,0.17543859649122806
"[1, 1, 0, 1, 0, 1, 1, 1, 0, 1, 1, 1, 1, 0, 0]",284,102,182,7,15,0.06862745098039216,0.08241758241758242
"[1, 0, 1, 1, 0, 0, 0, 0, 1, 0, 1, 0, 1, 1, 0]",119,63,56,0,6,0.0,0.10714285714285714
"[1, 0, 1, 1, 0, 0, 1, 0, 1, 0, 0, 1, 0, 1, 1]",104,45,59,3,5,0.06666666666666667,0.0847457627118644
"[1, 0, 1, 0, 1, 0, 0, 0, 1, 1, 1, 1, 1, 1, 0]",226,102,124,14,12,0.13725490196078433,0.0967741935483871
"[1, 0, 0, 1, 0, 0, 0, 1, 1, 1, 1, 0, 0, 0, 0]",363,207,156,14,17,0.06763285024154589,0.10897435897435898
"[1, 0, 1, 0, 1, 0, 0, 0, 1, 1, 1, 0, 0, 1, 0]",108,66,42,4,6,0.06060606060606061,0.14285714285714285
"[0, 0, 0, 0, 0, 1, 0, 1, 0, 1, 1, 1, 1, 0, 1]",130,81,49,5,4,0.06172839506172839,0.08163265306122448
"[1, 0, 0, 1, 1, 0, 0, 0, 1, 1, 1, 1, 0, 1, 1]",184,59,125,6,12,0.1016949152542373,0.096
"[1, 1, 0, 0, 0, 0, 0, 1, 1, 1, 1, 1, 0, 1, 1]",220,87,133,10,11,0.11494252873563218,0.08270676691729323
"[1, 0, 1, 0, 0, 1, 1, 0, 1, 1, 1, 0, 1, 1, 0]",126,50,76,7,5,0.14,0.06578947368421052
"[0, 0, 0, 1, 1, 1, 0, 0, 1, 0, 1, 0, 0, 0, 1]",147,80,67,6,7,0.075,0.1044776119402985
"[1, 0, 1, 0, 0, 1, 0, 0, 1, 0, 1, 0, 1, 0, 0]",137,81,56,13,2,0.16049382716049382,0.03571428571428571
"[1, 1, 0, 1, 0, 0, 1, 1, 0, 0, 1, 0, 1, 0, 0]",109,63,46,7,2,0.1111111111111111,0.043478260869565216
"[0, 0, 0, 0, 1, 1, 0, 1, 0, 0, 1, 1, 0, 0, 1]",243,150,93,18,8,0.12,0.08602150537634409
"[0, 1, 1, 0, 1, 0, 0, 1, 1, 1, 1, 1, 1, 0, 1]",272,100,172,7,14,0.07,0.08139534883720931
"[1, 0, 0, 0, 0, 0, 1, 1, 1, 0, 0, 1, 1, 1, 0]",141,72,69,7,2,0.09722222222222222,0.028985507246376812
"[0, 1, 0, 0, 1, 0, 1, 0, 0, 0, 0, 0, 1, 1, 1]",263,170,93,19,7,0.11176470588235295,0.07526881720430108
"[1, 1, 1, 0, 0, 1, 0, 0, 1, 0, 1, 0, 0, 0, 0]",164,86,78,6,4,0.06976744186046512,0.05128205128205128
"[0, 1, 0, 0, 0, 0, 0, 1, 0, 1, 1, 0, 0, 0, 1]",237,152,85,17,10,0.1118421052631579,0.11764705882352941
"[1, 1, 0, 0, 1, 0, 1, 1, 0, 0, 1, 0, 0, 0, 1]",127,61,66,4,6,0.06557377049180328,0.09090909090909091
"[0, 1, 1, 0, 0, 0, 0, 1, 1, 1, 0, 1, 1, 0, 0]",182,116,66,14,5,0.1206896551724138,0.07575757575757576
"[1, 1, 1, 0, 1, 0, 0, 1, 1, 1, 1, 0, 0, 0, 1]",185,84,101,10,5,0.11904761904761904,0.04950495049504951
"[1, 1, 0, 1, 0, 0, 0, 1, 1, 1, 0, 1, 1, 1, 0]",140,49,91,2,5,0.04081632653061224,0.054945054945054944
"[1, 1, 0, 0, 0, 1, 0, 1, 0, 1, 1, 0, 0, 0, 0]",208,121,87,10,9,0.08264462809917356,0.10344827586206896
"[0, 0, 1, 0, 0, 1, 1, 1, 1, 0, 1, 0, 1, 1, 1]",173,68,105,5,9,0.07352941176470588,0.08571428571428572
"[1, 0, 0, 0, 1, 1, 1, 0, 0, 1, 1, 0, 0, 0, 1]",137,63,74,7,5,0.1111111111111111,0.06756756756756757
"[1, 1, 0, 1, 0, 0, 0, 0, 0, 1, 0, 1, 1, 1, 1]",152,78,74,5,11,0.0641025641025641,0.14864864864864866
"[0, 1, 1, 0, 0, 0, 1, 1, 0, 1, 0, 1, 0, 1, 1]",104,52,52,3,1,0.057692307692307696,0.019230769230769232
"[0, 0, 1, 1, 0, 0, 0, 1, 1, 0, 1, 0, 1, 0, 1]",106,54,52,5,5,0.09259259259259259,0.09615384615384616
"[0, 0, 1, 0, 0, 0, 1, 1, 1, 1, 0, 0, 1, 1, 1]",305,154,151,15,19,0.09740259740259741,0.12582781456953643
"[0, 0, 1, 1, 1, 0, 0, 0, 0, 1, 1, 1, 0, 1, 0]",126,72,54,9,2,0.125,0.037037037037037035
"[1, 0, 0, 0, 1, 0, 0, 0, 1, 1, 1, 1, 0, 0, 0]",271,160,111,18,7,0.1125,0.06306306306306306
"[1, 1, 0, 1, 1, 1, 1, 0, 0, 1, 1, 1, 0, 0, 0]",214,88,126,4,18,0.045454545454545456,0.14285714285714285
"[1, 0, 0, 1, 0, 0, 0, 1, 1, 1, 0, 1, 1, 0, 1]",108,44,64,2,3,0.045454545454545456,0.046875
"[0, 0, 0, 0, 0, 1, 0, 1, 1, 0, 1, 1, 0, 0, 0]",283,177,106,18,12,0.1016949152542373,0.11320754716981132
"[0, 1, 1, 0, 1, 0, 0, 1, 1, 1, 0, 0, 1, 1, 0]",154,83,71,10,6,0.12048192771084337,0.08450704225352113
"[0, 1, 1, 1, 0, 1, 1, 1, 0, 0, 1, 0, 1, 1, 0]",119,50,69,3,5,0.06,0.07246376811594203
"[1, 1, 1, 0, 1, 1, 1, 1, 1, 0, 1, 0, 0, 1, 0]",233,80,153,6,14,0.075,0.0915032679738562
"[0, 1, 0, 0, 1, 0, 1, 0, 0, 1, 1, 0, 1, 1, 0]",117,60,57,5,6,0.08333333333333333,0.10526315789473684
"[0, 1, 1, 0, 1, 1, 0, 0, 1, 0, 1, 1, 1, 0, 1]",116,44,72,3,8,0.06818181818181818,0.1111111111111111
"[1, 0, 1, 1, 0, 1, 0, 1, 1, 0, 1, 1, 0, 0, 1]",173,65,108,2,7,0.03076923076923077,0.06481481481481481
"[0, 0, 1, 1, 0, 0, 0, 1, 0, 1, 0, 1, 1, 0, 1]",126,67,59,6,5,0.08955223880597014,0.0847457627118644
"[1, 1, 1, 0, 1, 1, 1, 0, 0, 0, 0, 1, 0, 0, 1]",129,55,74,5,10,0.09090909090909091,0.13513513513513514
"[0, 0, 0, 0, 1, 1, 0, 0, 1, 1, 1, 0, 1, 0, 0]",266,164,102,22,13,0.13414634146341464,0.12745098039215685
"[0, 0, 1, 0, 1, 1, 1, 1, 0, 0, 1, 1, 0, 1, 0]",125,57,68,6,11,0.10526315789473684,0.16176470588235295
"[0, 1, 0, 0, 1, 1, 0, 1, 1, 1, 1, 1, 0, 0, 1]",181,70,111,9,7,0.12857142857142856,0.06306306306306306
"[1, 0, 1, 0, 0, 1, 1, 0, 1, 1, 1, 1, 0, 1, 1]",220,81,139,8,22,0.09876543209876543,0.15827338129496402
"[1, 0, 0, 0, 0, 0, 1, 1, 0, 1, 0, 0, 0, 1, 0]",254,152,102,15,9,0.09868421052631579,0.08823529411764706
"[0, 0, 0, 0, 1, 1, 0, 1, 1, 1, 1, 1, 1, 1, 0]",198,86,112,11,12,0.12790697674418605,0.10714285714285714
"[0, 0, 1, 1, 0, 1, 0, 1, 1, 1, 1, 0, 0, 0, 1]",136,66,70,7,10,0.10606060606060606,0.14285714285714285
"[1, 1, 1, 1, 1, 1, 0, 0, 0, 1, 0, 1, 1, 0, 1]",346,122,224,11,22,0.09016393442622951,0.09821428571428571
"[1, 1, 0, 0, 0, 0, 1, 1, 0, 1, 0, 0, 0, 1, 1]",214,122,92,13,10,0.10655737704918032,0.10869565217391304
"[0, 0, 0, 1, 0, 1, 1, 0, 0, 1, 1, 1, 1, 1, 0]",156,76,80,10,8,0.13157894736842105,0.1
"[1, 0, 1, 0, 1, 0, 1, 1, 1, 1, 0, 0, 1, 0, 0]",121,41,80,2,6,0.04878048780487805,0.075
"[1, 0, 1, 1, 1, 1, 0, 0, 0, 1, 0, 1, 0, 0, 0]",123,61,62,6,7,0.09836065573770492,0.11290322580645161
"[0, 0, 1, 0, 0, 1, 0, 1, 0, 1, 1, 1, 1, 0, 1]",103,45,58,5,3,0.1111111111111111,0.05172413793103448
"[1, 0, 1, 1, 1, 1, 0, 1, 1, 0, 1, 0, 1, 0, 1]",197,56,141,5,11,0.08928571428571429,0.07801418439716312
"[0, 1, 0, 0, 1, 0, 0, 0, 1, 1, 0, 1, 1, 1, 1]",128,63,65,9,10,0.14285714285714285,0.15384615384615385
"[0, 0, 1, 1, 0, 0, 1, 1, 0, 0, 0, 1, 0, 1, 0]",247,143,104,14,13,0.0979020979020979,0.125
"[0, 1, 1, 1, 0, 1, 0, 0, 0, 1, 1, 0, 0, 1, 1]",211,107,104,11,9,0.102803738317757,0.08653846153846154
"[0, 1, 1, 1, 0, 1, 0, 1, 0, 0, 1, 1, 0, 0, 1]",147,74,73,8,11,0.10810810810810811,0.1506849315068493
"[1, 0, 0, 1, 0, 1, 1, 1, 1, 0, 1, 0, 0, 0, 1]",123,48,75,2,7,0.041666666666666664,0.09333333333333334
"[0, 1, 0, 1, 0, 1, 1, 0, 0, 1, 0, 1, 0, 1, 1]",101,49,52,5,4,0.10204081632653061,0.07692307692307693
"[0, 0, 1, 0, 1, 1, 0, 1, 0, 1, 1, 0, 0, 1, 0]",103,60,43,2,6,0.03333333333333333,0.13953488372093023
"[1, 1, 0, 1, 1, 0, 1, 0, 0, 0, 1, 0, 1, 1, 0]",93,43,50,3,2,0.06976744186046512,0.04
"[1, 1, 0, 0, 0, 1, 0, 1, 0, 1, 1, 0, 1, 1, 0]",124,67,57,6,5,0.08955223880597014,0.08771929824561403
"[0, 1, 0, 0, 0, 1, 1, 1, 1, 1, 1, 0, 1, 1, 1]",330,129,201,14,18,0.10852713178294573,0.08955223880597014
"[0, 0, 0, 1, 0, 0, 1, 1, 1, 0, 0, 1, 1, 0, 1]",122,66,56,7,5,0.10606060606060606,0.08928571428571429
"[1, 1, 1, 1, 0, 0, 0, 1, 1, 1, 1, 0, 0, 0, 1]",198,67,131,12,16,0.1791044776119403,0.12213740458015267
"[0, 0, 1, 0, 1, 1, 0, 1, 1, 1, 0, 0, 1, 0, 1]",105,49,56,2,2,0.04081632653061224,0.03571428571428571
"[0, 1, 1, 0, 1, 1, 1, 1, 1, 0, 1, 0, 0, 1, 0]",143,57,86,4,9,0.07017543859649122,0.10465116279069768
"[0, 0, 1, 0, 1, 1, 0, 1, 1, 1, 1, 0, 1, 1, 0]",154,66,88,10,8,0.15151515151515152,0.09090909090909091
"[0, 0, 1, 1, 1, 0, 1, 1, 1, 1, 1, 0, 0, 1, 1]",396,146,250,17,20,0.11643835616438356,0.08
"[0, 1, 0, 1, 0, 1, 0, 1, 0, 0, 0, 1, 0, 0, 0]",208,133,75,13,8,0.09774436090225563,0.10666666666666667
"[1, 1, 0, 0, 1, 0, 0, 1, 0, 0, 1, 1, 0, 1, 1]",115,56,59,6,4,0.10714285714285714,0.06779661016949153
"[1, 0, 0, 1, 0, 1, 0, 0, 1, 0, 0, 0, 0, 0, 1]",262,168,94,11,8,0.06547619047619048,0.0851063829787234
"[0, 1, 0, 1, 1, 0, 1, 0, 0, 0, 0, 0, 1, 0, 1]",119,66,53,11,1,0.16666666666666666,0.018867924528301886
"[1, 0, 0, 1, 0, 1, 0, 1, 1, 0, 1, 0, 0, 0, 0]",140,71,69,3,8,0.04225352112676056,0.11594202898550725
"[0, 0, 0, 0, 1, 1, 0, 1, 0, 1, 1, 0, 1, 1, 1]",185,96,89,11,11,0.11458333333333333,0.12359550561797752
"[1, 0, 1, 0, 0, 1, 0, 0, 0, 0, 1, 1, 0, 1, 0]",167,87,80,10,5,0.11494252873563218,0.0625
"[1, 0, 0, 1, 0, 1, 1, 0, 1, 1, 1, 1, 1, 0, 0]",163,65,98,6,11,0.09230769230769231,0.11224489795918367
"[0, 1, 0, 1, 0, 1, 0, 0, 1, 0, 0, 0, 1, 0, 1]",134,77,57,7,5,0.09090909090909091,0.08771929824561403
"[0, 1, 0, 1, 0, 1, 0, 1, 0, 0, 1, 0, 0, 0, 1]",145,79,66,9,7,0.11392405063291139,0.10606060606060606
"[0, 1, 0, 1, 1, 1, 0, 0, 1, 0, 0, 1, 1, 0, 0]",135,79,56,11,7,0.13924050632911392,0.125
"[0, 1, 1, 1, 1, 0, 1, 0, 1, 1, 1, 0, 0, 1, 0]",160,61,99,4,8,0.06557377049180328,0.08080808080808081
"[0, 0, 1, 1, 1, 1, 0, 1, 0, 1, 1, 1, 0, 0, 1]",212,96,116,5,9,0.052083333333333336,0.07758620689655173
"[1, 1, 0, 1, 0, 1, 0, 1, 1, 0, 1, 1, 0, 0, 1]",171,67,104,5,8,0.07462686567164178,0.07692307692307693
"[1, 1, 0, 0, 0, 0, 1, 1, 1, 0, 0, 0, 1, 1, 1]",285,148,137,20,9,0.13513513513513514,0.06569343065693431
"[1, 0, 1, 1, 1, 1, 0, 0, 0, 0, 1, 1, 1, 0, 0]",155,67,88,6,13,0.08955223880597014,0.14772727272727273
"[0, 1, 0, 1, 0, 0, 1, 1, 0, 1, 1, 1, 0, 0, 0]",134,67,67,10,8,0.14925373134328357,0.11940298507462686
"[1, 0, 0, 0, 0, 1, 1, 1, 0, 1, 0, 1, 1, 0, 1]",136,56,80,6,8,0.10714285714285714,0.1
"[0, 0, 0, 1, 1, 1, 0, 0, 0, 1, 1, 0, 0, 1, 1]",212,130,82,16,6,0.12307692307692308,0.07317073170731707
"[0, 1, 1, 1, 1, 1, 0, 1, 0, 0, 0, 1, 1, 0, 1]",152,66,86,9,10,0.13636363636363635,0.11627906976744186
"[0, 0, 0, 1, 1, 1, 1, 0, 0, 1, 1, 1, 1, 1, 0]",422,305,117,36,6,0.1180327868852459,0.05128205128205128
"[0, 0, 1, 1, 0, 0, 0, 1, 0, 1, 0, 1, 0, 1, 1]",139,80,59,9,6,0.1125,0.1016949152542373
"[1, 1, 0, 0, 1, 1, 1, 1, 0, 0, 1, 0, 1, 0, 0]",212,108,104,8,8,0.07407407407407407,0.07692307692307693
"[1, 1, 0, 0, 0, 0, 1, 1, 1, 0, 1, 1, 1, 1, 0]",212,97,115,8,8,0.08247422680412371,0.06956521739130435
"[1, 1, 1, 0, 1, 0, 0, 1, 0, 1, 1, 0, 0, 1, 0]",108,60,48,8,9,0.13333333333333333,0.1875
"[0, 1, 1, 0, 1, 1, 0, 0, 0, 1, 1, 0, 1, 0, 0]",127,63,64,6,10,0.09523809523809523,0.15625
"[0, 0, 0, 1, 1, 0, 1, 1, 1, 1, 0, 1, 0, 0, 1]",142,75,67,4,9,0.05333333333333334,0.13432835820895522
"[0, 0, 0, 0, 1, 1, 1, 1, 0, 1, 0, 1, 0, 1, 0]",147,78,69,8,6,0.10256410256410256,0.08695652173913043
"[1, 0, 1, 1, 0, 1, 0, 0, 0, 0, 0, 1, 1, 0, 0]",225,128,97,15,9,0.1171875,0.09278350515463918
"[1, 0, 1, 0, 1, 0, 0, 0, 0, 1, 1, 0, 0, 0, 1]",156,84,72,5,6,0.05952380952380952,0.08333333333333333
"[0, 1, 1, 0, 1, 0, 1, 0, 0, 1, 1, 1, 0, 1, 0]",120,55,65,6,11,0.10909090909090909,0.16923076923076924
"[1, 0, 0, 0, 0, 0, 1, 0, 1, 0, 1, 0, 0, 1, 1]",180,107,73,7,7,0.06542056074766354,0.0958904109589041
"[1, 1, 0, 1, 0, 1, 1, 1, 1, 0, 0, 1, 0, 0, 0]",109,47,62,7,7,0.14893617021276595,0.11290322580645161
"[0, 0, 0, 1, 1, 1, 0, 1, 1, 0, 0, 0, 1, 0, 1]",115,67,48,1,4,0.014925373134328358,0.08333333333333333
"[0, 0, 1, 1, 1, 0, 1, 0, 1, 0, 1, 1, 0, 0, 1]",133,59,74,2,3,0.03389830508474576,0.04054054054054054
"[0, 0, 0, 1, 1, 1, 1, 0, 0, 1, 0, 0, 0, 0, 0]",440,339,101,36,8,0.10619469026548672,0.07920792079207921
"[1, 0, 1, 1, 1, 0, 1, 1, 1, 0, 0, 0, 1, 0, 1]",135,54,81,5,8,0.09259259259259259,0.09876543209876543
"[1, 0, 0, 1, 0, 1, 1, 1, 1, 0, 1, 1, 0, 0, 0]",117,56,61,5,5,0.08928571428571429,0.08196721311475409
"[1, 1, 0, 0, 0, 1, 1, 0, 1, 0, 1, 1, 0, 0, 0]",132,63,69,4,5,0.06349206349206349,0.07246376811594203
"[1, 1, 1, 0, 0, 0, 0, 1, 0, 0, 1, 1, 0, 0, 0]",261,135,126,13,8,0.0962962962962963,0.06349206349206349
"[1, 1, 0, 1, 0, 1, 1, 1, 1, 0, 0, 0, 1, 1, 0]",167,65,102,9,8,0.13846153846153847,0.0784313725490196
"[1, 1, 0, 1, 0, 1, 1, 1, 0, 1, 0, 1, 0, 1, 0]",134,66,68,8,5,0.12121212121212122,0.07352941176470588
"[0, 1, 1, 0, 1, 1, 0, 0, 1, 1, 1, 0, 1, 0, 0]",121,52,69,3,4,0.057692307692307696,0.057971014492753624
"[0, 1, 0, 1, 0, 0, 0, 1, 0, 1, 1, 1, 1, 1, 1]",195,83,112,9,9,0.10843373493975904,0.08035714285714286
"[0, 0, 0, 1, 0, 1, 0, 0, 0, 1, 0, 1, 1, 1, 1]",170,100,70,9,5,0.09,0.07142857142857142
"[0, 1, 1, 1, 0, 1, 1, 0, 1, 1, 0, 1, 0, 0, 1]",160,72,88,6,8,0.08333333333333333,0.09090909090909091
"[0, 1, 1, 0, 0, 1, 1, 1, 0, 1, 1, 1, 0, 1, 1]",288,133,155,10,12,0.07518796992481203,0.07741935483870968
"[0, 1, 1, 0, 0, 0, 1, 0, 1, 0, 1, 0, 0, 1, 1]",143,99,44,12,4,0.12121212121212122,0.09090909090909091
"[1, 0, 1, 1, 0, 0, 0, 1, 1, 1, 0, 0, 1, 1, 1]",228,98,130,10,11,0.10204081632653061,0.08461538461538462
"[1, 0, 0, 1, 0, 1, 0, 0, 0, 1, 1, 1, 0, 1, 0]",114,60,54,2,6,0.03333333333333333,0.1111111111111111
"[0, 0, 1, 1, 1, 1, 0, 0, 0, 0, 1, 0, 0, 0, 1]",304,191,113,20,13,0.10471204188481675,0.11504424778761062
"[1, 1, 0, 0, 1, 0, 0, 1, 1, 1, 0, 0, 0, 1, 1]",161,78,83,9,6,0.11538461538461539,0.07228915662650602
"[0, 0, 0, 1, 0, 0, 1, 1, 1, 1, 0, 0, 1, 1, 1]",314,158,156,16,11,0.10126582278481013,0.07051282051282051
"[1, 1, 0, 0, 0, 0, 1, 1, 0, 1, 0, 1, 0, 1, 0]",160,68,92,5,7,0.07352941176470588,0.07608695652173914
"[1, 0, 1, 1, 0, 1, 0, 0, 1, 0, 0, 0, 0, 1, 0]",135,84,51,9,5,0.10714285714285714,0.09803921568627451
"[1, 0, 1, 0, 0, 1, 0, 0, 0, 1, 1, 0, 1, 0, 0]",145,84,61,11,5,0.13095238095238096,0.08196721311475409
"[1, 0, 0, 1, 1, 1, 1, 1, 0, 0, 0, 1, 1, 0, 1]",217,78,139,6,11,0.07692307692307693,0.07913669064748201
"[1, 1, 0, 1, 1, 0, 0, 1, 0, 1, 0, 0, 0, 1, 1]",132,68,64,11,3,0.16176470588235295,0.046875
"[1, 1, 1, 1, 1, 1, 1, 0, 0, 0, 1, 0, 1, 0, 0]",246,79,167,4,15,0.05063291139240506,0.08982035928143713
"[1, 1, 1, 1, 0, 1, 1, 0, 0, 0, 1, 0, 1, 0, 0]",113,50,63,5,2,0.1,0.031746031746031744
"[1, 1, 0, 1, 0, 0, 0, 1, 0, 0, 1, 1, 1, 0, 1]",90,41,49,9,3,0.21951219512195122,0.061224489795918366
"[1, 1, 0, 1, 1, 1, 1, 0, 0, 1, 0, 1, 0, 0, 1]",150,63,87,3,3,0.047619047619047616,0.034482758620689655
"[0, 0, 0, 1, 0, 1, 1, 1, 1, 0, 1, 0, 0, 0, 0]",140,79,61,10,7,0.12658227848101267,0.11475409836065574
"[1, 0, 0, 1, 0, 0, 0, 1, 0, 0, 1, 0, 1, 1, 0]",138,69,69,5,8,0.07246376811594203,0.11594202898550725
"[1, 1, 0, 1, 1, 0, 1, 1, 0, 1, 1, 0, 1, 0, 0]",149,73,76,10,9,0.136986301369863,0.11842105263157894
"[0, 1, 0, 1, 0, 0, 0, 1, 1, 0, 1, 0, 1, 1, 0]",101,54,47,6,4,0.1111111111111111,0.0851063829787234
"[1, 0, 1, 0, 0, 0, 1, 0, 1, 0, 0, 1, 1, 1, 1]",157,76,81,6,6,0.07894736842105263,0.07407407407407407
"[0, 1, 0, 0, 1, 0, 0, 1, 1, 0, 1, 0, 1, 1, 0]",126,63,63,7,4,0.1111111111111111,0.06349206349206349
"[0, 0, 0, 1, 0, 0, 1, 1, 1, 0, 1, 0, 1, 1, 1]",106,54,52,3,5,0.05555555555555555,0.09615384615384616
"[1, 0, 1, 1, 1, 1, 1, 0, 1, 0, 1, 0, 1, 1, 0]",213,88,125,4,8,0.045454545454545456,0.064
"[0, 0, 0, 1, 0, 1, 0, 1, 0, 1, 1, 0, 0, 1, 1]",150,89,61,8,11,0.0898876404494382,0.18032786885245902
"[1, 1, 0, 0, 0, 1, 0, 1, 0, 0, 1, 1, 0, 1, 0]",114,53,61,3,4,0.05660377358490566,0.06557377049180328
"[0, 0, 1, 1, 1, 1, 0, 1, 1, 1, 0, 0, 1, 0, 1]",152,62,90,3,10,0.04838709677419355,0.1111111111111111
"[1, 1, 0, 0, 0, 0, 1, 0, 1, 1, 0, 0, 1, 0, 1]",134,72,62,9,5,0.125,0.08064516129032258
"[0, 0, 0, 1, 1, 1, 0, 1, 1, 0, 0, 0, 1, 0, 0]",156,107,49,16,2,0.14953271028037382,0.04081632653061224
"[1, 1, 0, 0, 1, 0, 0, 1, 1, 0, 1, 0, 0, 1, 0]",111,58,53,7,2,0.1206896551724138,0.03773584905660377
"[1, 1, 1, 1, 0, 0, 1, 1, 0, 1, 0, 0, 1, 0, 0]",145,72,73,9,5,0.125,0.0684931506849315
"[1, 1, 0, 0, 0, 0, 1, 1, 0, 0, 0, 1, 1, 1, 0]",181,91,90,8,10,0.08791208791208792,0.1111111111111111
"[0, 0, 1, 1, 0, 1, 1, 0, 0, 1, 0, 0, 1, 0, 1]",118,64,54,1,8,0.015625,0.14814814814814814
"[1, 1, 1, 0, 0, 0, 0, 0, 1, 1, 0, 1, 1, 0, 0]",174,78,96,5,11,0.0641025641025641,0.11458333333333333
"[1, 0, 1, 0, 0, 0, 1, 1, 1, 1, 0, 0, 0, 1, 1]",150,69,81,7,7,0.10144927536231885,0.08641975308641975
"[1, 0, 0, 0, 1, 1, 1, 1, 1, 0, 0, 0, 0, 1, 0]",129,60,69,7,5,0.11666666666666667,0.07246376811594203
"[0, 0, 1, 0, 0, 1, 1, 0, 1, 0, 0, 0, 0, 1, 1]",213,132,81,9,8,0.06818181818181818,0.09876543209876543
"[0, 1, 0, 0, 0, 1, 1, 1, 0, 1, 0, 0, 1, 0, 1]",95,56,39,5,5,0.08928571428571429,0.1282051282051282
"[1, 1, 0, 0, 0, 1, 1, 1, 1, 0, 0, 1, 0, 1, 0]",116,54,62,5,9,0.09259259259259259,0.14516129032258066
"[1, 0, 1, 0, 1, 0, 0, 0, 1, 1, 1, 1, 0, 0, 0]",178,89,89,9,9,0.10112359550561797,0.10112359550561797
"[1, 0, 0, 0, 1, 1, 1, 0, 1, 1, 0, 0, 1, 1, 1]",222,79,143,7,14,0.08860759493670886,0.0979020979020979
"[1, 0, 1, 0, 1, 1, 1, 1, 1, 1, 0, 0, 0, 0, 0]",286,131,155,12,18,0.0916030534351145,0.11612903225806452
"[0, 0, 0, 1, 0, 1, 1, 0, 1, 1, 1, 1, 1, 1, 0]",192,92,100,9,12,0.09782608695652174,0.12
"[1, 1, 0, 0, 0, 0, 1, 1, 1, 1, 0, 1, 0, 0, 1]",239,123,116,10,7,0.08130081300813008,0.0603448275862069
"[0, 0, 0, 1, 1, 0, 1, 1, 0, 1, 0, 1, 1, 0, 1]",97,53,44,4,4,0.07547169811320754,0.09090909090909091
"[1, 1, 1, 0, 1, 1, 0, 1, 1, 0, 0, 1, 0, 0, 1]",174,76,98,7,8,0.09210526315789473,0.08163265306122448
"[0, 1, 0, 0, 0, 0, 1, 1, 0, 1, 1, 0, 1, 0, 1]",99,51,48,1,6,0.0196078431372549,0.125
"[0, 1, 1, 1, 1, 0, 1, 0, 1, 1, 0, 0, 0, 0, 0]",184,94,90,6,11,0.06382978723404255,0.12222222222222222
"[1, 1, 1, 0, 1, 0, 0, 1, 1, 0, 0, 1, 1, 0, 1]",161,70,91,6,6,0.08571428571428572,0.06593406593406594
"[0, 0, 0, 1, 1, 0, 0, 1, 1, 1, 0, 0, 1, 1, 1]",347,243,104,22,10,0.09053497942386832,0.09615384615384616
"[1, 1, 0, 1, 0, 0, 1, 1, 0, 0, 1, 0, 0, 0, 0]",153,100,53,3,2,0.03,0.03773584905660377
"[0, 1, 0, 1, 0, 1, 0, 0, 1, 0, 1, 0, 1, 1, 1]",133,69,64,6,4,0.08695652173913043,0.0625
"[0, 0, 0, 0, 1, 0, 0, 1, 1, 0, 0, 1, 0, 1, 0]",243,157,86,19,7,0.12101910828025478,0.08139534883720931
"[1, 1, 0, 1, 0, 0, 1, 0, 1, 1, 0, 1, 0, 1, 1]",126,56,70,5,11,0.08928571428571429,0.15714285714285714
"[0, 1, 1, 0, 1, 0, 0, 1, 0, 1, 1, 0, 1, 0, 1]",98,44,54,4,6,0.09090909090909091,0.1111111111111111
"[1, 1, 0, 0, 0, 1, 0, 1, 1, 1, 0, 0, 1, 1, 0]",163,91,72,9,6,0.0989010989010989,0.08333333333333333
"[0, 0, 1, 0, 1, 1, 1, 1, 0, 0, 0, 0, 0, 1, 0]",163,90,73,13,5,0.14444444444444443,0.0684931506849315
"[1, 1, 1, 0, 1, 0, 1, 0, 0, 0, 0, 1, 0, 1, 0]",116,56,60,5,3,0.08928571428571429,0.05
"[0, 0, 1, 1, 1, 0, 0, 0, 0, 1, 0, 1, 0, 0, 1]",170,109,61,12,6,0.11009174311926606,0.09836065573770492
"[0, 1, 1, 1, 0, 1, 0, 1, 1, 0, 0, 1, 1, 1, 0]",138,62,76,6,6,0.0967741935483871,0.07894736842105263
"[0, 1, 0, 1, 1, 0, 0, 1, 1, 1, 0, 0, 0, 1, 0]",128,62,66,5,2,0.08064516129032258,0.030303030303030304
"[1, 1, 1, 0, 0, 1, 0, 0, 1, 1, 0, 0, 1, 1, 0]",205,90,115,7,9,0.07777777777777778,0.0782608695652174
"[0, 0, 1, 1, 1, 0, 0, 1, 0, 0, 0, 1, 0, 1, 1]",144,77,67,9,4,0.11688311688311688,0.05970149253731343
"[1, 1, 1, 1, 0, 0, 0, 1, 0, 1, 0, 0, 1, 0, 0]",136,67,69,9,10,0.13432835820895522,0.14492753623188406
"[1, 0, 1, 1, 1, 0, 1, 0, 1, 1, 0, 1, 1, 1, 0]",231,81,150,3,15,0.037037037037037035,0.1
"[1, 1, 1, 1, 1, 0, 0, 1, 1, 0, 1, 1, 0, 1, 0]",279,86,193,10,12,0.11627906976744186,0.06217616580310881
"[0, 1, 0, 0, 0, 1, 1, 0, 1, 0, 0, 0, 1, 1, 0]",172,111,61,6,7,0.05405405405405406,0.11475409836065574
"[0, 0, 1, 0, 0, 0, 1, 1, 0, 1, 1, 0, 1, 0, 0]",142,75,67,10,6,0.13333333333333333,0.08955223880597014
"[1, 0, 0, 1, 1, 0, 0, 1, 0, 1, 1, 1, 0, 0, 1]",136,61,75,7,8,0.11475409836065574,0.10666666666666667
"[1, 1, 1, 0, 1, 0, 1, 0, 0, 1, 1, 0, 0, 1, 0]",115,55,60,5,6,0.09090909090909091,0.1
"[1, 1, 1, 0, 1, 0, 1, 0, 1, 0, 1, 0, 1, 1, 1]",276,96,180,5,10,0.052083333333333336,0.05555555555555555
"[0, 0, 0, 1, 1, 1, 0, 1, 0, 1, 0, 1, 0, 1, 0]",115,60,55,6,7,0.1,0.12727272727272726
"[0, 0, 1, 0, 1, 1, 1, 1, 0, 1, 0, 0, 1, 0, 1]",98,49,49,3,8,0.061224489795918366,0.16326530612244897
"[1, 1, 0, 1, 0, 0, 0, 1, 0, 0, 1, 1, 0, 0, 0]",183,105,78,14,7,0.13333333333333333,0.08974358974358974
"[1, 0, 0, 1, 0, 1, 0, 0, 1, 1, 1, 0, 0, 1, 0]",98,52,46,7,8,0.1346153846153846,0.17391304347826086
"[1, 1, 1, 0, 1, 0, 1, 0, 0, 0, 1, 1, 0, 1, 1]",145,58,87,4,8,0.06896551724137931,0.09195402298850575
"[0, 1, 0, 0, 0, 0, 0, 1, 1, 1, 1, 0, 0, 0, 1]",194,121,73,9,6,0.0743801652892562,0.0821917808219178
"[0, 0, 1, 0, 0, 1, 1, 1, 0, 1, 0, 1, 0, 0, 1]",98,45,53,6,6,0.13333333333333333,0.11320754716981132
"[1, 1, 0, 0, 1, 0, 0, 1, 1, 1, 0, 1, 0, 1, 0]",99,46,53,6,3,0.13043478260869565,0.05660377358490566
"[0, 1, 0, 1, 1, 0, 0, 0, 0, 1, 1, 1, 0, 1, 0]",117,55,62,6,6,0.10909090909090909,0.0967741935483871
"[0, 1, 1, 0, 1, 1, 1, 1, 0, 0, 1, 0, 0, 1, 0]",112,53,59,3,5,0.05660377358490566,0.0847457627118644
"[0, 1, 0, 1, 1, 1, 0, 0, 1, 0, 1, 0, 1, 0, 0]",117,66,51,6,5,0.09090909090909091,0.09803921568627451
"[0, 1, 1, 1, 0, 1, 0, 0, 0, 1, 0, 0, 1, 1, 0]",138,85,53,12,3,0.1411764705882353,0.05660377358490566
"[0, 1, 1, 0, 0, 0, 1, 0, 0, 0, 1, 1, 0, 1, 1]",124,70,54,7,5,0.1,0.09259259259259259
"[1, 0, 1, 0, 0, 1, 1, 0, 0, 0, 1, 1, 1, 1, 1]",233,98,135,10,13,0.10204081632653061,0.0962962962962963
"[1, 1, 0, 0, 1, 1, 0, 1, 0, 0, 0, 1, 1, 0, 1]",107,50,57,5,5,0.1,0.08771929824561403
"[1, 1, 1, 1, 0, 1, 1, 0, 0, 1, 1, 0, 1, 0, 0]",158,55,103,2,10,0.03636363636363636,0.0970873786407767
"[0, 0, 0, 1, 0, 1, 0, 1, 1, 1, 1, 0, 1, 0, 0]",122,63,59,9,9,0.14285714285714285,0.15254237288135594
"[1, 1, 0, 0, 0, 1, 0, 0, 0, 1, 1, 1, 1, 0, 0]",203,105,98,6,9,0.05714285714285714,0.09183673469387756
"[0, 0, 1, 1, 0, 1, 0, 0, 0, 0, 1, 0, 1, 1, 1]",154,78,76,6,9,0.07692307692307693,0.11842105263157894
"[1, 1, 1, 1, 0, 1, 0, 0, 0, 1, 0, 0, 0, 1, 1]",136,72,64,4,5,0.05555555555555555,0.078125
"[1, 0, 1, 1, 0, 0, 1, 0, 1, 1, 0, 1, 0, 0, 1]",104,56,48,5,6,0.08928571428571429,0.125
"[1, 0, 1, 0, 0, 1, 1, 0, 1, 0, 1, 1, 0, 1, 1]",124,50,74,2,8,0.04,0.10810810810810811
"[1, 1, 1, 1, 0, 0, 0, 0, 1, 1, 0, 1, 0, 1, 1]",374,156,218,16,23,0.10256410256410256,0.10550458715596331
"[1, 1, 0, 0, 0, 0, 0, 1, 1, 0, 1, 1, 1, 1, 0]",168,77,91,8,9,0.1038961038961039,0.0989010989010989
"[1, 0, 1, 1, 0, 0, 0, 0, 0, 1, 0, 0, 1, 1, 1]",161,85,76,11,11,0.12941176470588237,0.14473684210526316
"[0, 1, 0, 1, 0, 1, 0, 0, 0, 0, 1, 0, 0, 1, 0]",193,128,65,13,11,0.1015625,0.16923076923076924
"[0, 1, 1, 1, 0, 1, 1, 1, 1, 0, 0, 0, 1, 1, 0]",164,54,110,5,7,0.09259259259259259,0.06363636363636363
"[0, 1, 0, 1, 1, 1, 0, 0, 0, 1, 1, 1, 0, 0, 0]",129,70,59,9,5,0.12857142857142856,0.0847457627118644
"[0, 0, 1, 0, 1, 1, 0, 1, 1, 1, 0, 1, 0, 1, 0]",88,47,41,2,0,0.0425531914893617,0.0
"[1, 1, 1, 0, 1, 1, 1, 0, 0, 0, 0, 0, 0, 1, 0]",132,76,56,7,5,0.09210526315789473,0.08928571428571429
"[0, 1, 1, 0, 0, 0, 0, 1, 0, 1, 1, 1, 0, 1, 0]",123,75,48,7,8,0.09333333333333334,0.16666666666666666
"[1, 1, 1, 0, 0, 1, 0, 0, 0, 0, 1, 0, 0, 0, 1]",158,88,70,11,9,0.125,0.12857142857142856
"[1, 0, 1, 0, 1, 0, 1, 0, 0, 1, 1, 1, 1, 0, 0]",197,93,104,10,13,0.10752688172043011,0.125
"[0, 1, 1, 1, 1, 0, 1, 0, 1, 0, 1, 0, 1, 0, 1]",153,59,94,6,6,0.1016949152542373,0.06382978723404255
"[1, 1, 1, 0, 1, 1, 1, 0, 1, 0, 0, 1, 0, 1, 0]",134,56,78,6,9,0.10714285714285714,0.11538461538461539
"[1, 1, 1, 1, 1, 1, 0, 1, 0, 1, 0, 1, 0, 0, 0]",167,64,103,4,15,0.0625,0.14563106796116504
"[1, 1, 0, 1, 1, 0, 1, 0, 1, 1, 1, 0, 1, 0, 1]",227,72,155,4,13,0.05555555555555555,0.08387096774193549
"[1, 0, 1, 0, 0, 1, 0, 0, 0, 0, 1, 1, 1, 0, 1]",124,68,56,1,5,0.014705882352941176,0.08928571428571429
"[0, 0, 0, 1, 1, 0, 1, 1, 1, 0, 1, 0, 0, 0, 1]",103,65,38,6,3,0.09230769230769231,0.07894736842105263
"[0, 1, 1, 0, 1, 1, 1, 1, 0, 1, 1, 1, 0, 0, 0]",178,59,119,5,8,0.0847457627118644,0.06722689075630252
"[1, 0, 1, 0, 1, 0, 0, 0, 1, 0, 0, 0, 0, 0, 1]",243,160,83,10,12,0.0625,0.14457831325301204
"[1, 1, 0, 1, 1, 1, 1, 1, 0, 1, 0, 0, 1, 0, 1]",240,88,152,6,17,0.06818181818181818,0.1118421052631579
"[1, 1, 0, 0, 0, 1, 1, 1, 0, 0, 1, 0, 0, 1, 0]",116,63,53,6,4,0.09523809523809523,0.07547169811320754
"[0, 0, 0, 1, 1, 0, 0, 0, 1, 1, 1, 0, 0, 1, 0]",161,109,52,11,5,0.10091743119266056,0.09615384615384616
"[0, 1, 1, 1, 0, 0, 0, 1, 0, 0, 0, 0, 1, 0, 1]",140,85,55,6,4,0.07058823529411765,0.07272727272727272
"[1, 0, 0, 1, 0, 1, 1, 1, 0, 0, 1, 0, 0, 1, 0]",106,56,50,5,5,0.08928571428571429,0.1
"[0, 1, 0, 0, 0, 0, 0, 0, 1, 1, 1, 0, 0, 0, 1]",298,191,107,14,10,0.07329842931937172,0.09345794392523364
"[0, 0, 1, 1, 0, 1, 1, 0, 0, 0, 1, 1, 1, 0, 0]",138,80,58,13,5,0.1625,0.08620689655172414
"[1, 0, 1, 1, 0, 1, 0, 0, 0, 1, 0, 1, 0, 1, 0]",102,55,47,6,2,0.10909090909090909,0.0425531914893617
"[1, 1, 1, 0, 1, 0, 0, 1, 0, 0, 0, 1, 0, 1, 1]",140,70,70,8,4,0.11428571428571428,0.05714285714285714
"[1, 0, 1, 0, 1, 0, 1, 0, 1, 0, 0, 0, 0, 1, 0]",126,71,55,9,5,0.1267605633802817,0.09090909090909091
"[0, 1, 1, 1, 0, 1, 0, 1, 0, 0, 1, 0, 1, 0, 0]",98,47,51,6,6,0.1276595744680851,0.11764705882352941
"[1, 1, 0, 0, 1, 1, 0, 1, 0, 0, 0, 0, 1, 0, 0]",170,98,72,8,11,0.08163265306122448,0.1527777777777778
"[1, 0, 1, 0, 1, 1, 0, 1, 0, 1, 0, 0, 1, 1, 1]",167,76,91,7,10,0.09210526315789473,0.10989010989010989
"[0, 0, 1, 0, 0, 1, 0, 1, 0, 1, 0, 1, 0, 0, 1]",139,88,51,8,5,0.09090909090909091,0.09803921568627451
"[1, 0, 0, 0, 0, 0, 1, 1, 0, 1, 1, 1, 0, 1, 0]",114,55,59,2,9,0.03636363636363636,0.15254237288135594
"[1, 1, 0, 1, 0, 0, 1, 1, 1, 1, 0, 0, 1, 0, 0]",133,63,70,7,7,0.1111111111111111,0.1
"[1, 0, 1, 0, 1, 0, 0, 1, 1, 0, 1, 1, 1, 1, 0]",142,62,80,7,5,0.11290322580645161,0.0625
"[1, 0, 1, 1, 1, 1, 1, 0, 0, 1, 0, 0, 0, 1, 0]",94,39,55,6,7,0.15384615384615385,0.12727272727272726
"[1, 0, 0, 1, 1, 0, 0, 1, 1, 1, 0, 1, 1, 1, 0]",202,70,132,7,8,0.1,0.06060606060606061
"[1, 0, 1, 1, 1, 0, 0, 1, 0, 0, 0, 0, 0, 1, 0]",137,88,49,13,4,0.14772727272727273,0.08163265306122448
"[0, 0, 0, 1, 1, 0, 0, 1, 1, 1, 1, 0, 1, 1, 1]",445,306,139,34,8,0.1111111111111111,0.05755395683453238
"[1, 0, 0, 0, 1, 1, 0, 0, 1, 1, 1, 1, 0, 1, 1]",216,101,115,10,11,0.09900990099009901,0.09565217391304348
"[0, 0, 0, 0, 1, 1, 1, 0, 0, 0, 0, 1, 1, 0, 1]",228,140,88,14,10,0.1,0.11363636363636363
"[1, 1, 0, 1, 0, 0, 0, 0, 1, 0, 1, 0, 1, 0, 0]",139,75,64,6,3,0.08,0.046875
"[1, 0, 1, 1, 0, 1, 0, 1, 1, 0, 0, 1, 0, 0, 1]",114,55,59,6,7,0.10909090909090909,0.11864406779661017
"[1, 1, 0, 1, 1, 0, 0, 0, 1, 1, 0, 0, 1, 1, 0]",210,98,112,9,12,0.09183673469387756,0.10714285714285714
"[1, 1, 0, 1, 0, 0, 1, 0, 0, 0, 0, 0, 0, 1, 0]",234,146,88,14,12,0.0958904109589041,0.13636363636363635
"[0, 0, 1, 1, 1, 1, 1, 0, 0, 0, 1, 0, 0, 0, 0]",185,107,78,8,8,0.07476635514018691,0.10256410256410256
"[1, 1, 0, 0, 1, 0, 1, 0, 1, 1, 1, 1, 1, 0, 0]",207,89,118,10,9,0.11235955056179775,0.07627118644067797
"[0, 1, 1, 1, 0, 0, 1, 0, 1, 1, 0, 0, 1, 0, 1]",95,54,41,7,5,0.12962962962962962,0.12195121951219512
"[0, 0, 1, 0, 1, 0, 1, 0, 1, 1, 1, 1, 1, 0, 1]",129,46,83,8,2,0.17391304347826086,0.024096385542168676
"[0, 1, 1, 1, 0, 0, 1, 0, 1, 0, 0, 1, 1, 1, 1]",223,111,112,5,8,0.04504504504504504,0.07142857142857142
"[1, 1, 0, 0, 0, 1, 0, 1, 0, 1, 0, 1, 1, 0, 0]",119,63,56,8,5,0.12698412698412698,0.08928571428571429
"[1, 1, 0, 0, 1, 0, 1, 0, 0, 1, 0, 0, 0, 1, 0]",134,84,50,8,5,0.09523809523809523,0.1
"[0, 1, 0, 1, 1, 1, 1, 0, 1, 1, 1, 0, 0, 0, 0]",164,74,90,6,9,0.08108108108108109,0.1
"[0, 1, 1, 0, 0, 0, 0, 1, 0, 1, 1, 1, 0, 0, 1]",147,81,66,9,8,0.1111111111111111,0.12121212121212122
"[1, 0, 0, 1, 1, 0, 0, 0, 0, 0, 1, 1, 0, 1, 1]",217,81,136,7,14,0.08641975308641975,0.10294117647058823
"[0, 0, 0, 0, 0, 1, 1, 0, 1, 1, 0, 1, 1, 1, 0]",139,83,56,11,5,0.13253012048192772,0.08928571428571429
"[1, 1, 1, 0, 1, 0, 1, 1, 0, 1, 0, 1, 0, 1, 0]",138,53,85,5,7,0.09433962264150944,0.08235294117647059
"[1, 0, 0, 0, 1, 1, 1, 1, 1, 1, 0, 0, 1, 0, 0]",135,66,69,8,3,0.12121212121212122,0.043478260869565216
"[0, 0, 0, 1, 1, 0, 1, 1, 0, 1, 1, 0, 0, 1, 0]",88,57,31,5,2,0.08771929824561403,0.06451612903225806
"[0, 1, 0, 0, 1, 1, 0, 0, 1, 1, 0, 0, 1, 0, 0]",205,114,91,13,7,0.11403508771929824,0.07692307692307693
"[1, 1, 0, 0, 0, 1, 1, 1, 1, 1, 0, 0, 0, 1, 0]",123,57,66,2,11,0.03508771929824561,0.16666666666666666
"[0, 1, 1, 0, 1, 0, 1, 0, 1, 0, 0, 1, 0, 0, 1]",110,57,53,5,4,0.08771929824561403,0.07547169811320754
"[1, 1, 1, 0, 1, 0, 0, 1, 0, 0, 1, 0, 1, 0, 1]",102,42,60,2,5,0.047619047619047616,0.08333333333333333
"[1, 1, 1, 0, 1, 1, 1, 0, 1, 0, 0, 1, 0, 0, 1]",137,43,94,5,8,0.11627906976744186,0.0851063829787234
"[1, 1, 1, 1, 0, 0, 0, 1, 0, 0, 0, 1, 1, 0, 1]",136,71,65,6,2,0.08450704225352113,0.03076923076923077
"[0, 0, 0, 0, 0, 1, 0, 1, 1, 0, 0, 1, 1, 0, 1]",169,98,71,14,2,0.14285714285714285,0.028169014084507043
"[1, 1, 1, 1, 0, 0, 0, 1, 0, 0, 0, 1, 1, 1, 0]",123,61,62,4,5,0.06557377049180328,0.08064516129032258
"[1, 0, 0, 0, 0, 1, 1, 1, 0, 0, 1, 0, 0, 1, 0]",172,88,84,4,11,0.045454545454545456,0.13095238095238096
"[1, 0, 0, 0, 1, 0, 1, 1, 1, 0, 1, 1, 1, 0, 0]",125,62,63,6,6,0.0967741935483871,0.09523809523809523
"[0, 1, 0, 1, 0, 0, 1, 0, 1, 1, 1, 1, 1, 0, 1]",134,54,80,8,8,0.14814814814814814,0.1
"[1, 0, 1, 0, 1, 0, 1, 1, 0, 0, 0, 1, 1, 0, 0]",147,75,72,6,2,0.08,0.027777777777777776
"[1, 0, 0, 1, 0, 0, 1, 0, 1, 1, 1, 1, 1, 1, 0]",156,63,93,2,8,0.031746031746031744,0.08602150537634409
"[1, 1, 1, 1, 0, 1, 0, 0, 0, 0, 1, 1, 0, 1, 0]",118,53,65,4,5,0.07547169811320754,0.07692307692307693
"[1, 0, 0, 1, 1, 0, 0, 0, 1, 1, 1, 0, 1, 1, 0]",114,43,71,2,6,0.046511627906976744,0.08450704225352113
"[0, 1, 0, 1, 0, 1, 0, 0, 1, 0, 0, 1, 1, 0, 1]",98,61,37,6,4,0.09836065573770492,0.10810810810810811
"[1, 1, 1, 0, 1, 1, 0, 1, 1, 1, 0, 0, 0, 1, 0]",131,57,74,5,7,0.08771929824561403,0.0945945945945946
"[0, 1, 0, 1, 0, 0, 0, 1, 0, 0, 0, 1, 1, 0, 0]",296,188,108,12,13,0.06382978723404255,0.12037037037037036
"[1, 0, 1, 0, 1, 0, 0, 0, 1, 0, 0, 0, 1, 1, 0]",155,93,62,8,8,0.08602150537634409,0.12903225806451613
"[0, 1, 0, 1, 1, 1, 1, 0, 0, 1, 1, 1, 0, 1, 0]",154,62,92,5,9,0.08064516129032258,0.09782608695652174
"[0, 1, 1, 1, 1, 1, 0, 0, 1, 1, 1, 0, 0, 0, 1]",185,82,103,7,8,0.08536585365853659,0.07766990291262135
"[1, 0, 0, 1, 1, 1, 1, 0, 1, 0, 0, 0, 1, 1, 0]",143,55,88,9,6,0.16363636363636364,0.06818181818181818
"[0, 1, 1, 1, 1, 0, 1, 0, 1, 0, 0, 0, 1, 1, 1]",190,84,106,13,13,0.15476190476190477,0.12264150943396226
"[0, 0, 1, 0, 1, 0, 0, 0, 1, 1, 0, 1, 1, 0, 1]",114,56,58,1,6,0.017857142857142856,0.10344827586206896
"[1, 0, 0, 1, 1, 1, 1, 0, 1, 0, 1, 0, 1, 1, 0]",146,57,89,4,8,0.07017543859649122,0.0898876404494382
"[0, 0, 1, 0, 1, 0, 0, 1, 0, 0, 0, 0, 1, 1, 1]",276,170,106,21,8,0.12352941176470589,0.07547169811320754
"[1, 0, 0, 0, 1, 1, 0, 0, 1, 1, 1, 0, 0, 1, 0]",120,65,55,5,4,0.07692307692307693,0.07272727272727272
"[1, 1, 1, 1, 0, 1, 1, 0, 0, 0, 1, 0, 1, 1, 0]",156,64,92,6,12,0.09375,0.13043478260869565
"[0, 1, 1, 1, 0, 0, 1, 0, 0, 0, 1, 0, 0, 0, 1]",136,81,55,16,5,0.19753086419753085,0.09090909090909091
"[0, 1, 0, 1, 1, 0, 1, 0, 0, 1, 0, 0, 1, 1, 0]",121,71,50,6,11,0.08450704225352113,0.22
"[0, 1, 0, 0, 0, 0, 0, 1, 0, 0, 1, 0, 1, 1, 0]",236,160,76,14,9,0.0875,0.11842105263157894
"[1, 0, 0, 1, 1, 0, 1, 0, 0, 0, 1, 0, 1, 1, 0]",94,52,42,3,2,0.057692307692307696,0.047619047619047616
"[1, 0, 1, 1, 0, 0, 1, 1, 0, 1, 1, 0, 0, 0, 0]",143,73,70,12,3,0.1643835616438356,0.04285714285714286
"[0, 1, 0, 1, 1, 0, 0, 1, 1, 0, 1, 1, 0, 0, 0]",116,56,60,5,4,0.08928571428571429,0.06666666666666667
"[0, 1, 0, 1, 0, 1, 0, 0, 0, 0, 1, 1, 0, 1, 1]",126,76,50,8,5,0.10526315789473684,0.1
"[1, 0, 0, 1, 0, 1, 0, 0, 0, 1, 1, 0, 1, 1, 1]",129,59,70,3,11,0.05084745762711865,0.15714285714285714
"[1, 1, 0, 0, 1, 0, 1, 1, 0, 0, 0, 0, 0, 1, 0]",146,90,56,10,6,0.1111111111111111,0.10714285714285714
"[1, 0, 0, 1, 0, 1, 1, 0, 1, 0, 0, 1, 0, 1, 0]",89,42,47,4,4,0.09523809523809523,0.0851063829787234
"[1, 1, 0, 1, 1, 1, 0, 1, 0, 0, 1, 0, 1, 0, 1]",136,50,86,4,11,0.08,0.12790697674418605
"[1, 0, 0, 1, 0, 1, 1, 0, 0, 0, 1, 0, 0, 0, 1]",135,81,54,4,8,0.04938271604938271,0.14814814814814814
"[1, 0, 1, 0, 1, 1, 1, 0, 1, 0, 1, 1, 0, 0, 1]",181,86,95,7,7,0.08139534883720931,0.07368421052631578
"[0, 1, 0, 1, 0, 0, 1, 0, 1, 1, 0, 1, 0, 1, 1]",111,52,59,6,5,0.11538461538461539,0.0847457627118644
"[0, 1, 0, 1, 1, 0, 0, 1, 1, 0, 1, 0, 0, 1, 0]",118,56,62,1,5,0.017857142857142856,0.08064516129032258
"[0, 0, 0, 1, 1, 0, 0, 0, 1, 1, 0, 1, 0, 1, 1]",158,103,55,8,3,0.07766990291262135,0.05454545454545454
"[1, 0, 1, 0, 0, 1, 0, 1, 0, 1, 1, 0, 1, 1, 0]",115,55,60,4,7,0.07272727272727272,0.11666666666666667
"[0, 1, 1, 1, 1, 0, 1, 0, 0, 0, 0, 0, 1, 0, 1]",130,77,53,10,4,0.12987012987012986,0.07547169811320754
"[1, 1, 1, 1, 1, 1, 0, 1, 0, 1, 0, 0, 0, 1, 0]",150,57,93,5,7,0.08771929824561403,0.07526881720430108
"[0, 1, 0, 1, 1, 0, 1, 1, 1, 0, 1, 0, 1, 1, 1]",243,80,163,7,9,0.0875,0.05521472392638037
"[1, 0, 0, 1, 0, 0, 0, 1, 1, 0, 1, 0, 0, 0, 1]",153,83,70,11,6,0.13253012048192772,0.08571428571428572
"[1, 1, 0, 1, 1, 0, 1, 0, 0, 1, 0, 0, 0, 1, 0]",102,61,41,4,3,0.06557377049180328,0.07317073170731707
"[1, 0, 0, 0, 1, 0, 0, 1, 1, 1, 0, 1, 0, 1, 0]",100,54,46,6,5,0.1111111111111111,0.10869565217391304
"[0, 1, 1, 1, 0, 1, 0, 0, 1, 0, 1, 1, 0, 1, 0]",97,40,57,2,8,0.05,0.14035087719298245
"[0, 1, 0, 1, 0, 1, 0, 0, 1, 1, 0, 0, 1, 0, 0]",133,84,49,15,5,0.17857142857142858,0.10204081632653061
"[1, 0, 1, 0, 1, 0, 1, 0, 1, 0, 1, 1, 0, 0, 0]",121,72,49,5,2,0.06944444444444445,0.04081632653061224
"[1, 1, 1, 0, 1, 0, 0, 1, 0, 1, 1, 0, 0, 0, 1]",119,59,60,5,8,0.0847457627118644,0.13333333333333333
"[1, 1, 0, 0, 1, 0, 0, 0, 1, 0, 1, 1, 1, 0, 1]",95,40,55,5,6,0.125,0.10909090909090909
"[0, 0, 0, 1, 0, 1, 0, 1, 1, 0, 0, 1, 0, 1, 0]",139,86,53,10,3,0.11627906976744186,0.05660377358490566
"[1, 1, 1, 0, 0, 1, 0, 1, 1, 0, 0, 1, 0, 1, 0]",114,53,61,7,9,0.1320754716981132,0.14754098360655737
"[1, 0, 1, 1, 0, 1, 0, 0, 1, 1, 0, 0, 1, 0, 0]",109,53,56,5,5,0.09433962264150944,0.08928571428571429
"[0, 1, 0, 1, 1, 0, 1, 0, 0, 1, 1, 0, 0, 1, 0]",104,61,43,3,2,0.04918032786885246,0.046511627906976744
"[0, 1, 0, 0, 0, 1, 0, 0, 1, 0, 0, 1, 0, 1, 1]",146,85,61,8,0,0.09411764705882353,0.0
"[0, 1, 0, 0, 0, 1, 0, 0, 1, 1, 1, 0, 1, 0, 1]",94,49,45,3,2,0.061224489795918366,0.044444444444444446
"[0, 0, 1, 0, 0, 0, 1, 0, 0, 1, 1, 1, 0, 1, 0]",134,78,56,4,3,0.05128205128205128,0.05357142857142857
"[1, 0, 0, 1, 1, 1, 0, 0, 1, 0, 0, 0, 1, 0, 0]",141,82,59,8,5,0.0975609756097561,0.0847457627118644
"[1, 1, 1, 1, 0, 0, 1, 0, 0, 0, 1, 1, 0, 0, 1]",176,80,96,9,6,0.1125,0.0625
"[0, 0, 1, 1, 1, 0, 1, 0, 0, 0, 1, 1, 0, 1, 0]",103,53,50,3,8,0.05660377358490566,0.16
"[1, 1, 0, 0, 0, 1, 0, 1, 1, 1, 1, 0, 0, 0, 1]",128,62,66,8,6,0.12903225806451613,0.09090909090909091
"[1, 0, 1, 1, 0, 1, 1, 1, 0, 0, 0, 0, 0, 0, 1]",211,93,118,4,12,0.043010752688172046,0.1016949152542373
"[0, 0, 0, 1, 0, 0, 0, 1, 1, 0, 1, 1, 1, 0, 1]",113,73,40,6,5,0.0821917808219178,0.125
"[1, 1, 1, 0, 1, 0, 1, 1, 1, 0, 1, 0, 0, 0, 0]",106,45,61,3,8,0.06666666666666667,0.13114754098360656
"[1, 0, 1, 0, 0, 1, 1, 1, 1, 0, 1, 0, 0, 0, 1]",126,58,68,4,6,0.06896551724137931,0.08823529411764706
"[0, 1, 1, 0, 0, 1, 1, 0, 1, 1, 0, 0, 1, 0, 1]",131,70,61,6,5,0.08571428571428572,0.08196721311475409
"[1, 0, 0, 1, 0, 0, 1, 0, 1, 1, 0, 1, 1, 0, 0]",130,66,64,7,4,0.10606060606060606,0.0625
"[1, 0, 1, 1, 1, 1, 0, 1, 0, 1, 0, 1, 0, 1, 0]",165,57,108,7,9,0.12280701754385964,0.08333333333333333
"[0, 1, 1, 0, 1, 0, 0, 1, 0, 1, 0, 1, 1, 1, 1]",163,82,81,9,11,0.10975609756097561,0.13580246913580246
"[0, 1, 0, 0, 1, 1, 1, 1, 0, 1, 0, 0, 0, 0, 0]",176,105,71,7,7,0.06666666666666667,0.09859154929577464
"[1, 1, 1, 0, 0, 0, 1, 0, 0, 1, 1, 1, 0, 1, 0]",102,46,56,3,9,0.06521739130434782,0.16071428571428573
"[1, 1, 1, 0, 1, 0, 1, 0, 1, 0, 0, 0, 1, 0, 1]",113,47,66,1,2,0.02127659574468085,0.030303030303030304
"[0, 1, 0, 0, 1, 1, 0, 0, 0, 1, 0, 1, 1, 1, 1]",139,73,66,9,6,0.1232876712328767,0.09090909090909091
"[0, 1, 0, 0, 0, 1, 1, 0, 1, 1, 1, 0, 0, 1, 0]",95,49,46,8,1,0.16326530612244897,0.021739130434782608
"[0, 0, 1, 0, 1, 0, 1, 0, 1, 0, 1, 1, 0, 0, 1]",129,76,53,7,6,0.09210526315789473,0.11320754716981132
"[0, 0, 0, 1, 0, 1, 0, 0, 0, 1, 1, 0, 1, 0, 0]",234,160,74,12,8,0.075,0.10810810810810811
"[0, 1, 0, 1, 0, 1, 0, 1, 0, 1, 0, 0, 1, 0, 1]",100,53,47,4,3,0.07547169811320754,0.06382978723404255
"[1, 1, 0, 0, 1, 1, 0, 1, 0, 1, 0, 0, 0, 1, 0]",115,64,51,6,9,0.09375,0.17647058823529413
"[0, 0, 1, 0, 1, 1, 0, 1, 1, 1, 0, 1, 0, 1, 1]",129,52,77,11,9,0.21153846153846154,0.11688311688311688
"[1, 0, 1, 1, 0, 0, 0, 1, 0, 1, 1, 1, 0, 0, 0]",133,67,66,7,7,0.1044776119402985,0.10606060606060606
"[0, 0, 0, 0, 1, 0, 0, 1, 0, 0, 1, 1, 1, 0, 1]",151,103,48,8,7,0.07766990291262135,0.14583333333333334
"[1, 0, 1, 1, 0, 1, 1, 1, 0, 0, 0, 1, 1, 0, 0]",134,65,69,5,6,0.07692307692307693,0.08695652173913043
"[1, 0, 0, 1, 1, 1, 0, 1, 0, 0, 0, 0, 1, 0, 1]",121,50,71,4,7,0.08,0.09859154929577464
"[0, 1, 0, 1, 1, 1, 0, 1, 1, 1, 0, 1, 0, 1, 0]",133,55,78,7,9,0.12727272727272726,0.11538461538461539
"[0, 1, 1, 0, 1, 1, 0, 1, 1, 1, 1, 0, 0, 0, 1]",161,78,83,7,8,0.08974358974358974,0.0963855421686747
"[0, 1, 0, 0, 0, 1, 1, 1, 0, 0, 1, 0, 0, 1, 0]",147,80,67,8,6,0.1,0.08955223880597014
"[0, 0, 0, 0, 1, 1, 1, 1, 1, 1, 1, 0, 0, 1, 0]",219,91,128,9,16,0.0989010989010989,0.125
"[0, 1, 0, 1, 0, 1, 1, 0, 0, 0, 1, 0, 1, 0, 0]",157,86,71,9,8,0.10465116279069768,0.11267605633802817
"[1, 0, 0, 0, 1, 1, 0, 1, 0, 0, 0, 1, 1, 1, 0]",101,54,47,2,4,0.037037037037037035,0.0851063829787234
"[1, 0, 0, 0, 1, 1, 1, 0, 1, 1, 0, 1, 0, 0, 1]",101,37,64,6,3,0.16216216216216217,0.046875
"[0, 1, 0, 1, 0, 1, 0, 0, 1, 1, 0, 0, 1, 0, 1]",96,48,48,3,2,0.0625,0.041666666666666664
"[1, 0, 0, 1, 0, 1, 1, 0, 1, 1, 1, 0, 1, 0, 1]",116,42,74,1,7,0.023809523809523808,0.0945945945945946
"[0, 0, 0, 1, 1, 1, 1, 0, 1, 0, 1, 0, 0, 1, 0]",103,52,51,4,10,0.07692307692307693,0.19607843137254902
"[0, 0, 1, 0, 1, 0, 1, 0, 0, 1, 1, 1, 1, 0, 1]",112,57,55,8,7,0.14035087719298245,0.12727272727272726
"[1, 0, 0, 1, 0, 1, 0, 1, 1, 1, 0, 1, 0, 1, 0]",97,52,45,3,3,0.057692307692307696,0.06666666666666667
"[1, 1, 1, 0, 1, 0, 0, 1, 0, 1, 0, 1, 1, 0, 1]",131,49,82,7,5,0.14285714285714285,0.06097560975609756
"[0, 1, 0, 1, 0, 0, 0, 0, 1, 1, 1, 0, 0, 1, 0]",139,87,52,6,5,0.06896551724137931,0.09615384615384616
"[1, 1, 1, 0, 0, 1, 0, 0, 0, 1, 1, 1, 0, 1, 1]",142,68,74,4,8,0.058823529411764705,0.10810810810810811
"[0, 1, 0, 1, 1, 1, 0, 0, 0, 1, 1, 1, 1, 0, 1]",145,70,75,6,7,0.08571428571428572,0.09333333333333334
"[0, 1, 0, 1, 0, 0, 1, 1, 1, 1, 0, 1, 1, 0, 1]",133,46,87,7,9,0.15217391304347827,0.10344827586206896
"[1, 1, 0, 1, 0, 1, 1, 1, 0, 0, 1, 0, 0, 0, 1]",106,57,49,5,6,0.08771929824561403,0.12244897959183673
"[1, 1, 1, 1, 0, 1, 0, 0, 0, 1, 0, 1, 0, 0, 0]",114,57,57,1,7,0.017543859649122806,0.12280701754385964
"[1, 1, 0, 0, 0, 1, 1, 0, 1, 1, 1, 1, 1, 0, 1]",234,84,150,5,13,0.05952380952380952,0.08666666666666667
"[1, 0, 1, 1, 0, 1, 0, 1, 1, 1, 0, 1, 0, 0, 0]",93,47,46,2,6,0.0425531914893617,0.13043478260869565
"[0, 1, 0, 0, 0, 1, 1, 1, 1, 1, 1, 0, 1, 0, 0]",117,49,68,6,4,0.12244897959183673,0.058823529411764705
"[1, 0, 1, 1, 0, 1, 1, 1, 1, 0, 1, 0, 0, 0, 0]",136,69,67,10,9,0.14492753623188406,0.13432835820895522
"[1, 0, 0, 0, 1, 1, 1, 0, 1, 0, 1, 0, 1, 0, 1]",115,58,57,5,5,0.08620689655172414,0.08771929824561403
"[1, 0, 0, 0, 1, 0, 0, 1, 1, 0, 0, 0, 1, 0, 1]",137,79,58,7,5,0.08860759493670886,0.08620689655172414
"[1, 0, 0, 0, 1, 1, 1, 1, 0, 1, 0, 1, 0, 0, 1]",108,36,72,4,8,0.1111111111111111,0.1111111111111111
"[0, 1, 0, 0, 0, 0, 1, 0, 1, 1, 0, 0, 1, 1, 1]",175,94,81,4,8,0.0425531914893617,0.09876543209876543
"[1, 1, 0, 1, 0, 0, 0, 0, 0, 0, 1, 0, 1, 0, 1]",149,84,65,10,6,0.11904761904761904,0.09230769230769231
"[1, 0, 0, 1, 1, 0, 1, 0, 0, 1, 0, 0, 1, 0, 1]",108,56,52,5,5,0.08928571428571429,0.09615384615384616
"[1, 0, 1, 0, 1, 0, 1, 0, 0, 1, 0, 1, 0, 0, 0]",134,79,55,14,10,0.17721518987341772,0.18181818181818182
"[0, 1, 0, 1, 0, 0, 1, 0, 0, 0, 1, 1, 0, 1, 1]",120,71,49,14,3,0.19718309859154928,0.061224489795918366
"[0, 0, 1, 1, 1, 0, 0, 1, 0, 0, 0, 0, 0, 1, 1]",214,126,88,10,7,0.07936507936507936,0.07954545454545454
"[0, 0, 0, 0, 0, 0, 1, 1, 1, 0, 0, 1, 0, 0, 0]",688,495,193,44,20,0.08888888888888889,0.10362694300518134
"[0, 0, 1, 1, 1, 1, 1, 1, 1, 1, 1, 1, 0, 0, 0]",2079,872,1207,75,133,0.0860091743119266,0.11019055509527755
"[0, 1, 1, 0, 1, 0, 1, 0, 0, 0, 0, 1, 1, 0, 0]",226,149,77,11,9,0.0738255033557047,0.11688311688311688
"[1, 1, 0, 0, 1, 0, 0, 0, 0, 1, 1, 0, 0, 0, 0]",489,287,202,38,22,0.13240418118466898,0.10891089108910891
"[0, 1, 0, 1, 1, 1, 0, 1, 0, 0, 1, 1, 1, 1, 1]",317,115,202,8,18,0.06956521739130435,0.0891089108910891
"[1, 1, 1, 1, 0, 1, 1, 0, 1, 1, 0, 1, 1, 1, 1]",1741,389,1352,47,120,0.12082262210796915,0.08875739644970414
"[1, 1, 1, 1, 1, 1, 1, 0, 1, 0, 1, 0, 1, 1, 1]",1950,460,1490,49,148,0.10652173913043478,0.09932885906040269
"[1, 1, 1, 1, 1, 1, 1, 0, 0, 1, 1, 0, 1, 0, 1]",795,172,623,18,63,0.10465116279069768,0.10112359550561797
"[1, 1, 1, 0, 1, 1, 1, 1, 1, 0, 1, 1, 1, 1, 1]",7704,1375,6329,145,635,0.10545454545454545,0.1003318059725075
"[0, 0, 0, 0, 0, 0, 0, 0, 1, 1, 1, 0, 0, 0, 0]",3026,2391,635,217,47,0.09075700543705563,0.07401574803149606
"[0, 0, 0, 1, 1, 0, 1, 1, 0, 0, 0, 1, 0, 1, 0]",158,102,56,15,5,0.14705882352941177,0.08928571428571429
"[0, 1, 0, 1, 1, 0, 0, 1, 0, 1, 0, 0, 0, 0, 0]",287,190,97,12,13,0.06315789473684211,0.13402061855670103
"[0, 0, 1, 1, 0, 0, 0, 0, 0, 0, 0, 0, 0, 0, 0]",26573,21686,4887,2082,459,0.09600664022871899,0.09392265193370165
"[0, 0, 0, 0, 0, 0, 0, 0, 0, 0, 1, 0, 0, 0, 0]",56282,49801,6481,4768,636,0.09574104937651855,0.09813300416602376
"[1, 1, 1, 1, 1, 1, 1, 1, 1, 1, 0, 0, 1, 1, 1]",30554,5183,25371,508,2417,0.09801273393787382,0.09526624886681645
"[0, 1, 1, 1, 1, 1, 1, 1, 1, 1, 1, 1, 1, 0, 0]",6687,3452,3235,341,296,0.09878331402085748,0.09149922720247296
"[1, 1, 1, 1, 0, 1, 1, 1, 1, 1, 1, 1, 1, 1, 1]",64427,7893,56534,726,5347,0.0919802356518434,0.09458025259136095
"[1, 1, 1, 0, 0, 1, 0, 0, 0, 1, 1, 1, 1, 0, 0]",236,105,131,8,16,0.0761904761904762,0.12213740458015267
"[1, 0, 1, 0, 0, 0, 0, 0, 1, 1, 1, 1, 0, 1, 1]",154,66,88,8,7,0.12121212121212122,0.07954545454545454
"[0, 1, 1, 0, 1, 0, 0, 0, 0, 0, 1, 1, 1, 1, 0]",209,129,80,14,9,0.10852713178294573,0.1125
"[1, 1, 1, 1, 1, 0, 1, 1, 1, 0, 1, 0, 1, 1, 1]",1808,403,1405,30,142,0.07444168734491315,0.10106761565836299
"[1, 0, 1, 0, 1, 1, 1, 1, 1, 1, 1, 1, 1, 0, 1]",1615,378,1237,44,119,0.1164021164021164,0.09620048504446241
"[0, 1, 0, 1, 1, 1, 0, 1, 1, 0, 1, 0, 1, 1, 1]",252,82,170,10,16,0.12195121951219512,0.09411764705882353
"[1, 1, 0, 1, 0, 1, 1, 1, 1, 0, 1, 0, 0, 1, 0]",129,56,73,6,5,0.10714285714285714,0.0684931506849315
"[0, 0, 1, 0, 1, 0, 1, 1, 1, 0, 0, 0, 1, 0, 1]",104,49,55,5,7,0.10204081632653061,0.12727272727272726
"[0, 0, 0, 0, 1, 0, 1, 0, 1, 1, 1, 0, 0, 0, 1]",158,96,62,6,3,0.0625,0.04838709677419355
"[0, 1, 1, 0, 0, 1, 0, 0, 0, 1, 0, 1, 0, 1, 0]",116,66,50,7,4,0.10606060606060606,0.08
"[0, 1, 1, 0, 0, 1, 1, 0, 0, 0, 0, 0, 1, 1, 0]",333,243,90,25,6,0.102880658436214,0.06666666666666667
"[0, 0, 0, 1, 1, 0, 0, 1, 1, 0, 0, 0, 0, 0, 1]",842,690,152,67,11,0.09710144927536232,0.07236842105263158
"[1, 0, 1, 0, 0, 0, 1, 1, 0, 0, 1, 1, 0, 0, 0]",349,204,145,22,17,0.10784313725490197,0.11724137931034483
"[1, 1, 1, 1, 1, 1, 0, 1, 1, 1, 0, 1, 1, 1, 1]",7974,1379,6595,142,614,0.10297316896301668,0.0931008339651251
"[1, 1, 1, 0, 1, 1, 1, 1, 1, 1, 1, 1, 1, 0, 1]",6984,1238,5746,121,525,0.09773828756058159,0.09136790810998956
"[0, 0, 0, 1, 0, 0, 1, 1, 0, 0, 0, 0, 1, 1, 1]",498,335,163,32,15,0.0955223880597015,0.09202453987730061
"[1, 0, 0, 0, 1, 0, 0, 1, 1, 0, 0, 0, 0, 1, 1]",362,206,156,24,21,0.11650485436893204,0.1346153846153846
"[1, 0, 0, 1, 0, 0, 0, 1, 0, 0, 1, 0, 0, 0, 0]",503,360,143,30,10,0.08333333333333333,0.06993006993006994
"[0, 0, 0, 0, 0, 1, 0, 0, 1, 0, 0, 0, 1, 0, 0]",1551,1206,345,129,37,0.10696517412935323,0.1072463768115942
"[0, 0, 0, 0, 0, 0, 0, 0, 0, 0, 0, 1, 1, 0, 0]",28905,25470,3435,2528,312,0.09925402434236356,0.09082969432314411
"[1, 0, 0, 0, 1, 1, 0, 0, 1, 1, 0, 1, 0, 1, 1]",125,63,62,3,3,0.047619047619047616,0.04838709677419355
"[1, 1, 1, 1, 1, 1, 1, 0, 0, 0, 1, 1, 0, 0, 1]",486,141,345,15,23,0.10638297872340426,0.06666666666666667
"[1, 0, 1, 0, 1, 1, 0, 0, 1, 0, 1, 0, 1, 1, 1]",152,57,95,2,13,0.03508771929824561,0.1368421052631579
"[1, 1, 1, 0, 1, 0, 1, 1, 1, 0, 1, 0, 1, 1, 0]",231,95,136,7,13,0.07368421052631578,0.09558823529411764
"[0, 0, 1, 1, 1, 0, 1, 0, 1, 1, 1, 0, 1, 0, 1]",130,45,85,3,10,0.06666666666666667,0.11764705882352941
"[1, 1, 1, 1, 1, 1, 0, 0, 1, 0, 0, 0, 0, 0, 0]",302,154,148,15,19,0.09740259740259741,0.12837837837837837
"[0, 0, 0, 0, 0, 0, 0, 0, 1, 1, 1, 1, 1, 1, 0]",2330,1494,836,145,71,0.09705488621151272,0.08492822966507177
"[1, 1, 0, 0, 0, 0, 1, 1, 0, 0, 0, 0, 1, 1, 1]",2075,1046,1029,105,108,0.10038240917782026,0.10495626822157435
"[1, 0, 0, 1, 1, 1, 1, 0, 0, 0, 0, 1, 1, 0, 0]",1500,297,1203,33,113,0.1111111111111111,0.09393183707398171
"[0, 0, 0, 0, 1, 0, 1, 0, 0, 0, 1, 0, 0, 0, 0]",1575,1208,367,130,45,0.1076158940397351,0.1226158038147139
"[0, 0, 0, 1, 1, 0, 1, 1, 1, 0, 0, 0, 0, 1, 0]",154,92,62,9,9,0.09782608695652174,0.14516129032258066
"[0, 1, 0, 0, 1, 0, 0, 0, 0, 0, 0, 0, 0, 0, 0]",9388,7638,1750,737,162,0.09649122807017543,0.09257142857142857
"[1, 1, 1, 1, 1, 0, 0, 1, 1, 0, 1, 1, 1, 1, 1]",2585,481,2104,54,211,0.11226611226611227,0.1002851711026616
"[1, 1, 1, 1, 1, 1, 1, 1, 1, 0, 0, 1, 1, 0, 1]",2873,490,2383,51,227,0.10408163265306122,0.09525807805287453
"[0, 1, 1, 1, 1, 1, 1, 0, 1, 1, 1, 1, 1, 0, 1]",1537,425,1112,52,106,0.1223529411764706,0.09532374100719425
"[0, 0, 1, 1, 1, 0, 0, 0, 0, 0, 1, 0, 1, 0, 1]",145,82,63,9,5,0.10975609756097561,0.07936507936507936
"[0, 1, 0, 0, 1, 1, 1, 0, 0, 0, 0, 0, 1, 0, 1]",155,84,71,9,5,0.10714285714285714,0.07042253521126761
"[1, 0, 0, 0, 0, 0, 1, 0, 0, 1, 0, 0, 0, 0, 0]",1764,1309,455,129,48,0.0985485103132162,0.1054945054945055
"[1, 1, 1, 1, 1, 1, 0, 1, 0, 1, 1, 0, 0, 0, 0]",280,102,178,12,12,0.11764705882352941,0.06741573033707865
"[1, 1, 1, 0, 0, 0, 0, 0, 0, 1, 1, 1, 1, 1, 1]",2589,456,2133,46,220,0.10087719298245613,0.10314111579934365
"[1, 0, 0, 0, 0, 0, 1, 0, 0, 0, 0, 1, 1, 1, 0]",259,158,101,13,13,0.08227848101265822,0.12871287128712872
"[0, 0, 0, 0, 0, 0, 1, 0, 1, 0, 0, 0, 0, 1, 1]",1045,769,276,67,23,0.08712613784135241,0.08333333333333333
"[0, 0, 0, 0, 0, 0, 0, 0, 1, 0, 1, 0, 0, 0, 0]",8089,6622,1467,621,140,0.09377831470854726,0.09543285616905249
"[0, 1, 1, 1, 0, 1, 0, 0, 1, 1, 0, 0, 0, 0, 0]",236,145,91,20,8,0.13793103448275862,0.08791208791208792
"[0, 0, 0, 0, 1, 1, 0, 0, 1, 0, 0, 1, 1, 1, 0]",231,139,92,16,8,0.11510791366906475,0.08695652173913043
"[0, 0, 0, 0, 0, 1, 0, 0, 0, 0, 1, 1, 0, 0, 1]",886,643,243,53,23,0.08242612752721618,0.09465020576131687
"[0, 0, 0, 0, 0, 0, 0, 0, 0, 0, 0, 1, 1, 1, 0]",3302,2690,612,252,63,0.09368029739776952,0.10294117647058823
"[0, 0, 1, 0, 0, 0, 0, 0, 0, 0, 0, 0, 0, 0, 1]",9286,7555,1731,690,152,0.09133024487094639,0.0878105141536684
"[0, 0, 0, 1, 0, 0, 0, 0, 0, 1, 0, 0, 1, 0, 1]",519,379,140,39,8,0.10290237467018469,0.05714285714285714
"[0, 0, 1, 0, 0, 0, 1, 1, 0, 0, 0, 0, 0, 0, 0]",2813,2145,668,196,64,0.09137529137529138,0.09580838323353294
"[0, 0, 0, 0, 1, 1, 1, 1, 1, 1, 1, 1, 1, 1, 1]",5979,1942,4037,179,416,0.092173017507724,0.10304681694327471
"[1, 1, 0, 1, 1, 0, 0, 1, 1, 1, 1, 1, 1, 1, 1]",3421,861,2560,76,248,0.08826945412311266,0.096875
"[1, 1, 1, 0, 0, 1, 1, 1, 1, 1, 1, 0, 0, 1, 1]",4858,643,4215,46,409,0.07153965785381027,0.0970344009489917
"[1, 1, 0, 1, 1, 1, 0, 0, 1, 1, 1, 1, 1, 1, 0]",892,243,649,26,65,0.10699588477366255,0.10015408320493066
"[1, 1, 1, 1, 1, 1, 1, 1, 0, 1, 1, 1, 0, 0, 1]",2289,531,1758,49,155,0.09227871939736347,0.08816837315130831
"[0, 1, 1, 1, 1, 1, 1, 1, 0, 1, 1, 1, 1, 1, 1]",8534,2176,6358,202,633,0.09283088235294118,0.09955960994023277
"[1, 1, 0, 1, 1, 0, 1, 1, 1, 1, 1, 0, 1, 1, 1]",1600,369,1231,29,122,0.07859078590785908,0.09910641754670999
"[1, 1, 0, 0, 1, 1, 0, 1, 0, 0, 1, 1, 1, 1, 1]",450,179,271,17,25,0.09497206703910614,0.09225092250922509
"[0, 1, 0, 1, 1, 0, 0, 0, 0, 1, 1, 0, 0, 0, 0]",686,433,253,38,25,0.08775981524249422,0.09881422924901186
"[1, 0, 1, 1, 1, 1, 1, 0, 1, 1, 1, 1, 1, 0, 1]",1430,364,1066,36,111,0.0989010989010989,0.10412757973733583
"[1, 1, 1, 1, 1, 1, 1, 0, 1, 1, 1, 1, 1, 1, 0]",7800,1323,6477,121,617,0.09145880574452003,0.09526015130461633
"[1, 1, 1, 1, 1, 0, 1, 1, 1, 1, 1, 1, 1, 1, 0]",8122,1456,6666,148,626,0.10164835164835165,0.09390939093909391
"[1, 1, 0, 0, 1, 1, 0, 0, 0, 0, 0, 0, 1, 0, 0]",615,395,220,23,24,0.05822784810126582,0.10909090909090909
"[0, 1, 1, 1, 0, 1, 0, 0, 0, 0, 0, 0, 0, 0, 0]",857,587,270,58,25,0.09880749574105621,0.09259259259259259
"[0, 0, 0, 1, 0, 0, 1, 0, 0, 1, 0, 1, 1, 1, 0]",149,95,54,10,3,0.10526315789473684,0.05555555555555555
"[0, 1, 0, 0, 0, 1, 0, 1, 0, 0, 0, 0, 0, 1, 0]",513,358,155,32,18,0.0893854748603352,0.11612903225806452
"[1, 0, 0, 0, 0, 0, 0, 0, 0, 1, 0, 0, 0, 0, 1]",1954,1333,621,112,64,0.08402100525131283,0.10305958132045089
"[0, 1, 1, 0, 0, 0, 0, 1, 1, 0, 0, 1, 0, 0, 0]",469,371,98,26,6,0.07008086253369272,0.061224489795918366
"[0, 0, 0, 0, 0, 1, 1, 0, 0, 0, 0, 1, 1, 0, 0]",4773,4090,683,377,77,0.0921760391198044,0.11273792093704246
"[0, 0, 1, 0, 0, 1, 1, 0, 0, 0, 0, 0, 0, 0, 0]",3241,2418,823,220,76,0.09098428453267163,0.09234507897934387
"[1, 0, 1, 0, 0, 1, 0, 0, 1, 1, 0, 0, 0, 0, 0]",379,246,133,24,14,0.0975609756097561,0.10526315789473684
"[0, 0, 0, 0, 0, 0, 0, 1, 0, 0, 1, 1, 0, 1, 1]",381,262,119,20,7,0.07633587786259542,0.058823529411764705
"[0, 0, 0, 0, 0, 0, 0, 0, 0, 1, 0, 0, 1, 1, 0]",2350,1853,497,177,47,0.09552077711818673,0.09456740442655935
"[1, 1, 1, 1, 0, 0, 0, 0, 0, 0, 0, 0, 0, 0, 0]",5009,3387,1622,309,163,0.0912311780336581,0.10049321824907521
"[0, 0, 0, 0, 0, 1, 0, 0, 0, 0, 0, 1, 0, 0, 0]",6892,5721,1171,548,112,0.0957874497465478,0.09564474807856532
"[0, 0, 0, 0, 0, 0, 0, 0, 1, 0, 0, 0, 1, 1, 1]",3056,2557,499,238,46,0.09307782557684786,0.09218436873747494
"[0, 0, 0, 1, 0, 0, 0, 0, 1, 1, 0, 0, 0, 0, 1]",969,692,277,54,29,0.07803468208092486,0.10469314079422383
"[1, 1, 0, 0, 0, 1, 1, 0, 0, 0, 0, 0, 0, 0, 1]",411,248,163,29,18,0.11693548387096774,0.11042944785276074
"[1, 1, 1, 1, 1, 1, 1, 0, 1, 1, 0, 1, 1, 1, 1]",8321,1415,6906,146,648,0.10318021201413427,0.09383145091225022
"[1, 1, 0, 1, 1, 1, 1, 1, 0, 0, 0, 1, 0, 0, 1]",147,51,96,3,10,0.058823529411764705,0.10416666666666667
"[1, 0, 0, 0, 1, 1, 1, 0, 1, 1, 1, 0, 1, 1, 1]",293,103,190,8,23,0.07766990291262135,0.12105263157894737
"[1, 1, 0, 1, 1, 1, 1, 1, 0, 0, 0, 1, 1, 1, 1]",736,214,522,19,48,0.08878504672897196,0.09195402298850575
"[0, 0, 0, 1, 1, 0, 1, 1, 1, 1, 1, 0, 0, 0, 1]",113,51,62,4,6,0.0784313725490196,0.0967741935483871
"[0, 1, 1, 1, 1, 1, 1, 1, 0, 1, 0, 0, 1, 0, 0]",124,63,61,6,6,0.09523809523809523,0.09836065573770492
"[1, 1, 0, 1, 1, 1, 0, 1, 1, 1, 1, 1, 1, 1, 0]",1785,451,1334,42,121,0.09312638580931264,0.09070464767616192
"[0, 0, 0, 0, 1, 1, 0, 0, 1, 0, 0, 0, 0, 0, 1]",798,573,225,49,17,0.08551483420593368,0.07555555555555556
"[0, 0, 1, 0, 0, 1, 0, 0, 0, 0, 0, 1, 1, 0, 0]",762,546,216,49,22,0.08974358974358974,0.10185185185185185
"[0, 1, 0, 0, 1, 0, 1, 0, 0, 1, 0, 0, 1, 0, 0]",210,128,82,10,7,0.078125,0.08536585365853659
"[0, 0, 0, 0, 0, 1, 1, 0, 1, 1, 0, 1, 0, 1, 0]",141,81,60,8,7,0.09876543209876543,0.11666666666666667
"[1, 0, 0, 0, 0, 0, 1, 1, 0, 1, 1, 0, 1, 0, 1]",109,54,55,6,6,0.1111111111111111,0.10909090909090909
"[1, 0, 0, 0, 0, 1, 0, 0, 0, 0, 0, 0, 0, 0, 0]",8919,7019,1900,653,171,0.09303319561191054,0.09
"[1, 0, 0, 1, 0, 0, 0, 0, 1, 0, 0, 0, 0, 0, 0]",1786,1301,485,118,32,0.09069946195234435,0.06597938144329897
"[0, 0, 1, 1, 0, 0, 1, 0, 0, 0, 0, 1, 0, 0, 0]",631,451,180,43,16,0.09534368070953436,0.08888888888888889
"[0, 0, 1, 1, 0, 0, 0, 0, 0, 0, 0, 1, 0, 0, 1]",879,607,272,70,19,0.11532125205930807,0.06985294117647059
"[1, 0, 0, 1, 1, 1, 1, 1, 0, 0, 0, 0, 1, 0, 0]",155,73,82,6,6,0.0821917808219178,0.07317073170731707
"[0, 0, 0, 1, 1, 0, 0, 1, 0, 1, 1, 0, 0, 0, 1]",166,112,54,10,8,0.08928571428571429,0.14814814814814814
"[0, 1, 0, 0, 0, 0, 1, 1, 0, 0, 1, 0, 1, 1, 0]",159,95,64,9,4,0.09473684210526316,0.0625
"[1, 0, 1, 1, 1, 1, 0, 0, 1, 1, 1, 0, 0, 1, 1]",343,121,222,16,24,0.1322314049586777,0.10810810810810811
"[1, 0, 1, 0, 1, 1, 1, 1, 0, 0, 1, 1, 1, 0, 0]",193,82,111,10,9,0.12195121951219512,0.08108108108108109
"[1, 1, 1, 0, 1, 0, 1, 1, 1, 1, 1, 1, 0, 0, 0]",400,134,266,13,26,0.09701492537313433,0.09774436090225563
"[1, 1, 0, 0, 1, 1, 1, 1, 0, 0, 1, 1, 1, 1, 0]",2127,852,1275,86,114,0.10093896713615023,0.08941176470588236
"[1, 1, 1, 1, 1, 1, 0, 1, 1, 0, 1, 1, 1, 0, 1]",1499,320,1179,21,110,0.065625,0.09329940627650551
"[0, 1, 0, 0, 1, 0, 1, 1, 1, 0, 0, 1, 1, 1, 1]",248,122,126,12,10,0.09836065573770492,0.07936507936507936
"[1, 1, 0, 1, 0, 0, 1, 0, 1, 1, 1, 0, 0, 1, 1]",190,90,100,7,4,0.07777777777777778,0.04
"[0, 0, 0, 0, 0, 0, 0, 0, 0, 1, 1, 1, 0, 1, 0]",820,620,200,62,16,0.1,0.08
"[0, 1, 1, 1, 1, 1, 1, 0, 0, 0, 0, 1, 1, 0, 0]",1581,1222,359,113,30,0.09247135842880523,0.08356545961002786
"[1, 0, 1, 1, 1, 1, 1, 1, 0, 0, 0, 0, 1, 1, 0]",487,201,286,15,30,0.07462686567164178,0.1048951048951049
"[1, 0, 1, 1, 1, 1, 1, 1, 1, 0, 0, 1, 0, 1, 1]",618,173,445,28,46,0.16184971098265896,0.10337078651685393
"[1, 1, 0, 1, 1, 1, 0, 1, 0, 1, 0, 1, 1, 1, 0]",223,78,145,5,17,0.0641025641025641,0.11724137931034483
"[0, 0, 0, 1, 0, 0, 1, 1, 1, 1, 1, 1, 1, 1, 0]",351,164,187,19,20,0.11585365853658537,0.10695187165775401
"[1, 0, 1, 0, 0, 0, 1, 0, 0, 1, 1, 1, 1, 1, 1]",246,98,148,7,14,0.07142857142857142,0.0945945945945946
"[0, 1, 0, 0, 0, 0, 0, 0, 0, 0, 0, 0, 1, 1, 1]",2500,1919,581,188,53,0.0979676915059927,0.09122203098106713
"[1, 0, 1, 0, 0, 0, 0, 0, 0, 0, 1, 0, 0, 0, 0]",1708,1314,394,135,45,0.10273972602739725,0.11421319796954314
"[0, 0, 1, 0, 0, 0, 0, 0, 0, 0, 0, 1, 0, 1, 0]",1541,1183,358,102,29,0.08622147083685545,0.08100558659217877
"[0, 0, 0, 1, 0, 0, 0, 0, 0, 0, 0, 0, 1, 0, 1]",1684,1305,379,145,33,0.1111111111111111,0.0870712401055409
"[0, 0, 0, 0, 0, 0, 1, 0, 1, 1, 0, 1, 0, 0, 0]",585,420,165,45,11,0.10714285714285714,0.06666666666666667
"[0, 0, 1, 0, 0, 0, 0, 0, 0, 0, 1, 0, 1, 1, 0]",571,406,165,28,17,0.06896551724137931,0.10303030303030303
"[0, 0, 0, 0, 1, 0, 0, 0, 0, 0, 0, 0, 1, 0, 1]",1680,1290,390,114,43,0.08837209302325581,0.11025641025641025
"[0, 1, 0, 1, 1, 0, 1, 0, 0, 0, 0, 0, 0, 0, 1]",279,178,101,15,14,0.08426966292134831,0.13861386138613863
"[1, 0, 0, 1, 0, 1, 1, 0, 1, 0, 0, 0, 0, 0, 0]",306,192,114,18,8,0.09375,0.07017543859649122
"[1, 1, 1, 1, 1, 0, 0, 0, 0, 1, 1, 1, 1, 1, 1]",5860,795,5065,92,491,0.11572327044025157,0.09693978282329714
"[0, 1, 1, 1, 1, 1, 1, 1, 1, 0, 0, 0, 0, 1, 1]",2506,1708,798,172,86,0.10070257611241218,0.10776942355889724
"[1, 0, 0, 1, 1, 1, 1, 1, 1, 1, 1, 0, 0, 0, 0]",1972,367,1605,35,123,0.09536784741144415,0.07663551401869159
"[1, 1, 0, 0, 0, 0, 1, 0, 0, 0, 1, 0, 1, 1, 1]",205,120,85,16,6,0.13333333333333333,0.07058823529411765
"[0, 1, 1, 0, 0, 1, 1, 0, 0, 0, 0, 1, 1, 0, 0]",1877,1565,312,140,24,0.08945686900958466,0.07692307692307693
"[1, 1, 0, 0, 0, 1, 0, 0, 0, 0, 0, 0, 0, 0, 1]",785,509,276,40,30,0.07858546168958742,0.10869565217391304
"[1, 0, 0, 0, 0, 1, 0, 1, 0, 0, 0, 1, 0, 1, 0]",242,154,88,20,10,0.12987012987012986,0.11363636363636363
"[1, 1, 1, 1, 0, 0, 0, 0, 0, 0, 1, 1, 1, 1, 1]",2681,1036,1645,96,148,0.09266409266409266,0.08996960486322189
"[1, 1, 1, 1, 1, 0, 0, 0, 0, 0, 0, 1, 1, 1, 1]",2617,440,2177,33,200,0.075,0.09186954524575103
"[1, 1, 1, 1, 1, 1, 1, 0, 0, 0, 0, 0, 0, 1, 1]",2525,429,2096,50,212,0.11655011655011654,0.10114503816793893
"[0, 0, 1, 1, 1, 1, 1, 1, 1, 1, 0, 0, 0, 0, 0]",1673,839,834,82,72,0.09773539928486293,0.08633093525179857
"[0, 1, 1, 0, 0, 0, 0, 1, 1, 0, 0, 1, 1, 1, 1]",1824,1457,367,131,42,0.08991077556623199,0.11444141689373297
"[1, 1, 1, 1, 0, 1, 0, 0, 0, 0, 1, 1, 1, 1, 0]",268,111,157,3,6,0.02702702702702703,0.03821656050955414
"[1, 1, 1, 1, 1, 1, 1, 0, 1, 0, 0, 0, 0, 1, 1]",491,155,336,6,32,0.03870967741935484,0.09523809523809523
"[0, 1, 1, 1, 0, 0, 0, 1, 0, 0, 0, 1, 1, 0, 0]",200,112,88,18,13,0.16071428571428573,0.14772727272727273
"[1, 1, 0, 1, 0, 1, 1, 1, 1, 1, 1, 1, 1, 1, 1]",9892,1726,8166,180,744,0.10428736964078796,0.09110947832476121
"[1, 1, 1, 0, 0, 0, 1, 1, 0, 0, 0, 0, 0, 1, 0]",140,78,62,4,2,0.05128205128205128,0.03225806451612903
"[0, 1, 1, 0, 0, 0, 0, 0, 0, 1, 1, 0, 0, 0, 0]",4357,3795,562,348,47,0.091699604743083,0.08362989323843416
"[1, 0, 0, 1, 1, 0, 0, 0, 0, 0, 0, 1, 1, 0, 0]",2160,592,1568,58,132,0.09797297297297297,0.08418367346938775
"[0, 1, 1, 0, 1, 0, 0, 1, 1, 0, 0, 0, 0, 0, 0]",475,306,169,24,13,0.0784313725490196,0.07692307692307693
"[1, 0, 0, 1, 0, 0, 0, 0, 0, 0, 0, 1, 1, 1, 1]",462,272,190,31,17,0.11397058823529412,0.08947368421052632
"[0, 0, 1, 0, 0, 1, 0, 0, 0, 0, 0, 0, 0, 1, 1]",1009,719,290,71,30,0.09874826147426982,0.10344827586206896
"[1, 1, 1, 1, 1, 0, 1, 0, 1, 1, 1, 0, 0, 1, 1]",786,193,593,17,49,0.08808290155440414,0.08263069139966273
"[1, 0, 1, 1, 1, 1, 1, 1, 1, 0, 1, 0, 1, 1, 1]",1651,393,1258,39,104,0.09923664122137404,0.08267090620031796
"[1, 0, 1, 1, 1, 1, 1, 1, 1, 0, 1, 1, 0, 1, 0]",526,174,352,10,45,0.05747126436781609,0.1278409090909091
"[1, 1, 1, 0, 1, 1, 1, 1, 1, 1, 1, 0, 1, 1, 0]",1616,379,1237,43,134,0.11345646437994723,0.10832659660468877
"[1, 1, 0, 1, 1, 0, 0, 0, 0, 0, 0, 1, 1, 1, 1]",515,233,282,15,29,0.06437768240343347,0.10283687943262411
"[0, 0, 0, 0, 0, 0, 1, 1, 1, 0, 1, 1, 0, 1, 1]",208,104,104,2,7,0.019230769230769232,0.0673076923076923
"[0, 0, 0, 0, 0, 0, 0, 0, 0, 1, 1, 1, 0, 1, 1]",716,533,183,49,21,0.09193245778611632,0.11475409836065574
"[1, 0, 0, 0, 0, 0, 0, 0, 0, 0, 1, 1, 1, 0, 1]",375,201,174,22,16,0.10945273631840796,0.09195402298850575
"[0, 0, 1, 0, 0, 1, 0, 1, 1, 0, 0, 1, 1, 0, 0]",257,151,106,16,9,0.10596026490066225,0.08490566037735849
"[1, 0, 1, 1, 0, 1, 1, 1, 0, 0, 1, 0, 0, 1, 0]",115,49,66,3,4,0.061224489795918366,0.06060606060606061
"[1, 0, 0, 0, 0, 0, 1, 1, 1, 0, 1, 1, 1, 1, 1]",235,75,160,8,14,0.10666666666666667,0.0875
"[1, 0, 0, 1, 1, 0, 0, 0, 0, 0, 1, 1, 1, 0, 1]",171,66,105,6,12,0.09090909090909091,0.11428571428571428
"[1, 0, 1, 1, 0, 0, 1, 1, 1, 0, 0, 1, 1, 0, 0]",194,93,101,6,8,0.06451612903225806,0.07920792079207921
"[1, 0, 1, 1, 1, 1, 0, 0, 1, 0, 0, 1, 1, 1, 1]",326,116,210,18,32,0.15517241379310345,0.1523809523809524
"[0, 1, 1, 0, 0, 0, 0, 1, 1, 1, 1, 0, 0, 1, 0]",305,238,67,17,8,0.07142857142857142,0.11940298507462686
"[1, 1, 1, 1, 1, 0, 0, 1, 1, 0, 0, 0, 0, 1, 1]",2282,386,1896,31,177,0.08031088082901554,0.09335443037974683
"[0, 1, 0, 0, 0, 0, 0, 0, 0, 1, 0, 0, 0, 0, 1]",1648,1236,412,111,32,0.08980582524271845,0.07766990291262135
"[0, 0, 0, 1, 0, 1, 0, 0, 1, 0, 0, 0, 0, 0, 0]",1783,1353,430,138,36,0.10199556541019955,0.08372093023255814
"[1, 1, 0, 1, 0, 0, 0, 0, 0, 0, 0, 1, 0, 1, 0]",243,146,97,14,7,0.0958904109589041,0.07216494845360824
"[0, 0, 0, 0, 1, 1, 0, 1, 0, 1, 1, 0, 1, 0, 0]",150,91,59,10,6,0.10989010989010989,0.1016949152542373
"[0, 0, 0, 0, 0, 1, 1, 0, 1, 0, 1, 1, 0, 1, 0]",150,88,62,8,9,0.09090909090909091,0.14516129032258066
"[1, 1, 1, 0, 0, 0, 0, 1, 1, 1, 1, 1, 0, 1, 1]",631,129,502,13,54,0.10077519379844961,0.10756972111553785
"[1, 1, 0, 0, 0, 0, 0, 0, 0, 0, 0, 1, 1, 1, 1]",1221,708,513,92,43,0.12994350282485875,0.08382066276803118
"[1, 0, 0, 1, 0, 0, 0, 0, 1, 0, 1, 1, 0, 1, 0]",146,82,64,9,5,0.10975609756097561,0.078125
"[0, 0, 1, 1, 1, 0, 0, 1, 0, 0, 0, 0, 0, 0, 1]",312,201,111,23,11,0.11442786069651742,0.0990990990990991
"[0, 1, 0, 0, 0, 0, 0, 0, 1, 0, 1, 0, 0, 0, 1]",511,370,141,41,14,0.11081081081081082,0.09929078014184398
"[1, 1, 0, 1, 1, 0, 0, 1, 0, 1, 1, 0, 0, 1, 0]",92,49,43,7,1,0.14285714285714285,0.023255813953488372
"[1, 0, 1, 1, 1, 0, 1, 1, 1, 1, 1, 1, 1, 0, 0]",817,243,574,15,48,0.06172839506172839,0.08362369337979095
"[0, 1, 0, 0, 0, 0, 0, 0, 0, 1, 0, 0, 1, 1, 0]",658,474,184,42,27,0.08860759493670886,0.14673913043478262
"[1, 0, 1, 0, 0, 1, 0, 1, 0, 0, 0, 0, 0, 0, 0]",662,448,214,38,14,0.08482142857142858,0.06542056074766354
"[0, 0, 0, 1, 0, 0, 0, 0, 1, 0, 1, 0, 0, 1, 0]",470,351,119,36,14,0.10256410256410256,0.11764705882352941
"[0, 1, 1, 1, 1, 1, 0, 1, 1, 1, 1, 1, 1, 0, 0]",837,268,569,24,51,0.08955223880597014,0.08963093145869948
"[1, 1, 1, 0, 1, 0, 0, 1, 1, 1, 0, 0, 1, 0, 0]",108,62,46,11,5,0.1774193548387097,0.10869565217391304
"[0, 1, 0, 0, 0, 0, 0, 0, 0, 0, 1, 1, 0, 1, 1]",348,216,132,26,10,0.12037037037037036,0.07575757575757576
"[0, 0, 1, 1, 1, 1, 0, 1, 0, 0, 0, 0, 0, 0, 0]",442,283,159,24,15,0.08480565371024736,0.09433962264150944
"[1, 1, 1, 1, 0, 0, 1, 1, 0, 0, 1, 0, 1, 1, 1]",637,234,403,27,39,0.11538461538461539,0.0967741935483871
"[0, 0, 0, 1, 0, 0, 1, 0, 1, 1, 0, 0, 1, 1, 1]",166,88,78,10,4,0.11363636363636363,0.05128205128205128
"[0, 1, 0, 0, 0, 1, 0, 0, 1, 0, 1, 1, 0, 0, 1]",150,86,64,6,7,0.06976744186046512,0.109375
"[0, 0, 0, 1, 0, 0, 0, 0, 0, 0, 1, 0, 0, 0, 0]",7119,5834,1285,514,120,0.08810421666095303,0.0933852140077821
"[0, 0, 0, 0, 0, 0, 0, 1, 0, 0, 0, 1, 1, 0, 0]",2338,1830,508,153,52,0.08360655737704918,0.10236220472440945
"[0, 0, 0, 0, 1, 0, 1, 1, 0, 1, 1, 0, 0, 1, 0]",141,83,58,13,6,0.1566265060240964,0.10344827586206896
"[1, 0, 0, 1, 0, 0, 1, 0, 0, 1, 1, 1, 0, 1, 0]",122,60,62,4,6,0.06666666666666667,0.0967741935483871
"[1, 0, 0, 0, 0, 0, 1, 1, 1, 1, 0, 0, 0, 0, 0]",896,582,314,68,27,0.11683848797250859,0.08598726114649681
"[1, 0, 1, 1, 1, 0, 0, 0, 0, 1, 0, 0, 0, 1, 0]",121,77,44,3,5,0.03896103896103896,0.11363636363636363
"[1, 0, 1, 0, 1, 0, 0, 0, 1, 1, 1, 1, 0, 0, 1]",190,95,95,8,4,0.08421052631578947,0.042105263157894736
"[0, 1, 0, 0, 1, 1, 1, 0, 1, 1, 0, 1, 0, 1, 0]",117,55,62,4,5,0.07272727272727272,0.08064516129032258
"[1, 1, 0, 1, 1, 1, 1, 1, 1, 1, 1, 1, 1, 0, 0]",3635,887,2748,87,247,0.09808342728297632,0.08988355167394468
"[0, 1, 0, 1, 1, 1, 1, 1, 0, 0, 1, 0, 1, 1, 1]",267,99,168,7,18,0.0707070707070707,0.10714285714285714
"[0, 1, 0, 1, 0, 1, 1, 1, 1, 1, 0, 0, 1, 0, 1]",137,59,78,4,8,0.06779661016949153,0.10256410256410256
"[1, 1, 1, 1, 0, 1, 0, 1, 0, 1, 1, 1, 1, 1, 0]",559,152,407,16,43,0.10526315789473684,0.10565110565110565
"[0, 1, 0, 1, 1, 1, 1, 1, 0, 1, 0, 1, 0, 1, 1]",266,92,174,12,15,0.13043478260869565,0.08620689655172414
"[1, 0, 1, 0, 0, 0, 1, 0, 0, 1, 0, 0, 0, 1, 1]",157,102,55,12,6,0.11764705882352941,0.10909090909090909
"[0, 0, 1, 1, 0, 1, 0, 1, 0, 0, 0, 1, 0, 0, 1]",153,81,72,9,5,0.1111111111111111,0.06944444444444445
"[0, 0, 0, 0, 1, 1, 0, 1, 0, 1, 0, 0, 0, 1, 0]",263,161,102,15,12,0.09316770186335403,0.11764705882352941
"[1, 1, 0, 1, 0, 0, 0, 0, 0, 0, 0, 0, 1, 0, 0]",552,377,175,35,24,0.09283819628647215,0.13714285714285715
"[0, 0, 0, 1, 1, 0, 1, 0, 0, 0, 0, 0, 0, 0, 0]",2265,1733,532,176,41,0.10155799192152337,0.07706766917293233
"[0, 0, 1, 1, 0, 0, 0, 0, 1, 1, 0, 0, 0, 0, 0]",4576,3273,1303,303,124,0.0925756186984418,0.09516500383729855
"[0, 0, 0, 0, 0, 1, 1, 0, 0, 0, 1, 0, 0, 0, 0]",2203,1776,427,175,31,0.09853603603603604,0.07259953161592506
"[0, 1, 0, 0, 0, 0, 0, 0, 1, 1, 0, 0, 0, 1, 0]",613,445,168,30,16,0.06741573033707865,0.09523809523809523
"[0, 1, 0, 0, 1, 1, 1, 1, 1, 1, 1, 1, 0, 0, 1]",701,248,453,25,43,0.10080645161290322,0.09492273730684327
"[1, 1, 1, 0, 1, 1, 1, 0, 0, 0, 1, 0, 0, 1, 1]",181,69,112,3,9,0.043478260869565216,0.08035714285714286
"[1, 1, 1, 0, 0, 1, 0, 0, 1, 0, 1, 1, 1, 0, 1]",174,64,110,11,19,0.171875,0.17272727272727273
"[1, 1, 1, 0, 1, 0, 0, 0, 0, 0, 1, 0, 0, 0, 1]",169,96,73,9,4,0.09375,0.0547945205479452
"[1, 1, 1, 0, 1, 1, 1, 0, 1, 0, 0, 0, 0, 0, 1]",147,65,82,4,10,0.06153846153846154,0.12195121951219512
"[1, 0, 0, 0, 0, 1, 0, 0, 1, 1, 1, 0, 0, 1, 0]",135,69,66,4,11,0.057971014492753624,0.16666666666666666
"[0, 0, 1, 1, 1, 1, 0, 0, 0, 0, 0, 0, 0, 0, 0]",5051,3613,1438,327,135,0.09050650429006366,0.09388038942976357
"[0, 1, 0, 0, 0, 0, 1, 0, 0, 0, 0, 1, 1, 0, 0]",739,525,214,52,17,0.09904761904761905,0.0794392523364486
"[1, 0, 0, 0, 1, 1, 0, 1, 1, 1, 1, 1, 0, 0, 1]",203,74,129,8,15,0.10810810810810811,0.11627906976744186
"[0, 1, 0, 0, 1, 1, 1, 1, 0, 0, 0, 1, 1, 0, 1]",118,55,63,2,7,0.03636363636363636,0.1111111111111111
"[1, 1, 0, 1, 1, 0, 0, 0, 0, 0, 0, 0, 0, 0, 0]",1190,777,413,74,42,0.09523809523809523,0.1016949152542373
"[0, 1, 1, 0, 1, 1, 0, 0, 0, 0, 0, 0, 0, 0, 0]",1004,706,298,69,28,0.09773371104815864,0.09395973154362416
"[1, 1, 1, 1, 0, 1, 1, 0, 1, 1, 0, 0, 0, 0, 0]",196,72,124,13,9,0.18055555555555555,0.07258064516129033
"[0, 1, 1, 1, 0, 1, 0, 0, 1, 1, 0, 1, 0, 1, 0]",107,49,58,5,5,0.10204081632653061,0.08620689655172414
"[1, 1, 0, 1, 0, 1, 0, 0, 0, 1, 0, 1, 1, 0, 0]",139,73,66,4,7,0.0547945205479452,0.10606060606060606
"[1, 1, 0, 1, 0, 0, 1, 0, 0, 1, 0, 0, 1, 0, 0]",144,86,58,11,5,0.12790697674418605,0.08620689655172414
"[0, 0, 1, 1, 0, 1, 1, 1, 0, 0, 1, 1, 0, 1, 0]",106,54,52,6,4,0.1111111111111111,0.07692307692307693
"[1, 1, 1, 0, 0, 0, 0, 0, 0, 1, 1, 0, 0, 0, 0]",2175,608,1567,39,143,0.06414473684210527,0.09125717932354818
"[0, 1, 0, 0, 1, 1, 1, 0, 1, 1, 1, 0, 0, 1, 1]",180,86,94,9,7,0.10465116279069768,0.07446808510638298
"[0, 1, 0, 1, 1, 1, 1, 0, 0, 0, 0, 0, 0, 0, 0]",743,444,299,42,29,0.0945945945945946,0.09698996655518395
"[0, 0, 1, 0, 0, 0, 1, 0, 1, 0, 0, 1, 0, 0, 0]",528,368,160,35,12,0.09510869565217392,0.075
"[0, 0, 0, 1, 1, 0, 0, 0, 1, 0, 0, 1, 0, 0, 1]",296,199,97,19,15,0.09547738693467336,0.15463917525773196
"[1, 0, 1, 1, 1, 1, 0, 0, 0, 0, 0, 0, 1, 0, 0]",191,111,80,14,8,0.12612612612612611,0.1
"[1, 0, 0, 0, 0, 0, 0, 1, 1, 0, 0, 1, 1, 1, 1]",1874,384,1490,35,137,0.09114583333333333,0.09194630872483221
"[0, 1, 0, 1, 0, 1, 1, 0, 1, 1, 1, 0, 0, 0, 0]",146,74,72,6,3,0.08108108108108109,0.041666666666666664
"[1, 1, 0, 1, 0, 0, 0, 1, 0, 0, 1, 0, 1, 0, 1]",119,60,59,3,2,0.05,0.03389830508474576
"[0, 0, 1, 1, 1, 1, 1, 0, 1, 0, 0, 0, 1, 0, 0]",118,66,52,4,2,0.06060606060606061,0.038461538461538464
"[1, 0, 0, 0, 0, 1, 0, 0, 1, 1, 1, 1, 1, 0, 1]",118,52,66,4,4,0.07692307692307693,0.06060606060606061
"[0, 0, 0, 1, 0, 1, 0, 1, 1, 0, 0, 0, 0, 0, 0]",850,648,202,63,19,0.09722222222222222,0.09405940594059406
"[0, 0, 1, 0, 0, 0, 0, 0, 0, 0, 1, 0, 1, 0, 1]",540,389,151,40,15,0.10282776349614396,0.09933774834437085
"[1, 0, 0, 0, 1, 0, 0, 1, 1, 0, 0, 0, 0, 0, 0]",961,644,317,63,33,0.09782608695652174,0.10410094637223975
"[0, 1, 0, 0, 1, 1, 0, 0, 0, 1, 0, 0, 0, 1, 0]",210,131,79,17,7,0.1297709923664122,0.08860759493670886
"[1, 1, 0, 0, 0, 1, 1, 1, 1, 1, 1, 1, 0, 0, 1]",489,176,313,12,30,0.06818181818181818,0.09584664536741214
"[0, 1, 1, 0, 1, 1, 0, 1, 0, 1, 0, 0, 0, 1, 1]",115,55,60,3,6,0.05454545454545454,0.1
"[1, 0, 0, 0, 0, 0, 1, 1, 1, 0, 1, 0, 0, 1, 0]",162,84,78,6,5,0.07142857142857142,0.0641025641025641
"[0, 0, 1, 1, 1, 1, 0, 0, 0, 0, 0, 1, 1, 1, 1]",529,277,252,24,15,0.08664259927797834,0.05952380952380952
"[1, 1, 0, 0, 0, 0, 1, 0, 1, 0, 1, 0, 0, 0, 0]",286,185,101,12,9,0.06486486486486487,0.0891089108910891
"[1, 1, 0, 0, 1, 1, 0, 0, 1, 1, 0, 1, 0, 1, 1]",313,130,183,14,13,0.1076923076923077,0.07103825136612021
"[1, 0, 1, 0, 0, 0, 1, 1, 1, 0, 0, 0, 0, 1, 0]",154,90,64,7,3,0.07777777777777778,0.046875
"[1, 1, 1, 0, 0, 0, 1, 1, 1, 1, 1, 0, 1, 0, 0]",165,60,105,3,12,0.05,0.11428571428571428
"[0, 0, 0, 1, 0, 0, 1, 1, 1, 0, 1, 0, 0, 1, 1]",121,62,59,6,3,0.0967741935483871,0.05084745762711865
"[0, 0, 1, 1, 0, 0, 0, 1, 1, 1, 1, 0, 0, 1, 0]",134,75,59,5,7,0.06666666666666667,0.11864406779661017
"[1, 0, 0, 1, 0, 0, 1, 1, 0, 0, 1, 1, 1, 1, 0]",272,127,145,15,12,0.11811023622047244,0.08275862068965517
"[1, 0, 0, 0, 1, 1, 1, 1, 0, 0, 1, 1, 1, 0, 0]",147,66,81,4,4,0.06060606060606061,0.04938271604938271
"[0, 1, 0, 0, 0, 1, 1, 1, 1, 0, 0, 1, 1, 1, 0]",145,72,73,9,1,0.125,0.0136986301369863
"[0, 0, 1, 0, 1, 1, 1, 0, 0, 1, 0, 1, 0, 0, 0]",171,90,81,10,8,0.1111111111111111,0.09876543209876543
"[0, 0, 1, 0, 0, 1, 0, 0, 0, 0, 0, 0, 1, 0, 0]",1605,1235,370,106,30,0.08582995951417004,0.08108108108108109
"[1, 1, 0, 1, 0, 0, 0, 1, 0, 0, 1, 0, 0, 0, 0]",233,163,70,19,8,0.1165644171779141,0.11428571428571428
"[1, 0, 0, 1, 0, 1, 1, 0, 1, 0, 0, 0, 1, 0, 0]",130,72,58,6,7,0.08333333333333333,0.1206896551724138
"[0, 1, 0, 1, 0, 0, 0, 0, 0, 1, 1, 0, 0, 1, 0]",254,158,96,10,11,0.06329113924050633,0.11458333333333333
"[1, 0, 0, 1, 0, 1, 0, 1, 0, 0, 0, 1, 0, 0, 1]",134,74,60,4,4,0.05405405405405406,0.06666666666666667
"[1, 0, 0, 1, 0, 0, 0, 0, 1, 1, 1, 0, 0, 1, 0]",157,95,62,12,8,0.12631578947368421,0.12903225806451613
"[1, 0, 1, 1, 1, 0, 1, 1, 1, 0, 0, 0, 1, 0, 0]",106,53,53,2,5,0.03773584905660377,0.09433962264150944
"[0, 0, 0, 1, 0, 1, 1, 1, 0, 1, 1, 1, 0, 0, 0]",138,76,62,9,6,0.11842105263157894,0.0967741935483871
"[1, 0, 0, 1, 0, 0, 0, 1, 0, 1, 1, 0, 1, 0, 0]",131,82,49,7,2,0.08536585365853659,0.04081632653061224
"[0, 0, 1, 1, 1, 1, 0, 0, 0, 0, 0, 0, 0, 1, 0]",624,424,200,31,16,0.07311320754716981,0.08
"[1, 0, 0, 1, 1, 1, 1, 0, 0, 0, 0, 0, 0, 0, 1]",496,155,341,21,21,0.13548387096774195,0.06158357771260997
"[0, 0, 0, 0, 0, 1, 1, 0, 0, 1, 1, 1, 1, 0, 0]",2068,1718,350,171,47,0.09953434225844005,0.13428571428571429
"[1, 1, 1, 1, 0, 0, 0, 0, 1, 1, 0, 1, 1, 0, 0]",230,99,131,11,17,0.1111111111111111,0.1297709923664122
"[1, 1, 1, 0, 0, 0, 0, 0, 1, 1, 1, 1, 0, 0, 0]",289,147,142,14,10,0.09523809523809523,0.07042253521126761
"[0, 1, 0, 1, 1, 0, 0, 0, 1, 0, 0, 0, 0, 0, 0]",654,476,178,40,15,0.08403361344537816,0.08426966292134831
"[1, 0, 1, 0, 0, 0, 0, 0, 0, 0, 1, 0, 1, 1, 0]",230,149,81,13,3,0.087248322147651,0.037037037037037035
"[0, 1, 1, 0, 1, 1, 0, 1, 0, 0, 1, 0, 1, 0, 0]",100,63,37,9,3,0.14285714285714285,0.08108108108108109
"[1, 1, 1, 0, 0, 0, 0, 1, 0, 0, 0, 0, 0, 0, 0]",790,483,307,38,33,0.07867494824016563,0.10749185667752444
"[0, 0, 0, 0, 1, 0, 1, 1, 1, 0, 0, 0, 0, 1, 0]",231,161,70,12,7,0.07453416149068323,0.1
"[0, 1, 0, 0, 0, 0, 0, 0, 0, 1, 1, 0, 0, 0, 0]",3469,2655,814,240,80,0.0903954802259887,0.09828009828009827
"[0, 0, 0, 0, 0, 1, 0, 0, 0, 0, 0, 0, 0, 1, 1]",3872,3179,693,298,73,0.09374016986473734,0.10533910533910534
"[0, 0, 1, 0, 1, 0, 1, 0, 0, 0, 0, 1, 0, 1, 0]",248,161,87,18,7,0.11180124223602485,0.08045977011494253
"[0, 1, 0, 1, 1, 0, 0, 0, 1, 0, 1, 0, 1, 0, 0]",122,65,57,4,5,0.06153846153846154,0.08771929824561403
"[0, 0, 1, 1, 0, 0, 0, 1, 1, 0, 0, 1, 0, 1, 0]",171,112,59,7,4,0.0625,0.06779661016949153
"[0, 0, 0, 0, 0, 1, 0, 0, 0, 1, 0, 0, 0, 1, 0]",1495,1146,349,98,39,0.08551483420593368,0.11174785100286533
"[1, 1, 0, 0, 1, 0, 0, 0, 1, 0, 0, 0, 0, 0, 1]",252,165,87,18,14,0.10909090909090909,0.16091954022988506
"[1, 0, 0, 1, 0, 1, 1, 1, 0, 0, 1, 1, 1, 1, 1]",425,143,282,14,23,0.0979020979020979,0.08156028368794327
"[0, 0, 0, 0, 1, 1, 1, 1, 0, 1, 0, 1, 1, 0, 1]",159,81,78,6,6,0.07407407407407407,0.07692307692307693
"[0, 0, 1, 1, 1, 0, 1, 1, 0, 1, 1, 0, 1, 0, 1]",135,54,81,6,4,0.1111111111111111,0.04938271604938271
"[0, 1, 1, 1, 0, 1, 0, 1, 0, 1, 1, 0, 1, 0, 1]",125,51,74,2,3,0.0392156862745098,0.04054054054054054
"[0, 1, 1, 1, 0, 1, 1, 0, 1, 1, 0, 1, 1, 1, 1]",576,191,385,15,46,0.07853403141361257,0.11948051948051948
"[0, 1, 0, 0, 1, 1, 0, 0, 0, 1, 0, 0, 0, 0, 1]",275,174,101,21,6,0.1206896551724138,0.0594059405940594
"[0, 1, 0, 1, 0, 1, 0, 0, 1, 1, 0, 0, 0, 1, 0]",136,75,61,6,6,0.08,0.09836065573770492
"[1, 0, 0, 0, 0, 1, 0, 1, 0, 1, 0, 0, 1, 1, 0]",177,109,68,12,10,0.11009174311926606,0.14705882352941177
"[1, 0, 0, 0, 0, 1, 1, 0, 0, 0, 0, 0, 1, 0, 1]",384,154,230,13,23,0.08441558441558442,0.1
"[0, 1, 0, 0, 1, 0, 0, 0, 0, 1, 0, 0, 1, 0, 0]",484,351,133,29,7,0.08262108262108261,0.05263157894736842
"[0, 1, 1, 1, 0, 0, 0, 1, 0, 0, 0, 0, 1, 0, 0]",229,158,71,14,10,0.08860759493670886,0.14084507042253522
"[0, 1, 1, 1, 1, 1, 1, 0, 0, 0, 0, 1, 1, 1, 1]",2583,1880,703,174,67,0.0925531914893617,0.0953058321479374
"[1, 1, 1, 1, 0, 1, 1, 0, 1, 1, 0, 1, 1, 0, 1]",486,145,341,11,29,0.07586206896551724,0.08504398826979472
"[0, 1, 1, 0, 0, 1, 1, 0, 0, 0, 0, 0, 0, 0, 1]",862,721,141,71,13,0.09847434119278779,0.09219858156028368
"[0, 0, 1, 0, 0, 0, 0, 0, 1, 1, 1, 0, 0, 0, 0]",667,466,201,37,14,0.07939914163090128,0.06965174129353234
"[0, 0, 0, 1, 0, 0, 0, 0, 0, 1, 1, 1, 0, 0, 0]",650,480,170,49,17,0.10208333333333333,0.1
"[1, 0, 0, 0, 0, 1, 0, 0, 1, 0, 0, 0, 1, 0, 0]",507,319,188,19,13,0.05956112852664577,0.06914893617021277
"[0, 1, 1, 1, 1, 0, 1, 1, 1, 1, 1, 1, 0, 1, 1]",1687,470,1217,45,108,0.09574468085106383,0.08874281018898932
"[0, 0, 1, 1, 1, 1, 0, 0, 0, 0, 1, 1, 1, 1, 0]",1477,749,728,77,69,0.102803738317757,0.09478021978021978
"[1, 0, 1, 0, 1, 1, 0, 1, 1, 1, 1, 1, 1, 0, 1]",492,144,348,12,32,0.08333333333333333,0.09195402298850575
"[1, 1, 0, 1, 0, 1, 1, 0, 1, 1, 1, 1, 1, 1, 1]",2024,484,1540,44,162,0.09090909090909091,0.10519480519480519
"[0, 1, 1, 1, 1, 0, 0, 0, 0, 0, 0, 1, 1, 1, 1]",1898,1521,377,146,33,0.09598948060486522,0.08753315649867374
"[0, 0, 1, 1, 1, 1, 0, 0, 0, 0, 0, 0, 1, 1, 1]",2192,1214,978,119,89,0.09802306425041186,0.09100204498977506
"[0, 0, 0, 0, 0, 1, 0, 0, 1, 0, 1, 1, 1, 1, 1]",222,130,92,12,6,0.09230769230769231,0.06521739130434782
"[1, 1, 1, 0, 1, 0, 1, 1, 1, 1, 0, 1, 1, 1, 1]",1761,404,1357,44,137,0.10891089108910891,0.10095799557848195
"[1, 1, 1, 1, 0, 1, 0, 1, 1, 1, 1, 0, 1, 1, 1]",1789,438,1351,52,130,0.1187214611872146,0.09622501850481126
"[1, 1, 1, 1, 1, 0, 1, 0, 1, 1, 1, 1, 0, 1, 1]",1674,393,1281,30,124,0.07633587786259542,0.09679937548790007
"[1, 1, 0, 1, 0, 1, 1, 1, 0, 1, 0, 1, 1, 1, 1]",554,176,378,20,23,0.11363636363636363,0.06084656084656084
"[0, 1, 0, 1, 0, 1, 0, 0, 0, 0, 0, 0, 0, 0, 0]",2124,1547,577,171,55,0.11053652230122818,0.09532062391681109
"[0, 0, 0, 0, 0, 0, 1, 0, 1, 0, 1, 0, 1, 0, 0]",531,375,156,31,15,0.08266666666666667,0.09615384615384616
"[0, 0, 0, 0, 0, 0, 0, 0, 0, 1, 0, 1, 0, 1, 0]",1753,1375,378,110,33,0.08,0.0873015873015873
"[1, 1, 1, 0, 1, 1, 1, 1, 1, 0, 0, 0, 0, 0, 0]",376,163,213,14,25,0.08588957055214724,0.11737089201877934
"[1, 0, 1, 0, 0, 1, 1, 1, 1, 0, 1, 1, 1, 1, 1]",691,217,474,26,48,0.11981566820276497,0.10126582278481013
"[1, 0, 0, 0, 1, 1, 1, 1, 0, 1, 0, 0, 1, 1, 1]",186,64,122,7,10,0.109375,0.08196721311475409
"[0, 0, 1, 0, 0, 1, 0, 1, 0, 0, 0, 1, 1, 1, 1]",206,104,102,5,7,0.04807692307692308,0.06862745098039216
"[1, 1, 1, 1, 0, 1, 1, 1, 1, 1, 1, 1, 1, 0, 0]",3179,671,2508,56,230,0.08345752608047691,0.09170653907496013
"[1, 0, 1, 0, 0, 0, 0, 0, 1, 1, 1, 0, 0, 0, 0]",356,217,139,24,13,0.11059907834101383,0.09352517985611511
"[0, 0, 1, 0, 1, 0, 0, 0, 0, 0, 1, 1, 1, 0, 0]",287,160,127,16,12,0.1,0.09448818897637795
"[0, 0, 0, 0, 1, 1, 0, 1, 1, 1, 1, 0, 0, 1, 0]",124,59,65,5,8,0.0847457627118644,0.12307692307692308
"[0, 0, 1, 0, 0, 0, 0, 0, 0, 0, 0, 1, 1, 0, 0]",3600,2776,824,214,87,0.07708933717579251,0.10558252427184465
"[1, 0, 0, 0, 0, 1, 1, 0, 0, 0, 1, 0, 0, 0, 0]",672,405,267,48,26,0.11851851851851852,0.09737827715355805
"[1, 0, 1, 0, 1, 0, 0, 0, 1, 0, 0, 1, 0, 1, 0]",133,77,56,6,4,0.07792207792207792,0.07142857142857142
"[1, 0, 0, 1, 1, 1, 1, 0, 1, 0, 0, 0, 1, 1, 1]",265,90,175,11,14,0.12222222222222222,0.08
"[1, 1, 1, 1, 0, 0, 1, 1, 1, 1, 0, 1, 0, 0, 0]",280,120,160,15,15,0.125,0.09375
"[1, 0, 1, 0, 0, 0, 0, 0, 0, 0, 0, 1, 1, 1, 1]",649,380,269,40,27,0.10526315789473684,0.10037174721189591
"[0, 1, 0, 1, 0, 0, 0, 0, 0, 0, 0, 0, 1, 1, 1]",760,523,237,50,26,0.09560229445506692,0.10970464135021098
"[1, 1, 0, 0, 0, 0, 0, 1, 0, 1, 1, 0, 1, 0, 1]",138,67,71,3,11,0.04477611940298507,0.15492957746478872
"[1, 1, 1, 0, 0, 1, 0, 1, 0, 1, 0, 1, 0, 0, 0]",109,63,46,5,3,0.07936507936507936,0.06521739130434782
"[0, 1, 1, 1, 0, 1, 1, 1, 0, 1, 1, 1, 0, 1, 1]",495,164,331,12,42,0.07317073170731707,0.1268882175226586
"[0, 0, 1, 1, 1, 1, 0, 1, 1, 0, 1, 1, 1, 1, 1]",859,283,576,28,57,0.0989399293286219,0.09895833333333333
"[0, 0, 1, 1, 1, 0, 0, 0, 0, 1, 1, 0, 0, 1, 1]",471,258,213,27,11,0.10465116279069768,0.051643192488262914
"[0, 1, 1, 0, 0, 0, 0, 0, 0, 1, 1, 1, 0, 0, 0]",535,406,129,47,10,0.11576354679802955,0.07751937984496124
"[0, 0, 1, 1, 1, 1, 0, 0, 0, 0, 1, 1, 1, 1, 1]",2284,950,1334,89,142,0.09368421052631579,0.10644677661169415
"[0, 0, 0, 0, 1, 0, 1, 0, 0, 1, 0, 1, 1, 1, 1]",175,90,85,9,15,0.1,0.17647058823529413
"[1, 0, 1, 0, 0, 0, 0, 1, 0, 1, 0, 0, 1, 0, 1]",142,95,47,7,3,0.07368421052631578,0.06382978723404255
"[0, 0, 0, 0, 1, 1, 1, 0, 1, 0, 1, 0, 0, 0, 0]",283,185,98,16,10,0.08648648648648649,0.10204081632653061
"[0, 0, 1, 1, 1, 1, 0, 1, 0, 0, 0, 1, 0, 1, 0]",104,52,52,4,2,0.07692307692307693,0.038461538461538464
"[1, 1, 0, 1, 0, 0, 0, 1, 0, 0, 0, 1, 1, 1, 1]",152,86,66,8,6,0.09302325581395349,0.09090909090909091
"[0, 0, 1, 0, 0, 0, 0, 1, 1, 0, 0, 0, 0, 0, 0]",3327,2540,787,212,84,0.08346456692913386,0.10673443456162643
"[0, 0, 0, 1, 1, 0, 0, 0, 0, 0, 0, 1, 0, 0, 0]",2520,2076,444,171,41,0.08236994219653179,0.09234234234234234
"[1, 1, 1, 0, 1, 1, 1, 1, 0, 0, 0, 1, 0, 1, 1]",280,83,197,9,22,0.10843373493975904,0.1116751269035533
"[0, 1, 1, 0, 1, 0, 1, 0, 1, 0, 0, 1, 1, 1, 0]",103,50,53,8,8,0.16,0.1509433962264151
"[0, 0, 1, 1, 0, 1, 0, 1, 0, 1, 0, 0, 1, 1, 1]",153,71,82,9,8,0.1267605633802817,0.0975609756097561
"[1, 1, 0, 0, 0, 0, 0, 1, 1, 1, 0, 0, 0, 0, 1]",249,146,103,16,6,0.1095890410958904,0.05825242718446602
"[1, 0, 1, 1, 0, 1, 1, 0, 0, 0, 0, 0, 0, 0, 1]",189,96,93,10,11,0.10416666666666667,0.11827956989247312
"[1, 1, 1, 1, 1, 0, 1, 1, 0, 1, 1, 0, 1, 1, 0]",504,157,347,15,30,0.09554140127388536,0.08645533141210375
"[1, 0, 1, 0, 0, 1, 1, 1, 1, 1, 0, 1, 1, 0, 0]",162,67,95,6,8,0.08955223880597014,0.08421052631578947
"[1, 1, 0, 1, 0, 1, 1, 0, 1, 0, 0, 1, 1, 1, 1]",329,120,209,16,20,0.13333333333333333,0.09569377990430622
"[1, 1, 1, 1, 0, 0, 0, 1, 1, 0, 1, 0, 1, 1, 0]",188,76,112,9,11,0.11842105263157894,0.09821428571428571
"[1, 1, 0, 1, 0, 1, 0, 1, 1, 1, 1, 0, 1, 1, 1]",551,159,392,30,35,0.18867924528301888,0.08928571428571429
"[0, 0, 0, 1, 1, 0, 0, 0, 0, 0, 0, 1, 0, 1, 0]",802,619,183,61,15,0.09854604200323101,0.08196721311475409
"[0, 0, 0, 0, 0, 0, 0, 0, 1, 0, 0, 1, 0, 1, 0]",1677,1280,397,136,37,0.10625,0.09319899244332494
"[1, 0, 0, 1, 1, 0, 0, 0, 0, 0, 0, 0, 1, 0, 0]",832,415,417,38,42,0.09156626506024096,0.10071942446043165
"[1, 0, 0, 0, 1, 1, 1, 1, 1, 0, 1, 0, 1, 1, 0]",148,72,76,7,11,0.09722222222222222,0.14473684210526316
"[1, 1, 1, 0, 1, 0, 0, 1, 0, 0, 0, 1, 1, 1, 1]",187,79,108,11,10,0.13924050632911392,0.09259259259259259
"[0, 1, 1, 1, 1, 0, 1, 0, 0, 1, 0, 0, 0, 1, 1]",126,65,61,4,8,0.06153846153846154,0.13114754098360656
"[1, 0, 1, 0, 0, 1, 1, 1, 1, 0, 1, 0, 0, 1, 0]",99,35,64,3,6,0.08571428571428572,0.09375
"[1, 0, 0, 1, 1, 0, 1, 0, 0, 1, 1, 1, 1, 0, 1]",167,67,100,7,10,0.1044776119402985,0.1
"[1, 0, 0, 1, 1, 1, 0, 0, 1, 1, 1, 1, 1, 1, 0]",461,156,305,21,31,0.1346153846153846,0.10163934426229508
"[1, 1, 1, 0, 0, 1, 1, 1, 0, 0, 1, 1, 1, 1, 1]",1178,301,877,33,82,0.10963455149501661,0.09350057012542759
"[1, 0, 1, 0, 1, 1, 1, 0, 0, 0, 0, 1, 0, 0, 1]",132,67,65,4,7,0.05970149253731343,0.1076923076923077
"[1, 1, 0, 1, 0, 1, 0, 1, 1, 1, 0, 0, 0, 0, 1]",171,70,101,9,9,0.12857142857142856,0.0891089108910891
"[1, 0, 0, 1, 1, 1, 1, 1, 1, 0, 1, 0, 1, 0, 1]",282,81,201,6,25,0.07407407407407407,0.12437810945273632
"[0, 0, 1, 1, 1, 1, 1, 1, 1, 1, 1, 0, 0, 1, 0]",403,145,258,23,19,0.15862068965517243,0.07364341085271318
"[1, 0, 0, 0, 1, 1, 1, 1, 1, 1, 1, 1, 1, 0, 0]",657,230,427,24,37,0.10434782608695652,0.08665105386416862
"[1, 0, 0, 0, 0, 0, 1, 0, 0, 0, 1, 1, 1, 1, 1]",255,121,134,13,15,0.10743801652892562,0.11194029850746269
"[1, 0, 1, 0, 1, 0, 0, 0, 0, 0, 0, 0, 0, 1, 0]",574,400,174,32,16,0.08,0.09195402298850575
"[0, 1, 0, 0, 0, 1, 0, 1, 0, 1, 0, 0, 0, 0, 0]",572,397,175,33,25,0.08312342569269521,0.14285714285714285
"[0, 0, 1, 1, 1, 1, 1, 1, 1, 1, 1, 0, 0, 0, 0]",825,396,429,27,41,0.06818181818181818,0.09557109557109557
"[0, 1, 0, 0, 0, 0, 0, 1, 1, 1, 1, 1, 1, 1, 1]",585,272,313,24,27,0.08823529411764706,0.08626198083067092
"[1, 1, 1, 1, 1, 0, 0, 0, 1, 0, 0, 0, 0, 0, 1]",164,66,98,6,6,0.09090909090909091,0.061224489795918366
"[1, 1, 0, 1, 0, 1, 1, 1, 1, 1, 0, 0, 0, 1, 0]",152,62,90,8,9,0.12903225806451613,0.1
"[1, 1, 0, 0, 1, 1, 1, 0, 1, 1, 1, 1, 1, 1, 0]",665,194,471,11,44,0.05670103092783505,0.09341825902335456
"[0, 0, 1, 1, 0, 0, 1, 0, 0, 0, 0, 0, 1, 0, 0]",567,397,170,31,14,0.07808564231738035,0.08235294117647059
"[0, 1, 0, 1, 0, 0, 0, 1, 0, 0, 1, 1, 0, 0, 1]",183,117,66,7,8,0.05982905982905983,0.12121212121212122
"[1, 1, 0, 1, 0, 1, 0, 1, 0, 0, 0, 0, 1, 0, 1]",127,69,58,4,8,0.057971014492753624,0.13793103448275862
"[0, 1, 1, 0, 0, 0, 1, 0, 1, 1, 1, 0, 1, 0, 1]",108,54,54,11,6,0.2037037037037037,0.1111111111111111
"[0, 0, 0, 1, 0, 0, 1, 1, 1, 1, 1, 1, 0, 0, 0]",317,172,145,22,16,0.12790697674418605,0.1103448275862069
"[1, 1, 0, 1, 1, 1, 0, 1, 0, 0, 0, 1, 0, 0, 1]",108,52,56,5,12,0.09615384615384616,0.21428571428571427
"[0, 0, 0, 1, 0, 0, 1, 0, 0, 1, 1, 0, 1, 1, 1]",172,95,77,6,5,0.06315789473684211,0.06493506493506493
"[1, 0, 1, 1, 1, 0, 1, 1, 1, 1, 1, 1, 0, 0, 0]",387,133,254,11,21,0.08270676691729323,0.08267716535433071
"[1, 1, 1, 0, 1, 1, 1, 0, 1, 1, 1, 1, 1, 1, 0]",1667,407,1260,37,114,0.09090909090909091,0.09047619047619047
"[0, 0, 1, 1, 1, 1, 0, 0, 1, 1, 1, 1, 1, 1, 0]",2053,817,1236,80,133,0.09791921664626684,0.1076051779935275
"[0, 0, 0, 1, 0, 0, 0, 0, 1, 1, 1, 1, 0, 1, 1]",159,80,79,8,4,0.1,0.05063291139240506
"[0, 0, 0, 0, 0, 1, 0, 0, 0, 0, 1, 1, 1, 1, 0]",543,376,167,33,10,0.08776595744680851,0.059880239520958084
"[1, 0, 0, 1, 1, 0, 0, 0, 0, 1, 0, 0, 0, 0, 1]",391,189,202,11,17,0.0582010582010582,0.08415841584158416
"[0, 0, 1, 1, 0, 0, 0, 0, 0, 1, 0, 1, 0, 0, 0]",679,441,238,48,14,0.10884353741496598,0.058823529411764705
"[0, 1, 0, 0, 0, 0, 0, 0, 1, 0, 0, 0, 0, 1, 0]",1411,1061,350,103,29,0.09707822808671066,0.08285714285714285
"[1, 1, 1, 1, 1, 0, 1, 0, 1, 0, 1, 1, 0, 1, 0]",254,74,180,7,17,0.0945945945945946,0.09444444444444444
"[0, 1, 0, 0, 1, 1, 1, 1, 0, 1, 1, 1, 0, 1, 0]",119,49,70,5,7,0.10204081632653061,0.1
"[1, 1, 0, 0, 1, 0, 0, 1, 1, 1, 1, 0, 1, 1, 1]",328,111,217,10,19,0.09009009009009009,0.08755760368663594
"[1, 0, 1, 1, 1, 0, 1, 0, 1, 1, 1, 1, 0, 0, 1]",308,114,194,9,17,0.07894736842105263,0.08762886597938144
"[0, 0, 0, 0, 0, 0, 1, 1, 0, 0, 0, 0, 0, 1, 0]",2608,2014,594,192,57,0.09533267130089375,0.09595959595959595
"[1, 0, 0, 0, 0, 0, 0, 0, 0, 0, 0, 1, 0, 0, 1]",2049,1263,786,107,58,0.08471892319873317,0.0737913486005089
"[0, 0, 1, 0, 0, 1, 1, 1, 1, 1, 1, 0, 1, 1, 1]",328,119,209,16,17,0.13445378151260504,0.08133971291866028
"[0, 0, 0, 0, 1, 1, 1, 0, 1, 0, 0, 0, 0, 0, 0]",779,542,237,52,18,0.0959409594095941,0.0759493670886076
"[0, 1, 0, 1, 1, 0, 0, 0, 0, 0, 0, 0, 1, 1, 1]",362,222,140,23,10,0.1036036036036036,0.07142857142857142
"[1, 0, 1, 1, 0, 1, 1, 1, 0, 0, 0, 0, 1, 0, 0]",124,59,65,5,4,0.0847457627118644,0.06153846153846154
"[0, 1, 0, 1, 0, 1, 0, 1, 1, 0, 0, 0, 1, 0, 1]",131,71,60,6,6,0.08450704225352113,0.1
"[0, 0, 0, 0, 1, 0, 0, 1, 1, 0, 0, 1, 0, 0, 1]",285,178,107,21,7,0.11797752808988764,0.06542056074766354
"[1, 0, 0, 0, 0, 0, 0, 0, 0, 0, 1, 0, 1, 1, 1]",824,371,453,41,45,0.1105121293800539,0.09933774834437085
"[0, 0, 1, 0, 0, 0, 1, 0, 1, 0, 0, 1, 1, 0, 0]",348,233,115,24,16,0.10300429184549356,0.1391304347826087
"[1, 0, 1, 0, 0, 0, 0, 0, 1, 0, 0, 0, 0, 0, 0]",1803,1376,427,125,33,0.09084302325581395,0.07728337236533958
"[0, 0, 0, 1, 1, 1, 0, 0, 1, 1, 1, 1, 0, 0, 1]",283,157,126,16,14,0.10191082802547771,0.1111111111111111
"[0, 1, 1, 1, 1, 0, 1, 0, 1, 1, 1, 1, 1, 0, 0]",320,130,190,8,25,0.06153846153846154,0.13157894736842105
"[0, 1, 0, 0, 0, 0, 1, 1, 0, 0, 1, 1, 0, 1, 1]",163,91,72,13,2,0.14285714285714285,0.027777777777777776
"[0, 1, 0, 0, 1, 1, 0, 0, 1, 1, 1, 0, 0, 1, 1]",157,78,79,6,6,0.07692307692307693,0.0759493670886076
"[0, 1, 0, 1, 0, 1, 1, 1, 0, 1, 1, 0, 0, 1, 1]",168,70,98,8,7,0.11428571428571428,0.07142857142857142
"[0, 0, 0, 1, 1, 0, 1, 0, 1, 0, 1, 1, 1, 0, 1]",110,59,51,2,6,0.03389830508474576,0.11764705882352941
"[1, 1, 1, 1, 1, 0, 1, 1, 1, 0, 0, 1, 0, 0, 0]",180,76,104,9,11,0.11842105263157894,0.10576923076923077
"[1, 1, 0, 1, 1, 1, 1, 1, 1, 1, 0, 1, 0, 1, 0]",520,154,366,16,35,0.1038961038961039,0.09562841530054644
"[1, 1, 1, 0, 1, 1, 1, 1, 1, 1, 1, 0, 1, 0, 1]",1528,339,1189,37,111,0.10914454277286136,0.09335576114381834
"[1, 1, 1, 0, 1, 1, 1, 1, 0, 1, 1, 1, 0, 1, 1]",1614,359,1255,31,133,0.08635097493036212,0.10597609561752988
"[0, 1, 1, 0, 1, 1, 0, 1, 1, 0, 1, 1, 1, 1, 1]",602,209,393,16,43,0.07655502392344497,0.10941475826972011
"[1, 1, 1, 1, 1, 0, 0, 1, 1, 1, 1, 0, 0, 0, 1]",721,146,575,21,47,0.14383561643835616,0.0817391304347826
"[0, 1, 1, 1, 0, 0, 0, 0, 1, 1, 1, 1, 1, 1, 1]",933,380,553,31,60,0.08157894736842106,0.10849909584086799
"[1, 1, 0, 0, 0, 0, 1, 1, 1, 1, 1, 1, 0, 0, 0]",1551,765,786,78,70,0.10196078431372549,0.089058524173028
"[0, 0, 1, 0, 1, 1, 1, 0, 1, 0, 0, 1, 1, 1, 1]",185,88,97,10,7,0.11363636363636363,0.07216494845360824
"[1, 1, 1, 0, 1, 0, 0, 0, 1, 0, 0, 1, 0, 1, 1]",122,55,67,4,9,0.07272727272727272,0.13432835820895522
"[0, 1, 1, 1, 1, 1, 1, 0, 1, 1, 0, 0, 0, 1, 1]",351,144,207,12,14,0.08333333333333333,0.06763285024154589
"[1, 0, 0, 0, 0, 0, 0, 0, 0, 1, 1, 0, 0, 0, 0]",6703,3127,3576,291,322,0.09306044131755677,0.09004474272930649
"[1, 1, 0, 0, 1, 0, 0, 1, 1, 0, 1, 1, 0, 1, 0]",100,45,55,2,7,0.044444444444444446,0.12727272727272726
"[0, 1, 0, 0, 0, 1, 0, 0, 1, 0, 0, 1, 0, 1, 0]",192,119,73,11,8,0.09243697478991597,0.1095890410958904
"[0, 1, 0, 0, 0, 1, 0, 1, 0, 0, 0, 1, 0, 0, 1]",223,144,79,12,12,0.08333333333333333,0.1518987341772152
"[1, 0, 0, 0, 1, 1, 0, 0, 1, 0, 0, 0, 1, 0, 1]",139,80,59,7,5,0.0875,0.0847457627118644
"[0, 0, 1, 1, 1, 1, 1, 1, 1, 0, 1, 1, 1, 1, 0]",709,219,490,22,46,0.1004566210045662,0.09387755102040816
"[1, 1, 1, 0, 0, 0, 0, 0, 0, 1, 1, 1, 1, 0, 0]",1593,334,1259,36,148,0.10778443113772455,0.11755361397934869
"[1, 0, 1, 1, 0, 0, 0, 1, 0, 1, 0, 0, 1, 1, 1]",145,65,80,8,13,0.12307692307692308,0.1625
"[0, 0, 0, 0, 1, 1, 0, 0, 0, 1, 1, 0, 0, 1, 1]",404,240,164,21,14,0.0875,0.08536585365853659
"[1, 0, 0, 1, 1, 1, 1, 1, 0, 0, 0, 0, 1, 1, 0]",314,143,171,13,21,0.09090909090909091,0.12280701754385964
"[1, 1, 1, 0, 1, 0, 1, 0, 0, 1, 1, 1, 1, 1, 0]",254,79,175,12,20,0.1518987341772152,0.11428571428571428
"[0, 1, 0, 0, 1, 0, 1, 1, 0, 1, 1, 1, 1, 0, 1]",140,54,86,5,4,0.09259259259259259,0.046511627906976744
"[0, 0, 0, 0, 0, 0, 1, 0, 0, 0, 1, 0, 1, 0, 0]",1622,1227,395,108,42,0.08801955990220049,0.10632911392405063
"[0, 0, 0, 0, 0, 0, 0, 1, 0, 0, 0, 1, 0, 1, 0]",1606,1224,382,113,34,0.0923202614379085,0.08900523560209424
"[0, 0, 1, 1, 1, 1, 0, 0, 1, 0, 0, 1, 1, 1, 1]",404,189,215,18,21,0.09523809523809523,0.09767441860465116
"[1, 1, 1, 1, 1, 0, 0, 1, 1, 1, 1, 0, 0, 1, 0]",551,119,432,11,36,0.09243697478991597,0.08333333333333333
"[1, 1, 0, 1, 1, 1, 1, 0, 1, 1, 1, 1, 1, 0, 0]",686,195,491,25,47,0.1282051282051282,0.09572301425661914
"[0, 1, 0, 0, 1, 1, 1, 1, 1, 0, 1, 1, 0, 1, 1]",249,89,160,7,21,0.07865168539325842,0.13125
"[0, 0, 1, 1, 0, 1, 1, 1, 1, 0, 1, 0, 0, 0, 0]",129,68,61,5,5,0.07352941176470588,0.08196721311475409
"[1, 1, 1, 1, 1, 1, 0, 1, 1, 1, 0, 1, 0, 1, 0]",483,121,362,8,34,0.06611570247933884,0.09392265193370165
"[0, 1, 0, 1, 1, 1, 1, 0, 1, 1, 1, 0, 1, 1, 1]",517,165,352,13,29,0.07878787878787878,0.08238636363636363
"[1, 1, 0, 1, 1, 0, 1, 0, 1, 1, 1, 1, 0, 1, 1]",525,159,366,13,42,0.08176100628930817,0.11475409836065574
"[1, 1, 1, 0, 1, 1, 0, 1, 0, 1, 1, 1, 1, 0, 1]",500,152,348,17,42,0.1118421052631579,0.1206896551724138
"[0, 0, 0, 0, 1, 0, 1, 0, 1, 1, 1, 0, 1, 0, 0]",134,73,61,9,5,0.1232876712328767,0.08196721311475409
"[1, 1, 1, 1, 0, 1, 0, 1, 1, 1, 0, 0, 0, 0, 0]",232,84,148,4,18,0.047619047619047616,0.12162162162162163
"[0, 0, 1, 1, 1, 1, 1, 0, 1, 0, 1, 1, 1, 0, 0]",182,66,116,4,9,0.06060606060606061,0.07758620689655173
"[0, 0, 1, 0, 1, 0, 0, 0, 1, 0, 0, 0, 1, 1, 1]",221,140,81,15,7,0.10714285714285714,0.08641975308641975
"[1, 1, 0, 0, 0, 0, 0, 1, 1, 1, 1, 0, 1, 0, 1]",170,73,97,9,6,0.1232876712328767,0.061855670103092786
"[1, 1, 0, 0, 1, 1, 0, 1, 1, 0, 1, 1, 1, 1, 1]",835,236,599,19,57,0.08050847457627118,0.09515859766277128
"[1, 0, 1, 1, 1, 1, 1, 0, 1, 1, 0, 0, 1, 1, 0]",319,101,218,7,19,0.06930693069306931,0.0871559633027523
"[0, 0, 1, 1, 0, 1, 1, 1, 1, 0, 1, 1, 0, 1, 1]",265,99,166,10,18,0.10101010101010101,0.10843373493975904
"[1, 1, 1, 1, 0, 0, 0, 0, 1, 1, 0, 0, 1, 1, 1]",2484,998,1486,76,144,0.07615230460921844,0.09690444145356662
"[1, 1, 1, 1, 1, 1, 1, 1, 0, 0, 0, 0, 1, 1, 0]",2404,886,1518,96,157,0.10835214446952596,0.10342555994729907
"[1, 0, 0, 0, 0, 0, 0, 1, 1, 1, 1, 1, 1, 1, 1]",2594,457,2137,43,194,0.09409190371991247,0.09078146934955546
"[1, 0, 0, 0, 1, 0, 1, 0, 0, 1, 0, 1, 0, 1, 0]",133,72,61,6,7,0.08333333333333333,0.11475409836065574
"[0, 0, 1, 1, 1, 1, 1, 0, 1, 0, 1, 0, 1, 1, 0]",146,58,88,7,5,0.1206896551724138,0.056818181818181816
"[1, 0, 0, 1, 1, 1, 1, 1, 0, 1, 0, 1, 0, 1, 1]",254,90,164,10,13,0.1111111111111111,0.07926829268292683
"[0, 1, 1, 1, 1, 1, 0, 0, 1, 0, 0, 0, 0, 0, 0]",238,136,102,19,10,0.13970588235294118,0.09803921568627451
"[1, 0, 0, 1, 1, 1, 1, 1, 0, 0, 1, 0, 0, 0, 0]",134,65,69,8,6,0.12307692307692308,0.08695652173913043
"[1, 1, 0, 0, 1, 1, 1, 1, 1, 0, 0, 1, 0, 0, 0]",154,69,85,7,5,0.10144927536231885,0.058823529411764705
"[1, 0, 1, 1, 0, 1, 1, 0, 1, 0, 1, 0, 0, 0, 0]",119,58,61,2,7,0.034482758620689655,0.11475409836065574
"[0, 0, 1, 1, 0, 1, 1, 0, 1, 1, 0, 1, 0, 1, 0]",100,53,47,4,4,0.07547169811320754,0.0851063829787234
"[0, 1, 0, 1, 1, 0, 0, 0, 1, 1, 0, 1, 1, 0, 1]",116,56,60,3,1,0.05357142857142857,0.016666666666666666
"[1, 1, 0, 1, 0, 0, 1, 1, 0, 1, 0, 1, 1, 0, 0]",131,66,65,4,7,0.06060606060606061,0.1076923076923077
"[1, 1, 0, 1, 1, 1, 0, 1, 0, 0, 1, 1, 0, 1, 0]",163,72,91,7,4,0.09722222222222222,0.04395604395604396
"[1, 0, 1, 0, 0, 0, 0, 0, 0, 1, 1, 0, 0, 0, 1]",316,208,108,20,12,0.09615384615384616,0.1111111111111111
"[1, 1, 0, 0, 0, 1, 0, 0, 0, 0, 1, 0, 0, 0, 0]",648,477,171,55,22,0.11530398322851153,0.1286549707602339
"[0, 0, 1, 1, 0, 1, 0, 0, 1, 1, 0, 0, 0, 1, 0]",136,89,47,12,4,0.1348314606741573,0.0851063829787234
"[0, 0, 0, 0, 0, 1, 1, 0, 1, 0, 0, 1, 1, 0, 0]",373,247,126,20,4,0.08097165991902834,0.031746031746031744
"[0, 0, 0, 0, 0, 0, 1, 1, 0, 1, 0, 0, 1, 1, 0]",341,219,122,19,13,0.0867579908675799,0.10655737704918032
"[1, 1, 1, 0, 1, 0, 1, 0, 0, 0, 0, 1, 1, 1, 1]",293,129,164,11,15,0.08527131782945736,0.09146341463414634
"[1, 0, 1, 1, 1, 1, 1, 1, 1, 1, 1, 0, 1, 1, 0]",1605,356,1249,32,115,0.0898876404494382,0.09207365892714171
"[1, 1, 0, 0, 0, 0, 1, 1, 1, 1, 0, 1, 1, 1, 0]",246,99,147,11,15,0.1111111111111111,0.10204081632653061
"[0, 1, 1, 0, 1, 1, 1, 1, 0, 0, 0, 1, 0, 1, 1]",159,71,88,7,10,0.09859154929577464,0.11363636363636363
"[1, 0, 1, 0, 1, 1, 0, 1, 1, 1, 1, 0, 0, 0, 1]",157,71,86,6,7,0.08450704225352113,0.08139534883720931
"[0, 0, 0, 1, 0, 0, 0, 1, 1, 1, 1, 0, 1, 0, 1]",111,60,51,4,5,0.06666666666666667,0.09803921568627451
"[0, 1, 1, 0, 0, 0, 1, 0, 0, 0, 1, 1, 1, 1, 0]",164,105,59,11,5,0.10476190476190476,0.0847457627118644
"[0, 1, 0, 0, 0, 1, 0, 1, 0, 1, 1, 0, 0, 0, 1]",129,73,56,6,1,0.0821917808219178,0.017857142857142856
"[1, 0, 1, 0, 0, 0, 1, 0, 1, 0, 1, 1, 0, 0, 0]",132,83,49,8,3,0.0963855421686747,0.061224489795918366
"[1, 1, 1, 0, 1, 1, 1, 1, 0, 1, 1, 0, 0, 1, 1]",714,209,505,17,47,0.08133971291866028,0.09306930693069307
"[1, 1, 1, 0, 1, 1, 0, 0, 1, 1, 0, 1, 1, 1, 0]",235,85,150,7,17,0.08235294117647059,0.11333333333333333
"[0, 1, 0, 1, 0, 0, 1, 1, 1, 1, 1, 1, 0, 0, 1]",336,123,213,9,14,0.07317073170731707,0.06572769953051644
"[1, 0, 1, 1, 0, 1, 0, 1, 0, 0, 1, 1, 1, 1, 1]",293,96,197,9,23,0.09375,0.116751269035533
"[1, 1, 1, 1, 0, 1, 1, 0, 1, 0, 1, 0, 0, 1, 1]",299,99,200,12,30,0.12121212121212122,0.15
"[0, 0, 0, 0, 0, 1, 1, 0, 0, 1, 0, 1, 0, 1, 1]",285,204,81,25,7,0.12254901960784313,0.08641975308641975
"[0, 1, 1, 1, 1, 0, 1, 1, 0, 1, 1, 1, 1, 0, 1]",551,167,384,18,49,0.10778443113772455,0.12760416666666666
"[0, 1, 1, 1, 0, 1, 1, 0, 0, 1, 0, 1, 1, 1, 1]",271,118,153,11,16,0.09322033898305085,0.10457516339869281
"[0, 1, 1, 1, 1, 1, 0, 1, 0, 1, 1, 0, 0, 0, 0]",190,102,88,12,7,0.11764705882352941,0.07954545454545454
"[0, 1, 0, 0, 1, 1, 1, 1, 1, 0, 1, 0, 1, 1, 0]",136,70,66,10,10,0.14285714285714285,0.15151515151515152
"[0, 1, 0, 0, 1, 1, 0, 1, 1, 0, 1, 1, 1, 0, 1]",121,46,75,4,5,0.08695652173913043,0.06666666666666667
"[0, 1, 0, 1, 0, 0, 1, 1, 0, 1, 1, 0, 1, 1, 1]",148,58,90,6,7,0.10344827586206896,0.07777777777777778
"[0, 0, 1, 1, 1, 1, 1, 1, 1, 0, 0, 0, 0, 1, 1]",672,287,385,21,30,0.07317073170731707,0.07792207792207792
"[1, 0, 0, 0, 1, 1, 1, 1, 1, 1, 1, 0, 0, 0, 0]",323,143,180,7,10,0.04895104895104895,0.05555555555555555
"[0, 1, 1, 0, 0, 0, 1, 0, 1, 1, 0, 0, 0, 1, 1]",154,89,65,11,4,0.12359550561797752,0.06153846153846154
"[1, 0, 0, 0, 1, 0, 0, 1, 0, 1, 1, 0, 0, 0, 1]",150,89,61,7,9,0.07865168539325842,0.14754098360655737
"[1, 1, 0, 0, 1, 0, 1, 1, 1, 0, 0, 0, 0, 0, 1]",146,73,73,9,12,0.1232876712328767,0.1643835616438356
"[1, 0, 0, 0, 1, 1, 1, 0, 0, 1, 0, 1, 1, 1, 0]",115,50,65,9,2,0.18,0.03076923076923077
"[1, 1, 0, 0, 0, 0, 0, 0, 0, 1, 0, 1, 0, 0, 0]",694,488,206,54,15,0.11065573770491803,0.07281553398058252
"[0, 0, 1, 1, 1, 0, 1, 1, 0, 1, 0, 0, 1, 1, 1]",208,75,133,4,11,0.05333333333333334,0.08270676691729323
"[1, 1, 1, 0, 1, 0, 1, 0, 1, 1, 1, 0, 1, 1, 1]",576,161,415,17,32,0.10559006211180125,0.07710843373493977
"[0, 1, 1, 0, 1, 1, 1, 0, 1, 0, 1, 0, 1, 1, 1]",256,101,155,10,21,0.09900990099009901,0.13548387096774195
"[0, 1, 0, 1, 1, 1, 0, 0, 1, 0, 1, 0, 1, 1, 1]",168,86,82,6,5,0.06976744186046512,0.06097560975609756
"[0, 1, 0, 1, 1, 0, 0, 1, 0, 1, 1, 1, 0, 0, 1]",136,58,78,9,5,0.15517241379310345,0.0641025641025641
"[0, 0, 0, 0, 0, 1, 1, 0, 0, 1, 1, 0, 1, 0, 1]",328,254,74,40,9,0.15748031496062992,0.12162162162162163
"[1, 1, 1, 0, 0, 0, 0, 1, 0, 1, 1, 1, 0, 1, 0]",110,53,57,8,3,0.1509433962264151,0.05263157894736842
"[1, 1, 1, 1, 0, 0, 0, 0, 1, 0, 1, 1, 1, 0, 1]",170,59,111,3,7,0.05084745762711865,0.06306306306306306
"[1, 0, 1, 0, 1, 1, 0, 1, 1, 1, 1, 1, 0, 0, 1]",298,95,203,15,18,0.15789473684210525,0.08866995073891626
"[1, 0, 0, 0, 1, 1, 0, 1, 0, 1, 1, 0, 1, 1, 1]",168,55,113,4,12,0.07272727272727272,0.10619469026548672
"[1, 0, 1, 0, 1, 1, 1, 1, 0, 0, 0, 1, 1, 0, 1]",143,63,80,6,5,0.09523809523809523,0.0625
"[1, 0, 1, 1, 1, 1, 0, 1, 0, 1, 0, 1, 0, 1, 1]",240,98,142,6,11,0.061224489795918366,0.07746478873239436
"[0, 1, 1, 1, 1, 0, 1, 0, 1, 1, 1, 1, 0, 1, 0]",233,106,127,11,10,0.10377358490566038,0.07874015748031496
"[1, 0, 0, 1, 1, 0, 0, 0, 0, 1, 0, 1, 1, 0, 1]",134,54,80,4,12,0.07407407407407407,0.15
"[1, 1, 1, 1, 0, 1, 1, 0, 1, 1, 1, 0, 1, 0, 0]",257,102,155,7,13,0.06862745098039216,0.08387096774193549
"[1, 0, 0, 1, 1, 1, 0, 0, 0, 1, 1, 1, 0, 1, 0]",111,46,65,4,5,0.08695652173913043,0.07692307692307693
"[0, 0, 0, 0, 0, 1, 1, 0, 1, 1, 0, 0, 0, 0, 0]",875,643,232,75,18,0.1166407465007776,0.07758620689655173
"[0, 0, 0, 0, 0, 0, 0, 1, 1, 0, 1, 1, 0, 0, 0]",833,629,204,70,20,0.11128775834658187,0.09803921568627451
"[0, 0, 0, 1, 1, 1, 1, 1, 0, 0, 1, 0, 0, 0, 0]",227,131,96,14,10,0.10687022900763359,0.10416666666666667
"[0, 1, 1, 1, 1, 0, 1, 0, 0, 0, 0, 1, 1, 1, 1]",309,154,155,16,17,0.1038961038961039,0.10967741935483871
"[0, 0, 1, 0, 1, 0, 0, 0, 0, 1, 1, 1, 1, 0, 1]",120,63,57,10,5,0.15873015873015872,0.08771929824561403
"[0, 0, 0, 0, 1, 0, 1, 0, 0, 0, 0, 1, 1, 1, 1]",410,285,125,28,8,0.09824561403508772,0.064
"[1, 1, 1, 0, 0, 1, 0, 1, 0, 1, 0, 0, 1, 0, 0]",106,53,53,4,5,0.07547169811320754,0.09433962264150944
"[1, 1, 1, 1, 1, 0, 0, 1, 0, 1, 0, 1, 0, 0, 1]",183,68,115,11,9,0.16176470588235295,0.0782608695652174
"[0, 0, 1, 1, 1, 1, 1, 0, 0, 1, 0, 1, 0, 1, 0]",127,58,69,10,7,0.1724137931034483,0.10144927536231885
"[0, 0, 0, 0, 0, 1, 0, 1, 1, 0, 0, 1, 0, 1, 1]",170,106,64,3,6,0.02830188679245283,0.09375
"[1, 0, 1, 1, 0, 1, 0, 1, 1, 0, 1, 0, 1, 1, 1]",265,90,175,9,8,0.1,0.045714285714285714
"[1, 1, 1, 0, 1, 1, 0, 1, 0, 1, 1, 0, 1, 0, 1]",223,79,144,4,17,0.05063291139240506,0.11805555555555555
"[0, 0, 0, 1, 1, 0, 0, 1, 0, 1, 0, 0, 0, 0, 0]",747,557,190,45,18,0.0807899461400359,0.09473684210526316
"[0, 1, 1, 0, 0, 0, 0, 0, 1, 0, 1, 1, 1, 1, 1]",256,152,104,14,14,0.09210526315789473,0.1346153846153846
"[1, 0, 0, 1, 1, 0, 0, 0, 0, 0, 1, 0, 1, 1, 1]",297,100,197,7,10,0.07,0.050761421319796954
"[1, 1, 0, 0, 0, 1, 0, 0, 0, 0, 1, 1, 0, 0, 1]",251,136,115,16,11,0.11764705882352941,0.09565217391304348
"[0, 1, 0, 0, 1, 1, 1, 1, 0, 0, 0, 1, 0, 0, 0]",171,102,69,11,4,0.10784313725490197,0.057971014492753624
"[0, 1, 0, 1, 1, 1, 1, 1, 0, 1, 0, 0, 1, 0, 1]",126,57,69,7,9,0.12280701754385964,0.13043478260869565
"[0, 0, 1, 1, 1, 0, 0, 1, 0, 1, 0, 1, 1, 1, 1]",203,95,108,8,10,0.08421052631578947,0.09259259259259259
"[0, 1, 0, 1, 1, 0, 0, 0, 1, 0, 1, 1, 1, 1, 0]",108,50,58,3,5,0.06,0.08620689655172414
"[1, 1, 0, 0, 1, 1, 0, 0, 0, 1, 1, 0, 0, 0, 1]",179,103,76,9,7,0.08737864077669903,0.09210526315789473
"[1, 0, 1, 0, 0, 1, 1, 1, 0, 0, 0, 0, 0, 1, 1]",149,77,72,7,6,0.09090909090909091,0.08333333333333333
"[0, 1, 1, 1, 0, 1, 0, 0, 1, 1, 1, 0, 0, 0, 0]",131,68,63,3,5,0.04411764705882353,0.07936507936507936
"[0, 0, 1, 1, 0, 0, 0, 1, 0, 1, 0, 1, 1, 1, 1]",179,86,93,4,8,0.046511627906976744,0.08602150537634409
"[1, 0, 0, 0, 0, 0, 0, 1, 1, 1, 0, 0, 0, 0, 0]",962,544,418,50,36,0.09191176470588236,0.0861244019138756
"[0, 0, 1, 1, 1, 0, 0, 0, 0, 0, 0, 1, 1, 1, 0]",267,163,104,15,8,0.09202453987730061,0.07692307692307693
"[1, 0, 0, 0, 0, 1, 1, 1, 0, 0, 0, 1, 1, 1, 0]",143,66,77,9,9,0.13636363636363635,0.11688311688311688
"[0, 1, 1, 0, 0, 1, 1, 0, 0, 1, 0, 0, 1, 1, 0]",160,99,61,5,3,0.050505050505050504,0.04918032786885246
"[0, 0, 0, 1, 1, 0, 0, 1, 1, 0, 0, 1, 0, 0, 1]",290,217,73,31,8,0.14285714285714285,0.1095890410958904
"[0, 1, 1, 0, 0, 0, 0, 0, 0, 0, 0, 1, 0, 0, 1]",1006,778,228,85,22,0.10925449871465295,0.09649122807017543
"[0, 0, 0, 0, 1, 0, 0, 0, 0, 0, 1, 0, 0, 0, 1]",1584,1196,388,114,47,0.09531772575250837,0.1211340206185567
"[1, 1, 0, 0, 0, 0, 0, 0, 0, 1, 1, 0, 0, 0, 0]",1495,996,499,103,43,0.10341365461847389,0.08617234468937876
"[1, 1, 1, 0, 0, 0, 0, 0, 0, 0, 1, 1, 0, 0, 0]",623,315,308,30,33,0.09523809523809523,0.10714285714285714
"[1, 0, 0, 1, 1, 0, 0, 0, 1, 1, 1, 1, 0, 1, 0]",122,52,70,6,6,0.11538461538461539,0.08571428571428572
"[1, 1, 1, 0, 0, 0, 1, 0, 0, 1, 0, 1, 0, 1, 1]",121,50,71,3,10,0.06,0.14084507042253522
"[1, 1, 1, 1, 1, 0, 0, 0, 1, 0, 0, 1, 0, 1, 0]",113,45,68,5,8,0.1111111111111111,0.11764705882352941
"[0, 0, 0, 1, 0, 1, 1, 0, 0, 0, 0, 1, 0, 0, 0]",578,407,171,38,13,0.09336609336609336,0.07602339181286549
"[0, 0, 1, 0, 0, 1, 1, 0, 0, 0, 0, 1, 0, 1, 1]",180,112,68,6,11,0.05357142857142857,0.16176470588235295
"[1, 1, 1, 1, 1, 0, 1, 1, 1, 0, 0, 1, 1, 0, 1]",539,161,378,30,40,0.18633540372670807,0.10582010582010581
"[1, 1, 1, 0, 1, 1, 1, 0, 1, 0, 1, 1, 0, 1, 1]",535,147,388,10,34,0.06802721088435375,0.08762886597938144
"[0, 1, 1, 1, 0, 1, 1, 0, 0, 0, 0, 0, 0, 1, 0]",157,80,77,7,9,0.0875,0.11688311688311688
"[1, 1, 0, 1, 1, 1, 0, 1, 1, 0, 0, 0, 0, 0, 0]",220,116,104,11,8,0.09482758620689655,0.07692307692307693
"[1, 1, 0, 1, 1, 0, 0, 1, 1, 1, 1, 1, 1, 0, 1]",585,180,405,15,29,0.08333333333333333,0.07160493827160494
"[0, 0, 1, 1, 1, 1, 0, 0, 0, 0, 0, 0, 0, 1, 1]",847,547,300,51,29,0.09323583180987204,0.09666666666666666
"[1, 1, 1, 1, 1, 1, 0, 1, 0, 1, 0, 0, 1, 0, 1]",257,89,168,13,14,0.14606741573033707,0.08333333333333333
"[1, 1, 1, 1, 1, 0, 1, 1, 0, 0, 0, 1, 1, 0, 0]",234,71,163,9,23,0.1267605633802817,0.1411042944785276
"[1, 0, 0, 1, 0, 0, 0, 0, 1, 1, 1, 1, 1, 1, 1]",452,180,272,26,34,0.14444444444444443,0.125
"[0, 1, 1, 0, 0, 1, 0, 0, 0, 0, 1, 1, 1, 1, 1]",285,155,130,11,16,0.07096774193548387,0.12307692307692308
"[0, 1, 0, 1, 1, 1, 0, 1, 1, 0, 1, 0, 1, 0, 0]",123,67,56,6,2,0.08955223880597014,0.03571428571428571
"[1, 0, 1, 1, 1, 0, 0, 0, 0, 1, 0, 1, 1, 1, 0]",119,55,64,5,7,0.09090909090909091,0.109375
"[1, 1, 1, 1, 1, 0, 0, 1, 0, 1, 1, 0, 0, 1, 0]",176,59,117,8,14,0.13559322033898305,0.11965811965811966
"[0, 1, 1, 1, 0, 1, 1, 1, 1, 0, 1, 1, 1, 1, 0]",528,169,359,20,36,0.11834319526627218,0.10027855153203342
"[0, 1, 0, 0, 0, 1, 0, 0, 0, 1, 1, 0, 1, 0, 0]",200,128,72,17,4,0.1328125,0.05555555555555555
"[1, 0, 0, 0, 0, 0, 0, 1, 1, 1, 0, 0, 0, 1, 1]",304,115,189,9,16,0.0782608695652174,0.08465608465608465
"[0, 0, 1, 1, 0, 0, 0, 0, 0, 0, 1, 1, 1, 0, 0]",653,400,253,36,25,0.09,0.09881422924901186
"[0, 0, 0, 1, 1, 0, 1, 1, 1, 0, 0, 0, 1, 0, 1]",130,77,53,8,8,0.1038961038961039,0.1509433962264151
"[0, 0, 0, 0, 0, 0, 1, 1, 0, 1, 1, 1, 0, 0, 0]",311,197,114,20,10,0.10152284263959391,0.08771929824561403
"[0, 1, 1, 0, 0, 1, 1, 1, 0, 0, 0, 1, 1, 1, 1]",286,144,142,9,11,0.0625,0.07746478873239436
"[1, 0, 0, 1, 1, 0, 0, 1, 1, 1, 0, 0, 0, 1, 1]",215,71,144,7,13,0.09859154929577464,0.09027777777777778
"[0, 1, 0, 0, 0, 0, 0, 1, 1, 1, 1, 0, 0, 1, 1]",477,266,211,21,25,0.07894736842105263,0.11848341232227488
"[1, 0, 0, 0, 1, 0, 1, 0, 1, 1, 1, 0, 0, 1, 1]",161,69,92,8,7,0.11594202898550725,0.07608695652173914
"[1, 1, 1, 1, 1, 1, 0, 1, 0, 0, 0, 1, 0, 1, 0]",139,49,90,4,7,0.08163265306122448,0.07777777777777778
"[1, 1, 1, 1, 0, 0, 1, 0, 1, 0, 0, 0, 1, 0, 1]",124,58,66,4,6,0.06896551724137931,0.09090909090909091
"[1, 1, 0, 1, 0, 0, 0, 0, 0, 0, 0, 0, 1, 0, 1]",261,169,92,15,9,0.08875739644970414,0.09782608695652174
"[0, 0, 0, 0, 1, 1, 1, 1, 0, 1, 1, 0, 1, 1, 0]",162,84,78,6,10,0.07142857142857142,0.1282051282051282
"[0, 0, 1, 0, 1, 1, 1, 1, 0, 1, 0, 0, 0, 0, 1]",127,55,72,3,10,0.05454545454545454,0.1388888888888889
"[1, 0, 1, 0, 0, 0, 1, 1, 1, 1, 1, 0, 1, 1, 0]",152,60,92,6,9,0.1,0.09782608695652174
"[1, 0, 0, 1, 1, 0, 0, 0, 1, 1, 0, 0, 1, 0, 0]",180,89,91,5,14,0.056179775280898875,0.15384615384615385
"[1, 0, 0, 0, 1, 1, 0, 1, 0, 0, 1, 0, 0, 0, 0]",272,166,106,14,3,0.08433734939759036,0.02830188679245283
"[1, 1, 1, 1, 0, 0, 1, 0, 0, 0, 0, 1, 1, 1, 0]",152,70,82,9,11,0.12857142857142856,0.13414634146341464
"[1, 1, 0, 0, 1, 1, 1, 0, 1, 1, 1, 0, 1, 1, 1]",651,213,438,15,47,0.07042253521126761,0.10730593607305935
"[1, 1, 0, 1, 1, 1, 1, 1, 1, 1, 1, 0, 1, 1, 0]",1581,377,1204,29,107,0.07692307692307693,0.0888704318936877
"[0, 1, 1, 0, 0, 1, 0, 1, 1, 0, 0, 0, 0, 1, 0]",155,84,71,9,7,0.10714285714285714,0.09859154929577464
"[1, 1, 1, 0, 0, 0, 0, 0, 1, 1, 0, 0, 1, 0, 1]",160,61,99,3,6,0.04918032786885246,0.06060606060606061
"[0, 0, 0, 1, 1, 0, 0, 0, 1, 0, 0, 0, 0, 1, 1]",474,348,126,27,15,0.07758620689655173,0.11904761904761904
"[0, 1, 0, 0, 1, 1, 0, 0, 0, 1, 1, 0, 0, 0, 0]",374,267,107,30,16,0.11235955056179775,0.14953271028037382
"[1, 1, 1, 0, 1, 1, 0, 0, 1, 1, 1, 1, 1, 1, 0]",903,270,633,26,62,0.0962962962962963,0.09794628751974724
"[0, 1, 1, 1, 1, 1, 1, 1, 0, 1, 1, 0, 0, 1, 1]",780,285,495,34,42,0.11929824561403508,0.08484848484848485
"[1, 1, 0, 0, 0, 0, 1, 1, 0, 0, 1, 1, 1, 0, 1]",382,162,220,11,22,0.06790123456790123,0.1
"[1, 1, 1, 0, 1, 0, 1, 1, 1, 1, 1, 1, 1, 0, 1]",1477,357,1120,32,107,0.0896358543417367,0.09553571428571428
"[1, 1, 0, 1, 1, 1, 0, 0, 0, 1, 0, 0, 0, 1, 0]",113,56,57,5,6,0.08928571428571429,0.10526315789473684
"[0, 0, 1, 1, 1, 1, 0, 1, 1, 1, 0, 0, 0, 1, 0]",127,57,70,9,6,0.15789473684210525,0.08571428571428572
"[0, 0, 0, 0, 1, 1, 1, 1, 0, 1, 1, 1, 0, 0, 0]",172,97,75,13,9,0.13402061855670103,0.12
"[1, 1, 0, 1, 1, 0, 1, 1, 1, 1, 0, 0, 0, 1, 0]",161,75,86,3,11,0.04,0.12790697674418605
"[1, 1, 1, 1, 0, 1, 1, 0, 1, 1, 1, 1, 0, 0, 0]",374,137,237,17,25,0.12408759124087591,0.10548523206751055
"[1, 1, 0, 0, 1, 1, 1, 1, 0, 0, 0, 1, 0, 0, 1]",215,99,116,7,11,0.0707070707070707,0.09482758620689655
"[0, 1, 0, 0, 1, 0, 0, 0, 0, 1, 0, 1, 1, 0, 0]",248,161,87,11,8,0.06832298136645963,0.09195402298850575
"[1, 1, 0, 0, 0, 0, 1, 1, 1, 0, 0, 0, 0, 1, 1]",294,161,133,17,15,0.10559006211180125,0.11278195488721804
"[0, 0, 1, 0, 0, 1, 0, 0, 1, 1, 0, 0, 0, 1, 0]",262,163,99,13,10,0.07975460122699386,0.10101010101010101
"[1, 0, 0, 0, 1, 1, 0, 1, 1, 1, 0, 0, 0, 0, 0]",200,112,88,16,8,0.14285714285714285,0.09090909090909091
"[0, 0, 1, 1, 0, 0, 0, 1, 1, 0, 1, 1, 1, 0, 0]",137,68,69,7,8,0.10294117647058823,0.11594202898550725
"[0, 1, 0, 0, 1, 1, 0, 0, 0, 1, 1, 0, 1, 1, 1]",158,77,81,9,9,0.11688311688311688,0.1111111111111111
"[0, 0, 1, 1, 0, 0, 1, 0, 0, 1, 0, 0, 1, 1, 1]",234,128,106,11,5,0.0859375,0.04716981132075472
"[0, 0, 1, 0, 1, 0, 1, 1, 0, 1, 0, 1, 0, 0, 1]",114,61,53,9,6,0.14754098360655737,0.11320754716981132
"[1, 1, 0, 1, 1, 0, 1, 1, 0, 0, 1, 0, 0, 1, 0]",103,42,61,4,4,0.09523809523809523,0.06557377049180328
"[1, 0, 0, 0, 0, 1, 0, 1, 0, 1, 0, 1, 0, 1, 1]",119,59,60,5,5,0.0847457627118644,0.08333333333333333
"[0, 0, 1, 0, 1, 0, 1, 0, 1, 0, 0, 1, 0, 1, 1]",101,57,44,5,7,0.08771929824561403,0.1590909090909091
"[0, 0, 1, 1, 1, 1, 0, 1, 1, 1, 0, 1, 0, 1, 0]",172,64,108,6,16,0.09375,0.14814814814814814
"[1, 0, 1, 0, 1, 1, 0, 0, 0, 0, 1, 1, 0, 0, 1]",244,133,111,10,13,0.07518796992481203,0.11711711711711711
"[1, 0, 1, 1, 0, 0, 0, 0, 0, 0, 0, 1, 1, 0, 0]",465,298,167,23,17,0.07718120805369127,0.10179640718562874
"[0, 1, 0, 1, 1, 0, 1, 1, 0, 0, 0, 0, 0, 0, 0]",356,216,140,22,12,0.10185185185185185,0.08571428571428572
"[0, 1, 0, 1, 0, 1, 1, 0, 1, 1, 0, 0, 0, 0, 0]",182,107,75,10,6,0.09345794392523364,0.08
"[1, 0, 1, 0, 1, 0, 1, 1, 0, 1, 1, 0, 0, 0, 0]",141,80,61,5,4,0.0625,0.06557377049180328
"[1, 0, 1, 1, 0, 1, 0, 1, 0, 1, 1, 0, 1, 1, 0]",126,52,74,3,7,0.057692307692307696,0.0945945945945946
"[0, 0, 1, 1, 0, 1, 1, 0, 1, 0, 1, 0, 1, 1, 0]",103,52,51,5,7,0.09615384615384616,0.13725490196078433
"[0, 0, 0, 0, 1, 1, 0, 0, 0, 0, 0, 1, 1, 0, 1]",444,274,170,21,14,0.07664233576642336,0.08235294117647059
"[1, 0, 1, 1, 0, 1, 0, 0, 0, 0, 1, 1, 0, 1, 1]",133,48,85,6,7,0.125,0.08235294117647059
"[1, 1, 1, 1, 0, 0, 1, 1, 0, 0, 1, 1, 0, 0, 1]",1952,774,1178,74,113,0.09560723514211886,0.09592529711375213
"[0, 0, 1, 1, 1, 1, 1, 0, 1, 0, 1, 1, 1, 1, 1]",836,247,589,26,56,0.10526315789473684,0.09507640067911714
"[0, 1, 1, 0, 1, 1, 0, 1, 0, 1, 1, 1, 1, 1, 0]",253,104,149,17,19,0.16346153846153846,0.12751677852348994
"[1, 1, 1, 1, 1, 1, 0, 1, 1, 0, 1, 1, 0, 1, 0]",495,130,365,9,42,0.06923076923076923,0.11506849315068493
"[0, 0, 1, 0, 0, 0, 1, 0, 0, 0, 0, 1, 1, 1, 0]",275,182,93,16,13,0.08791208791208792,0.13978494623655913
"[0, 1, 0, 1, 1, 0, 0, 0, 0, 0, 0, 1, 1, 0, 0]",681,414,267,39,25,0.09420289855072464,0.09363295880149813
"[1, 0, 1, 0, 1, 0, 0, 1, 0, 0, 0, 0, 0, 0, 1]",276,184,92,13,7,0.07065217391304347,0.07608695652173914
"[1, 0, 0, 0, 1, 0, 1, 0, 1, 0, 0, 1, 0, 0, 0]",264,163,101,19,15,0.1165644171779141,0.1485148514851485
"[0, 0, 1, 0, 0, 1, 1, 0, 1, 0, 0, 0, 0, 0, 1]",244,153,91,16,7,0.10457516339869281,0.07692307692307693
"[0, 0, 0, 1, 0, 0, 1, 1, 0, 1, 0, 0, 0, 0, 0]",620,438,182,47,24,0.10730593607305935,0.13186813186813187
"[1, 1, 0, 0, 0, 0, 0, 0, 1, 0, 0, 1, 1, 0, 1]",187,104,83,10,7,0.09615384615384616,0.08433734939759036
"[0, 0, 1, 0, 0, 1, 0, 0, 1, 1, 1, 1, 0, 0, 0]",273,156,117,14,15,0.08974358974358974,0.1282051282051282
"[1, 0, 0, 0, 1, 0, 0, 1, 0, 0, 1, 1, 1, 1, 0]",151,72,79,5,4,0.06944444444444445,0.05063291139240506
"[0, 1, 0, 1, 0, 0, 0, 0, 1, 0, 0, 1, 0, 0, 0]",528,378,150,26,7,0.06878306878306878,0.04666666666666667
"[0, 0, 1, 0, 1, 1, 0, 0, 0, 0, 0, 1, 1, 1, 0]",192,110,82,9,8,0.08181818181818182,0.0975609756097561
"[0, 0, 1, 1, 0, 0, 0, 0, 1, 0, 0, 1, 1, 0, 0]",395,250,145,22,13,0.088,0.0896551724137931
"[1, 0, 1, 1, 1, 0, 0, 0, 1, 0, 1, 0, 1, 0, 0]",111,63,48,5,0,0.07936507936507936,0.0
"[1, 0, 1, 0, 1, 1, 1, 0, 0, 0, 1, 0, 1, 0, 1]",111,43,68,4,6,0.09302325581395349,0.08823529411764706
"[1, 1, 1, 0, 1, 1, 1, 1, 0, 1, 0, 1, 1, 1, 1]",1743,413,1330,31,121,0.07506053268765134,0.09097744360902256
"[0, 1, 1, 1, 0, 1, 1, 0, 0, 0, 0, 0, 1, 1, 1]",217,113,104,9,11,0.07964601769911504,0.10576923076923077
"[0, 0, 0, 0, 0, 1, 1, 0, 0, 0, 0, 1, 1, 0, 1]",685,556,129,50,17,0.08992805755395683,0.13178294573643412
"[0, 0, 0, 0, 0, 0, 1, 1, 1, 0, 1, 0, 0, 0, 0]",755,523,232,53,21,0.10133843212237094,0.09051724137931035
"[0, 0, 0, 0, 0, 0, 0, 1, 0, 0, 0, 1, 1, 0, 1]",592,439,153,48,14,0.10933940774487472,0.0915032679738562
"[1, 0, 1, 0, 1, 1, 0, 1, 1, 1, 0, 0, 0, 1, 0]",110,54,56,3,11,0.05555555555555555,0.19642857142857142
"[0, 1, 1, 1, 1, 1, 0, 1, 0, 1, 1, 0, 1, 1, 1]",550,189,361,19,39,0.10052910052910052,0.10803324099722991
"[1, 1, 0, 1, 1, 1, 1, 1, 1, 0, 0, 1, 1, 0, 1]",585,160,425,18,39,0.1125,0.09176470588235294
"[1, 0, 1, 1, 1, 1, 1, 0, 0, 1, 0, 1, 1, 0, 1]",207,62,145,6,14,0.0967741935483871,0.09655172413793103
"[1, 1, 0, 1, 0, 1, 1, 1, 0, 0, 1, 1, 0, 1, 1]",253,85,168,11,14,0.12941176470588237,0.08333333333333333
"[1, 0, 1, 1, 1, 0, 0, 1, 0, 1, 1, 0, 0, 0, 0]",142,80,62,13,5,0.1625,0.08064516129032258
"[0, 0, 1, 0, 1, 1, 1, 0, 0, 0, 0, 0, 1, 0, 1]",152,86,66,10,0,0.11627906976744186,0.0
"[0, 0, 1, 1, 1, 1, 1, 0, 1, 0, 0, 1, 0, 1, 0]",124,62,62,8,4,0.12903225806451613,0.06451612903225806
"[0, 0, 1, 1, 1, 0, 0, 1, 0, 0, 0, 0, 1, 1, 0]",214,132,82,9,9,0.06818181818181818,0.10975609756097561
"[0, 1, 1, 1, 0, 0, 1, 1, 1, 0, 0, 1, 0, 0, 0]",136,75,61,4,7,0.05333333333333334,0.11475409836065574
"[0, 0, 0, 0, 0, 1, 0, 0, 0, 1, 1, 1, 0, 0, 1]",291,195,96,19,14,0.09743589743589744,0.14583333333333334
"[1, 1, 0, 0, 0, 1, 0, 1, 1, 1, 1, 1, 0, 0, 0]",181,86,95,9,11,0.10465116279069768,0.11578947368421053
"[1, 1, 1, 1, 1, 0, 1, 1, 1, 0, 1, 1, 1, 0, 0]",639,203,436,8,36,0.03940886699507389,0.08256880733944955
"[1, 0, 0, 0, 0, 1, 0, 1, 0, 0, 1, 1, 0, 1, 0]",128,70,58,8,4,0.11428571428571428,0.06896551724137931
"[1, 1, 0, 0, 0, 0, 0, 1, 1, 0, 0, 0, 0, 1, 0]",309,195,114,17,13,0.08717948717948718,0.11403508771929824
"[0, 0, 0, 0, 0, 1, 0, 0, 1, 1, 1, 1, 0, 0, 0]",582,405,177,36,18,0.08888888888888889,0.1016949152542373
"[0, 1, 0, 0, 0, 0, 1, 0, 0, 0, 0, 0, 0, 1, 1]",930,695,235,74,15,0.10647482014388489,0.06382978723404255
"[0, 0, 0, 0, 0, 0, 1, 0, 0, 1, 0, 1, 0, 1, 0]",548,402,146,55,15,0.13681592039800994,0.10273972602739725
"[1, 0, 0, 0, 0, 1, 1, 1, 0, 1, 0, 0, 0, 1, 1]",174,83,91,6,10,0.07228915662650602,0.10989010989010989
"[0, 0, 1, 1, 0, 0, 0, 0, 1, 1, 1, 0, 1, 0, 0]",255,165,90,15,8,0.09090909090909091,0.08888888888888889
"[1, 1, 0, 0, 0, 0, 1, 1, 0, 1, 1, 0, 1, 1, 1]",325,133,192,6,16,0.045112781954887216,0.08333333333333333
"[1, 1, 0, 0, 1, 1, 1, 1, 0, 1, 1, 1, 0, 1, 1]",706,211,495,16,53,0.07582938388625593,0.10707070707070707
"[0, 1, 1, 1, 1, 1, 0, 1, 0, 1, 0, 1, 1, 1, 0]",256,88,168,11,11,0.125,0.06547619047619048
"[1, 0, 0, 0, 0, 0, 0, 1, 1, 1, 1, 1, 0, 1, 0]",227,81,146,10,10,0.12345679012345678,0.0684931506849315
"[1, 0, 0, 1, 0, 0, 1, 0, 0, 0, 0, 0, 1, 0, 0]",513,361,152,40,17,0.11080332409972299,0.1118421052631579
"[0, 0, 1, 0, 1, 0, 1, 0, 1, 0, 0, 1, 0, 0, 1]",161,95,66,9,4,0.09473684210526316,0.06060606060606061
"[1, 1, 1, 1, 1, 1, 0, 1, 0, 0, 1, 0, 0, 1, 0]",151,67,84,7,7,0.1044776119402985,0.08333333333333333
"[1, 1, 0, 1, 0, 1, 1, 1, 1, 1, 1, 1, 1, 0, 0]",1045,330,715,24,77,0.07272727272727272,0.1076923076923077
"[1, 0, 1, 1, 0, 1, 1, 1, 1, 1, 0, 1, 1, 0, 0]",254,86,168,9,15,0.10465116279069768,0.08928571428571429
"[1, 1, 0, 1, 1, 0, 1, 1, 1, 1, 1, 0, 1, 1, 0]",509,156,353,14,35,0.08974358974358974,0.09915014164305949
"[0, 0, 1, 0, 1, 1, 1, 1, 1, 1, 1, 1, 1, 1, 0]",861,317,544,30,51,0.0946372239747634,0.09375
"[1, 1, 1, 0, 0, 1, 1, 1, 0, 0, 0, 0, 0, 1, 0]",123,41,82,3,8,0.07317073170731707,0.0975609756097561
"[1, 0, 0, 1, 0, 0, 0, 0, 1, 1, 1, 1, 0, 0, 1]",282,143,139,12,7,0.08391608391608392,0.050359712230215826
"[1, 1, 1, 0, 0, 1, 1, 1, 1, 1, 0, 0, 1, 0, 0]",209,64,145,5,10,0.078125,0.06896551724137931
"[1, 1, 0, 1, 1, 1, 0, 1, 1, 1, 0, 1, 0, 1, 0]",223,68,155,9,15,0.1323529411764706,0.0967741935483871
"[1, 0, 0, 1, 1, 0, 0, 1, 0, 1, 1, 0, 1, 1, 1]",223,64,159,6,17,0.09375,0.1069182389937107
"[1, 1, 0, 0, 1, 1, 0, 0, 1, 0, 1, 1, 0, 1, 1]",231,106,125,11,12,0.10377358490566038,0.096
"[1, 0, 1, 0, 1, 1, 1, 1, 0, 0, 1, 1, 0, 0, 1]",358,147,211,13,19,0.08843537414965986,0.09004739336492891
"[1, 0, 1, 0, 1, 0, 0, 1, 0, 0, 0, 0, 1, 1, 0]",186,103,83,6,8,0.05825242718446602,0.0963855421686747
"[0, 0, 0, 1, 0, 0, 1, 0, 0, 0, 1, 0, 0, 1, 1]",319,213,106,27,9,0.1267605633802817,0.08490566037735849
"[1, 1, 1, 0, 1, 0, 1, 0, 1, 1, 1, 1, 0, 0, 0]",212,89,123,11,12,0.12359550561797752,0.0975609756097561
"[0, 0, 1, 0, 1, 0, 1, 1, 0, 0, 1, 1, 1, 1, 0]",220,107,113,12,9,0.11214953271028037,0.07964601769911504
"[1, 0, 0, 1, 0, 1, 0, 0, 1, 0, 1, 0, 1, 1, 0]",106,52,54,7,7,0.1346153846153846,0.12962962962962962
"[1, 0, 1, 0, 1, 0, 0, 1, 0, 1, 0, 0, 1, 0, 1]",86,53,33,4,4,0.07547169811320754,0.12121212121212122
"[0, 0, 1, 1, 0, 0, 0, 0, 1, 1, 0, 0, 0, 1, 1]",621,371,250,28,25,0.07547169811320754,0.1
"[1, 0, 0, 0, 0, 1, 0, 1, 1, 1, 1, 0, 1, 1, 1]",199,62,137,7,14,0.11290322580645161,0.10218978102189781
"[0, 0, 0, 0, 0, 0, 1, 0, 1, 1, 0, 1, 1, 1, 1]",235,133,102,19,6,0.14285714285714285,0.058823529411764705
"[0, 0, 1, 0, 1, 0, 0, 1, 1, 1, 1, 1, 0, 0, 0]",167,91,76,7,9,0.07692307692307693,0.11842105263157894
"[0, 1, 1, 0, 1, 1, 0, 1, 0, 1, 0, 0, 0, 0, 1]",127,72,55,5,6,0.06944444444444445,0.10909090909090909
"[0, 0, 1, 1, 0, 1, 1, 0, 1, 0, 1, 0, 0, 0, 0]",172,106,66,9,7,0.08490566037735849,0.10606060606060606
"[1, 1, 1, 0, 0, 0, 0, 0, 1, 1, 0, 1, 1, 0, 1]",102,38,64,6,5,0.15789473684210525,0.078125
"[0, 0, 1, 0, 0, 0, 0, 0, 0, 1, 1, 1, 1, 0, 0]",822,525,297,51,44,0.09714285714285714,0.14814814814814814
"[1, 1, 1, 0, 1, 0, 1, 0, 1, 0, 1, 1, 0, 1, 1]",212,77,135,7,16,0.09090909090909091,0.11851851851851852
"[1, 1, 0, 0, 0, 1, 1, 1, 1, 0, 1, 0, 1, 0, 1]",162,58,104,6,9,0.10344827586206896,0.08653846153846154
"[1, 0, 0, 1, 0, 0, 1, 0, 0, 0, 0, 0, 0, 1, 0]",506,337,169,21,22,0.06231454005934718,0.1301775147928994
"[1, 0, 1, 0, 1, 1, 0, 0, 1, 0, 1, 0, 0, 1, 1]",130,54,76,4,8,0.07407407407407407,0.10526315789473684
"[0, 0, 1, 1, 1, 1, 0, 0, 1, 1, 0, 0, 1, 1, 0]",1478,750,728,77,75,0.10266666666666667,0.10302197802197802
"[1, 0, 0, 0, 0, 1, 0, 0, 1, 1, 0, 1, 1, 0, 1]",117,59,58,9,5,0.15254237288135594,0.08620689655172414
"[0, 1, 0, 0, 0, 0, 1, 0, 0, 1, 1, 0, 1, 1, 0]",145,91,54,11,1,0.12087912087912088,0.018518518518518517
"[0, 0, 1, 0, 1, 0, 0, 0, 0, 1, 0, 0, 1, 1, 0]",277,193,84,19,6,0.09844559585492228,0.07142857142857142
"[1, 1, 1, 1, 1, 0, 1, 0, 0, 1, 0, 0, 1, 0, 0]",115,53,62,9,5,0.16981132075471697,0.08064516129032258
"[1, 1, 1, 1, 0, 1, 1, 0, 0, 1, 1, 1, 0, 1, 1]",575,164,411,8,33,0.04878048780487805,0.08029197080291971
"[0, 1, 0, 0, 0, 1, 1, 0, 0, 1, 1, 1, 1, 1, 1]",494,219,275,29,27,0.1324200913242009,0.09818181818181818
"[1, 0, 0, 0, 0, 1, 0, 0, 0, 0, 1, 1, 1, 1, 0]",283,155,128,12,11,0.07741935483870968,0.0859375
"[1, 1, 1, 1, 0, 1, 0, 0, 0, 1, 1, 0, 0, 0, 0]",221,112,109,16,8,0.14285714285714285,0.07339449541284404
"[1, 0, 1, 1, 0, 1, 0, 0, 1, 1, 0, 0, 0, 1, 1]",148,74,74,9,7,0.12162162162162163,0.0945945945945946
"[1, 0, 1, 0, 1, 1, 1, 0, 0, 0, 1, 0, 1, 1, 0]",96,49,47,6,8,0.12244897959183673,0.1702127659574468
"[1, 0, 1, 1, 0, 1, 0, 0, 1, 1, 0, 1, 0, 1, 1]",160,62,98,2,7,0.03225806451612903,0.07142857142857142
"[1, 1, 1, 1, 0, 1, 1, 0, 1, 0, 0, 1, 1, 0, 1]",262,96,166,5,15,0.052083333333333336,0.09036144578313253
"[0, 1, 0, 0, 0, 0, 1, 1, 1, 1, 1, 0, 1, 1, 1]",207,83,124,5,16,0.060240963855421686,0.12903225806451613
"[1, 0, 1, 0, 0, 1, 1, 0, 1, 1, 0, 0, 0, 0, 1]",149,76,73,9,8,0.11842105263157894,0.1095890410958904
"[1, 1, 0, 1, 0, 0, 1, 1, 0, 1, 1, 0, 0, 0, 0]",155,86,69,8,5,0.09302325581395349,0.07246376811594203
"[1, 0, 1, 1, 1, 1, 1, 0, 0, 0, 1, 1, 0, 1, 1]",245,88,157,8,16,0.09090909090909091,0.10191082802547771
"[1, 1, 0, 0, 0, 0, 0, 1, 1, 0, 1, 1, 1, 1, 1]",280,111,169,10,18,0.09009009009009009,0.10650887573964497
"[0, 0, 1, 1, 0, 1, 1, 1, 0, 1, 1, 1, 0, 0, 0]",126,62,64,7,7,0.11290322580645161,0.109375
"[1, 1, 0, 0, 1, 0, 0, 0, 1, 0, 1, 1, 1, 1, 1]",210,94,116,13,15,0.13829787234042554,0.12931034482758622
"[0, 1, 0, 1, 1, 0, 0, 1, 0, 0, 0, 1, 1, 1, 1]",204,117,87,10,11,0.08547008547008547,0.12643678160919541
"[0, 1, 0, 1, 0, 1, 1, 0, 0, 1, 0, 0, 0, 1, 1]",109,66,43,6,4,0.09090909090909091,0.09302325581395349
"[0, 1, 0, 0, 1, 0, 1, 1, 0, 0, 0, 0, 0, 0, 0]",842,591,251,40,25,0.0676818950930626,0.099601593625498
"[0, 0, 1, 0, 0, 1, 0, 1, 1, 0, 0, 0, 0, 0, 0]",800,567,233,52,25,0.09171075837742504,0.1072961373390558
"[1, 1, 0, 0, 1, 1, 0, 0, 0, 0, 1, 1, 1, 0, 1]",378,181,197,14,21,0.07734806629834254,0.1065989847715736
"[0, 0, 1, 0, 0, 1, 0, 0, 1, 0, 0, 0, 0, 0, 1]",567,390,177,38,13,0.09743589743589744,0.07344632768361582
"[0, 0, 0, 1, 0, 0, 0, 1, 0, 0, 1, 0, 0, 1, 0]",426,299,127,26,6,0.08695652173913043,0.047244094488188976
"[0, 1, 1, 1, 1, 1, 1, 0, 0, 0, 1, 1, 1, 1, 0]",399,196,203,13,22,0.0663265306122449,0.10837438423645321
"[0, 0, 1, 1, 1, 0, 1, 1, 0, 0, 0, 1, 1, 1, 0]",110,50,60,5,6,0.1,0.1
"[0, 0, 0, 1, 0, 0, 1, 1, 1, 0, 1, 1, 0, 0, 0]",143,84,59,11,7,0.13095238095238096,0.11864406779661017
"[1, 1, 0, 1, 0, 0, 1, 0, 0, 0, 1, 0, 0, 1, 1]",140,82,58,4,6,0.04878048780487805,0.10344827586206896
"[1, 1, 0, 1, 1, 0, 1, 0, 0, 1, 1, 1, 1, 0, 1]",221,84,137,12,13,0.14285714285714285,0.0948905109489051
"[0, 1, 1, 0, 0, 1, 1, 0, 0, 0, 1, 0, 1, 1, 0]",153,90,63,6,8,0.06666666666666667,0.12698412698412698
"[1, 0, 0, 0, 1, 0, 1, 0, 0, 0, 0, 1, 1, 1, 0]",169,103,66,16,8,0.1553398058252427,0.12121212121212122
"[0, 0, 0, 0, 0, 1, 0, 0, 1, 0, 0, 0, 1, 0, 1]",552,391,161,43,15,0.10997442455242967,0.09316770186335403
"[1, 1, 0, 1, 0, 0, 1, 0, 0, 0, 0, 0, 1, 0, 0]",225,145,80,16,6,0.1103448275862069,0.075
"[1, 0, 1, 0, 1, 1, 0, 1, 0, 0, 1, 0, 0, 0, 0]",160,87,73,9,4,0.10344827586206896,0.0547945205479452
"[0, 1, 0, 1, 0, 1, 0, 1, 1, 0, 1, 0, 0, 1, 0]",107,60,47,9,3,0.15,0.06382978723404255
"[1, 0, 1, 1, 0, 1, 0, 1, 0, 1, 0, 1, 1, 0, 1]",135,54,81,9,4,0.16666666666666666,0.04938271604938271
"[0, 0, 1, 0, 0, 1, 0, 1, 1, 0, 1, 0, 1, 0, 1]",110,62,48,8,5,0.12903225806451613,0.10416666666666667
"[0, 1, 0, 1, 0, 0, 1, 0, 1, 1, 1, 1, 0, 0, 1]",165,85,80,4,5,0.047058823529411764,0.0625
"[0, 0, 1, 1, 1, 0, 0, 0, 1, 0, 1, 0, 1, 0, 0]",155,97,58,7,3,0.07216494845360824,0.05172413793103448
"[0, 1, 1, 0, 0, 0, 0, 0, 0, 0, 1, 1, 1, 0, 0]",399,280,119,27,8,0.09642857142857143,0.06722689075630252
"[1, 1, 1, 0, 1, 1, 0, 0, 0, 0, 0, 0, 0, 1, 1]",238,111,127,14,11,0.12612612612612611,0.08661417322834646
"[0, 0, 0, 0, 1, 1, 1, 0, 1, 1, 0, 0, 0, 0, 0]",364,231,133,22,13,0.09523809523809523,0.09774436090225563
"[0, 0, 0, 1, 0, 0, 0, 0, 0, 0, 1, 1, 1, 0, 1]",267,172,95,18,7,0.10465116279069768,0.07368421052631578
"[1, 1, 0, 0, 0, 1, 1, 1, 0, 0, 1, 0, 0, 0, 0]",171,97,74,11,8,0.1134020618556701,0.10810810810810811
"[1, 0, 1, 0, 1, 0, 0, 0, 0, 0, 1, 0, 0, 0, 0]",536,363,173,38,18,0.1046831955922865,0.10404624277456648
"[0, 0, 0, 1, 1, 0, 0, 1, 0, 0, 1, 0, 1, 0, 1]",144,84,60,3,6,0.03571428571428571,0.1
"[1, 0, 1, 1, 1, 1, 1, 0, 0, 1, 0, 1, 0, 0, 1]",143,63,80,5,10,0.07936507936507936,0.125
"[0, 0, 1, 0, 1, 1, 1, 0, 0, 0, 1, 1, 0, 1, 0]",102,52,50,8,7,0.15384615384615385,0.14
"[0, 1, 0, 0, 1, 0, 1, 1, 1, 0, 0, 0, 1, 1, 0]",94,41,53,2,5,0.04878048780487805,0.09433962264150944
"[0, 0, 1, 1, 0, 0, 0, 0, 0, 1, 1, 1, 1, 1, 1]",514,239,275,28,26,0.11715481171548117,0.09454545454545454
"[0, 1, 0, 0, 0, 0, 1, 0, 1, 1, 0, 1, 0, 1, 0]",138,86,52,9,5,0.10465116279069768,0.09615384615384616
"[1, 0, 0, 0, 1, 1, 1, 1, 1, 0, 0, 1, 1, 1, 0]",197,82,115,6,9,0.07317073170731707,0.0782608695652174
"[0, 0, 1, 0, 0, 0, 1, 0, 0, 0, 0, 0, 1, 1, 0]",671,490,181,41,14,0.0836734693877551,0.07734806629834254
"[1, 0, 1, 1, 1, 1, 1, 0, 1, 1, 0, 1, 1, 0, 1]",463,134,329,15,33,0.11194029850746269,0.10030395136778116
"[1, 0, 1, 0, 1, 0, 0, 1, 0, 1, 0, 0, 1, 1, 0]",118,61,57,7,4,0.11475409836065574,0.07017543859649122
"[0, 1, 0, 0, 0, 1, 0, 1, 0, 1, 0, 0, 1, 0, 1]",134,82,52,8,5,0.0975609756097561,0.09615384615384616
"[1, 0, 0, 0, 0, 0, 0, 1, 1, 0, 0, 0, 1, 1, 0]",436,209,227,16,19,0.07655502392344497,0.08370044052863436
"[1, 1, 0, 0, 1, 1, 1, 1, 1, 1, 0, 1, 0, 0, 0]",249,118,131,12,11,0.1016949152542373,0.08396946564885496
"[0, 0, 0, 0, 1, 0, 0, 0, 0, 1, 0, 1, 1, 1, 0]",264,177,87,25,2,0.14124293785310735,0.022988505747126436
"[1, 0, 0, 1, 0, 0, 1, 1, 1, 1, 0, 0, 1, 1, 1]",370,136,234,8,16,0.058823529411764705,0.06837606837606838
"[1, 1, 0, 1, 1, 1, 1, 0, 1, 0, 1, 1, 0, 0, 1]",264,99,165,9,16,0.09090909090909091,0.09696969696969697
"[0, 1, 1, 1, 1, 1, 1, 0, 1, 1, 1, 0, 0, 1, 1]",790,289,501,29,42,0.10034602076124567,0.08383233532934131
"[0, 0, 1, 0, 1, 0, 1, 0, 1, 0, 0, 0, 1, 1, 1]",121,72,49,8,2,0.1111111111111111,0.04081632653061224
"[1, 0, 1, 0, 1, 1, 1, 1, 0, 0, 1, 0, 1, 1, 0]",142,55,87,4,7,0.07272727272727272,0.08045977011494253
"[1, 1, 0, 0, 0, 0, 1, 0, 1, 0, 0, 0, 1, 1, 1]",229,126,103,13,9,0.10317460317460317,0.08737864077669903
"[1, 0, 0, 1, 1, 0, 0, 0, 0, 1, 0, 1, 0, 0, 0]",326,165,161,11,18,0.06666666666666667,0.11180124223602485
"[1, 0, 1, 0, 0, 0, 1, 0, 0, 1, 0, 1, 1, 1, 1]",123,64,59,4,5,0.0625,0.0847457627118644
"[0, 0, 0, 0, 1, 1, 0, 0, 0, 1, 0, 1, 0, 0, 0]",706,486,220,33,24,0.06790123456790123,0.10909090909090909
"[1, 0, 0, 1, 0, 0, 0, 0, 0, 0, 1, 1, 0, 1, 1]",194,116,78,10,7,0.08620689655172414,0.08974358974358974
"[1, 0, 1, 0, 0, 1, 0, 1, 0, 1, 0, 0, 0, 0, 1]",176,108,68,8,12,0.07407407407407407,0.17647058823529413
"[0, 0, 1, 1, 0, 1, 0, 1, 0, 0, 1, 0, 1, 0, 1]",109,66,43,8,6,0.12121212121212122,0.13953488372093023
"[0, 1, 1, 0, 1, 1, 0, 0, 0, 1, 1, 0, 1, 0, 1]",117,65,52,6,6,0.09230769230769231,0.11538461538461539
"[0, 0, 0, 1, 1, 0, 1, 1, 0, 0, 0, 1, 1, 0, 1]",137,82,55,10,6,0.12195121951219512,0.10909090909090909
"[1, 0, 0, 0, 1, 1, 0, 0, 0, 1, 0, 0, 0, 0, 1]",271,173,98,12,10,0.06936416184971098,0.10204081632653061
"[0, 1, 0, 0, 1, 0, 1, 1, 1, 1, 1, 0, 0, 1, 0]",91,46,45,5,5,0.10869565217391304,0.1111111111111111
"[0, 0, 1, 0, 0, 1, 0, 1, 1, 1, 1, 1, 0, 0, 1]",130,64,66,6,13,0.09375,0.19696969696969696
"[1, 1, 1, 1, 1, 1, 1, 0, 0, 1, 0, 0, 1, 0, 1]",344,93,251,8,31,0.08602150537634409,0.12350597609561753
"[0, 1, 1, 1, 1, 1, 1, 1, 1, 0, 0, 1, 0, 0, 1]",459,263,196,26,13,0.09885931558935361,0.0663265306122449
"[0, 1, 0, 1, 0, 0, 1, 1, 1, 1, 1, 0, 0, 1, 1]",224,102,122,16,7,0.1568627450980392,0.05737704918032787
"[1, 1, 1, 1, 1, 1, 0, 0, 0, 0, 1, 0, 0, 0, 1]",243,113,130,11,13,0.09734513274336283,0.1
"[1, 1, 1, 1, 0, 1, 1, 1, 1, 0, 1, 1, 0, 1, 0]",485,141,344,14,40,0.09929078014184398,0.11627906976744186
"[1, 1, 1, 0, 1, 0, 1, 1, 1, 1, 1, 1, 0, 0, 1]",878,251,627,23,58,0.09163346613545817,0.09250398724082935
"[1, 1, 1, 1, 1, 1, 1, 0, 1, 1, 1, 0, 0, 1, 0]",584,167,417,15,37,0.08982035928143713,0.08872901678657075
"[0, 1, 1, 0, 1, 1, 1, 1, 1, 1, 0, 1, 0, 0, 0]",154,72,82,6,7,0.08333333333333333,0.08536585365853659
"[1, 0, 1, 1, 1, 0, 1, 0, 1, 1, 1, 1, 0, 1, 1]",495,148,347,18,20,0.12162162162162163,0.05763688760806916
"[1, 0, 1, 0, 1, 1, 1, 0, 0, 0, 0, 1, 0, 1, 1]",125,60,65,3,11,0.05,0.16923076923076924
"[1, 1, 1, 0, 0, 1, 1, 1, 1, 0, 1, 1, 0, 0, 0]",233,79,154,12,15,0.1518987341772152,0.09740259740259741
"[0, 0, 0, 0, 0, 0, 1, 1, 0, 0, 1, 0, 1, 1, 1]",636,395,241,43,22,0.10886075949367088,0.0912863070539419
"[0, 0, 0, 0, 0, 0, 0, 1, 1, 0, 0, 1, 0, 1, 1]",626,475,151,55,14,0.11578947368421053,0.09271523178807947
"[0, 0, 0, 1, 0, 0, 1, 0, 0, 0, 1, 1, 0, 0, 1]",312,222,90,28,11,0.12612612612612611,0.12222222222222222
"[0, 1, 0, 1, 0, 0, 1, 0, 1, 0, 0, 1, 1, 0, 1]",105,57,48,7,10,0.12280701754385964,0.20833333333333334
"[0, 1, 0, 0, 1, 0, 0, 1, 0, 0, 1, 1, 1, 1, 1]",184,105,79,13,5,0.12380952380952381,0.06329113924050633
"[1, 1, 1, 0, 0, 0, 0, 1, 0, 0, 1, 0, 1, 1, 1]",210,66,144,6,10,0.09090909090909091,0.06944444444444445
"[0, 1, 0, 1, 1, 1, 0, 0, 1, 1, 1, 0, 1, 1, 1]",283,97,186,9,15,0.09278350515463918,0.08064516129032258
"[1, 0, 1, 0, 0, 0, 0, 1, 0, 1, 1, 1, 0, 0, 1]",118,60,58,6,6,0.1,0.10344827586206896
"[1, 0, 1, 1, 1, 0, 0, 1, 0, 0, 0, 1, 1, 0, 0]",160,78,82,5,11,0.0641025641025641,0.13414634146341464
"[1, 1, 0, 1, 0, 1, 1, 1, 0, 1, 1, 1, 1, 1, 0]",500,148,352,10,29,0.06756756756756757,0.08238636363636363
"[0, 0, 1, 0, 1, 0, 0, 1, 0, 0, 1, 0, 0, 1, 1]",162,99,63,4,3,0.04040404040404041,0.047619047619047616
"[0, 1, 0, 1, 0, 0, 1, 0, 1, 0, 0, 0, 0, 0, 1]",264,167,97,10,14,0.059880239520958084,0.14432989690721648
"[0, 0, 1, 1, 0, 0, 0, 0, 0, 1, 1, 0, 0, 1, 0]",310,206,104,20,12,0.0970873786407767,0.11538461538461539
"[0, 0, 1, 0, 0, 0, 0, 0, 1, 0, 1, 1, 1, 0, 1]",158,98,60,12,7,0.12244897959183673,0.11666666666666667
"[1, 0, 1, 0, 0, 0, 1, 1, 0, 0, 0, 1, 1, 1, 1]",152,70,82,8,6,0.11428571428571428,0.07317073170731707
"[1, 1, 0, 1, 1, 0, 1, 0, 0, 1, 1, 1, 0, 0, 0]",119,59,60,7,9,0.11864406779661017,0.15
"[0, 1, 0, 1, 1, 0, 1, 1, 0, 1, 0, 0, 1, 1, 1]",188,75,113,5,9,0.06666666666666667,0.07964601769911504
"[1, 1, 1, 0, 1, 0, 1, 0, 1, 1, 0, 0, 1, 1, 0]",185,73,112,8,7,0.1095890410958904,0.0625
"[0, 1, 1, 0, 1, 1, 0, 0, 0, 1, 1, 0, 1, 1, 1]",172,82,90,10,8,0.12195121951219512,0.08888888888888889
"[0, 0, 0, 0, 0, 1, 1, 1, 0, 0, 0, 0, 1, 0, 0]",640,467,173,51,15,0.10920770877944326,0.08670520231213873
"[1, 0, 1, 1, 0, 1, 0, 0, 0, 0, 0, 1, 0, 0, 0]",238,147,91,19,9,0.1292517006802721,0.0989010989010989
"[1, 0, 1, 0, 1, 1, 1, 0, 1, 1, 1, 1, 1, 0, 1]",511,160,351,8,37,0.05,0.10541310541310542
"[1, 0, 1, 0, 1, 1, 1, 0, 1, 0, 1, 1, 1, 0, 1]",229,82,147,8,19,0.0975609756097561,0.1292517006802721
"[1, 1, 1, 1, 0, 1, 1, 1, 0, 0, 1, 0, 0, 1, 1]",307,92,215,9,22,0.09782608695652174,0.10232558139534884
"[0, 0, 0, 1, 0, 0, 0, 0, 1, 0, 0, 1, 0, 0, 0]",1532,1184,348,116,31,0.09797297297297297,0.08908045977011494
"[1, 0, 0, 0, 0, 0, 0, 1, 1, 1, 1, 0, 1, 1, 1]",468,112,356,11,43,0.09821428571428571,0.12078651685393259
"[0, 0, 0, 1, 1, 1, 0, 1, 0, 0, 0, 1, 0, 0, 0]",231,158,73,14,7,0.08860759493670886,0.0958904109589041
"[0, 0, 1, 1, 0, 0, 0, 1, 1, 1, 0, 1, 0, 0, 0]",166,90,76,11,10,0.12222222222222222,0.13157894736842105
"[0, 1, 0, 0, 0, 1, 0, 1, 1, 0, 0, 0, 1, 0, 1]",119,76,43,8,5,0.10526315789473684,0.11627906976744186
"[0, 0, 1, 0, 1, 0, 0, 0, 1, 1, 0, 1, 0, 0, 0]",242,164,78,7,8,0.042682926829268296,0.10256410256410256
"[1, 0, 1, 0, 0, 0, 1, 0, 0, 1, 0, 1, 0, 0, 0]",252,161,91,17,12,0.10559006211180125,0.13186813186813187
"[0, 1, 1, 0, 0, 1, 1, 0, 1, 0, 0, 1, 0, 0, 1]",141,72,69,8,5,0.1111111111111111,0.07246376811594203
"[0, 0, 1, 1, 0, 0, 1, 1, 0, 1, 0, 0, 1, 0, 0]",193,116,77,15,5,0.12931034482758622,0.06493506493506493
"[0, 0, 0, 1, 1, 0, 0, 1, 1, 0, 1, 0, 0, 1, 0]",195,129,66,18,3,0.13953488372093023,0.045454545454545456
"[1, 1, 0, 0, 1, 1, 0, 1, 1, 0, 1, 0, 1, 0, 1]",155,57,98,6,14,0.10526315789473684,0.14285714285714285
"[1, 0, 1, 1, 0, 0, 1, 1, 0, 1, 1, 0, 1, 0, 1]",129,50,79,5,11,0.1,0.13924050632911392
"[0, 1, 0, 1, 1, 0, 0, 1, 1, 0, 1, 1, 0, 1, 0]",92,43,49,5,3,0.11627906976744186,0.061224489795918366
"[0, 0, 0, 0, 1, 1, 1, 0, 1, 1, 1, 0, 1, 1, 0]",114,59,55,8,4,0.13559322033898305,0.07272727272727272
"[0, 1, 1, 0, 0, 1, 1, 1, 1, 1, 1, 1, 0, 0, 1]",629,334,295,32,27,0.09580838323353294,0.09152542372881356
"[0, 1, 1, 0, 1, 0, 1, 1, 1, 1, 0, 1, 1, 0, 0]",174,74,100,6,14,0.08108108108108109,0.14
"[0, 0, 1, 1, 0, 0, 0, 1, 0, 1, 0, 0, 1, 1, 0]",189,109,80,15,8,0.13761467889908258,0.1
"[1, 0, 0, 1, 1, 1, 0, 1, 1, 1, 1, 1, 0, 0, 0]",227,85,142,4,9,0.047058823529411764,0.06338028169014084
"[1, 0, 1, 0, 0, 1, 0, 0, 1, 0, 0, 0, 1, 1, 1]",151,80,71,7,7,0.0875,0.09859154929577464
"[0, 1, 0, 0, 0, 0, 1, 0, 0, 0, 1, 1, 0, 0, 1]",291,181,110,22,9,0.12154696132596685,0.08181818181818182
"[1, 0, 0, 1, 1, 0, 0, 1, 1, 0, 1, 1, 0, 1, 1]",250,70,180,7,20,0.1,0.1111111111111111
"[0, 0, 1, 0, 0, 0, 1, 0, 1, 1, 1, 1, 0, 1, 1]",105,45,60,6,6,0.13333333333333333,0.1
"[1, 0, 0, 1, 0, 0, 0, 1, 0, 1, 1, 1, 1, 0, 1]",114,56,58,3,5,0.05357142857142857,0.08620689655172414
"[1, 0, 1, 1, 0, 1, 1, 1, 1, 0, 1, 1, 0, 0, 1]",301,124,177,12,21,0.0967741935483871,0.11864406779661017
"[1, 1, 0, 0, 1, 0, 0, 1, 1, 0, 0, 0, 1, 0, 0]",144,77,67,6,9,0.07792207792207792,0.13432835820895522
"[0, 0, 1, 0, 1, 0, 0, 0, 1, 1, 0, 0, 0, 0, 0]",819,572,247,50,18,0.08741258741258741,0.0728744939271255
"[0, 1, 0, 0, 0, 0, 1, 0, 0, 1, 0, 0, 1, 1, 0]",248,155,93,21,8,0.13548387096774195,0.08602150537634409
"[1, 1, 1, 1, 0, 1, 0, 0, 1, 0, 0, 0, 0, 0, 0]",243,146,97,17,6,0.11643835616438356,0.061855670103092786
"[0, 0, 0, 1, 1, 0, 1, 0, 0, 1, 1, 1, 0, 1, 0]",98,52,46,6,2,0.11538461538461539,0.043478260869565216
"[1, 1, 0, 0, 0, 0, 0, 1, 1, 1, 0, 0, 0, 0, 0]",401,251,150,17,9,0.06772908366533864,0.06
"[0, 0, 0, 0, 1, 1, 1, 1, 1, 1, 0, 0, 1, 1, 1]",2381,1027,1354,94,135,0.09152872444011685,0.09970457902511078
"[1, 0, 0, 1, 0, 0, 1, 0, 0, 0, 1, 0, 0, 0, 0]",553,386,167,32,12,0.08290155440414508,0.0718562874251497
"[0, 1, 0, 0, 1, 0, 0, 1, 0, 0, 0, 1, 0, 0, 0]",531,378,153,33,12,0.0873015873015873,0.0784313725490196
"[0, 1, 1, 0, 1, 1, 1, 1, 1, 0, 1, 0, 0, 1, 1]",259,103,156,7,15,0.06796116504854369,0.09615384615384616
"[0, 0, 1, 0, 1, 0, 0, 1, 1, 1, 0, 0, 0, 1, 1]",132,72,60,6,3,0.08333333333333333,0.05
"[1, 0, 0, 0, 1, 1, 0, 1, 0, 1, 1, 1, 0, 1, 1]",136,45,91,6,11,0.13333333333333333,0.12087912087912088
"[1, 1, 1, 0, 1, 1, 0, 1, 1, 1, 0, 1, 1, 0, 1]",469,130,339,6,28,0.046153846153846156,0.08259587020648967
"[0, 1, 1, 1, 1, 1, 1, 1, 1, 1, 0, 1, 0, 0, 1]",699,275,424,32,29,0.11636363636363636,0.06839622641509434
"[0, 0, 1, 0, 1, 0, 0, 1, 1, 0, 0, 1, 1, 1, 1]",302,179,123,18,12,0.1005586592178771,0.0975609756097561
"[0, 0, 0, 1, 1, 0, 1, 1, 0, 0, 0, 1, 1, 0, 0]",215,141,74,6,9,0.0425531914893617,0.12162162162162163
"[1, 1, 0, 1, 1, 0, 0, 1, 0, 1, 0, 0, 0, 0, 1]",144,73,71,6,7,0.0821917808219178,0.09859154929577464
"[0, 1, 0, 0, 1, 1, 1, 0, 0, 1, 1, 1, 1, 1, 1]",490,198,292,27,24,0.13636363636363635,0.0821917808219178
"[1, 0, 1, 1, 0, 1, 0, 0, 1, 0, 1, 1, 1, 1, 1]",268,91,177,9,16,0.0989010989010989,0.0903954802259887
"[1, 1, 0, 0, 1, 0, 1, 0, 1, 1, 1, 1, 0, 0, 1]",214,72,142,5,10,0.06944444444444445,0.07042253521126761
"[1, 1, 1, 0, 0, 0, 0, 0, 0, 0, 0, 1, 0, 1, 1]",397,137,260,10,20,0.072992700729927,0.07692307692307693
"[1, 1, 1, 1, 0, 1, 0, 0, 0, 0, 1, 1, 0, 0, 0]",236,120,116,12,9,0.1,0.07758620689655173
"[1, 1, 1, 0, 0, 1, 1, 1, 1, 1, 0, 1, 0, 0, 0]",236,69,167,8,13,0.11594202898550725,0.07784431137724551
"[1, 1, 1, 1, 1, 0, 1, 0, 1, 1, 0, 0, 1, 0, 0]",171,62,109,4,10,0.06451612903225806,0.09174311926605505
"[0, 1, 1, 0, 1, 1, 0, 0, 1, 0, 0, 1, 1, 1, 1]",215,101,114,9,9,0.0891089108910891,0.07894736842105263
"[1, 0, 1, 0, 1, 1, 1, 1, 1, 1, 0, 1, 1, 0, 0]",260,82,178,12,15,0.14634146341463414,0.08426966292134831
"[0, 0, 0, 1, 0, 1, 0, 0, 1, 0, 0, 1, 1, 0, 0]",301,193,108,23,10,0.11917098445595854,0.09259259259259259
"[0, 0, 0, 0, 1, 0, 1, 0, 0, 1, 0, 0, 1, 1, 0]",276,176,100,19,8,0.10795454545454546,0.08
"[0, 1, 0, 1, 0, 1, 0, 1, 0, 1, 0, 0, 0, 0, 0]",273,184,89,15,4,0.08152173913043478,0.0449438202247191
"[1, 0, 0, 1, 1, 0, 0, 0, 1, 1, 0, 0, 1, 1, 0]",221,100,121,8,7,0.08,0.05785123966942149
"[0, 0, 1, 0, 0, 0, 1, 0, 1, 0, 0, 1, 0, 1, 0]",198,116,82,8,8,0.06896551724137931,0.0975609756097561
"[1, 1, 0, 1, 1, 1, 1, 1, 0, 0, 0, 0, 1, 0, 0]",133,54,79,4,9,0.07407407407407407,0.11392405063291139
"[1, 0, 1, 0, 0, 1, 0, 0, 0, 0, 0, 0, 0, 0, 1]",680,467,213,34,22,0.0728051391862955,0.10328638497652583
"[0, 1, 1, 1, 0, 1, 0, 0, 0, 0, 0, 0, 0, 0, 1]",361,229,132,23,11,0.10043668122270742,0.08333333333333333
"[0, 0, 0, 0, 1, 0, 1, 1, 1, 0, 1, 0, 0, 0, 0]",269,161,108,14,7,0.08695652173913043,0.06481481481481481
"[0, 1, 1, 1, 0, 0, 1, 1, 0, 1, 1, 0, 1, 1, 1]",290,94,196,9,22,0.09574468085106383,0.11224489795918367
"[1, 0, 1, 1, 1, 0, 1, 1, 1, 0, 0, 1, 1, 0, 1]",253,83,170,9,13,0.10843373493975904,0.07647058823529412
"[0, 0, 1, 1, 0, 1, 1, 1, 0, 1, 1, 1, 0, 0, 1]",182,61,121,4,19,0.06557377049180328,0.15702479338842976
"[0, 1, 1, 1, 0, 0, 1, 1, 0, 1, 1, 1, 0, 1, 1]",238,90,148,5,8,0.05555555555555555,0.05405405405405406
"[1, 1, 0, 1, 1, 0, 1, 1, 1, 0, 0, 1, 1, 0, 1]",250,70,180,7,22,0.1,0.12222222222222222
"[1, 1, 1, 1, 1, 0, 1, 1, 0, 1, 0, 1, 1, 1, 0]",545,155,390,6,37,0.03870967741935484,0.09487179487179487
"[0, 1, 1, 1, 1, 0, 0, 1, 1, 0, 1, 1, 1, 1, 0]",339,170,169,13,16,0.07647058823529412,0.09467455621301775
"[0, 1, 0, 1, 1, 1, 1, 1, 1, 1, 0, 0, 1, 0, 0]",185,87,98,6,6,0.06896551724137931,0.061224489795918366
"[0, 1, 1, 0, 1, 0, 1, 0, 0, 0, 0, 0, 1, 0, 0]",248,158,90,17,7,0.10759493670886076,0.07777777777777778
"[1, 0, 0, 1, 0, 0, 1, 1, 1, 1, 0, 0, 1, 1, 0]",253,126,127,8,12,0.06349206349206349,0.09448818897637795
"[0, 1, 1, 1, 0, 1, 0, 0, 1, 0, 0, 0, 0, 1, 0]",131,81,50,8,4,0.09876543209876543,0.08
"[1, 1, 0, 0, 0, 1, 0, 1, 1, 1, 0, 1, 0, 0, 1]",125,58,67,4,13,0.06896551724137931,0.19402985074626866
"[0, 0, 1, 1, 0, 1, 1, 0, 1, 0, 1, 1, 1, 0, 1]",130,54,76,6,11,0.1111111111111111,0.14473684210526316
"[0, 0, 0, 0, 1, 0, 0, 0, 1, 1, 0, 1, 1, 0, 1]",138,91,47,8,7,0.08791208791208792,0.14893617021276595
"[1, 0, 1, 0, 1, 1, 1, 0, 1, 1, 1, 1, 0, 1, 1]",542,143,399,15,43,0.1048951048951049,0.10776942355889724
"[1, 1, 1, 1, 0, 0, 1, 1, 1, 1, 1, 0, 1, 0, 0]",412,167,245,19,24,0.11377245508982035,0.09795918367346938
"[1, 1, 1, 1, 0, 0, 1, 1, 0, 1, 1, 0, 1, 1, 0]",299,120,179,17,15,0.14166666666666666,0.08379888268156424
"[0, 0, 0, 1, 0, 1, 0, 1, 0, 0, 0, 1, 0, 1, 0]",234,147,87,8,6,0.05442176870748299,0.06896551724137931
"[0, 1, 1, 0, 0, 0, 0, 0, 1, 0, 1, 0, 1, 0, 0]",242,165,77,16,9,0.09696969696969697,0.11688311688311688
"[0, 0, 0, 1, 0, 0, 0, 1, 0, 1, 0, 1, 1, 1, 1]",192,104,88,12,6,0.11538461538461539,0.06818181818181818
"[1, 0, 1, 0, 1, 0, 0, 0, 1, 0, 0, 0, 1, 0, 1]",139,79,60,10,7,0.12658227848101267,0.11666666666666667
"[0, 1, 0, 1, 0, 1, 0, 0, 1, 0, 0, 0, 1, 0, 0]",226,141,85,11,9,0.07801418439716312,0.10588235294117647
"[1, 1, 1, 1, 0, 0, 1, 1, 0, 1, 0, 0, 0, 1, 1]",232,101,131,12,8,0.1188118811881188,0.061068702290076333
"[1, 1, 0, 1, 1, 0, 1, 0, 1, 1, 1, 1, 0, 0, 1]",323,111,212,15,26,0.13513513513513514,0.12264150943396226
"[0, 1, 1, 0, 1, 1, 0, 1, 0, 1, 1, 1, 1, 0, 0]",214,89,125,15,16,0.16853932584269662,0.128
"[0, 1, 1, 0, 1, 0, 0, 1, 1, 0, 1, 1, 0, 1, 0]",101,46,55,6,5,0.13043478260869565,0.09090909090909091
"[0, 0, 0, 0, 1, 1, 0, 1, 0, 1, 0, 0, 0, 0, 0]",661,470,191,68,15,0.14468085106382977,0.07853403141361257
"[0, 1, 1, 0, 1, 0, 0, 0, 1, 1, 1, 1, 0, 0, 0]",174,96,78,12,13,0.125,0.16666666666666666
"[0, 0, 0, 0, 1, 0, 0, 1, 1, 0, 1, 0, 0, 0, 1]",245,162,83,18,4,0.1111111111111111,0.04819277108433735
"[1, 0, 0, 1, 1, 0, 0, 1, 1, 0, 1, 0, 0, 1, 1]",201,63,138,7,11,0.1111111111111111,0.07971014492753623
"[1, 1, 0, 0, 0, 0, 1, 1, 1, 1, 0, 0, 0, 1, 1]",509,243,266,23,13,0.09465020576131687,0.04887218045112782
"[1, 0, 1, 1, 1, 0, 0, 0, 0, 1, 1, 1, 1, 0, 0]",442,212,230,27,15,0.12735849056603774,0.06521739130434782
"[0, 1, 0, 1, 1, 1, 0, 0, 0, 0, 1, 1, 1, 1, 0]",292,132,160,14,22,0.10606060606060606,0.1375
"[1, 0, 0, 0, 0, 1, 0, 0, 1, 0, 1, 0, 1, 1, 1]",133,56,77,6,7,0.10714285714285714,0.09090909090909091
"[0, 0, 1, 1, 0, 1, 0, 0, 0, 0, 0, 0, 1, 0, 0]",519,384,135,30,16,0.078125,0.11851851851851852
"[0, 0, 0, 0, 1, 1, 1, 0, 1, 0, 0, 1, 0, 0, 0]",284,187,97,24,10,0.12834224598930483,0.10309278350515463
"[0, 0, 1, 0, 0, 0, 0, 1, 1, 0, 0, 1, 0, 0, 0]",565,385,180,32,14,0.08311688311688312,0.07777777777777778
"[1, 1, 0, 1, 0, 1, 1, 1, 0, 0, 0, 0, 0, 0, 1]",214,101,113,8,13,0.07920792079207921,0.11504424778761062
"[1, 1, 0, 0, 1, 0, 1, 1, 1, 1, 0, 0, 0, 0, 0]",235,137,98,16,7,0.11678832116788321,0.07142857142857142
"[1, 0, 0, 0, 0, 0, 1, 0, 0, 1, 1, 1, 0, 0, 0]",308,194,114,19,13,0.0979381443298969,0.11403508771929824
"[1, 1, 0, 1, 0, 0, 1, 1, 0, 0, 0, 0, 1, 1, 1]",296,134,162,12,17,0.08955223880597014,0.10493827160493827
"[1, 1, 1, 1, 1, 0, 0, 1, 0, 1, 0, 0, 0, 1, 1]",210,69,141,6,19,0.08695652173913043,0.1347517730496454
"[1, 0, 0, 1, 0, 0, 1, 1, 0, 0, 1, 1, 0, 1, 0]",105,55,50,3,4,0.05454545454545454,0.08
"[1, 1, 1, 0, 1, 1, 1, 0, 1, 1, 1, 1, 0, 1, 0]",533,161,372,18,38,0.11180124223602485,0.10215053763440861
"[1, 0, 1, 0, 1, 1, 0, 1, 1, 1, 0, 1, 1, 1, 0]",199,62,137,4,13,0.06451612903225806,0.0948905109489051
"[0, 0, 0, 1, 1, 1, 0, 1, 0, 1, 1, 0, 1, 1, 1]",189,90,99,12,5,0.13333333333333333,0.050505050505050504
"[1, 1, 1, 0, 0, 1, 1, 0, 1, 1, 0, 0, 1, 1, 0]",192,54,138,5,11,0.09259259259259259,0.07971014492753623
"[1, 1, 1, 1, 1, 0, 1, 1, 1, 1, 0, 0, 1, 1, 0]",808,220,588,21,49,0.09545454545454546,0.08333333333333333
"[1, 1, 1, 1, 1, 0, 0, 1, 1, 1, 0, 0, 0, 1, 0]",194,77,117,9,14,0.11688311688311688,0.11965811965811966
"[0, 0, 1, 1, 0, 0, 1, 1, 1, 1, 0, 1, 0, 1, 1]",376,175,201,23,19,0.13142857142857142,0.0945273631840796
"[0, 0, 0, 1, 1, 1, 1, 0, 1, 1, 1, 1, 1, 1, 1]",963,412,551,29,52,0.0703883495145631,0.09437386569872959
"[0, 0, 1, 0, 1, 0, 0, 0, 1, 1, 0, 1, 1, 0, 0]",159,91,68,11,7,0.12087912087912088,0.10294117647058823
"[1, 1, 1, 1, 0, 1, 1, 1, 0, 0, 1, 1, 0, 1, 0]",223,78,145,9,9,0.11538461538461539,0.06206896551724138
"[1, 0, 0, 1, 0, 1, 1, 0, 1, 1, 0, 0, 0, 0, 1]",153,78,75,3,9,0.038461538461538464,0.12
"[1, 0, 0, 0, 0, 0, 0, 1, 0, 0, 1, 1, 1, 0, 0]",326,181,145,20,17,0.11049723756906077,0.11724137931034483
"[1, 0, 1, 1, 0, 1, 0, 1, 1, 1, 1, 0, 1, 0, 0]",153,65,88,7,9,0.1076923076923077,0.10227272727272728
"[1, 0, 0, 0, 1, 1, 1, 0, 1, 1, 0, 0, 0, 0, 1]",152,80,72,11,9,0.1375,0.125
"[0, 1, 0, 1, 1, 0, 1, 1, 1, 1, 0, 0, 0, 1, 1]",199,99,100,6,9,0.06060606060606061,0.09
"[0, 0, 0, 0, 1, 0, 1, 1, 0, 1, 1, 1, 1, 0, 0]",174,103,71,10,4,0.0970873786407767,0.056338028169014086
"[1, 1, 1, 1, 1, 1, 1, 0, 1, 0, 0, 0, 0, 0, 1]",253,95,158,10,18,0.10526315789473684,0.11392405063291139
"[0, 0, 0, 1, 1, 1, 1, 0, 1, 1, 0, 0, 0, 0, 0]",277,185,92,19,13,0.10270270270270271,0.14130434782608695
"[0, 0, 1, 1, 0, 0, 1, 0, 1, 1, 1, 0, 0, 1, 1]",163,83,80,5,9,0.060240963855421686,0.1125
"[0, 1, 1, 0, 1, 1, 0, 1, 1, 0, 1, 1, 0, 1, 1]",248,99,149,13,19,0.13131313131313133,0.12751677852348994
"[1, 1, 0, 1, 1, 0, 1, 1, 0, 1, 1, 0, 1, 1, 0]",256,94,162,11,14,0.11702127659574468,0.08641975308641975
"[1, 0, 1, 1, 1, 0, 0, 1, 1, 0, 1, 1, 0, 0, 1]",158,67,91,6,7,0.08955223880597014,0.07692307692307693
"[0, 0, 0, 1, 0, 0, 1, 1, 1, 0, 1, 0, 0, 0, 1]",127,73,54,8,4,0.1095890410958904,0.07407407407407407
"[1, 1, 0, 0, 1, 1, 0, 1, 1, 1, 1, 1, 1, 0, 1]",589,170,419,19,39,0.11176470588235295,0.09307875894988067
"[0, 1, 0, 0, 1, 1, 0, 1, 1, 1, 1, 0, 0, 0, 0]",181,95,86,12,7,0.12631578947368421,0.08139534883720931
"[1, 0, 0, 1, 0, 0, 1, 1, 0, 1, 1, 1, 1, 0, 0]",154,79,75,11,10,0.13924050632911392,0.13333333333333333
"[1, 0, 0, 1, 1, 1, 0, 0, 0, 1, 0, 0, 1, 0, 0]",160,102,58,12,4,0.11764705882352941,0.06896551724137931
"[1, 0, 0, 0, 1, 1, 1, 1, 1, 1, 1, 0, 1, 1, 1]",742,191,551,13,47,0.06806282722513089,0.0852994555353902
"[1, 0, 1, 1, 1, 1, 1, 0, 1, 0, 0, 1, 1, 0, 1]",224,77,147,5,11,0.06493506493506493,0.07482993197278912
"[0, 0, 1, 1, 0, 1, 1, 1, 0, 1, 1, 1, 0, 1, 1]",230,83,147,11,16,0.13253012048192772,0.10884353741496598
"[1, 0, 1, 0, 1, 1, 1, 1, 1, 0, 0, 1, 1, 0, 0]",364,132,232,15,27,0.11363636363636363,0.11637931034482758
"[0, 1, 0, 1, 0, 1, 0, 1, 1, 1, 1, 0, 1, 0, 1]",148,64,84,3,7,0.046875,0.08333333333333333
"[0, 0, 1, 0, 0, 0, 0, 0, 0, 1, 1, 0, 0, 1, 0]",567,401,166,40,19,0.09975062344139651,0.1144578313253012
"[0, 0, 0, 1, 0, 0, 0, 0, 0, 0, 1, 1, 0, 0, 1]",1021,733,288,81,34,0.11050477489768076,0.11805555555555555
"[0, 0, 0, 1, 1, 1, 0, 1, 0, 1, 0, 0, 1, 1, 1]",148,78,70,14,10,0.1794871794871795,0.14285714285714285
"[0, 0, 0, 1, 1, 1, 1, 0, 0, 0, 0, 1, 1, 1, 0]",358,268,90,28,11,0.1044776119402985,0.12222222222222222
"[0, 1, 0, 0, 0, 0, 1, 0, 1, 1, 0, 0, 0, 0, 0]",716,493,223,38,21,0.07707910750507099,0.09417040358744394
"[0, 0, 1, 1, 0, 1, 0, 1, 0, 1, 1, 1, 1, 0, 0]",151,64,87,4,8,0.0625,0.09195402298850575
"[1, 1, 1, 1, 1, 0, 1, 1, 0, 1, 0, 1, 0, 1, 1]",529,127,402,14,31,0.11023622047244094,0.07711442786069651
"[0, 1, 0, 1, 1, 1, 0, 0, 0, 1, 1, 1, 1, 1, 0]",178,68,110,9,11,0.1323529411764706,0.1
"[0, 1, 0, 1, 0, 0, 1, 0, 1, 1, 1, 0, 0, 0, 1]",112,60,52,4,5,0.06666666666666667,0.09615384615384616
"[1, 1, 1, 1, 1, 0, 0, 1, 0, 1, 0, 0, 1, 0, 1]",179,66,113,4,9,0.06060606060606061,0.07964601769911504
"[1, 1, 0, 1, 1, 1, 1, 1, 0, 0, 1, 0, 1, 0, 0]",133,44,89,4,4,0.09090909090909091,0.0449438202247191
"[1, 0, 1, 0, 1, 1, 1, 0, 1, 1, 0, 0, 1, 0, 0]",108,55,53,5,4,0.09090909090909091,0.07547169811320754
"[0, 1, 1, 0, 0, 1, 0, 1, 0, 1, 1, 1, 0, 1, 1]",144,67,77,9,2,0.13432835820895522,0.025974025974025976
"[1, 0, 0, 1, 0, 1, 1, 0, 0, 1, 0, 1, 0, 1, 1]",114,46,68,7,8,0.15217391304347827,0.11764705882352941
"[0, 0, 0, 0, 1, 0, 1, 0, 1, 0, 0, 0, 1, 1, 0]",282,182,100,10,12,0.054945054945054944,0.12
"[0, 1, 0, 0, 0, 0, 1, 0, 1, 0, 1, 0, 0, 0, 1]",232,152,80,20,3,0.13157894736842105,0.0375
"[1, 0, 0, 0, 1, 0, 0, 0, 0, 1, 0, 1, 0, 1, 0]",242,162,80,15,3,0.09259259259259259,0.0375
"[0, 0, 0, 0, 0, 0, 0, 1, 1, 0, 1, 0, 0, 1, 0]",705,521,184,45,20,0.08637236084452975,0.10869565217391304
"[0, 1, 1, 1, 1, 1, 0, 0, 1, 0, 0, 0, 0, 1, 0]",102,49,53,6,6,0.12244897959183673,0.11320754716981132
"[0, 0, 0, 1, 1, 0, 0, 1, 0, 0, 1, 1, 1, 1, 1]",291,158,133,22,9,0.13924050632911392,0.06766917293233082
"[1, 0, 1, 0, 0, 0, 0, 0, 0, 0, 1, 0, 0, 1, 0]",517,357,160,36,12,0.10084033613445378,0.075
"[0, 0, 1, 1, 0, 0, 0, 0, 0, 1, 0, 0, 1, 1, 1]",488,314,174,25,18,0.07961783439490445,0.10344827586206896
"[0, 1, 1, 1, 1, 0, 0, 0, 1, 0, 1, 0, 1, 0, 0]",126,71,55,7,3,0.09859154929577464,0.05454545454545454
"[0, 0, 0, 0, 1, 0, 1, 0, 0, 0, 1, 1, 1, 1, 0]",228,147,81,17,7,0.11564625850340136,0.08641975308641975
"[0, 1, 0, 1, 0, 0, 1, 1, 1, 1, 0, 1, 1, 1, 1]",321,110,211,13,18,0.11818181818181818,0.08530805687203792
"[1, 1, 0, 1, 1, 1, 1, 0, 1, 0, 1, 0, 1, 1, 1]",530,171,359,20,42,0.11695906432748537,0.116991643454039
"[1, 1, 0, 1, 0, 0, 0, 0, 1, 1, 1, 1, 0, 1, 1]",164,67,97,6,4,0.08955223880597014,0.041237113402061855
"[0, 0, 1, 0, 1, 1, 1, 0, 0, 1, 1, 0, 0, 0, 1]",129,72,57,10,7,0.1388888888888889,0.12280701754385964
"[0, 0, 1, 1, 0, 0, 1, 0, 0, 1, 0, 1, 1, 0, 1]",123,63,60,6,5,0.09523809523809523,0.08333333333333333
"[1, 0, 1, 0, 0, 1, 1, 0, 0, 1, 0, 0, 1, 0, 1]",94,51,43,5,8,0.09803921568627451,0.18604651162790697
"[0, 0, 0, 1, 1, 0, 1, 1, 0, 0, 0, 1, 0, 0, 1]",161,101,60,5,7,0.04950495049504951,0.11666666666666667
"[1, 0, 0, 1, 1, 0, 0, 0, 1, 1, 0, 0, 0, 1, 1]",201,87,114,3,9,0.034482758620689655,0.07894736842105263
"[1, 1, 1, 0, 1, 0, 0, 1, 1, 0, 1, 1, 0, 1, 0]",149,72,77,6,10,0.08333333333333333,0.12987012987012986
"[1, 1, 1, 1, 1, 0, 1, 0, 0, 1, 1, 0, 0, 1, 0]",156,53,103,3,11,0.05660377358490566,0.10679611650485436
"[0, 0, 0, 1, 0, 0, 0, 1, 1, 0, 1, 0, 1, 1, 1]",139,76,63,5,8,0.06578947368421052,0.12698412698412698
"[0, 1, 0, 0, 1, 0, 0, 0, 0, 1, 0, 1, 0, 0, 1]",209,135,74,19,10,0.14074074074074075,0.13513513513513514
"[0, 0, 0, 1, 1, 0, 0, 1, 0, 1, 1, 1, 0, 1, 1]",157,92,65,11,8,0.11956521739130435,0.12307692307692308
"[0, 0, 0, 0, 1, 0, 0, 0, 1, 1, 0, 0, 1, 0, 1]",258,170,88,12,14,0.07058823529411765,0.1590909090909091
"[0, 1, 1, 1, 1, 0, 1, 0, 1, 0, 1, 0, 0, 0, 1]",135,74,61,8,5,0.10810810810810811,0.08196721311475409
"[0, 0, 1, 1, 0, 0, 1, 1, 1, 1, 0, 1, 0, 1, 0]",221,104,117,12,9,0.11538461538461539,0.07692307692307693
"[0, 1, 1, 1, 0, 1, 0, 1, 1, 0, 1, 0, 1, 1, 0]",147,67,80,10,4,0.14925373134328357,0.05
"[1, 0, 0, 0, 1, 0, 0, 1, 0, 1, 1, 0, 0, 0, 0]",336,197,139,17,14,0.08629441624365482,0.10071942446043165
"[0, 1, 1, 0, 1, 1, 0, 0, 1, 0, 1, 0, 1, 1, 0]",102,52,50,5,4,0.09615384615384616,0.08
"[1, 0, 0, 1, 1, 1, 1, 0, 1, 1, 0, 1, 0, 1, 1]",288,93,195,10,17,0.10752688172043011,0.08717948717948718
"[1, 1, 1, 0, 1, 0, 0, 1, 1, 1, 1, 0, 1, 1, 0]",237,75,162,9,19,0.12,0.11728395061728394
"[0, 1, 1, 1, 1, 1, 1, 0, 0, 0, 1, 1, 1, 0, 0]",288,147,141,14,13,0.09523809523809523,0.09219858156028368
"[0, 0, 0, 0, 1, 1, 1, 1, 1, 1, 0, 0, 0, 1, 1]",590,342,248,34,31,0.09941520467836257,0.125
"[1, 1, 1, 0, 1, 0, 0, 1, 0, 0, 0, 0, 0, 0, 1]",203,107,96,9,13,0.08411214953271028,0.13541666666666666
"[1, 0, 1, 1, 1, 1, 1, 1, 0, 1, 0, 0, 0, 0, 1]",169,75,94,5,8,0.06666666666666667,0.0851063829787234
"[1, 1, 0, 0, 1, 1, 0, 0, 0, 0, 0, 1, 0, 0, 0]",470,323,147,23,14,0.07120743034055728,0.09523809523809523
"[0, 1, 1, 1, 0, 0, 0, 1, 0, 1, 0, 0, 0, 0, 1]",136,86,50,9,8,0.10465116279069768,0.16
"[1, 0, 1, 0, 1, 0, 1, 0, 1, 0, 1, 1, 0, 1, 1]",132,55,77,3,5,0.05454545454545454,0.06493506493506493
"[0, 1, 1, 1, 0, 0, 1, 1, 0, 1, 1, 0, 1, 0, 1]",141,57,84,9,9,0.15789473684210525,0.10714285714285714
"[0, 1, 0, 1, 0, 0, 0, 0, 0, 1, 0, 0, 0, 1, 1]",300,206,94,22,7,0.10679611650485436,0.07446808510638298
"[1, 0, 0, 0, 1, 1, 0, 1, 0, 1, 0, 0, 0, 0, 0]",297,180,117,22,12,0.12222222222222222,0.10256410256410256
"[0, 0, 0, 0, 1, 0, 1, 1, 1, 0, 1, 1, 0, 0, 1]",139,85,54,4,9,0.047058823529411764,0.16666666666666666
"[1, 0, 0, 0, 0, 0, 1, 0, 1, 1, 1, 0, 1, 1, 0]",131,70,61,8,5,0.11428571428571428,0.08196721311475409
"[0, 0, 1, 1, 0, 1, 0, 0, 0, 1, 0, 1, 0, 0, 1]",148,78,70,10,6,0.1282051282051282,0.08571428571428572
"[1, 0, 0, 0, 1, 0, 0, 1, 1, 0, 0, 0, 0, 0, 1]",288,177,111,15,9,0.0847457627118644,0.08108108108108109
"[1, 1, 1, 0, 0, 0, 0, 1, 0, 1, 1, 0, 0, 0, 1]",144,69,75,3,5,0.043478260869565216,0.06666666666666667
"[0, 0, 1, 0, 0, 1, 0, 0, 0, 1, 0, 0, 0, 1, 1]",285,193,92,21,11,0.10880829015544041,0.11956521739130435
"[0, 1, 1, 0, 1, 0, 0, 1, 0, 0, 1, 0, 0, 0, 1]",125,76,49,4,3,0.05263157894736842,0.061224489795918366
"[1, 1, 1, 0, 0, 0, 1, 0, 1, 0, 0, 1, 1, 1, 0]",126,48,78,2,12,0.041666666666666664,0.15384615384615385
"[1, 1, 1, 0, 0, 1, 0, 1, 1, 0, 0, 1, 0, 0, 1]",112,48,64,3,6,0.0625,0.09375
"[1, 1, 0, 0, 1, 0, 0, 1, 0, 1, 1, 1, 0, 0, 0]",128,66,62,4,3,0.06060606060606061,0.04838709677419355
"[0, 0, 0, 0, 0, 0, 1, 0, 0, 0, 1, 0, 1, 0, 1]",559,419,140,35,13,0.08353221957040573,0.09285714285714286
"[1, 0, 1, 0, 1, 1, 0, 1, 1, 0, 1, 0, 1, 1, 0]",137,52,85,2,6,0.038461538461538464,0.07058823529411765
"[0, 0, 0, 1, 1, 0, 0, 1, 0, 1, 0, 0, 1, 1, 0]",158,99,59,9,3,0.09090909090909091,0.05084745762711865
"[0, 0, 1, 0, 0, 0, 1, 1, 0, 1, 0, 1, 0, 0, 0]",227,153,74,14,8,0.0915032679738562,0.10810810810810811
"[1, 0, 0, 1, 1, 1, 0, 1, 0, 0, 1, 1, 1, 1, 0]",186,73,113,4,14,0.0547945205479452,0.12389380530973451
"[0, 1, 0, 0, 0, 1, 1, 1, 1, 0, 1, 1, 0, 1, 1]",161,67,94,5,10,0.07462686567164178,0.10638297872340426
"[1, 0, 1, 1, 1, 1, 1, 1, 1, 0, 1, 1, 0, 0, 1]",629,165,464,15,46,0.09090909090909091,0.09913793103448276
"[1, 0, 1, 0, 1, 0, 0, 1, 0, 1, 1, 0, 0, 1, 1]",139,66,73,3,7,0.045454545454545456,0.0958904109589041
"[1, 0, 0, 0, 1, 0, 1, 1, 0, 0, 1, 0, 0, 1, 0]",126,77,49,9,6,0.11688311688311688,0.12244897959183673
"[1, 1, 1, 0, 0, 0, 1, 0, 1, 1, 0, 0, 1, 0, 0]",126,74,52,3,5,0.04054054054054054,0.09615384615384616
"[0, 0, 1, 0, 1, 0, 0, 0, 0, 0, 1, 1, 1, 1, 0]",335,216,119,24,14,0.1111111111111111,0.11764705882352941
"[0, 0, 1, 1, 0, 0, 1, 0, 0, 1, 1, 0, 1, 1, 1]",185,93,92,13,6,0.13978494623655913,0.06521739130434782
"[0, 1, 0, 1, 1, 1, 0, 1, 1, 0, 1, 1, 1, 1, 0]",252,87,165,5,14,0.05747126436781609,0.08484848484848485
"[1, 1, 0, 1, 0, 1, 1, 1, 0, 1, 1, 0, 1, 1, 1]",571,177,394,22,35,0.12429378531073447,0.08883248730964467
"[1, 0, 0, 1, 0, 0, 1, 1, 1, 1, 1, 1, 1, 1, 1]",1187,345,842,38,70,0.11014492753623188,0.0831353919239905
"[1, 1, 0, 0, 1, 0, 0, 1, 1, 0, 0, 0, 0, 1, 0]",132,73,59,7,6,0.0958904109589041,0.1016949152542373
"[1, 1, 1, 0, 1, 1, 0, 0, 1, 0, 0, 1, 1, 0, 0]",144,55,89,7,3,0.12727272727272726,0.033707865168539325
"[1, 1, 0, 1, 1, 1, 0, 1, 0, 0, 0, 0, 1, 0, 0]",111,51,60,5,7,0.09803921568627451,0.11666666666666667
"[1, 1, 0, 1, 0, 1, 1, 0, 0, 1, 1, 1, 1, 1, 0]",238,80,158,6,19,0.075,0.12025316455696203
"[0, 1, 1, 0, 1, 0, 1, 1, 0, 0, 1, 1, 1, 1, 1]",409,176,233,18,25,0.10227272727272728,0.1072961373390558
"[1, 1, 0, 0, 1, 1, 1, 1, 0, 0, 1, 0, 0, 1, 0]",195,76,119,6,11,0.07894736842105263,0.09243697478991597
"[0, 0, 1, 1, 1, 1, 0, 0, 0, 0, 1, 1, 0, 0, 1]",1567,821,746,70,82,0.08526187576126674,0.10991957104557641
"[0, 0, 1, 1, 1, 1, 1, 0, 0, 1, 1, 1, 0, 1, 0]",177,76,101,5,8,0.06578947368421052,0.07920792079207921
"[0, 0, 0, 0, 0, 0, 0, 0, 0, 1, 1, 1, 1, 1, 0]",796,615,181,63,14,0.1024390243902439,0.07734806629834254
"[1, 0, 1, 1, 0, 0, 1, 0, 0, 0, 0, 1, 0, 1, 0]",130,74,56,12,5,0.16216216216216217,0.08928571428571429
"[0, 1, 0, 1, 0, 1, 0, 1, 1, 0, 0, 1, 0, 0, 0]",139,89,50,8,3,0.0898876404494382,0.06
"[0, 0, 1, 0, 1, 0, 1, 0, 1, 1, 0, 0, 1, 0, 0]",144,86,58,8,4,0.09302325581395349,0.06896551724137931
"[0, 1, 0, 1, 1, 1, 0, 0, 1, 0, 1, 0, 1, 1, 0]",122,62,60,4,4,0.06451612903225806,0.06666666666666667
"[0, 1, 1, 1, 0, 1, 0, 1, 1, 1, 0, 0, 1, 0, 1]",149,82,67,7,4,0.08536585365853659,0.05970149253731343
"[0, 0, 1, 0, 1, 1, 0, 0, 0, 1, 1, 1, 1, 0, 1]",102,45,57,4,16,0.08888888888888889,0.2807017543859649
"[0, 1, 1, 1, 1, 0, 0, 0, 0, 0, 0, 1, 1, 1, 0]",418,306,112,27,13,0.08823529411764706,0.11607142857142858
"[1, 0, 0, 0, 1, 1, 1, 0, 0, 1, 0, 1, 0, 1, 1]",129,64,65,7,4,0.109375,0.06153846153846154
"[0, 1, 0, 0, 0, 0, 1, 0, 1, 0, 0, 0, 0, 0, 1]",558,391,167,44,20,0.11253196930946291,0.11976047904191617
"[1, 1, 0, 1, 0, 0, 0, 0, 1, 0, 1, 0, 0, 0, 0]",273,168,105,19,15,0.1130952380952381,0.14285714285714285
"[1, 0, 1, 0, 0, 0, 1, 0, 0, 1, 0, 1, 1, 0, 0]",144,86,58,8,4,0.09302325581395349,0.06896551724137931
"[1, 0, 1, 0, 1, 1, 0, 0, 1, 1, 0, 0, 0, 0, 1]",259,112,147,8,14,0.07142857142857142,0.09523809523809523
"[0, 0, 1, 0, 0, 1, 0, 1, 0, 0, 1, 0, 0, 0, 1]",216,145,71,17,5,0.11724137931034483,0.07042253521126761
"[1, 0, 0, 0, 0, 1, 0, 0, 0, 0, 1, 0, 1, 0, 0]",499,364,135,44,10,0.12087912087912088,0.07407407407407407
"[0, 1, 0, 0, 0, 0, 1, 0, 0, 0, 0, 1, 0, 1, 0]",503,358,145,36,13,0.1005586592178771,0.0896551724137931
"[1, 0, 0, 0, 1, 0, 0, 0, 0, 0, 0, 0, 1, 1, 0]",841,561,280,55,38,0.09803921568627451,0.1357142857142857
"[1, 1, 0, 0, 0, 1, 1, 1, 0, 1, 0, 0, 1, 0, 0]",104,38,66,5,5,0.13157894736842105,0.07575757575757576
"[1, 1, 1, 1, 1, 0, 0, 0, 0, 0, 1, 1, 1, 0, 0]",188,76,112,9,11,0.11842105263157894,0.09821428571428571
"[1, 0, 0, 0, 0, 1, 1, 1, 1, 0, 0, 1, 0, 0, 1]",215,66,149,10,13,0.15151515151515152,0.087248322147651
"[0, 0, 0, 0, 1, 1, 0, 1, 1, 1, 1, 1, 1, 1, 1]",620,245,375,14,38,0.05714285714285714,0.10133333333333333
"[1, 0, 1, 1, 0, 0, 0, 0, 1, 1, 0, 1, 1, 1, 1]",197,80,117,10,8,0.125,0.06837606837606838
"[0, 1, 1, 0, 1, 0, 1, 0, 1, 1, 0, 0, 0, 0, 1]",160,93,67,15,8,0.16129032258064516,0.11940298507462686
"[0, 0, 0, 0, 1, 1, 0, 1, 0, 1, 0, 1, 1, 0, 0]",181,106,75,5,6,0.04716981132075472,0.08
"[0, 0, 1, 0, 0, 1, 0, 1, 0, 1, 0, 1, 0, 1, 0]",153,102,51,11,4,0.10784313725490197,0.0784313725490196
"[1, 0, 0, 1, 0, 0, 1, 0, 1, 0, 1, 0, 1, 0, 1]",99,52,47,5,6,0.09615384615384616,0.1276595744680851
"[1, 0, 1, 1, 0, 0, 1, 1, 0, 0, 1, 1, 0, 0, 0]",423,235,188,24,20,0.10212765957446808,0.10638297872340426
"[1, 1, 0, 1, 1, 0, 0, 1, 1, 0, 0, 1, 1, 0, 0]",439,208,231,18,27,0.08653846153846154,0.11688311688311688
"[1, 0, 1, 0, 0, 0, 1, 0, 0, 1, 1, 1, 1, 0, 1]",129,54,75,4,6,0.07407407407407407,0.08
"[1, 0, 1, 1, 1, 0, 1, 0, 1, 1, 1, 1, 1, 0, 1]",486,146,340,11,23,0.07534246575342465,0.06764705882352941
"[1, 0, 1, 1, 0, 1, 1, 0, 1, 1, 1, 0, 0, 1, 0]",138,56,82,5,8,0.08928571428571429,0.0975609756097561
"[1, 0, 0, 1, 0, 0, 0, 1, 1, 1, 1, 1, 1, 1, 0]",187,68,119,7,8,0.10294117647058823,0.06722689075630252
"[1, 1, 1, 1, 0, 0, 1, 0, 0, 0, 1, 1, 1, 1, 1]",462,171,291,16,30,0.0935672514619883,0.10309278350515463
"[1, 1, 0, 1, 0, 0, 0, 1, 1, 1, 1, 0, 1, 0, 1]",158,60,98,2,12,0.03333333333333333,0.12244897959183673
"[1, 1, 1, 1, 0, 1, 1, 0, 1, 0, 1, 1, 1, 1, 0]",544,172,372,19,38,0.11046511627906977,0.10215053763440861
"[1, 1, 1, 0, 1, 0, 0, 0, 0, 1, 0, 1, 1, 0, 0]",116,61,55,8,3,0.13114754098360656,0.05454545454545454
"[1, 0, 0, 0, 0, 0, 0, 0, 0, 1, 0, 1, 0, 0, 1]",619,375,244,37,27,0.09866666666666667,0.11065573770491803
"[0, 0, 1, 1, 0, 1, 0, 0, 1, 1, 0, 0, 0, 0, 1]",232,131,101,8,7,0.061068702290076333,0.06930693069306931
"[1, 1, 1, 1, 1, 0, 0, 0, 1, 0, 0, 0, 1, 1, 0]",161,63,98,9,7,0.14285714285714285,0.07142857142857142
"[1, 1, 0, 1, 0, 0, 0, 1, 1, 1, 0, 0, 0, 0, 0]",212,121,91,16,11,0.1322314049586777,0.12087912087912088
"[0, 0, 1, 0, 1, 1, 1, 1, 0, 0, 1, 1, 1, 1, 0]",264,118,146,10,18,0.0847457627118644,0.1232876712328767
"[0, 0, 0, 0, 0, 0, 0, 1, 1, 1, 0, 1, 1, 0, 0]",387,269,118,30,18,0.11152416356877323,0.15254237288135594
"[0, 0, 0, 1, 0, 0, 0, 0, 1, 1, 1, 1, 1, 1, 1]",362,203,159,20,16,0.09852216748768473,0.10062893081761007
"[1, 1, 1, 1, 1, 0, 0, 0, 0, 0, 0, 1, 0, 0, 1]",282,89,193,12,23,0.1348314606741573,0.11917098445595854
"[1, 1, 1, 0, 1, 0, 0, 0, 0, 0, 1, 1, 0, 1, 0]",135,69,66,3,2,0.043478260869565216,0.030303030303030304
"[1, 0, 0, 1, 1, 0, 1, 1, 1, 1, 1, 1, 0, 1, 0]",249,89,160,5,16,0.056179775280898875,0.1
"[1, 0, 1, 0, 0, 0, 1, 0, 0, 0, 1, 1, 1, 0, 1]",108,59,49,5,0,0.0847457627118644,0.0
"[0, 0, 1, 1, 0, 0, 0, 0, 1, 0, 1, 0, 1, 1, 1]",313,182,131,22,11,0.12087912087912088,0.08396946564885496
"[0, 1, 1, 1, 0, 0, 0, 0, 0, 0, 0, 1, 0, 1, 0]",253,161,92,12,5,0.07453416149068323,0.05434782608695652
"[0, 1, 1, 0, 0, 0, 0, 1, 0, 1, 1, 1, 1, 1, 1]",322,174,148,13,19,0.07471264367816093,0.12837837837837837
"[1, 1, 0, 0, 0, 0, 0, 0, 1, 1, 0, 0, 1, 0, 0]",592,369,223,34,24,0.0921409214092141,0.10762331838565023
"[0, 1, 0, 0, 1, 1, 1, 1, 0, 1, 0, 1, 0, 0, 1]",114,59,55,11,7,0.1864406779661017,0.12727272727272726
"[0, 1, 1, 1, 0, 1, 0, 1, 1, 0, 1, 0, 1, 1, 1]",270,105,165,4,16,0.0380952380952381,0.09696969696969697
"[0, 0, 0, 1, 1, 0, 0, 1, 0, 1, 1, 0, 0, 1, 1]",187,110,77,9,8,0.08181818181818182,0.1038961038961039
"[0, 0, 1, 1, 1, 0, 1, 0, 0, 0, 1, 1, 0, 0, 1]",173,87,86,9,8,0.10344827586206896,0.09302325581395349
"[0, 1, 1, 0, 0, 1, 1, 1, 0, 1, 0, 0, 0, 1, 1]",183,120,63,10,11,0.08333333333333333,0.1746031746031746
"[0, 1, 0, 0, 0, 1, 1, 0, 0, 0, 1, 1, 1, 1, 1]",186,107,79,13,11,0.12149532710280374,0.13924050632911392
"[0, 0, 1, 1, 1, 1, 0, 1, 1, 0, 0, 0, 0, 1, 1]",229,107,122,8,12,0.07476635514018691,0.09836065573770492
"[1, 1, 1, 0, 0, 0, 1, 1, 1, 1, 0, 1, 1, 0, 0]",182,65,117,8,9,0.12307692307692308,0.07692307692307693
"[1, 0, 1, 1, 0, 0, 1, 0, 1, 0, 1, 0, 0, 1, 0]",114,61,53,7,5,0.11475409836065574,0.09433962264150944
"[0, 0, 1, 1, 0, 1, 0, 0, 1, 1, 1, 1, 1, 0, 1]",153,53,100,2,11,0.03773584905660377,0.11
"[1, 0, 0, 1, 0, 0, 1, 0, 1, 0, 1, 1, 1, 0, 1]",107,44,63,5,4,0.11363636363636363,0.06349206349206349
"[1, 0, 1, 1, 0, 1, 0, 1, 1, 0, 0, 0, 0, 0, 0]",229,120,109,12,7,0.1,0.06422018348623854
"[1, 0, 1, 1, 0, 1, 1, 0, 0, 0, 0, 0, 1, 0, 1]",139,76,63,5,7,0.06578947368421052,0.1111111111111111
"[0, 0, 0, 1, 0, 1, 0, 1, 1, 0, 1, 1, 0, 0, 0]",154,97,57,7,7,0.07216494845360824,0.12280701754385964
"[1, 1, 0, 1, 1, 0, 0, 0, 0, 0, 1, 1, 0, 1, 0]",122,69,53,7,8,0.10144927536231885,0.1509433962264151
"[0, 1, 0, 0, 1, 0, 1, 0, 0, 0, 1, 0, 1, 1, 0]",138,79,59,9,5,0.11392405063291139,0.0847457627118644
"[1, 1, 0, 0, 1, 0, 0, 1, 0, 1, 0, 0, 0, 1, 0]",142,85,57,7,6,0.08235294117647059,0.10526315789473684
"[1, 1, 0, 0, 1, 0, 1, 1, 0, 0, 1, 0, 1, 1, 1]",187,76,111,13,8,0.17105263157894737,0.07207207207207207
"[0, 0, 1, 1, 0, 0, 1, 0, 1, 1, 0, 0, 1, 0, 1]",116,61,55,8,6,0.13114754098360656,0.10909090909090909
"[0, 1, 0, 1, 0, 1, 0, 1, 0, 0, 1, 1, 0, 0, 0]",211,111,100,8,10,0.07207207207207207,0.1
"[0, 1, 0, 1, 0, 0, 1, 1, 0, 1, 0, 0, 1, 1, 0]",111,60,51,7,3,0.11666666666666667,0.058823529411764705
"[1, 1, 1, 0, 0, 0, 0, 0, 1, 1, 0, 0, 0, 0, 0]",567,294,273,22,21,0.07482993197278912,0.07692307692307693
"[0, 0, 1, 0, 0, 0, 1, 0, 1, 1, 1, 0, 1, 0, 1]",102,59,43,9,3,0.15254237288135594,0.06976744186046512
"[0, 1, 0, 0, 0, 1, 0, 0, 0, 1, 0, 1, 1, 1, 0]",146,92,54,8,7,0.08695652173913043,0.12962962962962962
"[1, 1, 0, 1, 0, 0, 0, 0, 1, 0, 0, 0, 1, 0, 0]",246,161,85,14,9,0.08695652173913043,0.10588235294117647
"[1, 0, 0, 1, 1, 0, 1, 1, 1, 0, 0, 1, 0, 1, 1]",157,49,108,4,11,0.08163265306122448,0.10185185185185185
"[1, 0, 0, 1, 0, 1, 0, 0, 0, 0, 1, 0, 0, 0, 1]",220,129,91,9,11,0.06976744186046512,0.12087912087912088
"[0, 0, 0, 1, 0, 0, 1, 1, 0, 1, 0, 0, 1, 0, 1]",145,80,65,4,9,0.05,0.13846153846153847
"[0, 1, 1, 1, 0, 1, 0, 1, 0, 1, 1, 1, 1, 1, 0]",239,105,134,6,11,0.05714285714285714,0.08208955223880597
"[1, 0, 1, 0, 0, 1, 1, 0, 1, 1, 0, 1, 1, 0, 1]",113,51,62,3,8,0.058823529411764705,0.12903225806451613
"[1, 0, 1, 1, 1, 1, 1, 0, 0, 0, 0, 0, 1, 1, 0]",182,81,101,10,10,0.12345679012345678,0.09900990099009901
"[1, 1, 0, 1, 1, 1, 1, 1, 0, 0, 0, 0, 0, 1, 1]",266,100,166,6,16,0.06,0.0963855421686747
"[1, 0, 0, 1, 0, 0, 0, 0, 1, 1, 1, 1, 0, 1, 1]",133,53,80,2,2,0.03773584905660377,0.025
"[1, 1, 0, 0, 1, 0, 0, 0, 0, 1, 1, 1, 1, 0, 1]",134,63,71,7,6,0.1111111111111111,0.08450704225352113
"[0, 1, 0, 0, 0, 1, 1, 1, 1, 0, 1, 1, 1, 0, 1]",133,53,80,6,7,0.11320754716981132,0.0875
"[0, 1, 0, 1, 1, 0, 1, 0, 0, 0, 1, 1, 1, 1, 0]",139,67,72,5,9,0.07462686567164178,0.125
"[0, 0, 1, 0, 1, 1, 1, 0, 0, 0, 1, 0, 1, 0, 0]",141,78,63,9,5,0.11538461538461539,0.07936507936507936
"[0, 0, 1, 0, 1, 0, 1, 1, 1, 0, 1, 1, 1, 1, 1]",300,115,185,9,12,0.0782608695652174,0.06486486486486487
"[0, 1, 1, 1, 1, 1, 0, 1, 1, 0, 0, 1, 0, 1, 0]",130,52,78,7,7,0.1346153846153846,0.08974358974358974
"[1, 1, 1, 0, 0, 0, 1, 0, 1, 0, 1, 1, 0, 0, 0]",141,65,76,9,7,0.13846153846153847,0.09210526315789473
"[0, 1, 0, 0, 0, 0, 1, 1, 1, 1, 1, 0, 0, 0, 1]",134,78,56,10,10,0.1282051282051282,0.17857142857142858
"[1, 1, 1, 0, 0, 0, 0, 1, 0, 1, 0, 0, 0, 0, 1]",164,90,74,11,7,0.12222222222222222,0.0945945945945946
"[0, 1, 0, 0, 0, 1, 1, 1, 1, 1, 1, 0, 0, 1, 1]",449,190,259,26,26,0.1368421052631579,0.10038610038610038
"[1, 1, 1, 0, 1, 1, 1, 0, 1, 1, 0, 1, 0, 0, 0]",158,61,97,7,7,0.11475409836065574,0.07216494845360824
"[0, 0, 1, 1, 0, 0, 0, 1, 0, 0, 0, 1, 1, 0, 0]",385,247,138,27,19,0.10931174089068826,0.13768115942028986
"[0, 0, 1, 0, 0, 0, 1, 0, 0, 1, 1, 0, 1, 0, 1]",112,66,46,10,6,0.15151515151515152,0.13043478260869565
"[1, 0, 1, 1, 0, 0, 1, 0, 0, 0, 0, 0, 1, 0, 1]",142,87,55,4,4,0.04597701149425287,0.07272727272727272
"[1, 0, 1, 1, 0, 1, 1, 1, 1, 0, 0, 1, 1, 0, 0]",341,131,210,10,23,0.07633587786259542,0.10952380952380952
"[0, 1, 1, 1, 0, 0, 1, 0, 0, 1, 0, 1, 1, 1, 1]",193,91,102,7,6,0.07692307692307693,0.058823529411764705
"[1, 1, 1, 0, 1, 1, 1, 0, 0, 1, 0, 0, 1, 0, 1]",140,55,85,8,11,0.14545454545454545,0.12941176470588237
"[1, 1, 0, 1, 1, 0, 0, 0, 0, 1, 0, 1, 1, 0, 0]",124,54,70,8,7,0.14814814814814814,0.1
"[0, 1, 0, 0, 1, 1, 1, 0, 1, 1, 1, 0, 0, 0, 1]",113,57,56,6,5,0.10526315789473684,0.08928571428571429
"[1, 0, 0, 0, 1, 0, 1, 1, 1, 0, 0, 1, 1, 1, 1]",261,110,151,12,14,0.10909090909090909,0.09271523178807947
"[0, 0, 0, 0, 0, 0, 0, 1, 0, 1, 0, 1, 1, 1, 0]",296,203,93,25,10,0.12315270935960591,0.10752688172043011
"[0, 1, 0, 0, 0, 0, 0, 0, 0, 1, 0, 0, 0, 1, 0]",1442,1093,349,103,34,0.09423604757548033,0.09742120343839542
"[0, 0, 0, 1, 1, 1, 0, 1, 1, 1, 1, 0, 1, 1, 0]",133,52,81,3,7,0.057692307692307696,0.08641975308641975
"[1, 0, 1, 1, 0, 0, 1, 1, 1, 0, 0, 1, 0, 0, 1]",135,55,80,5,3,0.09090909090909091,0.0375
"[1, 0, 1, 1, 0, 1, 1, 0, 0, 1, 1, 0, 0, 1, 1]",336,123,213,16,17,0.13008130081300814,0.07981220657276995
"[1, 0, 1, 0, 1, 0, 1, 1, 1, 0, 0, 1, 1, 1, 1]",356,133,223,13,20,0.09774436090225563,0.08968609865470852
"[1, 1, 0, 1, 0, 1, 1, 1, 1, 0, 0, 1, 1, 1, 1]",1036,315,721,29,75,0.09206349206349207,0.10402219140083217
"[0, 0, 1, 1, 0, 1, 1, 1, 1, 1, 0, 0, 0, 0, 1]",207,99,108,11,11,0.1111111111111111,0.10185185185185185
"[1, 0, 1, 1, 1, 0, 0, 1, 1, 1, 0, 0, 0, 1, 1]",198,88,110,9,8,0.10227272727272728,0.07272727272727272
"[0, 0, 0, 0, 0, 0, 1, 0, 0, 1, 0, 1, 1, 1, 0]",300,213,87,26,11,0.12206572769953052,0.12643678160919541
"[0, 1, 1, 0, 0, 0, 0, 1, 1, 0, 1, 1, 1, 0, 1]",160,101,59,8,3,0.07920792079207921,0.05084745762711865
"[1, 0, 0, 1, 1, 1, 1, 1, 1, 1, 0, 1, 0, 0, 0]",248,91,157,10,15,0.10989010989010989,0.09554140127388536
"[1, 0, 0, 0, 1, 0, 0, 1, 0, 1, 0, 1, 0, 0, 1]",117,68,49,6,4,0.08823529411764706,0.08163265306122448
"[1, 0, 0, 1, 1, 1, 1, 1, 1, 1, 0, 0, 0, 0, 0]",408,164,244,14,26,0.08536585365853659,0.10655737704918032
"[1, 1, 1, 0, 1, 0, 0, 0, 0, 1, 0, 0, 0, 1, 1]",149,69,80,5,9,0.07246376811594203,0.1125
"[0, 1, 1, 1, 1, 0, 0, 0, 0, 0, 1, 0, 0, 0, 1]",242,170,72,17,8,0.1,0.1111111111111111
"[0, 1, 0, 1, 0, 0, 0, 1, 1, 0, 1, 0, 1, 0, 0]",134,82,52,14,5,0.17073170731707318,0.09615384615384616
"[1, 1, 1, 1, 0, 0, 0, 0, 0, 1, 1, 1, 1, 1, 0]",243,97,146,5,10,0.05154639175257732,0.0684931506849315
"[1, 1, 0, 0, 1, 0, 0, 1, 0, 0, 0, 0, 0, 1, 1]",206,121,85,17,10,0.14049586776859505,0.11764705882352941
"[1, 0, 0, 0, 1, 1, 0, 0, 0, 1, 0, 0, 0, 1, 0]",229,154,75,13,4,0.08441558441558442,0.05333333333333334
"[1, 0, 0, 1, 1, 1, 0, 0, 1, 0, 0, 0, 1, 1, 1]",177,72,105,6,10,0.08333333333333333,0.09523809523809523
"[1, 0, 1, 1, 0, 0, 1, 1, 1, 1, 1, 0, 1, 1, 1]",644,172,472,15,37,0.0872093023255814,0.07838983050847458
"[0, 0, 1, 0, 0, 0, 1, 0, 1, 1, 1, 0, 0, 0, 1]",148,86,62,2,8,0.023255813953488372,0.12903225806451613
"[0, 1, 0, 1, 1, 1, 1, 0, 1, 0, 0, 0, 1, 1, 1]",174,80,94,6,15,0.075,0.1595744680851064
"[0, 1, 0, 1, 1, 0, 0, 0, 1, 0, 1, 1, 1, 0, 1]",100,42,58,2,9,0.047619047619047616,0.15517241379310345
"[1, 0, 0, 1, 0, 1, 0, 0, 1, 1, 1, 1, 1, 1, 0]",211,94,117,6,12,0.06382978723404255,0.10256410256410256
"[0, 1, 0, 0, 1, 1, 1, 1, 1, 1, 0, 1, 0, 0, 1]",155,67,88,9,12,0.13432835820895522,0.13636363636363635
"[1, 1, 1, 0, 0, 1, 0, 1, 0, 0, 0, 1, 1, 0, 0]",172,80,92,8,14,0.1,0.15217391304347827
"[0, 1, 0, 0, 1, 1, 1, 0, 0, 1, 0, 1, 0, 0, 0]",167,103,64,11,6,0.10679611650485436,0.09375
"[1, 1, 0, 0, 1, 0, 0, 1, 1, 1, 0, 0, 1, 0, 1]",118,70,48,9,2,0.12857142857142856,0.041666666666666664
"[0, 1, 0, 1, 0, 1, 1, 0, 0, 1, 1, 1, 1, 0, 1]",158,80,78,3,8,0.0375,0.10256410256410256
"[0, 1, 1, 1, 1, 1, 0, 0, 0, 1, 1, 0, 1, 0, 0]",126,62,64,6,6,0.0967741935483871,0.09375
"[1, 1, 1, 0, 0, 0, 0, 0, 0, 0, 1, 1, 0, 1, 1]",217,69,148,8,10,0.11594202898550725,0.06756756756756757
"[0, 1, 1, 0, 1, 0, 1, 1, 1, 0, 0, 1, 1, 1, 0]",155,64,91,4,8,0.0625,0.08791208791208792
"[1, 1, 0, 1, 0, 1, 0, 0, 1, 1, 1, 0, 0, 1, 1]",192,80,112,4,8,0.05,0.07142857142857142
"[0, 1, 1, 0, 0, 0, 1, 0, 0, 0, 1, 0, 1, 1, 1]",182,125,57,9,4,0.072,0.07017543859649122
"[0, 0, 0, 1, 0, 1, 1, 0, 0, 1, 0, 1, 1, 0, 0]",154,92,62,5,5,0.05434782608695652,0.08064516129032258
"[0, 1, 0, 1, 1, 0, 1, 0, 1, 0, 0, 0, 1, 1, 0]",119,68,51,10,4,0.14705882352941177,0.0784313725490196
"[0, 0, 1, 1, 1, 0, 1, 0, 0, 0, 0, 1, 0, 0, 1]",157,91,66,12,3,0.13186813186813187,0.045454545454545456
"[1, 0, 0, 0, 1, 1, 1, 1, 0, 1, 0, 1, 1, 0, 0]",133,61,72,7,6,0.11475409836065574,0.08333333333333333
"[0, 1, 0, 1, 0, 1, 1, 1, 1, 1, 0, 1, 0, 1, 0]",142,62,80,7,4,0.11290322580645161,0.05
"[1, 0, 1, 0, 0, 1, 1, 1, 1, 0, 0, 1, 0, 1, 1]",163,61,102,6,6,0.09836065573770492,0.058823529411764705
"[0, 0, 1, 0, 0, 0, 0, 0, 1, 1, 1, 0, 1, 1, 1]",149,77,72,5,6,0.06493506493506493,0.08333333333333333
"[1, 1, 1, 1, 0, 1, 1, 0, 0, 1, 0, 0, 0, 0, 0]",162,72,90,5,8,0.06944444444444445,0.08888888888888889
"[1, 0, 1, 0, 0, 0, 0, 0, 1, 0, 1, 0, 1, 0, 1]",129,87,42,9,5,0.10344827586206896,0.11904761904761904
"[0, 1, 1, 0, 0, 1, 1, 0, 0, 1, 1, 0, 0, 1, 0]",369,267,102,18,10,0.06741573033707865,0.09803921568627451
"[0, 1, 1, 1, 0, 0, 1, 0, 0, 1, 0, 0, 0, 1, 1]",136,84,52,6,0,0.07142857142857142,0.0
"[1, 1, 0, 1, 0, 1, 1, 0, 0, 0, 0, 1, 0, 0, 1]",120,58,62,6,8,0.10344827586206896,0.12903225806451613
"[1, 0, 0, 0, 0, 0, 1, 0, 1, 1, 0, 1, 0, 1, 1]",143,65,78,5,8,0.07692307692307693,0.10256410256410256
"[0, 1, 0, 0, 0, 0, 0, 1, 0, 1, 1, 0, 1, 0, 1]",117,71,46,5,2,0.07042253521126761,0.043478260869565216
"[1, 0, 1, 0, 0, 0, 1, 0, 1, 0, 0, 1, 0, 1, 1]",130,68,62,10,8,0.14705882352941177,0.12903225806451613
"[1, 0, 1, 1, 0, 1, 1, 1, 1, 0, 1, 0, 0, 0, 1]",142,61,81,4,11,0.06557377049180328,0.13580246913580246
"[1, 0, 1, 1, 0, 1, 1, 1, 1, 0, 0, 1, 1, 0, 1]",226,91,135,3,14,0.03296703296703297,0.1037037037037037
"[1, 0, 0, 1, 1, 1, 1, 1, 1, 1, 1, 0, 0, 1, 0]",576,126,450,17,42,0.1349206349206349,0.09333333333333334
"[1, 0, 0, 0, 1, 0, 0, 0, 0, 1, 0, 0, 0, 1, 0]",477,328,149,35,14,0.10670731707317073,0.09395973154362416
"[1, 0, 0, 1, 1, 0, 1, 0, 0, 0, 1, 1, 1, 0, 0]",119,61,58,7,4,0.11475409836065574,0.06896551724137931
"[0, 1, 0, 0, 0, 0, 1, 1, 1, 1, 0, 0, 0, 0, 1]",515,304,211,22,14,0.07236842105263158,0.06635071090047394
"[0, 0, 1, 1, 1, 1, 1, 0, 0, 1, 1, 0, 0, 0, 1]",169,80,89,14,8,0.175,0.0898876404494382
"[1, 1, 0, 0, 0, 0, 1, 0, 1, 1, 1, 0, 1, 1, 1]",213,85,128,13,20,0.15294117647058825,0.15625
"[0, 0, 0, 0, 0, 0, 1, 1, 0, 0, 1, 1, 1, 0, 1]",418,227,191,20,19,0.0881057268722467,0.09947643979057591
"[0, 1, 1, 1, 0, 1, 1, 0, 1, 1, 1, 1, 0, 0, 0]",195,79,116,10,10,0.12658227848101267,0.08620689655172414
"[0, 1, 1, 1, 1, 1, 0, 1, 0, 0, 1, 1, 0, 0, 0]",164,70,94,7,9,0.1,0.09574468085106383
"[0, 0, 1, 1, 1, 1, 1, 0, 1, 0, 0, 1, 1, 0, 0]",153,72,81,5,6,0.06944444444444445,0.07407407407407407
"[0, 1, 1, 1, 0, 1, 1, 0, 1, 1, 1, 0, 0, 0, 1]",160,73,87,5,6,0.0684931506849315,0.06896551724137931
"[1, 0, 0, 1, 0, 1, 0, 0, 1, 0, 1, 1, 0, 0, 0]",156,101,55,12,4,0.1188118811881188,0.07272727272727272
"[1, 1, 1, 0, 0, 1, 1, 1, 1, 0, 0, 0, 1, 0, 0]",205,66,139,6,10,0.09090909090909091,0.07194244604316546
"[0, 0, 0, 1, 0, 1, 0, 0, 0, 1, 1, 1, 0, 0, 1]",164,103,61,5,5,0.04854368932038835,0.08196721311475409
"[0, 0, 0, 1, 0, 1, 1, 1, 0, 1, 0, 1, 1, 1, 0]",101,50,51,4,3,0.08,0.058823529411764705
"[0, 0, 1, 1, 1, 0, 0, 0, 0, 0, 0, 0, 1, 1, 1]",408,260,148,25,17,0.09615384615384616,0.11486486486486487
"[1, 0, 1, 1, 1, 1, 1, 0, 0, 0, 1, 1, 1, 0, 0]",180,71,109,4,11,0.056338028169014086,0.10091743119266056
"[0, 1, 1, 1, 1, 0, 0, 0, 0, 1, 0, 1, 0, 0, 1]",203,132,71,5,6,0.03787878787878788,0.08450704225352113
"[1, 0, 0, 0, 1, 0, 1, 1, 0, 1, 1, 1, 0, 0, 0]",130,61,69,3,13,0.04918032786885246,0.18840579710144928
"[0, 1, 0, 0, 1, 0, 1, 1, 1, 0, 1, 0, 1, 1, 1]",151,58,93,7,5,0.1206896551724138,0.053763440860215055
"[0, 0, 1, 1, 0, 0, 1, 0, 0, 1, 0, 1, 1, 1, 0]",118,62,56,6,7,0.0967741935483871,0.125
"[0, 0, 1, 1, 0, 1, 0, 0, 1, 1, 0, 1, 0, 1, 1]",97,43,54,4,4,0.09302325581395349,0.07407407407407407
"[1, 1, 0, 1, 0, 1, 0, 1, 1, 0, 0, 1, 0, 1, 1]",130,48,82,8,9,0.16666666666666666,0.10975609756097561
"[1, 1, 0, 0, 1, 0, 0, 1, 1, 1, 0, 1, 1, 0, 1]",147,62,85,3,7,0.04838709677419355,0.08235294117647059
"[0, 1, 0, 1, 0, 0, 1, 0, 1, 1, 1, 0, 0, 0, 0]",174,108,66,8,11,0.07407407407407407,0.16666666666666666
"[1, 0, 1, 1, 1, 1, 0, 1, 0, 0, 1, 0, 1, 1, 0]",142,64,78,10,10,0.15625,0.1282051282051282
"[0, 0, 1, 0, 1, 0, 1, 0, 0, 1, 0, 1, 1, 1, 0]",94,48,46,1,4,0.020833333333333332,0.08695652173913043
"[0, 0, 1, 1, 0, 0, 1, 1, 1, 0, 1, 0, 0, 1, 1]",229,104,125,12,6,0.11538461538461539,0.048
"[1, 1, 0, 0, 1, 0, 1, 0, 1, 0, 0, 0, 0, 0, 0]",325,218,107,28,8,0.12844036697247707,0.07476635514018691
"[0, 1, 0, 0, 1, 0, 1, 0, 1, 1, 0, 0, 0, 0, 1]",189,117,72,11,9,0.09401709401709402,0.125
"[0, 0, 1, 1, 1, 1, 0, 1, 0, 1, 0, 0, 1, 0, 1]",114,52,62,4,3,0.07692307692307693,0.04838709677419355
"[1, 1, 0, 1, 0, 1, 0, 0, 0, 1, 1, 1, 0, 1, 0]",89,41,48,4,3,0.0975609756097561,0.0625
"[0, 0, 0, 0, 1, 0, 1, 0, 1, 1, 1, 1, 1, 1, 1]",277,124,153,15,11,0.12096774193548387,0.0718954248366013
"[1, 0, 0, 0, 1, 1, 1, 0, 0, 0, 1, 0, 1, 0, 1]",103,50,53,4,3,0.08,0.05660377358490566
"[1, 1, 1, 1, 0, 1, 0, 0, 0, 0, 0, 0, 1, 0, 0]",158,88,70,10,8,0.11363636363636363,0.11428571428571428
"[0, 0, 1, 1, 0, 1, 0, 0, 0, 1, 0, 0, 1, 0, 1]",128,80,48,9,4,0.1125,0.08333333333333333
"[1, 1, 0, 0, 1, 1, 0, 0, 1, 1, 0, 1, 0, 1, 0]",200,98,102,6,11,0.061224489795918366,0.10784313725490197
"[0, 0, 1, 1, 1, 0, 0, 1, 1, 0, 1, 0, 0, 0, 1]",97,45,52,5,7,0.1111111111111111,0.1346153846153846
"[1, 1, 1, 0, 1, 1, 1, 1, 0, 1, 0, 1, 0, 1, 0]",248,77,171,11,17,0.14285714285714285,0.09941520467836257
"[1, 0, 1, 1, 0, 0, 1, 0, 1, 1, 1, 0, 1, 1, 0]",141,62,79,4,4,0.06451612903225806,0.05063291139240506
"[0, 0, 0, 1, 1, 0, 0, 1, 1, 0, 0, 1, 0, 1, 1]",312,247,65,21,7,0.08502024291497975,0.1076923076923077
"[0, 1, 0, 1, 1, 1, 0, 1, 1, 1, 1, 0, 0, 0, 0]",197,92,105,9,11,0.09782608695652174,0.10476190476190476
"[0, 0, 1, 0, 0, 0, 1, 1, 0, 0, 1, 0, 1, 0, 1]",138,85,53,6,1,0.07058823529411765,0.018867924528301886
"[1, 0, 0, 1, 0, 0, 1, 0, 1, 0, 0, 0, 1, 1, 0]",146,92,54,10,6,0.10869565217391304,0.1111111111111111
"[0, 1, 1, 0, 1, 0, 0, 1, 0, 0, 1, 0, 1, 0, 0]",147,92,55,6,4,0.06521739130434782,0.07272727272727272
"[0, 1, 1, 0, 1, 1, 0, 0, 0, 0, 0, 0, 1, 0, 1]",151,90,61,4,4,0.044444444444444446,0.06557377049180328
"[0, 0, 1, 1, 1, 1, 0, 1, 1, 0, 1, 1, 0, 0, 0]",151,77,74,9,8,0.11688311688311688,0.10810810810810811
"[1, 0, 0, 0, 0, 1, 1, 1, 0, 0, 0, 0, 0, 1, 0]",283,157,126,19,12,0.12101910828025478,0.09523809523809523
"[1, 0, 0, 1, 1, 0, 1, 1, 0, 1, 1, 0, 0, 0, 0]",181,84,97,5,10,0.05952380952380952,0.10309278350515463
"[0, 1, 0, 0, 1, 1, 0, 1, 1, 0, 1, 1, 0, 0, 0]",134,74,60,7,5,0.0945945945945946,0.08333333333333333
"[1, 0, 0, 1, 0, 1, 1, 0, 0, 1, 0, 0, 1, 1, 0]",113,55,58,7,5,0.12727272727272726,0.08620689655172414
"[0, 0, 1, 1, 0, 1, 1, 0, 0, 0, 0, 1, 1, 0, 1]",132,70,62,4,4,0.05714285714285714,0.06451612903225806
"[0, 0, 1, 0, 0, 1, 1, 0, 0, 1, 1, 1, 0, 0, 0]",202,121,81,10,9,0.08264462809917356,0.1111111111111111
"[0, 1, 1, 1, 0, 0, 1, 0, 1, 1, 1, 1, 1, 0, 0]",197,84,113,6,13,0.07142857142857142,0.11504424778761062
"[0, 1, 1, 1, 1, 0, 1, 0, 1, 0, 1, 1, 1, 0, 0]",156,62,94,3,10,0.04838709677419355,0.10638297872340426
"[0, 1, 1, 1, 0, 1, 1, 1, 1, 0, 0, 0, 1, 0, 0]",111,58,53,6,7,0.10344827586206896,0.1320754716981132
"[0, 0, 1, 0, 1, 1, 1, 0, 1, 1, 0, 1, 1, 1, 0]",153,63,90,4,7,0.06349206349206349,0.07777777777777778
"[1, 0, 0, 1, 0, 1, 0, 1, 1, 1, 0, 0, 1, 1, 1]",203,75,128,3,14,0.04,0.109375
"[1, 1, 1, 0, 0, 1, 1, 0, 1, 1, 1, 0, 0, 0, 1]",206,83,123,5,15,0.060240963855421686,0.12195121951219512
"[0, 0, 1, 0, 1, 0, 0, 0, 1, 1, 1, 1, 0, 0, 1]",185,104,81,9,9,0.08653846153846154,0.1111111111111111
"[1, 1, 0, 1, 0, 0, 0, 1, 1, 0, 1, 0, 1, 1, 0]",117,45,72,3,9,0.06666666666666667,0.125
"[0, 1, 0, 1, 1, 0, 0, 0, 1, 1, 0, 1, 1, 1, 1]",175,69,106,6,11,0.08695652173913043,0.10377358490566038
"[1, 1, 1, 1, 0, 1, 1, 1, 0, 1, 1, 0, 0, 1, 1]",705,187,518,17,49,0.09090909090909091,0.0945945945945946
"[1, 0, 0, 1, 0, 1, 0, 0, 1, 0, 0, 1, 1, 1, 1]",168,67,101,6,9,0.08955223880597014,0.0891089108910891
"[0, 0, 1, 0, 0, 0, 1, 0, 1, 1, 1, 1, 1, 1, 1]",252,104,148,7,15,0.0673076923076923,0.10135135135135136
"[1, 1, 0, 1, 0, 1, 1, 1, 0, 0, 1, 1, 0, 0, 1]",278,106,172,13,12,0.12264150943396226,0.06976744186046512
"[0, 1, 1, 1, 0, 0, 1, 1, 1, 1, 1, 0, 1, 1, 0]",241,96,145,10,16,0.10416666666666667,0.1103448275862069
"[0, 1, 0, 0, 1, 1, 0, 0, 1, 0, 1, 0, 0, 0, 0]",263,183,80,15,7,0.08196721311475409,0.0875
"[1, 1, 0, 0, 1, 0, 1, 0, 0, 1, 1, 1, 0, 1, 0]",123,64,59,8,3,0.125,0.05084745762711865
"[1, 0, 1, 1, 1, 1, 1, 0, 0, 1, 1, 1, 0, 1, 1]",569,166,403,18,34,0.10843373493975904,0.08436724565756824
"[0, 0, 0, 1, 1, 1, 1, 0, 1, 1, 0, 1, 1, 0, 1]",156,77,79,9,6,0.11688311688311688,0.0759493670886076
"[1, 1, 1, 1, 1, 1, 0, 1, 1, 1, 0, 1, 0, 0, 0]",313,113,200,8,21,0.07079646017699115,0.105
"[0, 1, 1, 1, 1, 1, 1, 0, 1, 1, 1, 0, 1, 0, 0]",266,109,157,11,16,0.10091743119266056,0.10191082802547771
"[0, 1, 1, 0, 0, 0, 0, 0, 1, 1, 0, 1, 1, 1, 0]",122,78,44,5,6,0.0641025641025641,0.13636363636363635
"[0, 1, 0, 1, 1, 0, 0, 1, 1, 1, 1, 1, 1, 0, 0]",441,188,253,17,19,0.09042553191489362,0.07509881422924901
"[0, 1, 0, 1, 0, 1, 0, 1, 0, 1, 1, 0, 0, 1, 1]",149,78,71,2,5,0.02564102564102564,0.07042253521126761
"[1, 0, 1, 0, 0, 1, 0, 0, 0, 1, 0, 1, 0, 1, 0]",120,69,51,4,3,0.057971014492753624,0.058823529411764705
"[0, 1, 1, 1, 1, 1, 1, 0, 1, 0, 1, 0, 1, 0, 1]",254,99,155,9,17,0.09090909090909091,0.10967741935483871
"[0, 1, 1, 1, 1, 1, 1, 1, 1, 0, 1, 1, 0, 0, 1]",712,286,426,27,41,0.0944055944055944,0.09624413145539906
"[1, 0, 0, 1, 1, 1, 1, 1, 1, 0, 1, 0, 0, 0, 1]",195,77,118,8,10,0.1038961038961039,0.0847457627118644
"[1, 1, 1, 1, 0, 0, 0, 1, 0, 0, 0, 0, 0, 0, 0]",444,278,166,36,13,0.12949640287769784,0.0783132530120482
"[1, 1, 0, 0, 1, 1, 1, 1, 1, 0, 0, 0, 1, 1, 1]",500,175,325,19,26,0.10857142857142857,0.08
"[1, 1, 0, 1, 1, 0, 0, 1, 0, 1, 0, 1, 1, 1, 1]",303,116,187,9,27,0.07758620689655173,0.1443850267379679
"[0, 0, 1, 0, 0, 0, 0, 0, 1, 0, 0, 1, 0, 1, 1]",277,194,83,18,6,0.09278350515463918,0.07228915662650602
"[0, 0, 1, 1, 0, 1, 1, 0, 0, 1, 0, 0, 0, 1, 1]",146,85,61,6,3,0.07058823529411765,0.04918032786885246
"[0, 1, 1, 0, 0, 1, 0, 1, 0, 1, 0, 1, 0, 1, 1]",104,48,56,5,2,0.10416666666666667,0.03571428571428571
"[1, 1, 0, 0, 1, 0, 1, 1, 0, 0, 1, 1, 1, 0, 0]",122,51,71,5,5,0.09803921568627451,0.07042253521126761
"[0, 1, 0, 1, 0, 0, 1, 1, 1, 1, 0, 1, 0, 1, 1]",148,60,88,10,11,0.16666666666666666,0.125
"[0, 1, 0, 0, 0, 1, 0, 1, 0, 0, 0, 1, 1, 1, 1]",165,93,72,7,5,0.07526881720430108,0.06944444444444445
"[1, 1, 1, 1, 0, 0, 1, 1, 0, 0, 1, 1, 0, 1, 0]",347,137,210,16,21,0.11678832116788321,0.1
"[0, 0, 1, 0, 0, 1, 1, 1, 0, 1, 0, 0, 1, 0, 1]",119,68,51,5,4,0.07352941176470588,0.0784313725490196
"[1, 1, 0, 0, 0, 0, 0, 0, 1, 0, 0, 1, 1, 1, 0]",218,122,96,9,9,0.07377049180327869,0.09375
"[1, 0, 0, 1, 1, 0, 0, 1, 1, 0, 0, 1, 1, 0, 1]",351,95,256,6,21,0.06315789473684211,0.08203125
"[1, 1, 0, 1, 1, 1, 0, 0, 0, 0, 1, 1, 1, 1, 0]",316,125,191,12,12,0.096,0.06282722513089005
"[1, 1, 1, 1, 1, 1, 0, 1, 0, 0, 0, 0, 1, 1, 0]",227,82,145,4,12,0.04878048780487805,0.08275862068965517
"[1, 0, 0, 1, 1, 0, 0, 0, 0, 1, 0, 0, 1, 0, 0]",354,194,160,14,12,0.07216494845360824,0.075
"[0, 0, 1, 0, 0, 1, 1, 0, 0, 0, 0, 1, 0, 0, 1]",299,191,108,12,12,0.06282722513089005,0.1111111111111111
"[1, 0, 0, 0, 0, 0, 0, 1, 1, 0, 0, 1, 0, 0, 1]",421,176,245,17,22,0.09659090909090909,0.08979591836734693
"[0, 0, 1, 1, 0, 1, 1, 0, 1, 1, 0, 0, 1, 0, 0]",92,45,47,3,1,0.06666666666666667,0.02127659574468085
"[0, 1, 0, 0, 1, 1, 0, 1, 1, 0, 1, 1, 0, 0, 1]",128,62,66,3,9,0.04838709677419355,0.13636363636363635
"[0, 1, 0, 1, 0, 0, 1, 1, 0, 1, 1, 0, 1, 1, 0]",99,46,53,4,6,0.08695652173913043,0.11320754716981132
"[0, 0, 1, 1, 1, 0, 0, 1, 1, 0, 1, 1, 0, 0, 1]",138,61,77,5,9,0.08196721311475409,0.11688311688311688
"[0, 0, 0, 0, 1, 1, 1, 1, 1, 0, 1, 0, 1, 1, 1]",331,137,194,17,21,0.12408759124087591,0.10824742268041238
"[0, 1, 0, 1, 1, 1, 0, 0, 0, 0, 1, 1, 0, 0, 1]",286,137,149,10,14,0.072992700729927,0.09395973154362416
"[0, 1, 1, 1, 1, 1, 0, 1, 1, 1, 0, 1, 0, 0, 0]",177,86,91,12,10,0.13953488372093023,0.10989010989010989
"[0, 0, 0, 0, 0, 1, 0, 0, 1, 0, 1, 0, 0, 1, 1]",323,226,97,20,9,0.08849557522123894,0.09278350515463918
"[0, 0, 1, 0, 1, 1, 1, 1, 1, 0, 1, 0, 0, 0, 0]",122,72,50,5,2,0.06944444444444445,0.04
"[1, 0, 0, 0, 1, 0, 1, 1, 1, 1, 1, 0, 1, 0, 0]",122,50,72,5,11,0.1,0.1527777777777778
"[1, 0, 0, 1, 1, 1, 0, 1, 1, 0, 0, 1, 1, 0, 1]",140,44,96,4,18,0.09090909090909091,0.1875
"[0, 1, 1, 1, 1, 1, 1, 0, 0, 0, 1, 1, 1, 0, 1]",320,163,157,14,13,0.08588957055214724,0.08280254777070063
"[1, 1, 0, 1, 0, 0, 1, 0, 1, 1, 0, 0, 1, 1, 1]",227,93,134,9,15,0.0967741935483871,0.11194029850746269
"[1, 1, 1, 0, 0, 0, 1, 1, 1, 0, 1, 0, 0, 1, 1]",181,71,110,12,7,0.16901408450704225,0.06363636363636363
"[1, 0, 1, 1, 1, 1, 0, 0, 0, 0, 0, 1, 1, 0, 1]",137,63,74,6,6,0.09523809523809523,0.08108108108108109
"[1, 0, 0, 1, 1, 1, 0, 1, 1, 1, 1, 0, 0, 0, 0]",251,115,136,12,11,0.10434782608695652,0.08088235294117647
"[1, 0, 1, 0, 0, 1, 0, 1, 1, 0, 0, 1, 1, 0, 0]",181,98,83,3,8,0.030612244897959183,0.0963855421686747
"[0, 1, 0, 1, 1, 0, 1, 1, 1, 0, 0, 0, 1, 0, 1]",106,46,60,8,5,0.17391304347826086,0.08333333333333333
"[0, 0, 1, 0, 1, 1, 0, 1, 1, 1, 0, 0, 0, 1, 0]",100,50,50,6,2,0.12,0.04
"[0, 1, 0, 0, 0, 1, 0, 1, 1, 0, 1, 1, 1, 0, 0]",112,65,47,6,6,0.09230769230769231,0.1276595744680851
"[1, 0, 0, 1, 0, 1, 0, 1, 0, 1, 1, 0, 0, 0, 0]",186,102,84,8,11,0.0784313725490196,0.13095238095238096
"[0, 0, 1, 1, 1, 0, 1, 1, 0, 1, 1, 0, 0, 1, 1]",213,95,118,9,10,0.09473684210526316,0.0847457627118644
"[0, 0, 0, 1, 1, 1, 0, 1, 1, 0, 1, 1, 0, 0, 1]",150,63,87,6,9,0.09523809523809523,0.10344827586206896
"[1, 0, 0, 0, 1, 1, 1, 0, 1, 1, 0, 1, 1, 0, 0]",137,70,67,1,4,0.014285714285714285,0.05970149253731343
"[0, 1, 1, 1, 1, 0, 1, 1, 0, 0, 1, 0, 0, 1, 1]",188,79,109,5,10,0.06329113924050633,0.09174311926605505
"[1, 1, 1, 1, 0, 0, 0, 0, 0, 0, 0, 1, 0, 1, 1]",329,181,148,15,13,0.08287292817679558,0.08783783783783784
"[1, 0, 1, 0, 0, 0, 0, 0, 0, 1, 0, 0, 0, 0, 1]",563,394,169,39,16,0.09898477157360407,0.09467455621301775
"[1, 0, 1, 0, 0, 1, 0, 0, 1, 0, 1, 1, 0, 0, 1]",129,65,64,6,5,0.09230769230769231,0.078125
"[1, 0, 1, 1, 1, 0, 1, 0, 0, 1, 0, 0, 1, 0, 1]",104,49,55,3,4,0.061224489795918366,0.07272727272727272
"[1, 0, 0, 0, 1, 1, 0, 1, 1, 1, 0, 1, 0, 0, 1]",122,52,70,5,6,0.09615384615384616,0.08571428571428572
"[0, 0, 1, 0, 0, 1, 1, 1, 1, 0, 1, 0, 1, 0, 1]",116,56,60,7,6,0.125,0.1
"[1, 1, 1, 1, 0, 0, 0, 1, 0, 1, 1, 0, 1, 1, 0]",171,64,107,4,9,0.0625,0.08411214953271028
"[1, 0, 1, 1, 0, 0, 0, 0, 1, 0, 1, 0, 0, 1, 1]",126,77,49,11,5,0.14285714285714285,0.10204081632653061
"[1, 1, 1, 0, 1, 1, 0, 0, 0, 0, 1, 0, 1, 0, 0]",122,67,55,4,11,0.05970149253731343,0.2
"[0, 1, 1, 1, 1, 1, 1, 1, 1, 0, 1, 1, 0, 0, 0]",387,200,187,13,18,0.065,0.0962566844919786
"[1, 1, 1, 1, 1, 0, 0, 1, 0, 1, 0, 1, 1, 0, 0]",165,60,105,7,9,0.11666666666666667,0.08571428571428572
"[0, 0, 0, 1, 0, 1, 0, 0, 1, 1, 1, 1, 1, 0, 0]",150,94,56,10,6,0.10638297872340426,0.10714285714285714
"[0, 0, 1, 0, 1, 1, 1, 0, 1, 1, 1, 1, 1, 1, 0]",278,109,169,9,20,0.08256880733944955,0.11834319526627218
"[1, 1, 0, 1, 1, 1, 0, 1, 0, 1, 1, 0, 1, 1, 0]",211,81,130,7,10,0.08641975308641975,0.07692307692307693
"[0, 1, 1, 1, 1, 1, 0, 1, 0, 0, 1, 1, 1, 1, 0]",314,122,192,15,14,0.12295081967213115,0.07291666666666667
"[1, 1, 0, 1, 0, 1, 0, 0, 1, 0, 1, 1, 1, 1, 1]",301,108,193,14,15,0.12962962962962962,0.07772020725388601
"[0, 0, 0, 0, 1, 0, 0, 0, 1, 1, 1, 1, 0, 0, 0]",495,345,150,20,9,0.057971014492753624,0.06
"[0, 1, 1, 0, 1, 0, 0, 0, 0, 1, 0, 0, 1, 0, 1]",146,79,67,12,11,0.1518987341772152,0.16417910447761194
"[1, 1, 1, 0, 0, 0, 1, 0, 1, 0, 0, 0, 1, 0, 1]",119,69,50,9,3,0.13043478260869565,0.06
"[1, 1, 1, 1, 1, 1, 1, 0, 1, 1, 0, 0, 0, 0, 0]",329,111,218,12,20,0.10810810810810811,0.09174311926605505
"[1, 1, 1, 1, 0, 1, 1, 1, 1, 0, 0, 1, 0, 0, 0]",193,69,124,9,11,0.13043478260869565,0.08870967741935484
"[1, 0, 0, 1, 0, 0, 0, 0, 0, 1, 0, 1, 0, 1, 1]",151,95,56,8,3,0.08421052631578947,0.05357142857142857
"[1, 0, 0, 1, 0, 1, 1, 1, 0, 1, 0, 1, 1, 0, 0]",130,55,75,3,7,0.05454545454545454,0.09333333333333334
"[0, 0, 0, 0, 0, 1, 1, 1, 1, 0, 1, 1, 0, 0, 1]",215,142,73,10,5,0.07042253521126761,0.0684931506849315
"[0, 0, 1, 1, 1, 0, 1, 0, 1, 1, 0, 0, 0, 1, 1]",144,67,77,9,11,0.13432835820895522,0.14285714285714285
"[1, 1, 1, 0, 0, 0, 1, 0, 1, 1, 1, 0, 0, 0, 0]",169,79,90,6,4,0.0759493670886076,0.044444444444444446
"[0, 0, 0, 1, 1, 0, 1, 1, 0, 1, 0, 0, 0, 0, 1]",192,115,77,9,14,0.0782608695652174,0.18181818181818182
"[1, 1, 0, 1, 1, 0, 1, 0, 0, 1, 1, 0, 1, 1, 1]",271,83,188,6,21,0.07228915662650602,0.11170212765957446
"[1, 0, 0, 1, 1, 1, 0, 0, 1, 0, 0, 1, 0, 0, 0]",138,79,59,2,9,0.02531645569620253,0.15254237288135594
"[0, 0, 1, 1, 0, 1, 1, 0, 0, 1, 1, 0, 1, 1, 0]",120,59,61,8,4,0.13559322033898305,0.06557377049180328
"[0, 1, 1, 1, 0, 0, 1, 1, 1, 0, 0, 1, 1, 1, 0]",155,64,91,4,11,0.0625,0.12087912087912088
"[1, 0, 0, 0, 0, 1, 1, 1, 0, 1, 1, 0, 1, 1, 0]",118,46,72,5,6,0.10869565217391304,0.08333333333333333
"[1, 0, 1, 0, 0, 0, 0, 1, 1, 1, 0, 1, 1, 0, 1]",96,50,46,5,7,0.1,0.15217391304347827
"[1, 0, 1, 1, 0, 1, 1, 0, 1, 0, 1, 0, 0, 1, 0]",119,55,64,6,8,0.10909090909090909,0.125
"[0, 1, 0, 1, 1, 1, 0, 1, 1, 0, 1, 1, 0, 1, 0]",137,49,88,6,4,0.12244897959183673,0.045454545454545456
"[1, 0, 1, 0, 1, 1, 0, 0, 1, 0, 1, 1, 0, 1, 0]",100,50,50,5,5,0.1,0.1
"[1, 1, 1, 1, 1, 1, 1, 0, 1, 0, 0, 1, 1, 0, 1]",570,142,428,18,35,0.1267605633802817,0.08177570093457943
"[0, 1, 1, 1, 1, 0, 0, 1, 0, 0, 0, 0, 0, 1, 1]",218,131,87,9,6,0.06870229007633588,0.06896551724137931
"[0, 1, 1, 1, 1, 0, 1, 0, 0, 1, 0, 0, 1, 0, 1]",117,69,48,4,4,0.057971014492753624,0.08333333333333333
"[0, 1, 1, 0, 0, 0, 0, 1, 0, 0, 1, 0, 0, 1, 0]",272,194,78,21,16,0.10824742268041238,0.20512820512820512
"[0, 0, 0, 1, 0, 0, 1, 1, 1, 1, 0, 0, 1, 1, 0]",350,206,144,16,13,0.07766990291262135,0.09027777777777778
"[0, 0, 0, 0, 1, 0, 0, 1, 1, 1, 1, 0, 0, 1, 1]",358,198,160,23,18,0.11616161616161616,0.1125
"[1, 0, 1, 0, 0, 0, 0, 0, 0, 1, 0, 0, 1, 1, 1]",237,138,99,14,10,0.10144927536231885,0.10101010101010101
"[1, 1, 1, 0, 0, 1, 0, 1, 0, 0, 1, 0, 1, 0, 1]",111,48,63,4,8,0.08333333333333333,0.12698412698412698
"[1, 0, 1, 0, 0, 1, 0, 1, 0, 1, 1, 0, 1, 0, 0]",83,39,44,3,3,0.07692307692307693,0.06818181818181818
"[1, 1, 0, 1, 1, 0, 1, 1, 0, 0, 1, 0, 1, 0, 1]",131,57,74,2,6,0.03508771929824561,0.08108108108108109
"[0, 1, 1, 1, 0, 1, 1, 0, 1, 1, 0, 0, 1, 0, 1]",124,56,68,3,8,0.05357142857142857,0.11764705882352941
"[1, 1, 0, 0, 0, 1, 1, 1, 1, 0, 1, 1, 1, 0, 0]",180,70,110,11,11,0.15714285714285714,0.1
"[0, 0, 1, 1, 0, 0, 0, 1, 0, 1, 1, 0, 1, 1, 1]",169,82,87,13,11,0.15853658536585366,0.12643678160919541
"[0, 1, 0, 1, 0, 0, 1, 0, 0, 0, 1, 0, 1, 1, 1]",145,81,64,8,8,0.09876543209876543,0.125
"[1, 1, 0, 1, 0, 0, 0, 1, 1, 1, 1, 1, 0, 0, 1]",202,82,120,11,13,0.13414634146341464,0.10833333333333334
"[0, 0, 1, 1, 0, 0, 0, 1, 1, 1, 0, 0, 0, 0, 0]",386,255,131,27,7,0.10588235294117647,0.05343511450381679
"[0, 1, 0, 0, 1, 1, 0, 1, 1, 1, 1, 1, 0, 1, 0]",133,56,77,6,5,0.10714285714285714,0.06493506493506493
"[1, 0, 0, 0, 0, 0, 1, 0, 1, 0, 0, 1, 1, 0, 1]",141,77,64,9,4,0.11688311688311688,0.0625
"[0, 1, 1, 0, 0, 0, 0, 1, 1, 1, 0, 0, 0, 1, 0]",188,129,59,10,0,0.07751937984496124,0.0
"[0, 0, 1, 0, 1, 0, 1, 1, 1, 1, 0, 0, 0, 0, 0]",278,177,101,20,12,0.11299435028248588,0.1188118811881188
"[1, 1, 0, 0, 1, 1, 1, 0, 0, 0, 1, 0, 0, 1, 0]",107,49,58,4,4,0.08163265306122448,0.06896551724137931
"[0, 1, 0, 0, 1, 0, 0, 0, 0, 0, 1, 1, 0, 1, 0]",248,162,86,17,5,0.10493827160493827,0.05813953488372093
"[0, 0, 1, 1, 0, 0, 1, 0, 0, 1, 1, 0, 1, 1, 0]",127,81,46,11,7,0.13580246913580246,0.15217391304347827
"[1, 0, 0, 0, 1, 1, 0, 0, 1, 0, 0, 1, 1, 0, 1]",118,50,68,4,7,0.08,0.10294117647058823
"[0, 1, 1, 1, 1, 1, 0, 0, 1, 0, 0, 0, 1, 1, 1]",206,112,94,10,12,0.08928571428571429,0.1276595744680851
"[1, 0, 0, 1, 1, 0, 0, 1, 0, 0, 1, 1, 1, 1, 1]",309,93,216,8,18,0.08602150537634409,0.08333333333333333
"[0, 1, 0, 0, 1, 1, 0, 1, 0, 0, 1, 1, 0, 1, 1]",91,44,47,5,7,0.11363636363636363,0.14893617021276595
"[0, 0, 1, 1, 1, 0, 1, 0, 1, 1, 0, 1, 1, 0, 0]",131,62,69,2,7,0.03225806451612903,0.10144927536231885
"[1, 1, 0, 0, 1, 0, 0, 1, 1, 1, 1, 1, 1, 0, 1]",297,118,179,17,10,0.1440677966101695,0.055865921787709494
"[1, 1, 1, 1, 0, 1, 0, 0, 0, 1, 0, 0, 0, 0, 0]",208,112,96,8,5,0.07142857142857142,0.052083333333333336
"[0, 0, 1, 1, 1, 1, 0, 1, 0, 0, 0, 1, 0, 0, 0]",179,109,70,9,5,0.08256880733944955,0.07142857142857142
"[1, 1, 0, 1, 1, 1, 0, 1, 1, 1, 1, 0, 0, 1, 0]",237,79,158,3,14,0.0379746835443038,0.08860759493670886
"[1, 1, 1, 1, 0, 0, 0, 0, 1, 0, 0, 1, 1, 1, 1]",387,150,237,17,21,0.11333333333333333,0.08860759493670886
"[1, 1, 0, 1, 1, 0, 1, 1, 0, 1, 1, 0, 0, 0, 1]",153,51,102,7,12,0.13725490196078433,0.11764705882352941
"[0, 0, 1, 0, 1, 0, 1, 1, 0, 0, 1, 0, 0, 0, 0]",260,173,87,15,11,0.08670520231213873,0.12643678160919541
"[1, 1, 1, 0, 0, 0, 0, 1, 0, 1, 0, 1, 1, 0, 0]",162,77,85,11,10,0.14285714285714285,0.11764705882352941
"[0, 0, 1, 0, 1, 0, 0, 0, 0, 1, 0, 1, 1, 0, 1]",122,78,44,8,4,0.10256410256410256,0.09090909090909091
"[1, 1, 0, 0, 0, 1, 0, 0, 1, 1, 1, 0, 0, 0, 0]",188,104,84,12,11,0.11538461538461539,0.13095238095238096
"[1, 1, 1, 1, 1, 0, 1, 1, 1, 0, 1, 1, 0, 0, 0]",324,95,229,5,21,0.05263157894736842,0.09170305676855896
"[0, 1, 0, 1, 0, 1, 1, 0, 0, 1, 1, 0, 0, 0, 0]",290,185,105,25,7,0.13513513513513514,0.06666666666666667
"[0, 0, 1, 0, 0, 0, 1, 1, 0, 0, 0, 1, 1, 1, 0]",167,88,79,7,11,0.07954545454545454,0.13924050632911392
"[0, 0, 1, 1, 0, 0, 0, 0, 1, 1, 0, 0, 1, 0, 1]",395,218,177,22,19,0.10091743119266056,0.10734463276836158
"[1, 0, 0, 0, 0, 1, 0, 1, 1, 0, 0, 1, 1, 1, 0]",132,72,60,8,4,0.1111111111111111,0.06666666666666667
"[1, 1, 1, 0, 1, 1, 0, 0, 0, 1, 0, 1, 1, 0, 1]",141,46,95,4,4,0.08695652173913043,0.042105263157894736
"[0, 0, 0, 0, 0, 0, 1, 0, 1, 0, 1, 1, 1, 1, 1]",289,181,108,22,8,0.12154696132596685,0.07407407407407407
"[1, 1, 0, 1, 0, 1, 0, 1, 1, 0, 0, 1, 0, 0, 1]",123,58,65,5,8,0.08620689655172414,0.12307692307692308
"[0, 0, 0, 1, 1, 1, 0, 0, 0, 0, 0, 1, 1, 1, 1]",337,208,129,17,14,0.08173076923076923,0.10852713178294573
"[0, 1, 1, 0, 0, 1, 0, 1, 0, 0, 0, 1, 0, 1, 1]",123,76,47,7,3,0.09210526315789473,0.06382978723404255
"[0, 1, 0, 0, 1, 0, 1, 0, 0, 0, 0, 0, 0, 1, 0]",507,357,150,27,10,0.07563025210084033,0.06666666666666667
"[0, 0, 1, 1, 1, 0, 1, 0, 0, 0, 1, 0, 1, 1, 1]",173,74,99,5,11,0.06756756756756757,0.1111111111111111
"[0, 0, 0, 0, 1, 0, 0, 1, 1, 1, 0, 0, 1, 1, 1]",238,133,105,12,8,0.09022556390977443,0.0761904761904762
"[1, 0, 0, 1, 0, 1, 0, 0, 0, 0, 0, 1, 0, 1, 1]",171,98,73,7,9,0.07142857142857142,0.1232876712328767
"[1, 0, 1, 1, 0, 0, 1, 0, 1, 0, 0, 0, 0, 0, 1]",168,104,64,13,7,0.125,0.109375
"[1, 0, 1, 1, 0, 0, 1, 1, 0, 0, 1, 1, 1, 0, 1]",204,79,125,8,8,0.10126582278481013,0.064
"[0, 1, 1, 1, 0, 1, 1, 0, 0, 0, 0, 0, 1, 0, 0]",137,83,54,6,4,0.07228915662650602,0.07407407407407407
"[0, 1, 0, 1, 0, 0, 0, 0, 0, 1, 1, 0, 1, 1, 0]",126,79,47,9,5,0.11392405063291139,0.10638297872340426
"[1, 0, 0, 1, 0, 0, 1, 0, 0, 1, 0, 1, 0, 0, 1]",138,83,55,6,5,0.07228915662650602,0.09090909090909091
"[0, 1, 0, 0, 0, 1, 1, 1, 0, 1, 0, 0, 0, 0, 0]",240,148,92,14,8,0.0945945945945946,0.08695652173913043
"[0, 1, 1, 0, 1, 0, 0, 0, 1, 0, 0, 0, 1, 0, 1]",151,79,72,3,8,0.0379746835443038,0.1111111111111111
"[1, 1, 0, 1, 1, 0, 1, 0, 0, 0, 1, 0, 0, 0, 1]",116,52,64,7,5,0.1346153846153846,0.078125
"[1, 0, 0, 0, 0, 0, 1, 0, 1, 0, 1, 0, 1, 1, 0]",133,73,60,5,3,0.0684931506849315,0.05
"[0, 1, 0, 1, 0, 1, 0, 0, 0, 0, 0, 1, 1, 1, 1]",219,123,96,12,7,0.0975609756097561,0.07291666666666667
"[1, 0, 0, 1, 0, 1, 0, 1, 0, 0, 0, 0, 0, 1, 1]",221,120,101,11,6,0.09166666666666666,0.0594059405940594
"[0, 1, 1, 1, 1, 1, 1, 1, 0, 0, 0, 1, 1, 1, 0]",252,96,156,10,13,0.10416666666666667,0.08333333333333333
"[1, 0, 0, 0, 1, 1, 1, 1, 1, 1, 0, 0, 0, 0, 1]",460,192,268,19,19,0.09895833333333333,0.0708955223880597
"[1, 1, 1, 0, 0, 0, 1, 1, 0, 0, 0, 1, 1, 1, 1]",268,84,184,8,19,0.09523809523809523,0.10326086956521739
"[1, 1, 0, 0, 1, 0, 0, 0, 1, 1, 0, 0, 1, 0, 0]",152,94,58,8,2,0.0851063829787234,0.034482758620689655
"[1, 1, 0, 1, 0, 0, 0, 0, 1, 0, 1, 1, 0, 0, 1]",123,66,57,4,6,0.06060606060606061,0.10526315789473684
"[0, 0, 0, 1, 1, 1, 1, 1, 0, 0, 1, 0, 1, 1, 1]",246,159,87,13,12,0.08176100628930817,0.13793103448275862
"[0, 0, 0, 1, 0, 0, 0, 0, 1, 1, 1, 1, 1, 1, 0]",358,215,143,33,16,0.15348837209302327,0.11188811188811189
"[1, 0, 0, 0, 1, 0, 0, 0, 1, 1, 1, 0, 0, 1, 1]",163,81,82,9,8,0.1111111111111111,0.0975609756097561
"[1, 0, 1, 0, 0, 0, 0, 1, 0, 0, 0, 0, 1, 1, 0]",280,170,110,14,7,0.08235294117647059,0.06363636363636363
"[1, 0, 1, 1, 1, 0, 0, 0, 0, 0, 0, 0, 1, 0, 0]",305,206,99,16,10,0.07766990291262135,0.10101010101010101
"[1, 0, 0, 1, 1, 1, 0, 1, 1, 1, 1, 1, 0, 1, 1]",570,160,410,15,27,0.09375,0.06585365853658537
"[1, 1, 0, 1, 0, 0, 0, 1, 0, 0, 0, 1, 0, 0, 1]",133,73,60,7,6,0.0958904109589041,0.1
"[1, 0, 0, 0, 0, 1, 0, 1, 0, 1, 1, 0, 0, 0, 1]",164,93,71,12,5,0.12903225806451613,0.07042253521126761
"[1, 0, 0, 0, 1, 1, 0, 0, 1, 0, 0, 1, 0, 0, 1]",122,69,53,8,5,0.11594202898550725,0.09433962264150944
"[0, 1, 0, 0, 0, 1, 1, 0, 0, 1, 0, 0, 1, 0, 0]",218,141,77,12,7,0.0851063829787234,0.09090909090909091
"[0, 0, 0, 0, 0, 0, 1, 1, 1, 1, 1, 1, 1, 0, 0]",459,252,207,28,19,0.1111111111111111,0.09178743961352658
"[1, 0, 1, 1, 0, 1, 1, 1, 1, 0, 0, 1, 0, 1, 1]",244,94,150,7,9,0.07446808510638298,0.06
"[1, 1, 0, 0, 1, 1, 0, 1, 1, 1, 0, 1, 0, 0, 0]",127,60,67,7,4,0.11666666666666667,0.05970149253731343
"[0, 1, 0, 1, 0, 1, 0, 0, 1, 1, 1, 1, 0, 1, 1]",157,74,83,3,4,0.04054054054054054,0.04819277108433735
"[1, 0, 0, 1, 1, 1, 0, 0, 1, 1, 1, 0, 1, 1, 0]",160,61,99,8,7,0.13114754098360656,0.0707070707070707
"[1, 1, 1, 1, 1, 0, 0, 1, 0, 0, 1, 1, 0, 1, 1]",304,103,201,14,17,0.13592233009708737,0.0845771144278607
"[0, 0, 1, 1, 0, 1, 0, 1, 1, 0, 1, 0, 0, 0, 1]",132,73,59,6,6,0.0821917808219178,0.1016949152542373
"[1, 1, 0, 0, 0, 1, 0, 1, 0, 1, 0, 1, 1, 1, 1]",182,73,109,8,12,0.1095890410958904,0.11009174311926606
"[1, 1, 0, 1, 1, 1, 0, 1, 1, 0, 0, 0, 1, 0, 1]",124,49,75,4,10,0.08163265306122448,0.13333333333333333
"[1, 1, 1, 0, 0, 0, 0, 0, 1, 1, 1, 0, 1, 0, 0]",132,66,66,9,6,0.13636363636363635,0.09090909090909091
"[1, 1, 1, 1, 1, 0, 0, 0, 0, 0, 1, 1, 1, 0, 1]",206,55,151,3,10,0.05454545454545454,0.06622516556291391
"[1, 0, 0, 1, 1, 1, 1, 1, 0, 1, 1, 0, 0, 0, 0]",167,75,92,11,12,0.14666666666666667,0.13043478260869565
"[1, 1, 0, 0, 0, 0, 0, 1, 1, 1, 1, 1, 0, 1, 0]",131,65,66,6,8,0.09230769230769231,0.12121212121212122
"[1, 1, 0, 1, 0, 0, 1, 0, 0, 0, 1, 0, 0, 1, 0]",152,89,63,13,7,0.14606741573033707,0.1111111111111111
"[1, 1, 0, 0, 1, 1, 1, 0, 1, 1, 1, 0, 0, 1, 0]",176,66,110,7,4,0.10606060606060606,0.03636363636363636
"[1, 0, 0, 1, 1, 1, 1, 0, 1, 1, 0, 0, 0, 0, 1]",180,72,108,8,13,0.1111111111111111,0.12037037037037036
"[0, 0, 1, 0, 1, 1, 1, 1, 1, 1, 0, 0, 1, 1, 0]",280,129,151,6,14,0.046511627906976744,0.09271523178807947
"[0, 1, 0, 1, 0, 1, 1, 0, 1, 0, 1, 0, 1, 0, 0]",105,44,61,6,12,0.13636363636363635,0.19672131147540983
"[1, 0, 0, 1, 0, 1, 0, 0, 0, 1, 0, 0, 1, 0, 0]",224,144,80,22,12,0.1527777777777778,0.15
"[0, 0, 1, 1, 0, 1, 0, 1, 1, 1, 1, 1, 0, 0, 0]",177,82,95,6,8,0.07317073170731707,0.08421052631578947
"[0, 0, 0, 1, 0, 0, 1, 1, 0, 1, 0, 1, 0, 0, 0]",255,167,88,16,9,0.09580838323353294,0.10227272727272728
"[1, 1, 0, 0, 0, 1, 0, 0, 1, 1, 0, 1, 0, 1, 0]",100,57,43,5,0,0.08771929824561403,0.0
"[0, 0, 0, 0, 0, 1, 0, 0, 1, 0, 1, 1, 1, 1, 0]",178,112,66,13,3,0.11607142857142858,0.045454545454545456
"[0, 0, 1, 1, 0, 0, 1, 1, 1, 1, 0, 0, 0, 1, 1]",449,253,196,24,22,0.09486166007905138,0.11224489795918367
"[1, 1, 1, 1, 0, 0, 0, 0, 0, 1, 1, 0, 1, 0, 0]",146,74,72,8,7,0.10810810810810811,0.09722222222222222
"[0, 0, 1, 0, 0, 1, 0, 1, 1, 1, 1, 1, 1, 0, 1]",144,71,73,7,7,0.09859154929577464,0.0958904109589041
"[0, 1, 0, 0, 0, 1, 0, 0, 1, 0, 1, 1, 1, 1, 1]",154,77,77,5,8,0.06493506493506493,0.1038961038961039
"[1, 0, 1, 1, 0, 0, 1, 0, 1, 0, 1, 1, 1, 0, 0]",113,45,68,4,3,0.08888888888888889,0.04411764705882353
"[0, 0, 1, 0, 0, 1, 1, 1, 1, 0, 0, 0, 1, 0, 0]",153,101,52,7,10,0.06930693069306931,0.19230769230769232
"[1, 1, 0, 0, 1, 0, 0, 1, 1, 1, 1, 0, 0, 0, 1]",131,63,68,5,5,0.07936507936507936,0.07352941176470588
"[0, 0, 1, 1, 0, 1, 0, 0, 0, 1, 0, 1, 1, 1, 1]",158,77,81,7,10,0.09090909090909091,0.12345679012345678
"[1, 0, 1, 1, 0, 0, 0, 1, 1, 0, 1, 0, 0, 0, 1]",104,51,53,8,8,0.1568627450980392,0.1509433962264151
"[1, 1, 0, 1, 0, 0, 0, 1, 0, 1, 1, 0, 0, 0, 0]",182,106,76,12,12,0.11320754716981132,0.15789473684210525
"[1, 1, 1, 0, 0, 1, 1, 1, 0, 1, 1, 1, 0, 1, 0]",251,79,172,5,19,0.06329113924050633,0.11046511627906977
"[1, 0, 1, 1, 0, 1, 0, 0, 0, 0, 0, 1, 1, 1, 0]",118,61,57,4,8,0.06557377049180328,0.14035087719298245
"[1, 1, 0, 0, 0, 1, 1, 0, 0, 0, 1, 0, 0, 0, 0]",273,164,109,24,10,0.14634146341463414,0.09174311926605505
"[0, 1, 0, 1, 1, 1, 0, 0, 0, 1, 1, 0, 0, 0, 1]",106,52,54,6,5,0.11538461538461539,0.09259259259259259
"[1, 0, 0, 1, 0, 0, 0, 1, 0, 1, 0, 0, 0, 0, 0]",583,415,168,37,19,0.0891566265060241,0.1130952380952381
"[1, 0, 1, 1, 0, 1, 1, 0, 1, 1, 1, 0, 1, 1, 0]",221,87,134,6,14,0.06896551724137931,0.1044776119402985
"[1, 0, 0, 0, 0, 0, 1, 0, 0, 0, 0, 1, 0, 1, 1]",293,177,116,13,18,0.07344632768361582,0.15517241379310345
"[1, 1, 0, 1, 1, 0, 0, 0, 0, 1, 1, 0, 1, 1, 0]",129,74,55,5,5,0.06756756756756757,0.09090909090909091
"[1, 1, 0, 1, 0, 1, 1, 0, 1, 1, 0, 0, 0, 0, 1]",165,84,81,6,6,0.07142857142857142,0.07407407407407407
"[0, 1, 1, 0, 1, 0, 1, 1, 0, 1, 1, 0, 0, 0, 0]",175,94,81,11,4,0.11702127659574468,0.04938271604938271
"[1, 1, 0, 1, 1, 0, 0, 0, 1, 0, 1, 0, 0, 1, 1]",135,63,72,9,7,0.14285714285714285,0.09722222222222222
"[1, 1, 0, 1, 1, 0, 1, 1, 1, 0, 1, 1, 0, 1, 0]",213,78,135,4,7,0.05128205128205128,0.05185185185185185
"[0, 1, 1, 0, 1, 1, 1, 1, 1, 1, 1, 0, 0, 0, 1]",284,92,192,12,18,0.13043478260869565,0.09375
"[0, 0, 0, 0, 1, 0, 0, 0, 1, 1, 1, 1, 1, 1, 0]",265,158,107,11,12,0.06962025316455696,0.11214953271028037
"[1, 0, 0, 0, 1, 0, 1, 1, 0, 0, 0, 0, 1, 0, 0]",246,154,92,18,7,0.11688311688311688,0.07608695652173914
"[1, 1, 1, 0, 0, 0, 1, 0, 0, 0, 0, 1, 1, 1, 1]",241,112,129,12,7,0.10714285714285714,0.05426356589147287
"[1, 0, 1, 1, 1, 1, 1, 1, 1, 0, 0, 0, 1, 0, 0]",157,68,89,10,8,0.14705882352941177,0.0898876404494382
"[1, 1, 1, 1, 1, 1, 1, 0, 1, 0, 0, 1, 0, 1, 1]",620,193,427,34,38,0.17616580310880828,0.08899297423887588
"[0, 1, 1, 1, 0, 0, 1, 1, 0, 1, 0, 1, 1, 0, 1]",146,62,84,8,14,0.12903225806451613,0.16666666666666666
"[0, 1, 1, 0, 1, 0, 0, 0, 1, 0, 0, 0, 0, 0, 1]",251,175,76,21,8,0.12,0.10526315789473684
"[0, 1, 1, 0, 0, 1, 1, 0, 0, 0, 1, 0, 0, 1, 1]",221,149,72,15,9,0.10067114093959731,0.125
"[1, 1, 0, 1, 1, 1, 1, 0, 0, 0, 1, 1, 0, 0, 0]",180,80,100,7,9,0.0875,0.09
"[1, 0, 0, 1, 1, 1, 0, 0, 1, 1, 0, 0, 1, 1, 1]",402,158,244,12,29,0.0759493670886076,0.11885245901639344
"[0, 0, 1, 0, 0, 0, 0, 0, 1, 1, 0, 1, 1, 1, 0]",140,82,58,4,6,0.04878048780487805,0.10344827586206896
"[1, 0, 0, 1, 1, 0, 0, 0, 0, 0, 0, 1, 1, 1, 0]",432,146,286,15,26,0.10273972602739725,0.09090909090909091
"[0, 0, 1, 1, 0, 0, 1, 1, 0, 1, 1, 1, 1, 1, 0]",234,84,150,11,13,0.13095238095238096,0.08666666666666667
"[1, 1, 1, 0, 0, 1, 0, 0, 1, 0, 1, 0, 1, 1, 0]",115,53,62,8,5,0.1509433962264151,0.08064516129032258
"[1, 1, 1, 1, 0, 1, 1, 1, 1, 0, 0, 1, 0, 0, 1]",252,101,151,16,11,0.15841584158415842,0.0728476821192053
"[1, 1, 0, 1, 1, 0, 1, 1, 0, 1, 1, 0, 0, 1, 0]",134,55,79,7,4,0.12727272727272726,0.05063291139240506
"[1, 0, 0, 1, 0, 1, 1, 1, 0, 0, 0, 0, 0, 0, 0]",399,253,146,16,18,0.06324110671936758,0.1232876712328767
"[1, 0, 0, 1, 1, 1, 0, 0, 1, 1, 0, 0, 0, 0, 1]",264,133,131,13,16,0.09774436090225563,0.12213740458015267
"[1, 0, 0, 1, 0, 1, 1, 0, 0, 1, 1, 0, 0, 1, 0]",133,67,66,4,9,0.05970149253731343,0.13636363636363635
"[1, 1, 0, 0, 0, 0, 1, 1, 1, 1, 0, 1, 0, 0, 0]",216,109,107,8,7,0.07339449541284404,0.06542056074766354
"[0, 1, 0, 1, 0, 1, 1, 1, 1, 0, 0, 0, 1, 0, 1]",122,60,62,4,11,0.06666666666666667,0.1774193548387097
"[0, 1, 1, 0, 0, 0, 1, 0, 1, 0, 1, 1, 1, 0, 1]",127,67,60,8,4,0.11940298507462686,0.06666666666666667
"[0, 0, 1, 1, 0, 1, 1, 1, 0, 0, 0, 0, 0, 0, 0]",388,241,147,27,15,0.11203319502074689,0.10204081632653061
"[0, 0, 0, 0, 0, 1, 1, 0, 1, 1, 1, 0, 0, 0, 0]",329,201,128,19,12,0.0945273631840796,0.09375
"[0, 0, 1, 1, 0, 1, 0, 1, 1, 0, 0, 0, 1, 0, 0]",158,93,65,13,5,0.13978494623655913,0.07692307692307693
"[0, 0, 1, 0, 1, 1, 0, 1, 0, 1, 0, 1, 1, 0, 1]",98,46,52,3,7,0.06521739130434782,0.1346153846153846
"[0, 0, 1, 0, 0, 1, 0, 0, 0, 1, 1, 1, 1, 1, 0]",138,79,59,5,6,0.06329113924050633,0.1016949152542373
"[0, 0, 0, 1, 1, 0, 0, 1, 0, 0, 1, 0, 0, 0, 1]",250,171,79,16,9,0.0935672514619883,0.11392405063291139
"[0, 1, 1, 1, 1, 0, 0, 0, 0, 1, 0, 0, 0, 0, 0]",425,321,104,30,9,0.09345794392523364,0.08653846153846154
"[0, 1, 0, 0, 0, 1, 1, 1, 0, 1, 0, 0, 1, 0, 0]",128,75,53,8,5,0.10666666666666667,0.09433962264150944
"[0, 0, 1, 1, 0, 0, 1, 1, 0, 1, 1, 0, 0, 0, 1]",165,89,76,7,6,0.07865168539325842,0.07894736842105263
"[0, 1, 0, 0, 1, 1, 0, 1, 0, 0, 0, 1, 0, 0, 0]",231,151,80,11,3,0.0728476821192053,0.0375
"[1, 1, 1, 1, 1, 1, 0, 0, 0, 1, 1, 0, 1, 1, 0]",328,131,197,14,20,0.10687022900763359,0.10152284263959391
"[0, 1, 0, 1, 1, 1, 0, 1, 1, 0, 0, 1, 0, 1, 0]",111,57,54,10,5,0.17543859649122806,0.09259259259259259
"[1, 1, 1, 0, 0, 1, 0, 1, 1, 1, 1, 0, 1, 1, 0]",229,81,148,13,8,0.16049382716049382,0.05405405405405406
"[1, 0, 1, 1, 1, 1, 1, 0, 1, 1, 1, 0, 0, 1, 0]",244,86,158,9,17,0.10465116279069768,0.10759493670886076
"[0, 1, 0, 1, 1, 0, 0, 1, 0, 0, 1, 1, 1, 1, 1]",229,104,125,11,7,0.10576923076923077,0.056
"[1, 0, 1, 1, 1, 0, 0, 0, 1, 0, 0, 0, 1, 0, 0]",141,82,59,9,4,0.10975609756097561,0.06779661016949153
"[1, 1, 1, 1, 0, 0, 1, 0, 1, 1, 0, 0, 1, 1, 0]",223,91,132,5,8,0.054945054945054944,0.06060606060606061
"[0, 1, 0, 1, 0, 0, 0, 0, 1, 0, 1, 0, 1, 1, 0]",136,89,47,4,8,0.0449438202247191,0.1702127659574468
"[0, 0, 1, 0, 1, 0, 0, 0, 0, 1, 0, 1, 0, 1, 1]",179,113,66,15,3,0.13274336283185842,0.045454545454545456
"[1, 0, 0, 1, 0, 0, 0, 0, 1, 1, 0, 1, 1, 1, 0]",123,59,64,2,8,0.03389830508474576,0.125
"[1, 0, 1, 1, 1, 0, 1, 0, 0, 0, 0, 1, 1, 0, 1]",109,46,63,5,6,0.10869565217391304,0.09523809523809523
"[1, 0, 1, 1, 1, 1, 0, 0, 0, 0, 0, 1, 0, 0, 1]",106,57,49,5,5,0.08771929824561403,0.10204081632653061
"[1, 0, 0, 0, 1, 0, 0, 0, 0, 1, 0, 0, 1, 1, 0]",268,171,97,22,10,0.1286549707602339,0.10309278350515463
"[1, 1, 1, 0, 1, 1, 0, 0, 1, 1, 1, 0, 1, 0, 1]",212,72,140,10,19,0.1388888888888889,0.1357142857142857
"[1, 0, 0, 0, 1, 1, 1, 0, 0, 1, 1, 1, 1, 1, 1]",522,175,347,15,35,0.08571428571428572,0.10086455331412104
"[1, 0, 1, 1, 1, 0, 0, 0, 1, 1, 0, 1, 1, 0, 0]",107,50,57,0,6,0.0,0.10526315789473684
"[1, 0, 0, 0, 0, 1, 1, 0, 1, 1, 1, 0, 0, 0, 1]",126,51,75,5,10,0.09803921568627451,0.13333333333333333
"[0, 0, 0, 0, 0, 1, 1, 1, 1, 0, 0, 0, 1, 1, 0]",311,225,86,23,10,0.10222222222222223,0.11627906976744186
"[1, 0, 0, 0, 0, 0, 1, 0, 1, 0, 0, 0, 1, 1, 0]",276,164,112,15,8,0.09146341463414634,0.07142857142857142
"[1, 1, 0, 0, 1, 1, 1, 0, 1, 0, 0, 1, 0, 1, 0]",111,56,55,7,7,0.125,0.12727272727272726
"[0, 1, 0, 1, 1, 1, 0, 0, 1, 1, 1, 0, 1, 0, 0]",125,55,70,6,9,0.10909090909090909,0.12857142857142856
"[0, 0, 1, 0, 1, 1, 0, 1, 1, 0, 1, 1, 1, 1, 1]",297,111,186,14,16,0.12612612612612611,0.08602150537634409
"[1, 1, 1, 1, 1, 0, 0, 1, 1, 0, 1, 0, 1, 0, 0]",195,59,136,13,22,0.22033898305084745,0.16176470588235295
"[1, 0, 0, 1, 1, 0, 0, 1, 0, 0, 1, 0, 1, 0, 0]",162,98,64,9,5,0.09183673469387756,0.078125
"[1, 1, 1, 0, 1, 1, 1, 0, 0, 1, 1, 0, 0, 0, 1]",164,59,105,9,5,0.15254237288135594,0.047619047619047616
"[1, 1, 1, 1, 1, 0, 1, 1, 0, 1, 1, 1, 0, 1, 0]",519,150,369,15,40,0.1,0.10840108401084012
"[0, 0, 1, 1, 0, 1, 1, 0, 1, 0, 0, 1, 1, 1, 0]",98,50,48,2,4,0.04,0.08333333333333333
"[0, 0, 0, 1, 1, 0, 1, 1, 0, 0, 1, 0, 0, 1, 1]",159,83,76,9,6,0.10843373493975904,0.07894736842105263
"[0, 0, 1, 1, 0, 1, 0, 1, 1, 1, 0, 1, 0, 1, 0]",109,50,59,7,4,0.14,0.06779661016949153
"[1, 0, 1, 0, 0, 1, 1, 0, 0, 0, 1, 0, 1, 1, 0]",104,54,50,9,7,0.16666666666666666,0.14
"[0, 0, 0, 0, 1, 0, 0, 1, 1, 0, 1, 1, 0, 1, 0]",147,94,53,7,5,0.07446808510638298,0.09433962264150944
"[1, 0, 0, 0, 1, 1, 1, 0, 0, 1, 1, 1, 0, 1, 1]",177,74,103,6,14,0.08108108108108109,0.13592233009708737
"[1, 0, 0, 0, 0, 0, 0, 0, 0, 1, 1, 1, 1, 0, 1]",407,147,260,9,23,0.061224489795918366,0.08846153846153847
"[1, 1, 1, 1, 1, 0, 0, 0, 0, 0, 0, 1, 1, 0, 1]",401,88,313,1,31,0.011363636363636364,0.09904153354632587
"[0, 1, 1, 0, 0, 1, 0, 1, 0, 0, 1, 0, 1, 1, 1]",156,88,68,5,5,0.056818181818181816,0.07352941176470588
"[0, 0, 1, 1, 0, 0, 0, 1, 1, 0, 1, 1, 0, 1, 0]",140,72,68,7,6,0.09722222222222222,0.08823529411764706
"[0, 1, 1, 1, 0, 0, 1, 1, 1, 1, 0, 1, 1, 0, 1]",276,99,177,9,19,0.09090909090909091,0.10734463276836158
"[0, 0, 0, 0, 1, 0, 0, 1, 0, 1, 0, 1, 1, 0, 1]",119,62,57,6,4,0.0967741935483871,0.07017543859649122
"[0, 1, 1, 0, 1, 0, 0, 1, 0, 1, 1, 1, 0, 1, 0]",107,49,58,7,2,0.14285714285714285,0.034482758620689655
"[0, 0, 1, 1, 1, 1, 0, 1, 1, 0, 1, 0, 1, 0, 0]",121,61,60,10,8,0.16393442622950818,0.13333333333333333
"[1, 0, 0, 1, 1, 0, 1, 0, 1, 1, 1, 0, 1, 0, 0]",97,42,55,8,4,0.19047619047619047,0.07272727272727272
"[1, 0, 1, 0, 1, 0, 0, 1, 1, 0, 1, 0, 1, 1, 1]",162,68,94,9,8,0.1323529411764706,0.0851063829787234
"[1, 0, 1, 1, 0, 1, 0, 0, 0, 1, 0, 0, 1, 0, 1]",92,50,42,3,5,0.06,0.11904761904761904
"[0, 1, 1, 0, 1, 0, 0, 1, 1, 1, 0, 0, 1, 0, 1]",99,43,56,2,3,0.046511627906976744,0.05357142857142857
"[0, 1, 0, 0, 1, 0, 1, 1, 1, 1, 0, 1, 1, 0, 1]",160,69,91,8,8,0.11594202898550725,0.08791208791208792
"[1, 0, 0, 1, 1, 1, 0, 1, 0, 1, 0, 0, 0, 0, 1]",152,74,78,7,9,0.0945945945945946,0.11538461538461539
"[1, 0, 1, 1, 0, 0, 1, 1, 1, 0, 1, 0, 1, 0, 0]",118,59,59,2,6,0.03389830508474576,0.1016949152542373
"[0, 0, 1, 1, 1, 0, 1, 0, 0, 1, 1, 0, 0, 1, 1]",207,98,109,8,3,0.08163265306122448,0.027522935779816515
"[1, 0, 1, 0, 1, 0, 0, 1, 0, 1, 1, 0, 1, 1, 0]",100,41,59,3,10,0.07317073170731707,0.1694915254237288
"[1, 1, 0, 1, 1, 0, 0, 1, 1, 0, 1, 0, 1, 0, 0]",114,52,62,4,8,0.07692307692307693,0.12903225806451613
"[1, 0, 0, 1, 1, 0, 0, 1, 0, 0, 1, 1, 1, 0, 0]",165,73,92,11,9,0.1506849315068493,0.09782608695652174
"[1, 0, 1, 0, 1, 0, 0, 0, 1, 1, 1, 0, 1, 1, 1]",123,53,70,7,10,0.1320754716981132,0.14285714285714285
"[0, 1, 1, 0, 0, 0, 1, 0, 0, 1, 0, 1, 1, 0, 1]",126,69,57,2,9,0.028985507246376812,0.15789473684210525
"[1, 0, 0, 0, 1, 0, 1, 1, 0, 1, 1, 1, 0, 1, 1]",144,64,80,6,5,0.09375,0.0625
"[1, 1, 0, 1, 0, 1, 1, 0, 1, 0, 1, 0, 0, 0, 1]",103,40,63,7,4,0.175,0.06349206349206349
"[1, 0, 0, 0, 1, 1, 0, 1, 0, 1, 1, 0, 1, 0, 1]",110,40,70,5,10,0.125,0.14285714285714285
"[0, 1, 1, 0, 0, 0, 1, 1, 1, 0, 0, 0, 1, 0, 0]",167,100,67,12,10,0.12,0.14925373134328357
"[1, 1, 0, 0, 1, 0, 0, 0, 1, 0, 0, 1, 1, 1, 1]",221,116,105,12,11,0.10344827586206896,0.10476190476190476
"[0, 0, 1, 0, 1, 0, 0, 0, 1, 1, 1, 0, 0, 0, 0]",314,189,125,16,12,0.08465608465608465,0.096
"[0, 1, 0, 0, 0, 1, 0, 1, 1, 1, 0, 1, 1, 0, 1]",100,47,53,2,2,0.0425531914893617,0.03773584905660377
"[1, 1, 0, 0, 0, 0, 0, 0, 1, 1, 0, 1, 0, 1, 0]",225,132,93,17,7,0.12878787878787878,0.07526881720430108
"[1, 0, 1, 0, 1, 1, 1, 1, 0, 1, 0, 1, 1, 0, 0]",166,75,91,8,10,0.10666666666666667,0.10989010989010989
"[1, 0, 0, 0, 0, 0, 1, 0, 1, 0, 0, 0, 1, 1, 1]",267,151,116,11,11,0.0728476821192053,0.09482758620689655
"[0, 1, 0, 0, 0, 0, 1, 1, 1, 0, 0, 0, 0, 0, 1]",277,189,88,19,11,0.10052910052910052,0.125
"[1, 1, 1, 0, 1, 0, 1, 1, 1, 1, 0, 1, 1, 0, 0]",292,103,189,15,23,0.14563106796116504,0.12169312169312169
"[1, 1, 1, 0, 1, 0, 1, 0, 1, 1, 1, 1, 0, 1, 0]",220,82,138,10,17,0.12195121951219512,0.12318840579710146
"[1, 1, 1, 0, 1, 0, 1, 0, 1, 0, 0, 1, 1, 1, 0]",133,52,81,5,8,0.09615384615384616,0.09876543209876543
"[0, 1, 0, 0, 0, 1, 1, 1, 1, 1, 1, 0, 0, 1, 0]",139,63,76,4,11,0.06349206349206349,0.14473684210526316
"[0, 1, 0, 0, 0, 1, 1, 1, 0, 1, 0, 1, 0, 0, 0]",156,107,49,12,2,0.11214953271028037,0.04081632653061224
"[1, 0, 1, 0, 1, 0, 0, 0, 0, 0, 0, 1, 0, 1, 0]",216,144,72,17,2,0.11805555555555555,0.027777777777777776
"[0, 1, 1, 1, 1, 1, 0, 1, 1, 0, 1, 0, 1, 0, 0]",147,85,62,7,8,0.08235294117647059,0.12903225806451613
"[1, 0, 0, 1, 0, 1, 0, 0, 0, 0, 1, 1, 1, 1, 1]",218,96,122,9,19,0.09375,0.1557377049180328
"[0, 1, 0, 1, 0, 0, 1, 1, 0, 0, 1, 0, 1, 0, 0]",120,72,48,6,7,0.08333333333333333,0.14583333333333334
"[1, 0, 0, 1, 0, 0, 1, 0, 1, 0, 0, 1, 0, 1, 0]",121,67,54,8,5,0.11940298507462686,0.09259259259259259
"[0, 0, 0, 0, 1, 1, 0, 1, 0, 0, 1, 0, 1, 0, 0]",265,175,90,14,10,0.08,0.1111111111111111
"[1, 0, 0, 0, 0, 0, 1, 1, 0, 1, 0, 0, 1, 0, 1]",153,96,57,11,4,0.11458333333333333,0.07017543859649122
"[0, 0, 0, 0, 0, 0, 1, 1, 0, 1, 0, 0, 1, 0, 1]",315,205,110,22,10,0.1073170731707317,0.09090909090909091
"[1, 0, 1, 1, 1, 1, 0, 0, 0, 0, 0, 0, 0, 0, 1]",483,265,218,20,22,0.07547169811320754,0.10091743119266056
"[1, 0, 0, 1, 1, 0, 0, 1, 0, 1, 1, 1, 0, 1, 0]",129,57,72,5,8,0.08771929824561403,0.1111111111111111
"[1, 1, 1, 0, 0, 0, 1, 0, 1, 0, 0, 1, 0, 1, 1]",104,52,52,5,8,0.09615384615384616,0.15384615384615385
"[1, 1, 1, 1, 0, 1, 0, 0, 1, 1, 1, 0, 1, 0, 0]",150,64,86,7,12,0.109375,0.13953488372093023
"[0, 1, 1, 0, 0, 1, 1, 0, 1, 0, 0, 1, 0, 1, 1]",158,91,67,9,3,0.0989010989010989,0.04477611940298507
"[0, 1, 1, 1, 1, 1, 1, 1, 1, 0, 1, 0, 0, 1, 0]",285,137,148,11,18,0.08029197080291971,0.12162162162162163
"[0, 1, 1, 0, 0, 1, 0, 0, 0, 0, 1, 0, 1, 0, 1]",167,108,59,16,4,0.14814814814814814,0.06779661016949153
"[0, 0, 1, 0, 0, 1, 1, 1, 0, 0, 0, 1, 1, 1, 0]",121,63,58,8,11,0.12698412698412698,0.1896551724137931
"[1, 0, 1, 0, 1, 0, 1, 1, 1, 1, 0, 0, 1, 1, 0]",219,87,132,5,12,0.05747126436781609,0.09090909090909091
"[1, 1, 0, 0, 0, 1, 1, 1, 1, 1, 0, 0, 0, 0, 0]",248,124,124,13,8,0.10483870967741936,0.06451612903225806
"[0, 1, 0, 1, 0, 1, 0, 1, 0, 0, 1, 1, 1, 0, 1]",103,56,47,9,3,0.16071428571428573,0.06382978723404255
"[0, 1, 0, 0, 0, 1, 0, 0, 1, 0, 0, 1, 1, 1, 0]",155,106,49,14,3,0.1320754716981132,0.061224489795918366
"[0, 0, 0, 0, 0, 1, 1, 0, 0, 1, 1, 0, 1, 1, 1]",484,374,110,47,8,0.12566844919786097,0.07272727272727272
"[0, 0, 0, 1, 0, 1, 1, 1, 1, 1, 0, 1, 1, 1, 1]",336,129,207,14,24,0.10852713178294573,0.11594202898550725
"[0, 0, 0, 0, 1, 0, 0, 1, 1, 1, 1, 0, 1, 1, 0]",137,77,60,9,6,0.11688311688311688,0.1
"[1, 1, 1, 1, 1, 0, 0, 0, 1, 0, 1, 1, 0, 0, 1]",204,74,130,6,7,0.08108108108108109,0.05384615384615385
"[0, 1, 0, 1, 0, 0, 0, 1, 1, 0, 1, 1, 0, 1, 1]",120,64,56,2,5,0.03125,0.08928571428571429
"[1, 0, 0, 1, 1, 0, 1, 1, 0, 1, 1, 1, 0, 1, 0]",142,56,86,5,9,0.08928571428571429,0.10465116279069768
"[1, 0, 0, 1, 0, 1, 1, 0, 0, 0, 1, 1, 1, 1, 1]",230,89,141,13,14,0.14606741573033707,0.09929078014184398
"[0, 0, 1, 1, 1, 0, 1, 1, 0, 0, 1, 1, 1, 1, 0]",229,100,129,8,13,0.08,0.10077519379844961
"[1, 1, 1, 0, 0, 0, 0, 0, 1, 1, 1, 0, 1, 0, 1]",148,62,86,0,8,0.0,0.09302325581395349
"[1, 1, 0, 0, 0, 0, 0, 1, 0, 1, 1, 1, 0, 1, 1]",162,75,87,7,11,0.09333333333333334,0.12643678160919541
"[0, 1, 1, 1, 1, 1, 0, 1, 1, 1, 0, 1, 1, 0, 0]",285,96,189,14,11,0.14583333333333334,0.0582010582010582
"[1, 0, 1, 1, 0, 1, 1, 1, 1, 0, 1, 0, 0, 1, 1]",272,91,181,11,23,0.12087912087912088,0.1270718232044199
"[0, 1, 0, 1, 1, 0, 0, 0, 0, 0, 1, 1, 0, 1, 0]",131,75,56,9,6,0.12,0.10714285714285714
"[0, 1, 1, 1, 0, 1, 0, 0, 0, 0, 0, 0, 0, 1, 1]",279,169,110,16,8,0.09467455621301775,0.07272727272727272
"[0, 0, 0, 0, 0, 1, 0, 1, 0, 1, 1, 1, 1, 1, 1]",238,142,96,15,11,0.1056338028169014,0.11458333333333333
"[1, 0, 0, 0, 0, 0, 0, 1, 0, 1, 0, 1, 1, 1, 1]",231,89,142,14,20,0.15730337078651685,0.14084507042253522
"[0, 0, 1, 0, 1, 0, 1, 0, 0, 1, 1, 1, 1, 0, 0]",182,96,86,14,12,0.14583333333333334,0.13953488372093023
"[0, 1, 0, 0, 0, 1, 1, 1, 1, 1, 1, 0, 1, 1, 0]",158,67,91,4,7,0.05970149253731343,0.07692307692307693
"[0, 0, 0, 0, 1, 1, 1, 0, 0, 1, 1, 1, 1, 1, 0]",185,104,81,10,11,0.09615384615384616,0.13580246913580246
"[1, 1, 0, 1, 1, 0, 1, 0, 1, 0, 0, 1, 1, 0, 0]",153,69,84,10,11,0.14492753623188406,0.13095238095238096
"[1, 0, 1, 1, 0, 0, 1, 1, 1, 0, 1, 1, 0, 0, 1]",173,59,114,8,11,0.13559322033898305,0.09649122807017543
"[1, 0, 0, 1, 0, 0, 1, 0, 1, 0, 0, 0, 0, 0, 1]",268,172,96,20,11,0.11627906976744186,0.11458333333333333
"[1, 1, 0, 1, 0, 0, 0, 0, 0, 0, 1, 1, 0, 1, 1]",168,78,90,8,12,0.10256410256410256,0.13333333333333333
"[1, 0, 1, 0, 0, 0, 1, 0, 0, 0, 0, 0, 1, 0, 0]",433,301,132,34,10,0.11295681063122924,0.07575757575757576
"[1, 0, 1, 1, 1, 0, 0, 0, 0, 0, 0, 1, 0, 1, 0]",135,71,64,11,4,0.15492957746478872,0.0625
"[1, 1, 1, 1, 0, 0, 1, 0, 1, 1, 0, 1, 0, 1, 0]",138,49,89,5,4,0.10204081632653061,0.0449438202247191
"[1, 0, 1, 0, 0, 1, 0, 0, 1, 1, 1, 1, 0, 0, 1]",165,82,83,9,9,0.10975609756097561,0.10843373493975904
"[1, 1, 1, 0, 1, 1, 1, 1, 0, 1, 1, 0, 0, 0, 1]",260,78,182,15,17,0.19230769230769232,0.09340659340659341
"[1, 0, 0, 1, 1, 1, 1, 0, 1, 0, 0, 0, 1, 0, 1]",125,60,65,2,7,0.03333333333333333,0.1076923076923077
"[1, 0, 0, 1, 1, 1, 1, 0, 0, 0, 1, 1, 0, 0, 0]",233,102,131,13,15,0.12745098039215685,0.11450381679389313
"[1, 1, 0, 1, 1, 0, 0, 1, 1, 0, 1, 1, 0, 1, 0]",132,56,76,6,3,0.10714285714285714,0.039473684210526314
"[0, 1, 0, 1, 0, 0, 0, 1, 1, 0, 0, 1, 1, 0, 1]",136,76,60,8,9,0.10526315789473684,0.15
"[1, 0, 0, 1, 0, 0, 1, 1, 0, 1, 0, 0, 1, 1, 1]",146,77,69,10,7,0.12987012987012986,0.10144927536231885
"[0, 1, 0, 0, 1, 0, 0, 1, 1, 0, 1, 0, 0, 1, 1]",130,64,66,10,7,0.15625,0.10606060606060606
"[0, 1, 1, 0, 1, 0, 1, 1, 0, 0, 1, 1, 1, 0, 1]",117,53,64,6,5,0.11320754716981132,0.078125
"[1, 0, 0, 1, 1, 1, 0, 1, 1, 0, 1, 1, 0, 1, 1]",266,90,176,6,22,0.06666666666666667,0.125
"[1, 0, 0, 1, 0, 0, 0, 1, 0, 0, 0, 0, 1, 1, 1]",224,128,96,15,11,0.1171875,0.11458333333333333
"[1, 0, 1, 0, 0, 0, 0, 1, 1, 1, 1, 1, 1, 1, 0]",234,95,139,11,7,0.11578947368421053,0.050359712230215826
"[0, 1, 1, 1, 0, 0, 1, 0, 0, 1, 1, 1, 1, 0, 0]",183,94,89,9,8,0.09574468085106383,0.0898876404494382
"[0, 0, 1, 0, 0, 0, 0, 1, 0, 1, 1, 0, 1, 0, 0]",231,143,88,16,8,0.11188811188811189,0.09090909090909091
"[0, 0, 0, 1, 0, 0, 0, 0, 0, 1, 0, 1, 0, 1, 1]",300,213,87,21,11,0.09859154929577464,0.12643678160919541
"[1, 1, 1, 0, 1, 0, 0, 0, 0, 1, 1, 1, 0, 1, 0]",125,62,63,4,6,0.06451612903225806,0.09523809523809523
"[0, 1, 1, 1, 0, 1, 0, 0, 0, 0, 1, 1, 1, 0, 1]",126,60,66,5,7,0.08333333333333333,0.10606060606060606
"[1, 0, 0, 1, 1, 1, 0, 0, 1, 1, 0, 1, 0, 0, 1]",119,54,65,5,11,0.09259259259259259,0.16923076923076924
"[1, 0, 0, 1, 1, 1, 0, 1, 1, 0, 0, 1, 0, 1, 1]",149,55,94,5,6,0.09090909090909091,0.06382978723404255
"[0, 1, 1, 1, 1, 1, 0, 0, 0, 1, 0, 0, 0, 1, 1]",145,74,71,8,9,0.10810810810810811,0.1267605633802817
"[0, 0, 1, 1, 1, 1, 0, 0, 0, 1, 1, 0, 0, 0, 1]",201,98,103,9,8,0.09183673469387756,0.07766990291262135
"[0, 1, 0, 1, 1, 0, 0, 1, 1, 1, 0, 0, 0, 1, 1]",147,60,87,3,8,0.05,0.09195402298850575
"[0, 1, 0, 1, 1, 0, 0, 0, 1, 0, 1, 0, 0, 1, 0]",154,90,64,11,9,0.12222222222222222,0.140625
"[0, 1, 0, 0, 0, 0, 1, 1, 1, 1, 1, 0, 0, 1, 1]",219,110,109,15,11,0.13636363636363635,0.10091743119266056
"[0, 0, 1, 0, 0, 0, 0, 1, 1, 1, 1, 1, 0, 0, 1]",165,101,64,17,6,0.16831683168316833,0.09375
"[0, 0, 1, 0, 0, 1, 0, 1, 1, 1, 0, 0, 0, 0, 1]",165,110,55,11,7,0.1,0.12727272727272726
"[0, 1, 0, 1, 0, 1, 1, 0, 0, 1, 1, 1, 1, 1, 0]",185,65,120,3,9,0.046153846153846156,0.075
"[0, 0, 0, 1, 0, 1, 1, 1, 1, 1, 0, 1, 1, 0, 1]",151,69,82,9,6,0.13043478260869565,0.07317073170731707
"[1, 0, 0, 1, 1, 1, 0, 0, 0, 0, 1, 1, 0, 0, 1]",307,151,156,12,9,0.07947019867549669,0.057692307692307696
"[0, 0, 1, 1, 1, 0, 0, 1, 1, 1, 0, 0, 0, 0, 1]",175,92,83,6,3,0.06521739130434782,0.03614457831325301
"[0, 1, 1, 1, 0, 0, 0, 1, 0, 0, 1, 1, 1, 0, 0]",137,66,71,3,9,0.045454545454545456,0.1267605633802817
"[0, 1, 0, 0, 0, 1, 1, 1, 0, 0, 0, 1, 1, 1, 1]",176,88,88,10,6,0.11363636363636363,0.06818181818181818
"[0, 1, 0, 0, 1, 0, 0, 0, 0, 0, 0, 1, 1, 1, 1]",458,298,160,37,13,0.12416107382550336,0.08125
"[1, 0, 1, 0, 1, 0, 0, 1, 0, 1, 1, 0, 0, 0, 0]",217,136,81,14,7,0.10294117647058823,0.08641975308641975
"[0, 0, 1, 0, 0, 0, 1, 1, 0, 1, 0, 1, 1, 0, 1]",86,48,38,3,5,0.0625,0.13157894736842105
"[1, 0, 1, 1, 0, 0, 0, 1, 1, 1, 1, 0, 0, 0, 0]",308,169,139,16,16,0.09467455621301775,0.11510791366906475
"[0, 1, 0, 1, 0, 0, 0, 0, 1, 1, 0, 1, 0, 0, 1]",160,91,69,4,12,0.04395604395604396,0.17391304347826086
"[0, 0, 1, 0, 0, 1, 1, 1, 0, 0, 1, 0, 0, 0, 0]",272,169,103,17,6,0.10059171597633136,0.05825242718446602
"[1, 1, 1, 0, 1, 0, 1, 1, 0, 1, 0, 1, 0, 0, 0]",120,59,61,6,6,0.1016949152542373,0.09836065573770492
"[1, 1, 0, 1, 1, 0, 0, 1, 0, 0, 0, 1, 0, 1, 1]",112,57,55,7,2,0.12280701754385964,0.03636363636363636
"[1, 0, 1, 0, 0, 1, 1, 1, 0, 1, 1, 1, 0, 0, 1]",158,65,93,6,5,0.09230769230769231,0.053763440860215055
"[1, 0, 0, 0, 1, 1, 1, 0, 1, 0, 1, 0, 1, 1, 1]",161,71,90,5,6,0.07042253521126761,0.06666666666666667
"[0, 0, 1, 1, 1, 0, 0, 0, 1, 1, 1, 0, 1, 0, 1]",116,58,58,5,8,0.08620689655172414,0.13793103448275862
"[0, 1, 1, 0, 1, 1, 0, 1, 1, 0, 1, 0, 0, 1, 0]",97,44,53,5,2,0.11363636363636363,0.03773584905660377
"[0, 0, 1, 0, 1, 1, 0, 1, 1, 0, 1, 1, 0, 1, 0]",111,58,53,3,6,0.05172413793103448,0.11320754716981132
"[1, 0, 1, 1, 0, 0, 1, 1, 0, 0, 1, 0, 1, 1, 0]",120,61,59,3,4,0.04918032786885246,0.06779661016949153
"[0, 0, 0, 0, 1, 1, 0, 1, 1, 0, 0, 1, 0, 0, 0]",314,197,117,14,7,0.07106598984771574,0.05982905982905983
"[0, 0, 0, 0, 1, 0, 1, 1, 1, 1, 1, 1, 0, 1, 1]",171,75,96,3,13,0.04,0.13541666666666666
"[1, 1, 1, 1, 0, 1, 0, 1, 0, 1, 1, 1, 0, 1, 1]",545,165,380,14,38,0.08484848484848485,0.1
"[0, 0, 0, 1, 0, 0, 1, 1, 1, 0, 0, 0, 1, 1, 0]",172,107,65,11,6,0.102803738317757,0.09230769230769231
"[1, 1, 0, 0, 1, 1, 1, 1, 0, 1, 1, 0, 1, 0, 0]",193,89,104,8,6,0.0898876404494382,0.057692307692307696
"[1, 0, 0, 0, 1, 1, 0, 1, 0, 1, 1, 1, 0, 0, 1]",125,57,68,6,1,0.10526315789473684,0.014705882352941176
"[0, 1, 1, 1, 0, 1, 1, 1, 0, 0, 0, 1, 1, 0, 0]",133,69,64,3,8,0.043478260869565216,0.125
"[0, 0, 1, 1, 1, 0, 1, 1, 1, 0, 0, 0, 1, 1, 0]",127,64,63,7,5,0.109375,0.07936507936507936
"[0, 0, 1, 1, 1, 0, 0, 0, 0, 1, 1, 0, 1, 0, 0]",185,119,66,7,1,0.058823529411764705,0.015151515151515152
"[0, 0, 1, 1, 0, 1, 1, 0, 0, 1, 0, 0, 1, 1, 1]",179,90,89,9,8,0.1,0.0898876404494382
"[1, 1, 1, 1, 1, 0, 0, 1, 0, 0, 1, 0, 0, 1, 0]",125,56,69,4,6,0.07142857142857142,0.08695652173913043
"[1, 1, 0, 1, 1, 1, 1, 0, 0, 0, 1, 0, 0, 1, 1]",159,58,101,4,7,0.06896551724137931,0.06930693069306931
"[1, 0, 0, 0, 0, 0, 1, 1, 1, 0, 0, 0, 1, 0, 1]",154,86,68,6,1,0.06976744186046512,0.014705882352941176
"[0, 0, 0, 1, 0, 0, 0, 0, 0, 1, 0, 1, 1, 1, 1]",263,180,83,19,5,0.10555555555555556,0.060240963855421686
"[0, 0, 0, 1, 0, 0, 1, 0, 1, 1, 0, 0, 1, 1, 0]",207,123,84,9,6,0.07317073170731707,0.07142857142857142
"[1, 0, 1, 0, 1, 0, 1, 0, 1, 0, 0, 0, 0, 1, 1]",140,65,75,6,8,0.09230769230769231,0.10666666666666667
"[0, 1, 1, 1, 0, 0, 1, 0, 0, 1, 0, 1, 1, 0, 1]",109,58,51,8,4,0.13793103448275862,0.0784313725490196
"[1, 0, 1, 0, 0, 0, 0, 0, 1, 0, 0, 0, 0, 1, 1]",313,215,98,26,6,0.12093023255813953,0.061224489795918366
"[0, 1, 0, 0, 0, 1, 1, 0, 1, 1, 0, 1, 0, 0, 1]",102,57,45,8,4,0.14035087719298245,0.08888888888888889
"[0, 1, 1, 0, 0, 1, 1, 0, 1, 1, 1, 1, 0, 1, 0]",160,65,95,7,16,0.1076923076923077,0.16842105263157894
"[0, 0, 1, 1, 1, 0, 1, 1, 0, 1, 0, 0, 1, 0, 0]",100,53,47,5,9,0.09433962264150944,0.19148936170212766
"[0, 0, 1, 0, 0, 0, 1, 0, 0, 1, 0, 0, 1, 0, 1]",193,116,77,9,11,0.07758620689655173,0.14285714285714285
"[1, 0, 1, 1, 1, 0, 0, 0, 0, 1, 1, 0, 1, 1, 1]",216,89,127,9,19,0.10112359550561797,0.14960629921259844
"[0, 0, 0, 1, 0, 0, 1, 1, 1, 1, 0, 0, 1, 0, 1]",152,90,62,8,4,0.08888888888888889,0.06451612903225806
"[0, 1, 1, 0, 0, 0, 1, 1, 1, 0, 1, 1, 1, 0, 0]",132,58,74,6,13,0.10344827586206896,0.17567567567567569
"[0, 0, 0, 0, 0, 1, 1, 0, 1, 0, 1, 0, 1, 0, 1]",155,98,57,10,3,0.10204081632653061,0.05263157894736842
"[0, 0, 1, 0, 0, 1, 1, 1, 1, 0, 0, 0, 0, 1, 1]",442,247,195,29,13,0.11740890688259109,0.06666666666666667
"[0, 1, 0, 0, 0, 1, 1, 1, 1, 1, 0, 0, 0, 0, 1]",221,124,97,7,8,0.056451612903225805,0.08247422680412371
"[1, 1, 0, 1, 1, 1, 0, 0, 0, 0, 1, 1, 1, 0, 0]",134,69,65,4,5,0.057971014492753624,0.07692307692307693
"[1, 1, 0, 0, 1, 0, 1, 0, 0, 1, 1, 0, 0, 1, 1]",182,88,94,11,10,0.125,0.10638297872340426
"[1, 1, 1, 0, 0, 1, 0, 1, 0, 0, 1, 1, 0, 0, 1]",152,69,83,6,7,0.08695652173913043,0.08433734939759036
"[1, 0, 0, 0, 1, 1, 0, 1, 0, 0, 1, 0, 0, 1, 1]",130,73,57,4,6,0.0547945205479452,0.10526315789473684
"[0, 0, 0, 0, 0, 1, 1, 1, 0, 0, 0, 1, 1, 0, 1]",187,120,67,8,8,0.06666666666666667,0.11940298507462686
"[0, 1, 0, 0, 0, 1, 1, 1, 1, 0, 1, 0, 0, 0, 0]",182,108,74,5,6,0.046296296296296294,0.08108108108108109
"[0, 1, 0, 0, 1, 1, 0, 0, 1, 0, 1, 0, 1, 1, 0]",113,62,51,4,6,0.06451612903225806,0.11764705882352941
"[1, 0, 1, 1, 1, 1, 1, 1, 1, 0, 1, 0, 0, 0, 1]",247,93,154,8,8,0.08602150537634409,0.05194805194805195
"[1, 0, 1, 1, 0, 0, 1, 1, 1, 1, 1, 0, 1, 0, 0]",161,70,91,5,10,0.07142857142857142,0.10989010989010989
"[1, 0, 0, 1, 1, 0, 0, 1, 1, 0, 1, 0, 0, 0, 0]",236,113,123,11,13,0.09734513274336283,0.10569105691056911
"[0, 1, 0, 1, 0, 0, 0, 0, 1, 1, 1, 0, 0, 0, 0]",317,196,121,15,10,0.07653061224489796,0.08264462809917356
"[0, 0, 1, 1, 1, 0, 1, 1, 1, 0, 0, 1, 1, 0, 0]",197,99,98,14,6,0.1414141414141414,0.061224489795918366
"[0, 0, 1, 1, 1, 1, 0, 1, 1, 0, 0, 0, 1, 0, 0]",121,66,55,6,10,0.09090909090909091,0.18181818181818182
"[0, 0, 1, 0, 1, 1, 1, 0, 1, 0, 0, 0, 0, 1, 0]",142,80,62,8,7,0.1,0.11290322580645161
"[1, 0, 0, 1, 0, 1, 1, 1, 0, 1, 0, 0, 0, 0, 1]",129,68,61,9,3,0.1323529411764706,0.04918032786885246
"[1, 1, 0, 1, 0, 0, 0, 1, 0, 1, 1, 0, 1, 0, 0]",108,60,48,4,5,0.06666666666666667,0.10416666666666667
"[0, 0, 1, 1, 0, 0, 1, 0, 0, 1, 0, 1, 0, 1, 1]",126,75,51,7,5,0.09333333333333334,0.09803921568627451
"[1, 1, 1, 0, 1, 0, 1, 0, 0, 0, 0, 0, 0, 0, 1]",179,106,73,10,4,0.09433962264150944,0.0547945205479452
"[0, 1, 0, 1, 0, 1, 0, 1, 0, 0, 0, 1, 1, 1, 0]",118,54,64,1,8,0.018518518518518517,0.125
"[1, 1, 0, 0, 1, 1, 0, 0, 0, 1, 1, 0, 0, 1, 1]",289,128,161,8,15,0.0625,0.09316770186335403
"[0, 1, 0, 1, 0, 1, 0, 0, 1, 1, 0, 1, 1, 0, 0]",130,68,62,7,7,0.10294117647058823,0.11290322580645161
"[0, 0, 0, 1, 0, 0, 0, 1, 1, 1, 1, 1, 1, 1, 0]",184,93,91,8,10,0.08602150537634409,0.10989010989010989
"[1, 0, 0, 0, 0, 1, 1, 1, 1, 0, 1, 1, 0, 0, 1]",190,55,135,3,14,0.05454545454545454,0.1037037037037037
"[0, 1, 1, 0, 0, 1, 1, 0, 1, 0, 0, 1, 1, 0, 0]",192,105,87,8,7,0.0761904761904762,0.08045977011494253
"[1, 1, 0, 1, 0, 1, 0, 1, 0, 1, 1, 1, 0, 1, 0]",118,53,65,4,6,0.07547169811320754,0.09230769230769231
"[0, 0, 1, 0, 1, 1, 0, 1, 1, 1, 1, 1, 0, 1, 1]",241,84,157,10,17,0.11904761904761904,0.10828025477707007
"[1, 0, 1, 1, 0, 1, 0, 1, 0, 1, 1, 0, 1, 1, 1]",231,94,137,4,14,0.0425531914893617,0.10218978102189781
"[0, 1, 0, 1, 0, 1, 1, 1, 0, 0, 0, 1, 1, 1, 0]",114,65,49,6,1,0.09230769230769231,0.02040816326530612
"[0, 0, 1, 1, 1, 0, 1, 1, 0, 0, 1, 0, 1, 0, 1]",105,42,63,1,3,0.023809523809523808,0.047619047619047616
"[1, 0, 0, 1, 1, 1, 0, 1, 1, 0, 0, 0, 1, 0, 1]",108,45,63,2,5,0.044444444444444446,0.07936507936507936
"[0, 1, 0, 0, 1, 0, 0, 0, 1, 1, 0, 1, 1, 0, 0]",140,68,72,6,8,0.08823529411764706,0.1111111111111111
"[0, 0, 0, 1, 1, 1, 0, 1, 0, 0, 1, 0, 1, 1, 0]",105,46,59,5,9,0.10869565217391304,0.15254237288135594
"[0, 1, 0, 0, 0, 1, 0, 1, 0, 0, 0, 1, 1, 0, 0]",314,234,80,29,4,0.12393162393162394,0.05
"[0, 0, 1, 0, 0, 0, 1, 1, 0, 1, 1, 1, 1, 1, 1]",201,104,97,9,7,0.08653846153846154,0.07216494845360824
"[1, 1, 1, 0, 0, 1, 0, 0, 0, 1, 1, 0, 1, 1, 1]",188,69,119,4,13,0.057971014492753624,0.1092436974789916
"[1, 0, 0, 1, 0, 0, 1, 0, 0, 0, 1, 0, 0, 1, 1]",182,100,82,13,9,0.13,0.10975609756097561
"[0, 0, 1, 0, 1, 1, 1, 0, 1, 0, 0, 0, 0, 0, 1]",153,93,60,9,8,0.0967741935483871,0.13333333333333333
"[0, 1, 1, 1, 1, 0, 0, 0, 1, 0, 1, 1, 1, 1, 0]",179,97,82,10,9,0.10309278350515463,0.10975609756097561
"[0, 0, 1, 1, 1, 0, 1, 1, 0, 0, 1, 1, 0, 1, 0]",113,58,55,5,7,0.08620689655172414,0.12727272727272726
"[1, 0, 1, 0, 0, 1, 0, 0, 0, 0, 1, 0, 1, 1, 0]",147,77,70,7,4,0.09090909090909091,0.05714285714285714
"[1, 0, 0, 1, 1, 1, 0, 0, 0, 0, 1, 1, 1, 1, 1]",450,164,286,11,29,0.06707317073170732,0.10139860139860139
"[0, 0, 1, 0, 0, 1, 1, 1, 0, 0, 0, 0, 1, 1, 1]",264,155,109,18,11,0.11612903225806452,0.10091743119266056
"[0, 1, 0, 1, 0, 1, 1, 0, 1, 1, 1, 0, 0, 0, 1]",123,62,61,4,4,0.06451612903225806,0.06557377049180328
"[1, 1, 0, 1, 0, 1, 0, 0, 0, 1, 0, 1, 1, 1, 0]",102,37,65,3,7,0.08108108108108109,0.1076923076923077
"[0, 0, 0, 1, 1, 1, 1, 0, 0, 1, 0, 0, 0, 1, 0]",185,122,63,12,10,0.09836065573770492,0.15873015873015872
"[1, 0, 0, 0, 0, 1, 1, 1, 1, 0, 0, 1, 0, 0, 0]",263,103,160,11,18,0.10679611650485436,0.1125
"[1, 1, 1, 1, 1, 0, 1, 0, 1, 0, 1, 0, 0, 0, 0]",130,52,78,4,9,0.07692307692307693,0.11538461538461539
"[0, 1, 1, 1, 1, 1, 0, 0, 1, 1, 0, 0, 1, 1, 0]",493,208,285,15,21,0.07211538461538461,0.07368421052631578
"[1, 1, 0, 1, 0, 1, 0, 0, 1, 1, 1, 1, 0, 0, 0]",192,85,107,6,10,0.07058823529411765,0.09345794392523364
"[1, 1, 0, 0, 0, 0, 0, 0, 1, 1, 1, 1, 0, 1, 1]",502,218,284,22,29,0.10091743119266056,0.10211267605633803
"[0, 0, 0, 0, 1, 1, 1, 0, 0, 1, 1, 0, 1, 0, 1]",126,71,55,7,5,0.09859154929577464,0.09090909090909091
"[1, 0, 1, 0, 1, 1, 0, 1, 1, 0, 0, 1, 1, 0, 0]",184,97,87,11,9,0.1134020618556701,0.10344827586206896
"[1, 1, 1, 0, 0, 0, 0, 1, 1, 0, 1, 1, 1, 1, 0]",235,78,157,9,14,0.11538461538461539,0.08917197452229299
"[0, 0, 1, 1, 1, 0, 0, 0, 0, 1, 1, 0, 1, 1, 1]",190,92,98,8,8,0.08695652173913043,0.08163265306122448
"[1, 0, 0, 1, 1, 1, 0, 0, 0, 0, 1, 1, 0, 1, 1]",168,83,85,9,5,0.10843373493975904,0.058823529411764705
"[1, 0, 1, 0, 0, 1, 1, 0, 0, 1, 0, 0, 1, 1, 1]",176,83,93,6,7,0.07228915662650602,0.07526881720430108
"[1, 1, 1, 0, 0, 1, 0, 0, 0, 1, 1, 0, 1, 0, 0]",105,53,52,7,5,0.1320754716981132,0.09615384615384616
"[0, 0, 1, 1, 1, 0, 1, 1, 1, 1, 1, 0, 0, 1, 0]",159,73,86,9,9,0.1232876712328767,0.10465116279069768
"[1, 1, 1, 0, 1, 0, 0, 0, 0, 0, 1, 1, 1, 0, 0]",155,74,81,4,5,0.05405405405405406,0.06172839506172839
"[1, 1, 1, 0, 0, 1, 1, 1, 1, 0, 1, 0, 0, 0, 0]",210,77,133,7,14,0.09090909090909091,0.10526315789473684
"[0, 0, 1, 0, 1, 0, 1, 1, 1, 0, 1, 1, 1, 0, 1]",128,51,77,3,11,0.058823529411764705,0.14285714285714285
"[1, 0, 1, 1, 0, 0, 1, 0, 0, 0, 1, 0, 0, 0, 0]",259,165,94,19,4,0.11515151515151516,0.0425531914893617
"[0, 1, 1, 0, 0, 0, 1, 0, 1, 1, 0, 0, 1, 1, 1]",195,101,94,7,10,0.06930693069306931,0.10638297872340426
"[0, 1, 0, 0, 0, 0, 0, 1, 0, 1, 1, 0, 1, 1, 1]",165,88,77,8,8,0.09090909090909091,0.1038961038961039
"[0, 1, 0, 0, 1, 1, 1, 0, 0, 0, 1, 1, 1, 1, 0]",124,67,57,4,8,0.05970149253731343,0.14035087719298245
"[1, 0, 0, 0, 0, 1, 0, 0, 1, 0, 0, 1, 1, 1, 0]",136,76,60,9,3,0.11842105263157894,0.05
"[1, 1, 0, 1, 0, 1, 1, 1, 0, 0, 1, 0, 0, 1, 1]",174,61,113,3,10,0.04918032786885246,0.08849557522123894
"[1, 0, 0, 1, 1, 1, 1, 0, 0, 1, 1, 1, 0, 0, 0]",223,70,153,8,9,0.11428571428571428,0.058823529411764705
"[1, 0, 0, 1, 0, 1, 1, 1, 0, 1, 1, 0, 0, 0, 0]",153,68,85,1,11,0.014705882352941176,0.12941176470588237
"[0, 1, 1, 0, 0, 0, 0, 0, 1, 0, 0, 1, 0, 1, 1]",232,155,77,12,6,0.07741935483870968,0.07792207792207792
"[0, 1, 1, 0, 1, 0, 1, 0, 1, 1, 0, 0, 0, 1, 1]",135,73,62,6,8,0.0821917808219178,0.12903225806451613
"[1, 1, 0, 0, 0, 0, 0, 1, 0, 1, 0, 1, 1, 1, 1]",195,107,88,15,11,0.14018691588785046,0.125
"[0, 1, 1, 0, 0, 1, 0, 1, 0, 1, 1, 0, 1, 1, 1]",192,96,96,7,10,0.07291666666666667,0.10416666666666667
"[1, 1, 1, 1, 0, 1, 0, 0, 0, 0, 1, 1, 1, 0, 0]",154,68,86,8,5,0.11764705882352941,0.05813953488372093
"[0, 1, 1, 0, 0, 1, 1, 0, 1, 0, 0, 0, 1, 1, 0]",134,73,61,4,3,0.0547945205479452,0.04918032786885246
"[1, 0, 1, 1, 0, 0, 1, 1, 0, 1, 0, 0, 0, 1, 1]",136,70,66,8,4,0.11428571428571428,0.06060606060606061
"[1, 0, 1, 0, 1, 1, 0, 1, 0, 1, 1, 0, 1, 1, 0]",122,50,72,2,6,0.04,0.08333333333333333
"[0, 0, 0, 0, 0, 0, 1, 1, 1, 1, 0, 1, 0, 1, 1]",327,186,141,17,13,0.0913978494623656,0.09219858156028368
"[0, 1, 0, 1, 0, 1, 0, 1, 1, 0, 0, 1, 0, 0, 1]",110,60,50,5,3,0.08333333333333333,0.06
"[0, 0, 1, 0, 1, 0, 0, 1, 1, 0, 0, 0, 1, 0, 1]",149,98,51,7,6,0.07142857142857142,0.11764705882352941
"[0, 1, 1, 1, 1, 1, 0, 0, 0, 1, 0, 1, 1, 0, 1]",134,76,58,9,3,0.11842105263157894,0.05172413793103448
"[1, 1, 0, 0, 1, 1, 1, 1, 0, 0, 0, 1, 1, 0, 1]",276,98,178,14,19,0.14285714285714285,0.10674157303370786
"[1, 0, 1, 1, 0, 0, 1, 0, 0, 0, 0, 1, 1, 0, 1]",119,58,61,0,8,0.0,0.13114754098360656
"[0, 0, 1, 1, 0, 1, 1, 1, 0, 0, 1, 0, 0, 1, 0]",97,51,46,3,6,0.058823529411764705,0.13043478260869565
"[0, 0, 1, 1, 0, 1, 1, 0, 1, 0, 0, 1, 0, 1, 1]",117,55,62,7,4,0.12727272727272726,0.06451612903225806
"[0, 1, 1, 0, 0, 0, 1, 1, 1, 1, 0, 1, 0, 0, 1]",109,53,56,6,6,0.11320754716981132,0.10714285714285714
"[0, 0, 1, 0, 0, 0, 0, 1, 1, 0, 1, 0, 1, 1, 1]",160,99,61,8,3,0.08080808080808081,0.04918032786885246
"[1, 0, 0, 0, 1, 0, 0, 0, 0, 1, 1, 0, 1, 0, 1]",140,83,57,6,5,0.07228915662650602,0.08771929824561403
"[1, 1, 1, 1, 0, 0, 0, 1, 0, 0, 0, 0, 1, 0, 1]",140,82,58,6,5,0.07317073170731707,0.08620689655172414
"[0, 0, 0, 1, 0, 1, 1, 0, 0, 1, 1, 0, 1, 0, 0]",149,83,66,9,7,0.10843373493975904,0.10606060606060606
"[1, 1, 1, 0, 1, 0, 0, 0, 0, 1, 1, 0, 0, 1, 0]",130,64,66,5,5,0.078125,0.07575757575757576
"[1, 0, 0, 0, 1, 0, 1, 0, 0, 0, 1, 0, 1, 1, 1]",166,90,76,7,9,0.07777777777777778,0.11842105263157894
"[1, 0, 0, 1, 1, 0, 0, 1, 0, 1, 1, 1, 1, 0, 0]",171,63,108,6,10,0.09523809523809523,0.09259259259259259
"[0, 0, 0, 0, 1, 1, 1, 0, 0, 1, 1, 0, 0, 0, 1]",193,114,79,8,2,0.07017543859649122,0.02531645569620253
"[1, 1, 1, 0, 0, 0, 1, 0, 1, 1, 1, 0, 1, 1, 1]",299,97,202,8,23,0.08247422680412371,0.11386138613861387
"[0, 0, 1, 0, 0, 0, 0, 1, 1, 0, 1, 0, 1, 1, 0]",120,75,45,11,1,0.14666666666666667,0.022222222222222223
"[1, 0, 0, 1, 1, 1, 0, 0, 0, 1, 0, 0, 1, 0, 1]",110,59,51,8,4,0.13559322033898305,0.0784313725490196
"[1, 0, 1, 0, 0, 0, 1, 0, 0, 0, 0, 1, 1, 0, 1]",139,81,58,4,6,0.04938271604938271,0.10344827586206896
"[1, 1, 0, 1, 0, 0, 0, 1, 0, 0, 0, 0, 1, 1, 0]",165,97,68,13,7,0.13402061855670103,0.10294117647058823
"[0, 1, 0, 1, 0, 0, 1, 0, 0, 1, 0, 0, 0, 1, 0]",227,149,78,13,6,0.087248322147651,0.07692307692307693
"[1, 0, 1, 0, 0, 1, 1, 1, 0, 1, 1, 0, 0, 1, 1]",174,77,97,5,10,0.06493506493506493,0.10309278350515463
"[1, 0, 1, 0, 0, 0, 1, 0, 1, 0, 1, 1, 1, 0, 1]",99,52,47,7,7,0.1346153846153846,0.14893617021276595
"[1, 0, 1, 1, 0, 1, 1, 0, 0, 0, 1, 1, 0, 0, 0]",145,79,66,5,2,0.06329113924050633,0.030303030303030304
"[1, 0, 1, 1, 0, 1, 1, 0, 1, 1, 0, 1, 0, 1, 0]",129,60,69,6,5,0.1,0.07246376811594203
"[1, 1, 0, 0, 1, 1, 1, 0, 0, 0, 0, 1, 0, 0, 1]",138,71,67,8,6,0.11267605633802817,0.08955223880597014
"[0, 1, 0, 0, 1, 0, 0, 1, 1, 0, 0, 0, 1, 0, 1]",165,101,64,7,7,0.06930693069306931,0.109375
"[1, 0, 0, 0, 1, 0, 1, 0, 1, 1, 0, 1, 1, 1, 0]",119,61,58,5,7,0.08196721311475409,0.1206896551724138
"[0, 0, 1, 1, 1, 0, 0, 0, 1, 0, 1, 0, 1, 1, 0]",112,51,61,11,7,0.21568627450980393,0.11475409836065574
"[0, 1, 1, 1, 0, 0, 1, 1, 0, 0, 1, 1, 1, 0, 0]",175,85,90,10,13,0.11764705882352941,0.14444444444444443
"[1, 0, 0, 1, 0, 0, 1, 1, 1, 0, 1, 0, 1, 0, 1]",86,37,49,0,5,0.0,0.10204081632653061
"[1, 0, 0, 1, 0, 1, 1, 1, 0, 0, 0, 1, 1, 0, 0]",123,54,69,3,9,0.05555555555555555,0.13043478260869565
"[1, 1, 0, 0, 1, 0, 1, 0, 0, 1, 1, 1, 1, 1, 0]",186,79,107,7,9,0.08860759493670886,0.08411214953271028
"[1, 1, 0, 0, 1, 0, 0, 1, 1, 0, 0, 1, 0, 1, 0]",106,54,52,5,4,0.09259259259259259,0.07692307692307693
"[0, 1, 1, 0, 1, 0, 1, 1, 0, 0, 0, 1, 1, 1, 1]",192,87,105,13,6,0.14942528735632185,0.05714285714285714
"[0, 0, 1, 1, 1, 0, 0, 1, 1, 0, 0, 0, 1, 1, 1]",212,104,108,12,8,0.11538461538461539,0.07407407407407407
"[0, 0, 1, 0, 0, 1, 1, 0, 0, 1, 1, 1, 0, 1, 0]",118,58,60,10,6,0.1724137931034483,0.1
"[0, 1, 1, 0, 1, 0, 0, 1, 1, 0, 0, 1, 1, 1, 1]",356,173,183,15,24,0.08670520231213873,0.13114754098360656
"[1, 0, 1, 1, 1, 1, 0, 0, 0, 1, 1, 0, 0, 1, 1]",261,102,159,16,13,0.1568627450980392,0.08176100628930817
"[0, 1, 1, 1, 0, 1, 0, 0, 1, 0, 0, 1, 1, 0, 1]",110,63,47,10,4,0.15873015873015872,0.0851063829787234
"[0, 0, 0, 1, 1, 1, 1, 0, 0, 0, 1, 1, 0, 0, 0]",286,206,80,27,6,0.13106796116504854,0.075
"[1, 0, 0, 1, 0, 0, 0, 1, 1, 1, 0, 0, 0, 1, 1]",162,81,81,11,6,0.13580246913580246,0.07407407407407407
"[0, 0, 1, 1, 1, 0, 0, 1, 0, 0, 0, 1, 1, 1, 0]",109,56,53,6,4,0.10714285714285714,0.07547169811320754
"[1, 0, 1, 1, 1, 0, 0, 1, 1, 1, 0, 0, 1, 0, 0]",129,49,80,4,4,0.08163265306122448,0.05
"[1, 0, 1, 0, 1, 1, 0, 1, 1, 0, 0, 1, 0, 0, 1]",119,57,62,4,4,0.07017543859649122,0.06451612903225806
"[1, 0, 0, 1, 0, 1, 0, 1, 1, 0, 1, 1, 0, 0, 1]",128,62,66,4,3,0.06451612903225806,0.045454545454545456
"[0, 0, 1, 1, 0, 1, 0, 1, 0, 0, 0, 1, 1, 1, 0]",113,68,45,5,9,0.07352941176470588,0.2
"[0, 0, 1, 1, 1, 0, 1, 0, 1, 1, 1, 1, 0, 0, 1]",221,98,123,10,16,0.10204081632653061,0.13008130081300814
"[1, 1, 1, 1, 1, 1, 1, 0, 1, 1, 0, 0, 1, 1, 0]",759,205,554,17,51,0.08292682926829269,0.09205776173285199
"[0, 1, 1, 1, 1, 1, 0, 1, 1, 0, 0, 0, 0, 1, 1]",243,105,138,15,14,0.14285714285714285,0.10144927536231885
"[1, 0, 0, 0, 1, 0, 1, 1, 0, 0, 0, 0, 1, 0, 1]",140,85,55,11,9,0.12941176470588237,0.16363636363636364
"[0, 1, 1, 1, 0, 0, 1, 0, 0, 1, 0, 1, 0, 0, 0]",147,83,64,7,4,0.08433734939759036,0.0625
"[0, 0, 1, 0, 1, 0, 1, 0, 1, 1, 1, 0, 0, 1, 0]",110,60,50,11,6,0.18333333333333332,0.12
"[1, 1, 1, 0, 0, 0, 1, 0, 0, 0, 1, 1, 0, 1, 0]",117,59,58,5,5,0.0847457627118644,0.08620689655172414
"[0, 0, 0, 1, 1, 0, 0, 1, 0, 0, 0, 1, 1, 1, 0]",158,108,50,6,5,0.05555555555555555,0.1
"[1, 0, 1, 1, 1, 0, 0, 1, 1, 1, 0, 1, 0, 1, 0]",131,50,81,6,9,0.12,0.1111111111111111
"[0, 0, 0, 0, 0, 1, 1, 0, 0, 0, 1, 1, 0, 1, 0]",335,244,91,24,16,0.09836065573770492,0.17582417582417584
"[1, 0, 0, 0, 0, 0, 1, 1, 0, 0, 0, 1, 1, 0, 1]",164,96,68,11,9,0.11458333333333333,0.1323529411764706
"[0, 0, 1, 1, 1, 0, 1, 1, 0, 1, 0, 1, 0, 1, 1]",153,61,92,9,12,0.14754098360655737,0.13043478260869565
"[0, 1, 0, 1, 1, 0, 0, 0, 0, 1, 1, 1, 1, 0, 1]",124,64,60,4,6,0.0625,0.1
"[1, 1, 1, 1, 1, 1, 0, 0, 0, 1, 0, 1, 0, 0, 0]",192,83,109,2,8,0.024096385542168676,0.07339449541284404
"[0, 1, 0, 0, 1, 1, 0, 0, 0, 1, 0, 1, 0, 1, 1]",129,67,62,4,9,0.05970149253731343,0.14516129032258066
"[1, 0, 0, 1, 0, 0, 1, 1, 0, 0, 0, 1, 0, 1, 0]",163,103,60,8,10,0.07766990291262135,0.16666666666666666
"[0, 1, 1, 1, 1, 1, 1, 0, 0, 0, 1, 0, 0, 1, 0]",167,103,64,10,6,0.0970873786407767,0.09375
"[1, 1, 1, 0, 0, 0, 0, 1, 0, 0, 1, 1, 1, 1, 0]",198,82,116,19,16,0.23170731707317074,0.13793103448275862
"[1, 0, 0, 0, 1, 1, 0, 0, 0, 1, 1, 1, 0, 0, 1]",139,71,68,8,6,0.11267605633802817,0.08823529411764706
"[1, 0, 0, 1, 1, 0, 1, 0, 1, 1, 1, 1, 0, 0, 0]",159,75,84,11,9,0.14666666666666667,0.10714285714285714
"[1, 1, 1, 1, 0, 0, 0, 1, 0, 1, 0, 0, 1, 1, 1]",257,96,161,10,22,0.10416666666666667,0.13664596273291926
"[1, 0, 0, 1, 1, 0, 1, 0, 0, 0, 0, 0, 1, 0, 1]",146,87,59,12,4,0.13793103448275862,0.06779661016949153
"[1, 0, 0, 0, 1, 1, 1, 1, 1, 1, 1, 0, 1, 0, 1]",276,106,170,7,24,0.0660377358490566,0.1411764705882353
"[0, 1, 0, 1, 0, 1, 0, 0, 1, 1, 0, 0, 0, 1, 1]",120,64,56,6,6,0.09375,0.10714285714285714
"[0, 1, 0, 0, 1, 0, 0, 0, 1, 1, 1, 0, 1, 0, 1]",115,63,52,6,3,0.09523809523809523,0.057692307692307696
"[0, 0, 1, 0, 0, 1, 0, 0, 0, 1, 1, 1, 0, 1, 0]",140,79,61,10,7,0.12658227848101267,0.11475409836065574
"[1, 0, 0, 1, 1, 1, 0, 0, 0, 0, 0, 0, 1, 0, 1]",167,91,76,6,9,0.06593406593406594,0.11842105263157894
"[1, 1, 0, 0, 1, 0, 1, 0, 0, 1, 1, 1, 0, 0, 0]",117,70,47,5,7,0.07142857142857142,0.14893617021276595
"[0, 1, 1, 1, 0, 0, 1, 0, 1, 1, 1, 0, 0, 0, 1]",100,46,54,4,4,0.08695652173913043,0.07407407407407407
"[1, 0, 0, 0, 1, 1, 0, 0, 1, 0, 0, 1, 1, 1, 0]",110,58,52,5,7,0.08620689655172414,0.1346153846153846
"[0, 1, 0, 1, 0, 0, 0, 0, 0, 1, 1, 0, 1, 1, 1]",143,82,61,6,6,0.07317073170731707,0.09836065573770492
"[1, 1, 0, 1, 1, 0, 1, 1, 0, 1, 0, 1, 0, 1, 0]",142,58,84,6,6,0.10344827586206896,0.07142857142857142
"[0, 0, 1, 0, 0, 1, 1, 0, 1, 1, 1, 1, 1, 1, 0]",160,78,82,5,12,0.0641025641025641,0.14634146341463414
"[0, 0, 1, 0, 1, 1, 0, 1, 1, 1, 1, 0, 1, 1, 1]",261,87,174,9,19,0.10344827586206896,0.10919540229885058
"[1, 1, 1, 1, 0, 0, 0, 0, 0, 0, 1, 0, 0, 1, 0]",280,163,117,11,11,0.06748466257668712,0.09401709401709402
"[0, 0, 0, 0, 0, 1, 0, 0, 0, 1, 1, 1, 1, 1, 0]",218,130,88,13,7,0.1,0.07954545454545454
"[0, 1, 1, 1, 1, 0, 0, 0, 1, 1, 1, 1, 0, 0, 0]",220,117,103,16,11,0.13675213675213677,0.10679611650485436
"[1, 1, 1, 0, 0, 0, 0, 0, 1, 0, 1, 0, 0, 1, 1]",198,84,114,6,11,0.07142857142857142,0.09649122807017543
"[0, 0, 0, 1, 0, 1, 0, 1, 1, 1, 0, 0, 0, 1, 1]",131,81,50,3,7,0.037037037037037035,0.14
"[1, 0, 0, 0, 1, 0, 1, 0, 1, 1, 1, 0, 0, 0, 1]",96,55,41,6,3,0.10909090909090909,0.07317073170731707
"[1, 1, 0, 0, 0, 0, 0, 1, 0, 0, 1, 0, 1, 0, 1]",162,98,64,11,4,0.11224489795918367,0.0625
"[1, 1, 0, 0, 1, 0, 1, 1, 0, 0, 0, 0, 1, 1, 1]",229,110,119,8,7,0.07272727272727272,0.058823529411764705
"[0, 1, 1, 0, 0, 0, 1, 0, 1, 1, 0, 1, 0, 0, 0]",175,101,74,7,5,0.06930693069306931,0.06756756756756757
"[1, 0, 1, 0, 1, 0, 1, 1, 1, 0, 1, 1, 1, 0, 1]",220,80,140,5,15,0.0625,0.10714285714285714
"[0, 0, 1, 1, 1, 0, 1, 1, 1, 0, 0, 1, 1, 1, 0]",168,68,100,8,9,0.11764705882352941,0.09
"[0, 1, 1, 1, 0, 1, 1, 1, 1, 0, 0, 0, 0, 0, 0]",280,145,135,16,16,0.1103448275862069,0.11851851851851852
"[1, 0, 1, 0, 0, 1, 1, 1, 0, 1, 0, 0, 0, 1, 1]",122,59,63,7,5,0.11864406779661017,0.07936507936507936
"[1, 1, 0, 1, 0, 0, 0, 0, 0, 0, 1, 0, 0, 0, 1]",246,167,79,13,7,0.07784431137724551,0.08860759493670886
"[0, 1, 1, 1, 1, 1, 1, 1, 0, 1, 0, 0, 1, 1, 0]",279,120,159,10,20,0.08333333333333333,0.12578616352201258
"[0, 1, 1, 0, 0, 0, 0, 1, 1, 0, 1, 1, 0, 1, 0]",143,87,56,7,4,0.08045977011494253,0.07142857142857142
"[1, 1, 1, 0, 1, 1, 0, 0, 1, 0, 1, 0, 1, 0, 0]",112,57,55,7,3,0.12280701754385964,0.05454545454545454
"[0, 0, 0, 0, 1, 0, 0, 0, 1, 1, 1, 0, 0, 0, 1]",263,175,88,16,9,0.09142857142857143,0.10227272727272728
"[0, 0, 1, 1, 1, 0, 1, 1, 0, 1, 1, 1, 1, 0, 0]",179,86,93,10,14,0.11627906976744186,0.15053763440860216
"[1, 1, 1, 1, 1, 1, 0, 1, 1, 0, 0, 1, 0, 0, 0]",176,65,111,9,12,0.13846153846153847,0.10810810810810811
"[0, 0, 1, 0, 0, 1, 0, 0, 0, 0, 1, 1, 1, 0, 0]",292,193,99,21,11,0.10880829015544041,0.1111111111111111
"[1, 1, 0, 0, 0, 1, 1, 1, 0, 0, 0, 0, 0, 1, 1]",199,100,99,11,9,0.11,0.09090909090909091
"[1, 0, 0, 0, 1, 0, 0, 0, 1, 1, 1, 1, 0, 1, 1]",118,54,64,4,3,0.07407407407407407,0.046875
"[1, 0, 0, 1, 0, 1, 1, 1, 0, 1, 1, 0, 1, 1, 0]",139,58,81,4,9,0.06896551724137931,0.1111111111111111
"[1, 0, 1, 0, 1, 0, 1, 0, 1, 1, 1, 0, 0, 0, 1]",101,42,59,2,5,0.047619047619047616,0.0847457627118644
"[1, 1, 1, 0, 0, 0, 0, 1, 1, 0, 1, 0, 0, 0, 1]",162,59,103,10,8,0.1694915254237288,0.07766990291262135
"[0, 0, 1, 1, 0, 0, 0, 0, 0, 1, 0, 1, 1, 1, 0]",200,110,90,11,6,0.1,0.06666666666666667
"[0, 1, 0, 1, 0, 1, 1, 0, 1, 1, 0, 1, 1, 0, 0]",101,47,54,7,5,0.14893617021276595,0.09259259259259259
"[1, 0, 1, 0, 1, 1, 0, 0, 0, 1, 0, 0, 0, 0, 1]",165,103,62,13,7,0.1262135922330097,0.11290322580645161
"[1, 0, 0, 0, 1, 1, 0, 1, 1, 1, 0, 1, 0, 1, 0]",118,57,61,7,4,0.12280701754385964,0.06557377049180328
"[0, 1, 0, 1, 0, 1, 0, 0, 0, 1, 1, 1, 0, 0, 0]",185,113,72,13,5,0.11504424778761062,0.06944444444444445
"[1, 1, 0, 0, 0, 0, 1, 0, 0, 1, 1, 1, 0, 1, 1]",132,62,70,7,8,0.11290322580645161,0.11428571428571428
"[1, 0, 0, 1, 0, 0, 0, 1, 1, 0, 1, 1, 1, 1, 0]",117,50,67,4,5,0.08,0.07462686567164178
"[0, 0, 1, 1, 1, 0, 1, 0, 1, 0, 0, 1, 1, 0, 0]",148,81,67,11,6,0.13580246913580246,0.08955223880597014
"[1, 1, 1, 0, 0, 1, 0, 1, 1, 1, 1, 0, 1, 0, 0]",194,80,114,9,13,0.1125,0.11403508771929824
"[1, 1, 0, 1, 0, 1, 0, 1, 0, 1, 1, 0, 0, 1, 0]",94,44,50,8,2,0.18181818181818182,0.04
"[0, 1, 1, 1, 0, 1, 0, 1, 0, 1, 0, 1, 1, 0, 0]",124,65,59,8,7,0.12307692307692308,0.11864406779661017
"[1, 1, 0, 1, 0, 0, 1, 1, 1, 0, 0, 1, 1, 0, 0]",180,91,89,12,7,0.13186813186813187,0.07865168539325842
"[1, 1, 0, 0, 0, 1, 1, 0, 0, 0, 1, 1, 1, 0, 0]",145,76,69,13,10,0.17105263157894737,0.14492753623188406
"[1, 0, 0, 1, 1, 1, 1, 0, 0, 0, 0, 1, 0, 0, 1]",268,86,182,10,13,0.11627906976744186,0.07142857142857142
"[0, 0, 1, 1, 1, 1, 1, 1, 0, 0, 1, 0, 1, 1, 0]",246,109,137,9,14,0.08256880733944955,0.10218978102189781
"[0, 1, 1, 1, 0, 1, 0, 1, 0, 1, 0, 0, 1, 1, 1]",171,73,98,12,11,0.1643835616438356,0.11224489795918367
"[1, 1, 0, 0, 1, 0, 0, 1, 0, 1, 0, 0, 1, 1, 1]",159,75,84,8,7,0.10666666666666667,0.08333333333333333
"[1, 1, 1, 0, 0, 1, 0, 0, 1, 0, 1, 0, 0, 1, 1]",147,57,90,3,6,0.05263157894736842,0.06666666666666667
"[0, 0, 0, 1, 0, 1, 1, 0, 0, 1, 0, 0, 1, 1, 0]",145,75,70,6,5,0.08,0.07142857142857142
"[1, 0, 0, 0, 1, 0, 1, 1, 1, 1, 0, 1, 0, 0, 0]",108,49,59,2,5,0.04081632653061224,0.0847457627118644
"[0, 0, 1, 0, 1, 0, 1, 0, 1, 0, 0, 0, 1, 0, 0]",224,146,78,17,7,0.11643835616438356,0.08974358974358974
"[0, 1, 1, 0, 1, 1, 1, 0, 1, 1, 0, 1, 1, 0, 1]",210,84,126,9,15,0.10714285714285714,0.11904761904761904
"[1, 0, 1, 0, 0, 1, 1, 1, 1, 0, 0, 1, 1, 1, 0]",174,68,106,7,10,0.10294117647058823,0.09433962264150944
"[1, 0, 0, 1, 1, 0, 0, 1, 0, 1, 1, 1, 1, 1, 0]",179,67,112,5,9,0.07462686567164178,0.08035714285714286
"[1, 1, 1, 1, 0, 0, 0, 0, 1, 0, 1, 1, 0, 1, 1]",228,84,144,5,14,0.05952380952380952,0.09722222222222222
"[1, 1, 0, 1, 0, 1, 0, 1, 0, 1, 0, 0, 1, 0, 0]",103,54,49,2,7,0.037037037037037035,0.14285714285714285
"[1, 1, 1, 0, 1, 0, 1, 0, 1, 1, 0, 1, 1, 0, 0]",159,69,90,5,6,0.07246376811594203,0.06666666666666667
"[1, 1, 1, 1, 1, 0, 1, 0, 1, 1, 0, 0, 0, 1, 1]",307,105,202,11,20,0.10476190476190476,0.09900990099009901
"[1, 0, 1, 1, 0, 1, 1, 1, 0, 1, 0, 0, 0, 0, 0]",123,68,55,3,1,0.04411764705882353,0.01818181818181818
"[1, 1, 0, 1, 0, 0, 0, 1, 0, 1, 0, 1, 1, 0, 1]",112,55,57,3,6,0.05454545454545454,0.10526315789473684
"[1, 1, 1, 0, 1, 1, 0, 0, 0, 0, 1, 0, 0, 1, 0]",100,46,54,6,5,0.13043478260869565,0.09259259259259259
"[0, 1, 1, 1, 1, 1, 0, 0, 0, 0, 0, 0, 1, 0, 1]",164,87,77,14,6,0.16091954022988506,0.07792207792207792
"[1, 1, 1, 1, 0, 1, 1, 1, 0, 1, 0, 0, 1, 1, 0]",281,93,188,8,19,0.08602150537634409,0.10106382978723404
"[1, 0, 0, 1, 1, 1, 1, 0, 0, 0, 0, 1, 0, 1, 1]",268,70,198,8,18,0.11428571428571428,0.09090909090909091
"[0, 1, 1, 0, 0, 0, 0, 1, 0, 1, 1, 1, 1, 1, 0]",148,80,68,8,7,0.1,0.10294117647058823
"[0, 1, 0, 0, 0, 1, 1, 1, 0, 1, 0, 1, 0, 1, 1]",115,62,53,4,2,0.06451612903225806,0.03773584905660377
"[0, 1, 1, 1, 1, 1, 0, 1, 1, 0, 0, 0, 1, 0, 0]",113,52,61,2,4,0.038461538461538464,0.06557377049180328
"[0, 0, 1, 1, 0, 0, 0, 1, 0, 1, 1, 0, 1, 0, 0]",157,91,66,10,6,0.10989010989010989,0.09090909090909091
"[0, 1, 0, 0, 0, 1, 1, 0, 1, 1, 1, 1, 0, 1, 0]",82,42,40,2,7,0.047619047619047616,0.175
"[0, 1, 0, 1, 0, 0, 0, 0, 1, 1, 0, 0, 0, 1, 0]",258,181,77,10,6,0.055248618784530384,0.07792207792207792
"[0, 0, 0, 1, 0, 1, 1, 1, 0, 0, 0, 0, 1, 0, 1]",136,85,51,10,5,0.11764705882352941,0.09803921568627451
"[1, 0, 1, 1, 0, 0, 0, 0, 1, 0, 0, 1, 0, 0, 1]",145,83,62,11,3,0.13253012048192772,0.04838709677419355
"[1, 1, 1, 0, 1, 0, 1, 0, 1, 0, 0, 0, 1, 0, 0]",104,47,57,4,3,0.0851063829787234,0.05263157894736842
"[1, 0, 0, 0, 1, 1, 0, 0, 0, 1, 0, 1, 1, 0, 1]",128,70,58,10,7,0.14285714285714285,0.1206896551724138
"[0, 0, 1, 0, 0, 0, 1, 0, 0, 1, 1, 0, 1, 1, 0]",149,89,60,10,7,0.11235955056179775,0.11666666666666667
"[0, 1, 1, 1, 0, 1, 0, 0, 1, 0, 0, 1, 1, 1, 0]",84,46,38,4,9,0.08695652173913043,0.23684210526315788
"[1, 1, 0, 0, 0, 1, 0, 0, 0, 1, 0, 0, 1, 0, 0]",243,159,84,18,9,0.11320754716981132,0.10714285714285714
"[1, 1, 1, 0, 1, 1, 1, 0, 0, 1, 0, 1, 0, 1, 1]",220,77,143,18,20,0.23376623376623376,0.13986013986013987
"[1, 1, 0, 0, 1, 0, 0, 1, 0, 1, 0, 1, 1, 0, 0]",114,52,62,6,2,0.11538461538461539,0.03225806451612903
"[1, 1, 1, 0, 0, 0, 0, 0, 0, 1, 0, 0, 1, 1, 1]",365,138,227,12,28,0.08695652173913043,0.12334801762114538
"[1, 0, 0, 1, 0, 0, 0, 1, 0, 1, 1, 0, 1, 0, 1]",96,53,43,5,3,0.09433962264150944,0.06976744186046512
"[1, 0, 1, 0, 0, 1, 0, 1, 0, 1, 1, 1, 0, 0, 0]",122,67,55,9,3,0.13432835820895522,0.05454545454545454
"[1, 1, 0, 1, 0, 1, 1, 1, 1, 0, 0, 1, 1, 1, 0]",286,93,193,7,23,0.07526881720430108,0.11917098445595854
"[0, 1, 0, 1, 1, 0, 1, 1, 0, 0, 1, 1, 1, 0, 1]",149,62,87,7,7,0.11290322580645161,0.08045977011494253
"[1, 0, 0, 1, 1, 1, 0, 1, 0, 1, 1, 0, 1, 1, 0]",156,60,96,4,9,0.06666666666666667,0.09375
"[0, 0, 1, 0, 0, 1, 1, 1, 0, 1, 0, 1, 1, 0, 1]",101,48,53,6,3,0.125,0.05660377358490566
"[0, 0, 0, 1, 0, 1, 0, 1, 0, 0, 1, 1, 0, 0, 1]",165,86,79,6,4,0.06976744186046512,0.05063291139240506
"[0, 1, 1, 0, 1, 1, 0, 0, 0, 1, 0, 0, 0, 0, 1]",151,86,65,4,10,0.046511627906976744,0.15384615384615385
"[1, 1, 0, 0, 1, 1, 1, 0, 1, 0, 1, 0, 0, 0, 1]",138,61,77,1,7,0.01639344262295082,0.09090909090909091
"[1, 1, 0, 1, 0, 1, 1, 1, 1, 0, 1, 1, 1, 0, 0]",266,87,179,10,19,0.11494252873563218,0.10614525139664804
"[1, 1, 0, 0, 0, 1, 1, 0, 0, 1, 1, 0, 1, 1, 0]",110,56,54,4,7,0.07142857142857142,0.12962962962962962
"[1, 0, 0, 0, 1, 1, 1, 0, 0, 1, 0, 1, 1, 0, 1]",110,51,59,6,4,0.11764705882352941,0.06779661016949153
"[0, 0, 1, 0, 1, 1, 1, 0, 1, 0, 1, 1, 1, 0, 0]",112,52,60,2,9,0.038461538461538464,0.15
"[1, 1, 1, 1, 0, 1, 1, 0, 1, 0, 0, 0, 1, 0, 0]",98,63,35,10,3,0.15873015873015872,0.08571428571428572
"[1, 0, 1, 1, 0, 0, 0, 0, 1, 1, 0, 1, 0, 1, 0]",108,61,47,8,5,0.13114754098360656,0.10638297872340426
"[1, 1, 0, 0, 1, 1, 0, 1, 1, 0, 0, 0, 0, 1, 1]",278,117,161,13,12,0.1111111111111111,0.07453416149068323
"[0, 0, 1, 1, 0, 0, 1, 1, 0, 1, 0, 1, 0, 1, 1]",217,102,115,8,4,0.0784313725490196,0.034782608695652174
"[0, 0, 0, 0, 1, 1, 0, 0, 1, 1, 0, 1, 0, 1, 0]",237,152,85,13,9,0.08552631578947369,0.10588235294117647
"[1, 0, 1, 0, 0, 0, 0, 1, 1, 0, 0, 1, 1, 0, 1]",141,81,60,7,5,0.08641975308641975,0.08333333333333333
"[0, 1, 1, 0, 0, 1, 1, 1, 0, 0, 0, 0, 1, 1, 1]",323,199,124,20,10,0.10050251256281408,0.08064516129032258
"[0, 1, 1, 1, 0, 1, 0, 0, 0, 0, 1, 0, 0, 0, 1]",158,96,62,8,6,0.08333333333333333,0.0967741935483871
"[1, 1, 1, 0, 0, 0, 0, 1, 0, 0, 1, 0, 1, 1, 0]",106,59,47,4,3,0.06779661016949153,0.06382978723404255
"[1, 0, 1, 1, 0, 0, 1, 1, 0, 0, 1, 1, 0, 1, 1]",208,91,117,13,16,0.14285714285714285,0.13675213675213677
"[0, 1, 0, 1, 1, 0, 0, 0, 0, 0, 1, 0, 1, 1, 1]",168,91,77,10,8,0.10989010989010989,0.1038961038961039
"[1, 0, 1, 1, 0, 0, 1, 0, 0, 1, 0, 1, 0, 0, 0]",150,81,69,8,9,0.09876543209876543,0.13043478260869565
"[0, 1, 0, 1, 1, 0, 0, 1, 0, 0, 1, 0, 1, 0, 0]",142,77,65,9,5,0.11688311688311688,0.07692307692307693
"[1, 1, 1, 0, 0, 1, 0, 1, 1, 0, 1, 0, 1, 0, 1]",130,52,78,2,8,0.038461538461538464,0.10256410256410256
"[0, 0, 0, 0, 1, 0, 1, 1, 0, 1, 1, 1, 0, 1, 1]",130,57,73,5,9,0.08771929824561403,0.1232876712328767
"[0, 1, 0, 0, 0, 1, 1, 1, 1, 0, 0, 1, 1, 0, 0]",450,252,198,31,24,0.12301587301587301,0.12121212121212122
"[0, 1, 1, 1, 0, 0, 0, 0, 1, 0, 1, 0, 0, 1, 0]",133,78,55,12,4,0.15384615384615385,0.07272727272727272
"[0, 0, 1, 1, 1, 0, 1, 0, 0, 1, 1, 0, 1, 0, 0]",104,56,48,4,8,0.07142857142857142,0.16666666666666666
"[0, 1, 1, 1, 1, 0, 1, 0, 1, 1, 0, 1, 0, 0, 0]",110,49,61,5,7,0.10204081632653061,0.11475409836065574
"[0, 1, 1, 1, 1, 0, 1, 1, 0, 0, 0, 1, 0, 1, 0]",99,41,58,6,4,0.14634146341463414,0.06896551724137931
"[0, 1, 0, 1, 1, 0, 0, 1, 1, 1, 1, 1, 0, 0, 0]",169,80,89,10,12,0.125,0.1348314606741573
"[0, 1, 1, 1, 1, 0, 0, 0, 0, 1, 0, 0, 1, 0, 0]",228,157,71,11,3,0.07006369426751592,0.04225352112676056
"[1, 0, 1, 1, 1, 1, 0, 0, 1, 0, 1, 0, 0, 1, 1]",163,71,92,8,11,0.11267605633802817,0.11956521739130435
"[0, 1, 1, 0, 0, 0, 1, 1, 1, 0, 1, 0, 1, 0, 0]",106,60,46,8,4,0.13333333333333333,0.08695652173913043
"[1, 1, 1, 1, 0, 1, 1, 0, 0, 0, 0, 0, 1, 0, 0]",139,80,59,11,1,0.1375,0.01694915254237288
"[1, 1, 0, 0, 0, 1, 0, 0, 0, 0, 1, 0, 1, 0, 0]",230,146,84,15,12,0.10273972602739725,0.14285714285714285
"[1, 1, 0, 1, 0, 1, 0, 0, 0, 1, 0, 1, 0, 0, 1]",94,50,44,6,5,0.12,0.11363636363636363
"[1, 0, 0, 1, 0, 0, 1, 1, 0, 1, 0, 1, 1, 0, 0]",128,68,60,4,9,0.058823529411764705,0.15
"[0, 1, 0, 0, 1, 0, 0, 0, 0, 1, 1, 1, 1, 0, 1]",116,55,61,2,6,0.03636363636363636,0.09836065573770492
"[1, 0, 1, 0, 1, 1, 0, 1, 0, 1, 1, 0, 0, 0, 1]",120,54,66,3,11,0.05555555555555555,0.16666666666666666
"[0, 1, 0, 1, 0, 1, 1, 0, 1, 0, 1, 1, 1, 0, 1]",138,60,78,6,4,0.1,0.05128205128205128
"[0, 1, 0, 0, 1, 0, 1, 0, 1, 1, 0, 0, 1, 0, 0]",156,83,73,9,7,0.10843373493975904,0.0958904109589041
"[1, 1, 1, 0, 1, 0, 0, 0, 0, 1, 0, 0, 0, 0, 1]",179,105,74,13,4,0.12380952380952381,0.05405405405405406
"[1, 1, 0, 1, 0, 0, 0, 1, 1, 0, 1, 0, 0, 0, 0]",173,99,74,11,8,0.1111111111111111,0.10810810810810811
"[0, 1, 0, 0, 1, 0, 1, 1, 0, 1, 0, 1, 1, 1, 1]",151,66,85,6,7,0.09090909090909091,0.08235294117647059
"[1, 1, 1, 0, 1, 1, 0, 1, 1, 0, 0, 0, 1, 0, 0]",121,56,65,4,9,0.07142857142857142,0.13846153846153847
"[0, 1, 1, 1, 1, 0, 1, 1, 0, 1, 1, 0, 0, 0, 1]",165,65,100,6,14,0.09230769230769231,0.14
"[1, 1, 1, 1, 1, 0, 0, 0, 0, 1, 0, 1, 0, 1, 0]",164,59,105,9,9,0.15254237288135594,0.08571428571428572
"[0, 1, 0, 1, 0, 1, 1, 1, 1, 1, 0, 0, 0, 0, 1]",201,86,115,7,14,0.08139534883720931,0.12173913043478261
"[0, 0, 0, 1, 0, 0, 1, 0, 0, 1, 1, 1, 1, 1, 0]",120,60,60,4,9,0.06666666666666667,0.15
"[0, 1, 1, 0, 1, 0, 0, 1, 0, 1, 0, 0, 1, 0, 1]",105,67,38,14,0,0.208955223880597,0.0
"[1, 1, 0, 0, 0, 1, 1, 1, 0, 0, 0, 1, 1, 1, 0]",136,61,75,6,5,0.09836065573770492,0.06666666666666667
"[0, 1, 0, 0, 0, 1, 0, 1, 0, 0, 1, 1, 1, 0, 0]",145,83,62,7,3,0.08433734939759036,0.04838709677419355
"[1, 0, 1, 0, 1, 1, 0, 1, 0, 1, 0, 1, 1, 0, 0]",99,47,52,2,3,0.0425531914893617,0.057692307692307696
"[0, 1, 1, 0, 1, 0, 0, 0, 1, 1, 0, 1, 0, 1, 0]",100,50,50,3,5,0.06,0.1
"[0, 1, 1, 0, 0, 0, 0, 1, 0, 1, 0, 0, 0, 1, 0]",269,175,94,20,14,0.11428571428571428,0.14893617021276595
"[1, 1, 0, 1, 1, 1, 0, 0, 0, 1, 1, 1, 0, 0, 0]",137,63,74,5,10,0.07936507936507936,0.13513513513513514
"[0, 1, 1, 1, 0, 0, 0, 0, 0, 0, 1, 1, 0, 1, 0]",177,108,69,12,7,0.1111111111111111,0.10144927536231885
"[0, 0, 1, 1, 1, 0, 1, 0, 1, 1, 0, 1, 0, 0, 1]",110,58,52,4,7,0.06896551724137931,0.1346153846153846
"[1, 0, 1, 1, 1, 0, 0, 1, 1, 0, 1, 1, 0, 0, 0]",134,66,68,4,2,0.06060606060606061,0.029411764705882353
"[0, 1, 0, 1, 0, 1, 1, 1, 0, 1, 0, 1, 0, 1, 1]",123,51,72,5,8,0.09803921568627451,0.1111111111111111
"[0, 1, 1, 1, 0, 0, 1, 0, 0, 1, 0, 0, 0, 0, 1]",161,91,70,5,2,0.054945054945054944,0.02857142857142857
"[1, 1, 1, 0, 1, 1, 0, 0, 0, 1, 0, 1, 1, 1, 0]",142,56,86,2,8,0.03571428571428571,0.09302325581395349
"[0, 1, 0, 1, 1, 0, 0, 1, 0, 1, 0, 1, 1, 0, 1]",103,52,51,6,2,0.11538461538461539,0.0392156862745098
"[0, 0, 1, 0, 0, 0, 0, 1, 1, 1, 0, 0, 1, 1, 1]",203,122,81,10,11,0.08196721311475409,0.13580246913580246
"[1, 0, 0, 0, 0, 1, 0, 1, 1, 0, 0, 1, 1, 1, 1]",230,92,138,5,16,0.05434782608695652,0.11594202898550725
"[1, 0, 0, 1, 0, 1, 0, 0, 0, 0, 1, 1, 1, 1, 0]",206,113,93,8,11,0.07079646017699115,0.11827956989247312
"[1, 1, 0, 1, 1, 0, 1, 0, 0, 0, 1, 0, 0, 0, 0]",137,87,50,3,5,0.034482758620689655,0.1
"[0, 1, 1, 0, 1, 1, 1, 0, 0, 0, 1, 1, 1, 0, 1]",154,68,86,5,4,0.07352941176470588,0.046511627906976744
"[0, 1, 1, 1, 0, 1, 0, 1, 0, 0, 1, 1, 0, 1, 1]",142,71,71,5,9,0.07042253521126761,0.1267605633802817
"[0, 0, 1, 1, 0, 1, 1, 0, 1, 1, 1, 0, 1, 0, 1]",144,57,87,5,8,0.08771929824561403,0.09195402298850575
"[0, 1, 1, 0, 1, 0, 1, 1, 0, 0, 1, 0, 0, 1, 1]",136,64,72,8,7,0.125,0.09722222222222222
"[1, 0, 1, 0, 1, 1, 1, 1, 1, 0, 1, 1, 0, 0, 0]",147,49,98,5,12,0.10204081632653061,0.12244897959183673
"[1, 0, 0, 1, 0, 0, 1, 1, 0, 0, 1, 0, 0, 1, 0]",135,86,49,6,0,0.06976744186046512,0.0
"[0, 1, 0, 1, 0, 1, 0, 0, 1, 1, 1, 0, 1, 0, 1]",108,56,52,7,4,0.125,0.07692307692307693
"[0, 1, 0, 1, 1, 0, 1, 0, 0, 1, 1, 1, 1, 0, 0]",182,92,90,5,6,0.05434782608695652,0.06666666666666667
"[0, 1, 0, 0, 1, 1, 0, 0, 1, 1, 0, 1, 0, 1, 1]",124,56,68,5,9,0.08928571428571429,0.1323529411764706
"[0, 1, 0, 0, 1, 0, 1, 1, 1, 1, 0, 0, 1, 0, 0]",137,84,53,11,7,0.13095238095238096,0.1320754716981132
"[1, 1, 1, 0, 0, 1, 1, 0, 1, 1, 0, 0, 0, 1, 0]",121,56,65,7,11,0.125,0.16923076923076924
"[1, 1, 0, 1, 1, 1, 1, 0, 0, 0, 0, 1, 0, 0, 1]",144,61,83,3,6,0.04918032786885246,0.07228915662650602
"[0, 1, 1, 1, 0, 1, 1, 1, 0, 1, 1, 0, 1, 0, 0]",148,68,80,7,6,0.10294117647058823,0.075
"[1, 1, 1, 1, 0, 1, 0, 0, 1, 1, 1, 0, 0, 1, 0]",117,43,74,2,10,0.046511627906976744,0.13513513513513514
"[1, 1, 0, 1, 0, 0, 0, 1, 1, 0, 1, 0, 0, 1, 0]",114,65,49,3,4,0.046153846153846156,0.08163265306122448
"[0, 1, 1, 0, 0, 0, 1, 1, 1, 1, 0, 0, 0, 1, 0]",133,77,56,7,2,0.09090909090909091,0.03571428571428571
"[0, 0, 1, 0, 0, 1, 1, 0, 0, 0, 1, 0, 0, 1, 1]",181,113,68,13,4,0.11504424778761062,0.058823529411764705
"[0, 0, 0, 0, 0, 1, 0, 1, 0, 1, 1, 1, 0, 1, 0]",127,74,53,8,5,0.10810810810810811,0.09433962264150944
"[0, 0, 1, 1, 1, 0, 0, 0, 0, 1, 0, 1, 0, 1, 1]",125,77,48,10,8,0.12987012987012986,0.16666666666666666
"[0, 0, 0, 1, 0, 1, 1, 0, 1, 1, 0, 1, 0, 0, 1]",108,56,52,6,3,0.10714285714285714,0.057692307692307696
"[1, 1, 0, 0, 0, 0, 0, 1, 0, 1, 1, 0, 1, 1, 0]",125,67,58,8,5,0.11940298507462686,0.08620689655172414
"[1, 1, 0, 0, 0, 0, 1, 0, 1, 0, 0, 0, 1, 0, 1]",162,102,60,7,4,0.06862745098039216,0.06666666666666667
"[1, 1, 1, 1, 1, 1, 0, 1, 0, 0, 0, 0, 0, 1, 0]",145,69,76,3,7,0.043478260869565216,0.09210526315789473
"[1, 1, 0, 0, 1, 1, 1, 0, 1, 0, 1, 0, 1, 0, 0]",118,56,62,4,7,0.07142857142857142,0.11290322580645161
"[0, 0, 0, 1, 1, 1, 1, 1, 0, 1, 1, 0, 0, 1, 1]",236,128,108,11,4,0.0859375,0.037037037037037035
"[1, 1, 0, 0, 0, 0, 1, 0, 1, 0, 1, 0, 0, 0, 1]",169,99,70,6,3,0.06060606060606061,0.04285714285714286
"[0, 1, 0, 0, 1, 0, 0, 1, 0, 1, 0, 1, 1, 1, 1]",129,64,65,3,4,0.046875,0.06153846153846154
"[1, 0, 0, 0, 1, 0, 1, 0, 0, 1, 0, 0, 1, 0, 1]",126,66,60,8,0,0.12121212121212122,0.0
"[0, 1, 1, 0, 0, 1, 0, 1, 1, 1, 1, 1, 1, 0, 1]",242,93,149,9,5,0.0967741935483871,0.03355704697986577
"[0, 0, 0, 0, 1, 0, 1, 1, 0, 1, 1, 0, 1, 1, 1]",142,72,70,7,4,0.09722222222222222,0.05714285714285714
"[0, 0, 0, 1, 0, 1, 1, 1, 1, 0, 0, 1, 1, 1, 0]",121,67,54,3,2,0.04477611940298507,0.037037037037037035
"[1, 1, 1, 1, 0, 1, 0, 0, 0, 1, 1, 0, 1, 1, 0]",138,61,77,6,4,0.09836065573770492,0.05194805194805195
"[1, 0, 0, 0, 1, 1, 0, 1, 0, 0, 1, 0, 1, 1, 0]",110,63,47,3,8,0.047619047619047616,0.1702127659574468
"[0, 1, 0, 0, 0, 1, 1, 0, 1, 0, 0, 1, 0, 1, 1]",109,58,51,6,1,0.10344827586206896,0.0196078431372549
"[0, 1, 0, 1, 0, 0, 0, 0, 0, 1, 0, 0, 1, 0, 1]",196,130,66,11,4,0.08461538461538462,0.06060606060606061
"[0, 1, 1, 1, 1, 1, 0, 0, 1, 0, 0, 1, 0, 1, 0]",104,47,57,2,5,0.0425531914893617,0.08771929824561403
"[0, 0, 0, 1, 0, 1, 1, 0, 1, 1, 1, 0, 0, 1, 1]",174,82,92,9,14,0.10975609756097561,0.15217391304347827
"[1, 0, 0, 1, 1, 0, 1, 1, 1, 0, 0, 1, 0, 0, 0]",111,48,63,3,9,0.0625,0.14285714285714285
"[1, 0, 1, 1, 0, 1, 0, 0, 1, 0, 1, 1, 1, 0, 0]",107,52,55,2,5,0.038461538461538464,0.09090909090909091
"[0, 0, 0, 1, 1, 1, 1, 0, 1, 1, 0, 1, 0, 0, 1]",130,61,69,4,4,0.06557377049180328,0.057971014492753624
"[0, 0, 0, 1, 0, 0, 0, 1, 1, 1, 0, 1, 0, 1, 0]",152,84,68,9,8,0.10714285714285714,0.11764705882352941
"[0, 1, 1, 0, 0, 1, 1, 1, 0, 1, 0, 0, 1, 1, 1]",238,134,104,7,13,0.05223880597014925,0.125
"[1, 0, 0, 1, 0, 1, 0, 1, 1, 0, 0, 0, 1, 1, 0]",130,66,64,4,3,0.06060606060606061,0.046875
"[0, 0, 1, 1, 0, 1, 0, 1, 0, 1, 0, 0, 0, 0, 1]",156,92,64,9,6,0.09782608695652174,0.09375
"[1, 1, 0, 1, 1, 1, 1, 0, 1, 0, 0, 1, 1, 0, 1]",219,78,141,7,12,0.08974358974358974,0.0851063829787234
"[0, 1, 1, 0, 1, 1, 1, 1, 0, 1, 0, 0, 1, 1, 0]",153,59,94,9,7,0.15254237288135594,0.07446808510638298
"[1, 1, 1, 0, 0, 1, 1, 0, 1, 1, 0, 0, 1, 0, 0]",141,63,78,3,8,0.047619047619047616,0.10256410256410256
"[0, 1, 1, 0, 1, 0, 1, 1, 1, 1, 1, 0, 0, 0, 0]",205,104,101,7,7,0.0673076923076923,0.06930693069306931
"[0, 1, 0, 1, 0, 1, 1, 1, 1, 0, 1, 0, 0, 0, 1]",95,47,48,8,5,0.1702127659574468,0.10416666666666667
"[0, 0, 0, 0, 1, 1, 0, 0, 1, 1, 1, 1, 1, 0, 0]",405,213,192,14,15,0.06572769953051644,0.078125
"[0, 0, 0, 1, 0, 1, 0, 1, 0, 0, 1, 0, 0, 1, 1]",184,104,80,8,4,0.07692307692307693,0.05
"[1, 1, 0, 1, 0, 0, 0, 1, 0, 0, 0, 1, 1, 0, 1]",102,58,44,4,3,0.06896551724137931,0.06818181818181818
"[1, 0, 0, 0, 0, 1, 0, 1, 0, 1, 0, 0, 1, 1, 1]",164,74,90,8,10,0.10810810810810811,0.1111111111111111
"[1, 1, 0, 1, 1, 0, 0, 0, 1, 0, 1, 1, 1, 0, 1]",128,52,76,5,7,0.09615384615384616,0.09210526315789473
"[1, 1, 0, 1, 1, 0, 0, 1, 1, 1, 0, 1, 1, 1, 0]",222,72,150,4,11,0.05555555555555555,0.07333333333333333
"[1, 0, 0, 0, 1, 1, 1, 1, 0, 1, 1, 0, 0, 1, 1]",199,86,113,2,10,0.023255813953488372,0.08849557522123894
"[1, 1, 1, 1, 0, 0, 0, 1, 1, 1, 0, 0, 1, 0, 0]",151,66,85,5,2,0.07575757575757576,0.023529411764705882
"[1, 1, 1, 0, 0, 1, 0, 1, 0, 0, 0, 0, 0, 1, 0]",141,87,54,11,2,0.12643678160919541,0.037037037037037035
"[1, 1, 1, 0, 1, 0, 1, 1, 0, 0, 1, 1, 0, 0, 0]",239,112,127,17,13,0.15178571428571427,0.10236220472440945
"[1, 1, 1, 0, 0, 0, 0, 1, 0, 1, 1, 1, 0, 0, 0]",173,76,97,8,10,0.10526315789473684,0.10309278350515463
"[0, 1, 1, 0, 0, 1, 1, 1, 0, 1, 1, 0, 1, 1, 0]",163,73,90,8,7,0.1095890410958904,0.07777777777777778
"[1, 1, 0, 0, 0, 1, 1, 0, 0, 1, 1, 1, 0, 1, 1]",185,79,106,14,14,0.17721518987341772,0.1320754716981132
"[0, 0, 1, 0, 1, 1, 0, 0, 1, 1, 1, 0, 1, 1, 0]",119,57,62,8,3,0.14035087719298245,0.04838709677419355
"[0, 0, 0, 0, 1, 0, 1, 1, 0, 1, 1, 1, 0, 0, 1]",133,80,53,9,7,0.1125,0.1320754716981132
"[0, 0, 1, 1, 1, 0, 0, 1, 0, 0, 1, 1, 1, 0, 0]",149,72,77,10,5,0.1388888888888889,0.06493506493506493
"[1, 1, 0, 0, 0, 0, 0, 0, 0, 1, 1, 0, 1, 1, 0]",207,127,80,9,5,0.07086614173228346,0.0625
"[1, 1, 0, 1, 0, 1, 0, 1, 0, 1, 0, 1, 0, 0, 1]",118,63,55,3,7,0.047619047619047616,0.12727272727272726
"[1, 0, 0, 0, 1, 0, 1, 0, 1, 0, 1, 1, 0, 0, 1]",103,49,54,8,6,0.16326530612244897,0.1111111111111111
"[0, 1, 0, 0, 1, 0, 1, 0, 1, 1, 1, 0, 1, 1, 0]",108,58,50,3,4,0.05172413793103448,0.08
"[0, 1, 1, 1, 1, 0, 0, 1, 1, 0, 1, 0, 1, 0, 0]",164,98,66,5,12,0.05102040816326531,0.18181818181818182
"[0, 0, 0, 1, 1, 0, 1, 0, 1, 0, 1, 1, 0, 1, 1]",132,68,64,5,5,0.07352941176470588,0.078125
"[0, 1, 0, 0, 0, 0, 0, 1, 1, 0, 1, 1, 1, 0, 1]",114,53,61,2,6,0.03773584905660377,0.09836065573770492
"[1, 0, 1, 0, 1, 0, 1, 0, 0, 1, 0, 0, 1, 1, 1]",150,77,73,3,9,0.03896103896103896,0.1232876712328767
"[0, 1, 0, 1, 0, 1, 1, 0, 0, 1, 0, 1, 1, 0, 1]",114,59,55,4,6,0.06779661016949153,0.10909090909090909
"[0, 0, 1, 0, 1, 1, 0, 0, 1, 1, 0, 1, 0, 0, 0]",155,91,64,6,8,0.06593406593406594,0.125
"[1, 0, 0, 1, 1, 0, 1, 0, 0, 1, 0, 1, 0, 0, 1]",115,56,59,6,5,0.10714285714285714,0.0847457627118644
"[1, 1, 0, 1, 0, 0, 1, 0, 0, 1, 1, 0, 1, 0, 0]",122,50,72,4,5,0.08,0.06944444444444445
"[0, 1, 0, 0, 0, 0, 1, 0, 1, 1, 1, 0, 0, 0, 0]",276,177,99,19,10,0.10734463276836158,0.10101010101010101
"[0, 1, 1, 1, 1, 0, 0, 1, 0, 0, 1, 1, 0, 0, 1]",162,89,73,4,8,0.0449438202247191,0.1095890410958904
"[1, 0, 1, 1, 0, 0, 1, 1, 0, 1, 0, 1, 1, 0, 0]",116,62,54,7,7,0.11290322580645161,0.12962962962962962
"[1, 1, 0, 1, 0, 0, 1, 0, 0, 0, 1, 1, 1, 0, 0]",117,71,46,5,5,0.07042253521126761,0.10869565217391304
"[1, 1, 0, 1, 1, 1, 0, 0, 0, 1, 0, 1, 1, 1, 0]",160,76,84,8,7,0.10526315789473684,0.08333333333333333
"[1, 1, 0, 0, 1, 0, 0, 0, 0, 1, 0, 1, 0, 1, 1]",146,85,61,8,5,0.09411764705882353,0.08196721311475409
"[1, 0, 0, 1, 1, 1, 1, 0, 1, 1, 1, 0, 0, 0, 0]",202,84,118,11,12,0.13095238095238096,0.1016949152542373
"[1, 1, 0, 0, 0, 1, 0, 1, 1, 0, 0, 1, 0, 1, 1]",121,54,67,1,9,0.018518518518518517,0.13432835820895522
"[0, 0, 1, 1, 0, 0, 1, 1, 0, 0, 1, 0, 1, 0, 0]",260,158,102,23,11,0.14556962025316456,0.10784313725490197
"[1, 0, 0, 0, 0, 1, 1, 0, 1, 0, 0, 0, 1, 1, 1]",237,104,133,11,11,0.10576923076923077,0.08270676691729323
"[0, 0, 0, 1, 1, 0, 0, 0, 0, 0, 1, 1, 1, 0, 1]",210,151,59,12,6,0.07947019867549669,0.1016949152542373
"[0, 1, 1, 0, 1, 1, 0, 0, 0, 1, 1, 1, 0, 0, 0]",128,73,55,4,8,0.0547945205479452,0.14545454545454545
"[0, 1, 0, 1, 0, 1, 0, 0, 1, 1, 0, 1, 0, 1, 0]",96,47,49,5,5,0.10638297872340426,0.10204081632653061
"[1, 1, 1, 0, 1, 0, 1, 0, 0, 0, 1, 0, 1, 1, 1]",177,65,112,7,9,0.1076923076923077,0.08035714285714286
"[1, 1, 0, 1, 1, 0, 0, 1, 0, 0, 1, 1, 1, 0, 0]",131,56,75,7,7,0.125,0.09333333333333334
"[0, 1, 0, 0, 1, 1, 1, 0, 0, 1, 1, 0, 1, 1, 0]",120,64,56,4,8,0.0625,0.14285714285714285
"[0, 0, 1, 1, 1, 0, 1, 1, 1, 1, 0, 0, 0, 1, 0]",118,64,54,5,6,0.078125,0.1111111111111111
"[0, 0, 0, 1, 1, 0, 1, 0, 1, 0, 0, 1, 1, 0, 1]",124,75,49,10,7,0.13333333333333333,0.14285714285714285
"[1, 1, 0, 0, 0, 1, 0, 0, 1, 0, 1, 0, 1, 0, 1]",102,54,48,1,4,0.018518518518518517,0.08333333333333333
"[0, 1, 0, 1, 0, 0, 1, 0, 0, 1, 0, 1, 1, 0, 0]",142,89,53,8,5,0.0898876404494382,0.09433962264150944
"[0, 1, 0, 0, 0, 1, 1, 0, 1, 1, 1, 1, 1, 0, 0]",138,66,72,4,8,0.06060606060606061,0.1111111111111111
"[1, 1, 0, 0, 0, 0, 1, 1, 0, 1, 0, 1, 0, 0, 1]",177,88,89,14,8,0.1590909090909091,0.0898876404494382
"[0, 0, 0, 1, 0, 0, 1, 0, 1, 0, 1, 1, 0, 0, 1]",173,109,64,5,9,0.045871559633027525,0.140625
"[0, 1, 1, 0, 1, 0, 1, 0, 1, 1, 0, 1, 1, 0, 1]",123,57,66,8,4,0.14035087719298245,0.06060606060606061
"[1, 1, 1, 1, 0, 1, 0, 1, 1, 0, 0, 0, 1, 1, 0]",161,63,98,8,11,0.12698412698412698,0.11224489795918367
"[1, 0, 1, 1, 0, 0, 1, 1, 1, 0, 0, 0, 1, 1, 0]",129,57,72,9,3,0.15789473684210525,0.041666666666666664
"[0, 0, 0, 1, 1, 0, 0, 1, 0, 1, 0, 1, 0, 1, 0]",140,81,59,7,8,0.08641975308641975,0.13559322033898305
"[0, 1, 0, 1, 0, 0, 1, 1, 1, 1, 0, 1, 0, 1, 0]",87,53,34,5,4,0.09433962264150944,0.11764705882352941
"[0, 1, 0, 1, 0, 0, 1, 1, 1, 0, 1, 1, 0, 0, 1]",137,65,72,5,6,0.07692307692307693,0.08333333333333333
"[1, 0, 1, 0, 0, 0, 0, 0, 0, 1, 0, 1, 1, 1, 0]",126,72,54,5,3,0.06944444444444445,0.05555555555555555
"[0, 1, 1, 1, 0, 0, 1, 1, 0, 0, 1, 0, 0, 1, 0]",105,59,46,7,3,0.11864406779661017,0.06521739130434782
"[1, 1, 0, 0, 0, 1, 0, 1, 1, 0, 1, 1, 1, 1, 0]",173,75,98,12,6,0.16,0.061224489795918366
"[0, 1, 0, 1, 0, 0, 0, 1, 0, 1, 1, 0, 1, 1, 0]",101,60,41,7,3,0.11666666666666667,0.07317073170731707
"[0, 0, 1, 1, 1, 0, 0, 1, 0, 1, 1, 0, 0, 1, 1]",172,85,87,10,12,0.11764705882352941,0.13793103448275862
"[0, 1, 0, 0, 0, 1, 1, 0, 0, 0, 1, 1, 0, 0, 1]",206,120,86,16,9,0.13333333333333333,0.10465116279069768
"[1, 0, 0, 1, 0, 1, 0, 0, 1, 0, 1, 1, 1, 1, 0]",120,54,66,4,9,0.07407407407407407,0.13636363636363635
"[0, 1, 0, 1, 1, 0, 0, 0, 1, 0, 0, 1, 0, 1, 0]",120,80,40,8,2,0.1,0.05
"[0, 0, 1, 0, 0, 1, 0, 1, 0, 1, 0, 0, 0, 1, 0]",223,151,72,17,3,0.11258278145695365,0.041666666666666664
"[1, 1, 0, 1, 0, 0, 1, 0, 1, 1, 0, 1, 0, 1, 0]",102,47,55,1,6,0.02127659574468085,0.10909090909090909
"[0, 1, 0, 1, 1, 1, 0, 0, 1, 0, 0, 0, 1, 1, 0]",121,70,51,6,5,0.08571428571428572,0.09803921568627451
"[0, 1, 0, 0, 1, 0, 1, 0, 1, 1, 0, 0, 1, 0, 1]",111,54,57,10,5,0.18518518518518517,0.08771929824561403
"[0, 0, 1, 1, 0, 0, 1, 1, 1, 1, 1, 0, 0, 1, 0]",187,90,97,9,8,0.1,0.08247422680412371
"[1, 0, 0, 1, 1, 0, 0, 1, 1, 0, 0, 1, 0, 0, 1]",249,82,167,3,17,0.036585365853658534,0.10179640718562874
"[1, 1, 0, 1, 1, 0, 1, 0, 0, 1, 1, 0, 0, 1, 0]",110,63,47,4,6,0.06349206349206349,0.1276595744680851
"[1, 0, 1, 1, 0, 1, 0, 1, 1, 1, 1, 0, 0, 0, 1]",174,71,103,9,7,0.1267605633802817,0.06796116504854369
"[0, 0, 1, 0, 1, 1, 0, 1, 0, 1, 1, 1, 1, 0, 0]",140,66,74,8,7,0.12121212121212122,0.0945945945945946
"[1, 0, 1, 0, 1, 0, 0, 1, 0, 0, 1, 0, 0, 1, 1]",119,66,53,6,2,0.09090909090909091,0.03773584905660377
"[0, 0, 1, 1, 1, 0, 1, 1, 1, 1, 0, 1, 0, 1, 0]",114,54,60,5,5,0.09259259259259259,0.08333333333333333
"[0, 1, 0, 0, 1, 1, 1, 0, 1, 0, 1, 1, 0, 1, 0]",90,46,44,2,4,0.043478260869565216,0.09090909090909091
"[1, 0, 1, 1, 1, 0, 1, 0, 1, 1, 0, 0, 1, 0, 0]",128,66,62,5,7,0.07575757575757576,0.11290322580645161
"[1, 0, 0, 1, 0, 0, 0, 0, 1, 0, 1, 1, 0, 0, 1]",158,82,76,13,5,0.15853658536585366,0.06578947368421052
"[0, 1, 1, 0, 0, 0, 1, 1, 1, 1, 0, 1, 0, 1, 0]",112,50,62,6,7,0.12,0.11290322580645161
"[1, 1, 0, 0, 1, 1, 0, 0, 0, 1, 0, 1, 0, 1, 0]",127,64,63,5,6,0.078125,0.09523809523809523
"[1, 1, 0, 0, 1, 0, 1, 0, 1, 1, 1, 0, 0, 1, 0]",119,54,65,6,4,0.1111111111111111,0.06153846153846154
"[1, 0, 1, 1, 1, 0, 1, 1, 0, 1, 0, 0, 1, 0, 1]",133,62,71,3,6,0.04838709677419355,0.08450704225352113
"[0, 1, 0, 1, 0, 1, 1, 1, 0, 0, 1, 0, 1, 0, 1]",102,57,45,6,1,0.10526315789473684,0.022222222222222223
"[1, 0, 0, 1, 0, 1, 1, 0, 0, 0, 1, 0, 0, 1, 0]",122,68,54,4,6,0.058823529411764705,0.1111111111111111
"[0, 0, 0, 0, 0, 1, 0, 1, 0, 1, 1, 1, 1, 0, 0]",219,140,79,14,6,0.1,0.0759493670886076
"[0, 1, 1, 1, 0, 1, 1, 1, 0, 0, 1, 1, 0, 0, 1]",285,107,178,16,22,0.14953271028037382,0.12359550561797752
"[1, 0, 1, 0, 0, 0, 0, 0, 1, 1, 1, 1, 0, 1, 0]",114,67,47,4,2,0.05970149253731343,0.0425531914893617
"[1, 0, 0, 0, 1, 0, 0, 1, 0, 1, 0, 1, 1, 1, 0]",104,61,43,10,3,0.16393442622950818,0.06976744186046512
"[0, 0, 1, 1, 1, 0, 0, 0, 1, 1, 1, 1, 0, 1, 1]",190,86,104,10,12,0.11627906976744186,0.11538461538461539
"[0, 1, 0, 0, 1, 0, 0, 1, 0, 1, 0, 1, 1, 1, 0]",112,65,47,8,6,0.12307692307692308,0.1276595744680851
"[1, 1, 0, 1, 1, 1, 0, 0, 0, 0, 0, 1, 1, 0, 0]",184,99,85,8,4,0.08080808080808081,0.047058823529411764
"[0, 1, 1, 0, 1, 1, 1, 0, 0, 0, 0, 0, 1, 1, 0]",144,83,61,9,4,0.10843373493975904,0.06557377049180328
"[1, 0, 0, 0, 0, 0, 1, 0, 0, 1, 0, 1, 1, 0, 1]",131,71,60,7,8,0.09859154929577464,0.13333333333333333
"[1, 0, 1, 0, 1, 1, 0, 1, 0, 0, 1, 0, 1, 0, 1]",91,41,50,5,7,0.12195121951219512,0.14
"[0, 1, 0, 1, 0, 1, 0, 0, 1, 1, 1, 1, 0, 0, 0]",215,100,115,14,18,0.14,0.1565217391304348
"[0, 1, 0, 1, 1, 0, 1, 0, 0, 1, 1, 0, 1, 0, 0]",99,60,39,3,2,0.05,0.05128205128205128
"[1, 0, 1, 0, 0, 1, 1, 0, 0, 1, 1, 0, 0, 1, 0]",162,93,69,12,10,0.12903225806451613,0.14492753623188406
"[0, 1, 0, 1, 1, 0, 0, 1, 1, 1, 0, 1, 1, 1, 0]",158,73,85,4,11,0.0547945205479452,0.12941176470588237
"[0, 0, 1, 0, 0, 1, 0, 1, 1, 1, 0, 0, 0, 1, 0]",143,87,56,12,3,0.13793103448275862,0.05357142857142857
"[0, 0, 1, 0, 1, 0, 1, 0, 0, 1, 1, 0, 0, 1, 0]",130,75,55,9,6,0.12,0.10909090909090909
"[0, 1, 0, 0, 1, 0, 1, 0, 1, 0, 1, 0, 1, 0, 1]",110,64,46,5,3,0.078125,0.06521739130434782
"[1, 1, 1, 0, 0, 1, 0, 0, 0, 1, 0, 1, 1, 1, 0]",120,57,63,7,3,0.12280701754385964,0.047619047619047616
"[0, 1, 1, 1, 1, 1, 0, 0, 0, 1, 0, 1, 0, 1, 0]",117,57,60,5,7,0.08771929824561403,0.11666666666666667
"[0, 0, 1, 1, 0, 1, 1, 1, 1, 1, 0, 0, 1, 0, 1]",156,64,92,6,10,0.09375,0.10869565217391304
"[0, 1, 1, 0, 1, 1, 1, 0, 1, 0, 0, 1, 0, 1, 0]",90,41,49,7,3,0.17073170731707318,0.061224489795918366
"[1, 1, 0, 1, 0, 1, 1, 0, 0, 0, 1, 1, 0, 0, 1]",155,71,84,7,5,0.09859154929577464,0.05952380952380952
"[0, 1, 0, 1, 1, 1, 1, 1, 0, 0, 1, 1, 1, 0, 0]",171,75,96,7,11,0.09333333333333334,0.11458333333333333
"[0, 1, 1, 1, 0, 1, 0, 0, 0, 0, 1, 1, 0, 1, 0]",102,52,50,5,3,0.09615384615384616,0.06
"[0, 1, 0, 0, 1, 1, 0, 0, 1, 0, 1, 1, 1, 1, 0]",115,44,71,3,11,0.06818181818181818,0.15492957746478872
"[1, 0, 1, 0, 0, 0, 0, 1, 0, 0, 0, 1, 1, 1, 0]",138,69,69,5,6,0.07246376811594203,0.08695652173913043
"[0, 1, 0, 1, 1, 1, 0, 0, 1, 0, 0, 0, 1, 0, 1]",110,61,49,8,6,0.13114754098360656,0.12244897959183673
"[0, 1, 0, 0, 1, 0, 0, 1, 0, 1, 1, 0, 1, 1, 0]",111,59,52,6,5,0.1016949152542373,0.09615384615384616
"[0, 0, 1, 1, 0, 0, 0, 1, 0, 0, 1, 1, 0, 1, 0]",150,84,66,5,8,0.05952380952380952,0.12121212121212122
"[0, 0, 0, 1, 1, 1, 1, 1, 0, 0, 1, 1, 0, 1, 0]",137,77,60,6,5,0.07792207792207792,0.08333333333333333
"[0, 1, 1, 0, 1, 0, 0, 1, 0, 0, 0, 1, 0, 1, 1]",115,58,57,8,3,0.13793103448275862,0.05263157894736842
"[1, 1, 0, 0, 1, 1, 0, 1, 0, 1, 1, 0, 0, 1, 0]",120,49,71,7,7,0.14285714285714285,0.09859154929577464
"[0, 1, 0, 0, 0, 1, 0, 0, 1, 1, 1, 0, 1, 1, 1]",129,60,69,6,6,0.1,0.08695652173913043
"[0, 0, 0, 1, 1, 0, 0, 0, 1, 0, 1, 1, 0, 1, 0]",152,89,63,3,6,0.033707865168539325,0.09523809523809523
"[0, 0, 1, 0, 0, 1, 0, 0, 0, 0, 1, 0, 1, 1, 1]",217,134,83,20,7,0.14925373134328357,0.08433734939759036
"[1, 1, 0, 1, 0, 1, 0, 1, 0, 0, 1, 0, 1, 0, 1]",126,67,59,4,2,0.05970149253731343,0.03389830508474576
"[0, 0, 1, 0, 0, 1, 1, 0, 1, 0, 1, 1, 0, 1, 1]",123,48,75,2,6,0.041666666666666664,0.08
"[0, 1, 0, 1, 0, 1, 0, 0, 1, 1, 1, 0, 0, 1, 0]",99,54,45,4,5,0.07407407407407407,0.1111111111111111
"[0, 1, 0, 1, 1, 0, 0, 1, 1, 1, 0, 0, 1, 0, 0]",129,54,75,7,5,0.12962962962962962,0.06666666666666667
"[1, 1, 1, 1, 0, 0, 1, 0, 0, 1, 0, 0, 1, 1, 0]",146,69,77,9,6,0.13043478260869565,0.07792207792207792
"[1, 0, 0, 1, 1, 0, 1, 1, 0, 1, 0, 0, 1, 0, 1]",112,48,64,5,5,0.10416666666666667,0.078125
"[1, 0, 1, 0, 1, 1, 0, 0, 1, 1, 0, 1, 1, 1, 0]",126,54,72,5,4,0.09259259259259259,0.05555555555555555
"[1, 0, 1, 0, 0, 0, 1, 1, 1, 1, 1, 0, 0, 0, 1]",136,62,74,11,7,0.1774193548387097,0.0945945945945946
"[1, 1, 1, 0, 1, 1, 0, 1, 1, 0, 1, 0, 0, 1, 1]",241,94,147,8,13,0.0851063829787234,0.08843537414965986
"[0, 1, 0, 1, 1, 1, 1, 1, 1, 0, 0, 0, 0, 0, 1]",162,72,90,12,7,0.16666666666666666,0.07777777777777778
"[0, 1, 0, 1, 1, 1, 0, 0, 0, 1, 0, 1, 1, 1, 1]",175,89,86,16,8,0.1797752808988764,0.09302325581395349
"[1, 1, 1, 0, 1, 0, 0, 0, 1, 0, 0, 1, 1, 0, 0]",150,89,61,6,1,0.06741573033707865,0.01639344262295082
"[1, 0, 0, 1, 0, 1, 0, 1, 0, 1, 0, 0, 1, 1, 0]",112,59,53,3,13,0.05084745762711865,0.24528301886792453
"[1, 1, 1, 0, 1, 0, 0, 0, 1, 1, 1, 0, 1, 0, 0]",89,45,44,7,8,0.15555555555555556,0.18181818181818182
"[1, 1, 0, 1, 1, 1, 0, 0, 0, 1, 0, 1, 1, 0, 0]",123,66,57,5,6,0.07575757575757576,0.10526315789473684
"[1, 1, 1, 0, 0, 0, 1, 0, 1, 0, 0, 1, 1, 0, 1]",127,62,65,7,5,0.11290322580645161,0.07692307692307693
"[0, 1, 0, 0, 0, 0, 1, 0, 1, 0, 1, 1, 1, 0, 1]",105,56,49,6,8,0.10714285714285714,0.16326530612244897
"[0, 1, 0, 0, 1, 1, 0, 1, 0, 1, 0, 0, 1, 0, 0]",125,83,42,4,0,0.04819277108433735,0.0
"[0, 1, 1, 0, 1, 0, 1, 0, 1, 0, 1, 1, 0, 0, 1]",117,58,59,6,8,0.10344827586206896,0.13559322033898305
"[1, 0, 1, 0, 0, 0, 0, 1, 0, 1, 0, 1, 0, 1, 1]",111,51,60,0,7,0.0,0.11666666666666667
"[0, 1, 0, 0, 0, 1, 0, 0, 1, 1, 1, 0, 1, 0, 0]",143,87,56,7,6,0.08045977011494253,0.10714285714285714
"[1, 0, 1, 0, 1, 0, 1, 0, 0, 1, 1, 0, 1, 0, 0]",99,59,40,5,1,0.0847457627118644,0.025
"[0, 0, 0, 1, 0, 1, 1, 0, 0, 1, 1, 1, 0, 1, 1]",119,54,65,5,4,0.09259259259259259,0.06153846153846154
"[0, 1, 1, 0, 0, 0, 1, 0, 0, 1, 1, 0, 1, 0, 1]",111,63,48,5,5,0.07936507936507936,0.10416666666666667
"[0, 1, 0, 0, 1, 0, 0, 0, 1, 1, 1, 0, 0, 1, 0]",151,90,61,6,2,0.06666666666666667,0.03278688524590164
"[1, 1, 1, 1, 1, 0, 1, 0, 0, 1, 0, 0, 0, 1, 0]",125,54,71,3,5,0.05555555555555555,0.07042253521126761
"[0, 1, 1, 1, 0, 0, 1, 0, 0, 1, 0, 1, 0, 1, 1]",135,61,74,4,6,0.06557377049180328,0.08108108108108109
"[1, 0, 0, 1, 1, 0, 1, 0, 1, 1, 0, 0, 1, 1, 0]",156,74,82,8,6,0.10810810810810811,0.07317073170731707
"[0, 1, 1, 1, 1, 1, 0, 1, 1, 1, 0, 1, 0, 0, 1]",245,101,144,15,10,0.1485148514851485,0.06944444444444445
"[0, 1, 1, 0, 0, 1, 0, 1, 1, 0, 0, 1, 1, 0, 1]",117,62,55,2,1,0.03225806451612903,0.01818181818181818
"[0, 1, 1, 0, 1, 0, 1, 0, 0, 0, 0, 1, 0, 1, 1]",129,74,55,8,4,0.10810810810810811,0.07272727272727272
"[0, 1, 1, 0, 0, 0, 1, 1, 1, 0, 1, 1, 0, 1, 0]",119,67,52,5,5,0.07462686567164178,0.09615384615384616
"[1, 1, 0, 1, 1, 1, 1, 1, 0, 0, 0, 0, 0, 1, 0]",139,72,67,10,5,0.1388888888888889,0.07462686567164178
"[1, 1, 0, 1, 0, 1, 1, 0, 1, 1, 0, 0, 0, 1, 0]",109,55,54,7,5,0.12727272727272726,0.09259259259259259
"[1, 0, 0, 0, 0, 1, 0, 0, 0, 1, 0, 1, 1, 0, 1]",155,85,70,10,9,0.11764705882352941,0.12857142857142856
"[0, 1, 0, 0, 1, 0, 1, 1, 0, 1, 1, 0, 0, 1, 1]",136,59,77,5,6,0.0847457627118644,0.07792207792207792
"[0, 0, 1, 1, 0, 1, 0, 1, 0, 0, 1, 0, 0, 1, 1]",130,69,61,9,12,0.13043478260869565,0.19672131147540983
"[0, 1, 0, 1, 1, 0, 1, 1, 0, 0, 1, 1, 0, 1, 0]",115,47,68,3,10,0.06382978723404255,0.14705882352941177
"[1, 0, 0, 1, 0, 0, 0, 1, 1, 1, 1, 1, 0, 0, 1]",167,73,94,8,8,0.1095890410958904,0.0851063829787234
"[1, 0, 0, 1, 0, 1, 0, 1, 1, 1, 0, 1, 0, 0, 1]",95,45,50,3,4,0.06666666666666667,0.08
"[0, 0, 0, 1, 1, 0, 1, 1, 0, 1, 0, 1, 0, 0, 1]",109,57,52,4,5,0.07017543859649122,0.09615384615384616
"[0, 0, 0, 1, 0, 1, 1, 1, 1, 1, 0, 1, 0, 1, 1]",152,70,82,12,10,0.17142857142857143,0.12195121951219512
"[0, 1, 1, 0, 1, 0, 1, 0, 1, 0, 1, 0, 0, 0, 1]",109,62,47,6,4,0.0967741935483871,0.0851063829787234
"[1, 1, 0, 1, 0, 0, 1, 0, 1, 0, 1, 0, 1, 0, 1]",91,32,59,2,7,0.0625,0.11864406779661017
"[0, 0, 0, 1, 1, 0, 0, 1, 1, 0, 1, 1, 1, 0, 1]",133,81,52,9,4,0.1111111111111111,0.07692307692307693
"[0, 0, 0, 0, 1, 1, 1, 1, 0, 1, 1, 0, 1, 0, 0]",134,68,66,5,7,0.07352941176470588,0.10606060606060606
"[1, 0, 1, 0, 1, 1, 1, 1, 1, 0, 0, 0, 1, 0, 1]",142,51,91,5,8,0.09803921568627451,0.08791208791208792
"[0, 1, 0, 1, 1, 1, 0, 1, 0, 0, 0, 0, 1, 0, 1]",105,61,44,7,6,0.11475409836065574,0.13636363636363635
"[1, 1, 0, 1, 0, 1, 0, 1, 1, 0, 0, 0, 0, 0, 1]",130,80,50,9,6,0.1125,0.12
"[0, 0, 1, 1, 0, 1, 0, 1, 0, 1, 0, 1, 1, 1, 0]",125,64,61,4,5,0.0625,0.08196721311475409
"[1, 0, 1, 0, 0, 1, 1, 1, 0, 0, 0, 1, 1, 0, 1]",100,42,58,4,7,0.09523809523809523,0.1206896551724138
"[0, 1, 1, 0, 1, 0, 1, 0, 1, 0, 0, 1, 0, 1, 0]",119,60,59,4,6,0.06666666666666667,0.1016949152542373
"[0, 1, 0, 1, 1, 1, 0, 0, 0, 1, 0, 0, 1, 1, 1]",137,67,70,8,10,0.11940298507462686,0.14285714285714285
"[0, 1, 0, 1, 0, 0, 1, 1, 0, 1, 1, 1, 0, 1, 0]",117,49,68,4,8,0.08163265306122448,0.11764705882352941
"[1, 0, 1, 0, 0, 1, 1, 0, 1, 0, 1, 0, 0, 1, 0]",74,39,35,5,1,0.1282051282051282,0.02857142857142857
"[1, 0, 0, 1, 0, 0, 1, 0, 1, 0, 1, 0, 1, 1, 1]",111,58,53,8,10,0.13793103448275862,0.18867924528301888
"[1, 0, 1, 1, 0, 0, 1, 0, 1, 1, 0, 1, 0, 0, 0]",115,59,56,6,6,0.1016949152542373,0.10714285714285714
"[0, 1, 1, 1, 0, 0, 1, 0, 0, 0, 0, 0, 1, 1, 1]",218,117,101,11,7,0.09401709401709402,0.06930693069306931
"[0, 1, 0, 0, 1, 1, 0, 0, 0, 1, 1, 1, 1, 1, 1]",257,120,137,14,18,0.11666666666666667,0.13138686131386862
"[0, 1, 0, 0, 0, 1, 0, 0, 1, 1, 0, 0, 0, 1, 1]",185,111,74,11,6,0.0990990990990991,0.08108108108108109
"[1, 1, 1, 0, 0, 1, 1, 0, 0, 0, 1, 0, 1, 0, 0]",168,59,109,7,9,0.11864406779661017,0.08256880733944955
"[1, 1, 1, 1, 0, 0, 1, 1, 0, 0, 0, 1, 0, 1, 0]",214,110,104,6,9,0.05454545454545454,0.08653846153846154
"[0, 1, 0, 1, 1, 1, 1, 0, 0, 1, 1, 0, 0, 0, 1]",173,93,80,12,6,0.12903225806451613,0.075
"[0, 1, 1, 0, 1, 0, 1, 1, 1, 1, 0, 0, 1, 1, 0]",242,100,142,10,16,0.1,0.11267605633802817
"[0, 0, 0, 1, 1, 0, 1, 0, 1, 1, 1, 1, 0, 0, 1]",161,88,73,7,6,0.07954545454545454,0.0821917808219178
"[0, 0, 0, 0, 1, 1, 0, 1, 0, 1, 1, 1, 1, 0, 0]",179,97,82,9,5,0.09278350515463918,0.06097560975609756
"[1, 0, 1, 0, 1, 0, 0, 0, 0, 1, 1, 0, 0, 0, 0]",459,282,177,22,13,0.07801418439716312,0.07344632768361582
"[0, 0, 0, 1, 0, 0, 0, 1, 1, 0, 1, 1, 1, 0, 0]",151,85,66,8,9,0.09411764705882353,0.13636363636363635
"[0, 1, 1, 0, 1, 1, 1, 1, 1, 0, 1, 0, 1, 1, 1]",543,165,378,15,35,0.09090909090909091,0.09259259259259259
"[0, 0, 1, 1, 1, 1, 1, 1, 1, 1, 0, 0, 1, 1, 0]",2006,848,1158,75,113,0.08844339622641509,0.09758203799654577
"[1, 0, 0, 0, 0, 0, 0, 0, 0, 0, 0, 0, 1, 1, 1]",3843,1942,1901,211,181,0.10865087538619979,0.09521304576538664
"[1, 1, 0, 0, 0, 0, 0, 0, 0, 0, 0, 0, 0, 1, 1]",3141,2239,902,194,75,0.08664582402858419,0.08314855875831485
"[1, 1, 1, 0, 0, 0, 0, 0, 0, 0, 0, 0, 0, 0, 1]",1562,697,865,66,82,0.09469153515064563,0.09479768786127167
"[0, 0, 0, 1, 1, 1, 0, 0, 0, 0, 0, 0, 0, 0, 0]",3289,2496,793,262,76,0.10496794871794872,0.09583858764186633
"[0, 0, 0, 0, 0, 0, 0, 1, 1, 1, 0, 0, 0, 0, 0]",2896,2314,582,214,64,0.09248055315471046,0.10996563573883161
"[0, 0, 1, 1, 0, 0, 1, 0, 0, 0, 0, 0, 0, 0, 0]",2392,1793,599,179,56,0.09983268265476855,0.09348914858096828
"[1, 0, 0, 0, 0, 0, 0, 0, 0, 1, 0, 0, 0, 0, 0]",8059,6128,1931,577,169,0.0941579634464752,0.08751941998964267
"[1, 1, 1, 1, 1, 1, 1, 0, 0, 1, 1, 1, 1, 1, 1]",30874,3386,27488,337,2659,0.09952746603662138,0.09673311990686845
"[1, 0, 0, 0, 1, 1, 1, 1, 1, 1, 1, 1, 0, 1, 1]",686,189,497,23,49,0.12169312169312169,0.09859154929577464
"[1, 1, 1, 1, 1, 1, 0, 1, 1, 1, 0, 1, 1, 0, 1]",1578,339,1239,41,119,0.12094395280235988,0.096045197740113
"[0, 1, 1, 1, 1, 0, 1, 1, 1, 1, 1, 1, 1, 1, 1]",9324,2131,7193,224,687,0.10511496949788832,0.09550952314750452
"[1, 1, 1, 1, 1, 0, 1, 0, 1, 1, 0, 1, 1, 1, 0]",501,138,363,8,30,0.057971014492753624,0.08264462809917356
"[1, 1, 1, 1, 1, 1, 1, 1, 1, 0, 1, 0, 1, 1, 0]",1876,421,1455,43,130,0.1021377672209026,0.08934707903780069
"[1, 1, 1, 1, 1, 1, 1, 1, 0, 1, 0, 1, 1, 1, 0]",1760,403,1357,41,117,0.10173697270471464,0.08621960206337509
"[1, 1, 1, 1, 1, 1, 1, 1, 1, 1, 0, 1, 0, 1, 1]",8893,1505,7388,142,684,0.09435215946843854,0.09258256632376827
"[0, 1, 1, 1, 1, 1, 0, 1, 1, 1, 1, 0, 0, 0, 1]",292,112,180,11,15,0.09821428571428571,0.08333333333333333
"[0, 1, 0, 1, 1, 1, 1, 1, 0, 1, 1, 1, 1, 0, 0]",332,135,197,13,23,0.0962962962962963,0.116751269035533
"[1, 1, 0, 1, 0, 0, 1, 0, 1, 1, 1, 1, 1, 0, 1]",243,79,164,11,18,0.13924050632911392,0.10975609756097561
"[1, 1, 0, 0, 0, 0, 0, 1, 1, 0, 1, 0, 0, 1, 1]",168,85,83,9,8,0.10588235294117647,0.0963855421686747
"[0, 1, 0, 0, 0, 1, 0, 0, 0, 0, 0, 1, 1, 1, 1]",336,209,127,20,10,0.09569377990430622,0.07874015748031496
"[0, 0, 0, 1, 0, 0, 0, 1, 0, 0, 0, 0, 0, 1, 1]",837,633,204,48,24,0.07582938388625593,0.11764705882352941
"[0, 0, 1, 0, 0, 0, 0, 0, 0, 0, 0, 0, 1, 0, 0]",6934,5662,1272,488,111,0.0861886259272342,0.08726415094339622
"[1, 0, 0, 0, 1, 0, 0, 1, 0, 0, 0, 0, 0, 0, 0]",1885,1360,525,147,64,0.10808823529411765,0.1219047619047619
"[1, 0, 1, 1, 0, 0, 0, 0, 0, 1, 1, 1, 1, 1, 1]",428,183,245,20,27,0.1092896174863388,0.11020408163265306
"[0, 0, 1, 0, 1, 1, 1, 1, 1, 1, 1, 1, 1, 1, 1]",2833,775,2058,69,206,0.08903225806451613,0.1000971817298348
"[0, 0, 0, 1, 0, 1, 1, 1, 1, 1, 1, 1, 1, 1, 1]",1122,426,696,50,58,0.11737089201877934,0.08333333333333333
"[1, 1, 0, 0, 0, 1, 0, 1, 1, 1, 1, 1, 1, 0, 1]",273,91,182,3,22,0.03296703296703297,0.12087912087912088
"[1, 1, 1, 1, 0, 0, 1, 0, 0, 0, 0, 0, 0, 1, 0]",187,109,78,8,9,0.07339449541284404,0.11538461538461539
"[0, 0, 1, 1, 0, 0, 1, 1, 1, 1, 0, 0, 0, 0, 1]",1568,791,777,75,71,0.09481668773704172,0.09137709137709138
"[0, 0, 0, 0, 1, 0, 1, 1, 1, 0, 0, 1, 1, 0, 0]",256,149,107,11,8,0.0738255033557047,0.07476635514018691
"[1, 0, 0, 0, 1, 0, 0, 0, 0, 1, 0, 1, 1, 1, 0]",126,70,56,8,3,0.11428571428571428,0.05357142857142857
"[0, 1, 0, 1, 0, 0, 0, 1, 0, 0, 0, 0, 1, 0, 1]",212,129,83,13,6,0.10077519379844961,0.07228915662650602
"[1, 1, 1, 0, 0, 0, 1, 1, 0, 1, 1, 1, 0, 0, 0]",168,84,84,7,11,0.08333333333333333,0.13095238095238096
"[0, 0, 0, 0, 0, 0, 1, 0, 0, 1, 0, 0, 0, 0, 0]",8117,6747,1370,686,137,0.10167481843782422,0.1
"[1, 1, 0, 0, 1, 1, 0, 1, 1, 1, 1, 1, 1, 1, 1]",2620,631,1989,55,179,0.08716323296354993,0.08999497234791352
"[1, 1, 1, 1, 1, 1, 1, 1, 1, 1, 0, 0, 1, 1, 0]",6597,1657,4940,160,461,0.09656004828002414,0.09331983805668016
"[0, 1, 1, 1, 1, 0, 1, 1, 0, 1, 1, 1, 1, 1, 1]",2028,645,1383,59,114,0.09147286821705426,0.0824295010845987
"[0, 1, 1, 1, 0, 1, 1, 1, 1, 0, 1, 1, 0, 1, 1]",517,148,369,15,37,0.10135135135135136,0.1002710027100271
"[1, 0, 1, 1, 1, 0, 1, 1, 1, 1, 0, 1, 1, 0, 1]",491,128,363,11,34,0.0859375,0.09366391184573003
"[0, 1, 1, 1, 1, 1, 0, 1, 1, 0, 1, 1, 1, 1, 0]",555,181,374,15,30,0.08287292817679558,0.08021390374331551
"[1, 1, 1, 1, 1, 0, 1, 0, 1, 1, 1, 1, 1, 1, 0]",1774,411,1363,49,125,0.1192214111922141,0.09170946441672781
"[1, 0, 1, 0, 1, 0, 0, 0, 1, 0, 1, 0, 1, 0, 0]",133,70,63,4,11,0.05714285714285714,0.1746031746031746
"[1, 0, 1, 0, 0, 1, 1, 0, 0, 1, 0, 1, 0, 1, 1]",121,58,63,5,7,0.08620689655172414,0.1111111111111111
"[0, 0, 1, 0, 0, 0, 0, 0, 0, 1, 0, 1, 0, 0, 1]",534,383,151,42,6,0.10966057441253264,0.039735099337748346
"[0, 0, 1, 1, 1, 1, 1, 1, 1, 0, 1, 0, 1, 1, 0]",316,119,197,18,19,0.15126050420168066,0.09644670050761421
"[1, 1, 0, 0, 0, 0, 0, 0, 1, 1, 1, 1, 1, 1, 1]",2667,1042,1625,91,142,0.0873320537428023,0.08738461538461538
"[1, 0, 1, 0, 0, 0, 1, 1, 1, 0, 0, 0, 0, 0, 0]",392,247,145,29,18,0.11740890688259109,0.12413793103448276
"[1, 1, 0, 0, 0, 0, 0, 1, 0, 0, 0, 0, 1, 1, 1]",436,268,168,28,13,0.1044776119402985,0.07738095238095238
"[0, 0, 0, 0, 1, 0, 1, 0, 0, 0, 0, 1, 1, 0, 0]",887,645,242,58,26,0.08992248062015504,0.10743801652892562
"[0, 0, 0, 1, 0, 0, 0, 0, 0, 1, 0, 0, 0, 0, 1]",1656,1270,386,123,41,0.09685039370078741,0.10621761658031088
"[1, 0, 0, 1, 0, 1, 0, 1, 0, 0, 0, 0, 1, 0, 0]",235,153,82,17,5,0.1111111111111111,0.06097560975609756
"[0, 0, 0, 0, 1, 1, 1, 0, 0, 0, 0, 0, 0, 1, 0]",648,453,195,38,16,0.08388520971302428,0.08205128205128205
"[1, 0, 0, 0, 0, 0, 1, 0, 0, 1, 0, 1, 0, 1, 0]",226,138,88,16,11,0.11594202898550725,0.125
"[0, 0, 0, 0, 0, 1, 0, 0, 0, 0, 0, 1, 0, 0, 1]",1759,1347,412,122,48,0.09057164068299926,0.11650485436893204
"[0, 0, 1, 0, 0, 1, 0, 0, 0, 0, 1, 0, 0, 0, 1]",501,366,135,35,18,0.09562841530054644,0.13333333333333333
"[1, 0, 0, 0, 1, 0, 0, 1, 0, 0, 0, 0, 1, 0, 0]",511,343,168,41,13,0.119533527696793,0.07738095238095238
"[1, 1, 1, 1, 1, 1, 1, 0, 0, 1, 1, 1, 0, 1, 1]",2623,466,2157,40,197,0.08583690987124463,0.09133055169216504
"[1, 1, 1, 1, 0, 0, 0, 0, 0, 0, 0, 0, 1, 1, 1]",2256,1177,1079,117,106,0.0994052676295667,0.09823911028730306
"[0, 0, 1, 1, 1, 1, 1, 1, 1, 1, 0, 0, 1, 1, 1]",4646,1511,3135,148,311,0.09794837855724686,0.09920255183413078
"[1, 1, 0, 0, 1, 1, 1, 1, 1, 1, 0, 0, 1, 1, 1]",5029,1484,3545,151,327,0.10175202156334232,0.0922425952045134
"[0, 1, 1, 1, 0, 0, 1, 1, 1, 1, 1, 1, 0, 0, 1]",737,270,467,20,45,0.07407407407407407,0.09635974304068523
"[1, 1, 1, 0, 1, 1, 1, 0, 0, 1, 1, 1, 1, 1, 1]",2925,686,2239,80,227,0.11661807580174927,0.1013845466726217
"[1, 1, 1, 1, 0, 1, 1, 0, 0, 1, 0, 1, 1, 1, 1]",627,202,425,21,52,0.10396039603960396,0.1223529411764706
"[1, 1, 1, 1, 1, 1, 0, 1, 1, 0, 0, 1, 0, 1, 1]",588,173,415,16,45,0.09248554913294797,0.10843373493975904
"[0, 0, 0, 1, 1, 0, 0, 0, 0, 1, 1, 1, 1, 0, 1]",372,281,91,28,6,0.099644128113879,0.06593406593406594
"[1, 1, 1, 1, 1, 1, 1, 0, 1, 1, 1, 1, 0, 1, 1]",7543,1243,6300,129,597,0.10378117457763475,0.09476190476190476
"[1, 1, 1, 1, 1, 1, 1, 1, 1, 0, 1, 1, 1, 1, 0]",7990,1405,6585,126,648,0.08967971530249111,0.09840546697038724
"[1, 1, 1, 0, 1, 1, 1, 1, 1, 1, 1, 1, 1, 1, 0]",8273,1521,6752,142,618,0.09335963182117028,0.09152843601895734
"[1, 1, 1, 1, 1, 1, 0, 1, 1, 1, 1, 1, 1, 1, 0]",7691,1394,6297,127,582,0.09110473457675754,0.09242496426869938
"[0, 1, 1, 1, 1, 1, 1, 0, 1, 1, 1, 1, 1, 1, 1]",8785,2211,6574,216,600,0.09769335142469471,0.09126863401277761
"[0, 1, 1, 1, 1, 1, 1, 1, 1, 0, 1, 1, 1, 1, 1]",8766,2297,6469,247,631,0.10753156290814106,0.09754212397588499
"[1, 0, 0, 0, 0, 0, 0, 1, 0, 0, 1, 0, 1, 1, 1]",278,129,149,13,12,0.10077519379844961,0.08053691275167785
"[0, 1, 1, 0, 0, 0, 0, 0, 0, 1, 0, 0, 1, 0, 1]",323,235,88,19,6,0.08085106382978724,0.06818181818181818
"[1, 1, 1, 0, 0, 1, 1, 0, 0, 0, 0, 0, 0, 1, 0]",405,133,272,11,27,0.08270676691729323,0.09926470588235294
"[1, 1, 1, 1, 1, 0, 0, 1, 1, 0, 0, 0, 0, 0, 0]",1742,358,1384,37,126,0.10335195530726257,0.09104046242774566
"[1, 0, 1, 1, 1, 0, 1, 0, 0, 0, 0, 0, 0, 0, 0]",400,243,157,23,9,0.09465020576131687,0.05732484076433121
"[0, 0, 1, 0, 1, 1, 1, 0, 1, 0, 0, 0, 0, 0, 0]",325,213,112,10,10,0.046948356807511735,0.08928571428571429
"[0, 1, 0, 0, 1, 0, 0, 1, 0, 1, 1, 1, 0, 1, 0]",81,44,37,6,4,0.13636363636363635,0.10810810810810811
"[0, 0, 1, 0, 0, 0, 0, 1, 0, 1, 1, 0, 0, 1, 0]",217,139,78,13,13,0.09352517985611511,0.16666666666666666
"[0, 1, 0, 0, 1, 1, 1, 0, 0, 1, 1, 0, 1, 0, 1]",114,37,77,4,6,0.10810810810810811,0.07792207792207792
"[0, 0, 1, 1, 1, 0, 1, 1, 1, 1, 1, 1, 1, 1, 0]",716,245,471,19,39,0.07755102040816327,0.08280254777070063
"[0, 0, 1, 1, 0, 1, 1, 1, 0, 1, 1, 0, 1, 0, 0]",99,42,57,3,2,0.07142857142857142,0.03508771929824561
"[0, 0, 1, 0, 0, 0, 0, 0, 0, 1, 1, 0, 0, 0, 0]",3391,2602,789,222,90,0.08531898539584935,0.11406844106463879
"[0, 0, 0, 1, 0, 0, 1, 1, 0, 1, 1, 1, 1, 1, 1]",226,117,109,18,6,0.15384615384615385,0.05504587155963303
"[0, 0, 0, 0, 0, 0, 1, 0, 0, 1, 1, 0, 1, 1, 1]",323,215,108,13,7,0.06046511627906977,0.06481481481481481
"[1, 0, 0, 0, 0, 0, 0, 0, 0, 1, 0, 0, 1, 1, 0]",744,456,288,33,34,0.07236842105263158,0.11805555555555555
"[1, 0, 0, 0, 1, 0, 0, 0, 0, 0, 0, 0, 0, 1, 0]",1622,1207,415,121,30,0.10024855012427507,0.07228915662650602
"[0, 0, 0, 0, 0, 0, 1, 0, 0, 0, 1, 1, 0, 1, 0]",528,375,153,39,15,0.104,0.09803921568627451
"[1, 1, 0, 0, 1, 1, 0, 0, 0, 0, 0, 0, 0, 0, 1]",2343,1400,943,128,91,0.09142857142857143,0.09650053022269353
"[1, 1, 0, 0, 0, 0, 1, 0, 0, 0, 0, 0, 0, 0, 1]",721,497,224,57,22,0.11468812877263582,0.09821428571428571
"[0, 0, 0, 0, 0, 0, 0, 1, 0, 0, 0, 0, 1, 1, 0]",2501,1989,512,171,54,0.08597285067873303,0.10546875
"[1, 1, 1, 0, 1, 1, 1, 1, 1, 1, 1, 0, 0, 1, 1]",3030,688,2342,58,195,0.08430232558139535,0.08326216908625107
"[1, 1, 1, 0, 0, 0, 0, 1, 1, 0, 0, 0, 0, 0, 0]",2227,616,1611,50,153,0.08116883116883117,0.09497206703910614
"[1, 1, 1, 0, 0, 0, 1, 0, 0, 1, 0, 0, 0, 0, 1]",176,101,75,6,14,0.0594059405940594,0.18666666666666668
"[0, 1, 0, 0, 1, 0, 0, 0, 1, 0, 0, 1, 0, 0, 1]",230,133,97,17,7,0.12781954887218044,0.07216494845360824
"[0, 1, 1, 1, 0, 1, 1, 1, 0, 1, 1, 1, 1, 1, 1]",1849,500,1349,43,113,0.086,0.083765752409192
"[0, 0, 1, 1, 1, 0, 1, 1, 1, 0, 1, 1, 1, 1, 1]",692,208,484,15,47,0.07211538461538461,0.09710743801652892
"[1, 1, 0, 0, 0, 1, 1, 1, 0, 1, 1, 1, 0, 1, 1]",272,112,160,9,16,0.08035714285714286,0.1
"[1, 1, 0, 1, 1, 0, 0, 0, 1, 1, 1, 0, 1, 1, 1]",288,113,175,13,17,0.11504424778761062,0.09714285714285714
"[1, 1, 1, 1, 1, 1, 0, 1, 1, 0, 0, 0, 1, 1, 1]",847,237,610,16,64,0.06751054852320675,0.10491803278688525
"[1, 1, 1, 1, 1, 1, 1, 1, 0, 1, 1, 0, 0, 0, 1]",767,214,553,20,55,0.09345794392523364,0.09945750452079566
"[1, 1, 1, 1, 1, 0, 1, 1, 1, 0, 0, 0, 1, 1, 1]",766,190,576,21,49,0.11052631578947368,0.08506944444444445
"[1, 1, 0, 0, 1, 1, 1, 1, 1, 1, 0, 0, 0, 0, 1]",1997,776,1221,67,122,0.08634020618556701,0.09991809991809991
"[0, 1, 1, 1, 1, 1, 0, 0, 1, 1, 1, 1, 1, 1, 0]",1151,429,722,32,86,0.07459207459207459,0.11911357340720222
"[0, 1, 0, 0, 1, 1, 1, 1, 1, 0, 0, 1, 1, 1, 1]",522,210,312,21,31,0.1,0.09935897435897435
"[0, 1, 1, 0, 0, 1, 0, 0, 0, 0, 1, 0, 0, 0, 0]",654,489,165,40,20,0.081799591002045,0.12121212121212122
"[0, 1, 1, 0, 0, 0, 0, 0, 0, 0, 1, 0, 0, 1, 1]",543,426,117,40,7,0.09389671361502347,0.05982905982905983
"[0, 0, 0, 0, 1, 0, 0, 1, 0, 0, 0, 1, 1, 0, 0]",687,499,188,60,13,0.12024048096192384,0.06914893617021277
"[0, 0, 0, 0, 1, 0, 0, 1, 1, 1, 1, 1, 0, 0, 0]",289,184,105,13,7,0.07065217391304347,0.06666666666666667
"[0, 0, 1, 1, 0, 0, 1, 0, 1, 1, 0, 0, 0, 1, 1]",182,83,99,11,18,0.13253012048192772,0.18181818181818182
"[0, 0, 1, 1, 1, 0, 1, 0, 1, 1, 1, 1, 1, 0, 1]",249,87,162,15,16,0.1724137931034483,0.09876543209876543
"[1, 1, 1, 0, 0, 1, 1, 1, 0, 1, 0, 1, 1, 1, 1]",761,171,590,11,51,0.06432748538011696,0.08644067796610169
"[0, 0, 1, 1, 1, 0, 0, 1, 1, 1, 0, 1, 0, 1, 1]",149,71,78,6,6,0.08450704225352113,0.07692307692307693
"[1, 1, 1, 0, 0, 1, 1, 1, 0, 0, 1, 1, 1, 0, 1]",268,80,188,9,26,0.1125,0.13829787234042554
"[0, 0, 0, 1, 1, 1, 1, 1, 0, 1, 0, 1, 0, 1, 1]",177,86,91,8,5,0.09302325581395349,0.054945054945054944
"[0, 1, 0, 1, 1, 1, 1, 1, 1, 0, 0, 0, 1, 1, 1]",359,140,219,16,18,0.11428571428571428,0.0821917808219178
"[1, 0, 1, 1, 1, 0, 1, 0, 1, 1, 1, 1, 1, 1, 0]",578,161,417,12,33,0.07453416149068323,0.07913669064748201
"[0, 0, 1, 1, 1, 0, 1, 0, 0, 1, 0, 1, 1, 1, 0]",118,63,55,5,2,0.07936507936507936,0.03636363636363636
"[1, 0, 1, 0, 1, 1, 1, 0, 1, 1, 0, 1, 1, 1, 1]",579,169,410,12,42,0.07100591715976332,0.1024390243902439
"[1, 0, 1, 1, 1, 0, 0, 1, 1, 1, 0, 0, 1, 0, 1]",163,60,103,2,13,0.03333333333333333,0.1262135922330097
"[0, 1, 1, 0, 1, 1, 1, 0, 0, 1, 1, 1, 0, 0, 1]",195,77,118,11,11,0.14285714285714285,0.09322033898305085
"[1, 1, 0, 0, 1, 1, 1, 1, 1, 0, 0, 1, 1, 0, 1]",344,114,230,14,17,0.12280701754385964,0.07391304347826087
"[0, 1, 1, 0, 1, 0, 1, 1, 1, 0, 1, 1, 0, 0, 1]",122,47,75,7,3,0.14893617021276595,0.04
"[1, 1, 0, 1, 0, 0, 0, 0, 1, 0, 0, 0, 0, 0, 1]",258,155,103,17,10,0.10967741935483871,0.0970873786407767
"[1, 0, 0, 0, 0, 0, 0, 0, 1, 0, 1, 1, 0, 1, 0]",247,156,91,18,13,0.11538461538461539,0.14285714285714285
"[1, 1, 0, 1, 0, 1, 1, 1, 1, 1, 0, 1, 1, 0, 1]",484,140,344,16,34,0.11428571428571428,0.09883720930232558
"[1, 1, 1, 1, 0, 1, 0, 1, 1, 1, 1, 1, 0, 1, 1]",1650,371,1279,33,133,0.0889487870619946,0.10398749022673964
"[1, 0, 0, 1, 1, 0, 0, 0, 0, 1, 1, 0, 0, 0, 0]",2149,634,1515,65,150,0.10252365930599369,0.09900990099009901
"[1, 1, 0, 1, 0, 0, 0, 0, 0, 0, 0, 0, 0, 0, 0]",2759,2001,758,183,68,0.09145427286356822,0.08970976253298153
"[0, 1, 1, 1, 0, 0, 0, 1, 0, 0, 0, 0, 0, 0, 0]",752,542,210,50,27,0.09225092250922509,0.12857142857142856
"[0, 0, 1, 0, 0, 0, 0, 1, 0, 1, 0, 0, 0, 1, 0]",484,353,131,38,12,0.10764872521246459,0.0916030534351145
"[0, 0, 1, 1, 1, 1, 1, 1, 0, 1, 0, 1, 1, 1, 1]",922,310,612,26,64,0.08387096774193549,0.10457516339869281
"[1, 1, 1, 1, 1, 1, 1, 0, 0, 1, 1, 1, 0, 0, 1]",1054,244,810,33,78,0.13524590163934427,0.0962962962962963
"[1, 1, 1, 0, 0, 1, 1, 1, 1, 1, 1, 1, 1, 0, 1]",3016,500,2516,48,247,0.096,0.09817170111287758
"[0, 1, 1, 1, 1, 1, 1, 1, 0, 1, 1, 1, 0, 0, 1]",682,221,461,17,47,0.07692307692307693,0.1019522776572668
"[0, 0, 0, 1, 1, 0, 0, 0, 0, 0, 1, 0, 0, 1, 0]",596,461,135,39,15,0.08459869848156182,0.1111111111111111
"[1, 1, 0, 1, 0, 0, 1, 1, 0, 0, 0, 0, 0, 0, 1]",345,195,150,20,14,0.10256410256410256,0.09333333333333334
"[0, 0, 0, 0, 0, 1, 1, 1, 1, 0, 0, 0, 0, 1, 0]",689,546,143,29,12,0.05311355311355311,0.08391608391608392
"[0, 1, 1, 0, 0, 0, 1, 0, 0, 0, 0, 0, 0, 0, 0]",2332,1800,532,174,51,0.09666666666666666,0.09586466165413533
"[0, 0, 1, 1, 0, 0, 1, 1, 0, 0, 0, 1, 0, 0, 0]",499,329,170,36,22,0.1094224924012158,0.12941176470588237
"[1, 1, 1, 1, 1, 1, 0, 1, 0, 1, 1, 1, 0, 0, 1]",717,194,523,17,57,0.08762886597938144,0.1089866156787763
"[1, 0, 1, 0, 1, 1, 1, 1, 1, 1, 1, 0, 1, 0, 1]",514,173,341,12,41,0.06936416184971098,0.12023460410557185
"[0, 1, 0, 1, 1, 0, 1, 1, 1, 0, 0, 1, 0, 0, 1]",121,56,65,6,6,0.10714285714285714,0.09230769230769231
"[0, 1, 1, 1, 1, 1, 1, 1, 1, 1, 0, 0, 0, 1, 1]",992,431,561,46,52,0.10672853828306264,0.09269162210338681
"[1, 0, 0, 1, 0, 0, 1, 1, 1, 1, 1, 0, 1, 1, 0]",147,57,90,6,11,0.10526315789473684,0.12222222222222222
"[1, 0, 1, 1, 0, 0, 1, 0, 0, 1, 0, 0, 1, 1, 1]",149,72,77,7,8,0.09722222222222222,0.1038961038961039
"[1, 1, 1, 0, 1, 1, 0, 0, 1, 0, 0, 1, 0, 0, 1]",124,49,75,9,7,0.1836734693877551,0.09333333333333334
"[1, 1, 0, 1, 1, 1, 0, 1, 1, 0, 0, 1, 0, 0, 1]",140,60,80,8,12,0.13333333333333333,0.15
"[0, 1, 0, 1, 1, 1, 0, 0, 1, 0, 0, 0, 1, 1, 1]",144,61,83,2,9,0.03278688524590164,0.10843373493975904
"[1, 1, 1, 0, 0, 1, 0, 1, 1, 1, 0, 0, 1, 0, 0]",119,56,63,5,5,0.08928571428571429,0.07936507936507936
"[1, 1, 1, 1, 0, 0, 1, 0, 1, 1, 1, 0, 0, 1, 0]",148,65,83,6,7,0.09230769230769231,0.08433734939759036
"[1, 0, 1, 1, 1, 1, 1, 1, 1, 1, 1, 1, 0, 0, 1]",3589,843,2746,79,238,0.0937129300118624,0.08667152221412965
"[0, 0, 0, 0, 0, 0, 0, 1, 1, 0, 0, 1, 1, 1, 1]",2632,2204,428,191,50,0.0866606170598911,0.11682242990654206
"[0, 1, 0, 1, 1, 0, 0, 0, 0, 0, 0, 0, 0, 0, 1]",799,584,215,61,19,0.10445205479452055,0.08837209302325581
"[0, 0, 0, 0, 1, 1, 1, 1, 0, 0, 0, 0, 0, 1, 0]",641,403,238,36,21,0.08933002481389578,0.08823529411764706
"[0, 0, 0, 0, 0, 1, 1, 1, 1, 0, 0, 0, 0, 0, 1]",848,692,156,72,16,0.10404624277456648,0.10256410256410256
"[0, 0, 1, 0, 1, 1, 0, 1, 0, 1, 1, 1, 0, 0, 0]",113,66,47,10,6,0.15151515151515152,0.1276595744680851
"[0, 1, 0, 0, 0, 0, 1, 0, 1, 1, 0, 1, 0, 1, 1]",108,55,53,3,5,0.05454545454545454,0.09433962264150944
"[0, 0, 0, 0, 0, 1, 0, 0, 0, 1, 0, 0, 1, 0, 0]",1550,1229,321,131,28,0.10659072416598861,0.08722741433021806
"[1, 0, 0, 0, 1, 0, 0, 0, 0, 1, 1, 1, 0, 0, 1]",179,97,82,11,5,0.1134020618556701,0.06097560975609756
"[1, 0, 1, 0, 0, 0, 1, 0, 0, 0, 0, 1, 1, 1, 0]",164,100,64,9,4,0.09,0.0625
"[1, 0, 0, 0, 0, 0, 0, 1, 0, 1, 0, 0, 0, 1, 0]",479,322,157,31,12,0.09627329192546584,0.07643312101910828
"[0, 1, 1, 0, 0, 1, 0, 1, 0, 0, 0, 1, 0, 0, 0]",238,150,88,16,7,0.10666666666666667,0.07954545454545454
"[1, 0, 1, 1, 0, 0, 1, 0, 1, 1, 0, 0, 1, 0, 1]",95,46,49,3,3,0.06521739130434782,0.061224489795918366
"[0, 1, 1, 0, 1, 1, 0, 0, 1, 0, 1, 1, 0, 0, 1]",111,56,55,5,3,0.08928571428571429,0.05454545454545454
"[0, 1, 0, 0, 0, 0, 1, 0, 1, 0, 0, 1, 0, 1, 0]",216,134,82,9,7,0.06716417910447761,0.08536585365853659
"[1, 1, 1, 1, 0, 1, 1, 1, 1, 1, 1, 0, 0, 1, 1]",3166,663,2503,53,219,0.07993966817496229,0.08749500599280863
"[1, 1, 1, 0, 0, 1, 1, 0, 0, 1, 1, 1, 1, 1, 0]",662,145,517,15,47,0.10344827586206896,0.09090909090909091
"[1, 1, 0, 0, 0, 0, 1, 0, 0, 0, 1, 0, 0, 1, 0]",244,154,90,21,9,0.13636363636363635,0.1
"[1, 0, 1, 1, 0, 1, 0, 1, 1, 0, 0, 0, 0, 1, 0]",105,52,53,7,3,0.1346153846153846,0.05660377358490566
"[0, 0, 1, 1, 0, 0, 1, 1, 0, 0, 0, 0, 0, 0, 0]",4689,3363,1326,317,132,0.09426107641986321,0.09954751131221719
"[0, 0, 0, 0, 0, 0, 0, 1, 0, 1, 1, 0, 1, 1, 0]",265,178,87,15,7,0.08426966292134831,0.08045977011494253
"[0, 0, 0, 0, 1, 0, 1, 0, 0, 1, 1, 0, 0, 0, 0]",860,598,262,47,25,0.07859531772575251,0.09541984732824428
"[1, 0, 1, 1, 1, 0, 0, 1, 1, 1, 1, 0, 1, 1, 1]",600,177,423,18,39,0.1016949152542373,0.09219858156028368
"[0, 0, 0, 0, 1, 1, 0, 1, 1, 1, 0, 0, 1, 1, 1]",252,120,132,12,13,0.1,0.09848484848484848
"[0, 1, 1, 1, 1, 0, 1, 1, 0, 0, 1, 0, 0, 1, 0]",119,53,66,4,5,0.07547169811320754,0.07575757575757576
"[0, 0, 0, 0, 1, 0, 0, 0, 1, 0, 0, 1, 0, 1, 0]",508,369,139,41,17,0.1111111111111111,0.1223021582733813
"[0, 1, 1, 1, 1, 0, 0, 1, 0, 1, 0, 1, 1, 1, 0]",158,66,92,9,12,0.13636363636363635,0.13043478260869565
"[1, 0, 1, 0, 0, 0, 1, 1, 1, 1, 0, 0, 1, 0, 1]",133,60,73,6,12,0.1,0.1643835616438356
"[1, 0, 1, 1, 1, 1, 1, 0, 1, 0, 1, 0, 1, 1, 1]",546,187,359,22,38,0.11764705882352941,0.10584958217270195
"[1, 0, 1, 0, 1, 1, 1, 1, 1, 0, 1, 0, 1, 0, 1]",239,81,158,6,19,0.07407407407407407,0.12025316455696203
"[0, 1, 1, 1, 0, 1, 0, 1, 1, 1, 1, 1, 0, 1, 0]",238,77,161,7,17,0.09090909090909091,0.10559006211180125
"[1, 0, 1, 0, 0, 1, 1, 0, 0, 0, 1, 1, 1, 0, 1]",110,47,63,3,1,0.06382978723404255,0.015873015873015872
"[0, 1, 0, 0, 0, 1, 1, 1, 1, 0, 1, 0, 0, 1, 1]",138,72,66,11,6,0.1527777777777778,0.09090909090909091
"[0, 0, 0, 0, 0, 0, 0, 0, 1, 1, 0, 0, 0, 0, 1]",7523,5617,1906,510,171,0.0907957984689336,0.08971668415529906
"[0, 0, 0, 1, 0, 0, 0, 0, 0, 0, 0, 0, 0, 1, 1]",4087,3297,790,288,81,0.08735213830755233,0.10253164556962026
"[1, 0, 0, 0, 1, 0, 0, 0, 0, 0, 0, 0, 0, 0, 1]",1977,1459,518,142,53,0.09732693625771076,0.10231660231660232
"[0, 1, 1, 1, 0, 0, 0, 1, 0, 0, 1, 1, 1, 1, 1]",199,92,107,8,10,0.08695652173913043,0.09345794392523364
"[1, 0, 1, 1, 1, 0, 0, 0, 1, 0, 0, 1, 1, 1, 1]",189,75,114,9,10,0.12,0.08771929824561403
"[0, 1, 0, 0, 0, 1, 0, 0, 1, 0, 1, 1, 1, 1, 0]",108,67,41,7,5,0.1044776119402985,0.12195121951219512
"[1, 1, 1, 1, 0, 0, 1, 0, 1, 1, 1, 1, 1, 1, 0]",683,177,506,15,47,0.0847457627118644,0.09288537549407115
"[1, 1, 1, 1, 1, 0, 1, 1, 1, 0, 0, 0, 1, 0, 0]",157,72,85,7,7,0.09722222222222222,0.08235294117647059
"[0, 1, 1, 1, 0, 1, 1, 1, 1, 1, 0, 0, 1, 0, 0]",177,71,106,4,4,0.056338028169014086,0.03773584905660377
"[1, 1, 0, 0, 1, 1, 0, 0, 0, 0, 1, 1, 1, 1, 1]",2469,970,1499,93,119,0.09587628865979382,0.07938625750500333
"[0, 0, 0, 1, 1, 0, 0, 1, 0, 1, 1, 1, 0, 1, 0]",129,73,56,5,7,0.0684931506849315,0.125
"[1, 1, 1, 0, 0, 0, 1, 1, 0, 0, 1, 0, 1, 1, 1]",225,91,134,9,18,0.0989010989010989,0.13432835820895522
"[0, 0, 1, 0, 0, 1, 0, 1, 0, 0, 0, 0, 1, 1, 0]",302,189,113,24,9,0.12698412698412698,0.07964601769911504
"[0, 1, 1, 1, 0, 0, 1, 0, 0, 1, 0, 1, 0, 1, 0]",98,45,53,5,3,0.1111111111111111,0.05660377358490566
"[0, 0, 0, 0, 0, 0, 0, 0, 1, 1, 0, 1, 1, 0, 0]",898,634,264,52,20,0.08201892744479496,0.07575757575757576
"[0, 0, 0, 0, 0, 0, 0, 0, 0, 0, 1, 1, 0, 1, 1]",1818,1360,458,125,47,0.09191176470588236,0.10262008733624454
"[1, 0, 0, 1, 0, 1, 0, 0, 1, 1, 0, 0, 0, 0, 0]",400,236,164,17,27,0.07203389830508475,0.16463414634146342
"[1, 1, 0, 0, 1, 1, 1, 0, 0, 1, 0, 1, 0, 0, 1]",132,65,67,11,5,0.16923076923076924,0.07462686567164178
"[1, 0, 0, 0, 1, 0, 0, 1, 1, 1, 1, 0, 0, 0, 1]",129,66,63,6,4,0.09090909090909091,0.06349206349206349
"[1, 1, 1, 1, 0, 0, 1, 1, 0, 0, 0, 1, 0, 0, 1]",242,110,132,10,6,0.09090909090909091,0.045454545454545456
"[1, 1, 1, 1, 1, 0, 1, 0, 0, 0, 0, 0, 0, 1, 1]",289,126,163,14,14,0.1111111111111111,0.08588957055214724
"[0, 1, 1, 1, 1, 1, 0, 1, 0, 0, 0, 0, 0, 0, 1]",169,93,76,11,5,0.11827956989247312,0.06578947368421052
"[0, 0, 0, 0, 1, 0, 1, 0, 1, 1, 1, 1, 1, 0, 1]",113,58,55,8,5,0.13793103448275862,0.09090909090909091
"[0, 0, 1, 1, 0, 1, 0, 1, 0, 0, 0, 1, 1, 0, 1]",107,50,57,2,7,0.04,0.12280701754385964
"[1, 0, 0, 1, 0, 0, 1, 0, 0, 1, 0, 0, 0, 1, 1]",186,97,89,11,10,0.1134020618556701,0.11235955056179775
"[1, 0, 0, 1, 1, 0, 1, 0, 0, 1, 0, 0, 1, 0, 0]",121,71,50,8,4,0.11267605633802817,0.08
"[1, 1, 1, 0, 0, 1, 1, 0, 1, 1, 1, 1, 1, 0, 1]",553,155,398,15,33,0.0967741935483871,0.0829145728643216
"[0, 1, 1, 1, 0, 0, 1, 1, 0, 1, 1, 1, 1, 1, 0]",274,91,183,8,20,0.08791208791208792,0.1092896174863388
"[0, 1, 0, 0, 1, 0, 1, 0, 0, 1, 0, 0, 1, 1, 1]",129,74,55,7,4,0.0945945945945946,0.07272727272727272
"[0, 0, 0, 0, 0, 1, 0, 1, 1, 1, 1, 0, 0, 0, 0]",491,339,152,33,13,0.09734513274336283,0.08552631578947369
"[0, 1, 1, 0, 0, 0, 1, 0, 0, 0, 1, 0, 1, 0, 0]",226,153,73,15,6,0.09803921568627451,0.0821917808219178
"[0, 0, 1, 0, 0, 1, 1, 1, 0, 0, 0, 0, 0, 1, 0]",250,164,86,15,9,0.09146341463414634,0.10465116279069768
"[0, 0, 0, 0, 0, 1, 1, 0, 0, 0, 1, 0, 0, 1, 0]",669,498,171,56,15,0.11244979919678715,0.08771929824561403
"[1, 0, 0, 0, 0, 0, 0, 1, 0, 1, 1, 1, 1, 0, 0]",249,131,118,15,13,0.11450381679389313,0.11016949152542373
"[0, 0, 0, 1, 1, 0, 0, 0, 1, 0, 0, 1, 0, 0, 0]",606,452,154,49,13,0.1084070796460177,0.08441558441558442
"[1, 0, 1, 1, 1, 0, 0, 0, 0, 1, 1, 1, 0, 1, 1]",198,95,103,14,9,0.14736842105263157,0.08737864077669903
"[0, 0, 1, 0, 0, 1, 1, 1, 1, 1, 0, 1, 0, 0, 0]",143,79,64,6,7,0.0759493670886076,0.109375
"[0, 0, 1, 1, 1, 1, 0, 1, 1, 0, 0, 0, 0, 1, 0]",128,69,59,9,9,0.13043478260869565,0.15254237288135594
"[0, 0, 0, 0, 1, 0, 1, 0, 1, 1, 0, 0, 0, 0, 0]",838,591,247,50,32,0.08460236886632826,0.12955465587044535
"[0, 0, 0, 1, 0, 0, 0, 1, 0, 0, 1, 1, 0, 0, 0]",709,500,209,45,21,0.09,0.10047846889952153
"[0, 0, 1, 1, 0, 0, 0, 1, 0, 0, 0, 1, 0, 0, 1]",255,168,87,12,11,0.07142857142857142,0.12643678160919541
"[1, 0, 0, 1, 0, 0, 1, 1, 0, 0, 0, 1, 0, 0, 0]",269,183,86,16,12,0.08743169398907104,0.13953488372093023
"[1, 0, 1, 0, 1, 1, 1, 0, 1, 0, 0, 1, 0, 1, 1]",140,54,86,5,7,0.09259259259259259,0.08139534883720931
"[1, 0, 0, 1, 1, 1, 0, 1, 0, 1, 1, 1, 0, 1, 0]",124,57,67,8,7,0.14035087719298245,0.1044776119402985
"[1, 1, 1, 0, 1, 0, 0, 1, 0, 1, 0, 0, 0, 0, 0]",199,124,75,14,8,0.11290322580645161,0.10666666666666667
"[0, 0, 0, 1, 1, 1, 0, 1, 0, 0, 1, 0, 1, 0, 0]",160,102,58,15,9,0.14705882352941177,0.15517241379310345
"[0, 0, 0, 0, 0, 0, 0, 0, 1, 0, 1, 0, 0, 1, 0]",1708,1332,376,133,26,0.09984984984984985,0.06914893617021277
"[0, 1, 0, 1, 1, 1, 1, 0, 0, 0, 0, 1, 1, 1, 1]",568,244,324,29,31,0.11885245901639344,0.09567901234567901
"[0, 0, 1, 1, 0, 0, 0, 0, 0, 0, 0, 0, 1, 0, 1]",1159,798,361,86,37,0.10776942355889724,0.10249307479224377
"[1, 0, 0, 0, 1, 0, 1, 1, 1, 1, 1, 1, 1, 0, 0]",251,91,160,5,19,0.054945054945054944,0.11875
"[1, 1, 0, 0, 0, 1, 0, 1, 1, 1, 1, 1, 1, 1, 0]",317,117,200,11,24,0.09401709401709402,0.12
"[0, 0, 0, 1, 0, 0, 0, 0, 1, 1, 0, 1, 1, 0, 0]",310,209,101,17,9,0.08133971291866028,0.0891089108910891
"[1, 0, 0, 0, 1, 0, 0, 0, 0, 1, 1, 0, 1, 1, 0]",160,101,59,6,9,0.0594059405940594,0.15254237288135594
"[1, 1, 0, 0, 0, 0, 1, 0, 0, 0, 1, 0, 0, 0, 0]",601,406,195,42,18,0.10344827586206896,0.09230769230769231
"[0, 0, 0, 1, 0, 1, 0, 1, 0, 0, 0, 0, 0, 0, 1]",642,466,176,42,19,0.09012875536480687,0.10795454545454546
"[0, 0, 0, 1, 0, 0, 0, 1, 1, 1, 0, 1, 1, 0, 0]",165,95,70,7,9,0.07368421052631578,0.12857142857142856
"[0, 0, 0, 1, 1, 0, 0, 1, 1, 0, 0, 1, 1, 0, 1]",399,303,96,22,1,0.07260726072607261,0.010416666666666666
"[1, 0, 0, 1, 1, 1, 0, 1, 0, 0, 1, 1, 1, 1, 1]",396,123,273,8,27,0.06504065040650407,0.0989010989010989
"[0, 0, 0, 0, 1, 0, 0, 1, 1, 1, 0, 1, 0, 0, 1]",171,102,69,15,8,0.14705882352941177,0.11594202898550725
"[1, 1, 1, 1, 0, 0, 0, 0, 1, 1, 0, 0, 0, 1, 1]",506,237,269,20,22,0.08438818565400844,0.08178438661710037
"[0, 0, 1, 0, 0, 1, 0, 0, 1, 1, 0, 0, 1, 1, 1]",237,137,100,12,8,0.08759124087591241,0.08
"[0, 1, 1, 1, 0, 0, 1, 1, 1, 1, 0, 1, 0, 0, 1]",165,71,94,8,11,0.11267605633802817,0.11702127659574468
"[1, 1, 1, 0, 0, 1, 0, 1, 0, 0, 0, 0, 0, 1, 1]",194,87,107,12,15,0.13793103448275862,0.14018691588785046
"[0, 0, 0, 0, 1, 0, 0, 1, 0, 1, 1, 1, 0, 0, 1]",201,115,86,13,11,0.11304347826086956,0.12790697674418605
"[0, 1, 0, 0, 0, 0, 1, 0, 0, 1, 0, 1, 1, 1, 0]",164,96,68,8,6,0.08333333333333333,0.08823529411764706
"[1, 0, 0, 0, 0, 0, 0, 1, 0, 0, 0, 0, 0, 1, 0]",1640,1188,452,114,36,0.09595959595959595,0.07964601769911504
"[0, 1, 0, 0, 1, 0, 0, 0, 0, 0, 0, 1, 0, 0, 0]",1603,1266,337,116,27,0.09162717219589257,0.08011869436201781
"[0, 0, 0, 0, 1, 1, 0, 0, 1, 0, 1, 1, 0, 1, 0]",166,87,79,3,7,0.034482758620689655,0.08860759493670886
"[1, 0, 1, 0, 0, 0, 1, 0, 0, 1, 0, 0, 1, 1, 0]",184,108,76,9,4,0.08333333333333333,0.05263157894736842
"[1, 0, 1, 0, 1, 0, 0, 0, 1, 0, 0, 1, 0, 0, 1]",141,87,54,6,3,0.06896551724137931,0.05555555555555555
"[0, 1, 0, 1, 0, 1, 0, 0, 0, 1, 0, 0, 1, 0, 0]",237,152,85,17,4,0.1118421052631579,0.047058823529411764
"[0, 1, 1, 1, 0, 1, 1, 1, 0, 0, 0, 1, 0, 0, 1]",111,56,55,2,4,0.03571428571428571,0.07272727272727272
"[1, 0, 0, 0, 1, 0, 1, 1, 0, 1, 0, 0, 0, 0, 1]",160,86,74,7,5,0.08139534883720931,0.06756756756756757
"[1, 1, 0, 0, 0, 0, 0, 0, 0, 1, 0, 0, 0, 1, 0]",640,447,193,38,18,0.08501118568232663,0.09326424870466321
"[1, 1, 0, 1, 1, 0, 0, 1, 1, 1, 0, 0, 0, 0, 0]",179,91,88,9,8,0.0989010989010989,0.09090909090909091
"[1, 0, 1, 1, 0, 1, 1, 1, 0, 0, 0, 0, 0, 1, 1]",158,68,90,9,9,0.1323529411764706,0.1
"[0, 0, 1, 0, 1, 1, 0, 0, 1, 0, 1, 0, 1, 0, 1]",100,46,54,5,5,0.10869565217391304,0.09259259259259259
"[0, 0, 0, 1, 0, 1, 1, 0, 0, 1, 0, 1, 0, 1, 0]",124,75,49,7,5,0.09333333333333334,0.10204081632653061
"[0, 0, 0, 1, 0, 0, 0, 0, 0, 0, 1, 0, 0, 1, 0]",1493,1138,355,98,33,0.08611599297012303,0.09295774647887324
"[0, 0, 0, 1, 0, 1, 1, 0, 0, 0, 1, 0, 0, 0, 0]",617,438,179,46,14,0.1050228310502283,0.0782122905027933
"[1, 0, 1, 1, 0, 1, 1, 0, 1, 0, 0, 1, 0, 1, 0]",96,42,54,7,6,0.16666666666666666,0.1111111111111111
"[1, 0, 0, 1, 0, 1, 1, 0, 1, 1, 0, 1, 0, 0, 1]",122,64,58,8,4,0.125,0.06896551724137931
"[0, 1, 0, 1, 1, 1, 0, 0, 0, 0, 1, 0, 0, 0, 0]",264,174,90,15,8,0.08620689655172414,0.08888888888888889
"[0, 0, 1, 0, 0, 0, 1, 1, 0, 0, 0, 0, 1, 1, 0]",578,395,183,35,19,0.08860759493670886,0.10382513661202186
"[0, 0, 0, 1, 0, 1, 0, 1, 0, 0, 0, 0, 1, 0, 1]",254,160,94,15,13,0.09375,0.13829787234042554
"[0, 1, 0, 1, 0, 0, 0, 0, 1, 0, 0, 0, 0, 1, 0]",480,326,154,42,13,0.12883435582822086,0.08441558441558442
"[1, 1, 1, 0, 0, 1, 0, 0, 0, 1, 0, 0, 0, 0, 0]",261,152,109,16,11,0.10526315789473684,0.10091743119266056
"[1, 0, 1, 0, 1, 1, 1, 0, 0, 1, 0, 0, 0, 1, 0]",113,65,48,8,6,0.12307692307692308,0.125
"[1, 1, 0, 0, 1, 0, 1, 1, 1, 0, 0, 1, 1, 1, 1]",422,145,277,17,21,0.11724137931034483,0.07581227436823104
"[0, 1, 1, 1, 1, 1, 1, 1, 1, 1, 1, 0, 1, 1, 0]",1945,653,1292,59,112,0.0903522205206738,0.08668730650154799
"[0, 1, 1, 0, 1, 0, 1, 0, 1, 1, 1, 1, 1, 1, 1]",671,226,445,17,43,0.0752212389380531,0.09662921348314607
"[1, 1, 1, 1, 1, 1, 1, 0, 1, 0, 0, 1, 1, 1, 0]",588,139,449,11,34,0.07913669064748201,0.0757238307349666
"[1, 1, 0, 1, 0, 1, 0, 1, 1, 0, 1, 0, 1, 1, 0]",146,62,84,4,6,0.06451612903225806,0.07142857142857142
"[1, 1, 1, 0, 1, 0, 0, 1, 1, 1, 1, 0, 0, 1, 1]",580,194,386,25,37,0.12886597938144329,0.09585492227979274
"[0, 1, 0, 0, 0, 0, 1, 1, 1, 1, 0, 0, 0, 1, 1]",200,107,93,4,11,0.037383177570093455,0.11827956989247312
"[1, 0, 1, 0, 1, 0, 1, 1, 0, 0, 0, 0, 1, 1, 1]",225,106,119,12,14,0.11320754716981132,0.11764705882352941
"[1, 0, 0, 0, 0, 0, 1, 1, 1, 0, 0, 0, 1, 0, 0]",267,176,91,17,8,0.09659090909090909,0.08791208791208792
"[0, 0, 1, 1, 0, 1, 0, 0, 0, 0, 0, 1, 1, 1, 0]",175,98,77,8,6,0.08163265306122448,0.07792207792207792
"[1, 0, 1, 1, 0, 1, 1, 1, 0, 0, 1, 1, 1, 1, 1]",784,234,550,21,59,0.08974358974358974,0.10727272727272727
"[0, 0, 0, 0, 0, 1, 0, 0, 0, 0, 0, 1, 1, 1, 0]",621,464,157,39,20,0.08405172413793104,0.12738853503184713
"[1, 0, 0, 1, 0, 0, 0, 1, 0, 0, 0, 1, 0, 0, 1]",232,144,88,14,6,0.09722222222222222,0.06818181818181818
"[1, 1, 1, 0, 0, 1, 0, 1, 1, 1, 1, 1, 1, 0, 1]",574,157,417,16,37,0.10191082802547771,0.08872901678657075
"[1, 1, 0, 0, 0, 0, 1, 1, 1, 1, 0, 1, 1, 1, 1]",774,279,495,22,43,0.07885304659498207,0.08686868686868687
"[1, 0, 0, 1, 1, 1, 1, 0, 0, 0, 0, 1, 1, 1, 1]",2160,350,1810,39,168,0.11142857142857143,0.09281767955801105
"[1, 1, 1, 1, 1, 1, 0, 1, 0, 0, 1, 1, 1, 1, 1]",2515,577,1938,47,194,0.08145580589254767,0.1001031991744066
"[0, 0, 1, 0, 1, 1, 1, 0, 0, 0, 0, 0, 0, 0, 0]",942,652,290,66,28,0.10122699386503067,0.09655172413793103
"[1, 1, 0, 0, 0, 0, 1, 1, 1, 1, 1, 1, 0, 1, 1]",825,299,526,23,42,0.07692307692307693,0.07984790874524715
"[0, 0, 0, 0, 1, 1, 1, 1, 0, 0, 0, 0, 0, 0, 1]",2465,1546,919,134,99,0.08667529107373868,0.10772578890097932
"[0, 1, 1, 1, 1, 1, 0, 1, 1, 1, 0, 0, 0, 0, 0]",196,88,108,15,15,0.17045454545454544,0.1388888888888889
"[0, 1, 0, 1, 0, 0, 0, 1, 0, 0, 0, 0, 0, 1, 1]",342,233,109,22,8,0.0944206008583691,0.07339449541284404
"[0, 1, 0, 0, 1, 1, 1, 1, 0, 1, 0, 0, 1, 0, 1]",109,56,53,4,8,0.07142857142857142,0.1509433962264151
"[0, 1, 1, 1, 0, 1, 0, 1, 1, 1, 1, 0, 1, 0, 1]",223,73,150,7,22,0.0958904109589041,0.14666666666666667
"[1, 1, 1, 1, 1, 1, 0, 1, 0, 1, 1, 1, 0, 1, 0]",505,155,350,14,28,0.09032258064516129,0.08
"[0, 1, 1, 1, 1, 1, 0, 0, 0, 0, 0, 0, 0, 1, 1]",298,175,123,16,9,0.09142857142857143,0.07317073170731707
"[0, 0, 0, 0, 0, 1, 1, 0, 0, 1, 0, 0, 1, 0, 1]",308,222,86,25,7,0.11261261261261261,0.08139534883720931
"[0, 0, 0, 0, 0, 1, 1, 0, 1, 1, 1, 1, 0, 0, 1]",199,123,76,11,11,0.08943089430894309,0.14473684210526316
"[0, 0, 0, 0, 0, 0, 0, 0, 1, 1, 0, 1, 1, 1, 1]",679,463,216,41,19,0.08855291576673865,0.08796296296296297
"[0, 1, 1, 0, 1, 0, 0, 0, 1, 0, 0, 1, 0, 0, 1]",140,86,54,13,5,0.1511627906976744,0.09259259259259259
"[1, 0, 1, 0, 1, 1, 0, 1, 0, 1, 1, 1, 0, 0, 1]",163,62,101,6,6,0.0967741935483871,0.0594059405940594
"[1, 0, 0, 1, 0, 0, 1, 1, 0, 1, 0, 1, 1, 1, 1]",202,65,137,9,16,0.13846153846153847,0.11678832116788321
"[0, 0, 1, 1, 1, 1, 0, 1, 0, 0, 0, 1, 1, 1, 1]",275,111,164,13,14,0.11711711711711711,0.08536585365853659
"[0, 1, 1, 1, 1, 0, 0, 1, 1, 1, 1, 0, 1, 0, 0]",289,185,104,17,14,0.0918918918918919,0.1346153846153846
"[0, 1, 1, 0, 1, 0, 1, 0, 0, 0, 0, 0, 0, 0, 0]",795,561,234,59,19,0.1051693404634581,0.0811965811965812
"[0, 0, 0, 0, 0, 0, 1, 0, 0, 1, 1, 1, 0, 0, 0]",743,521,222,47,20,0.09021113243761997,0.09009009009009009
"[0, 1, 1, 1, 1, 0, 0, 1, 1, 1, 0, 1, 1, 1, 1]",867,416,451,39,36,0.09375,0.07982261640798226
"[0, 0, 1, 1, 1, 1, 0, 0, 1, 1, 1, 0, 1, 1, 1]",662,242,420,25,30,0.10330578512396695,0.07142857142857142
"[0, 0, 0, 0, 1, 1, 0, 0, 1, 1, 1, 1, 0, 0, 1]",1658,878,780,90,63,0.10250569476082004,0.08076923076923077
"[1, 1, 1, 0, 1, 0, 0, 1, 0, 0, 0, 1, 1, 1, 0]",102,49,53,4,5,0.08163265306122448,0.09433962264150944
"[1, 1, 1, 1, 0, 0, 1, 0, 1, 1, 1, 1, 1, 1, 1]",2320,567,1753,34,155,0.059964726631393295,0.08841985168282944
"[1, 1, 1, 0, 0, 0, 0, 1, 1, 0, 0, 1, 1, 1, 1]",2374,394,1980,29,178,0.07360406091370558,0.0898989898989899
"[0, 0, 0, 0, 0, 0, 1, 1, 1, 0, 0, 0, 0, 1, 1]",786,536,250,60,26,0.11194029850746269,0.104
"[1, 1, 1, 1, 1, 0, 0, 1, 0, 1, 1, 1, 0, 0, 1]",303,104,199,4,16,0.038461538461538464,0.08040201005025126
"[1, 0, 1, 0, 1, 1, 1, 1, 0, 1, 1, 1, 1, 1, 0]",527,176,351,17,46,0.09659090909090909,0.13105413105413105
"[1, 0, 1, 1, 1, 0, 0, 1, 0, 1, 0, 1, 0, 0, 0]",123,65,58,9,6,0.13846153846153847,0.10344827586206896
"[1, 0, 0, 0, 0, 1, 1, 0, 1, 0, 0, 0, 1, 0, 0]",272,161,111,14,18,0.08695652173913043,0.16216216216216217
"[0, 0, 0, 0, 0, 1, 0, 0, 0, 0, 1, 1, 0, 1, 0]",552,377,175,25,14,0.06631299734748011,0.08
"[1, 0, 0, 0, 0, 0, 0, 0, 1, 0, 1, 0, 1, 1, 1]",320,144,176,20,17,0.1388888888888889,0.09659090909090909
"[0, 0, 1, 0, 0, 1, 1, 0, 0, 0, 0, 0, 0, 0, 1]",756,539,217,47,22,0.08719851576994433,0.10138248847926268
"[1, 0, 1, 1, 0, 1, 1, 1, 1, 1, 1, 0, 0, 1, 1]",1029,321,708,29,58,0.09034267912772585,0.08192090395480225
"[1, 1, 1, 1, 1, 0, 1, 1, 1, 1, 0, 0, 0, 1, 0]",270,93,177,10,16,0.10752688172043011,0.0903954802259887
"[1, 1, 1, 1, 1, 1, 0, 1, 1, 1, 1, 0, 0, 0, 1]",700,210,490,25,55,0.11904761904761904,0.11224489795918367
"[0, 1, 0, 1, 0, 0, 1, 1, 1, 1, 1, 1, 1, 1, 1]",1078,347,731,31,70,0.0893371757925072,0.09575923392612859
"[1, 0, 1, 0, 1, 0, 0, 1, 1, 1, 1, 1, 1, 1, 1]",1008,318,690,27,88,0.08490566037735849,0.12753623188405797
"[1, 1, 1, 0, 1, 0, 0, 1, 0, 1, 0, 1, 0, 1, 0]",104,52,52,5,5,0.09615384615384616,0.09615384615384616
"[0, 1, 0, 1, 0, 1, 0, 0, 1, 1, 1, 0, 0, 1, 1]",137,62,75,5,9,0.08064516129032258,0.12
"[1, 1, 1, 0, 0, 1, 1, 1, 0, 0, 1, 1, 0, 1, 0]",155,56,99,4,8,0.07142857142857142,0.08080808080808081
"[0, 0, 0, 0, 0, 1, 0, 1, 1, 1, 0, 0, 1, 1, 1]",245,147,98,15,12,0.10204081632653061,0.12244897959183673
"[0, 1, 0, 0, 0, 0, 0, 1, 0, 1, 1, 1, 0, 0, 1]",171,104,67,7,6,0.0673076923076923,0.08955223880597014
"[1, 0, 0, 0, 1, 0, 0, 0, 0, 0, 1, 0, 1, 1, 1]",215,122,93,13,7,0.10655737704918032,0.07526881720430108
"[0, 1, 1, 0, 0, 0, 1, 0, 1, 1, 0, 0, 0, 1, 0]",142,85,57,13,6,0.15294117647058825,0.10526315789473684
"[0, 0, 0, 1, 1, 1, 0, 0, 0, 0, 1, 1, 0, 0, 0]",633,422,211,50,21,0.11848341232227488,0.0995260663507109
"[0, 0, 1, 1, 1, 1, 1, 0, 1, 1, 0, 0, 1, 1, 1]",422,150,272,15,29,0.1,0.10661764705882353
"[0, 1, 1, 0, 1, 0, 1, 1, 0, 1, 0, 0, 1, 1, 1]",186,79,107,9,10,0.11392405063291139,0.09345794392523364
"[1, 0, 1, 1, 1, 1, 0, 1, 1, 1, 1, 0, 0, 0, 1]",277,97,180,4,19,0.041237113402061855,0.10555555555555556
"[0, 0, 0, 0, 0, 1, 0, 0, 1, 0, 1, 0, 0, 1, 0]",513,382,131,43,7,0.112565445026178,0.05343511450381679
"[0, 0, 1, 1, 1, 1, 1, 0, 1, 0, 1, 1, 0, 0, 0]",176,68,108,8,13,0.11764705882352941,0.12037037037037036
"[1, 1, 1, 1, 0, 1, 1, 0, 0, 0, 1, 1, 1, 1, 1]",854,261,593,23,54,0.08812260536398467,0.09106239460370995
"[1, 1, 1, 1, 1, 0, 1, 1, 1, 1, 0, 0, 1, 1, 1]",2942,687,2255,61,203,0.08879184861717612,0.09002217294900222
"[0, 0, 0, 1, 1, 1, 0, 1, 1, 0, 0, 0, 1, 1, 0]",147,79,68,3,6,0.0379746835443038,0.08823529411764706
"[0, 0, 0, 0, 0, 1, 0, 0, 0, 1, 1, 1, 1, 1, 1]",376,237,139,24,11,0.10126582278481013,0.07913669064748201
"[0, 0, 0, 0, 1, 0, 0, 1, 0, 1, 1, 0, 1, 1, 0]",157,92,65,3,7,0.03260869565217391,0.1076923076923077
"[1, 0, 1, 1, 0, 0, 0, 1, 0, 0, 0, 1, 0, 1, 0]",127,68,59,4,3,0.058823529411764705,0.05084745762711865
"[0, 0, 1, 0, 0, 0, 1, 0, 0, 0, 1, 0, 0, 0, 0]",1630,1203,427,109,46,0.09060681629260182,0.10772833723653395
"[1, 0, 0, 1, 1, 1, 1, 1, 1, 1, 0, 0, 1, 1, 1]",1533,354,1179,32,116,0.0903954802259887,0.09838846480067855
"[1, 1, 1, 1, 0, 0, 1, 1, 1, 1, 1, 1, 1, 0, 0]",1437,420,1017,46,91,0.10952380952380952,0.08947885939036382
"[1, 1, 0, 0, 1, 1, 0, 0, 1, 0, 0, 0, 0, 0, 1]",227,132,95,14,8,0.10606060606060606,0.08421052631578947
"[1, 0, 1, 0, 1, 0, 0, 1, 0, 0, 1, 1, 0, 0, 1]",149,78,71,1,6,0.01282051282051282,0.08450704225352113
"[1, 0, 1, 1, 1, 0, 0, 0, 1, 0, 1, 0, 1, 1, 1]",150,61,89,4,11,0.06557377049180328,0.12359550561797752
"[0, 0, 1, 0, 0, 1, 1, 0, 0, 1, 1, 0, 1, 1, 1]",158,83,75,14,6,0.1686746987951807,0.08
"[1, 0, 1, 0, 1, 0, 1, 0, 0, 0, 0, 1, 0, 1, 0]",120,58,62,5,3,0.08620689655172414,0.04838709677419355
"[1, 1, 1, 0, 0, 0, 1, 1, 0, 0, 0, 1, 0, 1, 1]",144,62,82,1,4,0.016129032258064516,0.04878048780487805
"[0, 1, 1, 1, 1, 1, 1, 0, 0, 0, 1, 1, 0, 0, 0]",223,134,89,16,9,0.11940298507462686,0.10112359550561797
"[0, 0, 1, 1, 1, 1, 1, 1, 0, 0, 0, 1, 1, 0, 0]",265,130,135,17,15,0.13076923076923078,0.1111111111111111
"[0, 1, 0, 0, 0, 1, 0, 0, 1, 1, 1, 1, 1, 1, 0]",188,97,91,15,7,0.15463917525773196,0.07692307692307693
"[0, 1, 1, 0, 1, 1, 1, 0, 1, 0, 0, 0, 1, 0, 0]",101,49,52,4,5,0.08163265306122448,0.09615384615384616
"[0, 0, 0, 0, 0, 1, 0, 1, 0, 0, 0, 1, 0, 0, 1]",527,370,157,39,16,0.10540540540540541,0.10191082802547771
"[0, 1, 0, 1, 1, 0, 1, 0, 1, 1, 0, 0, 1, 1, 1]",192,75,117,7,8,0.09333333333333334,0.06837606837606838
"[1, 1, 1, 1, 0, 1, 0, 1, 0, 1, 1, 0, 1, 0, 1]",259,87,172,6,15,0.06896551724137931,0.0872093023255814
"[1, 0, 1, 0, 0, 0, 0, 0, 1, 0, 1, 0, 1, 1, 0]",145,83,62,5,2,0.060240963855421686,0.03225806451612903
"[0, 0, 1, 0, 0, 1, 1, 1, 1, 0, 1, 1, 1, 0, 1]",142,66,76,6,8,0.09090909090909091,0.10526315789473684
"[0, 1, 0, 1, 1, 1, 1, 0, 0, 1, 0, 0, 1, 1, 1]",187,74,113,11,10,0.14864864864864866,0.08849557522123894
"[1, 1, 0, 1, 0, 1, 1, 1, 1, 0, 0, 1, 0, 0, 1]",164,65,99,7,10,0.1076923076923077,0.10101010101010101
"[0, 0, 0, 0, 0, 1, 0, 0, 1, 0, 0, 1, 0, 0, 1]",548,396,152,39,12,0.09848484848484848,0.07894736842105263
"[0, 0, 0, 1, 0, 0, 0, 0, 0, 1, 0, 1, 0, 0, 0]",1649,1271,378,124,37,0.0975609756097561,0.09788359788359788
"[1, 0, 0, 0, 0, 0, 1, 0, 0, 0, 0, 0, 0, 0, 1]",1782,1299,483,132,46,0.10161662817551963,0.09523809523809523
"[1, 0, 0, 0, 0, 0, 0, 1, 1, 0, 0, 0, 0, 0, 1]",1182,545,637,46,71,0.08440366972477065,0.11145996860282574
"[0, 1, 0, 0, 0, 0, 1, 1, 0, 1, 0, 0, 0, 0, 0]",588,414,174,39,18,0.09420289855072464,0.10344827586206896
"[0, 0, 0, 0, 0, 0, 0, 1, 0, 0, 1, 1, 1, 1, 1]",547,384,163,37,15,0.09635416666666667,0.09202453987730061
"[1, 1, 1, 0, 1, 0, 0, 0, 0, 0, 0, 0, 1, 0, 0]",268,170,98,16,13,0.09411764705882353,0.1326530612244898
"[1, 0, 1, 0, 1, 1, 0, 0, 0, 0, 0, 0, 0, 1, 1]",295,172,123,13,12,0.0755813953488372,0.0975609756097561
"[0, 0, 0, 1, 0, 0, 0, 1, 0, 0, 0, 0, 1, 0, 0]",1522,1134,388,96,36,0.08465608465608465,0.09278350515463918
"[0, 0, 1, 1, 0, 1, 0, 0, 0, 0, 0, 0, 0, 0, 0]",2386,1806,580,169,58,0.09357696566998892,0.1
"[0, 0, 0, 1, 1, 1, 1, 0, 1, 1, 1, 0, 0, 1, 1]",248,125,123,11,11,0.088,0.08943089430894309
"[1, 0, 0, 0, 0, 0, 1, 1, 0, 0, 1, 0, 0, 1, 1]",206,120,86,15,11,0.125,0.12790697674418605
"[1, 1, 1, 0, 0, 0, 0, 1, 0, 0, 0, 0, 0, 1, 1]",308,148,160,10,4,0.06756756756756757,0.025
"[0, 1, 0, 1, 1, 1, 1, 1, 1, 1, 0, 1, 0, 0, 1]",252,81,171,7,27,0.08641975308641975,0.15789473684210525
"[1, 0, 0, 1, 0, 1, 0, 1, 0, 1, 1, 0, 0, 0, 1]",118,66,52,6,4,0.09090909090909091,0.07692307692307693
"[1, 0, 0, 1, 0, 0, 1, 0, 0, 1, 1, 0, 1, 0, 0]",122,69,53,10,5,0.14492753623188406,0.09433962264150944
"[1, 1, 0, 0, 1, 0, 0, 1, 0, 0, 1, 1, 0, 1, 0]",105,60,45,5,4,0.08333333333333333,0.08888888888888889
"[1, 1, 0, 1, 0, 0, 0, 0, 0, 0, 0, 0, 0, 1, 0]",610,425,185,35,20,0.08235294117647059,0.10810810810810811
"[0, 0, 0, 0, 0, 0, 1, 1, 1, 1, 1, 1, 0, 1, 0]",354,188,166,13,18,0.06914893617021277,0.10843373493975904
"[1, 1, 1, 1, 1, 1, 0, 1, 1, 0, 1, 0, 0, 1, 1]",666,170,496,15,43,0.08823529411764706,0.08669354838709678
"[1, 1, 1, 0, 0, 0, 1, 1, 1, 1, 1, 1, 0, 1, 0]",264,94,170,11,15,0.11702127659574468,0.08823529411764706
"[1, 0, 1, 0, 1, 1, 1, 0, 1, 0, 0, 0, 1, 0, 1]",95,46,49,7,4,0.15217391304347827,0.08163265306122448
"[0, 0, 1, 0, 1, 0, 1, 1, 1, 0, 1, 0, 0, 0, 1]",100,61,39,6,5,0.09836065573770492,0.1282051282051282
"[0, 0, 1, 1, 0, 1, 0, 1, 0, 1, 1, 1, 1, 0, 1]",158,63,95,1,17,0.015873015873015872,0.17894736842105263
"[0, 1, 1, 1, 1, 1, 0, 0, 1, 1, 0, 1, 0, 1, 0]",165,83,82,10,7,0.12048192771084337,0.08536585365853659
"[1, 0, 1, 1, 1, 1, 1, 0, 0, 1, 1, 0, 1, 0, 1]",228,66,162,6,17,0.09090909090909091,0.10493827160493827
"[1, 1, 0, 0, 1, 1, 0, 0, 1, 0, 0, 0, 0, 1, 1]",251,132,119,6,9,0.045454545454545456,0.07563025210084033
"[0, 1, 0, 1, 0, 1, 1, 0, 0, 1, 1, 1, 0, 0, 1]",149,68,81,7,6,0.10294117647058823,0.07407407407407407
"[0, 0, 0, 0, 1, 0, 1, 0, 1, 1, 0, 0, 1, 1, 1]",226,128,98,7,10,0.0546875,0.10204081632653061
"[1, 1, 1, 0, 0, 0, 0, 0, 1, 0, 1, 0, 1, 1, 0]",121,54,67,5,3,0.09259259259259259,0.04477611940298507
"[1, 1, 0, 1, 0, 1, 0, 1, 1, 1, 0, 1, 1, 0, 0]",150,57,93,6,11,0.10526315789473684,0.11827956989247312
"[1, 0, 1, 1, 1, 0, 0, 1, 1, 1, 0, 1, 1, 1, 1]",632,185,447,16,39,0.08648648648648649,0.087248322147651
"[1, 1, 0, 1, 0, 1, 0, 1, 1, 1, 0, 1, 0, 0, 1]",126,47,79,1,10,0.02127659574468085,0.12658227848101267
"[1, 1, 0, 1, 0, 0, 1, 1, 1, 1, 1, 1, 1, 0, 1]",549,156,393,14,42,0.08974358974358974,0.10687022900763359
"[1, 1, 0, 1, 1, 1, 0, 1, 1, 1, 1, 1, 0, 1, 1]",1607,382,1225,31,103,0.08115183246073299,0.08408163265306122
"[1, 1, 1, 0, 0, 1, 1, 0, 1, 1, 1, 1, 0, 0, 1]",401,105,296,11,28,0.10476190476190476,0.0945945945945946
"[1, 1, 1, 1, 0, 0, 1, 1, 0, 1, 1, 1, 1, 0, 0]",466,161,305,12,36,0.07453416149068323,0.1180327868852459
"[1, 0, 0, 1, 1, 1, 1, 0, 0, 0, 1, 1, 1, 1, 1]",625,159,466,16,41,0.10062893081761007,0.08798283261802575
"[0, 0, 1, 1, 0, 0, 1, 1, 1, 1, 1, 1, 1, 0, 1]",716,256,460,21,35,0.08203125,0.07608695652173914
"[1, 1, 1, 1, 1, 0, 1, 1, 1, 0, 0, 0, 0, 1, 1]",562,166,396,13,39,0.0783132530120482,0.09848484848484848
"[0, 1, 0, 0, 1, 1, 0, 0, 0, 0, 1, 1, 0, 0, 0]",764,497,267,48,32,0.096579476861167,0.1198501872659176
"[0, 0, 0, 0, 1, 0, 0, 0, 0, 0, 0, 1, 0, 0, 1]",1666,1277,389,111,36,0.08692247454972592,0.09254498714652956
"[0, 1, 0, 1, 1, 0, 0, 1, 1, 1, 1, 0, 0, 0, 1]",155,67,88,8,10,0.11940298507462686,0.11363636363636363
"[1, 1, 1, 1, 0, 0, 1, 1, 0, 0, 1, 0, 1, 0, 1]",286,102,184,12,26,0.11764705882352941,0.14130434782608695
"[1, 1, 1, 1, 1, 0, 0, 1, 1, 0, 0, 1, 0, 1, 0]",272,71,201,9,18,0.1267605633802817,0.08955223880597014
"[1, 0, 0, 1, 1, 1, 1, 1, 1, 0, 0, 1, 1, 0, 0]",1926,313,1613,29,169,0.0926517571884984,0.10477371357718537
"[0, 1, 1, 1, 0, 1, 1, 1, 0, 0, 1, 0, 1, 1, 1]",274,111,163,11,13,0.0990990990990991,0.07975460122699386
"[0, 1, 0, 1, 1, 1, 0, 1, 1, 1, 0, 1, 1, 1, 0]",218,80,138,11,16,0.1375,0.11594202898550725
"[1, 0, 0, 0, 1, 1, 1, 0, 1, 0, 0, 0, 1, 0, 0]",146,88,58,6,5,0.06818181818181818,0.08620689655172414
"[0, 0, 0, 0, 0, 1, 1, 0, 0, 0, 0, 1, 1, 1, 0]",631,506,125,46,11,0.09090909090909091,0.088
"[1, 0, 0, 1, 0, 1, 0, 0, 1, 1, 0, 0, 1, 1, 1]",195,92,103,14,7,0.15217391304347827,0.06796116504854369
"[0, 1, 0, 1, 0, 0, 0, 1, 0, 0, 1, 0, 0, 1, 0]",215,144,71,17,7,0.11805555555555555,0.09859154929577464
"[1, 0, 0, 1, 0, 0, 0, 1, 0, 1, 0, 0, 0, 1, 0]",212,134,78,10,6,0.07462686567164178,0.07692307692307693
"[1, 0, 1, 1, 0, 1, 1, 0, 1, 1, 0, 0, 1, 1, 1]",323,102,221,6,12,0.058823529411764705,0.05429864253393665
"[1, 1, 0, 0, 0, 1, 0, 1, 0, 0, 1, 1, 1, 1, 0]",145,70,75,8,5,0.11428571428571428,0.06666666666666667
"[0, 0, 1, 1, 1, 1, 0, 1, 0, 1, 1, 0, 0, 0, 1]",135,66,69,8,6,0.12121212121212122,0.08695652173913043
"[0, 0, 1, 1, 0, 0, 0, 1, 1, 0, 0, 1, 1, 0, 0]",361,214,147,12,14,0.056074766355140186,0.09523809523809523
"[0, 0, 1, 0, 1, 0, 0, 0, 0, 1, 0, 0, 0, 0, 0]",1760,1344,416,130,34,0.09672619047619048,0.08173076923076923
"[0, 0, 1, 1, 1, 0, 0, 0, 0, 0, 0, 0, 1, 0, 0]",622,462,160,43,11,0.09307359307359307,0.06875
"[0, 0, 0, 0, 1, 1, 1, 1, 1, 0, 0, 1, 1, 1, 1]",601,289,312,22,30,0.07612456747404844,0.09615384615384616
"[1, 1, 0, 0, 0, 1, 0, 0, 0, 0, 1, 0, 0, 1, 1]",175,102,73,9,8,0.08823529411764706,0.1095890410958904
"[0, 1, 1, 1, 1, 0, 1, 0, 0, 0, 0, 1, 0, 0, 1]",116,61,55,5,8,0.08196721311475409,0.14545454545454545
"[1, 1, 0, 0, 1, 1, 1, 1, 1, 1, 0, 0, 1, 1, 0]",2130,803,1327,72,122,0.0896637608966376,0.09193669932177845
"[0, 0, 0, 0, 0, 1, 1, 1, 0, 0, 0, 1, 1, 1, 1]",361,241,120,24,9,0.0995850622406639,0.075
"[1, 0, 1, 0, 1, 1, 1, 1, 0, 1, 0, 0, 0, 0, 0]",144,83,61,6,8,0.07228915662650602,0.13114754098360656
"[1, 1, 0, 1, 0, 1, 1, 1, 1, 0, 1, 1, 1, 0, 1]",493,138,355,11,36,0.07971014492753623,0.10140845070422536
"[1, 0, 1, 1, 1, 0, 0, 1, 1, 1, 1, 1, 1, 1, 0]",654,198,456,17,29,0.08585858585858586,0.06359649122807018
"[0, 1, 1, 1, 1, 0, 0, 0, 0, 0, 1, 0, 1, 0, 1]",143,98,45,8,6,0.08163265306122448,0.13333333333333333
"[0, 0, 1, 0, 0, 0, 1, 0, 0, 0, 0, 1, 1, 1, 1]",338,227,111,16,9,0.07048458149779736,0.08108108108108109
"[0, 1, 0, 0, 0, 0, 0, 1, 1, 0, 0, 0, 1, 0, 0]",553,391,162,36,17,0.09207161125319693,0.10493827160493827
"[1, 0, 1, 0, 0, 0, 0, 0, 1, 1, 0, 0, 0, 1, 0]",238,158,80,17,5,0.10759493670886076,0.0625
"[0, 1, 0, 0, 0, 1, 0, 0, 0, 0, 0, 0, 0, 1, 1]",895,655,240,64,26,0.09770992366412214,0.10833333333333334
"[0, 1, 0, 1, 0, 0, 0, 0, 0, 1, 0, 1, 0, 1, 1]",159,107,52,15,4,0.14018691588785046,0.07692307692307693
"[1, 0, 0, 1, 1, 1, 1, 1, 1, 0, 1, 1, 1, 1, 0]",718,181,537,22,58,0.12154696132596685,0.10800744878957169
"[1, 0, 1, 0, 1, 1, 0, 0, 1, 1, 0, 0, 1, 1, 1]",348,121,227,16,21,0.1322314049586777,0.09251101321585903
"[1, 0, 0, 1, 1, 1, 0, 1, 1, 1, 0, 1, 1, 1, 1]",643,190,453,22,47,0.11578947368421053,0.10375275938189846
"[1, 0, 1, 1, 0, 1, 1, 1, 1, 1, 1, 0, 0, 0, 1]",320,126,194,11,11,0.0873015873015873,0.05670103092783505
"[0, 1, 1, 0, 0, 1, 1, 1, 1, 1, 0, 1, 0, 1, 0]",139,77,62,9,6,0.11688311688311688,0.0967741935483871
"[1, 1, 1, 1, 0, 0, 1, 1, 1, 1, 1, 0, 0, 1, 1]",1352,384,968,37,80,0.09635416666666667,0.08264462809917356
"[1, 1, 0, 1, 1, 0, 1, 1, 0, 1, 0, 1, 0, 0, 0]",118,49,69,5,8,0.10204081632653061,0.11594202898550725
"[0, 1, 1, 0, 0, 0, 1, 0, 0, 0, 0, 1, 0, 0, 0]",643,465,178,41,8,0.08817204301075268,0.0449438202247191
"[1, 0, 0, 0, 0, 1, 1, 1, 1, 1, 1, 1, 1, 0, 1]",730,146,584,12,49,0.0821917808219178,0.0839041095890411
"[0, 0, 0, 1, 0, 1, 1, 1, 1, 1, 1, 1, 1, 1, 0]",372,141,231,17,24,0.12056737588652482,0.1038961038961039
"[1, 0, 0, 0, 0, 1, 0, 0, 1, 0, 0, 0, 0, 1, 1]",361,202,159,26,23,0.12871287128712872,0.14465408805031446
"[0, 0, 0, 0, 0, 0, 1, 0, 0, 0, 1, 1, 1, 0, 0]",667,470,197,54,12,0.1148936170212766,0.06091370558375635
"[0, 1, 0, 1, 1, 1, 0, 0, 0, 0, 0, 0, 1, 1, 0]",343,200,143,20,10,0.1,0.06993006993006994
"[1, 1, 1, 1, 0, 1, 1, 1, 1, 0, 1, 1, 0, 0, 1]",655,170,485,13,48,0.07647058823529412,0.09896907216494845
"[1, 0, 0, 1, 1, 1, 1, 0, 1, 1, 0, 0, 1, 1, 0]",214,76,138,8,15,0.10526315789473684,0.10869565217391304
"[0, 0, 1, 1, 0, 1, 1, 0, 0, 0, 0, 0, 0, 1, 0]",272,179,93,19,12,0.10614525139664804,0.12903225806451613
"[1, 0, 0, 1, 0, 1, 1, 1, 1, 1, 1, 1, 1, 1, 0]",679,201,478,18,43,0.08955223880597014,0.0899581589958159
"[0, 0, 1, 0, 1, 0, 0, 1, 1, 1, 0, 0, 0, 0, 1]",173,108,65,11,8,0.10185185185185185,0.12307692307692308
"[1, 1, 0, 0, 1, 0, 1, 0, 1, 1, 0, 0, 0, 0, 1]",159,78,81,7,8,0.08974358974358974,0.09876543209876543
"[0, 1, 0, 1, 1, 1, 1, 1, 1, 1, 0, 0, 1, 1, 1]",1053,348,705,33,71,0.09482758620689655,0.10070921985815603
"[1, 0, 0, 1, 0, 1, 1, 1, 1, 1, 1, 1, 0, 0, 1]",416,151,265,15,31,0.09933774834437085,0.1169811320754717
"[1, 1, 0, 1, 0, 1, 1, 1, 0, 0, 1, 0, 1, 1, 1]",279,99,180,11,15,0.1111111111111111,0.08333333333333333
"[1, 1, 1, 0, 1, 0, 1, 1, 1, 0, 0, 1, 0, 1, 1]",258,99,159,4,11,0.04040404040404041,0.06918238993710692
"[0, 1, 1, 1, 1, 1, 0, 1, 0, 1, 1, 1, 0, 0, 1]",257,96,161,4,15,0.041666666666666664,0.09316770186335403
"[1, 1, 1, 1, 1, 0, 1, 1, 1, 1, 1, 0, 1, 0, 1]",1526,350,1176,29,106,0.08285714285714285,0.09013605442176871
"[1, 0, 1, 1, 1, 0, 1, 1, 0, 0, 1, 0, 1, 1, 1]",252,102,150,9,10,0.08823529411764706,0.06666666666666667
"[0, 0, 1, 0, 0, 1, 1, 1, 1, 1, 0, 1, 0, 1, 1]",189,83,106,7,11,0.08433734939759036,0.10377358490566038
"[0, 0, 0, 0, 1, 1, 1, 0, 0, 1, 1, 0, 1, 1, 1]",192,107,85,15,7,0.14018691588785046,0.08235294117647059
"[1, 0, 0, 1, 0, 1, 1, 0, 0, 0, 1, 0, 1, 1, 0]",126,57,69,5,9,0.08771929824561403,0.13043478260869565
"[1, 0, 1, 1, 1, 0, 0, 0, 0, 0, 1, 0, 0, 0, 0]",264,160,104,19,11,0.11875,0.10576923076923077
"[1, 0, 0, 1, 0, 1, 1, 1, 0, 0, 0, 0, 0, 1, 0]",157,92,65,10,5,0.10869565217391304,0.07692307692307693
"[0, 1, 1, 1, 0, 0, 1, 0, 1, 1, 1, 0, 0, 0, 0]",167,85,82,9,8,0.10588235294117647,0.0975609756097561
"[0, 1, 0, 1, 0, 1, 1, 0, 0, 0, 0, 0, 0, 0, 1]",339,238,101,17,11,0.07142857142857142,0.10891089108910891
"[0, 1, 0, 0, 1, 1, 1, 0, 1, 1, 1, 0, 0, 0, 0]",165,90,75,7,5,0.07777777777777778,0.06666666666666667
"[0, 0, 1, 1, 1, 1, 1, 1, 1, 0, 0, 0, 0, 0, 1]",255,112,143,12,16,0.10714285714285714,0.11188811188811189
"[1, 0, 0, 0, 0, 0, 1, 1, 1, 1, 1, 1, 1, 0, 0]",290,134,156,12,13,0.08955223880597014,0.08333333333333333
"[1, 0, 1, 1, 0, 0, 0, 0, 0, 0, 0, 0, 1, 1, 1]",613,341,272,28,31,0.08211143695014662,0.11397058823529412
"[1, 0, 0, 1, 0, 1, 1, 1, 0, 0, 1, 0, 1, 0, 1]",123,60,63,4,6,0.06666666666666667,0.09523809523809523
"[1, 1, 0, 1, 1, 1, 0, 0, 0, 0, 0, 1, 1, 1, 0]",136,68,68,11,5,0.16176470588235295,0.07352941176470588
"[0, 1, 0, 1, 0, 1, 1, 1, 0, 0, 1, 1, 0, 0, 0]",176,97,79,5,7,0.05154639175257732,0.08860759493670886
"[1, 1, 0, 1, 0, 1, 0, 1, 1, 1, 0, 0, 1, 1, 0]",177,65,112,4,11,0.06153846153846154,0.09821428571428571
"[1, 1, 1, 1, 0, 0, 1, 0, 0, 1, 0, 1, 1, 1, 1]",345,109,236,10,23,0.09174311926605505,0.09745762711864407
"[1, 1, 1, 0, 1, 0, 0, 1, 1, 0, 1, 1, 1, 1, 1]",676,199,477,21,49,0.10552763819095477,0.10272536687631027
"[0, 1, 1, 1, 0, 1, 0, 0, 0, 1, 1, 1, 0, 0, 0]",139,87,52,4,4,0.04597701149425287,0.07692307692307693
"[1, 0, 0, 0, 1, 1, 1, 0, 1, 0, 0, 0, 1, 1, 1]",168,70,98,8,11,0.11428571428571428,0.11224489795918367
"[0, 0, 0, 0, 0, 1, 1, 0, 0, 0, 0, 0, 1, 1, 1]",1699,1440,259,125,34,0.08680555555555555,0.13127413127413126
"[1, 1, 1, 0, 0, 1, 0, 0, 0, 0, 0, 1, 0, 0, 0]",261,155,106,11,4,0.07096774193548387,0.03773584905660377
"[1, 1, 1, 0, 0, 1, 1, 0, 1, 1, 0, 0, 1, 1, 1]",442,125,317,3,29,0.024,0.0914826498422713
"[0, 0, 1, 0, 1, 0, 1, 0, 0, 1, 0, 0, 0, 0, 1]",234,156,78,13,7,0.08333333333333333,0.08974358974358974
"[0, 0, 0, 0, 0, 0, 0, 0, 0, 1, 0, 1, 1, 1, 1]",1149,868,281,76,31,0.08755760368663594,0.1103202846975089
"[0, 1, 0, 1, 0, 0, 1, 1, 0, 0, 0, 0, 0, 0, 1]",481,305,176,25,17,0.08196721311475409,0.09659090909090909
"[0, 1, 0, 1, 1, 1, 1, 1, 0, 0, 1, 1, 1, 1, 1]",999,329,670,25,72,0.07598784194528875,0.10746268656716418
"[0, 1, 1, 1, 0, 0, 1, 1, 1, 1, 1, 1, 1, 0, 1]",627,204,423,21,47,0.10294117647058823,0.1111111111111111
"[1, 1, 0, 0, 0, 0, 1, 1, 1, 1, 1, 0, 0, 0, 0]",336,173,163,12,8,0.06936416184971098,0.049079754601226995
"[0, 0, 0, 1, 0, 0, 0, 1, 0, 1, 0, 0, 1, 1, 0]",296,191,105,23,8,0.12041884816753927,0.0761904761904762
"[1, 0, 0, 0, 0, 1, 0, 0, 0, 1, 0, 1, 0, 0, 1]",247,143,104,17,6,0.11888111888111888,0.057692307692307696
"[1, 0, 0, 0, 0, 1, 1, 1, 1, 0, 0, 0, 0, 0, 0]",2342,713,1629,74,139,0.10378681626928471,0.08532842234499693
"[0, 0, 0, 0, 1, 0, 1, 1, 1, 1, 1, 1, 0, 1, 0]",119,66,53,12,5,0.18181818181818182,0.09433962264150944
"[1, 1, 0, 0, 0, 1, 1, 0, 1, 0, 0, 1, 1, 1, 1]",212,92,120,13,13,0.14130434782608695,0.10833333333333334
"[1, 1, 1, 0, 0, 0, 1, 1, 0, 1, 0, 0, 1, 1, 1]",201,79,122,10,13,0.12658227848101267,0.10655737704918032
"[1, 1, 1, 1, 1, 0, 1, 1, 1, 0, 0, 0, 1, 1, 0]",297,89,208,10,18,0.11235955056179775,0.08653846153846154
"[0, 0, 1, 0, 1, 1, 0, 0, 0, 1, 0, 1, 1, 1, 1]",131,65,66,6,5,0.09230769230769231,0.07575757575757576
"[1, 1, 0, 1, 0, 1, 1, 1, 1, 1, 1, 1, 0, 1, 1]",1542,373,1169,43,129,0.11528150134048257,0.11035072711719418
"[0, 0, 0, 0, 1, 1, 1, 1, 0, 1, 1, 1, 1, 0, 0]",204,91,113,12,12,0.13186813186813187,0.10619469026548672
"[1, 1, 0, 1, 1, 1, 0, 1, 1, 1, 0, 1, 0, 0, 1]",226,76,150,7,20,0.09210526315789473,0.13333333333333333
"[1, 0, 1, 1, 0, 1, 1, 0, 1, 1, 1, 0, 1, 1, 1]",537,167,370,14,43,0.08383233532934131,0.11621621621621622
"[1, 1, 1, 1, 1, 1, 0, 1, 0, 1, 1, 0, 1, 1, 0]",536,153,383,16,36,0.10457516339869281,0.09399477806788512
"[1, 0, 0, 0, 1, 0, 1, 0, 1, 1, 1, 1, 1, 1, 1]",355,128,227,17,22,0.1328125,0.09691629955947137
"[1, 0, 0, 0, 1, 1, 0, 0, 0, 1, 0, 1, 0, 1, 1]",117,59,58,5,9,0.0847457627118644,0.15517241379310345
"[0, 1, 0, 0, 0, 0, 1, 1, 1, 0, 0, 0, 1, 1, 1]",180,95,85,14,8,0.14736842105263157,0.09411764705882353
"[0, 0, 1, 0, 0, 0, 0, 1, 1, 1, 0, 0, 0, 1, 1]",185,108,77,8,5,0.07407407407407407,0.06493506493506493
"[1, 1, 0, 0, 1, 0, 0, 1, 1, 0, 0, 1, 1, 0, 0]",294,147,147,7,13,0.047619047619047616,0.08843537414965986
"[1, 0, 0, 0, 0, 1, 1, 0, 0, 1, 1, 0, 0, 1, 0]",374,109,265,13,20,0.11926605504587157,0.07547169811320754
"[0, 1, 0, 0, 0, 1, 0, 0, 0, 1, 0, 1, 1, 0, 1]",141,79,62,10,9,0.12658227848101267,0.14516129032258066
"[0, 0, 1, 0, 0, 0, 1, 0, 0, 0, 1, 0, 1, 1, 0]",234,156,78,16,6,0.10256410256410256,0.07692307692307693
"[1, 0, 0, 1, 0, 0, 0, 1, 0, 0, 0, 1, 0, 1, 1]",148,86,62,11,5,0.12790697674418605,0.08064516129032258
"[0, 0, 1, 0, 0, 1, 0, 0, 0, 0, 0, 0, 1, 1, 0]",847,627,220,72,21,0.11483253588516747,0.09545454545454546
"[0, 0, 1, 1, 0, 0, 1, 0, 0, 0, 0, 0, 1, 0, 1]",270,168,102,10,7,0.05952380952380952,0.06862745098039216
"[1, 1, 0, 0, 0, 0, 0, 0, 0, 0, 1, 0, 0, 1, 1]",718,462,256,44,21,0.09523809523809523,0.08203125
"[0, 0, 0, 0, 0, 0, 0, 1, 1, 1, 1, 0, 1, 1, 1]",508,383,125,38,16,0.09921671018276762,0.128
"[1, 0, 0, 1, 1, 1, 0, 0, 0, 0, 0, 0, 1, 1, 1]",415,189,226,20,16,0.10582010582010581,0.07079646017699115
"[1, 0, 1, 1, 0, 0, 1, 1, 1, 1, 1, 0, 0, 0, 0]",230,101,129,13,10,0.12871287128712872,0.07751937984496124
"[0, 0, 0, 1, 1, 1, 1, 0, 1, 0, 0, 0, 1, 1, 1]",216,134,82,12,5,0.08955223880597014,0.06097560975609756
"[0, 1, 0, 0, 1, 1, 1, 0, 1, 0, 1, 1, 1, 0, 0]",131,68,63,9,7,0.1323529411764706,0.1111111111111111
"[1, 1, 0, 0, 0, 1, 0, 0, 1, 0, 1, 0, 1, 1, 1]",134,64,70,6,6,0.09375,0.08571428571428572
"[1, 1, 0, 0, 0, 0, 1, 0, 1, 1, 0, 0, 0, 0, 1]",218,132,86,16,12,0.12121212121212122,0.13953488372093023
"[1, 1, 0, 1, 1, 0, 1, 0, 0, 0, 0, 1, 0, 1, 1]",116,48,68,2,9,0.041666666666666664,0.1323529411764706
"[0, 1, 1, 1, 0, 0, 1, 1, 0, 1, 1, 1, 0, 0, 1]",171,79,92,8,10,0.10126582278481013,0.10869565217391304
"[1, 0, 1, 1, 1, 0, 0, 1, 1, 0, 1, 1, 1, 0, 0]",169,63,106,8,14,0.12698412698412698,0.1320754716981132
"[1, 1, 1, 1, 0, 1, 1, 1, 0, 0, 1, 1, 0, 1, 1]",587,180,407,14,57,0.07777777777777778,0.14004914004914004
"[1, 1, 1, 1, 1, 1, 0, 1, 1, 1, 0, 0, 1, 1, 0]",730,211,519,18,51,0.08530805687203792,0.09826589595375723
"[1, 1, 1, 1, 0, 0, 1, 0, 0, 1, 0, 0, 1, 1, 1]",296,119,177,10,31,0.08403361344537816,0.1751412429378531
"[0, 1, 0, 0, 1, 0, 0, 1, 0, 0, 0, 1, 1, 0, 0]",314,208,106,16,6,0.07692307692307693,0.05660377358490566
"[1, 1, 0, 1, 1, 1, 0, 1, 0, 1, 1, 0, 1, 1, 1]",588,169,419,14,38,0.08284023668639054,0.09069212410501193
"[0, 0, 0, 1, 0, 1, 1, 0, 1, 0, 1, 1, 1, 0, 1]",116,57,59,5,9,0.08771929824561403,0.15254237288135594
"[0, 0, 0, 0, 0, 1, 0, 1, 1, 0, 1, 0, 1, 1, 1]",198,121,77,12,6,0.09917355371900827,0.07792207792207792
"[1, 1, 1, 1, 1, 0, 1, 0, 1, 1, 0, 1, 1, 0, 0]",283,101,182,11,18,0.10891089108910891,0.0989010989010989
"[1, 0, 0, 0, 1, 0, 0, 1, 1, 0, 0, 1, 1, 0, 0]",311,166,145,22,15,0.13253012048192772,0.10344827586206896
"[1, 0, 1, 1, 1, 1, 1, 1, 1, 0, 1, 1, 0, 0, 0]",304,102,202,14,18,0.13725490196078433,0.0891089108910891
"[1, 0, 0, 1, 1, 1, 1, 1, 1, 1, 1, 1, 0, 0, 0]",753,202,551,15,48,0.07425742574257425,0.08711433756805807
"[0, 0, 0, 1, 0, 0, 0, 1, 1, 0, 1, 0, 0, 0, 0]",569,403,166,39,18,0.0967741935483871,0.10843373493975904
"[0, 0, 0, 1, 0, 0, 0, 1, 0, 0, 0, 1, 1, 0, 1]",216,141,75,18,8,0.1276595744680851,0.10666666666666667
"[0, 0, 0, 0, 0, 1, 1, 1, 1, 0, 0, 1, 1, 0, 1]",427,316,111,24,4,0.0759493670886076,0.036036036036036036
"[1, 0, 0, 0, 0, 0, 1, 1, 1, 1, 0, 0, 1, 1, 0]",468,245,223,18,28,0.07346938775510205,0.12556053811659193
"[0, 0, 1, 1, 0, 0, 0, 0, 0, 1, 1, 1, 1, 0, 0]",441,287,154,25,20,0.08710801393728224,0.12987012987012986
"[0, 1, 0, 1, 0, 1, 1, 1, 1, 0, 0, 0, 0, 0, 0]",367,207,160,23,13,0.1111111111111111,0.08125
"[0, 1, 1, 1, 0, 0, 0, 1, 0, 1, 0, 1, 1, 0, 1]",101,50,51,9,4,0.18,0.0784313725490196
"[0, 1, 0, 1, 0, 1, 1, 1, 0, 0, 1, 1, 1, 0, 0]",123,59,64,5,10,0.0847457627118644,0.15625
"[1, 1, 0, 1, 1, 1, 1, 1, 1, 0, 1, 0, 0, 0, 1]",213,85,128,8,17,0.09411764705882353,0.1328125
"[1, 1, 0, 1, 0, 1, 0, 0, 0, 1, 1, 1, 0, 1, 1]",141,52,89,3,10,0.057692307692307696,0.11235955056179775
"[0, 1, 1, 1, 0, 1, 1, 0, 0, 0, 0, 1, 1, 1, 1]",389,170,219,15,26,0.08823529411764706,0.1187214611872146
"[0, 0, 1, 1, 1, 1, 0, 0, 0, 0, 1, 0, 1, 0, 0]",285,185,100,16,12,0.08648648648648649,0.12
"[0, 0, 0, 1, 1, 0, 0, 1, 0, 1, 1, 1, 1, 0, 1]",138,72,66,6,8,0.08333333333333333,0.12121212121212122
"[1, 0, 0, 1, 1, 0, 0, 0, 1, 0, 1, 0, 1, 1, 1]",188,66,122,5,13,0.07575757575757576,0.10655737704918032
"[0, 0, 0, 1, 0, 0, 1, 1, 0, 0, 0, 1, 1, 0, 0]",345,209,136,18,15,0.0861244019138756,0.11029411764705882
"[0, 0, 0, 0, 1, 0, 0, 1, 1, 0, 0, 0, 1, 1, 0]",298,203,95,15,12,0.07389162561576355,0.12631578947368421
"[0, 0, 1, 1, 0, 1, 1, 0, 0, 0, 0, 0, 1, 0, 0]",252,159,93,20,7,0.12578616352201258,0.07526881720430108
"[0, 1, 0, 0, 0, 0, 1, 1, 1, 0, 0, 1, 1, 0, 0]",261,153,108,16,9,0.10457516339869281,0.08333333333333333
"[0, 0, 1, 0, 0, 0, 0, 1, 1, 1, 0, 0, 1, 1, 0]",185,115,70,11,8,0.09565217391304348,0.11428571428571428
"[1, 1, 1, 1, 0, 0, 1, 1, 1, 0, 1, 1, 1, 0, 1]",598,173,425,15,41,0.08670520231213873,0.09647058823529411
"[1, 1, 1, 1, 0, 1, 1, 1, 1, 1, 1, 1, 0, 0, 0]",1047,283,764,30,70,0.10600706713780919,0.09162303664921466
"[1, 1, 1, 0, 1, 1, 0, 1, 1, 0, 1, 1, 1, 0, 0]",244,82,162,9,12,0.10975609756097561,0.07407407407407407
"[0, 1, 0, 1, 0, 1, 1, 1, 1, 0, 1, 1, 1, 1, 1]",625,209,416,24,30,0.11483253588516747,0.07211538461538461
"[0, 1, 0, 0, 1, 0, 1, 0, 1, 1, 1, 1, 0, 1, 1]",142,59,83,2,9,0.03389830508474576,0.10843373493975904
"[1, 1, 1, 1, 1, 0, 1, 0, 0, 0, 1, 1, 0, 0, 0]",189,91,98,9,8,0.0989010989010989,0.08163265306122448
"[1, 0, 0, 0, 0, 0, 1, 0, 0, 0, 0, 0, 0, 1, 1]",1074,680,394,57,36,0.0838235294117647,0.09137055837563451
"[1, 1, 1, 0, 1, 1, 1, 1, 0, 0, 0, 0, 1, 1, 0]",329,138,191,12,13,0.08695652173913043,0.06806282722513089
"[1, 1, 0, 1, 1, 0, 1, 1, 1, 1, 1, 1, 1, 1, 0]",1904,472,1432,33,140,0.06991525423728813,0.09776536312849161
"[1, 1, 1, 0, 1, 0, 0, 1, 1, 0, 1, 1, 0, 1, 1]",248,84,164,7,9,0.08333333333333333,0.054878048780487805
"[1, 0, 1, 0, 1, 1, 1, 0, 1, 1, 1, 0, 1, 0, 0]",148,62,86,4,6,0.06451612903225806,0.06976744186046512
"[1, 0, 0, 0, 1, 0, 1, 1, 1, 1, 0, 1, 1, 0, 0]",114,53,61,4,6,0.07547169811320754,0.09836065573770492
"[0, 0, 0, 0, 0, 1, 1, 0, 1, 0, 0, 0, 0, 1, 1]",462,340,122,36,12,0.10588235294117647,0.09836065573770492
"[0, 0, 0, 0, 1, 1, 1, 0, 0, 1, 1, 1, 0, 0, 0]",217,122,95,22,8,0.18032786885245902,0.08421052631578947
"[0, 0, 1, 0, 1, 1, 0, 0, 0, 0, 1, 1, 1, 0, 0]",189,111,78,9,9,0.08108108108108109,0.11538461538461539
"[0, 0, 1, 0, 0, 0, 0, 1, 0, 1, 1, 0, 0, 0, 0]",651,460,191,41,12,0.0891304347826087,0.06282722513089005
"[0, 1, 1, 1, 1, 1, 1, 1, 0, 1, 1, 0, 1, 1, 0]",536,186,350,20,26,0.10752688172043011,0.07428571428571429
"[1, 0, 1, 1, 1, 1, 1, 1, 1, 0, 1, 1, 0, 1, 1]",1596,333,1263,34,122,0.1021021021021021,0.09659540775930324
"[0, 0, 0, 0, 0, 1, 1, 0, 0, 1, 1, 1, 0, 0, 1]",375,286,89,32,10,0.11188811188811189,0.11235955056179775
"[0, 0, 0, 1, 1, 0, 1, 1, 0, 0, 0, 0, 1, 1, 0]",247,160,87,19,11,0.11875,0.12643678160919541
"[0, 1, 1, 0, 0, 0, 0, 1, 1, 1, 0, 0, 0, 0, 1]",261,180,81,19,10,0.10555555555555556,0.12345679012345678
"[0, 0, 0, 1, 0, 1, 0, 1, 1, 0, 1, 0, 0, 0, 0]",278,178,100,19,9,0.10674157303370786,0.09
"[0, 0, 0, 1, 0, 0, 0, 0, 1, 0, 0, 1, 1, 1, 0]",231,168,63,15,9,0.08928571428571429,0.14285714285714285
"[0, 0, 0, 0, 1, 0, 0, 0, 0, 1, 0, 0, 1, 1, 1]",542,408,134,48,14,0.11764705882352941,0.1044776119402985
"[1, 0, 0, 1, 1, 0, 0, 0, 1, 1, 0, 1, 1, 1, 0]",128,54,74,5,9,0.09259259259259259,0.12162162162162163
"[0, 0, 0, 0, 0, 1, 1, 1, 0, 0, 0, 1, 0, 0, 1]",298,214,84,14,7,0.06542056074766354,0.08333333333333333
"[1, 1, 0, 0, 0, 1, 0, 0, 0, 0, 0, 1, 1, 1, 0]",147,86,61,7,5,0.08139534883720931,0.08196721311475409
"[0, 0, 1, 1, 0, 0, 1, 0, 1, 0, 1, 1, 0, 1, 0]",128,68,60,11,9,0.16176470588235295,0.15
"[0, 0, 1, 0, 0, 0, 1, 0, 0, 1, 0, 1, 0, 0, 0]",554,372,182,42,19,0.11290322580645161,0.1043956043956044
"[1, 0, 0, 1, 1, 1, 1, 0, 0, 0, 0, 1, 1, 0, 1]",393,88,305,10,27,0.11363636363636363,0.08852459016393442
"[1, 0, 1, 0, 1, 0, 1, 1, 1, 1, 1, 1, 1, 0, 0]",368,127,241,17,18,0.13385826771653545,0.07468879668049792
"[0, 0, 0, 0, 1, 0, 1, 0, 1, 0, 1, 0, 1, 1, 1]",139,89,50,14,5,0.15730337078651685,0.1
"[0, 1, 1, 1, 1, 0, 0, 0, 0, 1, 0, 1, 0, 1, 0]",133,75,58,5,4,0.06666666666666667,0.06896551724137931
"[0, 1, 0, 1, 1, 1, 1, 0, 0, 0, 0, 1, 0, 1, 0]",120,65,55,5,4,0.07692307692307693,0.07272727272727272
"[0, 1, 0, 1, 0, 1, 0, 0, 1, 0, 1, 1, 0, 0, 1]",116,58,58,2,6,0.034482758620689655,0.10344827586206896
"[0, 1, 0, 1, 0, 1, 0, 1, 0, 0, 1, 0, 1, 1, 0]",101,54,47,5,7,0.09259259259259259,0.14893617021276595
"[0, 0, 0, 1, 0, 1, 0, 1, 0, 1, 0, 0, 1, 0, 1]",137,73,64,5,8,0.0684931506849315,0.125
"[0, 0, 0, 1, 1, 0, 0, 0, 0, 0, 1, 1, 0, 1, 1]",299,216,83,17,5,0.0787037037037037,0.060240963855421686
"[0, 1, 0, 0, 0, 0, 1, 1, 1, 0, 1, 1, 0, 1, 0]",100,55,45,6,4,0.10909090909090909,0.08888888888888889
"[0, 0, 1, 0, 0, 0, 0, 1, 1, 1, 0, 1, 1, 0, 1]",111,52,59,4,5,0.07692307692307693,0.0847457627118644
"[0, 1, 1, 0, 0, 1, 1, 0, 1, 0, 1, 1, 0, 1, 1]",183,93,90,5,12,0.053763440860215055,0.13333333333333333
"[1, 1, 1, 1, 1, 0, 1, 1, 0, 0, 1, 1, 0, 1, 0]",255,93,162,5,12,0.053763440860215055,0.07407407407407407
"[1, 1, 1, 1, 0, 0, 1, 1, 1, 1, 1, 0, 1, 0, 1]",823,259,564,25,49,0.09652509652509653,0.08687943262411348
"[1, 0, 1, 1, 0, 1, 1, 0, 1, 0, 1, 1, 1, 1, 1]",579,172,407,8,41,0.046511627906976744,0.10073710073710074
"[0, 1, 0, 1, 1, 1, 1, 1, 1, 0, 1, 1, 0, 1, 1]",507,165,342,18,31,0.10909090909090909,0.09064327485380116
"[0, 0, 1, 1, 1, 0, 0, 0, 0, 1, 1, 1, 1, 0, 0]",447,237,210,32,12,0.1350210970464135,0.05714285714285714
"[1, 0, 1, 0, 1, 1, 0, 0, 0, 0, 1, 1, 1, 0, 0]",128,62,66,6,7,0.0967741935483871,0.10606060606060606
"[1, 0, 1, 0, 1, 1, 0, 1, 0, 1, 0, 1, 1, 1, 1]",281,114,167,13,16,0.11403508771929824,0.09580838323353294
"[0, 0, 1, 1, 1, 0, 0, 0, 0, 1, 1, 0, 0, 0, 0]",769,512,257,56,24,0.109375,0.0933852140077821
"[0, 0, 1, 1, 0, 0, 0, 1, 0, 1, 1, 0, 0, 0, 0]",352,237,115,24,15,0.10126582278481013,0.13043478260869565
"[0, 0, 0, 1, 1, 0, 0, 0, 0, 1, 0, 0, 1, 1, 0]",352,257,95,32,1,0.1245136186770428,0.010526315789473684
"[1, 0, 0, 0, 0, 1, 0, 1, 0, 0, 0, 1, 1, 0, 1]",161,92,69,14,7,0.15217391304347827,0.10144927536231885
"[1, 1, 1, 1, 1, 1, 0, 1, 1, 1, 1, 0, 1, 0, 1]",1585,360,1225,40,116,0.1111111111111111,0.0946938775510204
"[0, 0, 0, 0, 0, 1, 1, 1, 0, 1, 0, 0, 0, 0, 1]",335,241,94,30,7,0.12448132780082988,0.07446808510638298
"[0, 0, 1, 0, 0, 0, 0, 0, 0, 0, 1, 1, 1, 0, 1]",269,168,101,17,9,0.10119047619047619,0.0891089108910891
"[0, 1, 0, 1, 0, 1, 1, 1, 1, 1, 0, 1, 0, 1, 1]",216,74,142,9,16,0.12162162162162163,0.11267605633802817
"[1, 0, 1, 0, 1, 0, 1, 0, 1, 1, 1, 1, 1, 0, 1]",200,65,135,6,15,0.09230769230769231,0.1111111111111111
"[1, 1, 0, 1, 1, 0, 0, 1, 0, 0, 0, 0, 1, 0, 0]",127,71,56,6,4,0.08450704225352113,0.07142857142857142
"[1, 1, 1, 1, 0, 1, 1, 0, 1, 1, 0, 0, 1, 0, 0]",179,70,109,8,14,0.11428571428571428,0.12844036697247707
"[0, 1, 1, 1, 1, 1, 1, 0, 0, 1, 0, 1, 1, 1, 0]",287,136,151,13,16,0.09558823529411764,0.10596026490066225
"[0, 1, 1, 1, 1, 0, 1, 1, 1, 1, 1, 0, 1, 0, 1]",500,170,330,18,31,0.10588235294117647,0.09393939393939393
"[1, 1, 1, 1, 0, 0, 0, 0, 0, 1, 0, 1, 1, 0, 1]",177,77,100,11,11,0.14285714285714285,0.11
"[1, 1, 1, 1, 1, 0, 0, 0, 0, 0, 1, 0, 1, 1, 0]",195,68,127,9,13,0.1323529411764706,0.10236220472440945
"[1, 1, 0, 0, 0, 1, 1, 0, 0, 0, 0, 1, 1, 1, 1]",507,254,253,23,25,0.09055118110236221,0.09881422924901186
"[0, 1, 1, 1, 1, 0, 0, 1, 0, 1, 1, 1, 1, 0, 0]",238,119,119,14,12,0.11764705882352941,0.10084033613445378
"[0, 0, 1, 1, 0, 0, 1, 1, 1, 1, 0, 1, 0, 0, 0]",212,124,88,12,7,0.0967741935483871,0.07954545454545454
"[1, 1, 0, 0, 1, 1, 0, 0, 1, 1, 1, 1, 0, 1, 0]",360,131,229,18,34,0.13740458015267176,0.14847161572052403
"[1, 0, 0, 0, 0, 0, 1, 0, 0, 0, 1, 1, 1, 0, 0]",275,169,106,15,12,0.08875739644970414,0.11320754716981132
"[0, 0, 1, 0, 1, 1, 1, 1, 1, 0, 0, 0, 0, 1, 0]",133,75,58,4,8,0.05333333333333334,0.13793103448275862
"[1, 0, 1, 0, 1, 0, 1, 1, 1, 1, 1, 1, 1, 1, 0]",672,212,460,19,46,0.08962264150943396,0.1
"[1, 1, 1, 0, 1, 1, 1, 0, 0, 1, 0, 1, 1, 0, 1]",223,72,151,13,19,0.18055555555555555,0.12582781456953643
"[1, 1, 0, 1, 0, 0, 0, 0, 0, 0, 0, 0, 0, 0, 1]",769,541,228,49,18,0.09057301293900184,0.07894736842105263
"[0, 0, 1, 1, 0, 0, 0, 0, 0, 1, 1, 0, 0, 0, 1]",379,235,144,27,13,0.1148936170212766,0.09027777777777778
"[1, 1, 1, 1, 0, 0, 0, 1, 1, 1, 0, 1, 0, 0, 0]",150,69,81,8,9,0.11594202898550725,0.1111111111111111
"[1, 1, 1, 1, 1, 0, 0, 0, 1, 1, 1, 0, 1, 0, 0]",180,74,106,5,15,0.06756756756756757,0.14150943396226415
"[0, 1, 0, 1, 1, 1, 1, 1, 0, 0, 0, 1, 1, 1, 0]",169,76,93,7,9,0.09210526315789473,0.0967741935483871
"[1, 0, 0, 1, 1, 0, 1, 1, 1, 1, 1, 0, 0, 0, 1]",171,64,107,5,9,0.078125,0.08411214953271028
"[0, 0, 0, 0, 1, 1, 0, 1, 1, 0, 1, 1, 1, 1, 1]",267,106,161,13,17,0.12264150943396226,0.10559006211180125
"[1, 1, 0, 1, 1, 0, 1, 1, 1, 0, 0, 0, 0, 1, 1]",303,130,173,7,17,0.05384615384615385,0.09826589595375723
"[0, 0, 1, 0, 0, 1, 1, 0, 0, 0, 0, 0, 1, 1, 0]",321,208,113,19,12,0.09134615384615384,0.10619469026548672
"[0, 1, 0, 0, 0, 0, 0, 1, 0, 0, 1, 1, 0, 0, 0]",717,506,211,48,20,0.09486166007905138,0.0947867298578199
"[1, 1, 1, 0, 0, 1, 1, 1, 1, 1, 1, 0, 1, 0, 0]",390,92,298,11,33,0.11956521739130435,0.11073825503355705
"[0, 0, 1, 1, 1, 0, 0, 1, 1, 0, 0, 1, 1, 1, 1]",527,234,293,22,19,0.09401709401709402,0.06484641638225255
"[0, 0, 0, 1, 1, 0, 1, 1, 1, 1, 1, 1, 1, 0, 1]",259,92,167,10,20,0.10869565217391304,0.11976047904191617
"[1, 0, 0, 0, 0, 0, 1, 0, 0, 1, 1, 0, 0, 1, 1]",318,185,133,13,10,0.07027027027027027,0.07518796992481203
"[1, 1, 1, 0, 0, 1, 0, 0, 0, 0, 1, 1, 1, 1, 0]",198,90,108,5,12,0.05555555555555555,0.1111111111111111
"[0, 1, 0, 0, 0, 1, 0, 1, 1, 0, 0, 1, 1, 1, 0]",123,65,58,4,5,0.06153846153846154,0.08620689655172414
"[0, 1, 0, 1, 0, 0, 1, 0, 0, 0, 0, 1, 1, 0, 0]",354,228,126,24,9,0.10526315789473684,0.07142857142857142
"[1, 0, 0, 1, 0, 0, 0, 1, 0, 0, 1, 1, 0, 0, 0]",318,199,119,25,16,0.12562814070351758,0.13445378151260504
"[1, 1, 1, 0, 1, 1, 0, 0, 0, 0, 0, 0, 0, 0, 0]",568,307,261,25,29,0.08143322475570032,0.1111111111111111
"[0, 1, 0, 1, 1, 0, 0, 1, 1, 1, 1, 0, 0, 1, 0]",133,62,71,9,5,0.14516129032258066,0.07042253521126761
"[1, 0, 1, 0, 0, 1, 0, 1, 0, 0, 1, 0, 1, 0, 1]",97,46,51,4,7,0.08695652173913043,0.13725490196078433
"[0, 0, 0, 0, 0, 1, 0, 1, 1, 0, 0, 1, 0, 0, 0]",565,401,164,40,19,0.09975062344139651,0.11585365853658537
"[1, 0, 1, 0, 0, 0, 1, 0, 1, 1, 0, 1, 0, 1, 1]",98,56,42,6,1,0.10714285714285714,0.023809523809523808
"[0, 0, 0, 1, 1, 0, 1, 0, 0, 0, 1, 0, 1, 0, 0]",233,151,82,16,13,0.10596026490066225,0.15853658536585366
"[1, 0, 0, 0, 1, 1, 0, 1, 0, 0, 0, 1, 0, 1, 0]",132,81,51,15,4,0.18518518518518517,0.0784313725490196
"[1, 0, 1, 0, 1, 1, 1, 1, 1, 1, 0, 1, 0, 1, 1]",501,165,336,22,45,0.13333333333333333,0.13392857142857142
"[0, 0, 1, 1, 0, 1, 1, 0, 0, 0, 0, 0, 0, 0, 1]",317,209,108,23,7,0.11004784688995216,0.06481481481481481
"[1, 0, 0, 0, 0, 0, 1, 1, 0, 1, 1, 0, 0, 0, 0]",336,183,153,14,16,0.07650273224043716,0.10457516339869281
"[1, 0, 1, 0, 0, 1, 0, 1, 0, 0, 1, 1, 1, 1, 1]",204,88,116,10,8,0.11363636363636363,0.06896551724137931
"[0, 1, 1, 1, 0, 1, 1, 1, 0, 0, 0, 0, 0, 0, 0]",282,171,111,16,14,0.0935672514619883,0.12612612612612611
"[0, 0, 0, 0, 1, 1, 1, 0, 0, 1, 0, 0, 1, 1, 1]",242,137,105,14,8,0.10218978102189781,0.0761904761904762
"[1, 0, 1, 1, 1, 0, 1, 1, 1, 1, 0, 1, 0, 0, 0]",158,61,97,5,9,0.08196721311475409,0.09278350515463918
"[1, 1, 0, 1, 1, 1, 0, 1, 1, 1, 1, 0, 1, 0, 0]",265,83,182,7,23,0.08433734939759036,0.12637362637362637
"[0, 1, 1, 0, 1, 1, 1, 0, 1, 1, 1, 1, 0, 1, 0]",235,99,136,9,16,0.09090909090909091,0.11764705882352941
"[1, 1, 1, 1, 0, 1, 0, 1, 0, 1, 0, 1, 1, 0, 1]",223,72,151,8,10,0.1111111111111111,0.06622516556291391
"[1, 1, 0, 0, 0, 1, 1, 1, 0, 0, 0, 1, 1, 1, 1]",329,104,225,7,17,0.0673076923076923,0.07555555555555556
"[0, 0, 0, 1, 0, 1, 0, 0, 0, 0, 0, 0, 1, 1, 1]",631,459,172,46,19,0.10021786492374728,0.11046511627906977
"[1, 1, 0, 1, 0, 1, 0, 1, 0, 1, 0, 1, 1, 0, 0]",108,54,54,3,5,0.05555555555555555,0.09259259259259259
"[0, 1, 1, 1, 1, 0, 1, 1, 1, 0, 1, 0, 1, 0, 1]",235,109,126,13,12,0.11926605504587157,0.09523809523809523
"[1, 0, 1, 1, 1, 1, 0, 0, 0, 1, 1, 1, 0, 0, 0]",165,83,82,7,5,0.08433734939759036,0.06097560975609756
"[1, 0, 0, 1, 0, 1, 0, 0, 0, 0, 1, 0, 0, 1, 1]",170,84,86,7,8,0.08333333333333333,0.09302325581395349
"[0, 0, 0, 1, 0, 0, 1, 1, 0, 1, 0, 1, 1, 1, 1]",149,76,73,6,9,0.07894736842105263,0.1232876712328767
"[1, 1, 0, 1, 0, 1, 1, 1, 0, 0, 0, 1, 0, 0, 1]",115,57,58,2,3,0.03508771929824561,0.05172413793103448
"[1, 0, 0, 0, 1, 1, 0, 0, 1, 1, 1, 1, 1, 1, 1]",849,291,558,35,56,0.12027491408934708,0.1003584229390681
"[1, 0, 0, 1, 1, 1, 0, 1, 0, 1, 0, 1, 1, 1, 1]",306,89,217,6,20,0.06741573033707865,0.09216589861751152
"[1, 0, 1, 1, 1, 0, 1, 1, 0, 1, 0, 0, 1, 1, 0]",153,61,92,10,10,0.16393442622950818,0.10869565217391304
"[1, 1, 0, 1, 0, 0, 0, 0, 1, 0, 0, 0, 0, 1, 1]",198,108,90,12,5,0.1111111111111111,0.05555555555555555
"[1, 1, 1, 0, 1, 0, 0, 0, 1, 1, 0, 0, 0, 0, 0]",265,150,115,18,13,0.12,0.11304347826086956
"[0, 1, 1, 1, 0, 0, 0, 1, 0, 1, 1, 0, 1, 0, 0]",120,67,53,8,9,0.11940298507462686,0.16981132075471697
"[0, 1, 0, 1, 1, 1, 0, 0, 0, 1, 0, 1, 1, 0, 1]",108,55,53,6,2,0.10909090909090909,0.03773584905660377
"[0, 1, 0, 0, 1, 0, 1, 1, 0, 1, 0, 1, 1, 1, 0]",111,51,60,5,3,0.09803921568627451,0.05
"[1, 1, 1, 0, 1, 0, 1, 1, 0, 1, 1, 0, 1, 0, 0]",155,68,87,6,12,0.08823529411764706,0.13793103448275862
"[1, 0, 1, 1, 1, 1, 0, 1, 1, 1, 0, 0, 1, 1, 1]",735,191,544,16,53,0.08376963350785341,0.0974264705882353
"[1, 1, 0, 1, 1, 1, 1, 0, 1, 1, 1, 0, 0, 1, 1]",712,195,517,18,49,0.09230769230769231,0.09477756286266925
"[0, 1, 1, 1, 1, 1, 1, 0, 1, 1, 0, 0, 1, 1, 1]",840,328,512,33,55,0.10060975609756098,0.107421875
"[1, 1, 0, 1, 0, 1, 1, 1, 0, 0, 0, 0, 1, 1, 0]",225,96,129,12,9,0.125,0.06976744186046512
"[1, 1, 0, 1, 1, 1, 0, 1, 1, 1, 0, 0, 1, 1, 1]",743,202,541,21,51,0.10396039603960396,0.09426987060998152
"[1, 0, 1, 0, 1, 0, 1, 0, 1, 1, 1, 1, 1, 1, 0]",257,95,162,9,12,0.09473684210526316,0.07407407407407407
"[1, 1, 0, 1, 0, 1, 0, 1, 0, 1, 1, 1, 1, 1, 1]",650,206,444,17,55,0.0825242718446602,0.12387387387387387
"[1, 1, 1, 0, 1, 1, 0, 1, 0, 0, 1, 1, 0, 1, 0]",156,56,100,4,13,0.07142857142857142,0.13
"[1, 1, 0, 0, 1, 0, 0, 0, 0, 1, 1, 1, 1, 1, 0]",158,69,89,4,6,0.057971014492753624,0.06741573033707865
"[1, 0, 0, 0, 1, 1, 0, 1, 1, 0, 1, 0, 0, 1, 1]",127,55,72,4,6,0.07272727272727272,0.08333333333333333
"[0, 1, 0, 0, 1, 0, 1, 1, 1, 1, 1, 1, 1, 1, 0]",344,132,212,13,14,0.09848484848484848,0.0660377358490566
"[1, 1, 0, 1, 1, 1, 0, 0, 0, 1, 0, 0, 1, 0, 1]",100,55,45,2,2,0.03636363636363636,0.044444444444444446
"[0, 1, 0, 0, 0, 0, 1, 1, 0, 1, 1, 1, 0, 1, 1]",108,52,56,7,1,0.1346153846153846,0.017857142857142856
"[1, 0, 0, 1, 0, 1, 1, 0, 1, 1, 1, 0, 0, 0, 0]",156,78,78,7,7,0.08974358974358974,0.08974358974358974
"[1, 1, 1, 0, 0, 1, 0, 1, 1, 0, 1, 1, 1, 0, 0]",175,71,104,8,13,0.11267605633802817,0.125
"[0, 1, 1, 1, 1, 1, 1, 1, 0, 0, 1, 0, 0, 0, 1]",184,83,101,4,9,0.04819277108433735,0.0891089108910891
"[1, 1, 0, 0, 0, 1, 1, 1, 0, 1, 1, 1, 1, 0, 0]",205,78,127,4,13,0.05128205128205128,0.10236220472440945
"[1, 1, 0, 0, 0, 0, 0, 0, 1, 0, 0, 0, 1, 0, 0]",668,474,194,41,16,0.08649789029535865,0.08247422680412371
"[0, 1, 0, 1, 1, 1, 0, 0, 0, 0, 0, 0, 1, 0, 0]",269,187,82,11,7,0.058823529411764705,0.08536585365853659
"[1, 0, 0, 0, 1, 0, 0, 1, 1, 1, 0, 1, 1, 0, 0]",115,65,50,6,11,0.09230769230769231,0.22
"[0, 0, 1, 0, 0, 0, 1, 0, 0, 1, 1, 1, 0, 1, 1]",115,69,46,7,2,0.10144927536231885,0.043478260869565216
"[1, 1, 1, 0, 1, 1, 0, 1, 0, 0, 1, 1, 1, 1, 0]",267,101,166,17,19,0.16831683168316833,0.1144578313253012
"[1, 1, 0, 0, 1, 1, 0, 0, 0, 1, 0, 1, 1, 0, 1]",157,73,84,8,7,0.1095890410958904,0.08333333333333333
"[0, 0, 0, 1, 1, 1, 0, 0, 1, 1, 0, 0, 0, 0, 0]",617,432,185,39,17,0.09027777777777778,0.0918918918918919
"[0, 1, 0, 1, 1, 0, 1, 0, 0, 1, 0, 0, 0, 0, 0]",250,171,79,18,5,0.10526315789473684,0.06329113924050633
"[1, 0, 0, 1, 0, 1, 0, 0, 1, 0, 0, 1, 0, 1, 1]",132,63,69,6,8,0.09523809523809523,0.11594202898550725
"[0, 1, 0, 1, 1, 1, 1, 0, 0, 1, 0, 1, 0, 0, 1]",112,56,56,5,4,0.08928571428571429,0.07142857142857142
"[0, 1, 0, 1, 0, 1, 0, 1, 0, 0, 0, 0, 1, 0, 0]",233,148,85,13,7,0.08783783783783784,0.08235294117647059
"[1, 0, 0, 0, 0, 1, 0, 0, 0, 0, 0, 0, 1, 1, 1]",640,354,286,35,31,0.09887005649717515,0.10839160839160839
"[1, 1, 0, 0, 1, 0, 0, 0, 0, 0, 1, 1, 1, 1, 0]",217,108,109,10,12,0.09259259259259259,0.11009174311926606
"[0, 0, 1, 1, 1, 0, 0, 0, 1, 1, 1, 0, 0, 1, 0]",93,52,41,5,3,0.09615384615384616,0.07317073170731707
"[1, 0, 0, 0, 0, 1, 1, 0, 0, 1, 0, 0, 1, 0, 1]",190,94,96,6,8,0.06382978723404255,0.08333333333333333
"[0, 1, 0, 1, 0, 0, 0, 1, 0, 1, 1, 1, 1, 1, 0]",118,61,57,7,5,0.11475409836065574,0.08771929824561403
"[1, 1, 0, 1, 1, 0, 1, 0, 1, 0, 1, 0, 1, 1, 1]",256,92,164,12,10,0.13043478260869565,0.06097560975609756
"[1, 1, 1, 0, 0, 1, 1, 1, 0, 1, 1, 0, 1, 0, 1]",291,93,198,15,22,0.16129032258064516,0.1111111111111111
"[0, 1, 1, 0, 0, 0, 0, 1, 0, 0, 1, 1, 0, 1, 0]",157,97,60,10,3,0.10309278350515463,0.05
"[1, 0, 1, 1, 0, 1, 1, 1, 1, 1, 0, 1, 1, 0, 1]",479,125,354,11,44,0.088,0.12429378531073447
"[1, 1, 0, 0, 1, 0, 0, 1, 1, 1, 1, 1, 0, 0, 1]",211,80,131,13,12,0.1625,0.0916030534351145
"[0, 1, 0, 0, 1, 1, 0, 0, 0, 0, 0, 0, 0, 1, 1]",542,348,194,37,16,0.10632183908045977,0.08247422680412371
"[0, 0, 1, 1, 0, 1, 0, 0, 0, 1, 0, 1, 0, 1, 0]",149,87,62,8,8,0.09195402298850575,0.12903225806451613
"[1, 1, 1, 1, 1, 0, 0, 1, 0, 0, 1, 1, 1, 1, 0]",356,123,233,9,22,0.07317073170731707,0.0944206008583691
"[1, 0, 1, 0, 0, 1, 1, 1, 1, 0, 1, 1, 1, 0, 1]",215,72,143,3,21,0.041666666666666664,0.14685314685314685
"[1, 1, 0, 1, 1, 1, 1, 0, 0, 0, 1, 0, 1, 1, 0]",157,63,94,8,13,0.12698412698412698,0.13829787234042554
"[0, 1, 1, 1, 1, 0, 1, 1, 1, 1, 0, 0, 0, 1, 0]",178,76,102,10,8,0.13157894736842105,0.0784313725490196
"[1, 0, 1, 1, 0, 0, 1, 1, 1, 1, 0, 1, 1, 1, 1]",649,207,442,20,36,0.0966183574879227,0.08144796380090498
"[1, 0, 1, 1, 1, 1, 0, 1, 0, 1, 1, 0, 0, 1, 1]",312,107,205,12,21,0.11214953271028037,0.1024390243902439
"[1, 1, 0, 1, 1, 1, 1, 0, 1, 1, 1, 1, 0, 1, 0]",492,141,351,11,33,0.07801418439716312,0.09401709401709402
"[1, 1, 1, 0, 1, 1, 1, 1, 0, 1, 1, 1, 1, 0, 1]",1477,315,1162,28,104,0.08888888888888889,0.08950086058519793
"[1, 0, 1, 0, 1, 0, 1, 0, 1, 0, 0, 1, 1, 1, 1]",196,83,113,10,8,0.12048192771084337,0.07079646017699115
"[0, 1, 0, 1, 0, 1, 0, 1, 0, 1, 0, 0, 1, 1, 1]",133,69,64,9,7,0.13043478260869565,0.109375
"[0, 1, 0, 0, 0, 0, 1, 0, 1, 0, 1, 0, 1, 0, 0]",231,151,80,17,4,0.11258278145695365,0.05
"[1, 0, 1, 1, 0, 1, 0, 0, 1, 0, 1, 1, 0, 1, 1]",134,61,73,8,5,0.13114754098360656,0.0684931506849315
"[0, 0, 1, 0, 0, 0, 1, 0, 1, 1, 0, 1, 0, 0, 1]",149,85,64,7,8,0.08235294117647059,0.125
"[0, 1, 1, 0, 0, 0, 0, 1, 0, 1, 0, 0, 0, 1, 1]",244,156,88,21,7,0.1346153846153846,0.07954545454545454
"[1, 0, 1, 1, 0, 1, 0, 0, 0, 0, 0, 1, 1, 1, 1]",199,91,108,5,11,0.054945054945054944,0.10185185185185185
"[0, 1, 0, 1, 0, 0, 0, 1, 0, 0, 1, 0, 1, 1, 1]",142,82,60,11,9,0.13414634146341464,0.15
"[1, 1, 0, 0, 0, 0, 0, 1, 1, 0, 0, 0, 1, 0, 1]",208,125,83,8,7,0.064,0.08433734939759036
"[0, 1, 1, 0, 0, 0, 1, 0, 0, 0, 0, 1, 1, 0, 1]",147,80,67,11,8,0.1375,0.11940298507462686
"[1, 1, 0, 1, 1, 1, 1, 1, 1, 1, 1, 0, 0, 1, 0]",588,191,397,19,44,0.09947643979057591,0.11083123425692695
"[0, 1, 1, 1, 1, 1, 1, 1, 0, 0, 1, 0, 0, 1, 0]",170,70,100,4,8,0.05714285714285714,0.08
"[1, 0, 1, 1, 0, 1, 0, 1, 0, 1, 0, 0, 1, 1, 1]",191,75,116,7,8,0.09333333333333334,0.06896551724137931
"[1, 1, 0, 1, 1, 1, 0, 1, 1, 0, 1, 1, 0, 0, 1]",244,77,167,7,13,0.09090909090909091,0.07784431137724551
"[1, 0, 0, 0, 0, 1, 1, 0, 1, 0, 0, 1, 1, 1, 1]",237,79,158,11,15,0.13924050632911392,0.0949367088607595
"[1, 0, 1, 1, 1, 1, 1, 0, 1, 1, 0, 1, 0, 1, 1]",520,145,375,13,27,0.0896551724137931,0.072
"[1, 0, 1, 0, 0, 0, 0, 1, 0, 0, 0, 1, 1, 1, 1]",192,105,87,4,10,0.0380952380952381,0.11494252873563218
"[1, 1, 1, 0, 0, 1, 0, 0, 0, 1, 0, 1, 0, 0, 0]",155,80,75,4,6,0.05,0.08
"[0, 1, 1, 1, 1, 0, 0, 1, 1, 0, 0, 1, 1, 0, 1]",431,318,113,34,10,0.1069182389937107,0.08849557522123894
"[1, 1, 0, 1, 1, 1, 0, 1, 0, 0, 0, 0, 1, 1, 1]",234,105,129,6,8,0.05714285714285714,0.06201550387596899
"[1, 1, 0, 1, 1, 1, 0, 1, 1, 1, 0, 1, 0, 0, 0]",140,55,85,7,12,0.12727272727272726,0.1411764705882353
"[1, 1, 0, 0, 0, 0, 0, 1, 1, 1, 0, 0, 1, 1, 1]",249,114,135,4,13,0.03508771929824561,0.0962962962962963
"[1, 0, 1, 1, 0, 0, 0, 0, 0, 1, 1, 0, 0, 0, 0]",496,287,209,27,19,0.09407665505226481,0.09090909090909091
"[0, 1, 1, 1, 0, 0, 0, 0, 1, 0, 1, 1, 0, 1, 1]",132,58,74,6,9,0.10344827586206896,0.12162162162162163
"[1, 0, 0, 0, 1, 0, 1, 0, 1, 1, 1, 0, 0, 0, 0]",208,114,94,4,6,0.03508771929824561,0.06382978723404255
"[1, 1, 1, 0, 1, 1, 1, 0, 1, 0, 1, 0, 0, 0, 0]",140,65,75,9,7,0.13846153846153847,0.09333333333333334
"[0, 0, 1, 0, 0, 0, 0, 1, 1, 0, 1, 0, 1, 0, 1]",132,83,49,5,6,0.060240963855421686,0.12244897959183673
"[0, 1, 0, 0, 1, 0, 0, 0, 0, 1, 1, 0, 1, 0, 1]",140,84,56,6,7,0.07142857142857142,0.125
"[0, 0, 1, 1, 0, 0, 1, 0, 1, 1, 0, 0, 0, 0, 0]",341,219,122,20,13,0.091324200913242,0.10655737704918032
"[1, 0, 0, 1, 1, 0, 0, 1, 0, 1, 1, 0, 0, 0, 0]",211,97,114,10,14,0.10309278350515463,0.12280701754385964
"[0, 0, 0, 0, 1, 0, 0, 1, 0, 0, 1, 1, 0, 0, 1]",345,220,125,21,14,0.09545454545454546,0.112
"[1, 1, 0, 0, 0, 1, 0, 1, 1, 0, 1, 0, 1, 1, 1]",185,79,106,9,8,0.11392405063291139,0.07547169811320754
"[1, 1, 0, 0, 0, 0, 0, 0, 0, 0, 1, 1, 0, 0, 1]",2179,1311,868,128,77,0.09763539282990084,0.08870967741935484
"[1, 0, 1, 0, 1, 1, 1, 1, 1, 0, 1, 0, 1, 1, 1]",579,162,417,19,30,0.11728395061728394,0.07194244604316546
"[0, 0, 1, 0, 1, 0, 1, 1, 1, 1, 1, 0, 1, 0, 1]",130,63,67,6,9,0.09523809523809523,0.13432835820895522
"[0, 1, 1, 0, 1, 0, 1, 0, 0, 0, 1, 1, 0, 0, 1]",115,57,58,7,6,0.12280701754385964,0.10344827586206896
"[0, 1, 1, 0, 1, 0, 1, 1, 1, 0, 1, 0, 0, 1, 1]",139,59,80,8,5,0.13559322033898305,0.0625
"[0, 1, 0, 1, 1, 0, 1, 0, 1, 1, 1, 0, 1, 0, 0]",100,48,52,7,2,0.14583333333333334,0.038461538461538464
"[1, 1, 1, 0, 0, 0, 0, 1, 1, 1, 0, 1, 1, 1, 0]",208,78,130,12,13,0.15384615384615385,0.1
"[1, 1, 0, 1, 1, 1, 1, 1, 0, 0, 1, 1, 0, 0, 1]",649,202,447,17,44,0.08415841584158416,0.09843400447427293
"[1, 0, 1, 1, 0, 1, 1, 1, 1, 1, 0, 0, 1, 1, 0]",357,132,225,10,15,0.07575757575757576,0.06666666666666667
"[1, 1, 0, 1, 0, 0, 0, 1, 0, 0, 1, 1, 0, 1, 1]",107,46,61,3,9,0.06521739130434782,0.14754098360655737
"[1, 1, 1, 1, 1, 0, 1, 0, 1, 1, 1, 1, 0, 0, 1]",817,223,594,14,59,0.06278026905829596,0.09932659932659933
"[1, 0, 1, 1, 1, 1, 1, 0, 1, 0, 1, 1, 1, 1, 0]",537,157,380,14,32,0.08917197452229299,0.08421052631578947
"[0, 1, 1, 1, 0, 0, 0, 0, 1, 0, 0, 1, 0, 1, 1]",124,67,57,10,6,0.14925373134328357,0.10526315789473684
"[1, 1, 1, 0, 1, 1, 1, 1, 0, 0, 1, 1, 1, 0, 1]",557,151,406,15,43,0.09933774834437085,0.10591133004926108
"[0, 1, 0, 0, 0, 1, 1, 0, 0, 0, 0, 1, 0, 0, 0]",564,401,163,34,15,0.08478802992518704,0.09202453987730061
"[0, 0, 0, 0, 1, 1, 0, 1, 1, 1, 0, 0, 1, 0, 0]",149,97,52,5,5,0.05154639175257732,0.09615384615384616
"[0, 0, 1, 0, 1, 0, 0, 0, 0, 0, 1, 1, 0, 1, 0]",230,142,88,13,9,0.09154929577464789,0.10227272727272728
"[1, 1, 1, 0, 0, 0, 0, 1, 1, 1, 0, 0, 1, 1, 1]",380,107,273,8,23,0.07476635514018691,0.08424908424908426
"[1, 1, 1, 1, 0, 0, 0, 0, 1, 1, 1, 0, 0, 0, 0]",313,154,159,10,15,0.06493506493506493,0.09433962264150944
"[1, 1, 1, 0, 0, 0, 1, 0, 1, 1, 1, 0, 1, 0, 0]",131,63,68,2,6,0.031746031746031744,0.08823529411764706
"[1, 1, 0, 1, 1, 1, 0, 0, 1, 1, 1, 0, 0, 0, 1]",166,58,108,6,10,0.10344827586206896,0.09259259259259259
"[1, 1, 0, 0, 0, 0, 0, 0, 1, 0, 1, 1, 1, 1, 1]",321,138,183,12,21,0.08695652173913043,0.11475409836065574
"[0, 1, 1, 1, 0, 1, 1, 0, 0, 1, 0, 0, 1, 1, 1]",203,107,96,7,10,0.06542056074766354,0.10416666666666667
"[1, 0, 1, 1, 0, 1, 0, 0, 1, 1, 1, 0, 0, 0, 1]",115,54,61,8,4,0.14814814814814814,0.06557377049180328
"[1, 1, 0, 0, 1, 1, 1, 0, 1, 1, 0, 0, 0, 0, 0]",196,97,99,12,7,0.12371134020618557,0.0707070707070707
"[1, 1, 0, 1, 0, 0, 1, 1, 1, 0, 0, 1, 0, 0, 0]",118,67,51,4,4,0.05970149253731343,0.0784313725490196
"[1, 0, 1, 1, 0, 1, 0, 0, 1, 1, 1, 0, 0, 1, 0]",98,47,51,2,2,0.0425531914893617,0.0392156862745098
"[1, 1, 1, 1, 1, 0, 1, 0, 1, 1, 0, 1, 0, 0, 1]",239,72,167,11,12,0.1527777777777778,0.0718562874251497
"[0, 0, 1, 0, 0, 1, 0, 0, 1, 0, 1, 0, 0, 0, 1]",237,161,76,16,10,0.09937888198757763,0.13157894736842105
"[0, 0, 0, 0, 0, 1, 0, 0, 1, 0, 0, 1, 0, 1, 0]",524,353,171,35,20,0.09915014164305949,0.11695906432748537
"[1, 0, 0, 1, 0, 0, 0, 1, 1, 0, 1, 1, 0, 0, 0]",155,86,69,9,5,0.10465116279069768,0.07246376811594203
"[0, 0, 0, 0, 1, 0, 0, 0, 1, 0, 0, 1, 0, 0, 1]",499,363,136,38,13,0.1046831955922865,0.09558823529411764
"[1, 0, 1, 1, 1, 0, 1, 1, 1, 1, 1, 0, 1, 1, 0]",482,154,328,13,32,0.08441558441558442,0.0975609756097561
"[1, 1, 0, 0, 1, 0, 1, 1, 1, 1, 0, 0, 1, 0, 1]",140,63,77,5,5,0.07936507936507936,0.06493506493506493
"[1, 0, 0, 0, 1, 1, 1, 0, 0, 0, 1, 0, 1, 0, 0]",165,98,67,7,5,0.07142857142857142,0.07462686567164178
"[1, 0, 1, 0, 0, 0, 1, 1, 1, 0, 0, 0, 1, 0, 1]",108,58,50,3,8,0.05172413793103448,0.16
"[1, 1, 0, 1, 0, 0, 0, 1, 1, 1, 0, 0, 0, 1, 0]",110,58,52,3,7,0.05172413793103448,0.1346153846153846
"[1, 0, 1, 1, 1, 0, 0, 0, 1, 1, 1, 0, 1, 0, 0]",121,57,64,8,4,0.14035087719298245,0.0625
"[0, 1, 0, 0, 0, 0, 0, 0, 1, 1, 1, 1, 0, 1, 1]",197,114,83,7,6,0.06140350877192982,0.07228915662650602
"[1, 1, 0, 1, 0, 0, 0, 1, 0, 0, 0, 0, 0, 0, 1]",283,176,107,18,8,0.10227272727272728,0.07476635514018691
"[0, 0, 1, 1, 1, 0, 1, 0, 0, 0, 1, 0, 0, 0, 0]",249,149,100,13,10,0.087248322147651,0.1
"[0, 1, 0, 0, 1, 1, 0, 1, 0, 1, 0, 0, 1, 1, 1]",166,69,97,6,8,0.08695652173913043,0.08247422680412371
"[1, 0, 0, 1, 0, 1, 0, 0, 0, 1, 1, 0, 1, 0, 0]",140,86,54,10,6,0.11627906976744186,0.1111111111111111
"[0, 1, 1, 0, 1, 0, 1, 0, 1, 0, 0, 0, 1, 0, 0]",145,89,56,13,6,0.14606741573033707,0.10714285714285714
"[1, 0, 0, 1, 0, 0, 1, 1, 0, 0, 0, 0, 1, 1, 1]",328,169,159,16,14,0.09467455621301775,0.0880503144654088
"[0, 0, 0, 0, 1, 1, 1, 0, 1, 1, 0, 0, 1, 1, 0]",189,103,86,14,7,0.13592233009708737,0.08139534883720931
"[1, 1, 1, 0, 1, 1, 1, 0, 1, 1, 0, 0, 1, 1, 1]",712,200,512,22,60,0.11,0.1171875
"[0, 1, 0, 1, 0, 1, 1, 0, 1, 1, 0, 1, 1, 1, 1]",243,85,158,8,18,0.09411764705882353,0.11392405063291139
"[1, 1, 0, 1, 1, 0, 1, 1, 1, 1, 0, 1, 1, 1, 0]",539,153,386,18,32,0.11764705882352941,0.08290155440414508
"[1, 1, 0, 1, 1, 0, 1, 1, 1, 1, 0, 1, 1, 0, 0]",278,103,175,18,14,0.17475728155339806,0.08
"[0, 0, 0, 1, 1, 1, 0, 1, 1, 1, 0, 1, 1, 0, 1]",156,67,89,6,5,0.08955223880597014,0.056179775280898875
"[1, 1, 1, 0, 0, 1, 1, 0, 0, 1, 1, 1, 1, 0, 1]",765,138,627,14,67,0.10144927536231885,0.10685805422647528
"[0, 1, 1, 1, 1, 1, 0, 0, 0, 1, 1, 0, 1, 0, 1]",174,86,88,9,4,0.10465116279069768,0.045454545454545456
"[1, 1, 1, 1, 0, 0, 1, 1, 1, 1, 1, 0, 0, 0, 0]",437,160,277,13,25,0.08125,0.09025270758122744
"[1, 1, 1, 0, 1, 0, 1, 1, 0, 0, 1, 1, 1, 0, 0]",161,54,107,5,8,0.09259259259259259,0.07476635514018691
"[1, 1, 1, 1, 1, 1, 1, 1, 0, 1, 0, 0, 1, 0, 0]",299,107,192,6,23,0.056074766355140186,0.11979166666666667
"[0, 1, 1, 1, 0, 1, 0, 1, 0, 0, 0, 0, 1, 1, 0]",148,85,63,11,7,0.12941176470588237,0.1111111111111111
"[0, 1, 1, 1, 0, 0, 0, 0, 1, 1, 0, 0, 1, 0, 1]",174,102,72,11,4,0.10784313725490197,0.05555555555555555
"[0, 0, 1, 0, 0, 0, 1, 1, 1, 0, 0, 0, 0, 1, 1]",249,143,106,17,12,0.11888111888111888,0.11320754716981132
"[1, 0, 1, 1, 0, 0, 1, 1, 1, 1, 0, 0, 1, 1, 0]",474,213,261,18,25,0.08450704225352113,0.09578544061302682
"[0, 0, 1, 0, 1, 0, 1, 0, 1, 0, 0, 0, 0, 0, 1]",244,164,80,15,9,0.09146341463414634,0.1125
"[1, 0, 0, 0, 0, 1, 1, 0, 0, 1, 1, 0, 1, 0, 1]",220,70,150,6,16,0.08571428571428572,0.10666666666666667
"[0, 0, 1, 0, 0, 1, 0, 0, 1, 1, 0, 0, 1, 0, 0]",244,169,75,12,7,0.07100591715976332,0.09333333333333334
"[0, 0, 1, 1, 0, 1, 0, 0, 1, 1, 1, 0, 1, 0, 0]",104,53,51,5,9,0.09433962264150944,0.17647058823529413
"[1, 1, 0, 0, 1, 1, 0, 1, 0, 1, 1, 1, 1, 1, 1]",802,261,541,20,51,0.07662835249042145,0.09426987060998152
"[0, 0, 0, 0, 0, 0, 1, 1, 0, 1, 0, 0, 0, 1, 0]",611,454,157,41,12,0.09030837004405286,0.07643312101910828
"[1, 0, 0, 0, 1, 1, 0, 0, 0, 0, 1, 0, 0, 1, 0]",232,144,88,14,9,0.09722222222222222,0.10227272727272728
"[1, 1, 0, 1, 1, 1, 0, 1, 1, 1, 1, 1, 0, 1, 0]",467,128,339,13,50,0.1015625,0.14749262536873156
"[1, 0, 0, 1, 1, 0, 1, 1, 1, 0, 1, 1, 1, 1, 1]",670,176,494,20,39,0.11363636363636363,0.07894736842105263
"[1, 0, 0, 0, 1, 1, 1, 1, 1, 0, 1, 1, 1, 0, 0]",184,61,123,7,14,0.11475409836065574,0.11382113821138211
"[1, 1, 1, 1, 1, 1, 1, 0, 0, 0, 1, 0, 1, 1, 1]",972,233,739,29,64,0.12446351931330472,0.08660351826792964
"[0, 0, 0, 1, 1, 0, 1, 0, 1, 1, 1, 0, 1, 1, 1]",195,100,95,9,12,0.09,0.12631578947368421
"[0, 0, 0, 0, 0, 0, 0, 1, 0, 1, 1, 1, 1, 1, 1]",399,247,152,29,13,0.11740890688259109,0.08552631578947369
"[0, 1, 1, 0, 1, 1, 1, 1, 0, 1, 1, 0, 0, 1, 0]",134,65,69,3,6,0.046153846153846156,0.08695652173913043
"[0, 1, 0, 1, 1, 0, 0, 0, 0, 0, 0, 0, 1, 1, 0]",400,240,160,16,13,0.06666666666666667,0.08125
"[1, 0, 0, 1, 1, 1, 0, 1, 0, 0, 0, 0, 0, 0, 1]",196,99,97,8,7,0.08080808080808081,0.07216494845360824
"[1, 0, 0, 1, 0, 1, 0, 0, 1, 0, 1, 0, 0, 1, 0]",136,81,55,10,6,0.12345679012345678,0.10909090909090909
"[0, 0, 0, 1, 1, 1, 1, 1, 1, 1, 1, 0, 1, 0, 1]",394,223,171,21,16,0.09417040358744394,0.0935672514619883
"[0, 0, 1, 0, 0, 1, 1, 0, 0, 1, 1, 1, 1, 1, 1]",526,241,285,19,34,0.07883817427385892,0.11929824561403508
"[0, 1, 1, 1, 0, 0, 1, 1, 0, 0, 1, 1, 0, 1, 1]",190,80,110,7,8,0.0875,0.07272727272727272
"[1, 0, 1, 1, 1, 1, 1, 1, 1, 0, 0, 1, 1, 1, 0]",594,160,434,16,39,0.1,0.08986175115207373
"[1, 0, 0, 1, 0, 1, 1, 1, 1, 1, 1, 1, 0, 1, 1]",527,175,352,20,32,0.11428571428571428,0.09090909090909091
"[0, 1, 1, 0, 1, 0, 0, 1, 0, 1, 1, 1, 1, 1, 1]",327,142,185,20,21,0.14084507042253522,0.11351351351351352
"[1, 1, 0, 1, 1, 1, 0, 0, 1, 0, 1, 0, 1, 1, 1]",230,79,151,6,21,0.0759493670886076,0.1390728476821192
"[1, 0, 1, 1, 1, 1, 1, 1, 0, 0, 0, 0, 0, 0, 0]",485,239,246,32,31,0.13389121338912133,0.12601626016260162
"[0, 1, 1, 1, 1, 1, 0, 1, 0, 0, 0, 0, 1, 1, 0]",158,84,74,6,10,0.07142857142857142,0.13513513513513514
"[0, 1, 1, 1, 1, 1, 0, 1, 0, 1, 1, 0, 0, 1, 0]",151,70,81,4,6,0.05714285714285714,0.07407407407407407
"[0, 1, 0, 1, 1, 1, 1, 1, 0, 1, 0, 1, 1, 0, 0]",132,50,82,2,7,0.04,0.08536585365853659
"[1, 1, 1, 1, 0, 0, 1, 0, 1, 1, 1, 1, 1, 0, 1]",521,159,362,18,32,0.11320754716981132,0.08839779005524862
"[1, 1, 1, 1, 1, 0, 0, 1, 0, 1, 1, 1, 1, 1, 0]",577,157,420,17,34,0.10828025477707007,0.08095238095238096
"[0, 0, 0, 0, 0, 0, 1, 1, 0, 1, 0, 0, 0, 1, 1]",510,350,160,34,14,0.09714285714285714,0.0875
"[0, 0, 1, 1, 1, 1, 0, 1, 0, 1, 1, 1, 1, 1, 1]",862,252,610,27,60,0.10714285714285714,0.09836065573770492
"[1, 0, 0, 0, 1, 0, 1, 0, 0, 1, 0, 1, 0, 0, 0]",206,126,80,15,12,0.11904761904761904,0.15
"[0, 0, 1, 1, 0, 1, 1, 0, 1, 1, 0, 0, 0, 0, 0]",246,136,110,19,13,0.13970588235294118,0.11818181818181818
"[1, 0, 0, 0, 1, 1, 1, 1, 0, 0, 0, 0, 0, 0, 0]",839,519,320,41,26,0.0789980732177264,0.08125
"[0, 1, 1, 0, 0, 0, 1, 0, 1, 0, 0, 0, 1, 1, 1]",172,110,62,12,4,0.10909090909090909,0.06451612903225806
"[0, 1, 0, 1, 1, 0, 1, 1, 0, 1, 0, 0, 0, 0, 1]",128,71,57,8,7,0.11267605633802817,0.12280701754385964
"[0, 0, 1, 0, 0, 0, 1, 1, 0, 0, 0, 0, 1, 1, 1]",453,267,186,28,21,0.10486891385767791,0.11290322580645161
"[1, 1, 0, 1, 1, 1, 0, 1, 1, 1, 0, 0, 1, 1, 0]",332,121,211,21,14,0.17355371900826447,0.06635071090047394
"[1, 1, 0, 1, 1, 0, 1, 1, 0, 0, 0, 0, 1, 1, 1]",308,121,187,14,23,0.11570247933884298,0.12299465240641712
"[0, 0, 0, 1, 1, 1, 0, 1, 1, 1, 1, 1, 0, 1, 1]",303,132,171,10,17,0.07575757575757576,0.09941520467836257
"[1, 1, 0, 1, 1, 1, 0, 0, 1, 1, 1, 1, 1, 0, 1]",539,151,388,13,37,0.08609271523178808,0.09536082474226804
"[0, 1, 1, 0, 1, 1, 1, 0, 0, 1, 1, 1, 1, 1, 0]",242,90,152,8,14,0.08888888888888889,0.09210526315789473
"[0, 0, 1, 0, 1, 1, 1, 0, 1, 0, 0, 1, 0, 0, 0]",139,76,63,5,6,0.06578947368421052,0.09523809523809523
"[0, 0, 0, 1, 0, 1, 1, 1, 0, 1, 0, 0, 1, 0, 0]",129,84,45,8,2,0.09523809523809523,0.044444444444444446
"[0, 1, 0, 1, 0, 1, 1, 0, 1, 0, 1, 0, 0, 0, 1]",92,46,46,6,2,0.13043478260869565,0.043478260869565216
"[0, 0, 1, 0, 1, 0, 1, 0, 0, 1, 0, 0, 0, 1, 0]",212,134,78,11,7,0.08208955223880597,0.08974358974358974
"[1, 1, 1, 1, 1, 0, 0, 0, 0, 0, 0, 0, 0, 0, 1]",650,208,442,22,37,0.10576923076923077,0.083710407239819
"[0, 1, 0, 0, 0, 1, 1, 1, 1, 1, 0, 0, 0, 0, 0]",270,159,111,22,9,0.13836477987421383,0.08108108108108109
"[1, 0, 1, 1, 1, 1, 0, 0, 1, 1, 0, 1, 0, 0, 0]",132,62,70,6,9,0.0967741935483871,0.12857142857142856
"[1, 0, 1, 1, 0, 1, 0, 1, 1, 1, 1, 0, 0, 1, 1]",384,142,242,12,30,0.08450704225352113,0.12396694214876033
"[0, 0, 1, 1, 0, 1, 0, 1, 0, 0, 0, 0, 0, 1, 0]",241,164,77,16,10,0.0975609756097561,0.12987012987012986
"[1, 0, 0, 0, 0, 0, 1, 1, 0, 1, 0, 1, 0, 0, 0]",272,165,107,22,10,0.13333333333333333,0.09345794392523364
"[1, 1, 0, 0, 1, 1, 0, 1, 0, 0, 1, 1, 1, 0, 0]",126,66,60,7,2,0.10606060606060606,0.03333333333333333
"[0, 1, 1, 0, 0, 0, 0, 0, 1, 1, 1, 1, 0, 1, 1]",182,104,78,11,8,0.10576923076923077,0.10256410256410256
"[0, 0, 1, 0, 0, 0, 1, 1, 1, 1, 1, 0, 0, 0, 0]",280,162,118,17,12,0.10493827160493827,0.1016949152542373
"[1, 1, 1, 0, 0, 0, 0, 1, 1, 1, 1, 0, 0, 0, 1]",409,102,307,7,22,0.06862745098039216,0.07166123778501629
"[1, 0, 0, 0, 0, 1, 1, 1, 0, 1, 0, 0, 1, 0, 0]",163,98,65,11,5,0.11224489795918367,0.07692307692307693
"[0, 0, 0, 1, 0, 0, 1, 0, 1, 0, 1, 1, 0, 0, 0]",293,182,111,19,11,0.1043956043956044,0.0990990990990991
"[0, 1, 0, 1, 1, 1, 0, 0, 0, 0, 0, 0, 1, 1, 1]",352,191,161,24,18,0.1256544502617801,0.11180124223602485
"[1, 1, 0, 0, 1, 1, 1, 0, 1, 0, 0, 1, 1, 0, 0]",188,93,95,10,13,0.10752688172043011,0.1368421052631579
"[1, 0, 1, 1, 1, 1, 0, 1, 0, 0, 1, 0, 0, 1, 1]",191,69,122,4,12,0.057971014492753624,0.09836065573770492
"[0, 0, 1, 1, 0, 0, 0, 1, 0, 0, 0, 0, 0, 0, 1]",694,482,212,49,27,0.1016597510373444,0.12735849056603774
"[1, 1, 0, 1, 1, 1, 1, 0, 0, 1, 1, 0, 1, 1, 0]",267,90,177,12,20,0.13333333333333333,0.11299435028248588
"[1, 1, 1, 0, 0, 0, 1, 0, 1, 1, 1, 1, 1, 1, 0]",337,106,231,13,23,0.12264150943396226,0.09956709956709957
"[0, 0, 0, 1, 1, 0, 1, 0, 1, 1, 1, 1, 1, 1, 1]",434,190,244,23,18,0.12105263157894737,0.07377049180327869
"[1, 1, 0, 1, 1, 0, 0, 1, 1, 1, 1, 0, 0, 1, 0]",172,74,98,6,5,0.08108108108108109,0.05102040816326531
"[1, 0, 1, 0, 0, 1, 1, 1, 0, 1, 1, 0, 1, 1, 1]",229,82,147,7,15,0.08536585365853659,0.10204081632653061
"[1, 1, 0, 1, 0, 1, 1, 1, 0, 0, 0, 0, 1, 0, 1]",116,54,62,9,7,0.16666666666666666,0.11290322580645161
"[0, 0, 1, 1, 1, 1, 1, 0, 1, 1, 1, 0, 0, 1, 1]",390,150,240,14,22,0.09333333333333334,0.09166666666666666
"[0, 1, 0, 1, 1, 1, 1, 0, 0, 1, 1, 0, 0, 0, 0]",425,235,190,19,20,0.08085106382978724,0.10526315789473684
"[1, 0, 1, 0, 0, 1, 0, 1, 1, 0, 1, 1, 0, 0, 0]",131,64,67,7,3,0.109375,0.04477611940298507
"[0, 0, 1, 0, 0, 1, 0, 1, 0, 0, 1, 0, 1, 1, 0]",163,113,50,8,6,0.07079646017699115,0.12
"[1, 1, 1, 1, 0, 1, 1, 0, 0, 1, 1, 1, 1, 1, 0]",651,179,472,16,47,0.0893854748603352,0.09957627118644068
"[1, 0, 0, 0, 0, 1, 1, 0, 1, 1, 0, 0, 0, 0, 0]",377,211,166,21,20,0.0995260663507109,0.12048192771084337
"[0, 0, 0, 1, 1, 0, 0, 0, 0, 1, 1, 0, 1, 1, 0]",257,180,77,18,11,0.1,0.14285714285714285
"[1, 1, 0, 0, 0, 1, 1, 1, 0, 1, 1, 0, 0, 0, 0]",159,78,81,12,1,0.15384615384615385,0.012345679012345678
"[0, 1, 1, 0, 1, 1, 1, 1, 0, 0, 0, 1, 1, 1, 0]",152,66,86,8,9,0.12121212121212122,0.10465116279069768
"[1, 1, 1, 1, 0, 1, 1, 0, 0, 0, 0, 0, 0, 0, 1]",196,99,97,8,12,0.08080808080808081,0.12371134020618557
"[1, 1, 1, 0, 1, 0, 1, 1, 0, 0, 1, 1, 1, 1, 1]",821,268,553,29,61,0.10820895522388059,0.11030741410488246
"[1, 0, 1, 1, 0, 1, 1, 0, 1, 1, 0, 1, 1, 0, 1]",236,84,152,8,17,0.09523809523809523,0.1118421052631579
"[1, 0, 1, 0, 0, 0, 0, 0, 1, 1, 1, 1, 1, 1, 0]",279,132,147,10,8,0.07575757575757576,0.05442176870748299
"[1, 0, 0, 1, 1, 0, 1, 1, 1, 1, 0, 0, 0, 0, 1]",218,75,143,7,13,0.09333333333333334,0.09090909090909091
"[0, 1, 1, 1, 0, 0, 0, 1, 0, 0, 1, 0, 0, 1, 1]",137,74,63,10,7,0.13513513513513514,0.1111111111111111
"[1, 0, 1, 0, 1, 1, 0, 0, 1, 0, 0, 0, 0, 1, 0]",138,80,58,12,7,0.15,0.1206896551724138
"[1, 1, 0, 1, 0, 1, 1, 0, 0, 1, 0, 0, 0, 0, 1]",123,66,57,9,5,0.13636363636363635,0.08771929824561403
"[1, 0, 1, 1, 1, 0, 1, 1, 1, 1, 0, 0, 0, 1, 1]",300,98,202,14,22,0.14285714285714285,0.10891089108910891
"[1, 0, 1, 0, 0, 0, 1, 1, 0, 1, 1, 1, 0, 1, 1]",156,69,87,8,13,0.11594202898550725,0.14942528735632185
"[0, 0, 1, 1, 1, 1, 0, 1, 0, 1, 0, 1, 1, 0, 1]",142,67,75,6,4,0.08955223880597014,0.05333333333333334
"[0, 0, 0, 1, 1, 1, 1, 0, 1, 0, 1, 0, 1, 1, 0]",143,87,56,5,11,0.05747126436781609,0.19642857142857142
"[1, 1, 1, 1, 0, 1, 1, 0, 1, 0, 0, 1, 0, 1, 0]",120,59,61,4,6,0.06779661016949153,0.09836065573770492
"[1, 0, 1, 0, 0, 0, 0, 1, 0, 1, 1, 0, 0, 0, 0]",321,202,119,18,8,0.0891089108910891,0.06722689075630252
"[0, 1, 1, 1, 1, 1, 0, 0, 1, 0, 1, 0, 1, 1, 1]",287,119,168,15,16,0.12605042016806722,0.09523809523809523
"[1, 0, 1, 0, 1, 1, 0, 1, 0, 0, 0, 1, 0, 1, 1]",109,55,54,6,5,0.10909090909090909,0.09259259259259259
"[0, 1, 0, 1, 0, 0, 1, 1, 1, 1, 1, 0, 1, 1, 0]",141,54,87,3,17,0.05555555555555555,0.19540229885057472
"[1, 0, 1, 1, 1, 0, 0, 1, 1, 0, 0, 0, 0, 1, 1]",426,203,223,17,22,0.08374384236453201,0.09865470852017937
"[0, 1, 0, 0, 1, 0, 1, 0, 1, 1, 1, 0, 0, 1, 1]",142,72,70,4,7,0.05555555555555555,0.1
"[0, 0, 1, 0, 1, 0, 1, 1, 1, 0, 1, 1, 0, 0, 1]",123,60,63,9,8,0.15,0.12698412698412698
"[1, 1, 1, 1, 0, 0, 1, 0, 0, 0, 0, 1, 0, 0, 0]",169,113,56,11,2,0.09734513274336283,0.03571428571428571
"[1, 0, 0, 1, 0, 0, 1, 1, 1, 1, 1, 0, 0, 1, 0]",102,47,55,4,7,0.0851063829787234,0.12727272727272726
"[0, 1, 0, 1, 0, 0, 0, 1, 1, 0, 0, 1, 0, 0, 1]",137,84,53,5,6,0.05952380952380952,0.11320754716981132
"[0, 1, 0, 1, 0, 1, 0, 0, 0, 1, 1, 0, 0, 1, 0]",121,69,52,5,5,0.07246376811594203,0.09615384615384616
"[1, 0, 1, 0, 1, 0, 0, 1, 0, 0, 0, 0, 0, 0, 0]",656,430,226,44,16,0.10232558139534884,0.07079646017699115
"[0, 1, 1, 1, 0, 1, 0, 1, 0, 0, 1, 1, 1, 1, 0]",193,74,119,10,8,0.13513513513513514,0.06722689075630252
"[1, 0, 0, 1, 1, 1, 0, 1, 0, 1, 0, 0, 1, 1, 1]",205,60,145,6,11,0.1,0.07586206896551724
"[0, 0, 1, 1, 0, 0, 1, 1, 1, 0, 1, 0, 1, 0, 0]",163,99,64,9,10,0.09090909090909091,0.15625
"[1, 0, 0, 0, 0, 1, 1, 1, 1, 0, 1, 1, 1, 1, 0]",238,68,170,12,21,0.17647058823529413,0.12352941176470589
"[1, 0, 0, 1, 1, 0, 0, 0, 1, 1, 0, 1, 0, 0, 0]",161,90,71,7,6,0.07777777777777778,0.08450704225352113
"[1, 0, 0, 1, 1, 1, 0, 0, 1, 0, 0, 1, 0, 1, 1]",123,50,73,5,3,0.1,0.0410958904109589
"[1, 0, 0, 0, 0, 0, 0, 0, 1, 0, 1, 0, 0, 1, 1]",375,214,161,28,11,0.1308411214953271,0.06832298136645963
"[1, 1, 0, 0, 1, 0, 0, 1, 0, 1, 1, 0, 1, 0, 0]",112,54,58,4,5,0.07407407407407407,0.08620689655172414
"[0, 0, 1, 0, 0, 0, 1, 1, 0, 1, 1, 1, 0, 0, 1]",117,58,59,6,12,0.10344827586206896,0.2033898305084746
"[1, 0, 0, 0, 1, 0, 0, 0, 1, 1, 0, 1, 1, 1, 0]",101,53,48,4,8,0.07547169811320754,0.16666666666666666
"[1, 0, 1, 0, 0, 0, 1, 0, 0, 0, 1, 1, 0, 1, 1]",124,69,55,4,11,0.057971014492753624,0.2
"[0, 0, 0, 1, 1, 1, 1, 0, 0, 0, 1, 0, 1, 0, 0]",198,148,50,12,3,0.08108108108108109,0.06
"[1, 1, 0, 1, 0, 0, 1, 1, 0, 1, 1, 0, 1, 0, 0]",117,52,65,5,5,0.09615384615384616,0.07692307692307693
"[0, 0, 1, 1, 0, 0, 1, 0, 0, 0, 1, 1, 1, 0, 1]",123,52,71,5,5,0.09615384615384616,0.07042253521126761
"[0, 1, 0, 0, 1, 1, 0, 0, 1, 0, 0, 0, 1, 1, 1]",170,99,71,8,9,0.08080808080808081,0.1267605633802817
"[1, 1, 1, 0, 1, 0, 0, 1, 1, 0, 0, 1, 0, 0, 0]",112,58,54,8,4,0.13793103448275862,0.07407407407407407
"[1, 1, 1, 1, 0, 1, 0, 0, 1, 1, 0, 0, 1, 0, 0]",124,58,66,7,6,0.1206896551724138,0.09090909090909091
"[1, 1, 1, 1, 1, 1, 1, 1, 0, 1, 0, 0, 1, 1, 0]",721,201,520,25,41,0.12437810945273632,0.07884615384615384
"[1, 1, 0, 0, 0, 0, 0, 0, 1, 0, 0, 0, 1, 1, 0]",362,226,136,22,12,0.09734513274336283,0.08823529411764706
"[0, 0, 1, 0, 0, 0, 0, 1, 1, 0, 0, 0, 1, 1, 1]",326,202,124,26,10,0.12871287128712872,0.08064516129032258
"[0, 0, 1, 0, 0, 0, 0, 1, 0, 1, 0, 0, 1, 0, 0]",477,324,153,46,20,0.1419753086419753,0.13071895424836602
"[0, 1, 0, 1, 1, 1, 0, 1, 1, 0, 0, 0, 1, 0, 0]",107,56,51,7,6,0.125,0.11764705882352941
"[1, 0, 1, 1, 1, 0, 0, 1, 0, 0, 1, 1, 0, 0, 0]",146,75,71,7,8,0.09333333333333334,0.11267605633802817
"[1, 1, 0, 1, 1, 1, 0, 0, 1, 0, 0, 1, 1, 0, 0]",152,58,94,1,10,0.017241379310344827,0.10638297872340426
"[1, 1, 1, 0, 1, 0, 1, 0, 1, 0, 0, 0, 1, 1, 1]",184,70,114,4,8,0.05714285714285714,0.07017543859649122
"[0, 0, 0, 0, 1, 1, 0, 1, 0, 0, 0, 0, 1, 0, 0]",512,364,148,36,13,0.0989010989010989,0.08783783783783784
"[0, 0, 0, 0, 0, 1, 1, 1, 0, 1, 1, 1, 0, 0, 1]",153,93,60,7,6,0.07526881720430108,0.1
"[1, 1, 0, 0, 0, 1, 1, 1, 0, 0, 0, 0, 0, 0, 0]",535,296,239,28,20,0.0945945945945946,0.08368200836820083
"[0, 1, 0, 0, 1, 1, 1, 0, 0, 1, 1, 0, 0, 0, 0]",342,205,137,27,16,0.13170731707317074,0.11678832116788321
"[0, 0, 1, 1, 0, 1, 1, 0, 1, 0, 1, 1, 0, 1, 1]",149,66,83,8,10,0.12121212121212122,0.12048192771084337
"[0, 0, 0, 0, 1, 0, 0, 0, 1, 1, 0, 1, 1, 0, 0]",287,187,100,23,9,0.12299465240641712,0.09
"[0, 1, 1, 0, 0, 0, 1, 1, 0, 0, 0, 1, 0, 0, 1]",175,104,71,9,6,0.08653846153846154,0.08450704225352113
"[1, 0, 0, 1, 1, 0, 0, 0, 0, 1, 1, 1, 0, 1, 0]",207,63,144,4,12,0.06349206349206349,0.08333333333333333
"[1, 0, 0, 1, 0, 1, 0, 1, 1, 0, 1, 0, 1, 1, 1]",169,67,102,6,5,0.08955223880597014,0.049019607843137254
"[1, 1, 1, 1, 1, 0, 1, 0, 1, 0, 1, 1, 0, 0, 1]",296,90,206,7,18,0.07777777777777778,0.08737864077669903
"[1, 1, 1, 0, 0, 1, 1, 1, 0, 0, 0, 1, 1, 1, 1]",462,149,313,10,29,0.06711409395973154,0.0926517571884984
"[0, 0, 1, 0, 1, 1, 0, 0, 1, 0, 0, 1, 0, 1, 1]",134,68,66,9,5,0.1323529411764706,0.07575757575757576
"[1, 0, 0, 1, 0, 1, 1, 0, 0, 1, 0, 0, 1, 0, 1]",105,60,45,5,3,0.08333333333333333,0.06666666666666667
"[1, 0, 1, 1, 1, 1, 1, 1, 1, 1, 0, 0, 1, 0, 1]",565,156,409,12,36,0.07692307692307693,0.08801955990220049
"[0, 1, 1, 1, 0, 0, 0, 0, 1, 0, 0, 0, 1, 1, 0]",180,116,64,15,5,0.12931034482758622,0.078125
"[1, 1, 1, 0, 1, 1, 0, 0, 1, 0, 0, 0, 0, 0, 1]",136,68,68,10,4,0.14705882352941177,0.058823529411764705
"[0, 0, 0, 1, 0, 0, 0, 0, 1, 1, 1, 0, 0, 1, 1]",232,142,90,17,11,0.11971830985915492,0.12222222222222222
"[1, 1, 1, 1, 0, 1, 1, 0, 1, 1, 0, 0, 1, 1, 1]",786,214,572,25,43,0.11682242990654206,0.07517482517482517
"[0, 0, 0, 1, 0, 1, 0, 1, 0, 0, 1, 0, 1, 1, 0]",150,94,56,9,3,0.09574468085106383,0.05357142857142857
"[0, 0, 0, 1, 0, 1, 1, 0, 0, 1, 0, 0, 1, 0, 1]",133,77,56,12,8,0.15584415584415584,0.14285714285714285
"[1, 0, 0, 1, 1, 1, 1, 0, 0, 0, 1, 0, 1, 1, 0]",152,49,103,1,6,0.02040816326530612,0.05825242718446602
"[0, 0, 0, 1, 1, 0, 1, 1, 0, 0, 1, 1, 1, 1, 0]",222,111,111,10,13,0.09009009009009009,0.11711711711711711
"[1, 1, 1, 0, 1, 0, 1, 0, 0, 1, 1, 0, 0, 1, 1]",244,95,149,16,15,0.16842105263157894,0.10067114093959731
"[1, 0, 0, 1, 0, 0, 0, 0, 1, 0, 0, 1, 1, 0, 0]",295,178,117,13,10,0.07303370786516854,0.08547008547008547
"[1, 0, 1, 1, 1, 1, 0, 1, 1, 1, 1, 0, 1, 1, 1]",1563,364,1199,36,108,0.0989010989010989,0.09007506255212677
"[0, 1, 0, 0, 0, 0, 1, 1, 1, 1, 1, 1, 0, 1, 1]",213,93,120,12,11,0.12903225806451613,0.09166666666666666
"[1, 1, 1, 1, 1, 1, 1, 0, 0, 1, 0, 0, 0, 0, 1]",278,93,185,8,15,0.08602150537634409,0.08108108108108109
"[0, 0, 0, 1, 1, 0, 0, 1, 0, 0, 1, 1, 0, 1, 1]",171,107,64,10,6,0.09345794392523364,0.09375
"[0, 1, 0, 0, 1, 0, 1, 1, 0, 0, 1, 0, 0, 1, 0]",139,77,62,7,7,0.09090909090909091,0.11290322580645161
"[0, 1, 0, 1, 1, 1, 1, 1, 1, 0, 1, 0, 1, 0, 0]",153,58,95,5,6,0.08620689655172414,0.06315789473684211
"[0, 1, 0, 1, 0, 1, 1, 0, 1, 1, 0, 1, 0, 1, 1]",143,53,90,5,7,0.09433962264150944,0.07777777777777778
"[0, 0, 1, 0, 0, 1, 0, 0, 0, 1, 0, 1, 0, 1, 1]",154,84,70,8,7,0.09523809523809523,0.1
"[1, 0, 1, 0, 0, 1, 1, 1, 1, 0, 1, 1, 0, 1, 1]",239,88,151,14,17,0.1590909090909091,0.11258278145695365
"[0, 0, 1, 0, 0, 0, 0, 1, 0, 1, 0, 0, 1, 1, 1]",206,119,87,9,8,0.07563025210084033,0.09195402298850575
"[1, 1, 0, 0, 1, 0, 0, 0, 0, 1, 0, 1, 0, 0, 1]",162,103,59,15,6,0.14563106796116504,0.1016949152542373
"[0, 1, 0, 0, 1, 1, 0, 0, 0, 0, 1, 0, 1, 0, 0]",253,144,109,11,7,0.0763888888888889,0.06422018348623854
"[1, 0, 1, 1, 1, 0, 1, 0, 0, 1, 1, 0, 0, 0, 0]",195,100,95,9,11,0.09,0.11578947368421053
"[0, 1, 0, 1, 1, 1, 0, 1, 0, 0, 1, 1, 0, 0, 0]",155,81,74,5,5,0.06172839506172839,0.06756756756756757
"[0, 0, 0, 0, 0, 1, 0, 1, 1, 1, 0, 1, 0, 0, 1]",162,96,66,7,6,0.07291666666666667,0.09090909090909091
"[0, 0, 0, 0, 0, 1, 1, 1, 0, 0, 0, 0, 1, 1, 1]",551,408,143,32,14,0.0784313725490196,0.0979020979020979
"[0, 0, 0, 1, 0, 0, 1, 0, 0, 0, 0, 0, 1, 0, 1]",522,394,128,29,13,0.07360406091370558,0.1015625
"[1, 1, 0, 0, 0, 1, 1, 1, 0, 0, 1, 1, 1, 1, 1]",472,167,305,19,25,0.11377245508982035,0.08196721311475409
"[1, 1, 1, 1, 1, 1, 0, 0, 0, 1, 1, 1, 0, 0, 1]",381,135,246,18,25,0.13333333333333333,0.1016260162601626
"[0, 0, 1, 0, 1, 1, 0, 1, 0, 1, 1, 0, 0, 1, 1]",131,60,71,6,4,0.1,0.056338028169014086
"[1, 0, 1, 0, 0, 0, 1, 0, 0, 0, 1, 0, 1, 1, 0]",167,92,75,9,7,0.09782608695652174,0.09333333333333334
"[1, 0, 0, 0, 1, 1, 0, 0, 1, 0, 0, 1, 0, 1, 0]",119,55,64,2,8,0.03636363636363636,0.125
"[0, 0, 0, 1, 0, 1, 1, 1, 0, 0, 1, 0, 1, 0, 0]",148,78,70,5,8,0.0641025641025641,0.11428571428571428
"[1, 0, 0, 0, 0, 1, 0, 1, 1, 1, 0, 0, 1, 0, 1]",119,60,59,7,5,0.11666666666666667,0.0847457627118644
"[1, 0, 1, 0, 0, 0, 0, 0, 1, 0, 0, 1, 1, 0, 0]",316,202,114,26,10,0.12871287128712872,0.08771929824561403
"[1, 0, 1, 1, 0, 1, 0, 1, 0, 1, 1, 0, 1, 0, 1]",133,47,86,2,9,0.0425531914893617,0.10465116279069768
"[0, 1, 0, 1, 0, 1, 1, 1, 0, 1, 1, 0, 1, 0, 1]",121,55,66,3,7,0.05454545454545454,0.10606060606060606
"[1, 0, 1, 0, 1, 0, 1, 1, 1, 0, 1, 1, 0, 1, 0]",120,55,65,3,9,0.05454545454545454,0.13846153846153847
"[1, 1, 1, 1, 0, 0, 1, 0, 0, 1, 0, 1, 0, 1, 0]",109,60,49,6,5,0.1,0.10204081632653061
"[1, 1, 0, 1, 1, 1, 0, 0, 1, 0, 1, 1, 1, 1, 1]",674,184,490,19,50,0.10326086956521739,0.10204081632653061
"[0, 0, 1, 1, 0, 0, 0, 0, 1, 0, 1, 1, 1, 0, 0]",191,106,85,10,5,0.09433962264150944,0.058823529411764705
"[0, 1, 1, 0, 1, 1, 0, 1, 1, 1, 0, 0, 1, 0, 1]",161,68,93,5,10,0.07352941176470588,0.10752688172043011
"[0, 0, 1, 0, 0, 0, 1, 1, 1, 1, 1, 1, 1, 0, 0]",210,103,107,9,7,0.08737864077669903,0.06542056074766354
"[1, 1, 1, 1, 0, 1, 0, 1, 0, 1, 1, 0, 1, 1, 0]",231,75,156,14,16,0.18666666666666668,0.10256410256410256
"[0, 1, 0, 0, 0, 1, 1, 1, 1, 0, 1, 0, 1, 0, 1]",112,51,61,7,7,0.13725490196078433,0.11475409836065574
"[1, 0, 1, 1, 0, 0, 0, 0, 1, 1, 1, 1, 1, 0, 1]",163,56,107,5,11,0.08928571428571429,0.102803738317757
"[1, 1, 0, 0, 0, 0, 0, 0, 0, 0, 1, 0, 1, 0, 0]",804,566,238,64,29,0.11307420494699646,0.12184873949579832
"[0, 0, 0, 0, 0, 1, 0, 0, 0, 1, 0, 1, 1, 0, 0]",617,453,164,36,15,0.07947019867549669,0.09146341463414634
"[0, 0, 0, 1, 1, 1, 0, 0, 1, 1, 1, 1, 1, 1, 0]",315,159,156,18,12,0.11320754716981132,0.07692307692307693
"[0, 0, 0, 0, 0, 0, 0, 1, 1, 1, 0, 0, 1, 1, 1]",602,444,158,33,22,0.07432432432432433,0.13924050632911392
"[0, 0, 1, 1, 1, 0, 1, 1, 0, 1, 1, 1, 1, 1, 0]",279,114,165,9,25,0.07894736842105263,0.15151515151515152
"[1, 1, 1, 0, 0, 1, 0, 1, 0, 1, 0, 1, 1, 1, 1]",323,103,220,8,27,0.07766990291262135,0.12272727272727273
"[1, 1, 1, 1, 0, 0, 1, 0, 1, 0, 1, 0, 1, 1, 1]",334,126,208,16,18,0.12698412698412698,0.08653846153846154
"[0, 1, 0, 1, 1, 1, 1, 0, 0, 1, 1, 1, 1, 0, 1]",280,96,184,8,21,0.08333333333333333,0.11413043478260869
"[0, 0, 0, 1, 1, 1, 1, 0, 0, 1, 1, 0, 0, 1, 0]",391,294,97,23,5,0.0782312925170068,0.05154639175257732
"[0, 1, 0, 0, 1, 0, 0, 1, 0, 0, 1, 1, 1, 1, 0]",148,80,68,7,3,0.0875,0.04411764705882353
"[0, 0, 0, 0, 1, 1, 0, 1, 0, 1, 1, 0, 0, 1, 1]",215,118,97,9,10,0.07627118644067797,0.10309278350515463
"[1, 1, 0, 1, 1, 1, 1, 1, 1, 0, 1, 0, 0, 0, 0]",186,73,113,7,9,0.0958904109589041,0.07964601769911504
"[1, 0, 1, 0, 0, 1, 1, 0, 1, 1, 1, 1, 1, 1, 0]",285,104,181,7,28,0.0673076923076923,0.15469613259668508
"[1, 0, 1, 0, 1, 0, 1, 0, 0, 1, 1, 0, 1, 1, 1]",149,66,83,9,11,0.13636363636363635,0.13253012048192772
"[0, 0, 1, 1, 1, 0, 1, 0, 0, 0, 1, 0, 0, 0, 1]",145,85,60,6,6,0.07058823529411765,0.1
"[1, 1, 1, 0, 0, 1, 1, 1, 0, 1, 0, 0, 0, 1, 0]",125,56,69,8,9,0.14285714285714285,0.13043478260869565
"[1, 0, 0, 0, 0, 1, 0, 0, 1, 0, 0, 0, 0, 0, 0]",1825,1345,480,117,63,0.08698884758364313,0.13125
"[1, 0, 1, 0, 0, 0, 0, 0, 0, 1, 1, 1, 1, 0, 0]",520,300,220,26,15,0.08666666666666667,0.06818181818181818
"[0, 1, 0, 1, 1, 1, 0, 0, 0, 0, 0, 0, 0, 1, 0]",294,191,103,25,11,0.13089005235602094,0.10679611650485436
"[0, 1, 1, 0, 1, 1, 1, 1, 0, 1, 0, 1, 1, 0, 0]",166,69,97,7,4,0.10144927536231885,0.041237113402061855
"[0, 1, 0, 1, 1, 1, 1, 1, 1, 1, 1, 0, 1, 1, 0]",520,149,371,16,38,0.10738255033557047,0.10242587601078167
"[0, 0, 0, 0, 1, 1, 0, 0, 0, 1, 1, 0, 1, 1, 1]",301,162,139,21,12,0.12962962962962962,0.08633093525179857
"[1, 0, 1, 0, 0, 1, 1, 1, 1, 1, 0, 1, 1, 1, 0]",255,94,161,8,18,0.0851063829787234,0.11180124223602485
"[1, 0, 1, 1, 0, 1, 1, 0, 0, 0, 0, 1, 1, 1, 1]",374,137,237,8,36,0.058394160583941604,0.1518987341772152
"[0, 1, 0, 1, 1, 0, 0, 1, 1, 1, 0, 1, 0, 1, 1]",181,86,95,8,10,0.09302325581395349,0.10526315789473684
"[0, 0, 0, 0, 1, 1, 1, 0, 0, 0, 1, 0, 0, 0, 1]",294,199,95,18,9,0.09045226130653267,0.09473684210526316
"[0, 1, 1, 1, 1, 0, 0, 1, 1, 0, 1, 0, 0, 0, 0]",205,141,64,7,4,0.04964539007092199,0.0625
"[1, 0, 0, 0, 1, 0, 1, 0, 0, 1, 1, 0, 1, 1, 0]",105,56,49,3,3,0.05357142857142857,0.061224489795918366
"[0, 0, 0, 0, 1, 0, 1, 1, 1, 1, 0, 0, 0, 1, 1]",178,88,90,9,9,0.10227272727272728,0.1
"[0, 1, 0, 1, 1, 1, 1, 1, 1, 0, 0, 1, 1, 1, 0]",307,116,191,6,22,0.05172413793103448,0.11518324607329843
"[0, 1, 0, 1, 0, 1, 0, 1, 1, 0, 1, 1, 1, 1, 1]",281,120,161,15,15,0.125,0.09316770186335403
"[0, 0, 0, 1, 0, 1, 0, 1, 0, 1, 1, 0, 1, 1, 1]",136,71,65,2,6,0.028169014084507043,0.09230769230769231
"[1, 0, 0, 1, 0, 0, 1, 1, 1, 0, 0, 1, 0, 0, 1]",118,57,61,5,4,0.08771929824561403,0.06557377049180328
"[1, 1, 1, 0, 1, 1, 0, 0, 0, 0, 1, 1, 0, 1, 0]",98,48,50,6,2,0.125,0.04
"[0, 1, 1, 1, 1, 0, 0, 1, 1, 0, 0, 1, 0, 0, 1]",244,177,67,10,9,0.05649717514124294,0.13432835820895522
"[0, 0, 1, 0, 1, 0, 1, 1, 1, 0, 0, 1, 0, 1, 0]",121,63,58,6,3,0.09523809523809523,0.05172413793103448
"[1, 1, 0, 0, 0, 0, 1, 0, 1, 0, 1, 1, 1, 0, 0]",148,83,65,5,3,0.060240963855421686,0.046153846153846156
"[1, 1, 0, 0, 0, 1, 1, 0, 0, 0, 0, 1, 0, 1, 0]",163,91,72,14,7,0.15384615384615385,0.09722222222222222
"[0, 0, 1, 1, 0, 0, 0, 1, 1, 0, 0, 0, 0, 1, 0]",273,179,94,9,13,0.05027932960893855,0.13829787234042554
"[0, 0, 0, 1, 0, 1, 1, 1, 1, 1, 0, 1, 1, 0, 0]",127,66,61,5,6,0.07575757575757576,0.09836065573770492
"[0, 0, 0, 0, 1, 0, 1, 1, 1, 1, 1, 0, 1, 1, 0]",133,69,64,8,10,0.11594202898550725,0.15625
"[0, 0, 0, 0, 0, 1, 0, 1, 1, 1, 1, 1, 0, 1, 1]",149,80,69,6,7,0.075,0.10144927536231885
"[0, 0, 0, 0, 1, 1, 0, 1, 0, 1, 1, 1, 0, 0, 0]",200,121,79,11,14,0.09090909090909091,0.17721518987341772
"[1, 0, 0, 1, 0, 1, 1, 1, 0, 0, 0, 0, 0, 1, 1]",181,100,81,12,5,0.12,0.06172839506172839
"[0, 1, 0, 1, 1, 1, 0, 0, 1, 0, 1, 1, 1, 1, 0]",161,68,93,9,9,0.1323529411764706,0.0967741935483871
"[0, 0, 1, 0, 1, 1, 0, 0, 1, 0, 1, 1, 1, 0, 0]",122,70,52,8,8,0.11428571428571428,0.15384615384615385
"[0, 0, 1, 1, 0, 1, 0, 1, 0, 1, 0, 0, 0, 1, 1]",130,78,52,4,8,0.05128205128205128,0.15384615384615385
"[1, 0, 1, 0, 1, 0, 0, 1, 1, 0, 0, 0, 0, 1, 1]",314,153,161,13,20,0.08496732026143791,0.12422360248447205
"[0, 0, 0, 0, 1, 0, 0, 1, 1, 0, 1, 0, 1, 0, 1]",133,74,59,7,7,0.0945945945945946,0.11864406779661017
"[0, 1, 0, 0, 1, 1, 1, 0, 0, 0, 0, 0, 1, 1, 0]",174,117,57,13,6,0.1111111111111111,0.10526315789473684
"[1, 0, 1, 0, 0, 1, 0, 0, 1, 1, 1, 0, 0, 0, 0]",184,108,76,13,4,0.12037037037037036,0.05263157894736842
"[0, 0, 1, 1, 0, 1, 0, 0, 0, 0, 1, 0, 0, 0, 1]",256,153,103,15,5,0.09803921568627451,0.04854368932038835
"[1, 0, 0, 1, 0, 0, 0, 0, 1, 0, 0, 1, 1, 0, 1]",136,77,59,9,5,0.11688311688311688,0.0847457627118644
"[1, 0, 0, 1, 1, 0, 0, 0, 1, 1, 0, 1, 1, 1, 1]",280,86,194,9,15,0.10465116279069768,0.07731958762886598
"[1, 1, 1, 1, 0, 0, 1, 0, 1, 0, 0, 1, 0, 1, 0]",115,44,71,4,7,0.09090909090909091,0.09859154929577464
"[0, 1, 0, 0, 0, 0, 0, 1, 1, 1, 1, 0, 1, 1, 1]",179,82,97,7,9,0.08536585365853659,0.09278350515463918
"[1, 0, 0, 0, 1, 1, 0, 0, 1, 0, 0, 0, 1, 1, 0]",155,79,76,8,8,0.10126582278481013,0.10526315789473684
"[1, 0, 0, 1, 0, 0, 0, 1, 1, 0, 0, 1, 1, 1, 1]",280,129,151,13,11,0.10077519379844961,0.0728476821192053
"[0, 0, 0, 0, 0, 0, 1, 0, 1, 1, 1, 0, 0, 0, 1]",300,211,89,25,7,0.11848341232227488,0.07865168539325842
"[0, 0, 0, 1, 0, 0, 1, 1, 0, 0, 0, 1, 0, 1, 0]",252,174,78,22,12,0.12643678160919541,0.15384615384615385
"[1, 1, 1, 0, 0, 1, 0, 0, 0, 0, 0, 1, 0, 1, 1]",128,67,61,11,6,0.16417910447761194,0.09836065573770492
"[1, 0, 0, 1, 0, 0, 1, 0, 0, 1, 1, 0, 0, 1, 0]",143,74,69,11,3,0.14864864864864866,0.043478260869565216
"[0, 0, 1, 1, 1, 0, 1, 1, 0, 0, 1, 0, 0, 1, 0]",114,62,52,9,3,0.14516129032258066,0.057692307692307696
"[0, 1, 1, 1, 1, 1, 1, 1, 1, 1, 1, 0, 0, 1, 0]",870,414,456,27,44,0.06521739130434782,0.09649122807017543
"[1, 1, 1, 1, 0, 1, 1, 0, 0, 1, 0, 1, 0, 0, 1]",149,61,88,2,13,0.03278688524590164,0.14772727272727273
"[1, 1, 0, 0, 1, 0, 1, 0, 1, 1, 0, 1, 1, 1, 0]",153,60,93,4,11,0.06666666666666667,0.11827956989247312
"[1, 0, 1, 0, 0, 0, 1, 1, 1, 1, 1, 1, 0, 0, 1]",333,146,187,9,22,0.06164383561643835,0.11764705882352941
"[1, 1, 0, 1, 1, 1, 0, 1, 1, 0, 1, 0, 0, 0, 1]",125,43,82,3,11,0.06976744186046512,0.13414634146341464
"[1, 0, 0, 1, 1, 0, 1, 0, 1, 0, 1, 1, 0, 0, 1]",132,55,77,3,12,0.05454545454545454,0.15584415584415584
"[0, 0, 1, 0, 1, 1, 0, 0, 1, 0, 0, 0, 1, 1, 1]",194,119,75,8,6,0.06722689075630252,0.08
"[1, 0, 0, 0, 1, 0, 0, 0, 1, 1, 0, 1, 1, 0, 0]",166,94,72,9,3,0.09574468085106383,0.041666666666666664
"[1, 1, 0, 1, 0, 1, 0, 0, 1, 1, 1, 0, 1, 1, 1]",265,100,165,8,16,0.08,0.09696969696969697
"[0, 0, 0, 1, 1, 0, 1, 0, 1, 0, 0, 1, 1, 1, 0]",134,74,60,9,3,0.12162162162162163,0.05
"[1, 1, 0, 0, 0, 1, 0, 1, 1, 1, 0, 0, 1, 1, 1]",225,90,135,6,8,0.06666666666666667,0.05925925925925926
"[0, 1, 1, 0, 0, 0, 1, 1, 1, 1, 1, 0, 1, 0, 0]",126,64,62,5,6,0.078125,0.0967741935483871
"[1, 0, 0, 0, 1, 1, 0, 0, 0, 0, 1, 0, 1, 1, 0]",174,97,77,9,6,0.09278350515463918,0.07792207792207792
"[1, 1, 1, 0, 0, 0, 1, 1, 0, 0, 0, 0, 1, 0, 1]",140,57,83,4,9,0.07017543859649122,0.10843373493975904
"[0, 1, 1, 1, 0, 0, 1, 1, 0, 0, 0, 1, 1, 1, 1]",261,126,135,11,5,0.0873015873015873,0.037037037037037035
"[1, 1, 1, 0, 0, 1, 0, 0, 1, 1, 0, 0, 0, 1, 1]",145,62,83,2,6,0.03225806451612903,0.07228915662650602
"[1, 0, 0, 1, 0, 1, 1, 0, 1, 1, 0, 0, 1, 1, 1]",213,76,137,7,12,0.09210526315789473,0.08759124087591241
"[0, 1, 0, 0, 1, 0, 1, 1, 1, 1, 0, 0, 1, 1, 1]",269,104,165,18,20,0.17307692307692307,0.12121212121212122
"[1, 0, 1, 1, 0, 1, 1, 0, 0, 1, 1, 0, 1, 1, 0]",141,48,93,4,9,0.08333333333333333,0.0967741935483871
"[1, 1, 0, 0, 1, 0, 1, 1, 0, 1, 1, 0, 1, 1, 0]",141,60,81,5,6,0.08333333333333333,0.07407407407407407
"[0, 1, 0, 0, 0, 0, 0, 0, 1, 0, 0, 0, 0, 1, 1]",813,583,230,50,19,0.08576329331046312,0.08260869565217391
"[0, 0, 1, 0, 0, 0, 0, 0, 0, 1, 0, 0, 0, 0, 1]",1605,1202,403,117,36,0.0973377703826955,0.08933002481389578
"[0, 0, 1, 0, 1, 0, 1, 0, 1, 1, 1, 0, 0, 1, 1]",146,71,75,10,3,0.14084507042253522,0.04
"[1, 1, 1, 0, 0, 1, 1, 1, 0, 0, 0, 1, 1, 0, 1]",163,60,103,2,14,0.03333333333333333,0.13592233009708737
"[0, 0, 1, 1, 0, 1, 1, 0, 1, 1, 0, 1, 0, 0, 1]",113,48,65,2,2,0.041666666666666664,0.03076923076923077
"[0, 1, 1, 1, 0, 0, 1, 1, 0, 1, 1, 0, 1, 1, 0]",153,61,92,5,10,0.08196721311475409,0.10869565217391304
"[1, 0, 0, 1, 1, 1, 1, 0, 1, 1, 1, 1, 1, 0, 1]",605,169,436,14,39,0.08284023668639054,0.08944954128440367
"[0, 1, 0, 1, 1, 1, 0, 0, 1, 0, 0, 0, 0, 0, 1]",190,109,81,14,14,0.12844036697247707,0.1728395061728395
"[0, 1, 1, 0, 1, 1, 1, 0, 1, 1, 1, 0, 1, 1, 0]",237,92,145,6,11,0.06521739130434782,0.07586206896551724
"[0, 1, 0, 1, 0, 1, 1, 0, 0, 1, 1, 0, 0, 0, 1]",148,73,75,2,6,0.0273972602739726,0.08
"[1, 0, 0, 1, 1, 0, 1, 0, 0, 1, 0, 0, 1, 1, 1]",177,68,109,5,2,0.07352941176470588,0.01834862385321101
"[0, 1, 0, 0, 0, 0, 0, 1, 1, 1, 1, 1, 1, 0, 1]",142,67,75,9,6,0.13432835820895522,0.08
"[1, 1, 1, 1, 0, 0, 1, 1, 0, 0, 1, 0, 0, 1, 1]",332,142,190,14,17,0.09859154929577464,0.08947368421052632
"[1, 1, 0, 0, 0, 1, 1, 1, 1, 0, 1, 0, 0, 0, 0]",166,85,81,6,13,0.07058823529411765,0.16049382716049382
"[1, 1, 0, 0, 0, 0, 0, 1, 0, 0, 0, 1, 0, 0, 1]",266,165,101,16,13,0.09696969696969697,0.12871287128712872
"[0, 0, 1, 0, 1, 1, 0, 0, 1, 1, 0, 0, 0, 0, 1]",312,175,137,16,13,0.09142857142857143,0.0948905109489051
"[1, 0, 1, 0, 0, 0, 1, 1, 0, 1, 0, 1, 0, 0, 0]",150,85,65,6,6,0.07058823529411765,0.09230769230769231
"[0, 0, 1, 0, 1, 0, 0, 0, 1, 1, 0, 1, 0, 1, 0]",147,88,59,9,6,0.10227272727272728,0.1016949152542373
"[1, 1, 1, 0, 0, 0, 0, 0, 1, 1, 1, 1, 1, 0, 0]",214,93,121,9,6,0.0967741935483871,0.049586776859504134
"[0, 0, 1, 1, 0, 1, 1, 1, 1, 1, 1, 1, 0, 0, 0]",262,114,148,11,19,0.09649122807017543,0.12837837837837837
"[0, 1, 1, 1, 0, 1, 0, 1, 0, 1, 1, 0, 1, 1, 1]",257,101,156,13,13,0.12871287128712872,0.08333333333333333
"[1, 0, 1, 0, 1, 0, 1, 0, 0, 0, 1, 1, 1, 1, 1]",193,81,112,7,10,0.08641975308641975,0.08928571428571429
"[1, 0, 1, 1, 1, 0, 0, 0, 1, 0, 1, 0, 0, 0, 0]",157,93,64,7,3,0.07526881720430108,0.046875
"[0, 0, 1, 0, 1, 1, 1, 1, 0, 1, 0, 0, 0, 1, 1]",147,65,82,5,10,0.07692307692307693,0.12195121951219512
"[0, 1, 0, 0, 0, 0, 1, 0, 1, 1, 1, 1, 0, 1, 0]",102,53,49,2,6,0.03773584905660377,0.12244897959183673
"[1, 0, 0, 1, 1, 0, 1, 1, 0, 0, 1, 1, 0, 0, 1]",201,76,125,7,12,0.09210526315789473,0.096
"[0, 1, 1, 0, 0, 0, 1, 0, 1, 1, 1, 0, 1, 1, 1]",166,88,78,5,6,0.056818181818181816,0.07692307692307693
"[1, 0, 1, 1, 0, 0, 0, 1, 0, 1, 1, 1, 0, 1, 1]",127,46,81,6,8,0.13043478260869565,0.09876543209876543
"[1, 1, 1, 0, 0, 1, 0, 1, 1, 0, 0, 0, 1, 0, 1]",102,39,63,2,4,0.05128205128205128,0.06349206349206349
"[1, 0, 1, 0, 1, 1, 0, 0, 1, 0, 0, 0, 0, 1, 1]",141,75,66,13,4,0.17333333333333334,0.06060606060606061
"[0, 0, 1, 0, 1, 1, 1, 0, 1, 0, 1, 0, 1, 1, 0]",94,50,44,3,9,0.06,0.20454545454545456
"[0, 1, 1, 0, 1, 0, 1, 1, 1, 1, 1, 1, 0, 0, 0]",255,93,162,12,16,0.12903225806451613,0.09876543209876543
"[1, 1, 1, 0, 0, 1, 1, 1, 1, 0, 1, 0, 1, 0, 1]",313,89,224,13,20,0.14606741573033707,0.08928571428571429
"[0, 0, 0, 1, 0, 1, 0, 1, 0, 0, 0, 0, 0, 1, 0]",464,322,142,24,13,0.07453416149068323,0.09154929577464789
"[1, 1, 0, 0, 0, 0, 0, 0, 0, 1, 0, 1, 0, 0, 1]",333,215,118,16,10,0.07441860465116279,0.0847457627118644
"[1, 1, 0, 0, 1, 0, 1, 0, 0, 0, 1, 1, 0, 0, 0]",222,115,107,13,14,0.11304347826086956,0.1308411214953271
"[1, 1, 0, 0, 1, 0, 0, 1, 0, 0, 0, 1, 1, 0, 0]",175,103,72,13,6,0.1262135922330097,0.08333333333333333
"[0, 1, 1, 0, 0, 1, 0, 0, 1, 0, 0, 0, 1, 1, 0]",147,82,65,9,2,0.10975609756097561,0.03076923076923077
"[1, 0, 0, 1, 1, 1, 0, 0, 1, 1, 0, 1, 1, 0, 1]",141,55,86,7,10,0.12727272727272726,0.11627906976744186
"[0, 0, 0, 1, 1, 1, 0, 0, 0, 1, 1, 0, 1, 1, 0]",139,70,69,7,5,0.1,0.07246376811594203
"[1, 0, 1, 1, 1, 0, 1, 0, 1, 0, 0, 0, 0, 0, 0]",199,105,94,10,6,0.09523809523809523,0.06382978723404255
"[1, 1, 0, 1, 1, 0, 1, 1, 1, 0, 1, 0, 1, 0, 0]",156,62,94,3,8,0.04838709677419355,0.0851063829787234
"[0, 0, 1, 0, 1, 1, 0, 0, 1, 0, 1, 1, 0, 0, 1]",111,61,50,0,3,0.0,0.06
"[1, 1, 1, 1, 0, 0, 1, 0, 1, 1, 0, 0, 1, 1, 1]",412,144,268,14,25,0.09722222222222222,0.09328358208955224
"[0, 1, 0, 1, 0, 0, 0, 1, 1, 0, 1, 0, 0, 1, 0]",127,77,50,7,8,0.09090909090909091,0.16
"[0, 1, 1, 1, 1, 1, 0, 1, 0, 1, 0, 1, 0, 0, 1]",149,60,89,8,8,0.13333333333333333,0.0898876404494382
"[0, 1, 0, 1, 0, 0, 0, 1, 0, 1, 0, 1, 1, 1, 1]",150,81,69,9,4,0.1111111111111111,0.057971014492753624
"[0, 1, 1, 1, 0, 1, 1, 1, 1, 1, 0, 0, 0, 1, 1]",281,112,169,12,12,0.10714285714285714,0.07100591715976332
"[0, 0, 0, 0, 1, 0, 1, 0, 1, 0, 1, 1, 1, 1, 0]",127,63,64,6,9,0.09523809523809523,0.140625
"[0, 1, 1, 1, 1, 1, 0, 1, 1, 1, 1, 0, 1, 0, 0]",239,93,146,7,10,0.07526881720430108,0.0684931506849315
"[1, 0, 0, 1, 0, 0, 1, 1, 0, 1, 1, 0, 1, 0, 1]",105,52,53,1,3,0.019230769230769232,0.05660377358490566
"[1, 0, 0, 1, 0, 1, 0, 0, 1, 1, 1, 1, 1, 0, 1]",160,63,97,6,7,0.09523809523809523,0.07216494845360824
"[1, 1, 0, 1, 1, 0, 0, 1, 0, 1, 0, 0, 1, 0, 1]",106,49,57,2,3,0.04081632653061224,0.05263157894736842
"[0, 0, 1, 0, 0, 0, 1, 1, 0, 1, 1, 0, 0, 1, 0]",159,95,64,8,4,0.08421052631578947,0.0625
"[1, 0, 0, 1, 1, 0, 0, 1, 0, 0, 0, 1, 1, 0, 1]",124,51,73,3,10,0.058823529411764705,0.136986301369863
"[1, 1, 1, 0, 1, 0, 1, 0, 0, 0, 0, 1, 0, 0, 1]",105,56,49,7,3,0.125,0.061224489795918366
"[1, 1, 1, 0, 0, 1, 0, 0, 1, 0, 0, 0, 1, 1, 0]",125,74,51,1,6,0.013513513513513514,0.11764705882352941
"[0, 1, 1, 0, 1, 0, 1, 1, 1, 1, 0, 1, 0, 0, 0]",112,53,59,3,3,0.05660377358490566,0.05084745762711865
"[0, 1, 0, 1, 1, 0, 1, 0, 1, 1, 1, 1, 0, 1, 0]",143,61,82,10,13,0.16393442622950818,0.15853658536585366
"[0, 0, 0, 0, 1, 0, 0, 1, 0, 1, 0, 0, 0, 1, 0]",484,333,151,28,13,0.08408408408408409,0.08609271523178808
"[1, 1, 0, 0, 0, 0, 0, 0, 0, 0, 1, 0, 0, 1, 0]",769,555,214,59,13,0.1063063063063063,0.06074766355140187
"[1, 0, 1, 1, 0, 0, 1, 1, 1, 0, 1, 1, 0, 1, 1]",233,79,154,10,14,0.12658227848101267,0.09090909090909091
"[0, 0, 0, 0, 0, 0, 0, 1, 1, 0, 1, 0, 1, 1, 1]",495,378,117,37,13,0.09788359788359788,0.1111111111111111
"[0, 1, 1, 1, 1, 1, 1, 0, 0, 1, 1, 0, 1, 0, 0]",221,142,79,16,8,0.11267605633802817,0.10126582278481013
"[1, 1, 0, 1, 1, 1, 1, 0, 1, 0, 0, 1, 1, 0, 0]",220,81,139,7,12,0.08641975308641975,0.08633093525179857
"[1, 1, 1, 0, 0, 0, 1, 0, 0, 0, 0, 1, 0, 0, 0]",247,150,97,20,10,0.13333333333333333,0.10309278350515463
"[1, 0, 1, 1, 1, 0, 0, 0, 1, 0, 0, 0, 0, 1, 0]",124,75,49,6,1,0.08,0.02040816326530612
"[0, 0, 1, 0, 1, 1, 1, 0, 0, 0, 1, 0, 0, 0, 0]",259,171,88,22,12,0.1286549707602339,0.13636363636363635
"[0, 0, 0, 1, 0, 0, 1, 1, 0, 0, 1, 0, 0, 0, 1]",256,182,74,19,8,0.1043956043956044,0.10810810810810811
"[0, 1, 0, 0, 0, 0, 1, 0, 0, 1, 1, 0, 0, 1, 0]",243,162,81,14,8,0.08641975308641975,0.09876543209876543
"[1, 1, 0, 0, 0, 0, 0, 1, 0, 1, 0, 0, 0, 0, 1]",327,207,120,21,12,0.10144927536231885,0.1
"[1, 0, 0, 1, 1, 0, 0, 1, 1, 0, 1, 0, 0, 0, 1]",164,63,101,8,10,0.12698412698412698,0.09900990099009901
"[0, 0, 1, 1, 0, 0, 1, 0, 0, 0, 0, 1, 0, 1, 0]",273,182,91,25,8,0.13736263736263737,0.08791208791208792
"[0, 0, 0, 1, 1, 0, 0, 1, 0, 0, 0, 0, 1, 0, 1]",292,201,91,21,10,0.1044776119402985,0.10989010989010989
"[1, 1, 1, 1, 0, 0, 1, 0, 1, 1, 0, 1, 0, 1, 1]",270,103,167,9,18,0.08737864077669903,0.10778443113772455
"[1, 1, 0, 1, 1, 1, 1, 0, 0, 1, 0, 1, 1, 0, 1]",214,78,136,9,15,0.11538461538461539,0.11029411764705882
"[1, 1, 0, 0, 0, 1, 1, 0, 1, 0, 1, 1, 0, 0, 1]",128,61,67,6,7,0.09836065573770492,0.1044776119402985
"[1, 0, 1, 0, 0, 1, 1, 0, 1, 0, 0, 1, 1, 1, 1]",205,82,123,3,16,0.036585365853658534,0.13008130081300814
"[1, 1, 0, 1, 0, 0, 1, 1, 0, 1, 0, 0, 1, 1, 1]",189,83,106,9,11,0.10843373493975904,0.10377358490566038
"[1, 0, 1, 1, 0, 0, 1, 0, 1, 1, 1, 1, 0, 1, 0]",124,57,67,8,3,0.14035087719298245,0.04477611940298507
"[0, 0, 0, 1, 0, 1, 0, 0, 1, 0, 0, 1, 1, 1, 1]",191,111,80,10,7,0.09009009009009009,0.0875
"[0, 1, 1, 1, 0, 1, 0, 0, 0, 1, 0, 0, 0, 1, 0]",146,93,53,6,8,0.06451612903225806,0.1509433962264151
"[1, 0, 1, 0, 1, 1, 1, 0, 0, 0, 0, 0, 1, 0, 0]",142,87,55,11,5,0.12643678160919541,0.09090909090909091
"[0, 1, 1, 0, 1, 0, 1, 1, 1, 0, 0, 0, 0, 0, 1]",112,59,53,7,6,0.11864406779661017,0.11320754716981132
"[0, 0, 0, 1, 1, 0, 1, 0, 1, 1, 1, 0, 0, 0, 0]",208,126,82,8,1,0.06349206349206349,0.012195121951219513
"[1, 0, 0, 0, 0, 1, 0, 0, 1, 0, 1, 1, 0, 0, 0]",224,146,78,6,7,0.0410958904109589,0.08974358974358974
"[0, 0, 0, 0, 1, 1, 0, 0, 1, 1, 1, 0, 1, 1, 1]",446,221,225,22,16,0.09954751131221719,0.07111111111111111
"[0, 0, 1, 1, 0, 1, 0, 0, 1, 0, 1, 1, 1, 0, 1]",104,54,50,7,3,0.12962962962962962,0.06
"[1, 0, 1, 0, 0, 0, 1, 1, 0, 0, 1, 1, 1, 0, 0]",134,73,61,8,3,0.1095890410958904,0.04918032786885246
"[0, 0, 1, 0, 1, 0, 0, 0, 1, 1, 0, 0, 1, 1, 1]",262,151,111,14,13,0.09271523178807947,0.11711711711711711
"[1, 0, 0, 1, 0, 0, 0, 0, 1, 0, 0, 1, 1, 1, 1]",190,107,83,11,8,0.102803738317757,0.0963855421686747
"[0, 0, 1, 1, 1, 0, 1, 1, 0, 1, 1, 1, 0, 0, 0]",159,89,70,7,1,0.07865168539325842,0.014285714285714285
"[0, 1, 1, 1, 0, 1, 0, 1, 0, 0, 0, 0, 1, 1, 1]",215,112,103,7,10,0.0625,0.0970873786407767
"[0, 1, 0, 0, 0, 0, 1, 0, 1, 0, 1, 0, 1, 1, 1]",142,90,52,7,6,0.07777777777777778,0.11538461538461539
"[0, 1, 0, 1, 0, 0, 0, 1, 1, 1, 0, 0, 1, 0, 1]",113,57,56,8,5,0.14035087719298245,0.08928571428571429
"[0, 1, 1, 1, 1, 0, 1, 0, 1, 1, 1, 1, 0, 1, 1]",571,186,385,20,42,0.10752688172043011,0.10909090909090909
"[1, 0, 0, 0, 0, 1, 1, 1, 1, 0, 0, 1, 1, 1, 0]",376,97,279,7,35,0.07216494845360824,0.12544802867383512
"[0, 1, 0, 1, 1, 1, 1, 1, 0, 0, 0, 0, 1, 1, 1]",385,168,217,19,24,0.1130952380952381,0.11059907834101383
"[0, 0, 1, 0, 0, 1, 0, 1, 1, 1, 1, 1, 0, 0, 0]",176,98,78,12,10,0.12244897959183673,0.1282051282051282
"[1, 1, 0, 0, 1, 0, 1, 0, 0, 0, 0, 1, 0, 1, 0]",136,87,49,9,3,0.10344827586206896,0.061224489795918366
"[0, 1, 0, 1, 0, 1, 1, 0, 1, 1, 1, 0, 1, 0, 1]",118,43,75,3,9,0.06976744186046512,0.12
"[0, 1, 1, 1, 0, 1, 1, 0, 0, 0, 0, 1, 1, 0, 0]",278,143,135,15,18,0.1048951048951049,0.13333333333333333
"[1, 1, 0, 0, 1, 1, 0, 0, 1, 0, 0, 1, 0, 1, 1]",160,79,81,10,5,0.12658227848101267,0.06172839506172839
"[0, 0, 1, 0, 0, 0, 0, 1, 1, 1, 1, 0, 1, 0, 0]",186,111,75,9,9,0.08108108108108109,0.12
"[0, 0, 0, 1, 0, 0, 1, 1, 0, 1, 1, 0, 0, 1, 0]",134,82,52,3,3,0.036585365853658534,0.057692307692307696
"[0, 1, 1, 0, 1, 0, 0, 1, 1, 0, 1, 0, 1, 1, 0]",110,47,63,7,6,0.14893617021276595,0.09523809523809523
"[0, 1, 0, 1, 0, 1, 1, 0, 0, 1, 0, 1, 1, 1, 1]",158,65,93,6,8,0.09230769230769231,0.08602150537634409
"[1, 1, 1, 0, 0, 0, 1, 1, 1, 0, 0, 0, 0, 0, 1]",168,83,85,12,9,0.14457831325301204,0.10588235294117647
"[1, 0, 0, 0, 0, 1, 1, 0, 1, 0, 1, 0, 0, 1, 0]",160,77,83,8,8,0.1038961038961039,0.0963855421686747
"[0, 1, 1, 1, 0, 0, 1, 0, 0, 0, 0, 1, 1, 0, 1]",114,60,54,3,7,0.05,0.12962962962962962
"[0, 0, 0, 1, 1, 1, 0, 0, 1, 0, 0, 0, 0, 1, 1]",251,161,90,6,11,0.037267080745341616,0.12222222222222222
"[1, 0, 1, 1, 0, 0, 0, 1, 1, 1, 0, 0, 1, 0, 0]",110,65,45,4,3,0.06153846153846154,0.06666666666666667
"[1, 0, 1, 0, 1, 1, 0, 0, 0, 0, 0, 1, 0, 1, 0]",152,90,62,13,4,0.14444444444444443,0.06451612903225806
"[1, 1, 1, 1, 0, 1, 0, 0, 1, 0, 0, 0, 0, 1, 0]",126,69,57,5,1,0.07246376811594203,0.017543859649122806
"[0, 1, 0, 1, 0, 0, 1, 0, 1, 1, 1, 0, 1, 0, 1]",90,51,39,8,8,0.1568627450980392,0.20512820512820512
"[0, 1, 0, 0, 0, 0, 0, 1, 1, 0, 0, 1, 0, 1, 0]",252,157,95,16,11,0.10191082802547771,0.11578947368421053
"[0, 0, 0, 0, 1, 1, 0, 0, 1, 0, 1, 1, 0, 0, 1]",222,139,83,15,7,0.1079136690647482,0.08433734939759036
"[1, 0, 0, 0, 0, 1, 0, 0, 1, 1, 1, 1, 0, 1, 0]",114,52,62,7,7,0.1346153846153846,0.11290322580645161
"[0, 1, 0, 1, 1, 0, 0, 0, 0, 1, 1, 1, 0, 0, 0]",177,111,66,14,7,0.12612612612612611,0.10606060606060606
"[0, 0, 1, 1, 1, 1, 1, 1, 0, 0, 1, 0, 0, 0, 1]",249,117,132,12,9,0.10256410256410256,0.06818181818181818
"[0, 1, 1, 0, 0, 0, 0, 1, 0, 1, 1, 0, 0, 0, 1]",167,113,54,18,6,0.1592920353982301,0.1111111111111111
"[0, 0, 1, 1, 1, 0, 0, 0, 1, 0, 1, 0, 1, 1, 1]",159,78,81,3,10,0.038461538461538464,0.12345679012345678
"[1, 1, 1, 0, 0, 0, 1, 0, 1, 1, 0, 0, 1, 1, 0]",151,67,84,4,8,0.05970149253731343,0.09523809523809523
"[1, 1, 0, 0, 1, 1, 0, 1, 0, 1, 0, 0, 1, 0, 0]",117,66,51,7,3,0.10606060606060606,0.058823529411764705
"[1, 0, 1, 0, 0, 1, 0, 0, 1, 1, 1, 0, 0, 1, 1]",146,70,76,6,11,0.08571428571428572,0.14473684210526316
"[0, 0, 1, 0, 1, 0, 0, 1, 0, 0, 1, 1, 1, 0, 0]",162,101,61,14,3,0.13861386138613863,0.04918032786885246
"[1, 0, 1, 0, 1, 1, 1, 0, 1, 1, 1, 1, 0, 0, 0]",197,87,110,8,16,0.09195402298850575,0.14545454545454545
"[1, 0, 0, 1, 0, 0, 0, 1, 0, 1, 1, 0, 0, 1, 0]",135,78,57,10,3,0.1282051282051282,0.05263157894736842
"[1, 1, 0, 0, 1, 0, 0, 0, 1, 0, 1, 1, 0, 0, 1]",142,79,63,10,2,0.12658227848101267,0.031746031746031744
"[1, 0, 1, 1, 1, 1, 0, 0, 1, 0, 0, 0, 1, 0, 1]",105,44,61,1,5,0.022727272727272728,0.08196721311475409
"[1, 0, 0, 1, 0, 0, 0, 1, 1, 0, 1, 0, 0, 1, 0]",128,65,63,2,4,0.03076923076923077,0.06349206349206349
"[1, 1, 0, 0, 1, 0, 0, 0, 1, 1, 0, 1, 0, 0, 1]",116,70,46,9,3,0.12857142857142856,0.06521739130434782
"[0, 0, 0, 0, 0, 0, 1, 0, 1, 1, 0, 0, 1, 1, 0]",407,294,113,36,10,0.12244897959183673,0.08849557522123894
"[0, 1, 1, 0, 1, 1, 0, 0, 0, 0, 1, 1, 0, 1, 0]",121,62,59,4,7,0.06451612903225806,0.11864406779661017
"[1, 1, 1, 1, 0, 1, 0, 1, 0, 1, 1, 1, 0, 0, 1]",282,85,197,11,11,0.12941176470588237,0.05583756345177665
"[1, 1, 0, 1, 1, 0, 0, 1, 1, 1, 0, 1, 0, 1, 0]",136,69,67,2,8,0.028985507246376812,0.11940298507462686
"[0, 0, 1, 0, 0, 1, 1, 1, 0, 1, 1, 1, 0, 1, 1]",168,61,107,2,6,0.03278688524590164,0.056074766355140186
"[1, 1, 1, 0, 1, 0, 1, 1, 1, 1, 0, 1, 0, 0, 0]",186,79,107,9,11,0.11392405063291139,0.102803738317757
"[0, 0, 0, 1, 1, 1, 0, 0, 1, 1, 1, 0, 1, 0, 1]",127,64,63,6,2,0.09375,0.031746031746031744
"[0, 0, 0, 0, 1, 1, 1, 0, 0, 1, 1, 1, 0, 1, 0]",129,73,56,9,6,0.1232876712328767,0.10714285714285714
"[1, 1, 1, 1, 0, 0, 0, 0, 1, 1, 1, 0, 0, 1, 1]",385,156,229,15,19,0.09615384615384616,0.08296943231441048
"[1, 1, 1, 1, 1, 1, 0, 0, 0, 1, 1, 1, 0, 1, 1]",762,217,545,20,49,0.09216589861751152,0.08990825688073395
"[0, 1, 1, 1, 1, 0, 0, 0, 1, 0, 0, 0, 1, 1, 1]",207,130,77,12,10,0.09230769230769231,0.12987012987012986
"[1, 0, 1, 1, 0, 0, 1, 1, 0, 0, 0, 1, 0, 1, 0]",101,59,42,8,1,0.13559322033898305,0.023809523809523808
"[0, 1, 1, 1, 0, 1, 0, 1, 1, 0, 0, 0, 1, 0, 1]",97,44,53,6,8,0.13636363636363635,0.1509433962264151
"[1, 0, 0, 0, 1, 1, 1, 1, 1, 0, 0, 1, 1, 0, 0]",273,129,144,14,15,0.10852713178294573,0.10416666666666667
"[1, 1, 0, 0, 0, 0, 0, 1, 0, 0, 0, 0, 0, 1, 0]",530,374,156,37,16,0.09893048128342247,0.10256410256410256
"[0, 1, 0, 1, 1, 1, 0, 0, 1, 1, 0, 0, 1, 0, 0]",122,63,59,6,3,0.09523809523809523,0.05084745762711865
"[1, 1, 1, 0, 1, 0, 1, 1, 1, 0, 0, 1, 1, 0, 0]",301,103,198,8,16,0.07766990291262135,0.08080808080808081
"[1, 1, 0, 0, 1, 0, 1, 1, 0, 0, 1, 1, 0, 0, 0]",222,107,115,12,12,0.11214953271028037,0.10434782608695652
"[1, 0, 0, 1, 1, 0, 1, 0, 0, 0, 0, 0, 0, 0, 0]",789,493,296,44,23,0.08924949290060852,0.0777027027027027
"[0, 0, 1, 0, 1, 0, 1, 0, 1, 0, 1, 0, 1, 0, 1]",107,54,53,7,2,0.12962962962962962,0.03773584905660377
"[1, 1, 0, 1, 0, 0, 1, 0, 0, 0, 1, 0, 1, 0, 1]",99,60,39,6,4,0.1,0.10256410256410256
"[0, 0, 0, 1, 0, 0, 0, 1, 0, 1, 1, 1, 1, 1, 1]",197,100,97,9,7,0.09,0.07216494845360824
"[1, 0, 1, 1, 1, 1, 1, 0, 0, 0, 1, 1, 0, 0, 1]",209,93,116,5,9,0.053763440860215055,0.07758620689655173
"[0, 1, 0, 1, 0, 1, 1, 0, 1, 0, 0, 1, 1, 1, 1]",185,85,100,4,7,0.047058823529411764,0.07
"[0, 0, 1, 0, 0, 0, 1, 1, 1, 0, 0, 0, 1, 0, 1]",145,93,52,6,9,0.06451612903225806,0.17307692307692307
"[1, 1, 1, 0, 1, 0, 1, 0, 0, 0, 0, 0, 1, 0, 0]",143,81,62,9,4,0.1111111111111111,0.06451612903225806
"[1, 1, 1, 0, 1, 1, 0, 0, 1, 0, 1, 0, 1, 1, 1]",285,88,197,7,22,0.07954545454545454,0.1116751269035533
"[1, 0, 0, 1, 0, 0, 1, 1, 0, 1, 1, 0, 0, 1, 0]",102,55,47,6,3,0.10909090909090909,0.06382978723404255
"[0, 0, 0, 0, 0, 0, 0, 1, 1, 1, 1, 1, 0, 1, 1]",344,241,103,24,9,0.0995850622406639,0.08737864077669903
"[1, 0, 1, 1, 0, 0, 1, 0, 1, 0, 1, 0, 1, 0, 1]",104,44,60,3,4,0.06818181818181818,0.06666666666666667
"[0, 1, 0, 1, 1, 1, 0, 0, 1, 0, 1, 1, 1, 0, 1]",151,57,94,6,6,0.10526315789473684,0.06382978723404255
"[1, 0, 1, 1, 0, 0, 1, 1, 1, 0, 0, 1, 1, 1, 0]",167,72,95,13,9,0.18055555555555555,0.09473684210526316
"[1, 0, 0, 0, 0, 0, 0, 1, 1, 0, 1, 1, 0, 1, 1]",214,75,139,6,13,0.08,0.09352517985611511
"[1, 1, 0, 0, 1, 1, 0, 1, 1, 0, 1, 1, 0, 0, 0]",172,85,87,11,4,0.12941176470588237,0.04597701149425287
"[0, 0, 1, 1, 0, 0, 1, 1, 0, 0, 1, 1, 0, 1, 1]",443,227,216,13,14,0.05726872246696035,0.06481481481481481
"[0, 1, 1, 1, 0, 0, 0, 0, 1, 1, 1, 1, 0, 0, 1]",458,221,237,27,26,0.12217194570135746,0.10970464135021098
"[1, 0, 1, 0, 1, 1, 1, 1, 1, 1, 0, 0, 0, 0, 1]",337,123,214,8,18,0.06504065040650407,0.08411214953271028
"[1, 0, 0, 0, 1, 1, 1, 1, 1, 0, 1, 1, 1, 0, 1]",241,84,157,4,14,0.047619047619047616,0.08917197452229299
"[1, 1, 1, 1, 1, 0, 0, 1, 1, 1, 0, 0, 0, 0, 0]",254,90,164,12,9,0.13333333333333333,0.054878048780487805
"[1, 0, 0, 0, 1, 1, 1, 0, 1, 1, 0, 1, 1, 1, 0]",150,72,78,7,6,0.09722222222222222,0.07692307692307693
"[0, 0, 0, 1, 0, 1, 0, 0, 0, 1, 0, 1, 1, 1, 0]",149,71,78,3,5,0.04225352112676056,0.0641025641025641
"[1, 0, 1, 1, 1, 0, 1, 0, 0, 1, 0, 1, 1, 0, 0]",124,65,59,6,2,0.09230769230769231,0.03389830508474576
"[1, 1, 1, 0, 1, 1, 1, 0, 0, 1, 1, 0, 1, 0, 0]",142,59,83,9,7,0.15254237288135594,0.08433734939759036
"[1, 0, 1, 1, 0, 1, 0, 0, 1, 0, 1, 1, 1, 0, 1]",118,49,69,6,3,0.12244897959183673,0.043478260869565216
"[1, 0, 0, 0, 1, 1, 1, 0, 0, 0, 0, 1, 0, 1, 0]",150,89,61,11,7,0.12359550561797752,0.11475409836065574
"[1, 0, 0, 1, 0, 0, 1, 1, 1, 0, 1, 1, 0, 0, 0]",128,72,56,15,6,0.20833333333333334,0.10714285714285714
"[0, 1, 1, 0, 0, 0, 1, 1, 1, 0, 1, 1, 0, 0, 1]",135,59,76,9,10,0.15254237288135594,0.13157894736842105
"[1, 1, 0, 1, 1, 1, 0, 1, 0, 0, 0, 0, 1, 1, 0]",155,73,82,5,10,0.0684931506849315,0.12195121951219512
"[1, 1, 0, 1, 1, 0, 1, 1, 1, 0, 1, 0, 0, 0, 0]",123,50,73,7,7,0.14,0.0958904109589041
"[0, 0, 1, 0, 0, 1, 1, 0, 0, 0, 0, 0, 1, 0, 0]",558,414,144,52,12,0.12560386473429952,0.08333333333333333
"[1, 0, 1, 1, 0, 1, 1, 0, 0, 1, 0, 0, 0, 1, 0]",111,56,55,6,4,0.10714285714285714,0.07272727272727272
"[1, 0, 0, 1, 0, 0, 1, 1, 1, 0, 1, 1, 1, 1, 0]",149,60,89,9,8,0.15,0.0898876404494382
"[1, 1, 0, 0, 0, 0, 0, 1, 0, 0, 1, 1, 1, 0, 0]",184,112,72,11,5,0.09821428571428571,0.06944444444444445
"[0, 0, 0, 1, 0, 0, 0, 1, 0, 1, 1, 0, 1, 1, 1]",169,96,73,7,6,0.07291666666666667,0.0821917808219178
"[0, 0, 0, 0, 1, 0, 0, 0, 1, 0, 1, 1, 0, 1, 1]",197,127,70,12,11,0.09448818897637795,0.15714285714285714
"[1, 0, 0, 0, 0, 0, 0, 1, 0, 0, 0, 1, 0, 1, 1]",344,182,162,17,12,0.09340659340659341,0.07407407407407407
"[1, 0, 1, 0, 1, 1, 0, 0, 0, 0, 0, 0, 1, 0, 0]",282,180,102,18,14,0.1,0.13725490196078433
"[0, 0, 0, 1, 0, 0, 1, 1, 0, 1, 1, 0, 1, 1, 0]",115,68,47,7,6,0.10294117647058823,0.1276595744680851
"[0, 0, 0, 0, 1, 0, 0, 0, 0, 1, 0, 0, 1, 1, 0]",647,459,188,49,10,0.10675381263616558,0.05319148936170213
"[0, 1, 0, 0, 0, 1, 1, 1, 0, 0, 1, 1, 0, 0, 0]",222,125,97,14,6,0.112,0.061855670103092786
"[0, 0, 1, 0, 0, 0, 1, 1, 1, 0, 0, 1, 1, 0, 0]",220,138,82,17,7,0.12318840579710146,0.08536585365853659
"[1, 1, 0, 0, 1, 1, 0, 0, 1, 1, 1, 0, 0, 0, 0]",297,157,140,13,10,0.08280254777070063,0.07142857142857142
"[1, 1, 1, 0, 1, 0, 0, 1, 0, 0, 1, 0, 1, 1, 0]",122,60,62,5,7,0.08333333333333333,0.11290322580645161
"[0, 1, 0, 0, 1, 0, 0, 1, 1, 1, 1, 0, 1, 0, 1]",117,54,63,3,5,0.05555555555555555,0.07936507936507936
"[1, 1, 1, 0, 1, 1, 1, 0, 0, 0, 0, 1, 0, 1, 0]",119,47,72,3,8,0.06382978723404255,0.1111111111111111
"[0, 0, 0, 1, 0, 0, 1, 1, 0, 0, 1, 1, 1, 1, 1]",331,166,165,11,13,0.06626506024096386,0.07878787878787878
"[0, 0, 1, 1, 0, 1, 1, 1, 1, 0, 0, 0, 1, 0, 1]",124,56,68,3,6,0.05357142857142857,0.08823529411764706
"[0, 1, 1, 0, 0, 0, 1, 0, 0, 1, 1, 1, 1, 1, 0]",147,78,69,5,5,0.0641025641025641,0.07246376811594203
"[1, 0, 1, 1, 0, 0, 0, 1, 0, 0, 1, 1, 1, 1, 1]",206,95,111,12,17,0.12631578947368421,0.15315315315315314
"[1, 1, 0, 1, 0, 1, 1, 0, 0, 1, 1, 0, 1, 0, 0]",134,65,69,10,3,0.15384615384615385,0.043478260869565216
"[0, 1, 1, 1, 1, 0, 1, 0, 1, 0, 0, 1, 0, 0, 0]",122,72,50,7,7,0.09722222222222222,0.14
"[1, 0, 1, 0, 0, 0, 0, 0, 0, 0, 1, 0, 0, 0, 1]",549,389,160,47,10,0.12082262210796915,0.0625
"[1, 0, 1, 1, 1, 0, 1, 0, 1, 1, 0, 1, 1, 0, 1]",217,78,139,1,16,0.01282051282051282,0.11510791366906475
"[0, 1, 1, 0, 1, 1, 1, 0, 1, 0, 1, 1, 0, 1, 1]",243,92,151,7,12,0.07608695652173914,0.07947019867549669
"[1, 1, 1, 1, 1, 0, 1, 0, 1, 0, 0, 1, 0, 1, 1]",264,89,175,9,16,0.10112359550561797,0.09142857142857143
"[0, 0, 1, 1, 1, 1, 0, 0, 0, 1, 1, 1, 1, 0, 1]",203,83,120,8,14,0.0963855421686747,0.11666666666666667
"[1, 1, 0, 0, 1, 1, 0, 0, 0, 0, 0, 1, 1, 0, 0]",389,219,170,14,16,0.0639269406392694,0.09411764705882353
"[1, 1, 0, 1, 0, 0, 0, 0, 1, 0, 0, 1, 0, 1, 1]",113,68,45,11,5,0.16176470588235295,0.1111111111111111
"[0, 0, 0, 0, 1, 1, 1, 1, 1, 0, 0, 0, 1, 1, 1]",318,160,158,20,9,0.125,0.056962025316455694
"[0, 0, 1, 0, 1, 0, 1, 0, 0, 0, 1, 1, 1, 0, 0]",180,115,65,13,5,0.11304347826086956,0.07692307692307693
"[1, 1, 0, 1, 0, 0, 0, 1, 0, 1, 0, 0, 1, 1, 1]",141,77,64,10,9,0.12987012987012986,0.140625
"[1, 1, 1, 0, 0, 1, 0, 1, 1, 0, 0, 0, 0, 1, 0]",108,55,53,7,8,0.12727272727272726,0.1509433962264151
"[1, 0, 0, 1, 1, 1, 0, 0, 1, 0, 1, 0, 0, 1, 0]",112,51,61,3,6,0.058823529411764705,0.09836065573770492
"[0, 1, 0, 1, 0, 0, 1, 1, 1, 0, 1, 0, 1, 1, 0]",109,50,59,6,7,0.12,0.11864406779661017
"[0, 1, 0, 1, 1, 0, 1, 1, 1, 1, 1, 0, 1, 0, 1]",223,91,132,12,9,0.13186813186813187,0.06818181818181818
"[1, 0, 1, 1, 0, 1, 0, 0, 1, 0, 1, 0, 0, 1, 1]",126,62,64,9,9,0.14516129032258066,0.140625
"[0, 1, 0, 1, 1, 1, 0, 0, 0, 0, 0, 1, 1, 1, 1]",248,138,110,9,12,0.06521739130434782,0.10909090909090909
"[1, 0, 0, 0, 0, 1, 1, 1, 0, 0, 0, 1, 0, 1, 1]",149,71,78,6,7,0.08450704225352113,0.08974358974358974
"[1, 0, 0, 1, 1, 0, 1, 0, 0, 0, 0, 0, 1, 1, 0]",176,92,84,8,11,0.08695652173913043,0.13095238095238096
"[0, 1, 1, 1, 1, 0, 1, 1, 0, 1, 0, 0, 1, 1, 0]",167,71,96,10,6,0.14084507042253522,0.0625
"[0, 0, 0, 0, 0, 0, 1, 0, 1, 1, 1, 1, 0, 1, 1]",155,87,68,3,8,0.034482758620689655,0.11764705882352941
"[0, 0, 1, 1, 0, 0, 0, 0, 0, 0, 1, 0, 1, 1, 1]",664,441,223,40,21,0.09070294784580499,0.09417040358744394
"[0, 1, 1, 0, 0, 0, 0, 1, 1, 0, 1, 0, 1, 1, 0]",145,94,51,9,6,0.09574468085106383,0.11764705882352941
"[1, 0, 0, 0, 1, 1, 0, 0, 0, 0, 1, 1, 0, 1, 0]",172,109,63,12,5,0.11009174311926606,0.07936507936507936
"[0, 1, 1, 1, 1, 0, 0, 0, 1, 1, 1, 0, 1, 0, 0]",140,71,69,5,7,0.07042253521126761,0.10144927536231885
"[1, 1, 0, 0, 1, 0, 1, 0, 1, 1, 1, 0, 0, 0, 1]",111,52,59,4,10,0.07692307692307693,0.1694915254237288
"[0, 1, 1, 0, 0, 1, 0, 1, 0, 1, 1, 1, 0, 0, 0]",114,65,49,11,5,0.16923076923076924,0.10204081632653061
"[1, 0, 1, 0, 1, 0, 0, 1, 0, 1, 0, 0, 0, 1, 1]",112,62,50,5,6,0.08064516129032258,0.12
"[1, 0, 1, 1, 1, 0, 1, 1, 0, 1, 1, 0, 1, 0, 1]",237,91,146,12,8,0.13186813186813187,0.0547945205479452
"[1, 0, 1, 1, 1, 0, 0, 0, 0, 0, 0, 1, 0, 0, 1]",165,96,69,7,7,0.07291666666666667,0.10144927536231885
"[1, 1, 0, 1, 0, 0, 1, 1, 0, 1, 1, 1, 1, 1, 0]",258,91,167,3,15,0.03296703296703297,0.08982035928143713
"[1, 1, 1, 1, 1, 0, 1, 0, 0, 1, 1, 0, 1, 1, 1]",694,192,502,13,51,0.06770833333333333,0.10159362549800798
"[1, 0, 0, 0, 0, 0, 1, 0, 1, 0, 1, 1, 0, 0, 0]",276,171,105,18,6,0.10526315789473684,0.05714285714285714
"[0, 1, 0, 0, 1, 0, 1, 1, 1, 1, 1, 0, 0, 1, 1]",231,85,146,10,11,0.11764705882352941,0.07534246575342465
"[1, 0, 1, 0, 0, 1, 0, 1, 0, 1, 1, 0, 1, 1, 1]",141,63,78,5,8,0.07936507936507936,0.10256410256410256
"[1, 1, 0, 0, 0, 0, 0, 0, 1, 0, 1, 1, 1, 0, 1]",172,92,80,15,10,0.16304347826086957,0.125
"[0, 1, 1, 0, 1, 0, 0, 0, 1, 1, 1, 0, 0, 1, 1]",155,76,79,5,8,0.06578947368421052,0.10126582278481013
"[0, 1, 1, 0, 0, 0, 1, 0, 1, 1, 0, 1, 1, 1, 1]",183,87,96,9,11,0.10344827586206896,0.11458333333333333
"[0, 0, 1, 0, 0, 1, 0, 0, 1, 0, 1, 0, 1, 0, 1]",145,85,60,9,6,0.10588235294117647,0.1
"[0, 1, 1, 1, 0, 0, 1, 0, 0, 1, 0, 0, 1, 0, 1]",128,79,49,10,2,0.12658227848101267,0.04081632653061224
"[0, 0, 1, 0, 0, 0, 1, 0, 0, 1, 1, 1, 0, 0, 1]",172,99,73,22,9,0.2222222222222222,0.1232876712328767
"[1, 1, 0, 0, 1, 1, 1, 1, 0, 1, 0, 1, 0, 0, 1]",214,88,126,4,14,0.045454545454545456,0.1111111111111111
"[1, 1, 0, 1, 0, 1, 0, 1, 1, 1, 0, 0, 1, 1, 1]",324,110,214,9,18,0.08181818181818182,0.08411214953271028
"[1, 1, 0, 1, 1, 1, 0, 0, 1, 1, 1, 1, 0, 1, 0]",246,75,171,11,14,0.14666666666666667,0.08187134502923976
"[0, 0, 0, 1, 0, 0, 1, 1, 0, 1, 0, 1, 0, 0, 1]",136,91,45,6,5,0.06593406593406594,0.1111111111111111
"[0, 0, 1, 0, 0, 0, 0, 1, 0, 1, 1, 1, 1, 1, 1]",197,90,107,14,7,0.15555555555555556,0.06542056074766354
"[0, 1, 0, 0, 0, 1, 1, 0, 0, 1, 0, 0, 1, 1, 0]",157,90,67,12,6,0.13333333333333333,0.08955223880597014
"[1, 0, 1, 0, 1, 1, 1, 0, 1, 1, 0, 1, 0, 0, 0]",109,46,63,3,6,0.06521739130434782,0.09523809523809523
"[1, 1, 0, 0, 1, 0, 0, 1, 0, 0, 1, 0, 0, 1, 1]",117,66,51,6,3,0.09090909090909091,0.058823529411764705
"[1, 0, 0, 0, 1, 0, 1, 1, 0, 0, 0, 1, 0, 0, 1]",139,74,65,13,5,0.17567567567567569,0.07692307692307693
"[1, 1, 0, 0, 1, 0, 1, 1, 0, 0, 0, 1, 1, 0, 0]",162,92,70,9,9,0.09782608695652174,0.12857142857142856
"[1, 0, 0, 1, 0, 0, 1, 1, 1, 1, 1, 1, 0, 1, 1]",288,85,203,7,21,0.08235294117647059,0.10344827586206896
"[1, 0, 1, 1, 1, 1, 0, 0, 1, 0, 1, 1, 1, 0, 0]",178,88,90,7,4,0.07954545454545454,0.044444444444444446
"[0, 1, 0, 0, 1, 0, 1, 0, 0, 0, 1, 0, 1, 0, 1]",135,96,39,5,4,0.052083333333333336,0.10256410256410256
"[0, 1, 0, 1, 0, 1, 0, 1, 0, 1, 0, 1, 1, 1, 0]",117,64,53,5,7,0.078125,0.1320754716981132
"[1, 0, 1, 0, 1, 0, 1, 0, 1, 0, 1, 0, 1, 1, 1]",161,58,103,8,9,0.13793103448275862,0.08737864077669903
"[1, 0, 0, 0, 1, 0, 1, 0, 0, 0, 0, 1, 0, 1, 1]",147,90,57,14,4,0.15555555555555556,0.07017543859649122
"[0, 1, 0, 0, 0, 1, 1, 0, 0, 0, 1, 0, 0, 1, 1]",180,112,68,11,10,0.09821428571428571,0.14705882352941177
"[1, 0, 1, 0, 0, 0, 1, 1, 0, 0, 0, 1, 0, 0, 1]",151,81,70,6,4,0.07407407407407407,0.05714285714285714
"[1, 0, 0, 0, 0, 1, 1, 0, 0, 0, 1, 0, 1, 1, 1]",319,112,207,13,23,0.11607142857142858,0.1111111111111111
"[1, 1, 1, 1, 0, 1, 1, 1, 0, 1, 1, 0, 0, 0, 1]",277,104,173,6,17,0.057692307692307696,0.09826589595375723
"[1, 0, 0, 0, 1, 1, 1, 0, 0, 0, 1, 0, 1, 1, 1]",149,70,79,5,6,0.07142857142857142,0.0759493670886076
"[0, 1, 0, 0, 0, 1, 1, 0, 0, 0, 1, 1, 1, 0, 0]",170,103,67,8,7,0.07766990291262135,0.1044776119402985
"[1, 0, 1, 0, 0, 1, 0, 0, 0, 1, 1, 0, 0, 0, 1]",156,97,59,11,3,0.1134020618556701,0.05084745762711865
"[0, 0, 0, 1, 1, 0, 0, 1, 0, 1, 0, 0, 1, 0, 0]",251,166,85,19,7,0.1144578313253012,0.08235294117647059
"[0, 0, 0, 0, 1, 1, 0, 1, 1, 0, 1, 0, 0, 1, 1]",163,79,84,8,5,0.10126582278481013,0.05952380952380952
"[1, 0, 1, 0, 1, 1, 0, 0, 1, 0, 0, 0, 0, 0, 1]",156,95,61,14,7,0.14736842105263157,0.11475409836065574
"[1, 0, 0, 0, 0, 1, 0, 0, 0, 0, 0, 1, 0, 1, 0]",501,349,152,30,13,0.08595988538681948,0.08552631578947369
"[1, 1, 0, 0, 1, 0, 0, 0, 0, 1, 1, 1, 0, 1, 1]",138,61,77,7,10,0.11475409836065574,0.12987012987012986
"[1, 1, 1, 0, 0, 1, 1, 1, 0, 0, 1, 0, 0, 1, 0]",131,67,64,8,6,0.11940298507462686,0.09375
"[1, 0, 1, 0, 1, 0, 0, 0, 0, 0, 1, 0, 1, 0, 0]",199,129,70,12,4,0.09302325581395349,0.05714285714285714
"[0, 1, 0, 0, 0, 1, 0, 1, 1, 0, 0, 0, 0, 0, 1]",288,172,116,11,11,0.06395348837209303,0.09482758620689655
"[0, 0, 0, 1, 1, 0, 0, 1, 0, 1, 0, 0, 0, 1, 0]",240,170,70,14,9,0.08235294117647059,0.12857142857142856
"[1, 0, 0, 0, 1, 1, 0, 0, 1, 0, 1, 0, 0, 0, 1]",136,75,61,4,3,0.05333333333333334,0.04918032786885246
"[0, 1, 1, 0, 0, 0, 0, 1, 0, 1, 0, 1, 0, 1, 1]",179,105,74,16,8,0.1523809523809524,0.10810810810810811
"[1, 0, 1, 1, 0, 1, 1, 1, 0, 1, 0, 1, 1, 1, 1]",536,158,378,11,37,0.06962025316455696,0.09788359788359788
"[1, 0, 0, 0, 0, 1, 0, 0, 1, 1, 1, 0, 0, 1, 1]",193,74,119,6,12,0.08108108108108109,0.10084033613445378
"[1, 0, 1, 0, 0, 0, 0, 0, 1, 0, 1, 1, 0, 0, 1]",165,83,82,8,10,0.0963855421686747,0.12195121951219512
"[0, 1, 1, 0, 1, 0, 0, 0, 0, 1, 1, 0, 1, 0, 1]",113,70,43,7,4,0.1,0.09302325581395349
"[0, 0, 0, 1, 1, 1, 1, 0, 0, 1, 0, 0, 1, 1, 0]",160,90,70,6,7,0.06666666666666667,0.1
"[1, 1, 1, 0, 0, 0, 1, 1, 1, 1, 0, 0, 1, 0, 0]",145,57,88,7,7,0.12280701754385964,0.07954545454545454
"[1, 1, 0, 0, 0, 0, 1, 1, 0, 0, 1, 0, 0, 1, 0]",229,137,92,13,12,0.0948905109489051,0.13043478260869565
"[1, 1, 0, 0, 0, 0, 1, 0, 1, 1, 0, 1, 0, 1, 0]",111,59,52,5,5,0.0847457627118644,0.09615384615384616
"[0, 1, 1, 1, 1, 0, 0, 0, 0, 1, 0, 1, 1, 0, 1]",143,81,62,8,7,0.09876543209876543,0.11290322580645161
"[0, 0, 1, 1, 1, 1, 0, 0, 0, 0, 1, 0, 1, 1, 0]",193,118,75,14,9,0.11864406779661017,0.12
"[0, 0, 0, 1, 0, 1, 0, 1, 0, 1, 1, 1, 0, 1, 1]",134,63,71,4,7,0.06349206349206349,0.09859154929577464
"[1, 0, 1, 1, 0, 0, 1, 0, 0, 0, 1, 1, 0, 1, 1]",120,53,67,5,3,0.09433962264150944,0.04477611940298507
"[0, 1, 0, 1, 1, 0, 0, 1, 0, 0, 0, 1, 1, 0, 1]",106,57,49,4,10,0.07017543859649122,0.20408163265306123
"[1, 0, 0, 0, 1, 1, 0, 0, 1, 0, 0, 1, 0, 1, 1]",132,67,65,5,5,0.07462686567164178,0.07692307692307693
"[0, 0, 0, 1, 0, 0, 0, 1, 1, 0, 0, 1, 0, 0, 1]",237,142,95,13,12,0.09154929577464789,0.12631578947368421
"[0, 1, 0, 0, 1, 0, 1, 1, 0, 0, 0, 0, 1, 0, 0]",247,146,101,13,12,0.08904109589041095,0.1188118811881188
"[1, 0, 1, 0, 0, 1, 0, 0, 1, 0, 1, 1, 0, 0, 0]",152,83,69,6,9,0.07228915662650602,0.13043478260869565
"[0, 1, 1, 0, 1, 0, 0, 1, 0, 0, 1, 0, 1, 1, 0]",99,53,46,3,5,0.05660377358490566,0.10869565217391304
"[1, 0, 0, 1, 0, 0, 1, 0, 1, 0, 0, 1, 1, 1, 0]",107,53,54,4,5,0.07547169811320754,0.09259259259259259
"[0, 0, 0, 0, 0, 0, 1, 1, 1, 1, 0, 1, 1, 1, 1]",486,236,250,14,22,0.059322033898305086,0.088
"[1, 0, 0, 0, 0, 0, 1, 0, 1, 1, 0, 0, 1, 1, 1]",218,101,117,11,18,0.10891089108910891,0.15384615384615385
"[0, 1, 0, 1, 1, 0, 0, 0, 0, 1, 0, 1, 0, 1, 1]",119,58,61,2,9,0.034482758620689655,0.14754098360655737
"[0, 1, 0, 1, 1, 1, 0, 1, 0, 0, 0, 1, 0, 0, 1]",108,60,48,9,7,0.15,0.14583333333333334
"[0, 0, 1, 0, 1, 1, 1, 0, 1, 0, 0, 0, 1, 0, 0]",135,81,54,7,5,0.08641975308641975,0.09259259259259259
"[1, 0, 1, 0, 1, 0, 1, 0, 0, 0, 1, 0, 1, 1, 1]",131,60,71,6,5,0.1,0.07042253521126761
"[0, 1, 0, 1, 0, 1, 0, 1, 0, 1, 0, 0, 0, 1, 0]",130,86,44,10,8,0.11627906976744186,0.18181818181818182
"[0, 0, 0, 1, 0, 1, 0, 1, 1, 0, 0, 0, 1, 0, 0]",235,165,70,15,8,0.09090909090909091,0.11428571428571428
"[1, 1, 1, 0, 0, 0, 0, 0, 1, 0, 0, 0, 0, 1, 0]",278,151,127,12,11,0.07947019867549669,0.08661417322834646
"[1, 0, 0, 0, 1, 0, 1, 0, 1, 1, 1, 1, 0, 1, 1]",160,71,89,5,8,0.07042253521126761,0.0898876404494382
"[1, 0, 0, 1, 1, 1, 0, 0, 0, 1, 1, 0, 1, 1, 0]",106,43,63,7,3,0.16279069767441862,0.047619047619047616
"[1, 0, 1, 0, 1, 0, 0, 0, 0, 1, 0, 1, 1, 1, 0]",114,62,52,7,6,0.11290322580645161,0.11538461538461539
"[1, 1, 1, 1, 1, 1, 0, 0, 0, 0, 0, 1, 0, 1, 0]",190,80,110,10,9,0.125,0.08181818181818182
"[0, 0, 1, 1, 0, 1, 0, 0, 0, 0, 1, 0, 1, 1, 0]",140,96,44,12,3,0.125,0.06818181818181818
"[1, 0, 0, 1, 1, 0, 1, 0, 0, 0, 0, 1, 0, 1, 1]",119,50,69,4,7,0.08,0.10144927536231885
"[0, 0, 0, 0, 1, 1, 0, 1, 0, 1, 0, 0, 0, 1, 1]",201,125,76,12,2,0.096,0.02631578947368421
"[1, 0, 0, 0, 0, 0, 0, 1, 1, 1, 1, 0, 1, 0, 1]",238,78,160,7,14,0.08974358974358974,0.0875
"[0, 1, 0, 1, 0, 1, 1, 0, 0, 0, 0, 0, 1, 0, 1]",155,87,68,6,8,0.06896551724137931,0.11764705882352941
"[1, 0, 0, 1, 1, 0, 1, 0, 0, 0, 0, 1, 1, 1, 1]",210,82,128,4,10,0.04878048780487805,0.078125
"[1, 0, 1, 1, 0, 0, 1, 1, 0, 1, 0, 0, 0, 0, 1]",130,77,53,10,8,0.12987012987012986,0.1509433962264151
"[1, 0, 1, 0, 1, 1, 0, 0, 1, 1, 0, 1, 0, 0, 0]",140,73,67,2,4,0.0273972602739726,0.05970149253731343
"[1, 1, 0, 1, 0, 1, 0, 0, 0, 0, 0, 0, 1, 1, 1]",256,123,133,11,14,0.08943089430894309,0.10526315789473684
"[1, 0, 1, 1, 0, 0, 0, 1, 0, 0, 1, 0, 1, 1, 1]",151,69,82,6,6,0.08695652173913043,0.07317073170731707
"[0, 1, 0, 1, 0, 1, 1, 1, 1, 1, 1, 1, 0, 1, 0]",272,97,175,9,27,0.09278350515463918,0.15428571428571428
"[1, 0, 1, 1, 0, 0, 0, 1, 0, 0, 0, 1, 1, 0, 1]",104,55,49,8,8,0.14545454545454545,0.16326530612244897
"[0, 1, 1, 0, 1, 1, 0, 1, 0, 1, 1, 0, 0, 0, 1]",108,49,59,4,5,0.08163265306122448,0.0847457627118644
"[1, 0, 1, 0, 0, 0, 1, 1, 0, 1, 1, 0, 1, 0, 1]",98,42,56,6,5,0.14285714285714285,0.08928571428571429
"[0, 1, 1, 1, 0, 1, 0, 0, 0, 1, 1, 0, 1, 1, 0]",107,49,58,4,5,0.08163265306122448,0.08620689655172414
"[1, 0, 0, 0, 0, 1, 1, 0, 1, 0, 1, 1, 0, 1, 0]",102,54,48,5,2,0.09259259259259259,0.041666666666666664
"[0, 0, 0, 1, 1, 0, 1, 0, 1, 1, 0, 0, 1, 0, 0]",143,93,50,8,5,0.08602150537634409,0.1
"[1, 0, 0, 1, 0, 1, 1, 0, 1, 0, 1, 1, 1, 1, 1]",278,92,186,13,14,0.14130434782608695,0.07526881720430108
"[0, 1, 0, 0, 0, 1, 0, 1, 1, 1, 1, 0, 1, 0, 0]",92,52,40,4,4,0.07692307692307693,0.1
"[0, 0, 0, 0, 1, 0, 0, 1, 1, 1, 0, 1, 0, 1, 0]",131,80,51,7,6,0.0875,0.11764705882352941
"[1, 0, 1, 0, 0, 0, 0, 0, 1, 0, 0, 1, 1, 1, 0]",140,85,55,6,5,0.07058823529411765,0.09090909090909091
"[0, 1, 1, 0, 1, 1, 1, 1, 1, 0, 0, 1, 0, 1, 0]",118,52,66,5,10,0.09615384615384616,0.15151515151515152
"[0, 0, 0, 1, 1, 0, 1, 1, 1, 1, 1, 1, 1, 0, 0]",258,108,150,17,21,0.1574074074074074,0.14
"[0, 1, 1, 1, 0, 1, 0, 1, 1, 0, 1, 0, 1, 0, 1]",145,77,68,5,7,0.06493506493506493,0.10294117647058823
"[0, 1, 1, 1, 0, 1, 0, 0, 1, 0, 0, 1, 1, 1, 1]",198,77,121,8,11,0.1038961038961039,0.09090909090909091
"[0, 1, 0, 1, 1, 1, 0, 0, 1, 0, 0, 1, 0, 1, 1]",112,54,58,4,7,0.07407407407407407,0.1206896551724138
"[1, 0, 0, 1, 0, 0, 0, 0, 1, 1, 0, 1, 1, 0, 1]",103,52,51,5,5,0.09615384615384616,0.09803921568627451
"[0, 0, 1, 1, 1, 1, 0, 1, 0, 1, 1, 1, 1, 1, 0]",286,111,175,12,14,0.10810810810810811,0.08
"[1, 1, 1, 1, 0, 1, 0, 1, 1, 1, 0, 0, 0, 0, 1]",261,108,153,11,15,0.10185185185185185,0.09803921568627451
"[0, 0, 0, 1, 1, 0, 0, 1, 0, 0, 1, 0, 0, 1, 0]",219,155,64,12,5,0.07741935483870968,0.078125
"[0, 1, 0, 1, 1, 0, 1, 1, 0, 0, 1, 0, 1, 1, 0]",114,52,62,4,5,0.07692307692307693,0.08064516129032258
"[1, 1, 1, 0, 1, 1, 0, 1, 1, 0, 0, 0, 0, 1, 0]",110,43,67,4,6,0.09302325581395349,0.08955223880597014
"[0, 1, 1, 0, 1, 1, 1, 1, 0, 0, 1, 0, 1, 1, 1]",280,118,162,7,12,0.059322033898305086,0.07407407407407407
"[0, 1, 1, 1, 1, 0, 1, 1, 0, 0, 1, 1, 0, 0, 1]",267,125,142,6,10,0.048,0.07042253521126761
"[1, 1, 0, 0, 0, 1, 0, 1, 1, 0, 0, 0, 0, 0, 0]",395,257,138,25,10,0.09727626459143969,0.07246376811594203
"[0, 1, 1, 0, 0, 1, 0, 1, 1, 0, 0, 0, 1, 0, 1]",133,64,69,9,5,0.140625,0.07246376811594203
"[1, 1, 1, 0, 1, 1, 1, 0, 1, 1, 0, 0, 0, 1, 0]",134,51,83,14,6,0.27450980392156865,0.07228915662650602
"[0, 1, 1, 1, 1, 0, 1, 1, 1, 0, 1, 1, 0, 0, 0]",187,76,111,6,11,0.07894736842105263,0.0990990990990991
"[1, 0, 1, 0, 0, 1, 1, 1, 0, 0, 1, 1, 1, 1, 0]",214,91,123,3,17,0.03296703296703297,0.13821138211382114
"[0, 1, 0, 1, 1, 0, 1, 0, 0, 1, 1, 1, 0, 0, 1]",126,53,73,4,4,0.07547169811320754,0.0547945205479452
"[1, 0, 1, 0, 0, 0, 1, 0, 1, 1, 0, 1, 0, 0, 1]",116,64,52,3,4,0.046875,0.07692307692307693
"[1, 1, 1, 0, 0, 0, 1, 1, 0, 0, 1, 1, 1, 1, 1]",650,210,440,26,41,0.12380952380952381,0.09318181818181819
"[0, 0, 0, 0, 0, 1, 1, 1, 1, 1, 0, 1, 0, 0, 0]",224,147,77,12,6,0.08163265306122448,0.07792207792207792
"[1, 1, 1, 0, 0, 0, 0, 0, 1, 1, 1, 1, 1, 0, 1]",191,65,126,9,10,0.13846153846153847,0.07936507936507936
"[1, 0, 1, 1, 1, 1, 0, 0, 1, 0, 0, 1, 1, 1, 0]",149,66,83,12,6,0.18181818181818182,0.07228915662650602
"[1, 0, 0, 1, 0, 0, 1, 0, 0, 1, 0, 0, 1, 0, 1]",124,73,51,8,1,0.1095890410958904,0.0196078431372549
"[0, 0, 1, 0, 0, 1, 0, 0, 1, 1, 1, 1, 0, 1, 0]",132,70,62,7,5,0.1,0.08064516129032258
"[1, 0, 0, 0, 0, 1, 1, 0, 0, 1, 1, 0, 1, 0, 0]",256,103,153,10,13,0.0970873786407767,0.08496732026143791
"[1, 0, 1, 1, 0, 0, 0, 1, 1, 0, 1, 1, 0, 1, 0]",96,58,38,3,6,0.05172413793103448,0.15789473684210525
"[0, 1, 0, 1, 1, 0, 0, 1, 1, 0, 1, 1, 1, 0, 0]",122,59,63,6,6,0.1016949152542373,0.09523809523809523
"[1, 1, 1, 1, 0, 1, 0, 1, 0, 0, 1, 1, 0, 1, 1]",263,100,163,6,14,0.06,0.08588957055214724
"[0, 1, 0, 1, 1, 1, 1, 0, 1, 1, 1, 1, 0, 0, 1]",322,103,219,8,21,0.07766990291262135,0.0958904109589041
"[0, 0, 0, 0, 0, 1, 1, 1, 0, 1, 1, 1, 1, 0, 1]",151,83,68,11,6,0.13253012048192772,0.08823529411764706
"[1, 0, 0, 1, 0, 0, 1, 1, 1, 1, 0, 0, 0, 1, 0]",93,50,43,6,2,0.12,0.046511627906976744
"[1, 0, 0, 1, 1, 1, 1, 0, 0, 0, 1, 0, 1, 0, 0]",171,59,112,5,11,0.0847457627118644,0.09821428571428571
"[0, 1, 1, 1, 0, 0, 0, 1, 1, 0, 0, 0, 1, 0, 0]",156,96,60,7,4,0.07291666666666667,0.06666666666666667
"[1, 1, 0, 1, 1, 1, 0, 0, 0, 1, 1, 0, 0, 0, 0]",195,100,95,14,6,0.14,0.06315789473684211
"[1, 0, 1, 1, 0, 1, 0, 1, 0, 0, 1, 1, 1, 0, 1]",151,57,94,4,13,0.07017543859649122,0.13829787234042554
"[1, 0, 1, 0, 1, 1, 0, 1, 1, 1, 1, 0, 1, 0, 1]",210,78,132,7,14,0.08974358974358974,0.10606060606060606
"[1, 1, 0, 1, 0, 1, 1, 0, 1, 1, 1, 1, 0, 1, 0]",197,65,132,6,15,0.09230769230769231,0.11363636363636363
"[0, 1, 0, 0, 0, 1, 0, 1, 1, 0, 0, 0, 1, 1, 1]",150,88,62,5,5,0.056818181818181816,0.08064516129032258
"[1, 1, 1, 1, 1, 1, 0, 0, 0, 1, 0, 0, 0, 0, 1]",204,83,121,4,3,0.04819277108433735,0.024793388429752067
"[0, 1, 0, 1, 1, 1, 0, 0, 1, 1, 0, 1, 0, 1, 1]",165,61,104,11,12,0.18032786885245902,0.11538461538461539
"[1, 1, 1, 1, 1, 0, 1, 0, 1, 0, 1, 0, 1, 1, 1]",613,169,444,9,43,0.05325443786982249,0.09684684684684684
"[0, 1, 1, 0, 0, 0, 1, 0, 0, 1, 1, 1, 1, 1, 1]",313,181,132,14,6,0.07734806629834254,0.045454545454545456
"[1, 0, 0, 0, 1, 1, 0, 1, 1, 1, 1, 0, 0, 1, 1]",260,96,164,6,13,0.0625,0.07926829268292683
"[0, 1, 0, 0, 0, 0, 1, 0, 1, 0, 0, 1, 1, 0, 0]",316,201,115,20,10,0.09950248756218906,0.08695652173913043
"[1, 1, 1, 1, 0, 0, 1, 0, 0, 0, 1, 0, 0, 0, 1]",130,69,61,10,5,0.14492753623188406,0.08196721311475409
"[1, 1, 0, 1, 1, 1, 0, 0, 1, 1, 1, 0, 0, 1, 1]",348,119,229,10,17,0.08403361344537816,0.07423580786026202
"[1, 1, 0, 0, 1, 0, 1, 1, 0, 1, 1, 1, 0, 0, 1]",167,61,106,4,9,0.06557377049180328,0.08490566037735849
"[1, 0, 1, 0, 0, 1, 0, 1, 1, 1, 1, 1, 0, 1, 0]",152,65,87,10,8,0.15384615384615385,0.09195402298850575
"[1, 1, 1, 1, 0, 1, 1, 1, 0, 0, 1, 0, 1, 0, 1]",216,71,145,10,19,0.14084507042253522,0.1310344827586207
"[0, 1, 1, 1, 1, 0, 1, 1, 1, 0, 0, 1, 0, 1, 0]",139,68,71,5,10,0.07352941176470588,0.14084507042253522
"[1, 1, 1, 0, 0, 1, 1, 1, 1, 0, 0, 0, 0, 0, 1]",408,90,318,13,33,0.14444444444444443,0.10377358490566038
"[1, 0, 1, 0, 1, 0, 0, 0, 1, 1, 1, 1, 0, 1, 1]",164,72,92,11,7,0.1527777777777778,0.07608695652173914
"[1, 1, 1, 1, 1, 1, 0, 0, 0, 1, 1, 0, 1, 0, 0]",210,94,116,10,10,0.10638297872340426,0.08620689655172414
"[0, 0, 1, 0, 0, 0, 1, 1, 1, 1, 0, 0, 0, 0, 0]",643,427,216,36,25,0.08430913348946135,0.11574074074074074
"[0, 1, 0, 1, 0, 0, 0, 0, 0, 1, 0, 1, 0, 0, 0]",500,371,129,33,13,0.0889487870619946,0.10077519379844961
"[1, 1, 1, 0, 0, 0, 0, 0, 0, 0, 0, 1, 0, 0, 1]",464,198,266,16,21,0.08080808080808081,0.07894736842105263
"[0, 0, 0, 1, 0, 0, 1, 1, 1, 0, 0, 1, 1, 0, 0]",280,159,121,10,11,0.06289308176100629,0.09090909090909091
"[1, 1, 1, 1, 1, 0, 1, 0, 0, 1, 1, 0, 0, 0, 1]",166,68,98,5,12,0.07352941176470588,0.12244897959183673
"[1, 1, 0, 0, 1, 1, 1, 0, 1, 0, 0, 0, 1, 1, 1]",255,106,149,10,14,0.09433962264150944,0.09395973154362416
"[0, 0, 0, 0, 0, 1, 0, 1, 0, 0, 0, 1, 1, 1, 0]",241,158,83,15,3,0.0949367088607595,0.03614457831325301
"[0, 1, 0, 0, 0, 1, 1, 0, 1, 0, 1, 0, 0, 1, 0]",131,78,53,8,7,0.10256410256410256,0.1320754716981132
"[0, 1, 1, 0, 1, 0, 0, 1, 0, 0, 1, 0, 0, 0, 0]",253,160,93,8,10,0.05,0.10752688172043011
"[1, 0, 0, 1, 0, 0, 0, 1, 1, 1, 1, 1, 0, 1, 0]",125,48,77,5,7,0.10416666666666667,0.09090909090909091
"[0, 1, 1, 1, 1, 0, 1, 1, 1, 1, 0, 0, 1, 0, 1]",227,71,156,4,11,0.056338028169014086,0.07051282051282051
"[1, 0, 0, 1, 0, 0, 0, 1, 1, 1, 0, 0, 0, 0, 0]",328,207,121,15,5,0.07246376811594203,0.04132231404958678
"[1, 0, 0, 0, 0, 1, 0, 0, 1, 0, 0, 0, 1, 1, 1]",263,140,123,12,12,0.08571428571428572,0.0975609756097561
"[0, 1, 0, 0, 0, 0, 1, 0, 0, 1, 0, 0, 0, 1, 1]",289,182,107,18,7,0.0989010989010989,0.06542056074766354
"[0, 1, 0, 0, 0, 0, 0, 0, 0, 1, 1, 0, 1, 1, 1]",267,168,99,17,7,0.10119047619047619,0.0707070707070707
"[1, 1, 1, 1, 0, 0, 0, 1, 0, 1, 1, 1, 1, 0, 1]",269,97,172,2,12,0.020618556701030927,0.06976744186046512
"[0, 0, 1, 0, 0, 0, 0, 0, 1, 0, 1, 0, 1, 1, 1]",208,146,62,18,4,0.1232876712328767,0.06451612903225806
"[0, 0, 0, 1, 0, 1, 1, 0, 1, 0, 1, 0, 1, 1, 0]",108,67,41,5,5,0.07462686567164178,0.12195121951219512
"[0, 1, 0, 1, 1, 0, 1, 1, 0, 1, 0, 1, 0, 0, 1]",116,46,70,4,11,0.08695652173913043,0.15714285714285714
"[1, 1, 0, 0, 1, 1, 1, 0, 1, 0, 1, 0, 1, 0, 1]",142,60,82,6,12,0.1,0.14634146341463414
"[1, 1, 1, 0, 1, 1, 1, 0, 0, 1, 1, 1, 0, 0, 1]",317,106,211,8,18,0.07547169811320754,0.08530805687203792
"[0, 0, 0, 1, 1, 1, 1, 0, 1, 1, 1, 0, 0, 0, 0]",181,100,81,12,11,0.12,0.13580246913580246
"[1, 0, 1, 1, 0, 1, 0, 1, 1, 1, 0, 0, 1, 1, 1]",313,109,204,10,21,0.09174311926605505,0.10294117647058823
"[1, 0, 1, 1, 0, 0, 1, 0, 0, 0, 0, 0, 0, 1, 1]",238,131,107,9,11,0.06870229007633588,0.102803738317757
"[0, 0, 1, 1, 0, 1, 0, 0, 1, 1, 1, 1, 0, 0, 1]",198,92,106,12,10,0.13043478260869565,0.09433962264150944
"[0, 0, 0, 0, 1, 1, 0, 1, 0, 0, 1, 1, 1, 1, 0]",186,94,92,10,8,0.10638297872340426,0.08695652173913043
"[0, 1, 1, 0, 0, 1, 1, 0, 1, 1, 0, 0, 0, 1, 1]",174,104,70,13,5,0.125,0.07142857142857142
"[0, 1, 1, 0, 0, 1, 0, 1, 0, 1, 0, 0, 0, 1, 1]",131,73,58,7,6,0.0958904109589041,0.10344827586206896
"[0, 0, 1, 1, 0, 0, 1, 0, 1, 1, 1, 1, 0, 1, 1]",172,83,89,5,10,0.060240963855421686,0.11235955056179775
"[1, 0, 0, 1, 1, 1, 1, 0, 0, 1, 0, 1, 1, 0, 0]",166,76,90,8,13,0.10526315789473684,0.14444444444444443
"[1, 0, 1, 1, 1, 1, 1, 0, 0, 0, 0, 1, 0, 1, 0]",113,46,67,3,5,0.06521739130434782,0.07462686567164178
"[1, 0, 1, 0, 1, 1, 0, 0, 0, 0, 0, 1, 1, 0, 0]",239,134,105,10,14,0.07462686567164178,0.13333333333333333
"[0, 0, 0, 1, 0, 1, 0, 1, 1, 0, 0, 0, 0, 0, 1]",289,198,91,18,6,0.09090909090909091,0.06593406593406594
"[1, 1, 1, 1, 1, 1, 1, 0, 1, 0, 1, 0, 1, 0, 0]",280,96,184,12,17,0.125,0.09239130434782608
"[1, 1, 0, 1, 0, 0, 1, 0, 0, 0, 0, 1, 1, 0, 1]",118,61,57,10,4,0.16393442622950818,0.07017543859649122
"[1, 0, 0, 0, 1, 1, 0, 1, 1, 1, 0, 1, 0, 0, 0]",102,56,46,4,4,0.07142857142857142,0.08695652173913043
"[1, 0, 1, 1, 1, 0, 1, 1, 1, 0, 1, 0, 0, 0, 1]",129,53,76,6,2,0.11320754716981132,0.02631578947368421
"[0, 0, 1, 1, 0, 0, 0, 1, 1, 1, 0, 1, 1, 1, 0]",129,61,68,3,4,0.04918032786885246,0.058823529411764705
"[0, 0, 0, 1, 0, 0, 1, 1, 0, 0, 0, 1, 1, 1, 0]",140,84,56,11,6,0.13095238095238096,0.10714285714285714
"[1, 0, 1, 0, 0, 1, 1, 0, 1, 0, 0, 0, 1, 0, 1]",119,61,58,5,4,0.08196721311475409,0.06896551724137931
"[1, 1, 1, 1, 0, 0, 0, 0, 1, 0, 1, 0, 1, 0, 0]",140,65,75,5,10,0.07692307692307693,0.13333333333333333
"[0, 0, 0, 0, 0, 0, 1, 0, 0, 0, 1, 1, 1, 1, 0]",450,307,143,28,17,0.09120521172638436,0.11888111888111888
"[1, 1, 0, 0, 0, 1, 0, 0, 1, 0, 1, 0, 1, 0, 0]",138,76,62,5,7,0.06578947368421052,0.11290322580645161
"[0, 0, 0, 1, 1, 1, 1, 0, 0, 0, 1, 1, 0, 1, 1]",195,129,66,9,8,0.06976744186046512,0.12121212121212122
"[0, 0, 0, 0, 0, 0, 1, 1, 1, 1, 0, 0, 0, 1, 1]",637,410,227,44,25,0.1073170731707317,0.11013215859030837
"[1, 1, 1, 0, 1, 0, 1, 1, 0, 1, 0, 1, 1, 0, 0]",185,81,104,5,14,0.06172839506172839,0.1346153846153846
"[0, 1, 1, 1, 1, 0, 1, 0, 1, 1, 0, 1, 0, 1, 1]",248,93,155,12,17,0.12903225806451613,0.10967741935483871
"[0, 1, 0, 0, 0, 1, 0, 1, 1, 0, 1, 1, 0, 1, 0]",113,55,58,5,11,0.09090909090909091,0.1896551724137931
"[0, 1, 0, 0, 0, 1, 1, 1, 0, 1, 0, 0, 0, 1, 0]",141,80,61,6,5,0.075,0.08196721311475409
"[0, 1, 0, 1, 1, 1, 0, 0, 0, 0, 1, 1, 1, 1, 1]",402,193,209,28,22,0.14507772020725387,0.10526315789473684
"[0, 0, 1, 1, 1, 0, 1, 0, 0, 1, 0, 1, 0, 1, 1]",138,67,71,7,8,0.1044776119402985,0.11267605633802817
"[0, 1, 1, 1, 0, 0, 1, 1, 1, 0, 1, 0, 0, 1, 0]",107,46,61,7,5,0.15217391304347827,0.08196721311475409
"[0, 0, 1, 0, 0, 0, 1, 1, 1, 1, 0, 1, 1, 1, 1]",199,72,127,4,13,0.05555555555555555,0.10236220472440945
"[1, 0, 0, 1, 0, 1, 1, 1, 0, 0, 1, 1, 0, 1, 0]",106,45,61,6,6,0.13333333333333333,0.09836065573770492
"[0, 0, 1, 0, 0, 1, 1, 0, 0, 1, 0, 0, 1, 0, 1]",148,97,51,14,2,0.14432989690721648,0.0392156862745098
"[0, 0, 0, 0, 0, 0, 1, 1, 1, 0, 0, 0, 1, 0, 1]",343,221,122,15,12,0.06787330316742081,0.09836065573770492
"[0, 0, 0, 1, 0, 0, 1, 1, 0, 0, 1, 1, 0, 1, 0]",158,91,67,5,4,0.054945054945054944,0.05970149253731343
"[0, 1, 0, 0, 1, 0, 1, 1, 0, 0, 1, 0, 1, 1, 1]",141,73,68,8,5,0.1095890410958904,0.07352941176470588
"[0, 1, 0, 1, 0, 0, 0, 1, 1, 1, 0, 0, 0, 1, 0]",144,78,66,3,9,0.038461538461538464,0.13636363636363635
"[0, 1, 0, 1, 1, 0, 0, 1, 0, 1, 1, 1, 0, 1, 1]",171,76,95,10,10,0.13157894736842105,0.10526315789473684
"[0, 0, 0, 1, 0, 1, 1, 1, 1, 1, 0, 1, 1, 1, 0]",124,48,76,5,6,0.10416666666666667,0.07894736842105263
"[1, 1, 1, 1, 1, 1, 0, 1, 0, 0, 1, 1, 1, 0, 0]",299,100,199,9,12,0.09,0.06030150753768844
"[0, 1, 1, 0, 1, 1, 1, 0, 1, 0, 1, 1, 1, 0, 1]",226,82,144,9,23,0.10975609756097561,0.1597222222222222
"[0, 0, 1, 1, 0, 1, 1, 0, 0, 1, 0, 0, 1, 1, 0]",124,73,51,9,2,0.1232876712328767,0.0392156862745098
"[0, 1, 1, 0, 1, 0, 1, 1, 1, 0, 1, 0, 1, 0, 1]",143,65,78,11,9,0.16923076923076924,0.11538461538461539
"[1, 1, 0, 1, 1, 0, 0, 0, 0, 0, 0, 0, 0, 1, 0]",329,199,130,14,13,0.07035175879396985,0.1
"[0, 0, 1, 1, 0, 0, 1, 1, 1, 0, 0, 0, 0, 0, 1]",254,137,117,9,13,0.06569343065693431,0.1111111111111111
"[1, 0, 1, 0, 0, 1, 0, 0, 0, 0, 1, 1, 0, 0, 0]",393,244,149,19,11,0.0778688524590164,0.0738255033557047
"[1, 0, 1, 1, 0, 0, 1, 0, 1, 1, 1, 0, 1, 1, 1]",271,114,157,11,18,0.09649122807017543,0.11464968152866242
"[0, 0, 1, 1, 1, 0, 1, 0, 0, 1, 1, 0, 1, 1, 1]",194,88,106,12,8,0.13636363636363635,0.07547169811320754
"[0, 1, 1, 1, 1, 0, 1, 1, 0, 0, 0, 1, 1, 1, 0]",165,65,100,9,8,0.13846153846153847,0.08
"[0, 1, 0, 1, 1, 1, 1, 0, 1, 1, 0, 0, 0, 1, 1]",181,62,119,4,7,0.06451612903225806,0.058823529411764705
"[1, 1, 0, 1, 1, 1, 0, 1, 0, 0, 1, 0, 0, 1, 1]",151,65,86,3,9,0.046153846153846156,0.10465116279069768
"[0, 1, 1, 0, 1, 0, 0, 0, 0, 0, 1, 0, 0, 1, 0]",237,162,75,15,4,0.09259259259259259,0.05333333333333334
"[1, 1, 0, 0, 0, 1, 1, 0, 1, 1, 1, 0, 1, 1, 1]",294,107,187,13,13,0.12149532710280374,0.06951871657754011
"[1, 0, 0, 1, 1, 1, 0, 1, 1, 0, 0, 0, 1, 0, 0]",101,54,47,5,5,0.09259259259259259,0.10638297872340426
"[0, 1, 0, 1, 0, 1, 0, 0, 1, 1, 0, 1, 0, 1, 1]",122,59,63,6,4,0.1016949152542373,0.06349206349206349
"[1, 1, 0, 1, 0, 1, 0, 1, 0, 0, 1, 1, 0, 1, 0]",101,45,56,6,5,0.13333333333333333,0.08928571428571429
"[1, 0, 1, 1, 1, 1, 0, 0, 1, 1, 1, 0, 1, 1, 1]",610,183,427,20,52,0.1092896174863388,0.12177985948477751
"[1, 1, 0, 1, 1, 1, 1, 1, 0, 0, 1, 1, 1, 0, 0]",297,99,198,12,23,0.12121212121212122,0.11616161616161616
"[0, 1, 0, 1, 0, 1, 1, 1, 0, 1, 0, 1, 1, 1, 0]",140,60,80,8,10,0.13333333333333333,0.125
"[0, 1, 0, 1, 0, 0, 0, 0, 1, 0, 1, 1, 1, 1, 1]",160,74,86,12,11,0.16216216216216217,0.12790697674418605
"[1, 0, 0, 0, 1, 0, 0, 1, 1, 0, 0, 1, 0, 0, 0]",250,160,90,24,13,0.15,0.14444444444444443
"[0, 0, 0, 1, 0, 1, 0, 0, 0, 0, 1, 1, 1, 0, 1]",164,100,64,8,8,0.08,0.125
"[0, 0, 1, 1, 0, 1, 0, 1, 1, 0, 1, 0, 1, 0, 0]",98,59,39,8,7,0.13559322033898305,0.1794871794871795
"[0, 0, 0, 1, 1, 0, 1, 0, 1, 1, 0, 1, 0, 1, 0]",112,62,50,8,6,0.12903225806451613,0.12
"[1, 0, 0, 0, 0, 1, 0, 0, 0, 1, 0, 0, 1, 1, 0]",250,153,97,16,6,0.10457516339869281,0.061855670103092786
"[1, 0, 0, 1, 1, 0, 0, 1, 0, 1, 0, 1, 1, 0, 1]",132,57,75,5,9,0.08771929824561403,0.12
"[0, 0, 0, 1, 0, 1, 1, 0, 0, 0, 0, 0, 0, 1, 0]",564,391,173,33,17,0.08439897698209718,0.09826589595375723
"[1, 1, 0, 1, 0, 1, 0, 1, 1, 1, 1, 1, 0, 0, 0]",201,81,120,8,13,0.09876543209876543,0.10833333333333334
"[0, 1, 1, 0, 1, 0, 1, 0, 1, 1, 1, 1, 1, 0, 0]",185,84,101,6,8,0.07142857142857142,0.07920792079207921
"[1, 0, 0, 0, 0, 0, 0, 1, 1, 0, 1, 0, 1, 0, 1]",189,86,103,14,6,0.16279069767441862,0.05825242718446602
"[0, 1, 1, 0, 1, 1, 0, 1, 0, 0, 1, 0, 0, 0, 1]",124,63,61,6,2,0.09523809523809523,0.03278688524590164
"[0, 0, 1, 0, 1, 0, 0, 0, 1, 0, 1, 0, 1, 0, 0]",248,171,77,16,10,0.0935672514619883,0.12987012987012986
"[0, 1, 1, 1, 0, 0, 1, 0, 1, 0, 0, 1, 0, 0, 0]",155,86,69,11,8,0.12790697674418605,0.11594202898550725
"[0, 1, 1, 1, 0, 1, 1, 0, 1, 1, 0, 0, 0, 1, 1]",155,67,88,6,14,0.08955223880597014,0.1590909090909091
"[1, 0, 0, 1, 1, 1, 0, 1, 0, 0, 0, 0, 0, 1, 1]",200,94,106,11,4,0.11702127659574468,0.03773584905660377
"[0, 1, 1, 0, 1, 0, 1, 0, 0, 1, 1, 0, 1, 0, 0]",108,66,42,10,3,0.15151515151515152,0.07142857142857142
"[0, 1, 0, 1, 0, 0, 0, 1, 1, 1, 0, 1, 0, 1, 0]",90,49,41,3,2,0.061224489795918366,0.04878048780487805
"[1, 0, 1, 0, 0, 1, 1, 0, 0, 1, 0, 1, 0, 0, 0]",132,73,59,8,5,0.1095890410958904,0.0847457627118644
"[1, 1, 0, 1, 0, 0, 1, 0, 1, 0, 0, 1, 1, 0, 1]",119,53,66,6,3,0.11320754716981132,0.045454545454545456
"[1, 0, 1, 1, 1, 0, 0, 1, 0, 1, 1, 0, 0, 1, 0]",91,55,36,5,1,0.09090909090909091,0.027777777777777776
"[0, 1, 1, 0, 1, 0, 0, 1, 0, 1, 1, 1, 0, 0, 1]",136,65,71,8,6,0.12307692307692308,0.08450704225352113
"[0, 0, 0, 0, 0, 1, 1, 0, 1, 0, 0, 1, 0, 1, 1]",210,137,73,14,2,0.10218978102189781,0.0273972602739726
"[0, 1, 1, 0, 0, 0, 1, 0, 1, 0, 0, 1, 0, 1, 1]",112,63,49,10,5,0.15873015873015872,0.10204081632653061
"[1, 1, 0, 1, 1, 1, 1, 1, 0, 0, 0, 0, 0, 0, 1]",329,140,189,10,19,0.07142857142857142,0.10052910052910052
"[1, 0, 0, 1, 0, 1, 1, 1, 0, 1, 0, 0, 0, 1, 0]",112,59,53,7,10,0.11864406779661017,0.18867924528301888
"[0, 0, 1, 0, 0, 1, 1, 0, 0, 1, 1, 1, 0, 1, 1]",128,59,69,4,8,0.06779661016949153,0.11594202898550725
"[0, 0, 1, 1, 0, 1, 0, 0, 1, 0, 1, 1, 1, 1, 0]",118,53,65,2,2,0.03773584905660377,0.03076923076923077
"[0, 0, 1, 1, 1, 1, 1, 1, 1, 1, 1, 0, 1, 0, 0]",420,157,263,14,26,0.08917197452229299,0.09885931558935361
"[0, 0, 0, 1, 0, 1, 0, 1, 0, 0, 1, 0, 0, 1, 0]",203,124,79,11,11,0.08870967741935484,0.13924050632911392
"[1, 0, 1, 0, 1, 0, 1, 0, 0, 1, 1, 1, 0, 1, 1]",146,60,86,5,9,0.08333333333333333,0.10465116279069768
"[1, 1, 1, 1, 0, 0, 1, 0, 1, 0, 1, 0, 1, 0, 0]",94,45,49,5,2,0.1111111111111111,0.04081632653061224
"[0, 0, 1, 1, 0, 1, 1, 1, 1, 1, 1, 0, 0, 1, 0]",162,57,105,6,11,0.10526315789473684,0.10476190476190476
"[1, 1, 1, 0, 1, 1, 1, 0, 1, 1, 1, 0, 0, 0, 0]",214,84,130,4,6,0.047619047619047616,0.046153846153846156
"[1, 1, 0, 1, 1, 0, 1, 0, 1, 0, 0, 1, 1, 0, 1]",153,61,92,7,10,0.11475409836065574,0.10869565217391304
"[1, 0, 0, 0, 0, 1, 1, 0, 1, 1, 1, 1, 0, 0, 1]",178,64,114,2,13,0.03125,0.11403508771929824
"[0, 0, 1, 0, 1, 0, 1, 0, 0, 0, 1, 1, 0, 1, 1]",122,64,58,6,6,0.09375,0.10344827586206896
"[0, 1, 1, 0, 1, 0, 0, 1, 1, 0, 1, 0, 0, 0, 1]",114,66,48,7,3,0.10606060606060606,0.0625
"[0, 0, 0, 1, 0, 1, 1, 1, 0, 0, 0, 0, 1, 1, 0]",275,189,86,15,13,0.07936507936507936,0.1511627906976744
"[1, 1, 1, 0, 1, 1, 0, 0, 1, 1, 1, 1, 0, 1, 1]",611,150,461,22,41,0.14666666666666667,0.08893709327548807
"[1, 0, 0, 0, 1, 0, 1, 1, 1, 1, 1, 1, 0, 0, 0]",226,107,119,13,13,0.12149532710280374,0.1092436974789916
"[0, 1, 1, 1, 1, 1, 0, 0, 0, 1, 0, 1, 1, 1, 1]",323,127,196,10,17,0.07874015748031496,0.08673469387755102
"[1, 0, 0, 0, 0, 1, 0, 1, 0, 0, 1, 1, 1, 0, 1]",123,64,59,0,3,0.0,0.05084745762711865
"[0, 1, 0, 0, 0, 0, 1, 0, 1, 0, 0, 1, 1, 1, 0]",144,83,61,10,5,0.12048192771084337,0.08196721311475409
"[1, 1, 0, 0, 0, 1, 1, 0, 0, 1, 1, 0, 0, 0, 1]",161,87,74,7,6,0.08045977011494253,0.08108108108108109
"[1, 1, 0, 1, 1, 0, 1, 1, 0, 1, 1, 1, 0, 1, 0]",206,67,139,8,8,0.11940298507462686,0.05755395683453238
"[1, 1, 1, 1, 0, 0, 1, 0, 1, 1, 0, 1, 1, 0, 1]",230,86,144,5,15,0.05813953488372093,0.10416666666666667
"[1, 1, 0, 1, 0, 0, 0, 1, 1, 1, 1, 0, 0, 1, 0]",134,61,73,5,6,0.08196721311475409,0.0821917808219178
"[0, 0, 0, 1, 1, 1, 0, 0, 1, 1, 1, 1, 1, 0, 0]",200,103,97,9,11,0.08737864077669903,0.1134020618556701
"[1, 1, 0, 1, 0, 0, 1, 1, 1, 1, 1, 1, 0, 1, 0]",243,95,148,10,18,0.10526315789473684,0.12162162162162163
"[1, 0, 0, 1, 1, 0, 0, 1, 0, 1, 1, 0, 1, 0, 1]",129,55,74,7,8,0.12727272727272726,0.10810810810810811
"[1, 1, 1, 1, 0, 1, 0, 1, 1, 0, 0, 0, 1, 0, 0]",128,67,61,9,5,0.13432835820895522,0.08196721311475409
"[0, 0, 1, 1, 1, 1, 1, 1, 1, 1, 0, 1, 0, 1, 0]",349,121,228,15,23,0.12396694214876033,0.10087719298245613
"[1, 1, 0, 1, 1, 0, 0, 1, 1, 1, 0, 1, 1, 0, 0]",188,84,104,5,9,0.05952380952380952,0.08653846153846154
"[0, 1, 1, 0, 1, 0, 0, 0, 0, 0, 0, 0, 1, 1, 1]",358,225,133,16,14,0.07111111111111111,0.10526315789473684
"[0, 0, 0, 1, 1, 0, 0, 1, 1, 0, 1, 0, 0, 0, 0]",360,268,92,29,9,0.10820895522388059,0.09782608695652174
"[0, 1, 0, 0, 1, 0, 0, 0, 0, 1, 0, 0, 1, 0, 1]",218,137,81,13,11,0.0948905109489051,0.13580246913580246
"[1, 1, 1, 0, 1, 1, 0, 1, 0, 1, 0, 1, 0, 0, 0]",125,52,73,3,4,0.057692307692307696,0.0547945205479452
"[1, 1, 0, 0, 0, 0, 1, 1, 1, 0, 1, 1, 0, 1, 1]",240,103,137,12,16,0.11650485436893204,0.11678832116788321
"[0, 0, 1, 0, 0, 1, 1, 1, 1, 0, 0, 1, 0, 1, 1]",163,83,80,13,12,0.1566265060240964,0.15
"[1, 0, 1, 0, 0, 0, 1, 0, 0, 0, 1, 0, 0, 0, 1]",229,145,84,12,4,0.08275862068965517,0.047619047619047616
"[0, 1, 1, 1, 0, 0, 0, 1, 1, 0, 1, 0, 0, 1, 0]",101,48,53,5,5,0.10416666666666667,0.09433962264150944
"[0, 0, 0, 1, 1, 0, 1, 1, 0, 1, 1, 1, 0, 0, 0]",150,78,72,7,9,0.08974358974358974,0.125
"[1, 0, 0, 1, 0, 0, 1, 1, 1, 0, 1, 1, 0, 0, 1]",121,52,69,6,6,0.11538461538461539,0.08695652173913043
"[0, 1, 1, 1, 1, 0, 1, 0, 1, 1, 0, 1, 0, 1, 0]",131,61,70,7,11,0.11475409836065574,0.15714285714285714
"[0, 1, 0, 1, 0, 1, 1, 1, 0, 1, 0, 0, 1, 0, 0]",91,53,38,3,4,0.05660377358490566,0.10526315789473684
"[0, 1, 0, 0, 1, 1, 1, 0, 0, 1, 0, 1, 1, 0, 1]",102,46,56,4,4,0.08695652173913043,0.07142857142857142
"[0, 0, 0, 1, 0, 1, 0, 1, 1, 1, 1, 0, 0, 1, 0]",114,58,56,7,4,0.1206896551724138,0.07142857142857142
"[1, 0, 1, 1, 0, 1, 1, 0, 1, 1, 1, 0, 0, 0, 0]",176,74,102,9,17,0.12162162162162163,0.16666666666666666
"[1, 0, 1, 0, 0, 1, 1, 1, 0, 0, 1, 1, 0, 1, 1]",147,56,91,5,8,0.08928571428571429,0.08791208791208792
"[0, 0, 1, 0, 0, 1, 1, 1, 1, 0, 0, 0, 1, 0, 1]",122,79,43,9,3,0.11392405063291139,0.06976744186046512
"[1, 0, 1, 1, 0, 0, 0, 1, 0, 0, 1, 0, 0, 0, 1]",134,75,59,5,3,0.06666666666666667,0.05084745762711865
"[0, 0, 0, 1, 1, 0, 0, 1, 1, 1, 1, 1, 0, 1, 1]",356,246,110,21,11,0.08536585365853659,0.1
"[0, 0, 0, 0, 0, 1, 1, 0, 0, 1, 1, 1, 1, 1, 0]",377,285,92,22,5,0.07719298245614035,0.05434782608695652
"[1, 1, 1, 1, 0, 0, 0, 0, 1, 1, 1, 0, 1, 0, 0]",212,90,122,8,4,0.08888888888888889,0.03278688524590164
"[1, 1, 0, 0, 1, 1, 0, 1, 1, 1, 0, 1, 0, 1, 1]",274,93,181,9,21,0.0967741935483871,0.11602209944751381
"[0, 0, 1, 1, 0, 1, 1, 0, 1, 1, 1, 1, 1, 1, 0]",315,101,214,15,26,0.1485148514851485,0.12149532710280374
"[0, 0, 1, 0, 1, 0, 0, 0, 1, 1, 1, 1, 1, 0, 1]",104,57,47,4,7,0.07017543859649122,0.14893617021276595
"[0, 1, 0, 1, 1, 0, 0, 1, 1, 1, 0, 1, 1, 0, 1]",132,63,69,3,9,0.047619047619047616,0.13043478260869565
"[1, 0, 1, 0, 0, 1, 1, 1, 1, 0, 0, 0, 0, 1, 1]",415,195,220,24,28,0.12307692307692308,0.12727272727272726
"[0, 0, 0, 0, 1, 1, 0, 1, 1, 1, 1, 0, 1, 1, 0]",136,69,67,15,6,0.21739130434782608,0.08955223880597014
"[0, 1, 1, 0, 1, 0, 0, 1, 0, 1, 1, 1, 0, 0, 0]",109,71,38,5,5,0.07042253521126761,0.13157894736842105
"[1, 0, 0, 0, 1, 1, 0, 1, 0, 0, 1, 1, 0, 1, 0]",97,52,45,6,2,0.11538461538461539,0.044444444444444446
"[0, 0, 1, 1, 0, 1, 1, 1, 0, 0, 0, 1, 0, 0, 1]",121,63,58,4,5,0.06349206349206349,0.08620689655172414
"[1, 0, 0, 0, 1, 1, 0, 0, 1, 1, 0, 1, 1, 1, 0]",116,54,62,6,2,0.1111111111111111,0.03225806451612903
"[1, 0, 1, 1, 1, 1, 1, 0, 1, 1, 0, 0, 1, 0, 1]",211,82,129,7,12,0.08536585365853659,0.09302325581395349
"[1, 0, 0, 0, 1, 1, 1, 0, 0, 0, 1, 0, 0, 0, 1]",167,90,77,8,10,0.08888888888888889,0.12987012987012986
"[1, 1, 0, 1, 0, 0, 1, 1, 1, 1, 1, 0, 0, 1, 1]",392,149,243,9,27,0.06040268456375839,0.1111111111111111
"[0, 1, 1, 0, 1, 1, 0, 1, 0, 0, 0, 0, 1, 0, 0]",135,85,50,9,4,0.10588235294117647,0.08
"[1, 0, 1, 0, 0, 1, 0, 0, 0, 1, 0, 1, 1, 0, 0]",169,79,90,6,8,0.0759493670886076,0.08888888888888889
"[1, 1, 1, 1, 0, 1, 0, 1, 1, 0, 0, 1, 0, 0, 1]",172,69,103,8,10,0.11594202898550725,0.0970873786407767
"[0, 0, 0, 0, 1, 1, 0, 1, 0, 0, 1, 0, 1, 0, 1]",160,99,61,9,8,0.09090909090909091,0.13114754098360656
"[1, 0, 1, 1, 0, 1, 0, 1, 0, 0, 1, 0, 1, 1, 0]",98,45,53,6,5,0.13333333333333333,0.09433962264150944
"[1, 1, 0, 1, 0, 1, 1, 1, 1, 1, 0, 1, 0, 0, 0]",176,66,110,5,9,0.07575757575757576,0.08181818181818182
"[0, 1, 0, 0, 1, 0, 1, 0, 0, 1, 1, 1, 0, 0, 0]",154,94,60,6,6,0.06382978723404255,0.1
"[0, 0, 0, 1, 0, 1, 0, 1, 0, 1, 1, 0, 0, 1, 0]",126,84,42,7,5,0.08333333333333333,0.11904761904761904
"[1, 0, 0, 0, 0, 1, 0, 1, 0, 1, 0, 1, 1, 0, 0]",199,107,92,13,17,0.12149532710280374,0.18478260869565216
"[0, 0, 1, 1, 0, 0, 0, 0, 0, 1, 1, 1, 1, 1, 0]",188,103,85,11,10,0.10679611650485436,0.11764705882352941
"[1, 1, 0, 1, 0, 1, 1, 0, 1, 0, 1, 0, 0, 0, 0]",122,60,62,2,16,0.03333333333333333,0.25806451612903225
"[0, 0, 1, 0, 1, 0, 0, 0, 1, 1, 1, 0, 1, 0, 0]",144,80,64,6,9,0.075,0.140625
"[1, 0, 1, 1, 1, 1, 0, 0, 0, 0, 1, 0, 0, 0, 1]",136,74,62,10,3,0.13513513513513514,0.04838709677419355
"[0, 0, 1, 1, 0, 0, 0, 1, 1, 0, 1, 0, 0, 0, 1]",159,94,65,7,5,0.07446808510638298,0.07692307692307693
"[1, 0, 0, 1, 1, 1, 0, 1, 0, 0, 0, 0, 0, 1, 0]",149,81,68,6,6,0.07407407407407407,0.08823529411764706
"[0, 1, 0, 1, 1, 1, 0, 0, 1, 0, 1, 1, 0, 1, 1]",153,54,99,5,6,0.09259259259259259,0.06060606060606061
"[0, 1, 1, 0, 0, 1, 1, 0, 0, 1, 0, 1, 1, 0, 1]",164,102,62,7,4,0.06862745098039216,0.06451612903225806
"[1, 0, 0, 0, 1, 0, 1, 0, 1, 1, 0, 0, 1, 0, 1]",97,53,44,1,3,0.018867924528301886,0.06818181818181818
"[0, 1, 0, 1, 1, 0, 0, 0, 1, 0, 0, 1, 1, 1, 0]",125,72,53,5,7,0.06944444444444445,0.1320754716981132
"[0, 0, 1, 0, 1, 0, 0, 0, 0, 0, 1, 0, 1, 0, 1]",258,150,108,14,10,0.09333333333333334,0.09259259259259259
"[0, 1, 0, 0, 1, 1, 0, 0, 0, 1, 0, 0, 1, 1, 0]",158,88,70,7,9,0.07954545454545454,0.12857142857142856
"[1, 0, 1, 0, 1, 0, 1, 0, 0, 1, 1, 0, 0, 0, 1]",115,63,52,12,5,0.19047619047619047,0.09615384615384616
"[1, 0, 1, 0, 0, 0, 1, 1, 1, 0, 1, 1, 1, 0, 1]",141,55,86,5,7,0.09090909090909091,0.08139534883720931
"[0, 1, 0, 0, 1, 1, 1, 1, 0, 0, 1, 1, 0, 0, 1]",411,183,228,19,26,0.10382513661202186,0.11403508771929824
"[1, 0, 0, 1, 0, 0, 1, 0, 0, 1, 0, 1, 0, 1, 1]",109,62,47,3,4,0.04838709677419355,0.0851063829787234
"[0, 0, 1, 1, 1, 0, 0, 0, 1, 1, 0, 0, 0, 1, 0]",159,96,63,8,4,0.08333333333333333,0.06349206349206349
"[1, 0, 0, 0, 1, 0, 0, 1, 1, 1, 0, 0, 0, 1, 1]",148,75,73,11,2,0.14666666666666667,0.0273972602739726
"[0, 0, 0, 0, 1, 0, 1, 1, 1, 0, 0, 1, 0, 0, 0]",260,170,90,20,9,0.11764705882352941,0.1
"[1, 1, 0, 1, 1, 0, 1, 0, 0, 0, 1, 1, 0, 1, 0]",93,45,48,5,4,0.1111111111111111,0.08333333333333333
"[0, 0, 1, 1, 1, 1, 0, 1, 1, 0, 1, 0, 0, 0, 1]",131,58,73,8,14,0.13793103448275862,0.1917808219178082
"[0, 1, 1, 0, 1, 0, 1, 1, 1, 0, 1, 0, 0, 1, 0]",99,46,53,4,5,0.08695652173913043,0.09433962264150944
"[0, 1, 1, 1, 1, 0, 1, 0, 0, 0, 1, 0, 0, 1, 1]",136,75,61,8,4,0.10666666666666667,0.06557377049180328
"[0, 0, 1, 1, 1, 1, 0, 1, 0, 0, 0, 1, 0, 0, 1]",131,72,59,5,11,0.06944444444444445,0.1864406779661017
"[0, 1, 1, 1, 0, 1, 0, 1, 0, 0, 0, 1, 0, 0, 0]",168,110,58,6,5,0.05454545454545454,0.08620689655172414
"[0, 1, 1, 1, 0, 0, 1, 1, 1, 0, 1, 0, 1, 1, 0]",145,53,92,6,11,0.11320754716981132,0.11956521739130435
"[1, 0, 0, 0, 1, 0, 1, 1, 1, 0, 1, 1, 0, 1, 0]",107,48,59,1,6,0.020833333333333332,0.1016949152542373
"[1, 0, 0, 0, 0, 1, 1, 1, 1, 0, 0, 0, 1, 0, 1]",238,74,164,7,9,0.0945945945945946,0.054878048780487805
"[1, 1, 0, 0, 1, 0, 1, 0, 1, 1, 0, 0, 0, 0, 0]",187,98,89,7,14,0.07142857142857142,0.15730337078651685
"[1, 1, 1, 0, 0, 1, 0, 1, 0, 1, 1, 0, 0, 0, 0]",166,82,84,11,10,0.13414634146341464,0.11904761904761904
"[0, 1, 1, 1, 0, 1, 1, 0, 1, 1, 1, 0, 0, 1, 0]",141,65,76,3,8,0.046153846153846156,0.10526315789473684
"[1, 0, 1, 0, 0, 0, 1, 1, 0, 1, 1, 1, 1, 0, 0]",131,55,76,4,6,0.07272727272727272,0.07894736842105263
"[0, 1, 1, 1, 1, 0, 0, 1, 0, 1, 0, 1, 1, 0, 0]",174,97,77,8,2,0.08247422680412371,0.025974025974025976
"[0, 0, 0, 1, 1, 1, 1, 1, 1, 1, 0, 0, 1, 0, 0]",162,96,66,7,6,0.07291666666666667,0.09090909090909091
"[1, 0, 0, 0, 1, 1, 1, 1, 1, 1, 1, 0, 0, 1, 0]",184,73,111,6,8,0.0821917808219178,0.07207207207207207
"[0, 0, 1, 1, 1, 1, 0, 0, 0, 1, 1, 1, 0, 1, 1]",223,92,131,7,20,0.07608695652173914,0.15267175572519084
"[1, 1, 0, 1, 1, 0, 1, 1, 0, 0, 1, 1, 0, 1, 0]",136,58,78,6,6,0.10344827586206896,0.07692307692307693
"[0, 0, 1, 0, 0, 1, 0, 0, 1, 1, 0, 1, 1, 0, 1]",117,59,58,3,6,0.05084745762711865,0.10344827586206896
"[1, 1, 1, 0, 1, 0, 0, 0, 0, 1, 0, 0, 0, 0, 0]",290,179,111,27,9,0.15083798882681565,0.08108108108108109
"[0, 0, 0, 1, 1, 1, 0, 1, 0, 0, 0, 0, 1, 0, 0]",263,186,77,19,9,0.10215053763440861,0.11688311688311688
"[0, 1, 0, 0, 0, 0, 1, 1, 1, 0, 1, 0, 0, 0, 0]",301,187,114,22,8,0.11764705882352941,0.07017543859649122
"[1, 0, 1, 0, 1, 1, 1, 1, 1, 0, 1, 1, 0, 0, 1]",284,86,198,5,20,0.05813953488372093,0.10101010101010101
"[0, 1, 0, 0, 1, 1, 1, 1, 0, 1, 0, 1, 1, 0, 1]",148,71,77,7,10,0.09859154929577464,0.12987012987012986
"[1, 1, 0, 0, 0, 1, 0, 1, 1, 1, 0, 0, 0, 1, 1]",148,68,80,10,11,0.14705882352941177,0.1375
"[1, 0, 0, 0, 1, 0, 1, 1, 1, 1, 0, 0, 0, 1, 0]",121,60,61,5,6,0.08333333333333333,0.09836065573770492
"[1, 0, 1, 0, 0, 0, 1, 0, 1, 1, 1, 1, 0, 0, 0]",153,84,69,5,8,0.05952380952380952,0.11594202898550725
"[0, 1, 1, 0, 1, 0, 0, 0, 1, 0, 1, 1, 1, 1, 0]",118,61,57,3,5,0.04918032786885246,0.08771929824561403
"[0, 1, 1, 1, 0, 0, 0, 0, 1, 1, 0, 1, 1, 1, 1]",234,102,132,8,15,0.0784313725490196,0.11363636363636363
"[1, 0, 1, 0, 1, 1, 1, 0, 0, 0, 0, 1, 1, 0, 1]",135,61,74,7,3,0.11475409836065574,0.04054054054054054
"[0, 0, 1, 0, 0, 1, 0, 0, 0, 1, 1, 1, 0, 1, 1]",110,62,48,6,4,0.0967741935483871,0.08333333333333333
"[0, 1, 1, 1, 0, 1, 1, 0, 1, 0, 1, 1, 0, 0, 0]",127,59,68,5,6,0.0847457627118644,0.08823529411764706
"[0, 0, 1, 0, 1, 0, 0, 0, 0, 1, 0, 0, 1, 1, 1]",229,139,90,13,11,0.09352517985611511,0.12222222222222222
"[0, 0, 1, 0, 1, 0, 0, 0, 0, 1, 0, 1, 1, 1, 1]",142,79,63,9,9,0.11392405063291139,0.14285714285714285
"[1, 1, 1, 1, 0, 0, 1, 1, 0, 1, 0, 0, 0, 1, 0]",139,73,66,7,6,0.0958904109589041,0.09090909090909091
"[0, 1, 0, 0, 0, 1, 0, 1, 1, 0, 1, 1, 1, 1, 0]",138,73,65,8,7,0.1095890410958904,0.1076923076923077
"[1, 1, 0, 1, 1, 1, 0, 0, 0, 1, 0, 1, 1, 1, 1]",314,113,201,16,23,0.1415929203539823,0.11442786069651742
"[0, 0, 1, 0, 0, 0, 1, 1, 0, 1, 0, 1, 1, 1, 1]",157,72,85,13,13,0.18055555555555555,0.15294117647058825
"[0, 1, 0, 0, 0, 0, 0, 0, 1, 1, 0, 1, 0, 1, 0]",262,169,93,15,13,0.08875739644970414,0.13978494623655913
"[1, 0, 1, 0, 0, 1, 0, 0, 0, 1, 0, 1, 0, 1, 1]",104,53,51,6,3,0.11320754716981132,0.058823529411764705
"[1, 1, 1, 0, 1, 1, 1, 0, 0, 0, 1, 0, 1, 1, 1]",297,95,202,11,18,0.11578947368421053,0.0891089108910891
"[0, 0, 0, 0, 0, 1, 1, 0, 0, 1, 0, 1, 1, 1, 0]",200,139,61,14,2,0.10071942446043165,0.03278688524590164
"[1, 0, 1, 0, 0, 1, 0, 1, 0, 0, 1, 0, 1, 0, 0]",123,74,49,3,5,0.04054054054054054,0.10204081632653061
"[0, 1, 1, 1, 1, 0, 1, 1, 0, 0, 0, 1, 0, 0, 1]",119,65,54,6,6,0.09230769230769231,0.1111111111111111
"[0, 0, 1, 1, 1, 0, 1, 0, 1, 1, 0, 1, 1, 0, 1]",152,63,89,5,7,0.07936507936507936,0.07865168539325842
"[0, 1, 1, 1, 0, 0, 0, 1, 1, 1, 0, 1, 1, 1, 0]",153,57,96,5,8,0.08771929824561403,0.08333333333333333
"[1, 0, 0, 1, 0, 0, 0, 1, 0, 0, 0, 1, 1, 1, 1]",164,90,74,5,9,0.05555555555555555,0.12162162162162163
"[1, 1, 1, 0, 1, 0, 1, 1, 1, 1, 0, 0, 1, 0, 1]",256,81,175,10,11,0.12345679012345678,0.06285714285714286
"[1, 1, 0, 1, 1, 0, 1, 0, 1, 0, 1, 1, 1, 0, 1]",225,84,141,8,16,0.09523809523809523,0.11347517730496454
"[1, 1, 1, 0, 0, 1, 1, 0, 1, 0, 1, 0, 1, 1, 0]",143,55,88,2,9,0.03636363636363636,0.10227272727272728
"[0, 1, 1, 1, 1, 0, 0, 1, 1, 0, 1, 0, 1, 0, 1]",167,87,80,5,8,0.05747126436781609,0.1
"[0, 0, 0, 1, 1, 0, 1, 1, 0, 0, 1, 0, 0, 0, 1]",165,104,61,7,6,0.0673076923076923,0.09836065573770492
"[0, 1, 0, 0, 1, 1, 1, 0, 0, 1, 0, 0, 0, 0, 1]",152,93,59,14,3,0.15053763440860216,0.05084745762711865
"[1, 0, 0, 1, 0, 0, 0, 0, 1, 0, 0, 1, 1, 1, 0]",135,72,63,7,8,0.09722222222222222,0.12698412698412698
"[0, 1, 1, 0, 1, 1, 1, 1, 0, 1, 0, 1, 0, 1, 1]",242,86,156,15,19,0.1744186046511628,0.12179487179487179
"[0, 0, 1, 1, 1, 1, 1, 1, 1, 0, 0, 1, 0, 0, 0]",182,88,94,6,8,0.06818181818181818,0.0851063829787234
"[1, 1, 0, 1, 1, 0, 1, 1, 0, 0, 0, 0, 0, 1, 0]",113,65,48,7,5,0.1076923076923077,0.10416666666666667
"[0, 0, 0, 1, 1, 1, 0, 1, 1, 0, 0, 1, 1, 0, 1]",131,66,65,10,10,0.15151515151515152,0.15384615384615385
"[1, 0, 0, 0, 0, 0, 1, 1, 1, 0, 1, 1, 0, 0, 1]",142,62,80,4,7,0.06451612903225806,0.0875
"[1, 1, 1, 0, 1, 1, 1, 0, 0, 0, 0, 0, 0, 1, 1]",301,123,178,11,17,0.08943089430894309,0.09550561797752809
"[0, 1, 1, 1, 0, 1, 1, 1, 0, 0, 0, 0, 0, 0, 1]",197,103,94,6,9,0.05825242718446602,0.09574468085106383
"[1, 1, 0, 0, 0, 0, 0, 1, 0, 1, 1, 0, 0, 1, 1]",211,104,107,7,8,0.0673076923076923,0.07476635514018691
"[0, 1, 0, 1, 1, 0, 0, 0, 0, 0, 1, 0, 1, 1, 0]",155,92,63,6,4,0.06521739130434782,0.06349206349206349
"[1, 0, 1, 0, 1, 1, 0, 0, 0, 0, 0, 1, 0, 1, 1]",136,70,66,4,6,0.05714285714285714,0.09090909090909091
"[1, 1, 1, 0, 0, 1, 0, 0, 0, 1, 0, 1, 0, 1, 1]",111,56,55,9,4,0.16071428571428573,0.07272727272727272
"[1, 0, 1, 0, 1, 0, 0, 0, 1, 1, 1, 1, 1, 0, 1]",132,58,74,7,3,0.1206896551724138,0.04054054054054054
"[0, 1, 0, 0, 0, 1, 1, 0, 0, 1, 0, 1, 0, 0, 0]",242,161,81,18,8,0.11180124223602485,0.09876543209876543
"[0, 0, 1, 0, 1, 1, 1, 0, 1, 1, 0, 0, 1, 0, 0]",115,67,48,6,2,0.08955223880597014,0.041666666666666664
"[0, 0, 0, 1, 1, 1, 1, 0, 1, 1, 1, 1, 0, 1, 1]",312,156,156,17,8,0.10897435897435898,0.05128205128205128
"[0, 0, 0, 0, 1, 1, 1, 0, 0, 0, 1, 1, 1, 0, 1]",149,80,69,8,10,0.1,0.14492753623188406
"[1, 1, 0, 0, 0, 1, 0, 1, 0, 1, 0, 0, 0, 1, 0]",132,73,59,3,5,0.0410958904109589,0.0847457627118644
"[0, 0, 0, 1, 0, 1, 1, 1, 1, 0, 0, 0, 0, 1, 0]",163,88,75,7,1,0.07954545454545454,0.013333333333333334
"[1, 0, 0, 0, 0, 1, 1, 0, 1, 1, 1, 1, 0, 0, 0]",170,78,92,7,10,0.08974358974358974,0.10869565217391304
"[1, 1, 1, 0, 1, 1, 0, 0, 1, 0, 1, 1, 0, 1, 1]",250,81,169,8,13,0.09876543209876543,0.07692307692307693
"[1, 1, 0, 1, 0, 0, 0, 0, 1, 0, 0, 1, 1, 1, 0]",104,50,54,6,5,0.12,0.09259259259259259
"[1, 0, 1, 1, 1, 1, 1, 0, 0, 1, 0, 0, 0, 1, 1]",152,68,84,5,8,0.07352941176470588,0.09523809523809523
"[1, 1, 0, 1, 1, 1, 1, 1, 0, 0, 1, 0, 0, 0, 1]",135,55,80,10,9,0.18181818181818182,0.1125
"[1, 0, 0, 0, 1, 0, 0, 0, 1, 1, 1, 0, 1, 1, 1]",131,60,71,4,2,0.06666666666666667,0.028169014084507043
"[1, 1, 0, 0, 0, 1, 0, 0, 0, 1, 1, 1, 0, 1, 1]",127,55,72,5,4,0.09090909090909091,0.05555555555555555
"[0, 1, 0, 1, 0, 0, 1, 0, 0, 1, 1, 0, 0, 0, 1]",159,97,62,8,3,0.08247422680412371,0.04838709677419355
"[1, 1, 0, 0, 1, 1, 1, 0, 0, 1, 1, 1, 1, 0, 0]",379,144,235,11,21,0.0763888888888889,0.08936170212765958
"[0, 1, 1, 0, 0, 0, 0, 1, 1, 0, 1, 1, 1, 0, 0]",170,102,68,9,10,0.08823529411764706,0.14705882352941177
"[0, 1, 0, 1, 0, 1, 1, 0, 0, 0, 1, 0, 1, 1, 0]",130,71,59,5,6,0.07042253521126761,0.1016949152542373
"[0, 0, 1, 0, 0, 1, 1, 1, 0, 0, 0, 1, 1, 1, 1]",188,89,99,6,13,0.06741573033707865,0.13131313131313133
"[1, 1, 0, 0, 1, 1, 1, 1, 0, 0, 1, 1, 1, 0, 0]",422,187,235,20,15,0.10695187165775401,0.06382978723404255
"[0, 1, 1, 1, 0, 0, 0, 1, 0, 1, 1, 1, 1, 0, 1]",152,67,85,7,7,0.1044776119402985,0.08235294117647059
"[1, 1, 1, 0, 0, 1, 0, 0, 0, 1, 1, 0, 0, 0, 1]",129,67,62,10,4,0.14925373134328357,0.06451612903225806
"[1, 1, 1, 0, 1, 0, 0, 1, 1, 1, 0, 0, 1, 1, 0]",177,71,106,10,7,0.14084507042253522,0.0660377358490566
"[1, 0, 0, 1, 0, 1, 0, 1, 0, 0, 0, 1, 1, 1, 0]",115,60,55,4,3,0.06666666666666667,0.05454545454545454
"[1, 0, 0, 0, 1, 0, 1, 0, 1, 0, 1, 1, 0, 0, 0]",171,105,66,5,4,0.047619047619047616,0.06060606060606061
"[0, 1, 1, 1, 0, 1, 0, 1, 0, 1, 0, 0, 1, 0, 0]",109,57,52,6,6,0.10526315789473684,0.11538461538461539
"[0, 0, 0, 1, 1, 0, 1, 0, 0, 0, 0, 1, 0, 1, 1]",172,113,59,11,5,0.09734513274336283,0.0847457627118644
"[0, 1, 1, 1, 1, 0, 1, 0, 0, 0, 0, 1, 1, 1, 0]",126,67,59,5,6,0.07462686567164178,0.1016949152542373
"[1, 0, 0, 0, 0, 1, 1, 1, 0, 1, 1, 0, 0, 1, 0]",123,61,62,8,5,0.13114754098360656,0.08064516129032258
"[1, 1, 1, 1, 1, 0, 0, 0, 0, 1, 0, 1, 1, 0, 1]",199,51,148,6,11,0.11764705882352941,0.07432432432432433
"[0, 0, 0, 0, 0, 0, 0, 0, 1, 1, 1, 1, 0, 1, 0]",595,401,194,31,18,0.0773067331670823,0.09278350515463918
"[0, 1, 0, 1, 0, 1, 1, 0, 0, 1, 0, 0, 1, 0, 0]",149,93,56,5,2,0.053763440860215055,0.03571428571428571
"[0, 0, 1, 1, 1, 1, 0, 0, 0, 1, 1, 0, 1, 0, 1]",168,70,98,6,7,0.08571428571428572,0.07142857142857142
"[0, 0, 1, 0, 1, 1, 0, 0, 1, 0, 0, 0, 0, 1, 1]",227,133,94,14,8,0.10526315789473684,0.0851063829787234
"[0, 1, 1, 0, 0, 1, 0, 1, 1, 0, 0, 1, 0, 0, 0]",181,110,71,9,6,0.08181818181818182,0.08450704225352113
"[0, 0, 0, 0, 1, 1, 0, 1, 1, 0, 1, 0, 0, 1, 0]",148,84,64,12,7,0.14285714285714285,0.109375
"[1, 1, 0, 0, 1, 0, 1, 1, 0, 0, 0, 1, 0, 0, 0]",141,81,60,6,12,0.07407407407407407,0.2
"[1, 0, 1, 0, 1, 0, 0, 1, 1, 1, 1, 0, 0, 0, 1]",141,72,69,7,6,0.09722222222222222,0.08695652173913043
"[1, 1, 0, 0, 1, 0, 0, 1, 0, 0, 1, 0, 1, 1, 0]",126,57,69,7,5,0.12280701754385964,0.07246376811594203
"[0, 1, 1, 0, 1, 1, 0, 0, 0, 1, 1, 1, 0, 1, 0]",96,41,55,4,5,0.0975609756097561,0.09090909090909091
"[0, 1, 0, 0, 1, 1, 0, 0, 1, 0, 1, 1, 0, 1, 1]",120,70,50,7,5,0.1,0.1
"[0, 1, 1, 1, 1, 1, 1, 0, 0, 1, 0, 1, 1, 0, 0]",188,89,99,12,13,0.1348314606741573,0.13131313131313133
"[0, 1, 0, 1, 1, 0, 0, 1, 1, 0, 1, 0, 1, 0, 1]",114,47,67,5,4,0.10638297872340426,0.05970149253731343
"[0, 1, 1, 1, 1, 0, 1, 0, 0, 0, 1, 1, 0, 1, 1]",155,75,80,6,9,0.08,0.1125
"[0, 1, 1, 0, 1, 0, 1, 1, 1, 1, 0, 0, 0, 0, 1]",218,89,129,8,10,0.0898876404494382,0.07751937984496124
"[1, 0, 0, 0, 1, 1, 0, 0, 1, 1, 0, 1, 1, 0, 0]",133,78,55,4,3,0.05128205128205128,0.05454545454545454
"[0, 1, 0, 1, 0, 0, 0, 0, 1, 0, 1, 0, 0, 1, 1]",172,96,76,8,11,0.08333333333333333,0.14473684210526316
"[1, 1, 0, 0, 1, 0, 0, 1, 0, 0, 1, 1, 1, 0, 1]",115,54,61,4,2,0.07407407407407407,0.03278688524590164
"[1, 0, 1, 0, 0, 0, 0, 1, 1, 0, 1, 0, 1, 1, 1]",145,75,70,7,5,0.09333333333333334,0.07142857142857142
"[0, 0, 0, 1, 0, 0, 1, 0, 1, 1, 0, 1, 0, 1, 0]",123,75,48,11,8,0.14666666666666667,0.16666666666666666
"[0, 0, 1, 1, 0, 0, 0, 1, 0, 0, 1, 0, 1, 0, 0]",286,192,94,21,4,0.109375,0.0425531914893617
"[1, 0, 0, 1, 0, 1, 1, 0, 0, 0, 0, 0, 1, 0, 1]",144,89,55,3,4,0.033707865168539325,0.07272727272727272
"[0, 1, 0, 1, 1, 1, 0, 0, 1, 0, 0, 1, 0, 0, 0]",148,80,68,10,3,0.125,0.04411764705882353
"[1, 0, 1, 0, 1, 1, 1, 0, 0, 1, 0, 0, 1, 0, 0]",123,69,54,6,8,0.08695652173913043,0.14814814814814814
"[0, 1, 1, 1, 1, 1, 1, 0, 0, 1, 0, 1, 1, 0, 1]",297,160,137,16,9,0.1,0.06569343065693431
"[0, 0, 1, 0, 1, 0, 0, 0, 0, 1, 1, 0, 1, 1, 1]",153,79,74,8,7,0.10126582278481013,0.0945945945945946
"[0, 0, 0, 1, 0, 1, 1, 0, 1, 0, 1, 1, 0, 0, 0]",159,98,61,5,4,0.05102040816326531,0.06557377049180328
"[1, 0, 0, 0, 1, 0, 1, 1, 0, 0, 0, 0, 0, 0, 1]",359,218,141,19,16,0.0871559633027523,0.11347517730496454
"[1, 1, 0, 0, 0, 1, 0, 1, 0, 1, 1, 0, 1, 1, 1]",190,81,109,11,8,0.13580246913580246,0.07339449541284404
"[0, 0, 1, 1, 1, 0, 0, 1, 1, 0, 0, 1, 1, 1, 0]",162,69,93,7,11,0.10144927536231885,0.11827956989247312
"[1, 1, 0, 0, 0, 1, 0, 0, 1, 1, 0, 1, 0, 0, 0]",150,82,68,15,4,0.18292682926829268,0.058823529411764705
"[0, 0, 1, 0, 1, 1, 1, 0, 0, 0, 1, 0, 0, 1, 1]",131,80,51,8,6,0.1,0.11764705882352941
"[1, 1, 0, 1, 1, 0, 1, 1, 1, 0, 0, 1, 0, 0, 0]",111,48,63,0,7,0.0,0.1111111111111111
"[1, 0, 0, 0, 1, 1, 1, 1, 1, 1, 0, 0, 0, 1, 0]",153,62,91,3,9,0.04838709677419355,0.0989010989010989
"[0, 1, 1, 1, 0, 1, 0, 1, 1, 1, 1, 0, 0, 1, 1]",399,172,227,16,25,0.09302325581395349,0.11013215859030837
"[0, 0, 1, 1, 0, 0, 1, 1, 1, 0, 1, 0, 0, 1, 0]",151,77,74,8,5,0.1038961038961039,0.06756756756756757
"[0, 0, 1, 0, 1, 0, 1, 1, 1, 1, 0, 0, 0, 1, 0]",119,63,56,9,3,0.14285714285714285,0.05357142857142857
"[1, 0, 1, 0, 1, 1, 0, 0, 1, 0, 1, 1, 0, 0, 0]",131,69,62,6,12,0.08695652173913043,0.1935483870967742
"[1, 1, 0, 1, 0, 0, 1, 0, 1, 1, 0, 1, 1, 0, 0]",127,50,77,4,9,0.08,0.11688311688311688
"[0, 1, 1, 0, 0, 1, 1, 1, 0, 0, 1, 0, 0, 0, 1]",139,85,54,8,2,0.09411764705882353,0.037037037037037035
"[1, 0, 0, 0, 1, 1, 1, 0, 0, 0, 1, 1, 0, 0, 0]",205,112,93,9,7,0.08035714285714286,0.07526881720430108
"[0, 1, 1, 0, 0, 1, 1, 0, 1, 1, 1, 1, 1, 0, 1]",290,135,155,9,13,0.06666666666666667,0.08387096774193549
"[0, 1, 1, 0, 0, 1, 0, 1, 0, 1, 1, 0, 1, 1, 0]",91,40,51,3,3,0.075,0.058823529411764705
"[0, 1, 0, 0, 1, 1, 0, 0, 1, 0, 1, 1, 0, 0, 1]",124,58,66,5,6,0.08620689655172414,0.09090909090909091
"[1, 1, 0, 0, 0, 0, 1, 1, 1, 1, 1, 0, 0, 0, 1]",240,107,133,12,7,0.11214953271028037,0.05263157894736842
"[0, 1, 1, 0, 0, 1, 0, 1, 1, 1, 0, 1, 1, 1, 0]",157,67,90,7,6,0.1044776119402985,0.06666666666666667
"[0, 0, 1, 1, 0, 0, 1, 0, 1, 1, 1, 0, 1, 1, 1]",224,104,120,10,13,0.09615384615384616,0.10833333333333334
"[1, 0, 0, 1, 0, 1, 0, 1, 0, 1, 0, 0, 0, 1, 1]",110,55,55,3,3,0.05454545454545454,0.05454545454545454
"[0, 0, 0, 1, 0, 0, 1, 0, 1, 0, 1, 0, 1, 0, 0]",242,152,90,15,9,0.09868421052631579,0.1
"[1, 1, 0, 1, 1, 1, 0, 1, 1, 0, 1, 0, 0, 0, 0]",139,59,80,8,10,0.13559322033898305,0.125
"[0, 1, 1, 0, 1, 0, 0, 0, 0, 1, 0, 1, 0, 1, 1]",123,69,54,5,6,0.07246376811594203,0.1111111111111111
"[0, 0, 0, 1, 1, 0, 1, 0, 0, 0, 0, 0, 1, 0, 1]",267,166,101,18,8,0.10843373493975904,0.07920792079207921
"[0, 1, 0, 1, 0, 0, 1, 0, 1, 1, 0, 1, 0, 1, 0]",101,51,50,7,8,0.13725490196078433,0.16
"[0, 1, 1, 1, 0, 1, 0, 1, 0, 0, 0, 0, 0, 1, 0]",137,79,58,5,5,0.06329113924050633,0.08620689655172414
"[1, 0, 0, 1, 0, 1, 1, 0, 1, 0, 0, 1, 0, 1, 1]",103,44,59,8,3,0.18181818181818182,0.05084745762711865
"[0, 0, 0, 0, 1, 1, 1, 0, 1, 1, 0, 0, 0, 0, 1]",209,122,87,9,8,0.07377049180327869,0.09195402298850575
"[1, 0, 1, 0, 0, 1, 1, 1, 1, 0, 1, 1, 1, 1, 0]",278,93,185,8,11,0.08602150537634409,0.05945945945945946
"[0, 1, 0, 1, 1, 0, 0, 0, 1, 1, 0, 1, 1, 1, 0]",100,52,48,5,7,0.09615384615384616,0.14583333333333334
"[0, 1, 0, 0, 1, 0, 1, 1, 0, 1, 1, 1, 0, 0, 0]",127,72,55,9,5,0.125,0.09090909090909091
"[1, 0, 1, 1, 0, 1, 1, 0, 0, 1, 0, 1, 0, 0, 1]",118,53,65,4,3,0.07547169811320754,0.046153846153846156
"[0, 0, 1, 0, 1, 1, 0, 0, 1, 0, 1, 1, 1, 1, 0]",131,67,64,9,4,0.13432835820895522,0.0625
"[1, 1, 1, 1, 1, 1, 1, 0, 1, 0, 0, 1, 0, 0, 0]",160,57,103,4,15,0.07017543859649122,0.14563106796116504
"[1, 1, 0, 1, 0, 1, 0, 1, 1, 0, 0, 0, 0, 0, 0]",212,104,108,9,6,0.08653846153846154,0.05555555555555555
"[1, 0, 1, 0, 0, 1, 1, 0, 0, 0, 1, 1, 0, 1, 0]",106,59,47,4,4,0.06779661016949153,0.0851063829787234
"[0, 0, 1, 1, 0, 0, 0, 1, 1, 0, 1, 0, 0, 1, 0]",159,97,62,11,7,0.1134020618556701,0.11290322580645161
"[1, 0, 0, 0, 1, 1, 1, 0, 0, 1, 0, 1, 1, 0, 0]",129,72,57,5,5,0.06944444444444445,0.08771929824561403
"[1, 1, 0, 0, 0, 1, 1, 0, 0, 1, 1, 1, 1, 1, 0]",198,95,103,8,7,0.08421052631578947,0.06796116504854369
"[0, 1, 0, 1, 1, 0, 0, 1, 0, 0, 1, 1, 0, 0, 0]",175,100,75,5,6,0.05,0.08
"[0, 1, 1, 1, 1, 1, 1, 0, 0, 1, 1, 1, 0, 1, 0]",386,223,163,19,16,0.08520179372197309,0.09815950920245399
"[0, 0, 0, 0, 1, 0, 1, 1, 0, 1, 1, 0, 0, 0, 0]",299,192,107,22,9,0.11458333333333333,0.08411214953271028
"[1, 1, 1, 0, 1, 1, 1, 0, 1, 1, 0, 1, 0, 0, 1]",240,92,148,8,19,0.08695652173913043,0.12837837837837837
"[1, 0, 1, 0, 0, 0, 0, 1, 0, 1, 0, 1, 0, 1, 0]",137,85,52,5,4,0.058823529411764705,0.07692307692307693
"[1, 1, 0, 1, 1, 1, 1, 1, 0, 1, 0, 0, 1, 0, 0]",152,59,93,6,7,0.1016949152542373,0.07526881720430108
"[1, 1, 0, 1, 0, 0, 0, 1, 1, 0, 1, 1, 0, 0, 1]",126,61,65,7,8,0.11475409836065574,0.12307692307692308
"[0, 1, 0, 1, 0, 1, 1, 0, 1, 0, 1, 1, 0, 1, 1]",128,49,79,4,5,0.08163265306122448,0.06329113924050633
"[0, 0, 0, 0, 1, 0, 0, 1, 0, 1, 0, 1, 0, 1, 1]",181,111,70,16,8,0.14414414414414414,0.11428571428571428
"[0, 1, 0, 1, 0, 1, 0, 0, 1, 0, 1, 0, 1, 0, 0]",150,74,76,7,6,0.0945945945945946,0.07894736842105263
"[0, 0, 0, 0, 1, 0, 1, 1, 1, 1, 1, 1, 0, 0, 0]",250,147,103,11,11,0.07482993197278912,0.10679611650485436
"[1, 1, 1, 1, 0, 1, 1, 0, 0, 0, 1, 0, 1, 0, 1]",150,53,97,8,6,0.1509433962264151,0.061855670103092786
"[1, 0, 0, 1, 0, 1, 1, 0, 1, 0, 1, 1, 1, 0, 1]",138,56,82,3,7,0.05357142857142857,0.08536585365853659
"[1, 0, 1, 1, 1, 1, 0, 0, 1, 0, 0, 1, 0, 1, 1]",154,64,90,4,4,0.0625,0.044444444444444446
"[1, 1, 1, 0, 0, 1, 0, 1, 1, 0, 0, 0, 0, 1, 1]",198,71,127,12,9,0.16901408450704225,0.07086614173228346
"[1, 1, 1, 1, 1, 0, 0, 1, 0, 1, 1, 0, 0, 0, 0]",185,76,109,9,8,0.11842105263157894,0.07339449541284404
"[0, 0, 1, 1, 1, 1, 1, 1, 0, 1, 0, 0, 0, 0, 1]",187,89,98,6,12,0.06741573033707865,0.12244897959183673
"[0, 1, 1, 0, 1, 0, 0, 1, 1, 1, 1, 1, 1, 1, 0]",312,120,192,11,16,0.09166666666666666,0.08333333333333333
"[0, 1, 1, 1, 0, 0, 0, 0, 0, 1, 1, 1, 0, 0, 0]",183,104,79,7,8,0.0673076923076923,0.10126582278481013
"[0, 0, 0, 1, 1, 1, 1, 1, 0, 1, 0, 0, 1, 0, 0]",128,74,54,4,6,0.05405405405405406,0.1111111111111111
"[0, 1, 1, 0, 1, 1, 1, 1, 1, 0, 0, 0, 0, 0, 1]",168,97,71,10,3,0.10309278350515463,0.04225352112676056
"[0, 1, 0, 1, 1, 1, 0, 0, 1, 1, 1, 1, 0, 0, 1]",357,158,199,16,15,0.10126582278481013,0.07537688442211055
"[0, 0, 1, 0, 1, 1, 1, 0, 0, 0, 0, 1, 1, 0, 1]",129,75,54,10,7,0.13333333333333333,0.12962962962962962
"[1, 0, 0, 0, 1, 1, 0, 1, 1, 0, 0, 1, 1, 1, 1]",291,109,182,13,22,0.11926605504587157,0.12087912087912088
"[0, 1, 0, 1, 0, 0, 1, 0, 0, 0, 1, 0, 1, 1, 0]",142,78,64,5,12,0.0641025641025641,0.1875
"[1, 0, 1, 0, 1, 0, 1, 0, 0, 0, 1, 1, 1, 0, 0]",126,62,64,3,7,0.04838709677419355,0.109375
"[1, 0, 0, 1, 0, 1, 0, 1, 1, 1, 1, 0, 1, 0, 0]",106,48,58,4,5,0.08333333333333333,0.08620689655172414
"[1, 1, 0, 0, 1, 0, 0, 1, 1, 0, 1, 1, 0, 0, 0]",151,73,78,8,7,0.1095890410958904,0.08974358974358974
"[1, 0, 1, 0, 1, 0, 1, 1, 1, 0, 1, 0, 0, 0, 0]",106,63,43,5,4,0.07936507936507936,0.09302325581395349
"[1, 1, 1, 1, 0, 0, 0, 1, 0, 1, 0, 1, 1, 0, 1]",157,69,88,11,9,0.15942028985507245,0.10227272727272728
"[1, 1, 1, 1, 0, 1, 1, 0, 0, 1, 1, 1, 0, 0, 0]",186,71,115,8,10,0.11267605633802817,0.08695652173913043
"[1, 1, 0, 1, 0, 0, 1, 1, 1, 1, 0, 0, 0, 0, 1]",273,123,150,13,15,0.10569105691056911,0.1
"[1, 0, 0, 1, 1, 1, 0, 1, 0, 1, 0, 1, 0, 0, 1]",117,48,69,8,7,0.16666666666666666,0.10144927536231885
"[1, 1, 0, 1, 0, 0, 0, 1, 1, 1, 1, 0, 1, 0, 0]",112,48,64,8,4,0.16666666666666666,0.0625
"[0, 1, 0, 1, 1, 0, 1, 1, 1, 0, 0, 1, 0, 1, 1]",139,60,79,5,5,0.08333333333333333,0.06329113924050633
"[0, 1, 0, 1, 0, 1, 0, 0, 0, 1, 0, 0, 1, 1, 1]",156,89,67,9,6,0.10112359550561797,0.08955223880597014
"[0, 1, 1, 0, 0, 1, 0, 1, 1, 0, 1, 1, 1, 1, 0]",169,66,103,8,10,0.12121212121212122,0.0970873786407767
"[1, 1, 0, 0, 0, 1, 1, 1, 1, 0, 0, 0, 1, 0, 1]",135,65,70,6,4,0.09230769230769231,0.05714285714285714
"[0, 1, 0, 0, 0, 0, 0, 0, 1, 0, 1, 1, 0, 0, 1]",244,152,92,17,8,0.1118421052631579,0.08695652173913043
"[1, 1, 0, 1, 1, 0, 1, 0, 0, 1, 0, 0, 1, 0, 0]",100,56,44,5,5,0.08928571428571429,0.11363636363636363
"[0, 0, 1, 0, 1, 1, 1, 1, 1, 0, 1, 0, 1, 0, 1]",135,55,80,4,13,0.07272727272727272,0.1625
"[1, 1, 0, 0, 1, 0, 0, 1, 0, 0, 1, 1, 1, 1, 0]",179,82,97,13,10,0.15853658536585366,0.10309278350515463
"[0, 1, 0, 1, 0, 1, 0, 1, 1, 0, 0, 1, 1, 0, 0]",162,80,82,11,8,0.1375,0.0975609756097561
"[1, 1, 1, 0, 0, 0, 0, 0, 1, 0, 1, 1, 1, 1, 0]",136,59,77,3,6,0.05084745762711865,0.07792207792207792
"[0, 0, 0, 0, 1, 0, 0, 1, 0, 0, 1, 0, 1, 0, 1]",243,158,85,16,4,0.10126582278481013,0.047058823529411764
"[0, 1, 1, 1, 0, 1, 0, 1, 1, 1, 0, 0, 1, 1, 0]",194,107,87,6,5,0.056074766355140186,0.05747126436781609
"[1, 1, 0, 1, 0, 1, 1, 0, 0, 1, 0, 1, 1, 0, 1]",141,60,81,7,9,0.11666666666666667,0.1111111111111111
"[0, 1, 1, 1, 0, 0, 1, 1, 0, 0, 1, 0, 1, 1, 1]",213,93,120,15,11,0.16129032258064516,0.09166666666666666
"[1, 0, 0, 0, 1, 1, 0, 0, 0, 1, 1, 0, 0, 0, 1]",169,97,72,11,8,0.1134020618556701,0.1111111111111111
"[0, 0, 0, 1, 1, 0, 1, 0, 0, 1, 1, 1, 1, 1, 1]",307,152,155,12,13,0.07894736842105263,0.08387096774193549
"[1, 1, 1, 0, 1, 0, 0, 0, 1, 1, 0, 1, 0, 0, 1]",118,56,62,6,8,0.10714285714285714,0.12903225806451613
"[1, 1, 0, 1, 1, 1, 0, 0, 1, 0, 0, 0, 1, 0, 1]",110,48,62,4,4,0.08333333333333333,0.06451612903225806
"[0, 0, 0, 0, 0, 1, 1, 0, 1, 0, 1, 1, 1, 1, 0]",161,97,64,8,7,0.08247422680412371,0.109375
"[1, 0, 1, 1, 1, 0, 1, 0, 0, 1, 1, 0, 1, 0, 0]",124,48,76,3,8,0.0625,0.10526315789473684
"[1, 1, 0, 1, 1, 1, 1, 0, 0, 0, 0, 0, 1, 0, 1]",142,70,72,4,7,0.05714285714285714,0.09722222222222222
"[1, 0, 0, 1, 1, 1, 0, 1, 0, 0, 1, 0, 1, 1, 0]",103,38,65,6,5,0.15789473684210525,0.07692307692307693
"[1, 0, 0, 1, 1, 0, 1, 0, 1, 0, 0, 1, 1, 1, 0]",100,48,52,5,4,0.10416666666666667,0.07692307692307693
"[1, 1, 0, 0, 1, 1, 0, 1, 0, 1, 0, 0, 1, 1, 1]",240,96,144,8,19,0.08333333333333333,0.13194444444444445
"[0, 1, 0, 1, 0, 1, 0, 0, 1, 0, 1, 1, 1, 0, 0]",109,61,48,6,4,0.09836065573770492,0.08333333333333333
"[0, 1, 0, 0, 1, 0, 1, 1, 1, 0, 0, 0, 0, 1, 0]",126,69,57,9,5,0.13043478260869565,0.08771929824561403
"[0, 0, 1, 1, 1, 0, 1, 1, 1, 1, 0, 0, 0, 0, 1]",252,120,132,10,13,0.08333333333333333,0.09848484848484848
"[1, 1, 0, 0, 0, 0, 1, 0, 0, 0, 1, 0, 0, 1, 1]",223,143,80,15,9,0.1048951048951049,0.1125
"[1, 1, 0, 0, 0, 0, 0, 1, 1, 0, 1, 1, 0, 0, 1]",161,93,68,12,4,0.12903225806451613,0.058823529411764705
"[0, 0, 1, 1, 1, 0, 1, 1, 1, 1, 1, 0, 1, 0, 0]",144,66,78,9,6,0.13636363636363635,0.07692307692307693
"[1, 0, 0, 1, 0, 0, 0, 1, 0, 0, 1, 1, 0, 1, 0]",116,67,49,6,3,0.08955223880597014,0.061224489795918366
"[0, 1, 0, 1, 0, 1, 0, 1, 0, 1, 0, 0, 1, 1, 0]",139,64,75,11,4,0.171875,0.05333333333333334
"[1, 0, 0, 0, 0, 1, 0, 0, 1, 0, 1, 0, 1, 0, 0]",204,131,73,21,4,0.16030534351145037,0.0547945205479452
"[1, 0, 0, 0, 1, 1, 0, 1, 0, 1, 1, 0, 0, 0, 1]",119,65,54,10,5,0.15384615384615385,0.09259259259259259
"[1, 1, 0, 0, 1, 1, 0, 1, 0, 0, 1, 0, 0, 0, 0]",189,117,72,14,9,0.11965811965811966,0.125
"[0, 1, 1, 0, 0, 0, 1, 0, 0, 1, 0, 1, 0, 0, 1]",162,94,68,13,7,0.13829787234042554,0.10294117647058823
"[1, 0, 1, 1, 1, 1, 0, 0, 0, 0, 1, 0, 0, 1, 1]",164,71,93,5,10,0.07042253521126761,0.10752688172043011
"[0, 0, 0, 1, 1, 1, 1, 0, 1, 1, 0, 0, 1, 1, 0]",162,89,73,10,9,0.11235955056179775,0.1232876712328767
"[1, 0, 1, 0, 0, 0, 1, 0, 0, 0, 1, 1, 0, 0, 0]",309,194,115,12,7,0.061855670103092786,0.06086956521739131
"[1, 0, 0, 0, 0, 0, 1, 1, 1, 0, 1, 1, 0, 1, 1]",144,62,82,2,11,0.03225806451612903,0.13414634146341464
"[1, 1, 1, 1, 0, 0, 1, 0, 0, 1, 1, 1, 0, 1, 0]",151,60,91,4,11,0.06666666666666667,0.12087912087912088
"[1, 1, 1, 1, 0, 0, 0, 1, 1, 0, 0, 1, 0, 0, 1]",134,63,71,10,6,0.15873015873015872,0.08450704225352113
"[1, 1, 1, 1, 0, 0, 1, 0, 0, 1, 1, 1, 0, 0, 0]",172,78,94,11,12,0.14102564102564102,0.1276595744680851
"[0, 0, 1, 0, 1, 0, 1, 0, 1, 0, 0, 0, 1, 1, 0]",151,89,62,10,4,0.11235955056179775,0.06451612903225806
"[0, 0, 1, 1, 1, 1, 0, 0, 0, 1, 1, 0, 1, 1, 0]",145,66,79,9,5,0.13636363636363635,0.06329113924050633
"[0, 0, 0, 1, 1, 1, 0, 1, 0, 1, 1, 0, 1, 0, 1]",131,68,63,8,5,0.11764705882352941,0.07936507936507936
"[0, 1, 1, 0, 1, 1, 0, 1, 1, 1, 0, 0, 1, 0, 0]",106,59,47,5,1,0.0847457627118644,0.02127659574468085
"[0, 0, 1, 0, 0, 1, 1, 1, 0, 1, 1, 0, 1, 0, 0]",111,52,59,4,4,0.07692307692307693,0.06779661016949153
"[1, 0, 1, 1, 1, 1, 0, 1, 0, 0, 1, 0, 1, 0, 0]",110,46,64,4,8,0.08695652173913043,0.125
"[0, 1, 1, 1, 1, 0, 1, 1, 0, 1, 0, 0, 0, 1, 0]",118,60,58,11,7,0.18333333333333332,0.1206896551724138
"[1, 1, 0, 0, 0, 0, 1, 1, 1, 0, 1, 1, 0, 0, 1]",197,88,109,9,9,0.10227272727272728,0.08256880733944955
"[1, 1, 1, 0, 1, 0, 0, 0, 0, 1, 0, 0, 0, 1, 0]",145,90,55,9,6,0.1,0.10909090909090909
"[1, 0, 1, 1, 0, 0, 1, 0, 0, 0, 0, 1, 1, 1, 1]",242,107,135,8,11,0.07476635514018691,0.08148148148148149
"[0, 0, 1, 1, 1, 1, 1, 0, 0, 0, 1, 1, 0, 1, 1]",219,82,137,5,15,0.06097560975609756,0.10948905109489052
"[1, 1, 0, 1, 0, 0, 1, 1, 0, 0, 0, 1, 1, 0, 0]",141,85,56,5,5,0.058823529411764705,0.08928571428571429
"[1, 1, 1, 0, 1, 1, 0, 0, 1, 0, 1, 0, 0, 0, 1]",107,56,51,5,6,0.08928571428571429,0.11764705882352941
"[0, 1, 1, 1, 1, 0, 1, 1, 0, 0, 1, 0, 1, 0, 0]",114,53,61,5,2,0.09433962264150944,0.03278688524590164
"[0, 1, 1, 0, 0, 1, 1, 1, 1, 0, 1, 1, 0, 0, 1]",226,137,89,7,11,0.051094890510948905,0.12359550561797752
"[1, 0, 1, 0, 1, 1, 0, 0, 0, 1, 0, 0, 0, 0, 0]",257,149,108,11,6,0.0738255033557047,0.05555555555555555
"[0, 1, 1, 1, 0, 0, 0, 1, 1, 0, 1, 0, 1, 0, 1]",87,42,45,6,8,0.14285714285714285,0.17777777777777778
"[1, 0, 0, 1, 1, 1, 0, 0, 0, 1, 1, 0, 1, 0, 1]",91,41,50,5,5,0.12195121951219512,0.1
"[1, 0, 1, 0, 1, 0, 0, 1, 1, 0, 0, 1, 0, 0, 0]",158,83,75,13,6,0.1566265060240964,0.08
"[0, 0, 1, 1, 1, 0, 1, 1, 1, 1, 0, 0, 1, 0, 0]",123,59,64,5,4,0.0847457627118644,0.0625
"[1, 0, 1, 1, 1, 0, 1, 1, 0, 0, 0, 1, 0, 0, 1]",115,55,60,2,7,0.03636363636363636,0.11666666666666667
"[1, 1, 1, 1, 0, 0, 1, 1, 0, 1, 0, 1, 0, 0, 0]",163,74,89,9,12,0.12162162162162163,0.1348314606741573
"[0, 1, 0, 1, 1, 0, 0, 1, 0, 1, 1, 0, 1, 1, 0]",97,36,61,3,9,0.08333333333333333,0.14754098360655737
"[1, 0, 0, 1, 0, 1, 0, 0, 1, 0, 0, 0, 1, 0, 0]",223,133,90,13,11,0.09774436090225563,0.12222222222222222
"[0, 1, 1, 1, 1, 0, 1, 1, 0, 0, 0, 0, 0, 1, 0]",121,69,52,6,1,0.08695652173913043,0.019230769230769232
"[0, 0, 1, 0, 1, 0, 1, 0, 0, 1, 1, 1, 0, 0, 1]",112,56,56,5,8,0.08928571428571429,0.14285714285714285
"[1, 1, 1, 0, 1, 1, 0, 1, 1, 0, 1, 1, 0, 1, 0]",197,54,143,4,18,0.07407407407407407,0.1258741258741259
"[0, 0, 0, 0, 1, 0, 0, 1, 1, 1, 1, 0, 0, 1, 0]",187,100,87,8,11,0.08,0.12643678160919541
"[0, 0, 1, 0, 0, 0, 0, 0, 1, 0, 0, 1, 1, 1, 1]",271,170,101,22,9,0.12941176470588237,0.0891089108910891
"[0, 1, 0, 1, 1, 0, 1, 1, 0, 0, 0, 0, 0, 0, 1]",225,130,95,9,10,0.06923076923076923,0.10526315789473684
"[0, 1, 0, 1, 0, 0, 0, 1, 0, 1, 0, 0, 1, 1, 1]",144,81,63,5,6,0.06172839506172839,0.09523809523809523
"[0, 1, 1, 0, 1, 0, 1, 0, 0, 0, 0, 0, 0, 1, 0]",210,144,66,21,4,0.14583333333333334,0.06060606060606061
"[1, 0, 0, 0, 1, 1, 1, 1, 0, 0, 0, 0, 0, 1, 0]",162,96,66,4,4,0.041666666666666664,0.06060606060606061
"[0, 0, 1, 0, 1, 1, 1, 1, 1, 1, 1, 0, 0, 0, 0]",321,155,166,18,9,0.11612903225806452,0.05421686746987952
"[0, 1, 0, 1, 0, 0, 1, 0, 0, 0, 1, 0, 0, 1, 0]",226,151,75,17,7,0.11258278145695365,0.09333333333333334
"[0, 1, 0, 0, 0, 1, 0, 1, 1, 0, 1, 1, 1, 0, 1]",99,56,43,4,1,0.07142857142857142,0.023255813953488372
"[1, 0, 1, 0, 1, 1, 0, 1, 1, 1, 0, 1, 0, 0, 1]",138,60,78,6,4,0.1,0.05128205128205128
"[0, 1, 0, 1, 1, 0, 1, 0, 1, 0, 1, 1, 0, 0, 1]",114,57,57,8,4,0.14035087719298245,0.07017543859649122
"[1, 0, 1, 1, 0, 1, 0, 0, 0, 1, 1, 0, 1, 0, 1]",104,58,46,2,4,0.034482758620689655,0.08695652173913043
"[0, 1, 1, 0, 1, 0, 0, 1, 1, 0, 0, 1, 0, 1, 1]",137,77,60,8,6,0.1038961038961039,0.1
"[1, 0, 1, 0, 0, 1, 0, 1, 0, 0, 1, 0, 0, 0, 1]",144,86,58,8,7,0.09302325581395349,0.1206896551724138
"[1, 0, 0, 1, 1, 0, 1, 1, 0, 0, 0, 0, 1, 0, 0]",131,76,55,8,7,0.10526315789473684,0.12727272727272726
"[1, 0, 0, 0, 0, 1, 0, 1, 1, 0, 1, 1, 1, 0, 0]",125,56,69,6,7,0.10714285714285714,0.10144927536231885
"[0, 1, 1, 1, 0, 1, 1, 1, 0, 0, 0, 1, 1, 1, 0]",142,60,82,8,12,0.13333333333333333,0.14634146341463414
"[1, 0, 1, 0, 1, 1, 0, 0, 1, 1, 1, 0, 0, 0, 0]",159,83,76,8,7,0.0963855421686747,0.09210526315789473
"[0, 1, 1, 1, 1, 1, 1, 0, 1, 1, 0, 0, 0, 1, 0]",119,57,62,4,9,0.07017543859649122,0.14516129032258066
"[0, 1, 1, 0, 0, 1, 0, 1, 0, 1, 0, 1, 1, 1, 0]",126,61,65,5,4,0.08196721311475409,0.06153846153846154
"[0, 0, 0, 1, 1, 0, 1, 1, 1, 0, 1, 0, 1, 0, 0]",120,64,56,6,6,0.09375,0.10714285714285714
"[1, 1, 1, 1, 0, 0, 0, 0, 0, 1, 1, 0, 0, 1, 0]",194,93,101,12,7,0.12903225806451613,0.06930693069306931
"[1, 1, 0, 0, 1, 0, 1, 1, 0, 1, 0, 0, 0, 0, 1]",127,69,58,7,3,0.10144927536231885,0.05172413793103448
"[0, 1, 0, 0, 0, 1, 1, 0, 1, 0, 1, 0, 1, 0, 1]",107,52,55,2,3,0.038461538461538464,0.05454545454545454
"[0, 1, 0, 0, 1, 0, 0, 1, 1, 0, 1, 1, 0, 1, 0]",94,58,36,3,6,0.05172413793103448,0.16666666666666666
"[1, 0, 1, 0, 1, 0, 0, 1, 1, 0, 1, 1, 1, 0, 0]",127,62,65,3,11,0.04838709677419355,0.16923076923076924
"[1, 1, 0, 1, 1, 1, 0, 1, 0, 1, 0, 0, 1, 1, 0]",148,71,77,7,4,0.09859154929577464,0.05194805194805195
"[1, 1, 1, 1, 1, 0, 1, 0, 0, 0, 0, 0, 1, 0, 0]",139,65,74,4,8,0.06153846153846154,0.10810810810810811
"[0, 1, 1, 0, 0, 0, 1, 1, 1, 1, 1, 1, 0, 1, 0]",158,75,83,9,7,0.12,0.08433734939759036
"[0, 0, 0, 0, 0, 0, 0, 1, 0, 1, 1, 1, 1, 0, 1]",178,110,68,9,6,0.08181818181818182,0.08823529411764706
"[1, 0, 1, 0, 1, 0, 0, 1, 1, 1, 0, 1, 0, 1, 0]",106,42,64,4,7,0.09523809523809523,0.109375
"[0, 1, 1, 0, 0, 1, 1, 0, 1, 1, 0, 1, 0, 0, 1]",138,78,60,13,6,0.16666666666666666,0.1
"[1, 0, 0, 1, 1, 0, 1, 0, 0, 0, 1, 0, 0, 0, 1]",143,84,59,13,4,0.15476190476190477,0.06779661016949153
"[1, 1, 0, 0, 0, 1, 0, 1, 0, 0, 1, 0, 0, 1, 1]",121,60,61,6,1,0.1,0.01639344262295082
"[0, 1, 0, 1, 1, 1, 1, 0, 0, 0, 0, 0, 1, 0, 1]",137,75,62,4,6,0.05333333333333334,0.0967741935483871
"[0, 0, 0, 0, 1, 0, 1, 0, 0, 1, 1, 1, 0, 1, 0]",138,75,63,5,5,0.06666666666666667,0.07936507936507936
"[0, 0, 0, 1, 1, 0, 0, 1, 1, 0, 1, 1, 1, 1, 1]",352,229,123,23,13,0.10043668122270742,0.10569105691056911
"[0, 1, 1, 1, 1, 1, 0, 0, 0, 0, 0, 1, 0, 1, 1]",149,68,81,8,8,0.11764705882352941,0.09876543209876543
"[0, 0, 1, 0, 0, 1, 0, 0, 0, 1, 0, 0, 1, 0, 1]",228,147,81,15,6,0.10204081632653061,0.07407407407407407
"[1, 0, 1, 1, 1, 1, 0, 1, 1, 0, 0, 0, 0, 0, 1]",140,58,82,4,11,0.06896551724137931,0.13414634146341464
"[0, 1, 0, 0, 0, 1, 0, 0, 0, 1, 1, 0, 0, 0, 1]",269,172,97,22,10,0.12790697674418605,0.10309278350515463
"[1, 1, 0, 0, 1, 1, 0, 0, 0, 1, 1, 1, 1, 1, 0]",195,87,108,9,12,0.10344827586206896,0.1111111111111111
"[0, 1, 1, 1, 0, 1, 0, 0, 1, 1, 1, 1, 0, 0, 0]",186,94,92,9,4,0.09574468085106383,0.043478260869565216
"[0, 1, 1, 0, 0, 0, 1, 0, 1, 1, 1, 1, 1, 0, 1]",134,63,71,4,8,0.06349206349206349,0.11267605633802817
"[1, 1, 1, 0, 0, 0, 1, 0, 0, 1, 0, 0, 1, 0, 1]",112,56,56,11,9,0.19642857142857142,0.16071428571428573
"[1, 1, 1, 1, 0, 0, 1, 0, 0, 0, 1, 0, 1, 1, 1]",199,91,108,11,5,0.12087912087912088,0.046296296296296294
"[0, 0, 1, 0, 1, 0, 0, 1, 1, 0, 1, 0, 1, 0, 0]",154,89,65,3,5,0.033707865168539325,0.07692307692307693
"[1, 0, 0, 1, 1, 0, 1, 0, 0, 1, 1, 1, 0, 1, 1]",157,68,89,7,9,0.10294117647058823,0.10112359550561797
"[1, 0, 1, 1, 0, 0, 1, 1, 0, 0, 1, 1, 0, 1, 0]",140,62,78,6,8,0.0967741935483871,0.10256410256410256
"[0, 0, 1, 0, 1, 1, 0, 0, 1, 1, 0, 1, 1, 0, 0]",111,64,47,6,4,0.09375,0.0851063829787234
"[0, 0, 0, 1, 1, 0, 1, 1, 1, 0, 1, 1, 1, 1, 0]",183,74,109,5,11,0.06756756756756757,0.10091743119266056
"[0, 0, 0, 0, 1, 0, 1, 1, 1, 1, 0, 1, 0, 0, 1]",110,63,47,3,3,0.047619047619047616,0.06382978723404255
"[1, 0, 1, 1, 0, 1, 1, 0, 1, 0, 0, 1, 0, 1, 1]",134,52,82,6,5,0.11538461538461539,0.06097560975609756
"[0, 0, 0, 0, 1, 0, 0, 0, 1, 1, 1, 0, 1, 0, 1]",150,90,60,8,8,0.08888888888888889,0.13333333333333333
"[1, 0, 0, 0, 0, 1, 0, 1, 1, 0, 0, 0, 1, 1, 1]",162,66,96,7,9,0.10606060606060606,0.09375
"[0, 1, 0, 0, 1, 0, 1, 1, 0, 0, 0, 0, 1, 1, 1]",215,104,111,15,17,0.14423076923076922,0.15315315315315314
"[1, 0, 0, 0, 0, 1, 1, 1, 1, 1, 0, 1, 0, 1, 0]",137,44,93,3,8,0.06818181818181818,0.08602150537634409
"[0, 0, 1, 1, 1, 0, 0, 1, 1, 0, 1, 0, 0, 1, 1]",132,60,72,2,6,0.03333333333333333,0.08333333333333333
"[1, 0, 1, 0, 1, 1, 0, 0, 0, 0, 1, 1, 1, 0, 1]",123,53,70,5,11,0.09433962264150944,0.15714285714285714
"[1, 0, 0, 0, 1, 0, 0, 1, 1, 1, 1, 1, 1, 0, 1]",143,56,87,7,8,0.125,0.09195402298850575
"[0, 1, 0, 0, 1, 0, 1, 0, 1, 1, 0, 0, 0, 1, 1]",136,65,71,7,9,0.1076923076923077,0.1267605633802817
"[0, 1, 1, 0, 1, 1, 1, 1, 1, 1, 0, 1, 0, 1, 1]",540,161,379,18,33,0.11180124223602485,0.0870712401055409
"[1, 0, 1, 0, 1, 0, 1, 0, 0, 0, 1, 0, 0, 1, 1]",133,79,54,8,6,0.10126582278481013,0.1111111111111111
"[1, 1, 0, 1, 1, 0, 0, 1, 0, 0, 0, 1, 1, 1, 1]",213,82,131,8,6,0.0975609756097561,0.04580152671755725
"[1, 1, 0, 0, 0, 1, 0, 0, 0, 1, 1, 0, 1, 1, 1]",156,79,77,12,7,0.1518987341772152,0.09090909090909091
"[0, 0, 0, 1, 0, 1, 0, 1, 1, 1, 0, 1, 1, 1, 1]",178,80,98,8,6,0.1,0.061224489795918366
"[0, 1, 1, 0, 1, 1, 1, 0, 1, 0, 0, 1, 0, 1, 1]",154,64,90,6,5,0.09375,0.05555555555555555
"[0, 1, 0, 1, 0, 1, 1, 0, 0, 0, 0, 1, 1, 1, 0]",113,60,53,3,10,0.05,0.18867924528301888
"[0, 1, 1, 1, 1, 0, 0, 1, 0, 1, 0, 0, 1, 0, 1]",122,68,54,5,8,0.07352941176470588,0.14814814814814814
"[1, 0, 0, 0, 1, 0, 1, 0, 1, 1, 1, 0, 1, 1, 0]",93,40,53,3,5,0.075,0.09433962264150944
"[1, 0, 0, 1, 1, 1, 1, 0, 0, 0, 1, 1, 1, 0, 0]",211,87,124,13,9,0.14942528735632185,0.07258064516129033
"[1, 1, 1, 0, 1, 0, 1, 0, 0, 1, 1, 0, 1, 1, 0]",145,50,95,5,7,0.1,0.07368421052631578
"[0, 0, 0, 0, 0, 1, 1, 1, 0, 0, 1, 1, 1, 0, 1]",165,94,71,7,7,0.07446808510638298,0.09859154929577464
"[0, 0, 1, 0, 1, 0, 1, 1, 0, 1, 1, 1, 0, 1, 1]",143,59,84,4,5,0.06779661016949153,0.05952380952380952
"[1, 1, 0, 1, 0, 1, 1, 1, 0, 0, 0, 1, 1, 1, 0]",142,67,75,8,6,0.11940298507462686,0.08
"[0, 0, 0, 1, 0, 0, 0, 1, 1, 0, 1, 1, 1, 1, 0]",140,73,67,4,2,0.0547945205479452,0.029850746268656716
"[1, 0, 0, 0, 0, 1, 0, 0, 0, 1, 0, 1, 0, 1, 0]",218,145,73,18,7,0.12413793103448276,0.0958904109589041
"[0, 1, 1, 1, 0, 0, 0, 0, 1, 0, 1, 1, 1, 0, 0]",134,77,57,6,4,0.07792207792207792,0.07017543859649122
"[0, 0, 1, 1, 1, 0, 0, 0, 0, 1, 0, 1, 1, 1, 0]",132,83,49,12,6,0.14457831325301204,0.12244897959183673
"[1, 1, 1, 0, 0, 0, 1, 0, 1, 1, 0, 0, 1, 0, 1]",108,40,68,5,5,0.125,0.07352941176470588
"[1, 0, 1, 1, 1, 0, 0, 1, 0, 0, 0, 0, 1, 1, 1]",172,77,95,9,7,0.11688311688311688,0.07368421052631578
"[1, 0, 0, 1, 0, 0, 0, 0, 0, 0, 1, 0, 1, 0, 1]",237,144,93,10,15,0.06944444444444445,0.16129032258064516
"[0, 1, 1, 1, 0, 1, 1, 1, 1, 0, 0, 1, 0, 0, 1]",149,61,88,5,6,0.08196721311475409,0.06818181818181818
"[0, 1, 1, 0, 1, 0, 0, 0, 0, 0, 0, 1, 0, 0, 1]",236,163,73,18,8,0.11042944785276074,0.1095890410958904
"[1, 0, 0, 1, 0, 0, 1, 0, 1, 0, 0, 1, 0, 0, 1]",124,76,48,9,4,0.11842105263157894,0.08333333333333333
"[1, 0, 0, 1, 0, 0, 0, 0, 1, 0, 1, 1, 1, 0, 0]",135,79,56,10,4,0.12658227848101267,0.07142857142857142
"[1, 1, 0, 1, 1, 0, 1, 1, 0, 1, 0, 0, 0, 1, 1]",155,47,108,7,12,0.14893617021276595,0.1111111111111111
"[1, 1, 1, 0, 0, 0, 1, 1, 1, 0, 0, 0, 1, 0, 0]",139,62,77,7,8,0.11290322580645161,0.1038961038961039
"[1, 1, 0, 1, 1, 0, 0, 1, 1, 0, 0, 1, 0, 1, 1]",174,76,98,7,13,0.09210526315789473,0.1326530612244898
"[0, 1, 0, 0, 0, 0, 0, 0, 1, 1, 1, 1, 1, 0, 1]",170,84,86,11,6,0.13095238095238096,0.06976744186046512
"[1, 0, 1, 0, 0, 1, 0, 0, 0, 1, 1, 0, 1, 0, 1]",93,43,50,7,7,0.16279069767441862,0.14
"[0, 0, 0, 1, 0, 1, 0, 1, 1, 0, 1, 0, 0, 1, 1]",129,68,61,7,3,0.10294117647058823,0.04918032786885246
"[0, 1, 0, 0, 0, 0, 0, 1, 1, 1, 0, 1, 1, 0, 1]",121,65,56,3,10,0.046153846153846156,0.17857142857142858
"[1, 1, 0, 1, 1, 1, 1, 0, 0, 1, 0, 0, 0, 1, 0]",92,51,41,3,3,0.058823529411764705,0.07317073170731707
"[0, 1, 0, 0, 1, 0, 1, 1, 0, 1, 0, 0, 0, 0, 1]",140,75,65,6,8,0.08,0.12307692307692308
"[0, 1, 0, 1, 0, 1, 0, 1, 0, 0, 1, 1, 0, 1, 0]",103,58,45,7,7,0.1206896551724138,0.15555555555555556
"[0, 1, 1, 1, 0, 1, 0, 0, 1, 0, 0, 0, 1, 0, 1]",115,63,52,10,3,0.15873015873015872,0.057692307692307696
"[0, 1, 1, 1, 0, 1, 1, 1, 0, 1, 0, 0, 1, 0, 0]",85,35,50,4,3,0.11428571428571428,0.06
"[0, 1, 0, 0, 1, 1, 1, 0, 1, 1, 0, 1, 0, 0, 1]",131,50,81,4,11,0.08,0.13580246913580246
"[0, 1, 0, 0, 1, 0, 1, 0, 0, 1, 0, 0, 1, 0, 1]",138,77,61,12,3,0.15584415584415584,0.04918032786885246
"[0, 1, 0, 0, 0, 0, 0, 0, 1, 0, 1, 1, 0, 1, 1]",139,87,52,7,5,0.08045977011494253,0.09615384615384616
"[0, 1, 1, 1, 0, 0, 1, 0, 1, 1, 1, 1, 0, 1, 0]",140,70,70,9,14,0.12857142857142856,0.2
"[0, 1, 0, 0, 1, 0, 1, 0, 1, 0, 1, 0, 1, 1, 0]",106,59,47,6,4,0.1016949152542373,0.0851063829787234
"[1, 1, 1, 0, 1, 0, 0, 0, 0, 1, 0, 1, 0, 1, 0]",104,59,45,2,3,0.03389830508474576,0.06666666666666667
"[1, 1, 0, 0, 0, 1, 0, 1, 1, 0, 1, 0, 0, 0, 0]",173,99,74,6,10,0.06060606060606061,0.13513513513513514
"[1, 1, 0, 0, 0, 1, 1, 0, 1, 1, 0, 0, 1, 0, 1]",96,42,54,3,6,0.07142857142857142,0.1111111111111111
"[1, 1, 1, 0, 0, 0, 1, 1, 0, 1, 0, 1, 0, 0, 1]",143,66,77,4,6,0.06060606060606061,0.07792207792207792
"[1, 0, 1, 1, 0, 1, 1, 1, 1, 0, 0, 0, 1, 0, 0]",124,53,71,5,8,0.09433962264150944,0.11267605633802817
"[0, 1, 1, 0, 1, 1, 0, 1, 0, 1, 1, 1, 0, 0, 1]",157,60,97,2,7,0.03333333333333333,0.07216494845360824
"[0, 1, 1, 0, 0, 0, 1, 1, 0, 1, 0, 1, 1, 0, 1]",129,63,66,4,7,0.06349206349206349,0.10606060606060606
"[0, 0, 0, 1, 0, 1, 1, 0, 1, 0, 0, 1, 1, 0, 1]",109,52,57,5,7,0.09615384615384616,0.12280701754385964
"[1, 0, 0, 1, 1, 0, 1, 0, 0, 0, 0, 1, 0, 0, 1]",159,89,70,11,9,0.12359550561797752,0.12857142857142856
"[0, 1, 1, 0, 1, 1, 0, 1, 0, 0, 1, 1, 0, 0, 0]",157,80,77,6,8,0.075,0.1038961038961039
"[0, 0, 1, 1, 0, 0, 1, 1, 0, 1, 1, 0, 0, 1, 0]",137,74,63,6,5,0.08108108108108109,0.07936507936507936
"[1, 1, 0, 0, 0, 1, 0, 0, 0, 1, 0, 1, 0, 1, 1]",136,77,59,2,2,0.025974025974025976,0.03389830508474576
"[0, 1, 0, 0, 0, 1, 0, 0, 1, 1, 0, 1, 1, 0, 0]",161,103,58,9,10,0.08737864077669903,0.1724137931034483
"[0, 1, 1, 0, 1, 0, 1, 1, 1, 0, 1, 0, 0, 0, 0]",117,71,46,6,4,0.08450704225352113,0.08695652173913043
"[1, 1, 1, 1, 0, 0, 1, 0, 0, 1, 0, 1, 1, 0, 1]",138,58,80,5,9,0.08620689655172414,0.1125
"[0, 0, 1, 0, 0, 1, 0, 1, 0, 1, 0, 0, 1, 1, 0]",137,82,55,11,5,0.13414634146341464,0.09090909090909091
"[1, 1, 0, 0, 1, 0, 0, 0, 1, 0, 1, 0, 0, 1, 0]",163,98,65,8,10,0.08163265306122448,0.15384615384615385
"[0, 1, 1, 1, 0, 1, 0, 1, 1, 0, 1, 0, 1, 0, 0]",100,55,45,5,7,0.09090909090909091,0.15555555555555556
"[0, 1, 1, 0, 0, 1, 0, 0, 0, 0, 1, 0, 1, 1, 0]",150,96,54,7,5,0.07291666666666667,0.09259259259259259
"[0, 1, 0, 0, 0, 1, 0, 1, 1, 0, 1, 1, 0, 1, 1]",108,55,53,4,4,0.07272727272727272,0.07547169811320754
"[0, 1, 0, 1, 0, 1, 1, 0, 0, 0, 1, 1, 0, 0, 1]",145,81,64,14,7,0.1728395061728395,0.109375
"[0, 0, 1, 0, 0, 1, 1, 0, 1, 0, 1, 1, 1, 0, 1]",98,48,50,6,3,0.125,0.06
"[1, 0, 1, 1, 0, 0, 1, 0, 0, 1, 1, 0, 1, 0, 1]",107,48,59,4,2,0.08333333333333333,0.03389830508474576
"[0, 1, 0, 1, 0, 0, 0, 1, 0, 0, 1, 0, 1, 1, 0]",138,87,51,9,6,0.10344827586206896,0.11764705882352941
"[1, 0, 0, 1, 0, 1, 1, 1, 0, 1, 0, 0, 1, 0, 1]",109,48,61,10,10,0.20833333333333334,0.16393442622950818
"[1, 1, 1, 1, 0, 1, 1, 0, 1, 0, 1, 0, 0, 0, 0]",130,48,82,6,5,0.125,0.06097560975609756
"[0, 0, 1, 0, 1, 1, 1, 1, 0, 0, 1, 1, 1, 0, 1]",157,57,100,5,12,0.08771929824561403,0.12
"[0, 1, 0, 0, 0, 1, 0, 1, 1, 0, 1, 0, 1, 1, 1]",115,60,55,6,7,0.1,0.12727272727272726
"[0, 0, 1, 0, 1, 0, 0, 1, 1, 0, 1, 1, 1, 0, 1]",104,50,54,3,5,0.06,0.09259259259259259
"[0, 1, 1, 0, 1, 1, 1, 1, 0, 0, 0, 0, 1, 0, 1]",114,56,58,6,5,0.10714285714285714,0.08620689655172414
"[1, 0, 0, 0, 0, 1, 1, 0, 0, 1, 1, 1, 0, 0, 0]",319,135,184,7,7,0.05185185185185185,0.03804347826086957
"[0, 0, 0, 1, 1, 1, 0, 1, 0, 0, 1, 1, 0, 0, 0]",163,101,62,5,6,0.04950495049504951,0.0967741935483871
"[1, 0, 0, 1, 1, 0, 1, 1, 0, 1, 1, 0, 0, 0, 1]",135,57,78,3,10,0.05263157894736842,0.1282051282051282
"[1, 0, 1, 0, 1, 1, 0, 0, 0, 1, 1, 0, 0, 0, 1]",114,64,50,4,6,0.0625,0.12
"[1, 0, 1, 0, 1, 1, 1, 1, 1, 0, 0, 1, 0, 1, 0]",146,55,91,7,10,0.12727272727272726,0.10989010989010989
"[0, 1, 0, 1, 1, 0, 0, 1, 1, 0, 0, 1, 1, 0, 1]",151,70,81,11,11,0.15714285714285714,0.13580246913580246
"[0, 1, 0, 1, 0, 0, 0, 0, 0, 1, 1, 1, 0, 1, 1]",128,78,50,5,5,0.0641025641025641,0.1
"[0, 1, 0, 1, 1, 1, 0, 1, 1, 1, 0, 0, 0, 0, 0]",171,98,73,13,7,0.1326530612244898,0.0958904109589041
"[1, 0, 0, 0, 1, 0, 1, 0, 1, 0, 1, 0, 1, 1, 0]",99,54,45,4,1,0.07407407407407407,0.022222222222222223
"[1, 1, 0, 1, 0, 0, 1, 0, 1, 1, 1, 0, 0, 1, 0]",105,51,54,5,6,0.09803921568627451,0.1111111111111111
"[0, 1, 1, 0, 1, 0, 1, 1, 1, 0, 1, 1, 1, 0, 0]",153,61,92,8,9,0.13114754098360656,0.09782608695652174
"[0, 1, 1, 1, 0, 1, 0, 0, 1, 0, 0, 1, 0, 0, 0]",133,74,59,4,3,0.05405405405405406,0.05084745762711865
"[1, 0, 0, 1, 1, 0, 0, 0, 1, 0, 0, 0, 1, 0, 1]",169,85,84,9,8,0.10588235294117647,0.09523809523809523
"[0, 1, 0, 0, 0, 0, 0, 0, 0, 1, 0, 1, 1, 1, 1]",305,188,117,21,12,0.11170212765957446,0.10256410256410256
"[1, 0, 1, 1, 0, 0, 1, 0, 0, 1, 0, 1, 0, 1, 0]",93,50,43,5,4,0.1,0.09302325581395349
"[0, 1, 1, 0, 1, 0, 1, 1, 0, 1, 1, 0, 1, 1, 0]",105,42,63,4,3,0.09523809523809523,0.047619047619047616
"[1, 1, 1, 0, 0, 0, 1, 0, 1, 1, 1, 0, 0, 0, 1]",128,66,62,9,8,0.13636363636363635,0.12903225806451613
"[0, 1, 0, 1, 0, 1, 0, 1, 0, 1, 1, 0, 0, 0, 1]",110,65,45,11,8,0.16923076923076924,0.17777777777777778
"[1, 1, 0, 1, 0, 1, 1, 0, 1, 1, 1, 0, 1, 0, 0]",140,53,87,1,10,0.018867924528301886,0.11494252873563218
"[0, 0, 1, 0, 1, 1, 0, 0, 1, 0, 1, 1, 1, 1, 1]",203,75,128,10,15,0.13333333333333333,0.1171875
"[0, 0, 1, 1, 0, 1, 1, 1, 1, 0, 0, 0, 0, 1, 0]",115,58,57,5,6,0.08620689655172414,0.10526315789473684
"[0, 1, 0, 0, 1, 1, 0, 0, 0, 1, 1, 0, 1, 1, 0]",127,66,61,6,7,0.09090909090909091,0.11475409836065574
"[1, 0, 0, 1, 1, 0, 0, 1, 0, 1, 1, 1, 1, 0, 1]",147,54,93,5,10,0.09259259259259259,0.10752688172043011
"[1, 1, 0, 1, 1, 1, 0, 1, 0, 1, 1, 0, 1, 0, 1]",216,66,150,11,15,0.16666666666666666,0.1
"[1, 0, 1, 1, 1, 0, 0, 1, 0, 0, 0, 0, 1, 0, 1]",121,68,53,3,4,0.04411764705882353,0.07547169811320754
"[0, 1, 0, 0, 1, 0, 1, 0, 1, 0, 1, 1, 1, 1, 1]",161,66,95,7,10,0.10606060606060606,0.10526315789473684
"[1, 0, 1, 1, 0, 1, 0, 1, 1, 1, 0, 1, 1, 1, 0]",228,73,155,9,15,0.1232876712328767,0.0967741935483871
"[0, 0, 0, 1, 0, 1, 1, 1, 1, 1, 0, 0, 1, 0, 0]",112,64,48,5,4,0.078125,0.08333333333333333
"[1, 0, 1, 0, 0, 1, 1, 1, 0, 1, 1, 0, 0, 0, 1]",108,54,54,7,4,0.12962962962962962,0.07407407407407407
"[1, 0, 1, 0, 1, 1, 0, 0, 0, 0, 1, 1, 0, 1, 0]",118,58,60,5,6,0.08620689655172414,0.1
"[0, 1, 0, 0, 0, 1, 1, 1, 0, 1, 0, 0, 0, 0, 1]",145,86,59,9,3,0.10465116279069768,0.05084745762711865
"[1, 1, 0, 0, 1, 1, 0, 0, 0, 1, 0, 0, 1, 1, 0]",165,82,83,6,10,0.07317073170731707,0.12048192771084337
"[0, 0, 1, 0, 1, 1, 1, 1, 0, 1, 0, 1, 1, 0, 0]",121,54,67,1,6,0.018518518518518517,0.08955223880597014
"[1, 1, 0, 1, 0, 1, 0, 0, 1, 0, 0, 1, 0, 1, 1]",98,56,42,3,2,0.05357142857142857,0.047619047619047616
"[1, 0, 1, 0, 1, 0, 0, 0, 1, 0, 1, 0, 0, 1, 0]",117,75,42,7,7,0.09333333333333334,0.16666666666666666
"[0, 1, 0, 1, 0, 1, 1, 0, 1, 1, 0, 0, 0, 1, 1]",110,50,60,2,7,0.04,0.11666666666666667
"[1, 0, 1, 0, 1, 0, 0, 0, 1, 0, 0, 1, 0, 1, 1]",107,58,49,7,9,0.1206896551724138,0.1836734693877551
"[1, 0, 0, 1, 1, 0, 1, 0, 1, 0, 0, 0, 1, 0, 1]",102,52,50,4,5,0.07692307692307693,0.1
"[0, 1, 0, 1, 0, 1, 0, 1, 1, 0, 0, 1, 1, 1, 0]",126,64,62,6,6,0.09375,0.0967741935483871
"[0, 0, 1, 1, 0, 1, 0, 1, 1, 0, 1, 1, 1, 0, 0]",126,59,67,4,6,0.06779661016949153,0.08955223880597014
"[0, 0, 1, 1, 1, 1, 0, 1, 0, 1, 0, 1, 0, 0, 1]",136,57,79,6,7,0.10526315789473684,0.08860759493670886
"[1, 1, 1, 0, 1, 0, 1, 0, 1, 1, 0, 0, 0, 0, 0]",156,75,81,5,6,0.06666666666666667,0.07407407407407407
"[0, 0, 1, 0, 1, 1, 0, 0, 0, 0, 1, 1, 1, 0, 1]",110,60,50,7,4,0.11666666666666667,0.08
"[1, 0, 0, 1, 0, 1, 1, 0, 0, 0, 0, 1, 1, 1, 0]",124,60,64,5,9,0.08333333333333333,0.140625
"[1, 0, 0, 0, 1, 0, 0, 1, 0, 1, 1, 0, 1, 0, 0]",143,79,64,7,7,0.08860759493670886,0.109375
"[1, 0, 1, 1, 0, 1, 0, 1, 0, 1, 0, 0, 0, 0, 1]",119,68,51,6,4,0.08823529411764706,0.0784313725490196
"[0, 0, 1, 0, 1, 0, 1, 0, 1, 0, 1, 0, 0, 1, 0]",130,69,61,11,3,0.15942028985507245,0.04918032786885246
"[0, 0, 1, 0, 1, 1, 1, 0, 1, 1, 1, 0, 0, 1, 0]",108,58,50,5,5,0.08620689655172414,0.1
"[1, 0, 1, 1, 1, 0, 0, 0, 1, 0, 1, 1, 1, 1, 0]",158,62,96,5,9,0.08064516129032258,0.09375
"[1, 0, 0, 0, 1, 1, 0, 1, 1, 1, 1, 1, 0, 1, 0]",135,57,78,6,4,0.10526315789473684,0.05128205128205128
"[0, 0, 0, 1, 1, 0, 1, 0, 0, 0, 1, 0, 1, 0, 1]",138,83,55,9,6,0.10843373493975904,0.10909090909090909
"[0, 0, 1, 0, 0, 1, 1, 0, 1, 0, 0, 1, 0, 1, 1]",132,70,62,9,4,0.12857142857142856,0.06451612903225806
"[1, 1, 0, 0, 0, 1, 1, 0, 0, 1, 0, 1, 0, 1, 0]",112,53,59,5,7,0.09433962264150944,0.11864406779661017
"[1, 1, 1, 0, 1, 0, 1, 1, 1, 0, 0, 0, 0, 0, 1]",143,60,83,6,4,0.1,0.04819277108433735
"[1, 0, 1, 0, 1, 1, 0, 0, 0, 0, 1, 0, 1, 0, 0]",170,93,77,10,5,0.10752688172043011,0.06493506493506493
"[0, 0, 0, 1, 0, 1, 1, 1, 0, 0, 0, 1, 0, 1, 1]",130,81,49,6,4,0.07407407407407407,0.08163265306122448
"[0, 1, 1, 0, 0, 0, 1, 1, 0, 1, 0, 1, 0, 1, 0]",105,57,48,7,1,0.12280701754385964,0.020833333333333332
"[1, 1, 1, 1, 1, 0, 1, 0, 1, 0, 0, 0, 0, 1, 0]",112,52,60,2,9,0.038461538461538464,0.15
"[0, 1, 1, 0, 1, 1, 1, 0, 1, 0, 1, 1, 0, 0, 1]",150,71,79,8,8,0.11267605633802817,0.10126582278481013
"[1, 1, 1, 0, 1, 0, 1, 0, 0, 0, 0, 0, 1, 1, 0]",144,81,63,5,8,0.06172839506172839,0.12698412698412698
"[0, 1, 1, 1, 1, 1, 0, 1, 0, 0, 1, 0, 0, 1, 0]",107,48,59,5,8,0.10416666666666667,0.13559322033898305
"[1, 1, 1, 0, 0, 0, 0, 0, 1, 1, 0, 1, 0, 0, 1]",135,65,70,5,5,0.07692307692307693,0.07142857142857142
"[1, 1, 1, 0, 1, 0, 0, 1, 1, 0, 1, 0, 0, 0, 0]",114,67,47,8,6,0.11940298507462686,0.1276595744680851
"[0, 1, 0, 0, 1, 0, 0, 0, 0, 1, 1, 1, 0, 1, 0]",146,81,65,6,5,0.07407407407407407,0.07692307692307693
"[1, 1, 0, 0, 1, 1, 1, 0, 0, 0, 1, 0, 1, 1, 0]",123,55,68,2,4,0.03636363636363636,0.058823529411764705
"[0, 1, 0, 0, 1, 1, 0, 1, 1, 0, 1, 0, 1, 1, 0]",104,49,55,3,3,0.061224489795918366,0.05454545454545454
"[1, 1, 1, 1, 1, 0, 1, 0, 0, 0, 0, 0, 1, 0, 1]",124,48,76,4,7,0.08333333333333333,0.09210526315789473
"[1, 1, 1, 0, 1, 0, 0, 0, 1, 0, 1, 0, 0, 0, 1]",104,53,51,4,6,0.07547169811320754,0.11764705882352941
"[0, 0, 0, 0, 1, 0, 0, 1, 0, 0, 1, 1, 0, 1, 1]",190,113,77,11,10,0.09734513274336283,0.12987012987012986
"[0, 1, 0, 1, 0, 0, 1, 0, 1, 1, 1, 0, 1, 0, 0]",109,55,54,7,6,0.12727272727272726,0.1111111111111111
"[0, 0, 1, 0, 1, 1, 1, 1, 1, 0, 0, 1, 1, 1, 0]",158,57,101,5,7,0.08771929824561403,0.06930693069306931
"[0, 1, 0, 0, 0, 1, 1, 0, 0, 0, 1, 1, 1, 0, 1]",111,66,45,5,4,0.07575757575757576,0.08888888888888889
"[0, 1, 0, 1, 0, 1, 1, 1, 1, 0, 0, 0, 1, 0, 0]",117,61,56,3,7,0.04918032786885246,0.125
"[1, 0, 0, 0, 1, 0, 0, 1, 1, 0, 1, 0, 0, 1, 0]",137,76,61,12,3,0.15789473684210525,0.04918032786885246
"[1, 1, 0, 0, 0, 1, 1, 1, 0, 0, 1, 1, 1, 1, 0]",222,100,122,11,11,0.11,0.09016393442622951
"[1, 1, 0, 0, 0, 1, 1, 0, 0, 0, 0, 1, 1, 1, 0]",172,86,86,9,10,0.10465116279069768,0.11627906976744186
"[1, 0, 1, 1, 0, 1, 1, 0, 0, 0, 1, 1, 0, 1, 0]",114,58,56,4,4,0.06896551724137931,0.07142857142857142
"[1, 0, 1, 0, 0, 0, 1, 1, 1, 0, 0, 1, 0, 0, 1]",122,58,64,6,4,0.10344827586206896,0.0625
"[1, 0, 1, 1, 0, 0, 1, 0, 1, 0, 0, 0, 1, 1, 0]",126,63,63,5,9,0.07936507936507936,0.14285714285714285
"[1, 1, 0, 1, 1, 0, 1, 0, 0, 0, 1, 0, 1, 0, 0]",107,55,52,8,4,0.14545454545454545,0.07692307692307693
"[1, 1, 0, 0, 0, 1, 1, 0, 1, 0, 1, 0, 1, 0, 1]",110,47,63,3,9,0.06382978723404255,0.14285714285714285
"[0, 0, 0, 0, 1, 0, 1, 0, 1, 0, 1, 0, 0, 1, 1]",178,101,77,12,11,0.1188118811881188,0.14285714285714285
"[1, 1, 0, 1, 0, 1, 1, 0, 1, 0, 1, 0, 0, 1, 0]",94,47,47,4,3,0.0851063829787234,0.06382978723404255
"[0, 0, 0, 1, 0, 0, 1, 0, 1, 1, 1, 0, 1, 0, 1]",116,57,59,3,6,0.05263157894736842,0.1016949152542373
"[0, 0, 1, 1, 0, 1, 0, 1, 0, 1, 0, 1, 1, 0, 0]",109,57,52,4,6,0.07017543859649122,0.11538461538461539
"[0, 0, 1, 0, 1, 1, 1, 1, 0, 0, 1, 0, 0, 1, 0]",99,47,52,1,2,0.02127659574468085,0.038461538461538464
"[1, 0, 0, 0, 1, 1, 0, 0, 1, 0, 1, 1, 0, 1, 0]",106,59,47,4,4,0.06779661016949153,0.0851063829787234
"[1, 0, 0, 1, 0, 1, 0, 0, 0, 1, 1, 0, 1, 0, 1]",104,63,41,3,7,0.047619047619047616,0.17073170731707318
"[1, 0, 1, 0, 0, 0, 1, 1, 1, 0, 1, 0, 0, 0, 1]",108,62,46,6,2,0.0967741935483871,0.043478260869565216
"[1, 1, 1, 0, 0, 0, 1, 0, 0, 0, 1, 0, 1, 0, 1]",113,59,54,2,2,0.03389830508474576,0.037037037037037035
"[0, 1, 1, 0, 0, 0, 1, 1, 1, 1, 1, 0, 0, 0, 1]",122,65,57,7,5,0.1076923076923077,0.08771929824561403
"[1, 0, 1, 1, 0, 0, 0, 0, 1, 0, 0, 1, 0, 1, 1]",110,62,48,6,5,0.0967741935483871,0.10416666666666667
"[1, 0, 1, 1, 1, 1, 0, 0, 0, 1, 1, 0, 0, 1, 0]",109,50,59,7,9,0.14,0.15254237288135594
"[0, 1, 0, 1, 1, 0, 1, 0, 0, 1, 0, 0, 1, 0, 1]",87,44,43,1,7,0.022727272727272728,0.16279069767441862
"[1, 0, 1, 0, 0, 0, 1, 1, 0, 0, 1, 0, 0, 0, 0]",280,178,102,17,6,0.09550561797752809,0.058823529411764705
"[0, 1, 1, 1, 0, 0, 0, 1, 1, 0, 1, 0, 0, 0, 1]",114,63,51,9,1,0.14285714285714285,0.0196078431372549
"[0, 1, 1, 1, 1, 1, 1, 0, 0, 1, 1, 1, 1, 1, 1]",7371,4205,3166,382,293,0.09084423305588585,0.09254579911560329
"[1, 1, 1, 1, 1, 1, 1, 1, 1, 1, 0, 1, 0, 1, 0]",1853,452,1401,45,135,0.09955752212389381,0.09635974304068523
"[0, 1, 1, 0, 1, 0, 1, 1, 1, 1, 0, 1, 1, 1, 1]",583,183,400,14,38,0.07650273224043716,0.095
"[1, 1, 0, 0, 1, 1, 0, 1, 0, 1, 1, 1, 1, 0, 1]",257,86,171,8,25,0.09302325581395349,0.14619883040935672
"[0, 1, 1, 1, 1, 1, 1, 1, 1, 1, 0, 0, 0, 0, 0]",731,392,339,31,23,0.07908163265306123,0.06784660766961652
"[1, 1, 0, 1, 1, 1, 1, 1, 1, 1, 1, 1, 0, 0, 0]",1062,310,752,30,66,0.0967741935483871,0.08776595744680851
"[0, 1, 1, 0, 1, 1, 0, 0, 0, 1, 0, 1, 0, 0, 0]",153,106,47,7,6,0.0660377358490566,0.1276595744680851
"[0, 0, 0, 0, 1, 1, 0, 1, 1, 0, 0, 0, 1, 0, 1]",184,115,69,14,5,0.12173913043478261,0.07246376811594203
"[0, 0, 1, 0, 1, 0, 0, 0, 0, 0, 0, 1, 1, 0, 1]",284,197,87,24,10,0.1218274111675127,0.11494252873563218
"[0, 0, 0, 1, 1, 1, 1, 0, 0, 1, 1, 1, 1, 1, 1]",2461,1810,651,158,63,0.08729281767955802,0.0967741935483871
"[1, 1, 1, 1, 0, 0, 1, 0, 0, 0, 1, 1, 1, 1, 0]",234,99,135,11,16,0.1111111111111111,0.11851851851851852
"[0, 0, 1, 1, 0, 1, 0, 0, 0, 0, 0, 1, 1, 1, 1]",275,132,143,12,11,0.09090909090909091,0.07692307692307693
"[1, 1, 1, 1, 0, 1, 1, 1, 0, 1, 0, 1, 1, 1, 1]",1819,412,1407,42,147,0.10194174757281553,0.1044776119402985
"[0, 1, 1, 1, 1, 1, 0, 1, 0, 0, 0, 1, 1, 1, 1]",376,162,214,14,17,0.08641975308641975,0.0794392523364486
"[0, 1, 1, 0, 1, 1, 1, 0, 1, 1, 1, 1, 0, 1, 1]",547,172,375,15,44,0.0872093023255814,0.11733333333333333
"[1, 1, 1, 1, 0, 1, 0, 1, 1, 0, 1, 1, 1, 0, 1]",498,151,347,14,34,0.09271523178807947,0.09798270893371758
"[0, 1, 1, 1, 1, 1, 1, 1, 1, 1, 0, 1, 0, 1, 1]",1921,693,1228,72,119,0.1038961038961039,0.09690553745928339
"[0, 1, 1, 1, 0, 1, 1, 0, 1, 0, 1, 1, 1, 1, 1]",671,248,423,29,34,0.11693548387096774,0.08037825059101655
"[1, 1, 1, 1, 1, 1, 1, 1, 1, 1, 1, 1, 0, 1, 0]",8890,1506,7384,133,715,0.08831341301460824,0.09683098591549295
"[0, 1, 0, 0, 0, 1, 1, 1, 0, 1, 0, 1, 1, 1, 1]",167,66,101,5,14,0.07575757575757576,0.13861386138613863
"[0, 1, 1, 1, 0, 0, 0, 1, 0, 1, 0, 0, 0, 1, 1]",145,80,65,10,9,0.125,0.13846153846153847
"[0, 1, 1, 0, 1, 0, 1, 0, 0, 0, 0, 1, 0, 1, 0]",131,77,54,7,5,0.09090909090909091,0.09259259259259259
"[0, 0, 1, 0, 1, 1, 0, 1, 0, 1, 0, 0, 0, 0, 1]",151,81,70,6,5,0.07407407407407407,0.07142857142857142
"[1, 1, 0, 0, 1, 0, 1, 1, 0, 1, 0, 1, 0, 0, 0]",127,68,59,3,6,0.04411764705882353,0.1016949152542373
"[1, 0, 0, 1, 0, 0, 0, 1, 0, 1, 0, 1, 0, 1, 1]",107,54,53,5,5,0.09259259259259259,0.09433962264150944
"[0, 0, 1, 1, 0, 1, 0, 0, 1, 1, 1, 0, 1, 1, 0]",124,56,68,4,8,0.07142857142857142,0.11764705882352941
"[1, 0, 0, 0, 0, 0, 1, 1, 0, 1, 0, 0, 1, 1, 1]",202,96,106,9,13,0.09375,0.12264150943396226
"[1, 0, 0, 1, 1, 0, 0, 0, 0, 0, 1, 1, 0, 1, 0]",191,89,102,6,10,0.06741573033707865,0.09803921568627451
"[1, 0, 1, 1, 0, 1, 0, 0, 0, 1, 1, 0, 0, 1, 1]",218,106,112,14,8,0.1320754716981132,0.07142857142857142
"[1, 0, 1, 1, 1, 0, 1, 1, 1, 1, 1, 1, 1, 1, 1]",8929,1696,7233,173,648,0.10200471698113207,0.08958938199917046
"[1, 1, 1, 1, 0, 1, 1, 1, 0, 1, 1, 1, 1, 1, 1]",8110,1438,6672,144,632,0.10013908205841446,0.09472422062350119
"[0, 1, 1, 1, 1, 1, 1, 1, 1, 1, 0, 1, 1, 1, 0]",1772,514,1258,47,109,0.0914396887159533,0.08664546899841018
"[1, 0, 0, 1, 1, 0, 0, 0, 0, 1, 1, 1, 1, 1, 0]",423,107,316,8,30,0.07476635514018691,0.0949367088607595
"[0, 0, 0, 0, 0, 0, 0, 1, 0, 0, 0, 0, 1, 1, 1]",2665,2259,406,223,41,0.09871624612660469,0.10098522167487685
"[0, 0, 0, 0, 0, 0, 0, 0, 0, 0, 0, 0, 1, 1, 0]",27895,23221,4674,2294,461,0.09878988846302915,0.09863072314933675
"[1, 1, 1, 1, 1, 1, 1, 0, 1, 1, 0, 1, 0, 0, 0]",298,96,202,7,22,0.07291666666666667,0.10891089108910891
"[0, 0, 1, 1, 0, 0, 1, 1, 0, 1, 0, 1, 1, 0, 0]",146,82,64,9,7,0.10975609756097561,0.109375
"[1, 1, 0, 0, 0, 1, 1, 0, 0, 1, 1, 0, 1, 0, 1]",125,71,54,6,6,0.08450704225352113,0.1111111111111111
"[1, 1, 1, 1, 1, 0, 0, 0, 1, 1, 0, 0, 1, 1, 0]",261,91,170,9,9,0.0989010989010989,0.052941176470588235
"[1, 1, 0, 0, 0, 1, 0, 1, 1, 1, 1, 1, 1, 1, 1]",910,276,634,30,53,0.10869565217391304,0.083596214511041
"[1, 1, 0, 0, 1, 0, 1, 0, 1, 1, 1, 1, 1, 1, 0]",288,103,185,7,15,0.06796116504854369,0.08108108108108109
"[1, 1, 1, 0, 1, 0, 0, 0, 1, 1, 1, 0, 1, 0, 1]",136,45,91,3,8,0.06666666666666667,0.08791208791208792
"[0, 1, 0, 1, 1, 0, 0, 1, 1, 1, 1, 0, 0, 1, 1]",524,236,288,25,25,0.1059322033898305,0.08680555555555555
"[0, 0, 1, 1, 1, 1, 1, 1, 0, 0, 1, 0, 0, 0, 0]",266,147,119,15,12,0.10204081632653061,0.10084033613445378
"[0, 0, 0, 0, 0, 0, 1, 1, 1, 1, 1, 1, 0, 0, 1]",1749,953,796,102,81,0.10703043022035677,0.10175879396984924
"[1, 0, 0, 1, 1, 0, 0, 1, 1, 0, 0, 1, 1, 1, 1]",2198,348,1850,26,187,0.07471264367816093,0.10108108108108108
"[1, 1, 0, 0, 1, 1, 0, 0, 1, 1, 0, 0, 1, 1, 1]",2297,945,1352,101,138,0.10687830687830688,0.10207100591715976
"[0, 1, 1, 0, 1, 1, 1, 0, 0, 0, 0, 1, 0, 1, 0]",104,59,45,7,8,0.11864406779661017,0.17777777777777778
"[1, 1, 1, 1, 1, 1, 1, 0, 0, 1, 1, 0, 1, 1, 1]",2976,543,2433,50,201,0.09208103130755065,0.08261405672009864
"[1, 1, 1, 1, 1, 1, 1, 1, 0, 0, 1, 1, 0, 1, 1]",2992,718,2274,50,238,0.06963788300835655,0.10466138962181179
"[1, 1, 1, 1, 1, 0, 0, 1, 1, 1, 1, 1, 1, 1, 0]",3230,554,2676,49,223,0.08844765342960288,0.08333333333333333
"[1, 1, 0, 1, 1, 1, 1, 0, 1, 1, 0, 1, 1, 1, 0]",563,149,414,13,45,0.087248322147651,0.10869565217391304
"[0, 1, 1, 0, 1, 1, 1, 1, 0, 0, 1, 1, 1, 1, 0]",445,163,282,15,21,0.09202453987730061,0.07446808510638298
"[1, 0, 1, 1, 1, 1, 1, 0, 1, 1, 0, 1, 1, 1, 1]",1669,382,1287,29,130,0.07591623036649214,0.10101010101010101
"[0, 1, 0, 1, 1, 1, 1, 1, 1, 0, 1, 1, 1, 1, 1]",1751,443,1308,51,112,0.11512415349887133,0.0856269113149847
"[1, 1, 0, 1, 0, 1, 1, 1, 1, 1, 1, 0, 1, 1, 1]",1710,410,1300,28,111,0.06829268292682927,0.08538461538461538
"[1, 0, 1, 1, 1, 1, 0, 1, 0, 1, 0, 0, 0, 1, 0]",111,47,64,5,3,0.10638297872340426,0.046875
"[1, 0, 0, 1, 0, 1, 0, 1, 1, 1, 1, 0, 1, 0, 1]",145,59,86,6,13,0.1016949152542373,0.1511627906976744
"[1, 0, 0, 0, 0, 0, 0, 1, 0, 1, 0, 0, 1, 1, 0]",307,197,110,15,11,0.07614213197969544,0.1
"[0, 1, 1, 1, 1, 1, 1, 1, 0, 1, 0, 1, 1, 0, 0]",324,133,191,9,16,0.06766917293233082,0.08376963350785341
"[0, 0, 0, 1, 1, 1, 0, 0, 0, 0, 0, 0, 1, 1, 1]",598,389,209,41,25,0.10539845758354756,0.11961722488038277
"[0, 0, 1, 0, 0, 0, 0, 1, 1, 1, 0, 1, 0, 1, 0]",128,75,53,11,6,0.14666666666666667,0.11320754716981132
"[1, 0, 1, 0, 0, 0, 0, 1, 0, 0, 0, 0, 0, 1, 0]",503,372,131,24,14,0.06451612903225806,0.10687022900763359
"[0, 1, 0, 1, 0, 0, 0, 0, 1, 0, 0, 0, 0, 0, 1]",560,391,169,39,15,0.09974424552429667,0.08875739644970414
"[1, 1, 0, 0, 0, 0, 0, 0, 1, 0, 0, 0, 0, 0, 0]",2408,1826,582,174,57,0.09529025191675794,0.0979381443298969
"[0, 0, 0, 1, 1, 1, 0, 0, 0, 0, 0, 0, 1, 0, 0]",632,461,171,46,17,0.09978308026030369,0.09941520467836257
"[0, 1, 0, 1, 0, 0, 0, 0, 0, 0, 0, 1, 1, 1, 0]",290,193,97,15,10,0.07772020725388601,0.10309278350515463
"[0, 0, 1, 0, 0, 1, 0, 1, 0, 1, 0, 0, 0, 0, 0]",552,395,157,47,19,0.1189873417721519,0.12101910828025478
"[0, 0, 1, 0, 0, 0, 0, 0, 1, 0, 0, 1, 0, 1, 0]",481,338,143,23,21,0.06804733727810651,0.14685314685314685
"[1, 1, 0, 0, 0, 0, 0, 0, 0, 0, 1, 0, 0, 0, 0]",2516,1886,630,208,44,0.1102863202545069,0.06984126984126984
"[1, 1, 1, 1, 1, 0, 1, 1, 1, 1, 1, 1, 1, 0, 1]",6866,1233,5633,123,547,0.09975669099756691,0.09710633765311556
"[0, 0, 0, 0, 0, 0, 0, 1, 1, 0, 0, 1, 1, 0, 1]",723,586,137,46,15,0.07849829351535836,0.10948905109489052
"[0, 0, 0, 1, 1, 1, 1, 0, 1, 0, 1, 0, 0, 0, 0]",202,137,65,11,6,0.08029197080291971,0.09230769230769231
"[0, 1, 1, 0, 1, 0, 1, 1, 0, 0, 0, 0, 1, 1, 0]",183,107,76,12,10,0.11214953271028037,0.13157894736842105
"[0, 1, 0, 0, 1, 0, 0, 0, 1, 1, 0, 1, 0, 1, 1]",118,68,50,6,11,0.08823529411764706,0.22
"[1, 0, 0, 1, 1, 1, 1, 1, 0, 1, 1, 1, 1, 1, 1]",2512,489,2023,40,186,0.081799591002045,0.09194265941670786
"[1, 1, 0, 0, 0, 0, 0, 0, 1, 0, 0, 1, 0, 1, 1]",245,149,96,14,9,0.09395973154362416,0.09375
"[0, 0, 0, 0, 1, 1, 1, 1, 1, 1, 0, 0, 1, 1, 0]",1573,805,768,82,71,0.10186335403726708,0.09244791666666667
"[0, 0, 1, 0, 1, 1, 0, 0, 1, 0, 0, 0, 0, 1, 0]",216,142,74,15,6,0.1056338028169014,0.08108108108108109
"[1, 0, 0, 1, 0, 0, 1, 0, 0, 1, 1, 1, 0, 0, 1]",117,64,53,2,10,0.03125,0.18867924528301888
"[1, 1, 1, 0, 0, 0, 0, 1, 0, 0, 1, 0, 0, 1, 0]",145,67,78,7,4,0.1044776119402985,0.05128205128205128
"[1, 1, 1, 1, 1, 1, 1, 1, 0, 0, 0, 0, 1, 0, 0]",379,160,219,13,21,0.08125,0.0958904109589041
"[1, 0, 1, 1, 0, 1, 0, 0, 1, 1, 1, 0, 1, 1, 1]",235,75,160,7,13,0.09333333333333334,0.08125
"[1, 1, 0, 1, 1, 0, 1, 0, 0, 1, 1, 1, 0, 1, 1]",240,80,160,8,15,0.1,0.09375
"[0, 0, 1, 0, 0, 1, 1, 0, 1, 1, 1, 0, 1, 1, 0]",103,52,51,1,3,0.019230769230769232,0.058823529411764705
"[0, 0, 1, 1, 0, 0, 0, 1, 0, 0, 1, 1, 0, 1, 1]",163,95,68,12,6,0.12631578947368421,0.08823529411764706
"[0, 0, 0, 0, 0, 0, 0, 0, 0, 0, 1, 0, 1, 1, 1]",3711,3094,617,297,55,0.09599224305106659,0.08914100486223663
"[0, 0, 0, 0, 0, 0, 0, 1, 0, 0, 0, 0, 0, 0, 1]",8622,7245,1377,691,146,0.09537612146307799,0.10602759622367465
"[0, 1, 0, 0, 1, 1, 0, 1, 1, 0, 0, 1, 1, 1, 1]",247,109,138,8,12,0.07339449541284404,0.08695652173913043
"[0, 0, 1, 0, 0, 1, 1, 0, 1, 1, 0, 0, 1, 1, 1]",174,88,86,9,9,0.10227272727272728,0.10465116279069768
"[0, 1, 0, 0, 0, 0, 0, 0, 0, 0, 1, 0, 0, 1, 1]",815,584,231,51,23,0.08732876712328767,0.09956709956709957
"[1, 0, 0, 0, 0, 0, 0, 0, 1, 1, 1, 1, 1, 1, 0]",517,253,264,12,30,0.04743083003952569,0.11363636363636363
"[0, 0, 0, 1, 1, 0, 0, 0, 0, 1, 0, 0, 0, 0, 0]",2308,1844,464,147,44,0.0797180043383948,0.09482758620689655
"[1, 1, 0, 0, 0, 0, 0, 0, 0, 1, 0, 0, 0, 0, 1]",758,526,232,48,18,0.09125475285171103,0.07758620689655173
"[0, 0, 0, 1, 1, 0, 0, 0, 0, 0, 0, 0, 1, 0, 0]",2276,1869,407,177,55,0.09470304975922954,0.13513513513513514
"[0, 1, 1, 1, 1, 1, 0, 0, 0, 1, 0, 0, 1, 0, 0]",140,81,59,13,8,0.16049382716049382,0.13559322033898305
"[0, 0, 0, 1, 0, 0, 1, 0, 0, 1, 0, 0, 1, 1, 0]",257,184,73,14,10,0.07608695652173914,0.136986301369863
"[0, 1, 1, 1, 0, 1, 1, 1, 1, 1, 1, 1, 1, 1, 0]",1904,491,1413,49,130,0.09979633401221996,0.09200283085633404
"[1, 0, 1, 1, 1, 0, 1, 1, 1, 1, 1, 1, 1, 0, 1]",1596,345,1251,24,115,0.06956521739130435,0.09192645883293366
"[0, 1, 1, 1, 1, 0, 0, 0, 1, 0, 0, 0, 0, 0, 1]",217,149,68,12,8,0.08053691275167785,0.11764705882352941
"[0, 0, 0, 1, 1, 0, 1, 1, 0, 1, 0, 1, 0, 1, 0]",99,43,56,2,5,0.046511627906976744,0.08928571428571429
"[1, 0, 0, 0, 1, 1, 0, 0, 0, 1, 0, 0, 0, 0, 0]",598,413,185,44,23,0.10653753026634383,0.12432432432432433
"[1, 1, 0, 1, 0, 0, 0, 1, 1, 0, 0, 0, 1, 0, 0]",155,101,54,12,4,0.1188118811881188,0.07407407407407407
"[1, 1, 0, 0, 1, 0, 0, 0, 0, 1, 0, 0, 0, 0, 0]",654,472,182,33,16,0.06991525423728813,0.08791208791208792
"[0, 0, 0, 0, 0, 0, 0, 0, 1, 1, 0, 0, 1, 0, 0]",2636,2020,616,210,57,0.10396039603960396,0.09253246753246754
"[1, 1, 1, 0, 1, 0, 1, 1, 1, 0, 1, 1, 1, 1, 1]",1794,416,1378,39,122,0.09375,0.08853410740203194
"[1, 0, 0, 1, 0, 0, 0, 1, 1, 0, 0, 0, 0, 0, 0]",925,622,303,60,27,0.09646302250803858,0.0891089108910891
"[1, 0, 0, 1, 1, 1, 0, 0, 1, 1, 1, 0, 1, 0, 1]",149,47,102,1,7,0.02127659574468085,0.06862745098039216
"[1, 0, 1, 0, 1, 0, 1, 1, 1, 1, 0, 0, 1, 1, 1]",386,141,245,13,14,0.09219858156028368,0.05714285714285714
"[0, 0, 1, 1, 1, 1, 1, 0, 1, 0, 1, 0, 1, 1, 1]",296,121,175,12,16,0.09917355371900827,0.09142857142857143
"[1, 1, 1, 1, 1, 1, 1, 1, 1, 0, 1, 1, 0, 1, 1]",8081,1329,6752,145,605,0.109104589917231,0.08960308056872038
"[0, 1, 1, 1, 1, 1, 1, 1, 1, 1, 0, 0, 1, 1, 1]",4201,1415,2786,129,239,0.0911660777385159,0.08578607322325915
"[0, 1, 1, 0, 0, 0, 0, 0, 0, 0, 0, 0, 0, 1, 1]",5326,4683,643,482,54,0.10292547512278453,0.08398133748055987
"[1, 1, 1, 1, 1, 0, 0, 0, 0, 1, 1, 0, 0, 0, 0]",1688,353,1335,33,125,0.09348441926345609,0.09363295880149813
"[0, 1, 0, 1, 1, 1, 1, 0, 1, 1, 1, 1, 1, 1, 0]",612,200,412,13,35,0.065,0.08495145631067962
"[1, 1, 1, 1, 1, 1, 0, 0, 1, 0, 1, 1, 1, 1, 0]",684,187,497,13,40,0.06951871657754011,0.08048289738430583
"[0, 1, 1, 1, 0, 1, 0, 1, 0, 1, 1, 1, 0, 1, 1]",239,93,146,10,13,0.10752688172043011,0.08904109589041095
"[1, 1, 1, 1, 0, 1, 1, 1, 0, 1, 0, 1, 0, 1, 1]",513,145,368,13,34,0.0896551724137931,0.09239130434782608
"[1, 1, 1, 1, 1, 0, 1, 1, 1, 0, 1, 0, 1, 0, 1]",495,153,342,19,37,0.12418300653594772,0.10818713450292397
"[1, 1, 0, 1, 0, 1, 1, 0, 1, 1, 1, 1, 1, 0, 1]",474,142,332,19,27,0.13380281690140844,0.08132530120481928
"[1, 0, 0, 1, 1, 1, 1, 1, 1, 1, 1, 0, 1, 0, 1]",849,183,666,26,62,0.14207650273224043,0.09309309309309309
"[0, 1, 1, 1, 0, 0, 1, 1, 1, 0, 0, 1, 0, 1, 1]",176,72,104,12,7,0.16666666666666666,0.0673076923076923
"[1, 0, 0, 1, 1, 0, 1, 1, 1, 0, 0, 1, 1, 1, 0]",151,50,101,4,10,0.08,0.09900990099009901
"[1, 0, 1, 1, 1, 0, 1, 1, 0, 0, 1, 1, 1, 1, 1]",822,232,590,20,52,0.08620689655172414,0.08813559322033898
"[1, 0, 1, 0, 1, 1, 1, 0, 1, 1, 0, 0, 1, 1, 1]",297,106,191,11,10,0.10377358490566038,0.05235602094240838
"[0, 0, 0, 0, 1, 0, 0, 0, 0, 0, 0, 0, 1, 0, 0]",6760,5564,1196,550,110,0.09884974838245866,0.09197324414715718
"[0, 0, 0, 0, 0, 1, 0, 1, 1, 0, 1, 0, 0, 0, 0]",593,430,163,33,19,0.07674418604651163,0.1165644171779141
"[1, 1, 0, 1, 1, 1, 1, 1, 1, 1, 1, 1, 0, 1, 0]",1579,396,1183,46,101,0.11616161616161616,0.08537616229923922
"[0, 1, 0, 1, 1, 1, 1, 1, 0, 1, 1, 0, 1, 1, 1]",555,172,383,15,45,0.0872093023255814,0.1174934725848564
"[1, 0, 0, 0, 1, 0, 1, 1, 1, 1, 1, 0, 0, 0, 1]",136,62,74,5,5,0.08064516129032258,0.06756756756756757
"[0, 0, 0, 1, 0, 0, 0, 1, 0, 1, 1, 1, 1, 1, 0]",134,77,57,4,10,0.05194805194805195,0.17543859649122806
"[1, 1, 1, 0, 0, 0, 1, 0, 0, 0, 0, 0, 0, 0, 0]",869,570,299,59,21,0.10350877192982456,0.07023411371237458
"[0, 1, 0, 0, 0, 0, 0, 0, 0, 0, 0, 1, 1, 1, 0]",723,530,193,54,19,0.1018867924528302,0.09844559585492228
"[0, 0, 0, 1, 0, 0, 0, 0, 1, 0, 1, 0, 0, 0, 1]",545,374,171,35,9,0.09358288770053476,0.05263157894736842
"[0, 0, 1, 1, 0, 0, 1, 1, 1, 1, 1, 1, 1, 1, 0]",1999,786,1213,80,120,0.10178117048346055,0.0989282769991756
"[1, 0, 0, 0, 0, 1, 1, 0, 0, 1, 1, 1, 1, 1, 1]",2310,325,1985,30,209,0.09230769230769231,0.1052896725440806
"[1, 1, 1, 1, 1, 1, 0, 0, 1, 1, 0, 1, 0, 0, 1]",366,131,235,12,35,0.0916030534351145,0.14893617021276595
"[0, 1, 0, 1, 1, 1, 1, 1, 1, 1, 0, 0, 1, 1, 0]",466,185,281,10,26,0.05405405405405406,0.09252669039145907
"[1, 0, 1, 1, 1, 0, 0, 1, 1, 1, 1, 1, 1, 0, 1]",612,182,430,16,41,0.08791208791208792,0.09534883720930233
"[1, 1, 0, 0, 1, 1, 1, 0, 1, 1, 1, 0, 0, 1, 1]",358,143,215,10,16,0.06993006993006994,0.07441860465116279
"[1, 0, 0, 1, 1, 1, 0, 0, 1, 1, 1, 0, 1, 1, 1]",299,98,201,7,21,0.07142857142857142,0.1044776119402985
"[1, 0, 0, 1, 1, 1, 1, 0, 0, 0, 0, 0, 0, 0, 0]",2320,629,1691,57,157,0.09062003179650238,0.09284447072738025
"[1, 1, 1, 0, 1, 0, 0, 1, 1, 1, 1, 0, 0, 0, 0]",285,109,176,5,20,0.045871559633027525,0.11363636363636363
"[1, 0, 0, 0, 0, 1, 1, 1, 1, 0, 1, 0, 0, 1, 1]",236,78,158,6,14,0.07692307692307693,0.08860759493670886
"[1, 0, 1, 0, 0, 0, 0, 1, 1, 1, 1, 0, 1, 0, 0]",109,58,51,8,5,0.13793103448275862,0.09803921568627451
"[0, 0, 1, 1, 0, 0, 1, 1, 1, 0, 0, 0, 0, 0, 0]",579,375,204,32,24,0.08533333333333333,0.11764705882352941
"[0, 0, 1, 0, 0, 0, 1, 1, 0, 0, 1, 1, 1, 0, 0]",173,106,67,12,9,0.11320754716981132,0.13432835820895522
"[1, 0, 0, 0, 1, 0, 0, 0, 1, 1, 0, 0, 1, 1, 1]",238,114,124,14,19,0.12280701754385964,0.1532258064516129
"[1, 1, 0, 0, 0, 1, 0, 0, 0, 1, 1, 0, 0, 1, 1]",234,115,119,12,16,0.10434782608695652,0.13445378151260504
"[1, 1, 1, 1, 0, 1, 0, 1, 1, 1, 1, 1, 1, 1, 1]",9361,1735,7626,155,727,0.0893371757925072,0.0953317597692106
"[1, 0, 0, 0, 1, 1, 0, 0, 0, 0, 0, 1, 0, 0, 1]",237,148,89,17,5,0.11486486486486487,0.056179775280898875
"[1, 1, 0, 0, 0, 0, 0, 0, 0, 0, 0, 1, 1, 1, 0]",527,290,237,31,29,0.10689655172413794,0.12236286919831224
"[0, 1, 1, 0, 0, 0, 1, 1, 0, 1, 0, 0, 1, 1, 0]",134,76,58,8,2,0.10526315789473684,0.034482758620689655
"[1, 0, 0, 0, 0, 0, 0, 0, 0, 0, 1, 0, 0, 1, 0]",1720,1199,521,110,55,0.09174311926605505,0.10556621880998081
"[0, 1, 1, 1, 1, 1, 1, 1, 0, 1, 1, 0, 1, 0, 1]",560,173,387,16,42,0.09248554913294797,0.10852713178294573
"[0, 0, 1, 1, 1, 1, 1, 1, 0, 0, 0, 0, 1, 1, 1]",2354,955,1399,109,130,0.11413612565445026,0.09292351679771266
"[0, 0, 0, 1, 1, 1, 1, 1, 1, 0, 0, 0, 0, 1, 1]",1758,1399,359,177,39,0.12651894210150108,0.10863509749303621
"[0, 0, 0, 0, 1, 1, 1, 1, 1, 1, 0, 0, 0, 0, 1]",1685,879,806,83,95,0.09442548350398179,0.11786600496277916
"[0, 0, 0, 0, 0, 0, 1, 1, 1, 1, 1, 1, 0, 0, 0]",2317,1429,888,110,73,0.07697690692792163,0.08220720720720721
"[0, 0, 1, 1, 1, 0, 1, 1, 1, 1, 1, 1, 1, 1, 1]",2648,679,1969,67,178,0.09867452135493372,0.090401218892839
"[0, 0, 1, 1, 0, 0, 0, 0, 0, 1, 1, 1, 0, 1, 1]",202,110,92,8,10,0.07272727272727272,0.10869565217391304
"[1, 1, 1, 0, 0, 1, 1, 0, 0, 0, 0, 0, 1, 1, 1]",493,142,351,15,40,0.1056338028169014,0.11396011396011396
"[1, 1, 0, 1, 1, 0, 0, 1, 1, 1, 0, 0, 1, 1, 0]",183,67,116,6,10,0.08955223880597014,0.08620689655172414
"[1, 1, 0, 0, 1, 0, 0, 1, 1, 1, 1, 1, 0, 1, 1]",292,108,184,10,20,0.09259259259259259,0.10869565217391304
"[1, 1, 0, 0, 1, 0, 1, 1, 0, 1, 1, 1, 0, 1, 1]",256,92,164,11,18,0.11956521739130435,0.10975609756097561
"[0, 0, 1, 0, 0, 0, 1, 1, 1, 1, 0, 0, 1, 0, 1]",119,68,51,5,2,0.07352941176470588,0.0392156862745098
"[1, 0, 1, 1, 1, 0, 0, 1, 0, 0, 0, 1, 1, 1, 1]",204,89,115,6,9,0.06741573033707865,0.0782608695652174
"[1, 1, 0, 0, 1, 0, 1, 1, 1, 0, 0, 1, 0, 0, 0]",117,58,59,6,3,0.10344827586206896,0.05084745762711865
"[0, 0, 0, 0, 1, 1, 1, 1, 0, 0, 1, 0, 1, 1, 1]",433,217,216,17,19,0.07834101382488479,0.08796296296296297
"[1, 0, 0, 0, 0, 1, 1, 1, 0, 0, 1, 1, 0, 0, 0]",294,170,124,13,11,0.07647058823529412,0.08870967741935484
"[1, 1, 1, 1, 1, 1, 1, 1, 0, 0, 1, 1, 0, 0, 0]",2318,858,1460,86,155,0.10023310023310024,0.10616438356164383
"[0, 0, 0, 0, 0, 0, 0, 1, 0, 0, 0, 0, 1, 0, 0]",7064,5830,1234,535,112,0.09176672384219554,0.09076175040518639
"[1, 1, 0, 0, 0, 0, 0, 0, 1, 1, 0, 1, 0, 1, 1]",288,157,131,15,7,0.09554140127388536,0.05343511450381679
"[1, 1, 1, 1, 1, 0, 0, 0, 0, 1, 1, 1, 1, 1, 0]",742,165,577,15,59,0.09090909090909091,0.1022530329289428
"[0, 0, 0, 0, 0, 0, 0, 0, 1, 1, 0, 0, 1, 1, 1]",3838,2670,1168,243,105,0.09101123595505618,0.0898972602739726
"[1, 1, 1, 1, 0, 0, 0, 0, 0, 1, 0, 1, 1, 0, 0]",210,107,103,14,9,0.1308411214953271,0.08737864077669903
"[1, 1, 0, 1, 0, 1, 1, 1, 0, 0, 0, 0, 0, 0, 0]",333,168,165,26,20,0.15476190476190477,0.12121212121212122
"[0, 0, 0, 0, 1, 0, 0, 1, 1, 0, 0, 0, 0, 0, 0]",2857,2146,711,189,61,0.08807082945013979,0.08579465541490858
"[0, 0, 0, 0, 0, 0, 0, 1, 0, 0, 1, 1, 0, 0, 0]",2504,1959,545,178,48,0.09086268504338949,0.08807339449541285
"[0, 1, 1, 1, 1, 1, 1, 0, 0, 1, 1, 0, 0, 1, 1]",2410,1683,727,158,68,0.09387997623291741,0.09353507565337002
"[1, 1, 0, 1, 1, 1, 0, 1, 0, 0, 1, 1, 1, 0, 0]",154,68,86,7,8,0.10294117647058823,0.09302325581395349
"[0, 0, 0, 1, 1, 0, 1, 1, 1, 0, 1, 0, 0, 1, 1]",156,75,81,9,6,0.12,0.07407407407407407
"[1, 0, 0, 0, 0, 0, 0, 0, 0, 1, 1, 0, 1, 1, 1]",509,179,330,22,34,0.12290502793296089,0.10303030303030303
"[1, 0, 0, 0, 0, 0, 0, 1, 1, 1, 1, 0, 1, 0, 0]",292,135,157,15,9,0.1111111111111111,0.05732484076433121
"[0, 0, 1, 1, 1, 1, 0, 0, 1, 1, 0, 0, 1, 0, 1]",356,178,178,18,16,0.10112359550561797,0.0898876404494382
"[1, 1, 0, 0, 1, 1, 1, 0, 1, 0, 0, 0, 0, 1, 1]",229,100,129,7,13,0.07,0.10077519379844961
"[0, 1, 0, 1, 1, 0, 0, 1, 1, 1, 0, 1, 0, 0, 0]",128,66,62,8,4,0.12121212121212122,0.06451612903225806
"[0, 0, 0, 0, 1, 0, 0, 0, 1, 0, 0, 1, 0, 1, 1]",270,183,87,15,11,0.08196721311475409,0.12643678160919541
"[0, 0, 0, 0, 1, 1, 0, 0, 0, 0, 0, 0, 0, 1, 1]",2571,1930,641,191,55,0.09896373056994819,0.08580343213728549
"[0, 0, 0, 0, 1, 1, 1, 1, 0, 0, 0, 1, 0, 0, 1]",333,204,129,23,13,0.11274509803921569,0.10077519379844961
"[0, 0, 0, 0, 0, 0, 0, 0, 1, 0, 1, 1, 0, 0, 0]",2191,1717,474,147,37,0.0856144437973209,0.07805907172995781
"[0, 0, 0, 0, 0, 0, 1, 0, 1, 1, 0, 1, 1, 0, 0]",263,180,83,18,9,0.1,0.10843373493975904
"[0, 0, 0, 1, 1, 0, 1, 1, 1, 0, 0, 1, 1, 1, 1]",283,146,137,15,15,0.10273972602739725,0.10948905109489052
"[0, 1, 0, 0, 1, 0, 1, 1, 1, 1, 0, 0, 0, 1, 0]",91,52,39,5,6,0.09615384615384616,0.15384615384615385
"[0, 0, 0, 0, 0, 1, 1, 1, 1, 0, 0, 0, 0, 0, 0]",5386,4642,744,408,71,0.08789314950452391,0.09543010752688172
"[1, 1, 0, 0, 0, 0, 0, 1, 1, 1, 1, 0, 0, 0, 0]",533,326,207,28,13,0.08588957055214724,0.06280193236714976
"[1, 1, 1, 0, 0, 0, 0, 1, 0, 0, 0, 1, 0, 0, 1]",169,95,74,7,10,0.07368421052631578,0.13513513513513514
"[0, 0, 1, 0, 1, 0, 1, 1, 1, 0, 0, 0, 0, 1, 0]",134,81,53,9,7,0.1111111111111111,0.1320754716981132
"[1, 0, 1, 1, 0, 1, 0, 1, 0, 0, 0, 1, 1, 1, 1]",184,84,100,7,8,0.08333333333333333,0.08
"[1, 0, 1, 0, 1, 0, 0, 1, 1, 1, 0, 1, 1, 0, 1]",146,57,89,6,12,0.10526315789473684,0.1348314606741573
"[1, 1, 1, 0, 1, 0, 0, 0, 1, 0, 1, 0, 1, 0, 0]",112,62,50,3,6,0.04838709677419355,0.12
"[0, 0, 1, 1, 1, 0, 0, 1, 1, 0, 1, 0, 0, 1, 0]",102,51,51,5,5,0.09803921568627451,0.09803921568627451
"[0, 1, 0, 0, 1, 1, 0, 0, 0, 1, 1, 1, 0, 1, 0]",106,59,47,2,3,0.03389830508474576,0.06382978723404255
"[1, 0, 0, 0, 0, 0, 0, 0, 0, 1, 1, 0, 1, 0, 1]",413,187,226,14,19,0.0748663101604278,0.084070796460177
"[0, 0, 0, 1, 1, 0, 0, 0, 1, 0, 0, 0, 0, 0, 0]",2118,1688,430,167,40,0.09893364928909952,0.09302325581395349
"[1, 1, 1, 0, 0, 0, 1, 0, 0, 1, 1, 1, 1, 1, 1]",457,136,321,17,33,0.125,0.102803738317757
"[0, 0, 0, 1, 0, 0, 1, 0, 1, 1, 1, 1, 0, 1, 1]",115,51,64,3,9,0.058823529411764705,0.140625
"[1, 1, 1, 1, 1, 0, 0, 1, 0, 1, 1, 1, 1, 1, 1]",2331,489,1842,41,177,0.08384458077709611,0.09609120521172639
"[0, 1, 1, 1, 1, 1, 1, 1, 1, 1, 0, 0, 1, 0, 1]",686,271,415,19,42,0.07011070110701106,0.10120481927710843
"[1, 1, 1, 1, 1, 1, 0, 1, 1, 1, 0, 0, 0, 1, 0]",260,97,163,8,11,0.08247422680412371,0.06748466257668712
"[1, 1, 1, 0, 1, 1, 1, 1, 0, 0, 1, 1, 1, 1, 1]",3251,749,2502,66,237,0.08811748998664887,0.09472422062350119
"[0, 1, 1, 1, 1, 1, 0, 0, 1, 0, 0, 1, 0, 1, 1]",153,75,78,6,11,0.08,0.14102564102564102
"[1, 1, 1, 0, 1, 1, 1, 1, 1, 0, 0, 1, 0, 0, 1]",285,120,165,4,18,0.03333333333333333,0.10909090909090909
"[1, 1, 1, 0, 1, 1, 1, 0, 1, 1, 1, 1, 1, 0, 0]",746,204,542,21,51,0.10294117647058823,0.0940959409594096
"[1, 0, 1, 0, 1, 1, 1, 1, 1, 1, 1, 1, 0, 1, 1]",1611,406,1205,42,123,0.10344827586206896,0.1020746887966805
"[0, 0, 1, 1, 0, 0, 1, 1, 0, 0, 0, 0, 1, 1, 1]",2065,1115,950,107,91,0.09596412556053811,0.09578947368421052
"[0, 0, 0, 0, 0, 1, 1, 1, 0, 0, 1, 1, 0, 0, 1]",283,172,111,18,10,0.10465116279069768,0.09009009009009009
"[0, 0, 1, 1, 0, 0, 1, 0, 1, 1, 1, 0, 1, 0, 1]",133,72,61,6,6,0.08333333333333333,0.09836065573770492
"[1, 0, 1, 0, 0, 0, 0, 1, 1, 0, 0, 0, 0, 1, 0]",259,163,96,11,9,0.06748466257668712,0.09375
"[1, 0, 0, 1, 0, 0, 1, 0, 1, 0, 1, 0, 0, 1, 1]",132,68,64,5,8,0.07352941176470588,0.125
"[0, 1, 0, 0, 1, 1, 1, 0, 0, 1, 0, 0, 1, 0, 1]",103,58,45,7,6,0.1206896551724138,0.13333333333333333
"[0, 0, 0, 1, 1, 0, 1, 1, 0, 0, 1, 1, 1, 1, 1]",328,160,168,22,21,0.1375,0.125
"[0, 0, 0, 0, 0, 0, 0, 0, 0, 1, 1, 0, 1, 1, 0]",883,685,198,61,19,0.08905109489051095,0.09595959595959595
"[1, 1, 0, 0, 0, 0, 0, 0, 1, 1, 1, 1, 0, 0, 0]",1990,1206,784,104,82,0.08623548922056384,0.10459183673469388
"[0, 0, 1, 1, 0, 0, 0, 0, 0, 1, 0, 1, 0, 1, 1]",271,156,115,10,14,0.0641025641025641,0.12173913043478261
"[1, 0, 0, 1, 1, 0, 0, 0, 0, 0, 1, 0, 1, 0, 1]",204,85,119,9,15,0.10588235294117647,0.12605042016806722
"[1, 0, 1, 0, 0, 1, 1, 0, 0, 0, 0, 0, 1, 0, 1]",181,104,77,9,6,0.08653846153846154,0.07792207792207792
"[0, 0, 0, 0, 1, 1, 0, 0, 1, 1, 1, 0, 0, 1, 0]",250,159,91,20,8,0.12578616352201258,0.08791208791208792
"[1, 1, 0, 0, 1, 1, 0, 0, 0, 1, 0, 0, 1, 1, 1]",292,142,150,13,19,0.09154929577464789,0.12666666666666668
"[1, 1, 1, 1, 1, 0, 0, 1, 1, 0, 0, 0, 1, 0, 0]",217,67,150,5,13,0.07462686567164178,0.08666666666666667
"[1, 1, 0, 1, 1, 1, 1, 1, 0, 0, 1, 1, 0, 0, 0]",323,134,189,8,18,0.05970149253731343,0.09523809523809523
"[0, 1, 0, 1, 0, 0, 1, 1, 1, 1, 0, 0, 0, 1, 1]",155,61,94,8,8,0.13114754098360656,0.0851063829787234
"[0, 1, 0, 0, 0, 0, 0, 0, 1, 1, 0, 0, 0, 0, 0]",3490,2637,853,233,85,0.08835798255593477,0.09964830011723329
"[0, 1, 0, 0, 1, 1, 1, 1, 0, 0, 1, 1, 0, 0, 0]",479,283,196,22,15,0.07773851590106007,0.07653061224489796
"[0, 0, 0, 0, 0, 0, 1, 0, 1, 1, 0, 0, 1, 0, 0]",543,405,138,46,15,0.11358024691358025,0.10869565217391304
"[1, 0, 1, 1, 1, 1, 1, 1, 0, 1, 1, 0, 1, 1, 0]",524,159,365,19,34,0.11949685534591195,0.09315068493150686
"[0, 1, 0, 0, 0, 1, 0, 1, 1, 0, 0, 1, 1, 0, 0]",281,175,106,14,11,0.08,0.10377358490566038
"[0, 1, 1, 0, 1, 0, 0, 1, 0, 0, 1, 0, 0, 1, 0]",130,79,51,8,0,0.10126582278481013,0.0
"[0, 1, 1, 0, 1, 1, 1, 0, 0, 1, 1, 0, 1, 0, 0]",118,54,64,5,8,0.09259259259259259,0.125
"[1, 0, 0, 1, 1, 1, 0, 1, 1, 1, 0, 0, 1, 1, 0]",171,61,110,6,9,0.09836065573770492,0.08181818181818182
"[0, 0, 1, 0, 1, 0, 0, 1, 0, 0, 1, 1, 1, 0, 1]",112,63,49,5,2,0.07936507936507936,0.04081632653061224
"[0, 1, 1, 0, 0, 0, 1, 0, 0, 1, 0, 0, 1, 1, 1]",178,117,61,10,6,0.08547008547008547,0.09836065573770492
"[0, 0, 0, 0, 1, 1, 0, 0, 0, 1, 0, 0, 1, 0, 0]",643,463,180,50,22,0.1079913606911447,0.12222222222222222
"[1, 0, 0, 0, 0, 0, 1, 1, 1, 1, 1, 1, 0, 0, 0]",516,280,236,24,24,0.08571428571428572,0.1016949152542373
"[0, 1, 0, 1, 1, 1, 1, 0, 0, 0, 0, 0, 0, 1, 0]",181,107,74,8,3,0.07476635514018691,0.04054054054054054
"[0, 0, 0, 0, 0, 1, 0, 0, 0, 1, 1, 0, 0, 0, 1]",631,472,159,48,13,0.1016949152542373,0.08176100628930817
"[1, 1, 0, 0, 0, 1, 0, 0, 0, 1, 1, 0, 0, 0, 1]",204,115,89,10,11,0.08695652173913043,0.12359550561797752
"[0, 0, 0, 0, 0, 1, 0, 0, 1, 0, 0, 0, 0, 1, 1]",977,719,258,57,26,0.07927677329624479,0.10077519379844961
"[0, 1, 1, 1, 1, 1, 1, 0, 0, 0, 0, 0, 0, 1, 1]",1803,1412,391,133,32,0.09419263456090651,0.08184143222506395
"[0, 0, 0, 1, 0, 0, 1, 0, 1, 0, 1, 0, 1, 1, 0]",148,92,56,10,10,0.10869565217391304,0.17857142857142858
"[0, 0, 1, 0, 1, 0, 1, 1, 0, 0, 0, 0, 0, 0, 0]",854,611,243,61,20,0.09983633387888707,0.0823045267489712
"[0, 1, 0, 0, 0, 0, 0, 0, 0, 1, 0, 1, 0, 1, 1]",298,206,92,23,14,0.11165048543689321,0.15217391304347827
"[0, 0, 0, 1, 1, 0, 0, 0, 1, 1, 1, 1, 1, 1, 1]",442,253,189,21,21,0.08300395256916997,0.1111111111111111
"[0, 1, 1, 0, 0, 0, 1, 1, 0, 0, 0, 1, 1, 1, 1]",216,135,81,16,7,0.11851851851851852,0.08641975308641975
"[1, 0, 1, 1, 0, 1, 1, 0, 1, 0, 1, 0, 0, 0, 1]",104,43,61,6,3,0.13953488372093023,0.04918032786885246
"[0, 1, 0, 0, 1, 0, 0, 0, 0, 0, 0, 1, 1, 0, 0]",941,680,261,75,27,0.11029411764705882,0.10344827586206896
"[1, 0, 0, 1, 0, 1, 0, 0, 0, 0, 0, 1, 0, 1, 0]",269,178,91,12,9,0.06741573033707865,0.0989010989010989
"[0, 1, 0, 0, 1, 0, 1, 0, 0, 0, 0, 0, 1, 0, 1]",271,176,95,11,11,0.0625,0.11578947368421053
"[1, 1, 0, 0, 0, 0, 1, 1, 1, 1, 0, 0, 0, 0, 0]",1989,1202,787,106,66,0.08818635607321132,0.08386277001270648
"[1, 1, 1, 1, 0, 0, 0, 0, 1, 1, 1, 1, 0, 0, 0]",1533,731,802,60,61,0.08207934336525308,0.07605985037406483
"[0, 0, 1, 0, 1, 1, 1, 1, 0, 0, 0, 0, 1, 1, 1]",349,169,180,19,14,0.11242603550295859,0.07777777777777778
"[1, 1, 0, 1, 1, 0, 0, 0, 1, 0, 1, 1, 1, 1, 1]",302,124,178,14,13,0.11290322580645161,0.07303370786516854
"[1, 1, 0, 0, 0, 0, 0, 1, 0, 1, 0, 0, 1, 1, 0]",194,105,89,10,8,0.09523809523809523,0.0898876404494382
"[1, 1, 0, 0, 0, 0, 1, 0, 0, 0, 1, 1, 1, 0, 1]",106,60,46,8,5,0.13333333333333333,0.10869565217391304
"[0, 0, 0, 1, 1, 0, 1, 1, 0, 0, 0, 0, 1, 0, 0]",249,153,96,18,7,0.11764705882352941,0.07291666666666667
"[1, 0, 0, 1, 1, 0, 0, 1, 1, 0, 1, 0, 1, 1, 1]",308,78,230,9,14,0.11538461538461539,0.06086956521739131
"[0, 0, 1, 0, 1, 1, 1, 0, 0, 0, 1, 0, 1, 1, 1]",151,71,80,7,7,0.09859154929577464,0.0875
"[1, 0, 1, 0, 0, 1, 0, 0, 1, 0, 0, 1, 0, 0, 1]",140,87,53,10,5,0.11494252873563218,0.09433962264150944
"[0, 1, 1, 1, 0, 1, 0, 0, 0, 1, 1, 1, 1, 0, 0]",230,117,113,11,10,0.09401709401709402,0.08849557522123894
"[0, 0, 0, 1, 1, 1, 0, 1, 0, 0, 0, 1, 1, 1, 1]",230,130,100,12,7,0.09230769230769231,0.07
"[0, 1, 0, 0, 0, 0, 0, 1, 1, 1, 0, 1, 0, 0, 0]",273,175,98,12,6,0.06857142857142857,0.061224489795918366
"[1, 0, 0, 1, 0, 1, 0, 0, 0, 0, 0, 1, 1, 1, 0]",189,110,79,11,9,0.1,0.11392405063291139
"[1, 1, 0, 0, 1, 0, 1, 0, 0, 0, 0, 0, 1, 1, 1]",247,137,110,14,10,0.10218978102189781,0.09090909090909091
"[1, 0, 0, 0, 0, 1, 0, 0, 1, 0, 1, 1, 1, 0, 0]",191,110,81,9,8,0.08181818181818182,0.09876543209876543
"[1, 0, 0, 0, 0, 0, 1, 0, 0, 0, 0, 0, 1, 1, 0]",734,510,224,53,26,0.10392156862745099,0.11607142857142858
"[1, 0, 1, 1, 0, 1, 0, 0, 0, 1, 0, 0, 1, 0, 0]",128,69,59,5,7,0.07246376811594203,0.11864406779661017
"[0, 1, 0, 1, 1, 0, 1, 0, 0, 0, 1, 0, 0, 1, 0]",114,58,56,4,2,0.06896551724137931,0.03571428571428571
"[0, 0, 1, 0, 1, 1, 0, 1, 0, 0, 0, 1, 0, 0, 1]",105,59,46,4,3,0.06779661016949153,0.06521739130434782
"[0, 1, 0, 0, 0, 1, 0, 0, 1, 0, 0, 1, 1, 0, 1]",135,75,60,10,7,0.13333333333333333,0.11666666666666667
"[0, 1, 0, 1, 1, 0, 1, 0, 0, 0, 0, 1, 0, 1, 1]",120,60,60,8,5,0.13333333333333333,0.08333333333333333
"[0, 1, 0, 1, 0, 0, 0, 0, 0, 0, 0, 0, 1, 1, 0]",1025,703,322,60,34,0.08534850640113797,0.10559006211180125
"[1, 0, 1, 1, 0, 0, 1, 1, 1, 0, 0, 0, 0, 0, 0]",278,151,127,11,14,0.0728476821192053,0.11023622047244094
"[0, 0, 0, 0, 1, 1, 1, 1, 0, 0, 0, 0, 1, 1, 0]",1986,1209,777,107,78,0.08850289495450786,0.10038610038610038
"[0, 1, 1, 1, 0, 0, 0, 0, 0, 1, 1, 1, 1, 0, 0]",296,171,125,23,10,0.13450292397660818,0.08
"[1, 0, 0, 1, 0, 0, 0, 0, 0, 0, 0, 1, 0, 1, 1]",327,206,121,18,12,0.08737864077669903,0.09917355371900827
"[0, 0, 1, 0, 0, 0, 0, 0, 0, 1, 0, 0, 1, 0, 0]",1569,1190,379,103,35,0.0865546218487395,0.09234828496042216
"[0, 1, 1, 1, 0, 0, 0, 0, 1, 0, 0, 0, 0, 0, 0]",654,467,187,34,16,0.0728051391862955,0.0855614973262032
"[0, 0, 0, 0, 1, 0, 0, 0, 1, 1, 0, 0, 0, 0, 1]",802,570,232,67,24,0.11754385964912281,0.10344827586206896
"[1, 0, 0, 0, 1, 0, 1, 0, 0, 1, 1, 0, 0, 0, 1]",152,90,62,9,7,0.1,0.11290322580645161
"[0, 1, 0, 0, 0, 1, 0, 1, 0, 0, 1, 1, 0, 0, 0]",333,237,96,16,9,0.06751054852320675,0.09375
"[1, 0, 1, 0, 0, 0, 1, 0, 1, 0, 0, 1, 1, 0, 0]",171,93,78,14,9,0.15053763440860216,0.11538461538461539
"[0, 1, 0, 1, 0, 1, 1, 1, 0, 0, 1, 0, 0, 0, 1]",134,65,69,8,4,0.12307692307692308,0.057971014492753624
"[1, 0, 1, 1, 0, 0, 1, 0, 1, 1, 1, 0, 0, 1, 1]",183,77,106,4,13,0.05194805194805195,0.12264150943396226
"[1, 0, 1, 1, 0, 1, 1, 0, 0, 1, 0, 1, 1, 1, 0]",131,60,71,7,5,0.11666666666666667,0.07042253521126761
"[1, 1, 1, 1, 0, 1, 0, 1, 1, 0, 1, 1, 0, 1, 1]",506,137,369,10,30,0.072992700729927,0.08130081300813008
"[1, 0, 1, 1, 0, 1, 0, 1, 0, 1, 1, 1, 1, 1, 1]",609,191,418,20,34,0.10471204188481675,0.08133971291866028
"[1, 0, 1, 0, 0, 1, 1, 1, 0, 1, 1, 0, 1, 1, 0]",144,50,94,4,6,0.08,0.06382978723404255
"[1, 1, 1, 0, 1, 0, 1, 1, 1, 1, 0, 0, 0, 1, 0]",144,56,88,3,10,0.05357142857142857,0.11363636363636363
"[1, 1, 1, 0, 1, 0, 1, 0, 1, 1, 0, 1, 0, 1, 1]",275,86,189,6,12,0.06976744186046512,0.06349206349206349
"[0, 0, 0, 1, 1, 1, 1, 1, 1, 1, 0, 1, 1, 1, 0]",312,142,170,10,21,0.07042253521126761,0.12352941176470589
"[0, 0, 0, 0, 1, 1, 1, 1, 0, 0, 0, 1, 1, 1, 1]",491,233,258,26,19,0.11158798283261803,0.07364341085271318
"[1, 0, 0, 0, 0, 1, 1, 1, 1, 0, 0, 0, 1, 1, 1]",469,125,344,8,28,0.064,0.08139534883720931
"[0, 0, 1, 1, 0, 0, 0, 1, 0, 0, 0, 0, 1, 1, 1]",407,272,135,24,14,0.08823529411764706,0.1037037037037037
"[0, 0, 1, 0, 0, 0, 0, 0, 1, 0, 0, 0, 0, 1, 0]",1449,1107,342,109,35,0.0984643179765131,0.1023391812865497
"[0, 0, 0, 1, 1, 0, 0, 0, 1, 0, 0, 0, 1, 0, 0]",569,413,156,37,20,0.08958837772397095,0.1282051282051282
"[1, 1, 0, 0, 0, 0, 1, 0, 1, 1, 0, 0, 0, 0, 0]",375,230,145,19,11,0.08260869565217391,0.07586206896551724
"[0, 1, 1, 0, 0, 0, 0, 0, 1, 0, 1, 0, 1, 0, 1]",154,105,49,13,3,0.12380952380952381,0.061224489795918366
"[0, 0, 1, 1, 0, 0, 0, 0, 0, 1, 0, 1, 0, 1, 0]",265,176,89,19,9,0.10795454545454546,0.10112359550561797
"[0, 0, 1, 0, 0, 1, 0, 0, 0, 0, 1, 0, 0, 1, 0]",476,330,146,26,15,0.07878787878787878,0.10273972602739725
"[0, 1, 1, 0, 0, 0, 0, 1, 1, 0, 0, 0, 1, 1, 1]",504,388,116,47,10,0.1211340206185567,0.08620689655172414
"[0, 1, 1, 1, 1, 1, 1, 1, 0, 1, 1, 0, 0, 0, 0]",240,111,129,9,13,0.08108108108108109,0.10077519379844961
"[0, 1, 1, 0, 1, 1, 0, 1, 1, 0, 1, 1, 1, 1, 0]",221,81,140,5,14,0.06172839506172839,0.1
"[0, 0, 1, 1, 1, 0, 0, 0, 0, 0, 0, 0, 0, 0, 1]",1019,725,294,74,27,0.10206896551724139,0.09183673469387756
"[1, 0, 0, 1, 0, 1, 1, 1, 1, 1, 1, 0, 1, 0, 0]",148,63,85,7,5,0.1111111111111111,0.058823529411764705
"[0, 0, 0, 0, 1, 1, 1, 1, 0, 1, 1, 1, 1, 1, 1]",625,234,391,18,36,0.07692307692307693,0.09207161125319693
"[1, 0, 0, 0, 0, 1, 1, 1, 1, 0, 1, 1, 1, 1, 1]",621,130,491,14,49,0.1076923076923077,0.09979633401221996
"[0, 1, 0, 1, 0, 0, 0, 1, 1, 0, 0, 0, 0, 1, 1]",398,243,155,24,13,0.09876543209876543,0.08387096774193549
"[1, 0, 1, 1, 1, 1, 1, 1, 0, 1, 0, 1, 1, 0, 1]",496,139,357,26,39,0.18705035971223022,0.1092436974789916
"[1, 1, 1, 0, 1, 1, 1, 1, 1, 1, 0, 1, 0, 1, 1]",1584,389,1195,34,120,0.08740359897172237,0.100418410041841
"[1, 1, 1, 0, 0, 1, 0, 1, 0, 1, 0, 1, 0, 1, 1]",141,42,99,4,7,0.09523809523809523,0.0707070707070707
"[1, 1, 1, 1, 1, 1, 1, 1, 1, 0, 0, 1, 0, 1, 0]",792,196,596,19,61,0.09693877551020408,0.10234899328859061
"[1, 0, 1, 0, 0, 1, 1, 1, 1, 1, 1, 1, 1, 1, 0]",747,243,504,18,45,0.07407407407407407,0.08928571428571429
"[1, 1, 0, 1, 0, 0, 1, 1, 1, 1, 1, 1, 1, 1, 1]",2827,684,2143,65,219,0.09502923976608187,0.1021931871208586
"[0, 0, 0, 1, 0, 1, 1, 1, 0, 0, 0, 0, 0, 0, 0]",845,588,257,55,21,0.0935374149659864,0.08171206225680934
"[1, 0, 0, 0, 1, 0, 1, 1, 1, 0, 0, 0, 0, 0, 0]",385,218,167,23,11,0.10550458715596331,0.0658682634730539
"[0, 0, 0, 0, 0, 0, 0, 1, 1, 0, 0, 0, 1, 0, 1]",913,706,207,73,20,0.10339943342776203,0.0966183574879227
"[1, 1, 0, 1, 0, 1, 0, 1, 1, 1, 1, 1, 0, 1, 1]",534,152,382,15,29,0.09868421052631579,0.07591623036649214
"[1, 1, 1, 1, 1, 0, 1, 0, 1, 1, 1, 0, 1, 0, 1]",496,122,374,6,39,0.04918032786885246,0.10427807486631016
"[0, 0, 1, 0, 1, 0, 1, 0, 1, 0, 0, 0, 0, 0, 0]",628,422,206,34,20,0.08056872037914692,0.0970873786407767
"[0, 0, 0, 1, 0, 1, 0, 1, 0, 1, 0, 0, 0, 0, 0]",575,428,147,31,11,0.07242990654205607,0.07482993197278912
"[0, 0, 0, 0, 0, 0, 0, 1, 0, 1, 0, 1, 0, 1, 0]",550,399,151,29,14,0.07268170426065163,0.09271523178807947
"[0, 1, 0, 1, 0, 0, 0, 1, 1, 1, 1, 0, 1, 0, 0]",133,78,55,7,3,0.08974358974358974,0.05454545454545454
"[1, 0, 0, 1, 0, 1, 0, 0, 0, 1, 1, 1, 1, 0, 1]",125,58,67,2,4,0.034482758620689655,0.05970149253731343
"[0, 1, 1, 0, 0, 1, 0, 0, 1, 0, 1, 0, 0, 0, 1]",164,107,57,8,5,0.07476635514018691,0.08771929824561403
"[0, 0, 1, 1, 1, 0, 0, 0, 0, 0, 1, 1, 0, 0, 1]",272,160,112,14,13,0.0875,0.11607142857142858
"[1, 0, 0, 1, 1, 0, 0, 1, 1, 1, 1, 1, 1, 0, 1]",712,116,596,5,54,0.04310344827586207,0.09060402684563758
"[1, 1, 0, 0, 0, 0, 1, 1, 0, 0, 1, 1, 0, 0, 1]",1575,801,774,81,57,0.10112359550561797,0.07364341085271318
"[1, 0, 1, 0, 0, 0, 1, 0, 0, 1, 0, 0, 1, 0, 0]",215,138,77,17,8,0.12318840579710146,0.1038961038961039
"[0, 1, 0, 1, 0, 1, 1, 0, 1, 1, 0, 1, 0, 0, 0]",112,50,62,7,10,0.14,0.16129032258064516
"[0, 1, 0, 1, 1, 0, 1, 0, 1, 1, 1, 0, 0, 1, 0]",99,39,60,2,5,0.05128205128205128,0.08333333333333333
"[0, 1, 0, 1, 0, 1, 1, 0, 1, 0, 1, 1, 1, 0, 0]",118,63,55,9,4,0.14285714285714285,0.07272727272727272
"[0, 0, 0, 0, 0, 0, 1, 1, 0, 0, 1, 0, 0, 1, 1]",668,457,211,45,21,0.09846827133479212,0.0995260663507109
"[0, 1, 0, 0, 1, 0, 1, 0, 1, 0, 0, 0, 1, 1, 0]",149,90,59,9,4,0.1,0.06779661016949153
"[0, 0, 1, 1, 0, 0, 1, 1, 1, 0, 1, 1, 0, 1, 0]",140,70,70,4,9,0.05714285714285714,0.12857142857142856
"[0, 1, 0, 0, 0, 1, 1, 0, 0, 1, 1, 1, 0, 1, 1]",128,57,71,4,7,0.07017543859649122,0.09859154929577464
"[0, 1, 1, 0, 1, 0, 1, 0, 0, 1, 0, 0, 0, 1, 1]",125,58,67,6,6,0.10344827586206896,0.08955223880597014
"[0, 1, 0, 1, 0, 1, 0, 1, 0, 0, 0, 0, 1, 1, 0]",191,114,77,11,6,0.09649122807017543,0.07792207792207792
"[0, 0, 1, 0, 1, 0, 1, 0, 1, 0, 0, 0, 0, 1, 1]",196,114,82,9,10,0.07894736842105263,0.12195121951219512
"[1, 0, 0, 1, 0, 0, 0, 1, 1, 1, 0, 1, 1, 1, 0]",101,47,54,5,4,0.10638297872340426,0.07407407407407407
"[0, 1, 1, 1, 0, 1, 0, 0, 1, 0, 0, 0, 1, 1, 1]",132,71,61,5,8,0.07042253521126761,0.13114754098360656
"[0, 1, 0, 1, 0, 0, 0, 0, 1, 1, 1, 1, 1, 1, 1]",384,180,204,24,12,0.13333333333333333,0.058823529411764705
"[1, 1, 1, 0, 0, 1, 0, 1, 0, 1, 0, 0, 0, 0, 1]",142,58,84,7,7,0.1206896551724138,0.08333333333333333
"[1, 0, 1, 0, 0, 0, 0, 1, 0, 0, 0, 0, 1, 1, 1]",247,156,91,16,6,0.10256410256410256,0.06593406593406594
"[0, 0, 0, 1, 1, 1, 0, 0, 0, 0, 1, 1, 0, 0, 1]",374,235,139,20,12,0.0851063829787234,0.08633093525179857
"[0, 0, 0, 0, 0, 1, 1, 1, 0, 0, 0, 0, 1, 1, 0]",574,382,192,42,20,0.1099476439790576,0.10416666666666667
"[0, 0, 1, 0, 1, 1, 0, 0, 0, 0, 0, 0, 1, 1, 1]",447,267,180,21,17,0.07865168539325842,0.09444444444444444
"[0, 0, 0, 0, 1, 0, 1, 1, 0, 0, 0, 0, 0, 0, 1]",766,532,234,51,28,0.09586466165413533,0.11965811965811966
"[1, 1, 1, 0, 0, 1, 1, 0, 0, 0, 0, 1, 0, 0, 0]",301,105,196,10,19,0.09523809523809523,0.09693877551020408
"[1, 1, 0, 1, 1, 1, 1, 1, 0, 0, 1, 0, 1, 1, 1]",602,196,406,19,43,0.09693877551020408,0.10591133004926108
"[0, 0, 0, 0, 1, 0, 1, 0, 1, 1, 0, 1, 0, 1, 1]",150,77,73,8,5,0.1038961038961039,0.0684931506849315
"[1, 1, 1, 1, 0, 0, 1, 1, 1, 1, 0, 0, 0, 0, 1]",2021,796,1225,82,121,0.10301507537688442,0.09877551020408164
"[0, 1, 1, 0, 0, 0, 1, 1, 1, 1, 1, 1, 0, 0, 1]",339,151,188,14,17,0.09271523178807947,0.09042553191489362
"[0, 1, 1, 0, 0, 1, 0, 1, 0, 0, 0, 0, 1, 1, 0]",179,108,71,12,10,0.1111111111111111,0.14084507042253522
"[1, 0, 0, 0, 0, 1, 1, 0, 0, 1, 0, 1, 0, 0, 0]",336,177,159,30,17,0.1694915254237288,0.1069182389937107
"[1, 1, 1, 0, 0, 0, 0, 1, 1, 0, 0, 1, 0, 1, 0]",242,83,159,9,21,0.10843373493975904,0.1320754716981132
"[0, 1, 1, 1, 1, 0, 1, 0, 0, 1, 1, 1, 1, 1, 0]",269,103,166,12,20,0.11650485436893204,0.12048192771084337
"[1, 1, 0, 0, 1, 1, 1, 0, 1, 1, 1, 1, 0, 1, 0]",244,79,165,10,14,0.12658227848101267,0.08484848484848485
"[1, 0, 1, 0, 0, 0, 1, 0, 1, 0, 1, 0, 0, 0, 0]",263,173,90,15,7,0.08670520231213873,0.07777777777777778
"[0, 0, 1, 0, 0, 0, 0, 1, 1, 0, 1, 0, 0, 0, 1]",285,182,103,21,6,0.11538461538461539,0.05825242718446602
"[0, 0, 0, 1, 0, 0, 0, 0, 1, 1, 0, 0, 0, 0, 0]",2973,2267,706,214,73,0.09439788266431408,0.10339943342776203
"[1, 1, 0, 0, 0, 1, 1, 0, 0, 1, 0, 0, 0, 1, 0]",141,90,51,8,3,0.08888888888888889,0.058823529411764705
"[0, 1, 1, 0, 1, 1, 1, 1, 1, 1, 0, 0, 1, 1, 1]",1115,346,769,40,59,0.11560693641618497,0.07672301690507152
"[1, 1, 1, 1, 0, 1, 1, 1, 1, 0, 0, 0, 1, 0, 1]",288,106,182,6,22,0.05660377358490566,0.12087912087912088
"[1, 0, 1, 0, 0, 1, 0, 1, 0, 1, 0, 1, 0, 0, 1]",107,62,45,3,5,0.04838709677419355,0.1111111111111111
"[0, 0, 1, 1, 1, 0, 0, 1, 1, 0, 1, 0, 1, 0, 1]",117,53,64,4,5,0.07547169811320754,0.078125
"[1, 1, 0, 0, 1, 1, 1, 0, 0, 1, 1, 0, 1, 0, 1]",171,78,93,12,7,0.15384615384615385,0.07526881720430108
"[0, 0, 1, 0, 0, 0, 0, 0, 1, 0, 1, 1, 1, 0, 0]",295,190,105,17,11,0.08947368421052632,0.10476190476190476
"[1, 0, 1, 1, 0, 0, 0, 1, 0, 0, 0, 0, 0, 1, 0]",212,126,86,7,4,0.05555555555555555,0.046511627906976744
"[1, 0, 1, 1, 0, 1, 1, 0, 1, 1, 0, 0, 0, 0, 0]",152,73,79,4,5,0.0547945205479452,0.06329113924050633
"[0, 1, 1, 1, 1, 0, 1, 1, 1, 1, 0, 0, 0, 1, 1]",274,97,177,10,14,0.10309278350515463,0.07909604519774012
"[1, 0, 1, 0, 1, 1, 1, 1, 0, 1, 1, 1, 1, 0, 0]",324,113,211,9,24,0.07964601769911504,0.11374407582938388
"[0, 0, 1, 1, 0, 0, 0, 0, 0, 0, 1, 0, 1, 0, 1]",402,262,140,29,12,0.11068702290076336,0.08571428571428572
"[0, 1, 0, 0, 0, 0, 1, 0, 0, 0, 0, 0, 0, 0, 1]",1825,1424,401,162,36,0.11376404494382023,0.08977556109725686
"[0, 1, 0, 0, 1, 0, 0, 0, 0, 1, 0, 0, 0, 0, 0]",1654,1252,402,119,37,0.0950479233226837,0.09203980099502487
"[0, 1, 1, 1, 1, 1, 1, 0, 1, 0, 1, 0, 1, 1, 1]",619,225,394,27,31,0.12,0.07868020304568528
"[0, 0, 0, 1, 0, 0, 1, 0, 1, 1, 0, 1, 1, 0, 0]",150,88,62,8,4,0.09090909090909091,0.06451612903225806
"[0, 0, 0, 0, 0, 0, 0, 1, 0, 0, 1, 0, 1, 1, 0]",634,446,188,32,16,0.07174887892376682,0.0851063829787234
"[0, 0, 0, 1, 0, 1, 0, 1, 0, 0, 0, 0, 0, 0, 0]",1919,1462,457,135,45,0.09233926128590972,0.09846827133479212
"[0, 1, 0, 0, 0, 1, 0, 0, 0, 0, 1, 1, 0, 0, 0]",800,585,215,48,20,0.08205128205128205,0.09302325581395349
"[1, 1, 0, 0, 0, 0, 0, 1, 0, 0, 1, 0, 0, 0, 1]",280,179,101,16,7,0.0893854748603352,0.06930693069306931
"[0, 0, 0, 0, 1, 1, 1, 1, 1, 1, 1, 1, 1, 0, 0]",751,353,398,33,35,0.09348441926345609,0.08793969849246232
"[0, 0, 1, 0, 0, 0, 0, 0, 1, 1, 1, 1, 1, 1, 1]",403,198,205,18,17,0.09090909090909091,0.08292682926829269
"[0, 1, 0, 0, 1, 1, 0, 1, 0, 0, 0, 0, 0, 0, 0]",671,495,176,47,20,0.09494949494949495,0.11363636363636363
"[0, 0, 0, 0, 0, 1, 0, 0, 1, 0, 0, 1, 1, 0, 1]",244,157,87,19,10,0.12101910828025478,0.11494252873563218
"[0, 1, 1, 0, 0, 1, 1, 0, 0, 1, 0, 0, 0, 0, 0]",409,313,96,30,10,0.09584664536741214,0.10416666666666667
"[0, 1, 1, 1, 0, 1, 0, 1, 0, 0, 1, 0, 0, 1, 1]",132,57,75,6,6,0.10526315789473684,0.08
"[1, 0, 1, 1, 1, 0, 1, 0, 1, 0, 1, 0, 0, 0, 0]",123,58,65,5,7,0.08620689655172414,0.1076923076923077
"[0, 1, 0, 0, 1, 1, 1, 1, 1, 1, 0, 0, 0, 1, 1]",226,93,133,3,17,0.03225806451612903,0.12781954887218044
"[0, 1, 0, 0, 0, 0, 0, 1, 0, 0, 0, 0, 0, 1, 0]",1485,1141,344,120,35,0.10517090271691498,0.10174418604651163
"[1, 0, 0, 0, 0, 0, 0, 1, 0, 0, 0, 0, 1, 0, 0]",1590,1108,482,80,44,0.07220216606498195,0.0912863070539419
"[0, 1, 1, 1, 0, 0, 1, 1, 0, 1, 0, 1, 0, 1, 1]",175,74,101,11,9,0.14864864864864866,0.0891089108910891
"[1, 0, 1, 1, 0, 0, 0, 0, 1, 0, 0, 0, 0, 0, 0]",639,465,174,37,17,0.07956989247311828,0.09770114942528736
"[0, 0, 0, 1, 0, 0, 0, 0, 0, 0, 1, 0, 1, 0, 1]",526,392,134,37,11,0.09438775510204081,0.08208955223880597
"[1, 0, 1, 0, 1, 1, 0, 0, 1, 1, 0, 1, 1, 1, 1]",284,103,181,13,13,0.1262135922330097,0.0718232044198895
"[0, 1, 0, 0, 0, 0, 0, 1, 0, 1, 0, 1, 1, 0, 0]",269,173,96,16,5,0.09248554913294797,0.052083333333333336
"[0, 1, 1, 1, 0, 1, 0, 0, 0, 0, 0, 1, 0, 1, 0]",167,86,81,12,10,0.13953488372093023,0.12345679012345678
"[1, 0, 0, 1, 0, 0, 1, 1, 1, 1, 0, 1, 1, 1, 0]",134,53,81,6,12,0.11320754716981132,0.14814814814814814
"[0, 0, 0, 1, 0, 0, 1, 0, 0, 1, 0, 0, 1, 0, 0]",478,349,129,31,12,0.08882521489971347,0.09302325581395349
"[0, 1, 0, 0, 0, 0, 0, 1, 0, 1, 0, 0, 0, 0, 0]",1765,1369,396,123,27,0.08984660336011688,0.06818181818181818
"[0, 0, 1, 1, 0, 1, 0, 0, 0, 0, 0, 0, 1, 1, 0]",405,261,144,26,9,0.09961685823754789,0.0625
"[1, 0, 0, 0, 0, 0, 1, 0, 1, 0, 1, 0, 0, 0, 0]",569,401,168,41,21,0.10224438902743142,0.125
"[0, 0, 0, 0, 0, 0, 1, 0, 0, 1, 1, 1, 1, 1, 1]",444,267,177,25,19,0.09363295880149813,0.10734463276836158
"[0, 0, 0, 1, 1, 1, 0, 1, 0, 0, 0, 0, 0, 0, 0]",780,569,211,56,20,0.0984182776801406,0.0947867298578199
"[0, 0, 0, 0, 1, 0, 0, 1, 0, 0, 0, 0, 1, 0, 0]",1484,1138,346,110,25,0.09666080843585237,0.07225433526011561
"[1, 0, 0, 0, 0, 0, 0, 1, 1, 0, 1, 0, 0, 0, 0]",686,399,287,37,23,0.09273182957393483,0.08013937282229965
"[1, 1, 0, 0, 1, 0, 0, 0, 0, 0, 0, 1, 1, 0, 1]",169,82,87,13,4,0.15853658536585366,0.04597701149425287
"[1, 0, 1, 0, 0, 1, 0, 0, 1, 1, 0, 1, 1, 0, 1]",87,42,45,4,5,0.09523809523809523,0.1111111111111111
"[0, 1, 0, 0, 1, 0, 1, 0, 0, 1, 0, 0, 1, 1, 0]",157,92,65,8,6,0.08695652173913043,0.09230769230769231
"[1, 1, 1, 1, 1, 1, 0, 1, 0, 0, 1, 0, 1, 0, 0]",183,67,116,7,12,0.1044776119402985,0.10344827586206896
"[0, 0, 1, 1, 1, 1, 1, 1, 0, 1, 0, 0, 0, 0, 0]",228,117,111,13,12,0.1111111111111111,0.10810810810810811
"[0, 1, 1, 0, 0, 1, 0, 0, 0, 0, 0, 0, 1, 1, 1]",392,284,108,26,9,0.09154929577464789,0.08333333333333333
"[0, 1, 0, 0, 0, 1, 0, 1, 0, 0, 1, 1, 0, 0, 1]",194,117,77,15,9,0.1282051282051282,0.11688311688311688
"[1, 0, 0, 1, 0, 0, 0, 1, 0, 1, 0, 0, 1, 1, 0]",161,101,60,7,10,0.06930693069306931,0.16666666666666666
"[1, 0, 1, 0, 0, 1, 1, 1, 1, 1, 1, 1, 1, 1, 1]",3094,808,2286,78,207,0.09653465346534654,0.09055118110236221
"[0, 1, 1, 0, 1, 0, 0, 1, 1, 1, 1, 1, 1, 1, 1]",982,336,646,28,59,0.08333333333333333,0.0913312693498452
"[0, 1, 1, 0, 1, 0, 0, 0, 0, 0, 1, 0, 0, 0, 0]",542,389,153,30,15,0.07712082262210797,0.09803921568627451
"[1, 0, 0, 1, 0, 1, 0, 1, 1, 1, 0, 1, 0, 0, 0]",102,47,55,9,8,0.19148936170212766,0.14545454545454545
"[0, 0, 1, 1, 0, 0, 1, 0, 1, 0, 1, 1, 1, 0, 1]",118,53,65,10,8,0.18867924528301888,0.12307692307692308
"[1, 1, 1, 0, 1, 0, 0, 1, 1, 0, 0, 1, 0, 1, 0]",99,38,61,5,3,0.13157894736842105,0.04918032786885246
"[1, 0, 1, 0, 1, 0, 1, 1, 1, 1, 0, 1, 0, 0, 1]",138,61,77,7,6,0.11475409836065574,0.07792207792207792
"[1, 1, 1, 1, 1, 1, 0, 0, 1, 1, 0, 1, 1, 0, 0]",409,132,277,21,37,0.1590909090909091,0.13357400722021662
"[0, 0, 1, 0, 0, 0, 0, 1, 1, 0, 0, 1, 1, 0, 1]",182,118,64,12,6,0.1016949152542373,0.09375
"[1, 0, 0, 1, 1, 1, 0, 0, 1, 1, 1, 1, 1, 0, 0]",244,86,158,6,22,0.06976744186046512,0.13924050632911392
"[0, 1, 1, 1, 1, 0, 0, 1, 1, 0, 0, 1, 1, 1, 1]",2516,1772,744,164,75,0.09255079006772009,0.10080645161290322
"[1, 0, 1, 1, 1, 1, 0, 0, 1, 1, 0, 0, 1, 1, 1]",891,297,594,33,53,0.1111111111111111,0.08922558922558922
"[1, 0, 0, 1, 1, 1, 0, 1, 1, 1, 1, 0, 0, 1, 1]",419,131,288,7,24,0.05343511450381679,0.08333333333333333
"[0, 1, 1, 1, 0, 1, 1, 0, 0, 1, 1, 1, 0, 0, 1]",143,61,82,3,6,0.04918032786885246,0.07317073170731707
"[1, 1, 1, 0, 0, 1, 0, 0, 0, 0, 0, 1, 1, 0, 1]",125,48,77,6,5,0.125,0.06493506493506493
"[1, 1, 1, 1, 0, 1, 1, 1, 1, 1, 0, 1, 1, 1, 0]",1615,371,1244,29,122,0.07816711590296496,0.09807073954983923
"[1, 1, 0, 1, 1, 1, 0, 0, 1, 1, 1, 0, 1, 1, 1]",607,175,432,17,49,0.09714285714285714,0.11342592592592593
"[1, 0, 0, 0, 0, 0, 1, 1, 1, 1, 0, 1, 0, 1, 0]",129,65,64,10,6,0.15384615384615385,0.09375
"[1, 0, 0, 1, 1, 0, 0, 1, 1, 1, 1, 1, 1, 1, 0]",774,152,622,12,56,0.07894736842105263,0.09003215434083602
"[0, 1, 0, 1, 0, 1, 0, 1, 1, 0, 0, 1, 1, 1, 1]",231,102,129,7,12,0.06862745098039216,0.09302325581395349
"[1, 1, 0, 0, 1, 0, 1, 0, 1, 0, 1, 1, 0, 0, 1]",137,64,73,4,9,0.0625,0.1232876712328767
"[1, 0, 1, 1, 1, 0, 0, 1, 0, 1, 1, 1, 0, 1, 0]",152,59,93,9,9,0.15254237288135594,0.0967741935483871
"[1, 1, 1, 0, 1, 1, 1, 0, 0, 1, 0, 1, 1, 1, 0]",235,86,149,10,18,0.11627906976744186,0.12080536912751678
"[1, 0, 1, 1, 1, 0, 1, 1, 1, 0, 0, 1, 0, 1, 1]",222,80,142,9,7,0.1125,0.04929577464788732
"[1, 1, 0, 1, 1, 0, 0, 0, 1, 1, 1, 0, 1, 0, 0]",113,45,68,4,9,0.08888888888888889,0.1323529411764706
"[0, 1, 1, 0, 1, 1, 0, 0, 1, 1, 0, 0, 0, 0, 0]",359,213,146,13,14,0.06103286384976526,0.0958904109589041
"[0, 1, 1, 0, 1, 1, 0, 0, 1, 1, 1, 1, 1, 1, 1]",1101,368,733,39,68,0.10597826086956522,0.0927694406548431
"[1, 0, 0, 0, 1, 0, 1, 0, 0, 1, 1, 1, 1, 0, 0]",205,101,104,8,5,0.07920792079207921,0.04807692307692308
"[0, 1, 0, 1, 1, 0, 0, 0, 1, 0, 1, 0, 0, 1, 1]",127,73,54,9,3,0.1232876712328767,0.05555555555555555
"[1, 1, 1, 1, 0, 0, 0, 1, 0, 0, 1, 1, 1, 1, 1]",476,153,323,18,37,0.11764705882352941,0.11455108359133127
"[0, 1, 1, 1, 1, 0, 0, 0, 1, 0, 0, 1, 1, 1, 1]",257,139,118,7,13,0.050359712230215826,0.11016949152542373
"[0, 1, 0, 0, 1, 1, 1, 1, 1, 0, 0, 0, 0, 1, 1]",322,165,157,17,12,0.10303030303030303,0.07643312101910828
"[1, 0, 1, 1, 0, 1, 1, 1, 1, 0, 1, 0, 1, 0, 0]",133,56,77,4,4,0.07142857142857142,0.05194805194805195
"[1, 0, 0, 1, 1, 1, 0, 0, 0, 0, 0, 0, 0, 1, 0]",244,152,92,14,3,0.09210526315789473,0.03260869565217391
"[1, 1, 0, 0, 0, 0, 1, 1, 1, 1, 1, 0, 0, 1, 1]",461,193,268,23,21,0.11917098445595854,0.07835820895522388
"[0, 1, 0, 0, 0, 0, 1, 0, 0, 1, 1, 1, 1, 1, 1]",243,121,122,12,17,0.09917355371900827,0.13934426229508196
"[1, 1, 0, 0, 1, 1, 0, 1, 1, 1, 1, 0, 1, 0, 0]",154,57,97,5,6,0.08771929824561403,0.061855670103092786
"[0, 0, 0, 1, 1, 1, 0, 0, 0, 1, 1, 1, 1, 1, 0]",147,74,73,6,4,0.08108108108108109,0.0547945205479452
"[0, 0, 0, 0, 0, 0, 1, 1, 1, 0, 0, 0, 1, 1, 1]",584,399,185,38,13,0.09523809523809523,0.07027027027027027
"[1, 1, 1, 0, 1, 0, 1, 0, 1, 0, 1, 1, 1, 1, 0]",242,94,148,10,7,0.10638297872340426,0.0472972972972973
"[1, 0, 0, 1, 1, 1, 1, 0, 1, 1, 1, 1, 1, 1, 0]",674,189,485,12,47,0.06349206349206349,0.09690721649484536
"[0, 1, 0, 1, 1, 1, 0, 0, 0, 0, 0, 0, 0, 1, 1]",274,144,130,19,13,0.13194444444444445,0.1
"[1, 1, 1, 0, 1, 0, 1, 1, 1, 0, 0, 0, 0, 0, 0]",275,124,151,17,12,0.13709677419354838,0.07947019867549669
"[0, 0, 1, 0, 0, 0, 0, 1, 0, 0, 1, 0, 0, 0, 1]",477,362,115,42,9,0.11602209944751381,0.0782608695652174
"[1, 1, 1, 1, 0, 0, 0, 0, 0, 1, 0, 1, 0, 1, 0]",127,64,63,11,6,0.171875,0.09523809523809523
"[0, 1, 1, 1, 1, 0, 1, 1, 1, 0, 1, 1, 1, 1, 0]",547,162,385,17,31,0.10493827160493827,0.08051948051948052
"[1, 1, 1, 1, 0, 1, 1, 0, 0, 1, 1, 0, 1, 1, 0]",237,80,157,7,15,0.0875,0.09554140127388536
"[1, 1, 1, 1, 1, 0, 1, 1, 1, 0, 1, 0, 1, 1, 0]",555,158,397,11,43,0.06962025316455696,0.10831234256926953
"[0, 1, 0, 1, 0, 0, 0, 0, 0, 0, 1, 1, 1, 1, 1]",348,173,175,18,15,0.10404624277456648,0.08571428571428572
"[1, 1, 0, 1, 1, 1, 0, 1, 1, 0, 0, 1, 1, 1, 1]",789,248,541,30,67,0.12096774193548387,0.12384473197781885
"[1, 1, 1, 1, 1, 1, 0, 0, 1, 1, 0, 0, 1, 0, 0]",362,155,207,15,26,0.0967741935483871,0.12560386473429952
"[0, 0, 0, 1, 1, 0, 1, 1, 0, 1, 1, 0, 1, 0, 1]",111,54,57,7,6,0.12962962962962962,0.10526315789473684
"[1, 1, 1, 0, 1, 0, 0, 1, 1, 0, 1, 0, 1, 1, 0]",135,56,79,1,9,0.017857142857142856,0.11392405063291139
"[1, 0, 0, 0, 0, 0, 0, 1, 1, 0, 0, 0, 1, 0, 1]",413,212,201,22,12,0.10377358490566038,0.05970149253731343
"[1, 0, 1, 1, 1, 1, 0, 0, 0, 1, 0, 1, 1, 1, 1]",300,101,199,6,19,0.0594059405940594,0.09547738693467336
"[1, 1, 1, 1, 0, 0, 1, 0, 1, 0, 0, 0, 1, 1, 1]",240,103,137,14,15,0.13592233009708737,0.10948905109489052
"[0, 0, 0, 0, 1, 0, 1, 1, 1, 1, 0, 0, 1, 0, 1]",105,57,48,8,5,0.14035087719298245,0.10416666666666667
"[0, 0, 0, 0, 1, 1, 0, 0, 0, 0, 1, 0, 1, 1, 1]",601,385,216,40,20,0.1038961038961039,0.09259259259259259
"[1, 0, 0, 0, 0, 0, 0, 1, 1, 0, 1, 1, 1, 1, 1]",330,98,232,12,25,0.12244897959183673,0.10775862068965517
"[0, 0, 1, 0, 1, 0, 1, 0, 1, 1, 1, 0, 0, 0, 0]",196,114,82,6,6,0.05263157894736842,0.07317073170731707
"[1, 1, 0, 0, 0, 1, 0, 1, 0, 1, 0, 1, 1, 1, 0]",113,52,61,5,4,0.09615384615384616,0.06557377049180328
"[0, 1, 1, 0, 0, 0, 1, 0, 1, 0, 1, 0, 1, 1, 1]",132,71,61,8,5,0.11267605633802817,0.08196721311475409
"[1, 0, 1, 0, 1, 1, 0, 0, 0, 1, 0, 1, 0, 1, 0]",105,62,43,5,3,0.08064516129032258,0.06976744186046512
"[1, 0, 1, 0, 1, 0, 0, 0, 1, 0, 1, 0, 1, 1, 0]",115,49,66,2,6,0.04081632653061224,0.09090909090909091
"[1, 0, 0, 1, 0, 0, 1, 1, 0, 1, 0, 1, 0, 1, 0]",99,59,40,11,6,0.1864406779661017,0.15
"[0, 0, 1, 1, 0, 1, 1, 1, 0, 0, 0, 1, 1, 1, 1]",228,97,131,13,13,0.13402061855670103,0.09923664122137404
"[0, 1, 0, 0, 1, 0, 0, 0, 0, 0, 0, 0, 1, 1, 0]",852,623,229,59,17,0.09470304975922954,0.07423580786026202
"[1, 0, 1, 0, 0, 1, 1, 1, 1, 1, 1, 0, 0, 1, 0]",160,60,100,3,6,0.05,0.06
"[0, 1, 1, 0, 1, 0, 1, 0, 0, 1, 1, 1, 1, 1, 1]",412,198,214,23,24,0.11616161616161616,0.11214953271028037
"[1, 1, 1, 1, 1, 1, 0, 1, 1, 0, 1, 0, 1, 0, 0]",279,91,188,11,19,0.12087912087912088,0.10106382978723404
"[0, 0, 1, 0, 0, 1, 0, 1, 1, 1, 1, 1, 1, 1, 1]",433,165,268,16,24,0.09696969696969697,0.08955223880597014
"[0, 1, 1, 0, 0, 1, 0, 1, 1, 1, 1, 0, 0, 1, 1]",259,118,141,12,13,0.1016949152542373,0.09219858156028368
"[1, 1, 0, 1, 1, 0, 0, 1, 0, 1, 1, 1, 1, 0, 0]",183,74,109,6,13,0.08108108108108109,0.11926605504587157
"[0, 1, 0, 0, 1, 1, 1, 0, 0, 0, 0, 1, 0, 0, 1]",136,85,51,7,3,0.08235294117647059,0.058823529411764705
"[1, 0, 0, 1, 0, 1, 0, 1, 1, 0, 0, 0, 0, 1, 1]",200,101,99,8,5,0.07920792079207921,0.050505050505050504
"[0, 0, 0, 1, 1, 0, 0, 1, 0, 1, 0, 1, 1, 0, 0]",190,131,59,13,8,0.09923664122137404,0.13559322033898305
"[0, 0, 0, 0, 0, 0, 1, 1, 0, 0, 1, 0, 1, 0, 1]",389,248,141,16,14,0.06451612903225806,0.09929078014184398
"[0, 0, 0, 1, 0, 0, 0, 0, 1, 0, 0, 0, 0, 1, 1]",792,581,211,50,29,0.08605851979345955,0.13744075829383887
"[1, 1, 1, 0, 1, 1, 0, 1, 1, 1, 0, 1, 1, 0, 0]",257,95,162,11,15,0.11578947368421053,0.09259259259259259
"[0, 1, 0, 1, 0, 0, 0, 0, 1, 1, 1, 0, 0, 1, 1]",166,82,84,7,7,0.08536585365853659,0.08333333333333333
"[1, 1, 0, 0, 0, 1, 1, 0, 0, 1, 1, 0, 0, 1, 1]",472,235,237,25,28,0.10638297872340426,0.11814345991561181
"[0, 1, 1, 0, 0, 0, 1, 1, 0, 0, 1, 1, 0, 0, 1]",289,147,142,8,26,0.05442176870748299,0.18309859154929578
"[1, 0, 1, 1, 0, 0, 0, 1, 0, 1, 1, 0, 0, 0, 1]",119,68,51,10,2,0.14705882352941177,0.0392156862745098
"[0, 0, 1, 0, 1, 1, 0, 0, 0, 1, 0, 1, 1, 0, 0]",162,95,67,11,8,0.11578947368421053,0.11940298507462686
"[0, 0, 0, 0, 1, 0, 1, 0, 1, 0, 0, 0, 0, 1, 1]",378,250,128,21,16,0.084,0.125
"[1, 0, 0, 1, 1, 0, 0, 0, 1, 1, 1, 0, 0, 1, 0]",140,60,80,3,6,0.05,0.075
"[0, 0, 1, 1, 1, 0, 1, 1, 1, 0, 0, 0, 0, 1, 1]",205,101,104,8,8,0.07920792079207921,0.07692307692307693
"[1, 0, 0, 0, 0, 0, 0, 0, 0, 0, 1, 0, 1, 1, 0]",660,433,227,31,20,0.07159353348729793,0.0881057268722467
"[1, 0, 1, 1, 1, 0, 1, 1, 1, 0, 0, 1, 0, 0, 1]",161,62,99,5,9,0.08064516129032258,0.09090909090909091
"[1, 0, 1, 0, 1, 0, 1, 1, 1, 0, 1, 1, 1, 0, 0]",151,58,93,5,3,0.08620689655172414,0.03225806451612903
"[1, 1, 0, 1, 0, 0, 1, 1, 0, 1, 1, 1, 0, 1, 0]",141,54,87,7,8,0.12962962962962962,0.09195402298850575
"[0, 1, 1, 1, 0, 1, 0, 0, 1, 1, 0, 1, 1, 1, 0]",132,63,69,4,4,0.06349206349206349,0.057971014492753624
"[0, 0, 1, 0, 1, 1, 1, 0, 0, 1, 0, 1, 0, 1, 1]",146,77,69,6,4,0.07792207792207792,0.057971014492753624
"[0, 0, 1, 1, 1, 0, 1, 1, 1, 0, 0, 0, 0, 0, 1]",156,79,77,10,9,0.12658227848101267,0.11688311688311688
"[0, 1, 1, 0, 0, 0, 0, 1, 1, 1, 0, 1, 1, 1, 0]",151,87,64,10,4,0.11494252873563218,0.0625
"[1, 0, 0, 0, 0, 1, 0, 1, 1, 1, 0, 1, 0, 1, 0]",119,63,56,4,9,0.06349206349206349,0.16071428571428573
"[0, 1, 0, 1, 1, 1, 1, 0, 0, 0, 0, 1, 0, 1, 1]",136,68,68,5,7,0.07352941176470588,0.10294117647058823
"[1, 1, 1, 1, 0, 1, 0, 1, 0, 1, 0, 1, 1, 1, 1]",605,176,429,21,57,0.11931818181818182,0.13286713286713286
"[0, 1, 1, 1, 1, 0, 1, 0, 1, 0, 1, 0, 1, 1, 1]",260,101,159,16,13,0.15841584158415842,0.08176100628930817
"[1, 1, 0, 1, 0, 1, 0, 0, 0, 1, 1, 1, 1, 0, 1]",143,52,91,5,5,0.09615384615384616,0.054945054945054944
"[1, 0, 1, 0, 1, 1, 1, 0, 1, 0, 1, 0, 0, 0, 1]",106,50,56,9,2,0.18,0.03571428571428571
"[1, 1, 0, 0, 1, 1, 0, 0, 0, 0, 1, 0, 1, 1, 0]",181,89,92,9,15,0.10112359550561797,0.16304347826086957
"[1, 0, 0, 0, 0, 0, 1, 0, 0, 0, 0, 1, 1, 1, 1]",394,203,191,12,24,0.059113300492610835,0.1256544502617801
"[1, 1, 1, 1, 0, 0, 0, 0, 0, 1, 0, 0, 0, 0, 1]",283,167,116,18,12,0.10778443113772455,0.10344827586206896
"[0, 1, 1, 0, 1, 1, 0, 0, 0, 0, 0, 0, 0, 0, 1]",503,330,173,24,22,0.07272727272727272,0.12716763005780346
"[1, 0, 1, 0, 0, 0, 1, 1, 1, 1, 1, 0, 0, 1, 0]",133,64,69,6,6,0.09375,0.08695652173913043
"[1, 1, 1, 1, 0, 0, 1, 1, 0, 1, 1, 0, 0, 1, 1]",443,167,276,12,33,0.0718562874251497,0.11956521739130435
"[0, 0, 0, 1, 1, 1, 1, 0, 0, 1, 1, 0, 1, 1, 0]",228,147,81,11,7,0.07482993197278912,0.08641975308641975
"[1, 0, 0, 0, 0, 1, 1, 1, 1, 0, 0, 1, 1, 0, 1]",382,83,299,9,33,0.10843373493975904,0.11036789297658862
"[0, 1, 0, 0, 0, 0, 1, 1, 1, 1, 0, 0, 1, 1, 0]",398,233,165,24,15,0.10300429184549356,0.09090909090909091
"[0, 1, 0, 0, 1, 0, 0, 0, 0, 1, 0, 1, 0, 0, 0]",523,356,167,29,25,0.08146067415730338,0.1497005988023952
"[0, 0, 0, 1, 0, 0, 0, 1, 0, 0, 0, 1, 0, 0, 0]",1501,1178,323,123,29,0.10441426146010187,0.08978328173374613
"[1, 1, 1, 1, 0, 0, 0, 0, 0, 0, 1, 0, 0, 0, 1]",328,184,144,18,9,0.09782608695652174,0.0625
"[0, 0, 1, 0, 1, 1, 1, 1, 1, 1, 0, 1, 0, 0, 1]",141,63,78,6,9,0.09523809523809523,0.11538461538461539
"[0, 0, 0, 1, 1, 0, 1, 0, 0, 1, 1, 1, 1, 0, 0]",201,119,82,13,11,0.1092436974789916,0.13414634146341464
"[1, 1, 0, 0, 1, 0, 1, 0, 1, 1, 1, 1, 1, 0, 1]",234,82,152,5,11,0.06097560975609756,0.07236842105263158
"[1, 1, 1, 0, 0, 1, 0, 1, 0, 1, 1, 1, 1, 1, 0]",268,87,181,4,12,0.04597701149425287,0.06629834254143646
"[1, 1, 0, 0, 0, 1, 0, 1, 1, 1, 1, 0, 0, 0, 0]",254,126,128,9,19,0.07142857142857142,0.1484375
"[0, 1, 1, 0, 0, 0, 1, 0, 1, 1, 1, 1, 0, 0, 0]",187,106,81,9,8,0.08490566037735849,0.09876543209876543
"[1, 0, 1, 0, 1, 1, 1, 1, 1, 1, 1, 0, 1, 1, 1]",1683,421,1262,42,132,0.0997624703087886,0.1045958795562599
"[0, 0, 1, 1, 1, 0, 0, 0, 0, 0, 1, 1, 1, 1, 0]",245,134,111,12,13,0.08955223880597014,0.11711711711711711
"[1, 0, 1, 1, 1, 0, 1, 1, 1, 0, 1, 0, 0, 1, 1]",252,90,162,12,20,0.13333333333333333,0.12345679012345678
"[1, 1, 1, 0, 0, 0, 0, 0, 0, 1, 1, 1, 0, 0, 0]",418,201,217,13,13,0.06467661691542288,0.059907834101382486
"[1, 0, 0, 1, 1, 0, 0, 1, 0, 0, 1, 1, 0, 0, 1]",181,83,98,8,8,0.0963855421686747,0.08163265306122448
"[1, 0, 1, 0, 0, 0, 0, 1, 1, 0, 0, 1, 1, 0, 0]",441,261,180,25,18,0.09578544061302682,0.1
"[1, 1, 0, 1, 0, 0, 0, 0, 1, 1, 0, 0, 1, 1, 0]",237,115,122,8,15,0.06956521739130435,0.12295081967213115
"[0, 1, 1, 0, 1, 0, 0, 0, 0, 1, 1, 0, 0, 1, 1]",277,146,131,15,12,0.10273972602739725,0.0916030534351145
"[0, 0, 0, 1, 0, 1, 1, 0, 1, 0, 0, 0, 0, 1, 1]",179,103,76,14,5,0.13592233009708737,0.06578947368421052
"[1, 0, 0, 0, 1, 0, 0, 0, 1, 0, 1, 1, 0, 1, 0]",141,73,68,9,4,0.1232876712328767,0.058823529411764705
"[0, 1, 0, 0, 1, 0, 0, 0, 1, 0, 0, 0, 1, 0, 1]",223,149,74,13,8,0.087248322147651,0.10810810810810811
"[1, 0, 1, 0, 0, 1, 0, 0, 0, 1, 0, 0, 0, 1, 0]",217,141,76,14,6,0.09929078014184398,0.07894736842105263
"[1, 0, 1, 1, 0, 0, 0, 0, 1, 1, 0, 0, 1, 0, 0]",159,92,67,10,3,0.10869565217391304,0.04477611940298507
"[0, 0, 1, 0, 1, 1, 0, 0, 0, 0, 1, 1, 0, 0, 1]",309,178,131,15,9,0.08426966292134831,0.06870229007633588
"[0, 0, 1, 0, 0, 0, 0, 0, 0, 1, 1, 0, 1, 1, 0]",283,178,105,13,13,0.07303370786516854,0.12380952380952381
"[0, 1, 1, 0, 0, 1, 1, 0, 0, 1, 1, 0, 0, 0, 1]",409,318,91,33,4,0.10377358490566038,0.04395604395604396
"[1, 0, 1, 1, 1, 0, 0, 0, 1, 1, 0, 0, 1, 1, 0]",154,78,76,7,3,0.08974358974358974,0.039473684210526314
"[0, 1, 1, 0, 1, 0, 0, 1, 0, 0, 1, 1, 0, 0, 0]",212,124,88,10,8,0.08064516129032258,0.09090909090909091
"[1, 1, 1, 0, 1, 1, 0, 1, 0, 0, 1, 0, 0, 1, 1]",186,86,100,16,13,0.18604651162790697,0.13
"[0, 1, 0, 0, 1, 1, 1, 1, 1, 1, 1, 1, 0, 1, 1]",702,233,469,25,29,0.1072961373390558,0.06183368869936034
"[1, 1, 1, 1, 1, 1, 0, 0, 1, 0, 0, 1, 0, 0, 1]",226,93,133,8,17,0.08602150537634409,0.12781954887218044
"[1, 0, 0, 1, 0, 0, 0, 1, 1, 0, 0, 1, 0, 0, 0]",248,153,95,15,5,0.09803921568627451,0.05263157894736842
"[1, 0, 1, 0, 1, 1, 0, 1, 1, 1, 1, 0, 0, 1, 1]",358,128,230,12,23,0.09375,0.1
"[1, 0, 0, 0, 1, 1, 1, 0, 1, 1, 1, 0, 1, 0, 1]",171,57,114,10,5,0.17543859649122806,0.043859649122807015
"[1, 0, 1, 0, 1, 1, 1, 0, 1, 1, 0, 0, 0, 1, 1]",175,71,104,6,8,0.08450704225352113,0.07692307692307693
"[1, 1, 0, 1, 1, 0, 0, 0, 0, 0, 0, 1, 0, 1, 1]",144,72,72,8,7,0.1111111111111111,0.09722222222222222
"[1, 1, 1, 0, 1, 0, 0, 1, 0, 0, 1, 1, 0, 1, 1]",162,59,103,1,11,0.01694915254237288,0.10679611650485436
"[0, 0, 1, 1, 1, 1, 1, 1, 0, 1, 0, 0, 1, 0, 0]",165,89,76,9,5,0.10112359550561797,0.06578947368421052
"[1, 0, 1, 1, 0, 0, 1, 1, 1, 1, 1, 1, 0, 1, 0]",249,93,156,10,15,0.10752688172043011,0.09615384615384616
"[1, 1, 1, 0, 1, 0, 1, 1, 0, 1, 1, 0, 0, 1, 1]",294,91,203,9,16,0.0989010989010989,0.07881773399014778
"[1, 1, 1, 1, 1, 1, 0, 0, 0, 0, 0, 1, 0, 1, 1]",368,140,228,12,20,0.08571428571428572,0.08771929824561403
"[0, 1, 0, 0, 0, 0, 1, 1, 1, 1, 1, 1, 1, 0, 0]",251,132,119,11,7,0.08333333333333333,0.058823529411764705
"[1, 1, 0, 1, 1, 1, 1, 1, 0, 0, 1, 0, 1, 1, 0]",250,93,157,8,20,0.08602150537634409,0.12738853503184713
"[1, 1, 1, 0, 0, 0, 1, 1, 1, 1, 0, 1, 0, 0, 1]",167,63,104,5,5,0.07936507936507936,0.04807692307692308
"[1, 1, 0, 1, 1, 1, 1, 0, 0, 0, 1, 1, 1, 1, 0]",296,112,184,12,23,0.10714285714285714,0.125
"[1, 1, 0, 0, 0, 1, 1, 1, 1, 1, 1, 0, 1, 1, 1]",777,228,549,18,48,0.07894736842105263,0.08743169398907104
"[0, 0, 0, 1, 0, 1, 0, 1, 1, 0, 1, 0, 1, 0, 1]",92,63,29,9,3,0.14285714285714285,0.10344827586206896
"[1, 1, 0, 0, 0, 1, 0, 1, 0, 1, 1, 0, 1, 0, 1]",84,40,44,1,4,0.025,0.09090909090909091
"[1, 0, 0, 1, 0, 0, 1, 0, 0, 0, 0, 0, 0, 1, 1]",404,241,163,23,20,0.0954356846473029,0.12269938650306748
"[0, 0, 1, 1, 0, 0, 1, 1, 0, 0, 1, 0, 0, 1, 0]",216,130,86,17,11,0.13076923076923078,0.12790697674418605
"[0, 0, 1, 0, 1, 0, 0, 0, 1, 0, 1, 0, 1, 1, 1]",160,89,71,4,4,0.0449438202247191,0.056338028169014086
"[1, 0, 1, 0, 0, 1, 1, 1, 1, 1, 1, 1, 1, 0, 1]",626,157,469,19,40,0.12101910828025478,0.08528784648187633
"[1, 1, 0, 0, 0, 0, 0, 0, 1, 1, 0, 0, 1, 1, 0]",1794,1102,692,100,62,0.09074410163339383,0.08959537572254335
"[0, 0, 1, 1, 1, 1, 1, 0, 1, 0, 1, 1, 0, 0, 1]",217,93,124,10,13,0.10752688172043011,0.10483870967741936
"[0, 1, 1, 0, 0, 0, 1, 1, 0, 0, 1, 0, 1, 1, 1]",166,104,62,11,7,0.10576923076923077,0.11290322580645161
"[1, 1, 0, 0, 1, 1, 0, 0, 0, 1, 0, 1, 0, 1, 1]",192,96,96,8,9,0.08333333333333333,0.09375
"[0, 0, 0, 0, 0, 1, 1, 1, 0, 1, 1, 1, 1, 0, 0]",193,116,77,11,9,0.09482758620689655,0.11688311688311688
"[1, 1, 0, 0, 1, 0, 0, 0, 0, 0, 0, 0, 1, 0, 0]",555,375,180,35,15,0.09333333333333334,0.08333333333333333
"[1, 0, 0, 0, 1, 1, 0, 0, 1, 0, 0, 0, 0, 0, 0]",652,436,216,43,17,0.09862385321100918,0.0787037037037037
"[1, 1, 0, 0, 0, 1, 1, 0, 0, 1, 0, 0, 0, 0, 0]",295,199,96,20,11,0.10050251256281408,0.11458333333333333
"[0, 0, 0, 1, 1, 0, 1, 1, 0, 0, 0, 0, 0, 1, 0]",235,154,81,20,8,0.12987012987012986,0.09876543209876543
"[0, 0, 0, 0, 1, 1, 0, 1, 1, 0, 0, 0, 0, 0, 1]",319,212,107,27,10,0.12735849056603774,0.09345794392523364
"[0, 0, 0, 1, 0, 0, 0, 1, 1, 0, 1, 0, 0, 1, 0]",213,138,75,9,2,0.06521739130434782,0.02666666666666667
"[1, 0, 0, 1, 0, 1, 0, 1, 1, 1, 1, 0, 1, 1, 1]",290,91,199,8,23,0.08791208791208792,0.11557788944723618
"[1, 1, 1, 0, 1, 0, 0, 1, 0, 1, 0, 1, 1, 1, 1]",286,94,192,11,13,0.11702127659574468,0.06770833333333333
"[0, 1, 1, 1, 0, 1, 1, 0, 0, 1, 1, 1, 1, 1, 1]",983,344,639,35,57,0.10174418604651163,0.0892018779342723
"[0, 0, 1, 1, 1, 0, 1, 1, 0, 0, 1, 1, 1, 1, 1]",462,183,279,16,22,0.08743169398907104,0.07885304659498207
"[1, 1, 1, 1, 1, 0, 0, 0, 0, 0, 0, 1, 1, 1, 0]",423,115,308,7,27,0.06086956521739131,0.08766233766233766
"[0, 1, 1, 0, 1, 1, 1, 1, 1, 1, 1, 0, 0, 0, 0]",378,172,206,21,20,0.12209302325581395,0.0970873786407767
"[0, 0, 0, 0, 0, 1, 1, 1, 0, 0, 0, 0, 0, 1, 1]",562,403,159,39,21,0.0967741935483871,0.1320754716981132
"[0, 1, 0, 0, 0, 0, 1, 1, 0, 0, 0, 0, 1, 1, 1]",591,340,251,42,26,0.12352941176470589,0.10358565737051793
"[0, 0, 0, 0, 1, 1, 0, 0, 0, 1, 0, 0, 0, 0, 1]",783,571,212,64,19,0.11208406304728546,0.08962264150943396
"[0, 0, 1, 0, 0, 1, 1, 0, 0, 0, 1, 1, 0, 0, 0]",352,227,125,26,13,0.1145374449339207,0.104
"[0, 1, 1, 1, 1, 1, 1, 1, 1, 1, 1, 0, 1, 0, 0]",783,312,471,26,42,0.08333333333333333,0.08917197452229299
"[1, 0, 0, 0, 1, 1, 1, 1, 1, 1, 1, 0, 1, 1, 0]",271,85,186,12,13,0.1411764705882353,0.06989247311827956
"[0, 1, 0, 0, 1, 0, 1, 0, 0, 1, 0, 0, 0, 0, 0]",556,415,141,35,12,0.08433734939759036,0.0851063829787234
"[1, 1, 1, 0, 1, 1, 1, 0, 1, 1, 1, 1, 0, 0, 0]",348,120,228,17,18,0.14166666666666666,0.07894736842105263
"[0, 0, 0, 1, 0, 1, 1, 1, 1, 0, 0, 1, 1, 1, 1]",330,161,169,17,17,0.10559006211180125,0.10059171597633136
"[1, 1, 1, 0, 1, 1, 0, 1, 1, 1, 1, 0, 0, 0, 1]",265,85,180,10,20,0.11764705882352941,0.1111111111111111
"[1, 0, 0, 1, 1, 1, 1, 0, 0, 0, 1, 0, 0, 1, 1]",209,62,147,7,13,0.11290322580645161,0.08843537414965986
"[1, 0, 0, 0, 1, 0, 0, 0, 0, 0, 1, 0, 1, 1, 0]",248,164,84,18,7,0.10975609756097561,0.08333333333333333
"[0, 1, 1, 0, 0, 0, 0, 1, 1, 1, 0, 0, 1, 1, 1]",359,242,117,19,9,0.07851239669421488,0.07692307692307693
"[0, 1, 0, 0, 0, 0, 1, 0, 1, 1, 0, 0, 0, 0, 1]",277,174,103,17,11,0.09770114942528736,0.10679611650485436
"[1, 1, 1, 0, 0, 1, 0, 0, 0, 0, 0, 0, 1, 1, 0]",288,145,143,12,13,0.08275862068965517,0.09090909090909091
"[0, 0, 1, 1, 0, 0, 0, 0, 1, 1, 0, 1, 1, 0, 0]",275,152,123,14,9,0.09210526315789473,0.07317073170731707
"[1, 1, 0, 1, 0, 0, 1, 1, 0, 0, 0, 0, 1, 1, 0]",254,135,119,12,14,0.08888888888888889,0.11764705882352941
"[0, 0, 1, 0, 0, 0, 1, 0, 0, 1, 1, 0, 0, 1, 1]",267,164,103,13,12,0.07926829268292683,0.11650485436893204
"[0, 1, 0, 0, 0, 0, 0, 0, 1, 0, 1, 1, 0, 1, 0]",233,158,75,13,6,0.08227848101265822,0.08
"[0, 1, 1, 1, 0, 0, 0, 0, 0, 1, 0, 0, 1, 0, 0]",260,166,94,17,9,0.10240963855421686,0.09574468085106383
"[0, 0, 1, 0, 0, 0, 0, 1, 0, 0, 1, 1, 1, 0, 0]",264,170,94,15,11,0.08823529411764706,0.11702127659574468
"[1, 0, 1, 1, 1, 0, 0, 0, 0, 0, 1, 0, 0, 0, 1]",157,85,72,8,3,0.09411764705882353,0.041666666666666664
"[0, 0, 1, 0, 1, 1, 0, 1, 1, 0, 1, 1, 0, 0, 1]",123,56,67,6,8,0.10714285714285714,0.11940298507462686
"[0, 1, 0, 1, 0, 1, 1, 1, 1, 0, 0, 0, 0, 1, 0]",120,63,57,9,6,0.14285714285714285,0.10526315789473684
"[0, 1, 1, 0, 0, 0, 0, 1, 0, 1, 0, 1, 1, 0, 0]",195,123,72,15,8,0.12195121951219512,0.1111111111111111
"[1, 0, 1, 0, 0, 0, 0, 1, 1, 0, 1, 1, 0, 0, 0]",171,106,65,15,6,0.14150943396226415,0.09230769230769231
"[0, 1, 1, 0, 1, 1, 1, 1, 1, 1, 0, 0, 1, 1, 0]",449,177,272,18,25,0.1016949152542373,0.09191176470588236
"[0, 1, 1, 0, 1, 0, 0, 1, 0, 1, 1, 0, 0, 0, 0]",195,117,78,9,14,0.07692307692307693,0.1794871794871795
"[1, 1, 0, 1, 0, 1, 1, 0, 1, 0, 1, 0, 1, 1, 1]",242,82,160,9,20,0.10975609756097561,0.125
"[0, 1, 1, 1, 0, 0, 0, 0, 1, 1, 0, 0, 0, 0, 0]",767,497,270,49,21,0.09859154929577464,0.07777777777777778
"[0, 0, 1, 1, 0, 0, 0, 0, 0, 0, 1, 0, 0, 1, 1]",658,446,212,39,20,0.08744394618834081,0.09433962264150944
"[1, 0, 0, 0, 0, 1, 0, 0, 1, 1, 0, 0, 0, 1, 0]",263,164,99,23,8,0.1402439024390244,0.08080808080808081
"[0, 1, 1, 0, 1, 0, 1, 1, 1, 0, 0, 0, 1, 0, 1]",116,66,50,6,4,0.09090909090909091,0.08
"[0, 0, 0, 1, 1, 0, 1, 0, 1, 1, 1, 0, 0, 0, 1]",125,75,50,8,1,0.10666666666666667,0.02
"[0, 1, 0, 1, 1, 1, 0, 1, 1, 0, 0, 0, 0, 0, 1]",133,71,62,7,7,0.09859154929577464,0.11290322580645161
"[1, 0, 1, 1, 1, 0, 0, 0, 0, 0, 0, 1, 1, 0, 0]",458,268,190,28,22,0.1044776119402985,0.11578947368421053
"[1, 0, 0, 1, 0, 0, 0, 0, 0, 0, 0, 1, 1, 1, 0]",275,170,105,19,9,0.11176470588235295,0.08571428571428572
"[0, 1, 0, 1, 0, 1, 0, 1, 0, 1, 1, 1, 1, 1, 0]",130,55,75,3,11,0.05454545454545454,0.14666666666666667
"[1, 1, 0, 1, 0, 1, 0, 1, 1, 1, 1, 1, 1, 0, 0]",338,110,228,14,23,0.12727272727272726,0.10087719298245613
"[0, 0, 1, 1, 0, 1, 1, 1, 1, 1, 1, 1, 0, 1, 0]",235,84,151,6,14,0.07142857142857142,0.09271523178807947
"[1, 0, 0, 1, 1, 0, 1, 1, 1, 1, 0, 0, 0, 1, 1]",204,75,129,6,12,0.08,0.09302325581395349
"[0, 0, 1, 1, 1, 1, 1, 1, 0, 1, 0, 1, 1, 1, 0]",292,117,175,15,15,0.1282051282051282,0.08571428571428572
"[1, 0, 0, 1, 0, 1, 1, 0, 0, 0, 0, 0, 0, 0, 0]",954,645,309,58,33,0.08992248062015504,0.10679611650485436
"[0, 0, 0, 1, 0, 1, 1, 1, 0, 0, 1, 0, 1, 1, 0]",102,59,43,5,6,0.0847457627118644,0.13953488372093023
"[1, 0, 0, 0, 1, 1, 1, 0, 0, 1, 1, 1, 0, 0, 1]",156,80,76,6,6,0.075,0.07894736842105263
"[0, 1, 0, 0, 0, 1, 1, 0, 0, 0, 0, 0, 1, 0, 0]",568,394,174,39,21,0.09898477157360407,0.1206896551724138
"[1, 1, 1, 0, 0, 0, 0, 1, 0, 0, 0, 1, 1, 0, 0]",222,124,98,9,9,0.07258064516129033,0.09183673469387756
"[1, 1, 1, 1, 1, 0, 0, 0, 0, 1, 0, 0, 0, 1, 1]",233,78,155,5,19,0.0641025641025641,0.12258064516129032
"[1, 1, 0, 1, 1, 1, 0, 1, 1, 1, 0, 0, 1, 0, 0]",150,60,90,8,7,0.13333333333333333,0.07777777777777778
"[0, 1, 1, 1, 1, 1, 0, 1, 1, 1, 0, 1, 1, 1, 0]",528,160,368,13,37,0.08125,0.10054347826086957
"[1, 1, 0, 1, 1, 1, 0, 1, 0, 1, 0, 1, 1, 1, 1]",557,174,383,24,43,0.13793103448275862,0.1122715404699739
"[1, 0, 1, 0, 1, 1, 1, 1, 1, 0, 1, 1, 1, 0, 1]",511,149,362,14,34,0.09395973154362416,0.09392265193370165
"[0, 1, 1, 0, 1, 1, 1, 0, 0, 1, 1, 1, 1, 0, 0]",364,169,195,22,26,0.1301775147928994,0.13333333333333333
"[0, 1, 0, 0, 1, 1, 1, 1, 0, 0, 0, 0, 0, 1, 1]",200,125,75,8,6,0.064,0.08
"[0, 0, 0, 1, 0, 0, 0, 1, 0, 0, 0, 0, 0, 0, 1]",1817,1413,404,141,43,0.09978768577494693,0.10643564356435643
"[0, 0, 0, 0, 1, 1, 0, 0, 0, 0, 1, 1, 1, 0, 1]",434,235,199,24,27,0.10212765957446808,0.135678391959799
"[1, 0, 0, 0, 0, 1, 1, 0, 0, 0, 0, 1, 1, 1, 0]",417,131,286,10,28,0.07633587786259542,0.0979020979020979
"[0, 0, 0, 1, 1, 0, 0, 0, 1, 1, 1, 1, 0, 0, 0]",327,220,107,22,9,0.1,0.08411214953271028
"[0, 0, 0, 1, 0, 1, 0, 0, 1, 0, 1, 0, 1, 1, 0]",141,80,61,5,5,0.0625,0.08196721311475409
"[1, 1, 1, 0, 0, 1, 1, 0, 1, 1, 1, 1, 1, 0, 0]",367,124,243,13,24,0.10483870967741936,0.09876543209876543
"[0, 0, 1, 0, 0, 0, 0, 0, 1, 0, 0, 1, 1, 0, 0]",728,527,201,56,20,0.1062618595825427,0.09950248756218906
"[0, 0, 0, 1, 0, 1, 0, 1, 0, 1, 0, 0, 1, 0, 0]",227,161,66,18,5,0.11180124223602485,0.07575757575757576
"[1, 1, 0, 0, 0, 0, 1, 0, 1, 0, 1, 0, 1, 0, 0]",169,97,72,16,4,0.16494845360824742,0.05555555555555555
"[1, 1, 1, 1, 0, 1, 0, 0, 1, 0, 0, 1, 0, 1, 1]",161,64,97,3,10,0.046875,0.10309278350515463
"[0, 0, 0, 1, 0, 1, 0, 1, 0, 1, 1, 0, 1, 0, 0]",131,78,53,8,6,0.10256410256410256,0.11320754716981132
"[0, 0, 0, 0, 0, 1, 0, 1, 0, 1, 0, 1, 1, 0, 1]",152,101,51,9,4,0.0891089108910891,0.0784313725490196
"[0, 1, 1, 0, 1, 1, 1, 1, 1, 1, 1, 0, 1, 1, 0]",557,173,384,15,50,0.08670520231213873,0.13020833333333334
"[1, 1, 0, 0, 0, 1, 1, 0, 1, 1, 1, 1, 1, 1, 1]",793,217,576,34,51,0.15668202764976957,0.08854166666666667
"[0, 1, 1, 0, 0, 0, 1, 1, 0, 1, 1, 1, 1, 1, 1]",358,172,186,22,21,0.12790697674418605,0.11290322580645161
"[0, 1, 0, 1, 1, 1, 0, 1, 1, 0, 0, 1, 1, 0, 0]",183,90,93,10,5,0.1111111111111111,0.053763440860215055
"[1, 0, 1, 1, 1, 0, 1, 1, 1, 0, 1, 1, 1, 0, 1]",455,127,328,14,38,0.11023622047244094,0.11585365853658537
"[1, 0, 0, 1, 0, 1, 1, 0, 1, 1, 1, 1, 1, 1, 1]",706,199,507,20,49,0.10050251256281408,0.09664694280078895
"[1, 1, 1, 0, 1, 1, 1, 0, 1, 1, 1, 1, 0, 1, 1]",1553,369,1184,26,101,0.07046070460704607,0.08530405405405406
"[0, 1, 0, 0, 1, 0, 0, 0, 1, 0, 0, 1, 1, 0, 0]",294,189,105,21,8,0.1111111111111111,0.0761904761904762
"[0, 1, 1, 1, 1, 0, 1, 1, 0, 0, 0, 0, 0, 0, 0]",320,204,116,24,14,0.11764705882352941,0.1206896551724138
"[0, 1, 1, 0, 0, 1, 1, 0, 0, 1, 0, 1, 0, 1, 1]",167,106,61,5,7,0.04716981132075472,0.11475409836065574
"[0, 0, 0, 0, 0, 1, 0, 1, 1, 0, 0, 1, 1, 0, 0]",458,315,143,32,15,0.10158730158730159,0.1048951048951049
"[1, 0, 1, 1, 1, 1, 0, 0, 0, 1, 1, 1, 1, 1, 0]",275,102,173,10,12,0.09803921568627451,0.06936416184971098
"[1, 0, 1, 0, 1, 1, 1, 1, 0, 0, 0, 1, 1, 1, 1]",356,119,237,10,27,0.08403361344537816,0.11392405063291139
"[0, 1, 0, 0, 1, 0, 1, 0, 1, 1, 0, 0, 1, 1, 1]",157,86,71,10,8,0.11627906976744186,0.11267605633802817
"[1, 1, 0, 1, 1, 0, 0, 0, 0, 0, 0, 0, 0, 0, 1]",409,247,162,26,13,0.10526315789473684,0.08024691358024691
"[0, 1, 1, 1, 1, 1, 1, 0, 1, 0, 1, 1, 0, 0, 1]",278,100,178,14,20,0.14,0.11235955056179775
"[1, 1, 1, 1, 1, 0, 1, 0, 0, 0, 0, 1, 0, 1, 1]",178,65,113,6,10,0.09230769230769231,0.08849557522123894
"[0, 1, 1, 1, 1, 1, 1, 1, 1, 1, 0, 1, 0, 0, 0]",325,150,175,14,16,0.09333333333333334,0.09142857142857143
"[0, 1, 0, 0, 1, 0, 1, 0, 0, 1, 1, 1, 1, 1, 0]",122,59,63,6,6,0.1016949152542373,0.09523809523809523
"[1, 0, 0, 0, 1, 0, 1, 1, 0, 0, 1, 1, 1, 1, 0]",214,101,113,8,13,0.07920792079207921,0.11504424778761062
"[1, 1, 0, 1, 0, 0, 0, 1, 0, 1, 1, 0, 0, 1, 1]",148,67,81,5,13,0.07462686567164178,0.16049382716049382
"[1, 1, 1, 1, 0, 1, 0, 0, 0, 1, 0, 1, 1, 0, 0]",130,51,79,5,8,0.09803921568627451,0.10126582278481013
"[0, 1, 1, 1, 1, 0, 1, 0, 0, 0, 1, 0, 1, 1, 0]",100,51,49,6,7,0.11764705882352941,0.14285714285714285
"[1, 1, 0, 1, 1, 1, 1, 0, 1, 0, 0, 0, 1, 0, 1]",136,50,86,7,9,0.14,0.10465116279069768
"[0, 1, 0, 1, 1, 0, 0, 0, 1, 1, 1, 0, 0, 0, 1]",107,61,46,9,2,0.14754098360655737,0.043478260869565216
"[0, 1, 0, 1, 0, 0, 0, 0, 0, 0, 1, 1, 1, 0, 1]",158,98,60,9,4,0.09183673469387756,0.06666666666666667
"[0, 1, 1, 0, 0, 1, 0, 1, 0, 0, 1, 1, 0, 0, 0]",202,130,72,6,6,0.046153846153846156,0.08333333333333333
"[0, 0, 1, 0, 1, 1, 1, 1, 0, 1, 1, 1, 0, 1, 0]",123,64,59,5,5,0.078125,0.0847457627118644
"[0, 0, 0, 0, 1, 0, 0, 1, 1, 0, 0, 1, 1, 0, 0]",634,426,208,42,27,0.09859154929577464,0.12980769230769232
"[1, 1, 0, 0, 0, 0, 1, 0, 0, 1, 1, 0, 0, 1, 1]",263,130,133,9,15,0.06923076923076923,0.11278195488721804
"[0, 0, 1, 1, 1, 0, 1, 1, 1, 1, 0, 0, 0, 1, 1]",178,77,101,5,4,0.06493506493506493,0.039603960396039604
"[1, 0, 0, 1, 1, 0, 1, 1, 0, 1, 1, 1, 1, 0, 1]",259,93,166,11,10,0.11827956989247312,0.060240963855421686
"[0, 1, 0, 0, 1, 1, 0, 1, 1, 0, 1, 1, 1, 1, 0]",174,79,95,8,7,0.10126582278481013,0.07368421052631578
"[1, 0, 1, 0, 0, 0, 0, 1, 0, 0, 1, 1, 0, 1, 1]",116,57,59,4,8,0.07017543859649122,0.13559322033898305
"[1, 0, 0, 0, 0, 0, 0, 1, 1, 0, 0, 1, 0, 1, 0]",365,151,214,19,20,0.12582781456953643,0.09345794392523364
"[1, 0, 0, 0, 0, 0, 1, 1, 1, 0, 0, 0, 1, 1, 1]",221,117,104,6,8,0.05128205128205128,0.07692307692307693
"[1, 1, 1, 0, 0, 0, 1, 0, 0, 1, 1, 0, 1, 0, 1]",114,49,65,3,8,0.061224489795918366,0.12307692307692308
"[1, 1, 1, 1, 1, 0, 1, 0, 1, 1, 1, 0, 0, 0, 1]",254,86,168,8,12,0.09302325581395349,0.07142857142857142
"[0, 1, 0, 0, 1, 1, 0, 0, 1, 1, 1, 0, 1, 0, 1]",109,50,59,5,8,0.1,0.13559322033898305
"[1, 1, 0, 1, 0, 0, 1, 1, 0, 0, 1, 1, 1, 0, 1]",150,57,93,9,10,0.15789473684210525,0.10752688172043011
"[1, 0, 1, 1, 0, 1, 0, 0, 1, 1, 0, 0, 1, 1, 1]",244,91,153,9,17,0.0989010989010989,0.1111111111111111
"[1, 0, 1, 1, 1, 1, 1, 1, 0, 0, 1, 0, 0, 0, 0]",161,72,89,7,6,0.09722222222222222,0.06741573033707865
"[0, 0, 0, 1, 1, 1, 1, 0, 1, 0, 0, 0, 1, 1, 0]",167,95,72,6,3,0.06315789473684211,0.041666666666666664
"[1, 1, 0, 1, 0, 1, 1, 1, 0, 0, 0, 1, 0, 1, 1]",135,62,73,4,12,0.06451612903225806,0.1643835616438356
"[0, 0, 0, 0, 0, 1, 0, 0, 1, 0, 0, 0, 1, 1, 0]",646,465,181,43,15,0.09247311827956989,0.08287292817679558
"[1, 0, 0, 0, 1, 0, 1, 0, 1, 1, 1, 1, 0, 0, 0]",159,76,83,7,10,0.09210526315789473,0.12048192771084337
"[1, 1, 0, 0, 0, 1, 0, 1, 0, 1, 1, 1, 1, 0, 0]",160,73,87,8,9,0.1095890410958904,0.10344827586206896
"[1, 1, 0, 1, 1, 1, 1, 0, 0, 0, 1, 0, 1, 0, 1]",160,66,94,2,5,0.030303030303030304,0.05319148936170213
"[0, 0, 0, 1, 1, 1, 1, 1, 0, 1, 1, 1, 1, 0, 0]",225,115,110,7,12,0.06086956521739131,0.10909090909090909
"[0, 1, 1, 0, 1, 0, 0, 1, 1, 0, 1, 1, 0, 0, 0]",124,68,56,6,5,0.08823529411764706,0.08928571428571429
"[1, 1, 1, 1, 1, 0, 0, 0, 1, 1, 0, 1, 1, 0, 1]",296,98,198,7,18,0.07142857142857142,0.09090909090909091
"[0, 0, 0, 1, 0, 0, 1, 0, 1, 0, 0, 1, 0, 1, 1]",189,114,75,10,6,0.08771929824561403,0.08
"[1, 1, 1, 0, 0, 0, 1, 0, 0, 1, 0, 1, 0, 0, 1]",111,61,50,1,7,0.01639344262295082,0.14
"[1, 0, 1, 0, 0, 0, 0, 1, 1, 0, 1, 1, 1, 0, 1]",104,45,59,2,5,0.044444444444444446,0.0847457627118644
"[1, 0, 0, 1, 0, 0, 0, 1, 0, 1, 1, 1, 1, 1, 0]",118,58,60,4,9,0.06896551724137931,0.15
"[1, 0, 0, 1, 0, 1, 0, 1, 1, 1, 1, 0, 0, 1, 1]",256,99,157,14,8,0.1414141414141414,0.050955414012738856
"[0, 1, 1, 1, 1, 1, 0, 1, 0, 1, 0, 0, 1, 0, 1]",145,60,85,7,6,0.11666666666666667,0.07058823529411765
"[1, 0, 1, 0, 1, 0, 1, 1, 0, 0, 1, 0, 0, 0, 1]",94,47,47,2,3,0.0425531914893617,0.06382978723404255
"[1, 0, 1, 1, 0, 1, 1, 1, 0, 1, 0, 1, 0, 1, 1]",226,62,164,6,25,0.0967741935483871,0.1524390243902439
"[0, 0, 0, 0, 0, 1, 1, 0, 1, 0, 1, 0, 1, 0, 0]",260,178,82,12,3,0.06741573033707865,0.036585365853658534
"[0, 0, 0, 0, 0, 0, 0, 1, 1, 0, 1, 0, 1, 0, 1]",311,234,77,28,5,0.11965811965811966,0.06493506493506493
"[1, 0, 1, 1, 0, 1, 1, 0, 0, 0, 1, 1, 1, 0, 1]",140,62,78,4,9,0.06451612903225806,0.11538461538461539
"[0, 0, 1, 0, 0, 0, 0, 0, 0, 0, 1, 0, 1, 1, 1]",519,352,167,44,16,0.125,0.09580838323353294
"[0, 1, 0, 0, 0, 1, 0, 0, 1, 1, 1, 0, 1, 1, 0]",104,57,47,4,9,0.07017543859649122,0.19148936170212766
"[0, 0, 1, 0, 0, 0, 0, 1, 1, 0, 1, 0, 0, 1, 0]",236,144,92,14,5,0.09722222222222222,0.05434782608695652
"[1, 0, 0, 1, 1, 1, 1, 0, 1, 0, 0, 1, 0, 1, 1]",193,70,123,9,13,0.12857142857142856,0.10569105691056911
"[1, 0, 0, 1, 0, 0, 0, 1, 0, 1, 0, 0, 0, 0, 1]",271,167,104,20,7,0.11976047904191617,0.0673076923076923
"[0, 1, 0, 1, 1, 0, 1, 0, 1, 0, 1, 0, 1, 1, 0]",100,41,59,4,6,0.0975609756097561,0.1016949152542373
"[1, 1, 1, 0, 0, 1, 0, 1, 0, 0, 1, 0, 0, 1, 0]",109,55,54,9,4,0.16363636363636364,0.07407407407407407
"[1, 0, 1, 1, 1, 1, 0, 0, 1, 0, 1, 0, 0, 1, 0]",107,45,62,5,3,0.1111111111111111,0.04838709677419355
"[1, 0, 1, 0, 0, 1, 0, 1, 1, 1, 1, 0, 0, 1, 0]",114,65,49,6,7,0.09230769230769231,0.14285714285714285
"[1, 0, 0, 1, 1, 1, 0, 0, 0, 1, 0, 1, 0, 1, 0]",117,66,51,5,3,0.07575757575757576,0.058823529411764705
"[0, 1, 1, 1, 0, 1, 1, 0, 0, 0, 0, 0, 0, 0, 1]",182,99,83,6,9,0.06060606060606061,0.10843373493975904
"[0, 0, 0, 1, 0, 1, 1, 0, 1, 0, 1, 0, 0, 0, 0]",249,157,92,13,14,0.08280254777070063,0.15217391304347827
"[0, 0, 0, 0, 0, 0, 0, 1, 0, 1, 1, 0, 1, 0, 1]",271,176,95,12,11,0.06818181818181818,0.11578947368421053
"[0, 0, 1, 1, 0, 0, 0, 1, 0, 1, 0, 1, 0, 0, 0]",272,190,82,21,14,0.11052631578947368,0.17073170731707318
"[1, 1, 0, 1, 0, 1, 0, 0, 0, 1, 0, 1, 1, 1, 1]",175,72,103,7,10,0.09722222222222222,0.0970873786407767
"[0, 1, 1, 0, 0, 1, 0, 0, 1, 0, 1, 0, 0, 1, 1]",133,73,60,8,6,0.1095890410958904,0.1
"[0, 0, 0, 0, 1, 1, 1, 1, 1, 1, 0, 1, 1, 0, 0]",252,115,137,15,14,0.13043478260869565,0.10218978102189781
"[1, 0, 0, 0, 0, 0, 1, 1, 1, 1, 1, 1, 0, 1, 1]",201,70,131,3,16,0.04285714285714286,0.12213740458015267
"[0, 1, 1, 1, 1, 1, 0, 0, 1, 1, 1, 0, 1, 1, 0]",258,91,167,15,19,0.16483516483516483,0.11377245508982035
"[0, 1, 0, 0, 1, 1, 0, 0, 1, 1, 1, 1, 0, 0, 1]",399,205,194,19,19,0.09268292682926829,0.0979381443298969
"[1, 1, 1, 0, 1, 0, 0, 1, 1, 1, 0, 1, 1, 1, 1]",614,180,434,18,38,0.1,0.08755760368663594
"[0, 1, 1, 0, 1, 1, 0, 1, 1, 1, 1, 1, 1, 0, 1]",519,170,349,17,36,0.1,0.10315186246418338
"[0, 0, 1, 0, 1, 0, 1, 0, 0, 1, 0, 1, 0, 0, 1]",127,70,57,10,5,0.14285714285714285,0.08771929824561403
"[1, 1, 0, 0, 0, 0, 1, 1, 1, 1, 1, 1, 1, 0, 0]",517,202,315,22,25,0.10891089108910891,0.07936507936507936
"[1, 1, 1, 1, 1, 1, 1, 0, 0, 1, 0, 0, 1, 1, 1]",1073,254,819,24,83,0.09448818897637795,0.10134310134310134
"[1, 1, 0, 1, 0, 1, 0, 0, 1, 1, 1, 1, 0, 1, 1]",288,110,178,11,22,0.1,0.12359550561797752
"[0, 1, 1, 1, 1, 0, 0, 0, 1, 0, 1, 1, 0, 1, 0]",126,62,64,6,4,0.0967741935483871,0.0625
"[1, 0, 1, 1, 1, 1, 0, 0, 0, 1, 0, 1, 1, 0, 1]",175,72,103,7,13,0.09722222222222222,0.1262135922330097
"[1, 0, 1, 0, 1, 1, 0, 0, 1, 1, 1, 1, 0, 1, 1]",282,102,180,5,16,0.049019607843137254,0.08888888888888889
"[1, 1, 1, 0, 1, 1, 1, 1, 0, 1, 0, 1, 1, 0, 0]",267,86,181,9,13,0.10465116279069768,0.0718232044198895
"[0, 1, 0, 1, 0, 0, 1, 1, 1, 1, 1, 1, 0, 1, 1]",277,104,173,12,13,0.11538461538461539,0.07514450867052024
"[1, 0, 0, 0, 1, 0, 1, 1, 1, 0, 1, 0, 0, 1, 0]",90,42,48,4,8,0.09523809523809523,0.16666666666666666
"[0, 0, 1, 0, 1, 0, 0, 0, 1, 0, 1, 1, 1, 0, 1]",112,59,53,4,4,0.06779661016949153,0.07547169811320754
"[0, 0, 1, 0, 1, 1, 0, 1, 0, 0, 1, 0, 1, 1, 0]",121,71,50,6,6,0.08450704225352113,0.12
"[0, 0, 0, 0, 0, 1, 0, 0, 0, 1, 0, 1, 1, 0, 1]",256,178,78,19,6,0.10674157303370786,0.07692307692307693
"[0, 0, 0, 0, 0, 0, 1, 0, 0, 0, 1, 0, 1, 1, 0]",622,430,192,33,19,0.07674418604651163,0.09895833333333333
"[1, 0, 0, 0, 1, 1, 0, 1, 0, 1, 0, 0, 1, 0, 1]",102,56,46,5,5,0.08928571428571429,0.10869565217391304
"[1, 1, 0, 1, 1, 0, 0, 0, 1, 1, 0, 1, 0, 1, 0]",105,49,56,5,3,0.10204081632653061,0.05357142857142857
"[0, 0, 1, 0, 1, 1, 1, 1, 1, 0, 0, 1, 0, 0, 1]",98,48,50,2,1,0.041666666666666664,0.02
"[1, 1, 1, 0, 0, 1, 0, 0, 1, 0, 1, 1, 1, 1, 1]",335,110,225,9,16,0.08181818181818182,0.07111111111111111
"[0, 1, 1, 1, 0, 1, 1, 0, 1, 0, 1, 0, 1, 0, 0]",122,55,67,6,3,0.10909090909090909,0.04477611940298507
"[1, 0, 0, 0, 1, 1, 1, 1, 1, 1, 1, 1, 0, 0, 0]",497,189,308,16,30,0.08465608465608465,0.09740259740259741
"[0, 0, 0, 1, 0, 1, 0, 0, 0, 0, 1, 0, 0, 0, 1]",572,399,173,37,19,0.09273182957393483,0.10982658959537572
"[0, 1, 0, 0, 0, 1, 0, 1, 0, 0, 0, 0, 1, 0, 0]",527,378,149,33,15,0.0873015873015873,0.10067114093959731
"[1, 1, 0, 0, 1, 0, 0, 0, 1, 0, 1, 0, 0, 0, 0]",264,170,94,17,9,0.1,0.09574468085106383
"[1, 0, 0, 1, 1, 0, 1, 1, 1, 0, 0, 1, 0, 0, 1]",109,45,64,3,5,0.06666666666666667,0.078125
"[0, 1, 1, 0, 0, 1, 1, 0, 1, 1, 1, 0, 0, 1, 0]",116,64,52,5,7,0.078125,0.1346153846153846
"[0, 0, 1, 1, 0, 0, 1, 1, 0, 1, 1, 1, 0, 0, 1]",177,81,96,7,5,0.08641975308641975,0.052083333333333336
"[1, 1, 0, 1, 0, 1, 1, 1, 1, 1, 1, 0, 0, 1, 1]",1024,300,724,25,69,0.08333333333333333,0.09530386740331492
"[1, 1, 0, 0, 1, 0, 0, 1, 1, 0, 1, 1, 1, 1, 0]",160,59,101,9,6,0.15254237288135594,0.0594059405940594
"[1, 1, 1, 0, 0, 1, 0, 0, 1, 1, 0, 1, 1, 1, 1]",313,101,212,8,19,0.07920792079207921,0.08962264150943396
"[1, 0, 1, 1, 1, 1, 0, 0, 1, 0, 0, 1, 1, 0, 1]",167,68,99,8,3,0.11764705882352941,0.030303030303030304
"[1, 1, 0, 1, 0, 0, 0, 0, 1, 1, 1, 1, 1, 1, 1]",636,222,414,14,41,0.06306306306306306,0.09903381642512077
"[1, 1, 1, 0, 1, 0, 0, 0, 0, 1, 1, 1, 1, 1, 1]",626,228,398,24,40,0.10526315789473684,0.10050251256281408
"[1, 1, 0, 1, 1, 1, 0, 1, 0, 1, 1, 1, 1, 0, 1]",474,125,349,13,32,0.104,0.09169054441260745
"[0, 0, 1, 1, 1, 0, 1, 1, 1, 1, 0, 1, 0, 1, 1]",257,85,172,6,14,0.07058823529411765,0.08139534883720931
"[1, 0, 0, 1, 1, 0, 1, 1, 0, 0, 0, 0, 0, 1, 1]",206,88,118,12,9,0.13636363636363635,0.07627118644067797
"[1, 1, 0, 0, 1, 1, 0, 1, 1, 0, 0, 0, 0, 0, 1]",177,85,92,13,7,0.15294117647058825,0.07608695652173914
"[0, 0, 1, 0, 1, 1, 1, 1, 0, 0, 1, 1, 0, 1, 1]",204,96,108,10,10,0.10416666666666667,0.09259259259259259
"[0, 1, 0, 1, 0, 1, 1, 1, 0, 0, 0, 0, 1, 0, 1]",119,67,52,7,2,0.1044776119402985,0.038461538461538464
"[0, 0, 1, 1, 0, 1, 0, 1, 0, 1, 1, 1, 0, 0, 0]",122,57,65,2,2,0.03508771929824561,0.03076923076923077
"[0, 0, 0, 1, 1, 0, 1, 0, 1, 0, 1, 1, 1, 0, 0]",112,63,49,2,6,0.031746031746031744,0.12244897959183673
"[1, 1, 0, 0, 1, 0, 1, 1, 0, 0, 0, 0, 0, 0, 1]",253,147,106,9,8,0.061224489795918366,0.07547169811320754
"[0, 0, 0, 1, 0, 0, 1, 0, 0, 1, 1, 0, 0, 1, 0]",271,171,100,14,11,0.08187134502923976,0.11
"[0, 1, 1, 1, 1, 1, 1, 1, 1, 0, 0, 1, 1, 1, 0]",987,493,494,38,45,0.07707910750507099,0.09109311740890688
"[0, 0, 1, 1, 0, 0, 1, 1, 1, 1, 1, 1, 0, 0, 0]",1452,715,737,58,73,0.08111888111888112,0.09905020352781546
"[1, 1, 0, 1, 0, 1, 1, 0, 1, 0, 1, 1, 0, 1, 0]",135,56,79,3,11,0.05357142857142857,0.13924050632911392
"[1, 0, 1, 1, 1, 0, 0, 0, 0, 0, 1, 0, 1, 0, 0]",137,78,59,5,3,0.0641025641025641,0.05084745762711865
"[1, 1, 1, 0, 0, 1, 1, 0, 0, 1, 1, 1, 0, 0, 1]",351,95,256,5,28,0.05263157894736842,0.109375
"[1, 0, 1, 1, 0, 1, 0, 0, 0, 1, 1, 1, 0, 0, 0]",143,77,66,7,7,0.09090909090909091,0.10606060606060606
"[0, 0, 1, 0, 1, 1, 1, 0, 0, 1, 1, 1, 0, 1, 1]",148,66,82,2,9,0.030303030303030304,0.10975609756097561
"[1, 0, 1, 0, 1, 1, 0, 1, 0, 0, 0, 0, 1, 0, 1]",118,55,63,5,7,0.09090909090909091,0.1111111111111111
"[1, 1, 1, 0, 0, 1, 0, 0, 0, 1, 1, 0, 0, 0, 0]",270,151,119,15,11,0.09933774834437085,0.09243697478991597
"[1, 0, 0, 0, 1, 0, 1, 1, 1, 0, 1, 0, 0, 0, 0]",194,101,93,9,6,0.0891089108910891,0.06451612903225806
"[0, 1, 1, 1, 0, 0, 1, 1, 1, 0, 0, 0, 1, 0, 1]",132,62,70,5,5,0.08064516129032258,0.07142857142857142
"[0, 0, 1, 0, 1, 1, 1, 0, 1, 1, 1, 0, 0, 1, 1]",192,77,115,4,8,0.05194805194805195,0.06956521739130435
"[0, 0, 1, 1, 1, 1, 0, 1, 1, 1, 0, 1, 0, 1, 1]",226,77,149,8,14,0.1038961038961039,0.09395973154362416
"[0, 0, 1, 1, 0, 0, 0, 1, 1, 1, 1, 0, 1, 1, 1]",234,105,129,12,13,0.11428571428571428,0.10077519379844961
"[0, 1, 0, 0, 0, 1, 1, 0, 0, 0, 1, 1, 1, 1, 0]",143,83,60,11,6,0.13253012048192772,0.1
"[0, 0, 1, 1, 1, 0, 0, 1, 1, 1, 1, 1, 1, 1, 1]",1437,456,981,43,100,0.09429824561403509,0.1019367991845056
"[1, 1, 0, 1, 0, 0, 1, 1, 1, 0, 0, 0, 1, 1, 1]",169,66,103,6,9,0.09090909090909091,0.08737864077669903
"[0, 0, 1, 1, 0, 1, 0, 1, 1, 0, 1, 1, 0, 1, 0]",115,55,60,6,3,0.10909090909090909,0.05
"[1, 1, 1, 1, 1, 1, 0, 1, 0, 1, 1, 0, 1, 0, 0]",257,91,166,8,14,0.08791208791208792,0.08433734939759036
"[0, 1, 1, 1, 1, 1, 1, 0, 1, 0, 1, 1, 0, 1, 0]",241,107,134,8,15,0.07476635514018691,0.11194029850746269
"[0, 0, 0, 0, 0, 1, 1, 0, 0, 0, 1, 1, 0, 0, 0]",1011,761,250,61,31,0.08015768725361366,0.124
"[1, 0, 1, 1, 1, 1, 0, 0, 1, 0, 1, 1, 1, 1, 1]",605,183,422,19,34,0.10382513661202186,0.08056872037914692
"[1, 0, 0, 0, 1, 0, 1, 1, 1, 0, 0, 0, 0, 0, 1]",158,91,67,4,6,0.04395604395604396,0.08955223880597014
"[0, 0, 0, 0, 1, 0, 0, 1, 0, 0, 0, 0, 0, 1, 0]",1541,1177,364,101,40,0.08581138487680544,0.10989010989010989
"[0, 1, 1, 1, 0, 1, 0, 0, 0, 1, 0, 0, 0, 0, 0]",258,173,85,21,6,0.12138728323699421,0.07058823529411765
"[0, 0, 1, 0, 1, 0, 0, 1, 1, 0, 0, 0, 1, 1, 1]",150,85,65,6,8,0.07058823529411765,0.12307692307692308
"[1, 1, 0, 1, 0, 0, 1, 1, 0, 1, 0, 1, 0, 0, 1]",110,46,64,2,7,0.043478260869565216,0.109375
"[1, 1, 0, 1, 0, 1, 0, 1, 0, 0, 0, 1, 0, 0, 1]",107,54,53,3,5,0.05555555555555555,0.09433962264150944
"[1, 1, 1, 0, 1, 1, 0, 0, 1, 1, 0, 0, 0, 1, 1]",220,85,135,5,11,0.058823529411764705,0.08148148148148149
"[1, 1, 1, 0, 0, 1, 0, 1, 0, 0, 0, 0, 1, 1, 1]",181,85,96,7,11,0.08235294117647059,0.11458333333333333
"[0, 1, 0, 1, 1, 0, 1, 1, 0, 1, 1, 1, 1, 1, 1]",631,189,442,17,38,0.08994708994708994,0.08597285067873303
"[1, 1, 1, 1, 1, 1, 1, 0, 1, 0, 1, 0, 1, 0, 1]",533,158,375,13,51,0.08227848101265822,0.136
"[0, 1, 1, 0, 1, 1, 1, 1, 0, 1, 1, 1, 0, 1, 1]",543,180,363,14,33,0.07777777777777778,0.09090909090909091
"[0, 1, 1, 0, 0, 0, 1, 1, 0, 1, 0, 1, 0, 0, 0]",168,98,70,8,7,0.08163265306122448,0.1
"[0, 1, 0, 1, 1, 0, 0, 0, 1, 1, 0, 1, 0, 1, 0]",105,53,52,5,7,0.09433962264150944,0.1346153846153846
"[1, 0, 1, 0, 1, 0, 0, 1, 0, 0, 1, 0, 1, 1, 0]",108,62,46,5,5,0.08064516129032258,0.10869565217391304
"[1, 1, 0, 1, 1, 1, 0, 0, 0, 1, 1, 0, 1, 1, 1]",283,107,176,9,19,0.08411214953271028,0.10795454545454546
"[1, 0, 1, 1, 1, 0, 1, 0, 1, 0, 0, 1, 1, 1, 1]",312,106,206,11,30,0.10377358490566038,0.14563106796116504
"[1, 1, 1, 1, 0, 1, 0, 1, 1, 0, 0, 1, 1, 1, 0]",262,91,171,8,13,0.08791208791208792,0.07602339181286549
"[0, 0, 1, 1, 1, 0, 1, 1, 1, 1, 1, 0, 0, 0, 0]",246,105,141,15,13,0.14285714285714285,0.09219858156028368
"[1, 0, 0, 1, 0, 1, 1, 1, 0, 1, 1, 0, 1, 0, 0]",118,50,68,6,10,0.12,0.14705882352941177
"[1, 1, 1, 0, 0, 1, 0, 1, 1, 1, 0, 1, 1, 0, 1]",221,77,144,10,7,0.12987012987012986,0.04861111111111111
"[0, 0, 0, 0, 0, 1, 0, 1, 0, 0, 0, 0, 1, 1, 1]",661,477,184,46,19,0.09643605870020965,0.10326086956521739
"[0, 1, 0, 0, 0, 0, 0, 1, 0, 1, 0, 0, 0, 0, 1]",572,389,183,38,12,0.09768637532133675,0.06557377049180328
"[0, 1, 0, 0, 0, 0, 1, 1, 0, 1, 1, 1, 1, 1, 1]",235,93,142,8,20,0.08602150537634409,0.14084507042253522
"[1, 0, 1, 0, 1, 1, 1, 0, 1, 0, 1, 0, 0, 0, 0]",124,68,56,5,3,0.07352941176470588,0.05357142857142857
"[1, 0, 1, 1, 1, 1, 0, 1, 1, 0, 1, 1, 1, 0, 0]",290,97,193,15,27,0.15463917525773196,0.13989637305699482
"[1, 0, 1, 1, 0, 1, 0, 1, 1, 0, 1, 1, 1, 1, 0]",253,87,166,8,18,0.09195402298850575,0.10843373493975904
"[1, 0, 0, 0, 1, 1, 1, 0, 1, 1, 0, 1, 0, 1, 1]",148,53,95,7,14,0.1320754716981132,0.14736842105263157
"[0, 0, 0, 0, 1, 0, 1, 0, 0, 0, 0, 0, 1, 1, 0]",746,534,212,51,18,0.09550561797752809,0.08490566037735849
"[0, 0, 0, 1, 1, 1, 0, 0, 1, 0, 0, 1, 1, 0, 0]",198,129,69,14,10,0.10852713178294573,0.14492753623188406
"[0, 1, 0, 1, 0, 0, 0, 0, 0, 1, 1, 0, 1, 0, 1]",133,80,53,7,3,0.0875,0.05660377358490566
"[0, 1, 1, 0, 1, 0, 0, 0, 0, 1, 1, 0, 0, 0, 0]",446,303,143,37,7,0.12211221122112212,0.04895104895104895
"[0, 1, 0, 0, 1, 0, 0, 1, 1, 0, 0, 1, 0, 0, 0]",255,156,99,5,10,0.03205128205128205,0.10101010101010101
"[0, 1, 0, 1, 1, 1, 1, 0, 1, 0, 0, 1, 0, 0, 0]",124,67,57,8,7,0.11940298507462686,0.12280701754385964
"[1, 0, 1, 1, 0, 0, 0, 1, 1, 0, 1, 0, 0, 1, 1]",131,70,61,4,8,0.05714285714285714,0.13114754098360656
"[1, 1, 0, 0, 0, 0, 0, 0, 1, 0, 1, 0, 0, 1, 0]",289,176,113,13,16,0.07386363636363637,0.1415929203539823
"[0, 1, 1, 1, 0, 0, 0, 0, 0, 0, 1, 0, 1, 0, 0]",255,162,93,14,10,0.08641975308641975,0.10752688172043011
"[1, 1, 1, 1, 1, 1, 0, 1, 1, 0, 0, 1, 1, 0, 1]",587,165,422,18,39,0.10909090909090909,0.0924170616113744
"[0, 0, 0, 0, 0, 1, 1, 0, 1, 0, 0, 0, 1, 0, 0]",595,430,165,38,19,0.08837209302325581,0.11515151515151516
"[0, 1, 1, 1, 1, 0, 0, 1, 0, 0, 0, 0, 0, 1, 0]",158,95,63,14,5,0.14736842105263157,0.07936507936507936
"[0, 1, 0, 0, 1, 0, 0, 1, 1, 1, 1, 0, 0, 1, 0]",108,64,44,7,6,0.109375,0.13636363636363635
"[1, 0, 1, 1, 0, 1, 1, 1, 1, 1, 0, 1, 0, 0, 1]",235,70,165,7,16,0.1,0.09696969696969697
"[1, 1, 1, 1, 0, 1, 0, 0, 0, 1, 1, 1, 1, 0, 0]",278,101,177,12,18,0.1188118811881188,0.1016949152542373
"[0, 0, 1, 1, 1, 1, 0, 1, 0, 0, 1, 0, 0, 1, 1]",157,76,81,10,8,0.13157894736842105,0.09876543209876543
"[1, 1, 0, 0, 0, 1, 1, 1, 1, 1, 0, 1, 1, 1, 0]",276,103,173,10,12,0.0970873786407767,0.06936416184971098
"[0, 1, 0, 0, 1, 1, 1, 0, 0, 0, 1, 1, 1, 1, 1]",215,109,106,9,10,0.08256880733944955,0.09433962264150944
"[0, 0, 0, 0, 0, 0, 1, 0, 1, 1, 1, 1, 1, 1, 1]",366,200,166,17,16,0.085,0.0963855421686747
"[0, 0, 1, 1, 0, 0, 1, 1, 1, 1, 1, 1, 1, 0, 0]",542,218,324,23,27,0.10550458715596331,0.08333333333333333
"[1, 0, 1, 1, 1, 1, 0, 1, 1, 0, 0, 1, 0, 0, 1]",172,76,96,3,9,0.039473684210526314,0.09375
"[1, 0, 1, 0, 0, 1, 0, 0, 1, 1, 0, 1, 1, 1, 1]",178,61,117,5,8,0.08196721311475409,0.06837606837606838
"[1, 0, 0, 1, 0, 1, 1, 0, 0, 0, 1, 0, 0, 0, 0]",272,180,92,16,9,0.08888888888888889,0.09782608695652174
"[0, 0, 0, 0, 1, 0, 0, 1, 0, 1, 1, 0, 0, 0, 1]",261,185,76,18,8,0.0972972972972973,0.10526315789473684
"[0, 0, 1, 1, 0, 1, 1, 0, 0, 0, 1, 1, 0, 0, 0]",197,129,68,9,6,0.06976744186046512,0.08823529411764706
"[0, 1, 1, 0, 1, 1, 0, 0, 1, 0, 1, 0, 0, 0, 0]",171,103,68,8,7,0.07766990291262135,0.10294117647058823
"[1, 0, 0, 1, 0, 1, 1, 1, 1, 1, 1, 1, 1, 0, 1]",576,162,414,6,34,0.037037037037037035,0.0821256038647343
"[0, 1, 0, 1, 0, 1, 0, 1, 0, 1, 1, 0, 1, 1, 1]",143,60,83,8,10,0.13333333333333333,0.12048192771084337
"[1, 1, 0, 1, 0, 0, 0, 0, 1, 1, 0, 0, 0, 0, 1]",321,166,155,12,12,0.07228915662650602,0.07741935483870968
"[1, 1, 1, 1, 1, 0, 1, 0, 0, 0, 0, 1, 1, 0, 0]",231,105,126,12,12,0.11428571428571428,0.09523809523809523
"[1, 1, 0, 0, 1, 1, 1, 1, 1, 0, 1, 0, 0, 0, 0]",203,94,109,8,10,0.0851063829787234,0.09174311926605505
"[0, 0, 1, 0, 1, 1, 1, 1, 1, 0, 1, 1, 1, 1, 1]",678,225,453,17,42,0.07555555555555556,0.09271523178807947
"[1, 1, 0, 0, 1, 0, 0, 1, 1, 1, 1, 1, 1, 0, 0]",344,141,203,13,20,0.09219858156028368,0.09852216748768473
"[0, 1, 0, 1, 1, 0, 1, 1, 0, 0, 1, 0, 0, 1, 1]",113,51,62,4,3,0.0784313725490196,0.04838709677419355
"[1, 0, 0, 1, 1, 1, 1, 0, 1, 0, 1, 1, 1, 1, 1]",819,180,639,23,66,0.12777777777777777,0.10328638497652583
"[1, 0, 0, 1, 1, 0, 0, 1, 0, 0, 1, 1, 0, 0, 0]",196,109,87,8,7,0.07339449541284404,0.08045977011494253
"[0, 1, 0, 0, 1, 1, 0, 0, 1, 0, 0, 1, 1, 0, 0]",188,111,77,11,4,0.0990990990990991,0.05194805194805195
"[1, 0, 0, 0, 0, 0, 0, 0, 1, 0, 1, 0, 1, 0, 1]",257,159,98,12,10,0.07547169811320754,0.10204081632653061
"[0, 1, 1, 0, 0, 0, 0, 0, 0, 1, 1, 1, 0, 1, 1]",339,269,70,25,5,0.09293680297397769,0.07142857142857142
"[0, 1, 0, 0, 1, 0, 0, 1, 0, 0, 0, 1, 1, 0, 1]",114,77,37,8,3,0.1038961038961039,0.08108108108108109
"[1, 1, 0, 1, 1, 0, 0, 0, 0, 1, 1, 1, 0, 0, 1]",152,63,89,5,12,0.07936507936507936,0.1348314606741573
"[1, 0, 1, 1, 0, 1, 0, 1, 0, 0, 0, 0, 0, 1, 0]",139,84,55,8,7,0.09523809523809523,0.12727272727272726
"[0, 1, 0, 0, 0, 0, 1, 0, 0, 1, 0, 0, 1, 1, 1]",195,120,75,11,9,0.09166666666666666,0.12
"[1, 0, 0, 1, 1, 0, 1, 1, 0, 1, 1, 0, 0, 1, 1]",227,91,136,8,17,0.08791208791208792,0.125
"[1, 1, 0, 0, 1, 1, 0, 1, 1, 0, 1, 1, 0, 0, 1]",198,76,122,6,11,0.07894736842105263,0.09016393442622951
"[1, 0, 1, 0, 0, 1, 1, 0, 0, 1, 1, 1, 1, 1, 1]",717,241,476,32,33,0.13278008298755187,0.06932773109243698
"[1, 1, 1, 0, 1, 0, 0, 1, 1, 0, 0, 1, 1, 1, 1]",583,191,392,14,38,0.07329842931937172,0.09693877551020408
"[0, 0, 1, 1, 0, 1, 1, 0, 0, 1, 1, 1, 1, 0, 0]",292,152,140,19,11,0.125,0.07857142857142857
"[1, 0, 1, 0, 0, 1, 0, 0, 0, 1, 0, 0, 0, 0, 1]",264,170,94,23,11,0.13529411764705881,0.11702127659574468
"[0, 1, 1, 0, 0, 0, 0, 1, 0, 0, 0, 1, 1, 1, 1]",269,188,81,18,7,0.09574468085106383,0.08641975308641975
"[0, 1, 0, 1, 1, 0, 0, 0, 0, 1, 0, 1, 0, 0, 0]",291,177,114,12,9,0.06779661016949153,0.07894736842105263
"[0, 0, 1, 0, 1, 1, 1, 0, 0, 0, 0, 1, 1, 1, 1]",342,179,163,18,27,0.1005586592178771,0.1656441717791411
"[0, 0, 1, 1, 1, 1, 0, 0, 1, 0, 0, 1, 0, 0, 1]",175,96,79,12,11,0.125,0.13924050632911392
"[0, 1, 0, 0, 0, 0, 1, 0, 0, 1, 0, 1, 0, 1, 1]",130,76,54,4,1,0.05263157894736842,0.018518518518518517
"[0, 1, 0, 0, 1, 1, 0, 0, 0, 0, 1, 1, 0, 0, 1]",487,297,190,29,14,0.09764309764309764,0.07368421052631578
"[1, 1, 1, 0, 0, 0, 1, 0, 1, 0, 1, 1, 0, 0, 1]",126,63,63,6,6,0.09523809523809523,0.09523809523809523
"[0, 0, 0, 1, 1, 0, 1, 0, 0, 0, 0, 0, 0, 1, 0]",542,397,145,39,14,0.0982367758186398,0.09655172413793103
"[0, 0, 0, 1, 1, 1, 0, 1, 0, 0, 1, 0, 0, 0, 0]",286,197,89,18,12,0.09137055837563451,0.1348314606741573
"[0, 1, 1, 0, 0, 0, 0, 1, 1, 0, 1, 0, 0, 1, 1]",232,171,61,14,6,0.08187134502923976,0.09836065573770492
"[1, 1, 0, 1, 0, 1, 1, 0, 1, 0, 1, 1, 1, 0, 0]",175,71,104,5,9,0.07042253521126761,0.08653846153846154
"[0, 1, 1, 0, 0, 1, 0, 1, 1, 1, 1, 0, 0, 0, 0]",224,128,96,9,6,0.0703125,0.0625
"[0, 0, 1, 0, 0, 0, 0, 0, 1, 0, 0, 1, 1, 1, 0]",242,144,98,8,7,0.05555555555555555,0.07142857142857142
"[0, 1, 0, 1, 1, 1, 1, 0, 1, 0, 1, 1, 0, 1, 1]",256,97,159,9,17,0.09278350515463918,0.1069182389937107
"[1, 0, 0, 1, 0, 1, 0, 0, 0, 1, 1, 1, 1, 1, 1]",307,110,197,12,20,0.10909090909090909,0.10152284263959391
"[1, 1, 1, 0, 0, 1, 0, 1, 0, 0, 0, 1, 1, 1, 1]",246,97,149,9,18,0.09278350515463918,0.12080536912751678
"[0, 1, 1, 1, 1, 0, 1, 0, 0, 1, 0, 0, 1, 1, 0]",161,69,92,6,6,0.08695652173913043,0.06521739130434782
"[1, 0, 1, 1, 1, 0, 1, 1, 1, 1, 0, 1, 0, 0, 1]",257,83,174,9,17,0.10843373493975904,0.09770114942528736
"[0, 0, 0, 1, 1, 0, 0, 1, 1, 1, 1, 0, 1, 0, 1]",277,189,88,22,15,0.1164021164021164,0.17045454545454544
"[1, 1, 0, 1, 1, 0, 1, 1, 0, 1, 1, 1, 1, 0, 0]",295,102,193,10,17,0.09803921568627451,0.08808290155440414
"[1, 0, 0, 0, 1, 1, 0, 1, 0, 1, 1, 1, 1, 1, 1]",345,123,222,14,28,0.11382113821138211,0.12612612612612611
"[1, 1, 1, 1, 1, 1, 0, 0, 0, 1, 1, 0, 1, 0, 1]",297,113,184,14,12,0.12389380530973451,0.06521739130434782
"[0, 0, 1, 1, 0, 1, 1, 1, 1, 1, 1, 0, 0, 0, 1]",184,79,105,6,6,0.0759493670886076,0.05714285714285714
"[0, 0, 1, 1, 1, 0, 0, 1, 1, 1, 1, 1, 0, 1, 1]",290,91,199,7,29,0.07692307692307693,0.1457286432160804
"[1, 1, 0, 1, 1, 1, 1, 0, 1, 0, 0, 0, 1, 1, 1]",310,114,196,13,25,0.11403508771929824,0.12755102040816327
"[0, 0, 1, 1, 1, 1, 1, 1, 1, 1, 0, 1, 0, 0, 1]",395,151,244,16,14,0.10596026490066225,0.05737704918032787
"[0, 1, 1, 1, 1, 0, 1, 0, 0, 0, 0, 1, 1, 0, 0]",223,118,105,14,4,0.11864406779661017,0.0380952380952381
"[1, 1, 1, 1, 0, 1, 1, 1, 1, 0, 1, 0, 0, 0, 0]",190,72,118,6,17,0.08333333333333333,0.1440677966101695
"[0, 0, 0, 0, 1, 0, 1, 0, 0, 0, 1, 1, 0, 1, 1]",190,119,71,13,6,0.1092436974789916,0.08450704225352113
"[1, 0, 0, 1, 1, 0, 1, 0, 1, 1, 1, 0, 0, 0, 0]",174,74,100,6,13,0.08108108108108109,0.13
"[1, 1, 0, 0, 1, 1, 0, 1, 0, 1, 1, 1, 0, 0, 0]",175,82,93,7,6,0.08536585365853659,0.06451612903225806
"[0, 1, 1, 1, 1, 1, 0, 1, 1, 1, 0, 0, 1, 1, 0]",331,126,205,8,20,0.06349206349206349,0.0975609756097561
"[0, 1, 1, 0, 1, 1, 0, 1, 0, 0, 0, 1, 1, 1, 0]",111,56,55,4,6,0.07142857142857142,0.10909090909090909
"[0, 1, 1, 0, 1, 0, 1, 1, 1, 0, 1, 1, 0, 1, 0]",151,63,88,9,5,0.14285714285714285,0.056818181818181816
"[1, 1, 1, 0, 1, 1, 0, 1, 0, 1, 1, 1, 0, 1, 1]",523,135,388,11,37,0.08148148148148149,0.09536082474226804
"[1, 1, 0, 1, 1, 0, 0, 0, 0, 0, 0, 0, 1, 0, 1]",138,73,65,5,7,0.0684931506849315,0.1076923076923077
"[0, 0, 0, 0, 1, 1, 1, 1, 0, 1, 1, 0, 0, 0, 0]",279,164,115,22,12,0.13414634146341464,0.10434782608695652
"[1, 0, 1, 1, 0, 1, 0, 1, 0, 1, 1, 1, 0, 0, 1]",159,63,96,6,14,0.09523809523809523,0.14583333333333334
"[1, 1, 0, 1, 0, 0, 0, 1, 0, 0, 0, 0, 0, 1, 1]",211,122,89,15,6,0.12295081967213115,0.06741573033707865
"[0, 1, 0, 0, 1, 1, 1, 0, 1, 0, 0, 0, 1, 0, 0]",125,75,50,12,2,0.16,0.04
"[1, 0, 0, 1, 1, 0, 1, 1, 1, 1, 1, 1, 0, 1, 1]",606,163,443,19,43,0.1165644171779141,0.09706546275395034
"[0, 0, 1, 1, 1, 0, 0, 0, 1, 0, 0, 1, 0, 0, 1]",158,91,67,6,6,0.06593406593406594,0.08955223880597014
"[0, 1, 0, 0, 1, 1, 0, 1, 0, 1, 1, 0, 0, 1, 0]",96,54,42,9,4,0.16666666666666666,0.09523809523809523
"[1, 1, 1, 1, 0, 1, 0, 0, 1, 1, 0, 1, 0, 1, 1]",208,82,126,10,7,0.12195121951219512,0.05555555555555555
"[1, 1, 1, 1, 0, 1, 0, 1, 1, 1, 1, 1, 0, 0, 1]",760,194,566,19,40,0.0979381443298969,0.0706713780918728
"[0, 0, 1, 1, 1, 1, 0, 0, 0, 0, 1, 1, 1, 0, 1]",387,173,214,20,27,0.11560693641618497,0.1261682242990654
"[0, 0, 0, 0, 1, 0, 0, 1, 0, 1, 0, 0, 0, 0, 1]",549,375,174,32,20,0.08533333333333333,0.11494252873563218
"[0, 1, 0, 1, 1, 1, 0, 0, 1, 1, 0, 1, 0, 1, 0]",105,40,65,3,6,0.075,0.09230769230769231
"[1, 1, 1, 0, 1, 1, 1, 1, 1, 0, 0, 1, 0, 1, 0]",230,84,146,6,15,0.07142857142857142,0.10273972602739725
"[0, 1, 0, 1, 1, 0, 0, 1, 0, 1, 0, 1, 1, 1, 0]",85,42,43,2,4,0.047619047619047616,0.09302325581395349
"[1, 0, 0, 0, 0, 1, 0, 1, 0, 1, 0, 0, 0, 1, 1]",185,99,86,12,7,0.12121212121212122,0.08139534883720931
"[0, 0, 0, 1, 0, 0, 0, 0, 0, 0, 0, 1, 1, 0, 1]",587,415,172,37,25,0.0891566265060241,0.14534883720930233
"[0, 0, 1, 1, 1, 0, 1, 0, 1, 0, 0, 1, 1, 1, 1]",217,86,131,8,15,0.09302325581395349,0.11450381679389313
"[1, 1, 0, 0, 1, 0, 0, 1, 0, 1, 1, 1, 0, 0, 1]",130,61,69,5,6,0.08196721311475409,0.08695652173913043
"[1, 1, 1, 1, 1, 0, 1, 0, 0, 1, 0, 0, 0, 0, 0]",152,78,74,5,5,0.0641025641025641,0.06756756756756757
"[1, 0, 1, 1, 0, 1, 0, 1, 0, 0, 0, 0, 0, 0, 1]",150,86,64,10,6,0.11627906976744186,0.09375
"[0, 0, 0, 0, 0, 0, 1, 0, 1, 0, 0, 1, 1, 1, 0]",278,186,92,16,7,0.08602150537634409,0.07608695652173914
"[1, 0, 0, 1, 1, 0, 0, 1, 0, 0, 1, 0, 1, 1, 0]",120,59,61,9,3,0.15254237288135594,0.04918032786885246
"[0, 0, 1, 1, 0, 1, 0, 1, 0, 0, 1, 1, 0, 0, 1]",174,101,73,11,6,0.10891089108910891,0.0821917808219178
"[0, 0, 1, 0, 0, 0, 1, 1, 0, 1, 0, 1, 0, 0, 1]",158,102,56,5,5,0.049019607843137254,0.08928571428571429
"[0, 0, 0, 1, 0, 1, 1, 1, 1, 1, 0, 0, 1, 1, 0]",190,109,81,10,8,0.09174311926605505,0.09876543209876543
"[1, 1, 0, 0, 0, 1, 1, 0, 0, 0, 1, 1, 0, 0, 1]",176,100,76,11,9,0.11,0.11842105263157894
"[0, 0, 0, 0, 1, 1, 0, 0, 1, 1, 0, 0, 0, 1, 1]",609,424,185,42,17,0.09905660377358491,0.0918918918918919
"[0, 1, 0, 0, 0, 0, 0, 1, 0, 0, 1, 1, 1, 1, 1]",196,98,98,12,16,0.12244897959183673,0.16326530612244897
"[0, 1, 1, 0, 0, 1, 0, 0, 0, 1, 1, 1, 0, 1, 0]",107,60,47,8,1,0.13333333333333333,0.02127659574468085
"[0, 0, 1, 0, 0, 0, 1, 1, 0, 1, 0, 1, 1, 1, 0]",99,56,43,6,3,0.10714285714285714,0.06976744186046512
"[0, 1, 0, 0, 0, 0, 1, 0, 1, 0, 0, 1, 0, 0, 0]",454,324,130,47,6,0.14506172839506173,0.046153846153846156
"[1, 0, 1, 0, 1, 1, 0, 1, 0, 1, 0, 1, 0, 0, 1]",108,49,59,9,6,0.1836734693877551,0.1016949152542373
"[1, 0, 1, 1, 0, 1, 1, 0, 0, 1, 1, 0, 0, 0, 0]",274,119,155,12,15,0.10084033613445378,0.0967741935483871
"[0, 1, 0, 1, 0, 1, 1, 0, 1, 0, 0, 0, 1, 1, 1]",131,65,66,6,7,0.09230769230769231,0.10606060606060606
"[1, 1, 0, 1, 1, 0, 0, 1, 0, 1, 0, 1, 1, 0, 1]",128,53,75,6,9,0.11320754716981132,0.12
"[0, 1, 0, 1, 0, 0, 1, 1, 0, 1, 1, 0, 0, 1, 0]",121,53,68,4,5,0.07547169811320754,0.07352941176470588
"[0, 0, 0, 0, 1, 1, 1, 0, 1, 1, 1, 0, 0, 1, 1]",206,99,107,8,10,0.08080808080808081,0.09345794392523364
"[0, 0, 0, 0, 0, 0, 1, 1, 1, 0, 1, 1, 1, 0, 0]",244,149,95,15,10,0.10067114093959731,0.10526315789473684
"[1, 0, 1, 1, 1, 0, 1, 1, 1, 1, 1, 0, 0, 1, 1]",810,235,575,20,55,0.0851063829787234,0.09565217391304348
"[0, 0, 1, 0, 1, 1, 1, 1, 1, 0, 1, 1, 0, 0, 0]",117,64,53,6,5,0.09375,0.09433962264150944
"[0, 0, 0, 0, 1, 1, 1, 0, 1, 1, 1, 0, 1, 1, 1]",233,110,123,6,12,0.05454545454545454,0.0975609756097561
"[1, 1, 0, 0, 1, 0, 0, 1, 1, 1, 0, 0, 1, 1, 0]",151,81,70,10,4,0.12345679012345678,0.05714285714285714
"[0, 0, 0, 0, 0, 1, 0, 1, 0, 1, 0, 1, 0, 0, 1]",243,161,82,14,7,0.08695652173913043,0.08536585365853659
"[1, 0, 1, 0, 1, 0, 1, 0, 1, 1, 0, 1, 1, 0, 0]",110,60,50,4,6,0.06666666666666667,0.12
"[0, 0, 0, 1, 1, 1, 0, 0, 1, 1, 0, 1, 1, 0, 1]",123,62,61,8,6,0.12903225806451613,0.09836065573770492
"[1, 0, 1, 1, 0, 0, 1, 0, 1, 1, 1, 0, 0, 0, 1]",122,61,61,6,9,0.09836065573770492,0.14754098360655737
"[1, 1, 0, 0, 1, 1, 1, 1, 0, 1, 0, 1, 1, 1, 0]",324,110,214,5,19,0.045454545454545456,0.08878504672897196
"[0, 1, 1, 1, 0, 1, 0, 0, 1, 1, 1, 0, 1, 1, 0]",127,55,72,4,8,0.07272727272727272,0.1111111111111111
"[0, 1, 0, 0, 1, 1, 1, 0, 0, 0, 0, 1, 0, 1, 1]",126,71,55,5,2,0.07042253521126761,0.03636363636363636
"[0, 0, 1, 0, 0, 0, 1, 0, 0, 0, 1, 1, 1, 0, 1]",142,90,52,5,5,0.05555555555555555,0.09615384615384616
"[1, 0, 0, 1, 0, 0, 1, 0, 0, 0, 1, 0, 0, 0, 1]",227,159,68,16,8,0.10062893081761007,0.11764705882352941
"[0, 0, 0, 0, 0, 1, 0, 0, 1, 0, 0, 1, 1, 1, 1]",337,232,105,21,11,0.09051724137931035,0.10476190476190476
"[0, 1, 1, 1, 1, 1, 0, 1, 0, 1, 0, 1, 1, 0, 0]",148,61,87,5,7,0.08196721311475409,0.08045977011494253
"[1, 0, 0, 1, 1, 1, 0, 0, 1, 1, 1, 0, 0, 0, 1]",141,61,80,6,5,0.09836065573770492,0.0625
"[1, 1, 1, 0, 0, 1, 1, 0, 1, 0, 0, 1, 1, 1, 1]",413,121,292,12,31,0.09917355371900827,0.10616438356164383
"[0, 0, 1, 1, 0, 1, 1, 0, 1, 1, 1, 0, 0, 1, 1]",201,76,125,12,17,0.15789473684210525,0.136
"[1, 0, 0, 1, 1, 0, 1, 1, 0, 1, 1, 1, 0, 0, 1]",182,69,113,8,13,0.11594202898550725,0.11504424778761062
"[0, 0, 1, 0, 0, 1, 1, 0, 1, 1, 1, 0, 1, 1, 1]",156,64,92,4,11,0.0625,0.11956521739130435
"[1, 0, 0, 0, 0, 1, 0, 0, 0, 1, 1, 0, 1, 0, 1]",132,74,58,10,6,0.13513513513513514,0.10344827586206896
"[1, 1, 0, 1, 1, 0, 0, 1, 0, 0, 0, 0, 0, 1, 1]",143,64,79,5,10,0.078125,0.12658227848101267
"[1, 1, 0, 0, 0, 0, 0, 0, 0, 1, 0, 1, 0, 1, 0]",280,173,107,17,4,0.09826589595375723,0.037383177570093455
"[1, 1, 0, 0, 0, 0, 1, 0, 1, 0, 0, 0, 0, 0, 1]",316,202,114,11,13,0.054455445544554455,0.11403508771929824
"[1, 1, 1, 1, 1, 1, 1, 1, 0, 1, 0, 1, 0, 0, 1]",709,205,504,26,52,0.12682926829268293,0.10317460317460317
"[0, 1, 0, 0, 0, 0, 1, 0, 0, 1, 1, 0, 0, 0, 0]",784,538,246,49,22,0.09107806691449814,0.08943089430894309
"[0, 0, 0, 1, 1, 1, 1, 1, 1, 0, 1, 1, 0, 1, 1]",340,183,157,18,23,0.09836065573770492,0.1464968152866242
"[0, 0, 0, 1, 0, 0, 1, 0, 0, 1, 0, 1, 1, 0, 0]",262,174,88,14,7,0.08045977011494253,0.07954545454545454
"[0, 1, 0, 1, 1, 1, 0, 0, 1, 1, 0, 0, 1, 1, 1]",379,166,213,16,16,0.0963855421686747,0.07511737089201878
"[0, 0, 1, 1, 0, 0, 1, 0, 0, 1, 1, 1, 1, 1, 1]",394,189,205,24,20,0.12698412698412698,0.0975609756097561
"[1, 0, 1, 1, 1, 1, 1, 0, 1, 1, 0, 0, 1, 0, 0]",159,65,94,8,9,0.12307692307692308,0.09574468085106383
"[0, 0, 0, 1, 1, 0, 1, 1, 1, 1, 1, 0, 1, 1, 0]",148,63,85,7,3,0.1111111111111111,0.03529411764705882
"[0, 1, 0, 0, 0, 1, 1, 0, 1, 1, 1, 1, 1, 0, 1]",153,68,85,9,13,0.1323529411764706,0.15294117647058825
"[1, 0, 1, 0, 0, 0, 1, 1, 0, 1, 1, 1, 1, 1, 0]",155,65,90,6,12,0.09230769230769231,0.13333333333333333
"[1, 0, 0, 0, 0, 1, 1, 0, 0, 0, 0, 0, 0, 1, 0]",953,421,532,40,60,0.09501187648456057,0.11278195488721804
"[1, 1, 1, 1, 0, 0, 0, 0, 0, 0, 0, 1, 0, 0, 1]",325,190,135,8,16,0.042105263157894736,0.11851851851851852
"[0, 0, 1, 1, 0, 1, 1, 1, 0, 1, 0, 0, 0, 0, 1]",124,72,52,5,6,0.06944444444444445,0.11538461538461539
"[1, 0, 1, 1, 0, 1, 0, 1, 1, 0, 0, 1, 1, 1, 1]",361,131,230,9,22,0.06870229007633588,0.09565217391304348
"[1, 0, 0, 0, 1, 0, 1, 0, 1, 1, 0, 1, 1, 0, 1]",132,52,80,3,9,0.057692307692307696,0.1125
"[1, 1, 1, 1, 0, 0, 1, 0, 0, 1, 0, 0, 0, 1, 0]",127,64,63,6,5,0.09375,0.07936507936507936
"[1, 0, 1, 1, 1, 0, 0, 1, 0, 1, 0, 1, 1, 0, 1]",135,64,71,8,5,0.125,0.07042253521126761
"[0, 0, 0, 0, 1, 1, 1, 0, 1, 0, 1, 1, 1, 0, 0]",144,80,64,10,3,0.125,0.046875
"[1, 1, 1, 0, 0, 0, 0, 1, 1, 1, 0, 1, 0, 1, 1]",269,83,186,10,19,0.12048192771084337,0.10215053763440861
"[1, 0, 1, 1, 1, 1, 0, 0, 0, 1, 1, 1, 0, 0, 1]",149,57,92,9,7,0.15789473684210525,0.07608695652173914
"[0, 0, 0, 1, 0, 0, 1, 0, 1, 1, 0, 0, 1, 0, 1]",131,84,47,8,3,0.09523809523809523,0.06382978723404255
"[1, 0, 1, 1, 0, 0, 1, 1, 0, 0, 0, 0, 1, 0, 0]",176,107,69,10,10,0.09345794392523364,0.14492753623188406
"[0, 0, 1, 0, 0, 0, 1, 0, 1, 1, 0, 1, 0, 1, 1]",106,53,53,2,4,0.03773584905660377,0.07547169811320754
"[0, 0, 1, 0, 0, 0, 1, 1, 1, 1, 0, 0, 0, 1, 0]",145,89,56,14,7,0.15730337078651685,0.125
"[1, 0, 1, 0, 0, 1, 0, 0, 0, 1, 1, 1, 1, 0, 0]",199,102,97,5,11,0.049019607843137254,0.1134020618556701
"[0, 0, 1, 0, 1, 0, 0, 1, 0, 0, 0, 1, 1, 1, 1]",171,106,65,9,7,0.08490566037735849,0.1076923076923077
"[1, 0, 0, 0, 0, 0, 0, 0, 1, 1, 0, 1, 1, 0, 0]",321,194,127,17,11,0.08762886597938144,0.08661417322834646
"[0, 0, 0, 1, 0, 0, 0, 1, 1, 1, 1, 0, 1, 1, 1]",146,81,65,7,4,0.08641975308641975,0.06153846153846154
"[1, 0, 0, 0, 1, 1, 1, 0, 1, 0, 0, 1, 0, 0, 0]",140,80,60,8,2,0.1,0.03333333333333333
"[1, 1, 1, 0, 0, 0, 1, 1, 1, 0, 1, 0, 0, 1, 0]",135,66,69,6,6,0.09090909090909091,0.08695652173913043
"[1, 1, 1, 1, 1, 1, 0, 0, 0, 1, 1, 1, 0, 1, 0]",285,110,175,8,16,0.07272727272727272,0.09142857142857143
"[0, 0, 1, 1, 1, 0, 0, 0, 0, 1, 1, 0, 1, 0, 1]",148,77,71,8,8,0.1038961038961039,0.11267605633802817
"[0, 0, 0, 1, 1, 1, 0, 0, 0, 0, 1, 1, 1, 0, 1]",154,92,62,9,5,0.09782608695652174,0.08064516129032258
"[0, 0, 1, 0, 1, 1, 1, 0, 0, 0, 0, 0, 0, 1, 1]",382,226,156,17,20,0.0752212389380531,0.1282051282051282
"[1, 0, 0, 0, 1, 1, 1, 1, 0, 1, 0, 1, 0, 1, 1]",168,70,98,11,10,0.15714285714285714,0.10204081632653061
"[1, 0, 0, 1, 1, 0, 0, 1, 0, 0, 0, 0, 0, 0, 0]",789,483,306,42,36,0.08695652173913043,0.11764705882352941
"[1, 1, 0, 1, 0, 1, 0, 0, 0, 0, 1, 0, 1, 0, 0]",153,85,68,7,4,0.08235294117647059,0.058823529411764705
"[0, 0, 1, 1, 0, 1, 0, 1, 0, 0, 0, 0, 1, 0, 1]",146,90,56,10,7,0.1111111111111111,0.125
"[1, 1, 1, 1, 1, 0, 0, 1, 0, 1, 0, 1, 0, 1, 1]",291,93,198,10,21,0.10752688172043011,0.10606060606060606
"[1, 0, 0, 1, 1, 1, 1, 1, 0, 0, 0, 0, 0, 0, 1]",353,147,206,17,12,0.11564625850340136,0.05825242718446602
"[0, 1, 0, 1, 0, 1, 0, 1, 0, 0, 1, 1, 0, 1, 1]",114,56,58,9,5,0.16071428571428573,0.08620689655172414
"[0, 0, 1, 1, 1, 1, 0, 0, 1, 1, 1, 0, 1, 0, 0]",214,101,113,8,13,0.07920792079207921,0.11504424778761062
"[1, 0, 1, 0, 0, 0, 0, 0, 0, 1, 1, 1, 0, 1, 0]",166,91,75,12,5,0.13186813186813187,0.06666666666666667
"[1, 0, 1, 1, 0, 1, 0, 0, 0, 0, 0, 0, 1, 1, 1]",229,110,119,9,10,0.08181818181818182,0.08403361344537816
"[0, 0, 0, 0, 1, 0, 1, 1, 1, 1, 1, 0, 0, 0, 0]",312,201,111,16,6,0.07960199004975124,0.05405405405405406
"[0, 0, 0, 1, 0, 1, 0, 1, 0, 0, 1, 1, 1, 1, 1]",205,105,100,11,9,0.10476190476190476,0.09
"[0, 0, 1, 1, 0, 0, 1, 0, 0, 0, 1, 0, 1, 0, 1]",115,69,46,5,3,0.07246376811594203,0.06521739130434782
"[0, 1, 0, 0, 1, 0, 0, 0, 0, 1, 0, 0, 0, 0, 1]",558,393,165,40,14,0.10178117048346055,0.08484848484848485
"[1, 0, 0, 1, 1, 1, 1, 0, 1, 0, 1, 0, 0, 1, 1]",219,66,153,7,15,0.10606060606060606,0.09803921568627451
"[0, 1, 0, 1, 0, 0, 1, 0, 0, 0, 0, 0, 1, 1, 0]",290,179,111,19,10,0.10614525139664804,0.09009009009009009
"[1, 0, 1, 0, 0, 1, 1, 0, 1, 1, 0, 0, 1, 1, 0]",129,58,71,6,5,0.10344827586206896,0.07042253521126761
"[0, 1, 0, 1, 0, 0, 1, 1, 0, 1, 1, 0, 0, 1, 1]",147,74,73,3,10,0.04054054054054054,0.136986301369863
"[0, 0, 1, 0, 1, 0, 0, 1, 1, 0, 1, 1, 0, 0, 1]",125,71,54,7,5,0.09859154929577464,0.09259259259259259
"[0, 1, 1, 1, 0, 1, 0, 0, 0, 1, 0, 1, 0, 0, 1]",95,53,42,5,1,0.09433962264150944,0.023809523809523808
"[0, 0, 0, 1, 1, 1, 1, 1, 1, 0, 1, 0, 1, 0, 0]",186,113,73,8,10,0.07079646017699115,0.136986301369863
"[1, 0, 0, 1, 1, 0, 0, 1, 1, 1, 1, 1, 0, 0, 1]",364,86,278,14,26,0.16279069767441862,0.09352517985611511
"[1, 0, 1, 0, 0, 0, 0, 0, 1, 1, 1, 1, 1, 1, 1]",432,178,254,15,23,0.08426966292134831,0.09055118110236221
"[0, 0, 1, 0, 1, 1, 0, 0, 0, 1, 1, 1, 0, 1, 0]",96,50,46,2,7,0.04,0.15217391304347827
"[1, 1, 0, 0, 1, 0, 0, 1, 1, 0, 0, 0, 1, 1, 0]",140,81,59,10,3,0.12345679012345678,0.05084745762711865
"[1, 1, 0, 1, 1, 1, 0, 0, 0, 0, 0, 0, 0, 0, 0]",521,290,231,28,18,0.09655172413793103,0.07792207792207792
"[0, 1, 1, 1, 1, 1, 0, 0, 0, 1, 1, 0, 0, 0, 0]",234,131,103,16,12,0.12213740458015267,0.11650485436893204
"[1, 0, 0, 1, 0, 1, 0, 1, 1, 1, 0, 1, 1, 1, 1]",278,107,171,8,13,0.07476635514018691,0.07602339181286549
"[0, 1, 1, 0, 1, 0, 1, 1, 0, 0, 0, 0, 0, 0, 1]",231,141,90,15,4,0.10638297872340426,0.044444444444444446
"[1, 0, 1, 1, 0, 0, 0, 0, 0, 1, 0, 1, 0, 1, 1]",115,60,55,6,6,0.1,0.10909090909090909
"[1, 1, 1, 0, 0, 0, 1, 1, 1, 1, 1, 0, 0, 1, 0]",171,62,109,9,16,0.14516129032258066,0.14678899082568808
"[1, 1, 1, 1, 0, 1, 1, 1, 1, 1, 0, 1, 0, 1, 0]",481,143,338,18,32,0.1258741258741259,0.09467455621301775
"[0, 0, 1, 0, 1, 1, 1, 0, 0, 1, 0, 0, 0, 0, 0]",309,202,107,14,11,0.06930693069306931,0.102803738317757
"[0, 0, 0, 1, 1, 0, 0, 1, 0, 1, 1, 0, 0, 1, 0]",172,114,58,11,6,0.09649122807017543,0.10344827586206896
"[0, 0, 0, 1, 0, 0, 0, 1, 1, 0, 1, 0, 1, 0, 1]",136,82,54,12,2,0.14634146341463414,0.037037037037037035
"[1, 1, 0, 0, 0, 0, 0, 1, 0, 0, 0, 1, 1, 0, 1]",170,92,78,10,10,0.10869565217391304,0.1282051282051282
"[1, 1, 0, 1, 0, 0, 0, 0, 1, 0, 0, 1, 1, 0, 1]",104,59,45,6,8,0.1016949152542373,0.17777777777777778
"[0, 0, 0, 1, 0, 0, 0, 1, 0, 0, 0, 1, 0, 1, 1]",290,186,104,18,3,0.0967741935483871,0.028846153846153848
"[0, 0, 0, 1, 1, 1, 0, 0, 1, 0, 0, 0, 0, 1, 0]",242,157,85,18,8,0.11464968152866242,0.09411764705882353
"[0, 1, 1, 0, 1, 1, 1, 0, 0, 1, 0, 1, 1, 1, 0]",146,58,88,7,9,0.1206896551724138,0.10227272727272728
"[0, 1, 0, 0, 0, 0, 1, 0, 0, 0, 1, 1, 0, 1, 0]",221,135,86,13,5,0.0962962962962963,0.05813953488372093
"[1, 1, 0, 0, 0, 1, 1, 1, 1, 1, 1, 1, 1, 0, 0]",765,272,493,26,45,0.09558823529411764,0.09127789046653144
"[1, 0, 0, 0, 0, 1, 0, 0, 1, 1, 1, 1, 1, 1, 0]",209,103,106,11,11,0.10679611650485436,0.10377358490566038
"[1, 1, 1, 1, 0, 0, 0, 0, 0, 1, 1, 0, 0, 0, 1]",227,124,103,10,10,0.08064516129032258,0.0970873786407767
"[1, 0, 1, 0, 1, 1, 1, 0, 1, 1, 1, 1, 1, 1, 0]",565,160,405,20,36,0.125,0.08888888888888889
"[0, 1, 1, 0, 0, 1, 0, 0, 0, 1, 1, 0, 0, 0, 0]",386,259,127,23,15,0.0888030888030888,0.11811023622047244
"[0, 0, 0, 0, 1, 0, 0, 0, 1, 0, 1, 0, 0, 1, 0]",482,340,142,33,9,0.09705882352941177,0.06338028169014084
"[1, 0, 1, 0, 0, 1, 1, 1, 0, 1, 0, 1, 1, 1, 1]",280,95,185,7,19,0.07368421052631578,0.10270270270270271
"[1, 1, 0, 1, 1, 0, 0, 0, 0, 1, 1, 0, 0, 0, 0]",432,218,214,22,17,0.10091743119266056,0.0794392523364486
"[0, 0, 0, 0, 1, 0, 1, 1, 1, 0, 0, 0, 1, 0, 1]",157,100,57,9,3,0.09,0.05263157894736842
"[0, 1, 1, 0, 0, 0, 1, 0, 1, 0, 1, 0, 0, 1, 0]",154,92,62,5,4,0.05434782608695652,0.06451612903225806
"[1, 1, 0, 0, 1, 0, 0, 0, 0, 0, 1, 0, 1, 1, 0]",151,93,58,4,7,0.043010752688172046,0.1206896551724138
"[0, 0, 1, 1, 0, 0, 1, 0, 1, 0, 0, 1, 0, 0, 0]",241,158,83,14,5,0.08860759493670886,0.060240963855421686
"[1, 1, 1, 1, 1, 0, 0, 0, 1, 0, 1, 0, 1, 1, 0]",158,58,100,7,10,0.1206896551724138,0.1
"[0, 1, 1, 1, 1, 1, 0, 0, 0, 1, 0, 1, 0, 1, 1]",156,77,79,11,7,0.14285714285714285,0.08860759493670886
"[0, 0, 0, 1, 0, 0, 1, 1, 0, 1, 0, 1, 0, 1, 1]",112,63,49,5,5,0.07936507936507936,0.10204081632653061
"[0, 0, 0, 1, 0, 1, 1, 0, 1, 1, 1, 1, 0, 0, 1]",165,93,72,6,4,0.06451612903225806,0.05555555555555555
"[1, 1, 0, 0, 0, 1, 1, 1, 1, 1, 0, 1, 0, 0, 1]",158,67,91,4,18,0.05970149253731343,0.1978021978021978
"[1, 1, 0, 0, 0, 0, 1, 0, 1, 1, 0, 1, 0, 0, 0]",157,89,68,8,4,0.0898876404494382,0.058823529411764705
"[0, 1, 1, 0, 0, 0, 0, 1, 0, 1, 1, 0, 1, 0, 0]",143,90,53,9,11,0.1,0.20754716981132076
"[0, 0, 0, 1, 0, 1, 1, 1, 1, 1, 0, 0, 1, 1, 1]",305,138,167,12,16,0.08695652173913043,0.09580838323353294
"[0, 0, 0, 1, 0, 0, 0, 1, 0, 1, 0, 0, 1, 1, 1]",222,147,75,12,11,0.08163265306122448,0.14666666666666667
"[1, 1, 0, 0, 0, 0, 1, 0, 1, 1, 1, 0, 1, 0, 0]",115,68,47,3,3,0.04411764705882353,0.06382978723404255
"[0, 1, 1, 1, 0, 0, 1, 1, 0, 0, 1, 0, 1, 0, 1]",119,57,62,7,6,0.12280701754385964,0.0967741935483871
"[1, 1, 0, 1, 1, 0, 0, 1, 1, 1, 0, 0, 1, 0, 0]",131,51,80,2,10,0.0392156862745098,0.125
"[0, 1, 1, 0, 1, 1, 0, 0, 1, 1, 0, 0, 1, 1, 1]",368,168,200,23,16,0.13690476190476192,0.08
"[0, 0, 1, 0, 1, 1, 1, 1, 1, 0, 1, 1, 1, 0, 1]",225,77,148,9,20,0.11688311688311688,0.13513513513513514
"[1, 0, 1, 1, 0, 1, 1, 0, 1, 1, 0, 1, 1, 0, 0]",172,67,105,7,10,0.1044776119402985,0.09523809523809523
"[0, 1, 1, 0, 0, 1, 0, 1, 1, 0, 1, 1, 0, 1, 1]",149,82,67,7,6,0.08536585365853659,0.08955223880597014
"[1, 1, 1, 0, 1, 0, 1, 1, 1, 1, 0, 0, 1, 1, 1]",927,269,658,19,68,0.07063197026022305,0.1033434650455927
"[0, 1, 1, 1, 0, 0, 0, 1, 1, 0, 0, 0, 1, 0, 1]",119,68,51,7,3,0.10294117647058823,0.058823529411764705
"[0, 1, 0, 1, 0, 0, 0, 0, 0, 1, 1, 1, 1, 0, 1]",132,80,52,9,3,0.1125,0.057692307692307696
"[0, 1, 1, 0, 1, 1, 0, 1, 1, 0, 1, 0, 0, 1, 1]",167,71,96,3,5,0.04225352112676056,0.052083333333333336
"[1, 1, 0, 0, 1, 1, 1, 1, 0, 1, 1, 1, 1, 1, 0]",662,212,450,23,43,0.10849056603773585,0.09555555555555556
"[1, 1, 0, 1, 1, 1, 0, 1, 1, 0, 1, 0, 1, 0, 0]",125,56,69,4,3,0.07142857142857142,0.043478260869565216
"[0, 1, 1, 0, 0, 0, 1, 0, 0, 0, 0, 0, 0, 1, 1]",460,322,138,28,9,0.08695652173913043,0.06521739130434782
"[1, 1, 0, 1, 0, 1, 1, 0, 1, 1, 1, 0, 0, 0, 0]",171,75,96,12,8,0.16,0.08333333333333333
"[0, 1, 1, 1, 1, 1, 1, 0, 1, 0, 1, 0, 1, 1, 0]",251,87,164,8,22,0.09195402298850575,0.13414634146341464
"[1, 1, 1, 1, 1, 0, 1, 0, 0, 0, 0, 1, 0, 1, 0]",123,59,64,4,4,0.06779661016949153,0.0625
"[0, 0, 1, 1, 1, 1, 0, 0, 1, 1, 1, 0, 0, 0, 1]",202,93,109,12,8,0.12903225806451613,0.07339449541284404
"[1, 1, 1, 0, 0, 1, 1, 0, 0, 0, 1, 1, 1, 1, 0]",257,84,173,7,16,0.08333333333333333,0.09248554913294797
"[1, 1, 1, 0, 0, 1, 0, 1, 0, 0, 0, 1, 0, 1, 1]",138,56,82,3,8,0.05357142857142857,0.0975609756097561
"[0, 0, 0, 1, 0, 1, 1, 0, 0, 1, 0, 0, 1, 0, 0]",226,149,77,20,5,0.1342281879194631,0.06493506493506493
"[0, 0, 1, 1, 1, 0, 0, 1, 0, 0, 0, 1, 1, 1, 1]",199,92,107,11,7,0.11956521739130435,0.06542056074766354
"[1, 0, 0, 1, 1, 1, 1, 1, 0, 1, 1, 1, 1, 0, 0]",359,106,253,13,20,0.12264150943396226,0.07905138339920949
"[1, 1, 0, 1, 1, 0, 0, 1, 1, 1, 1, 1, 0, 1, 1]",607,175,432,14,35,0.08,0.08101851851851852
"[1, 0, 1, 0, 1, 0, 0, 0, 1, 1, 1, 1, 1, 0, 0]",163,72,91,8,5,0.1111111111111111,0.054945054945054944
"[0, 0, 0, 0, 0, 1, 0, 0, 1, 1, 1, 1, 1, 1, 1]",395,236,159,15,13,0.0635593220338983,0.08176100628930817
"[0, 1, 1, 1, 0, 0, 0, 1, 0, 1, 0, 0, 0, 0, 0]",304,195,109,20,12,0.10256410256410256,0.11009174311926606
"[0, 1, 1, 0, 1, 0, 0, 0, 1, 1, 0, 0, 0, 0, 1]",252,157,95,10,11,0.06369426751592357,0.11578947368421053
"[1, 1, 0, 0, 1, 1, 1, 1, 0, 0, 1, 1, 0, 1, 0]",335,139,196,14,21,0.10071942446043165,0.10714285714285714
"[0, 1, 1, 1, 1, 0, 1, 1, 0, 0, 0, 0, 0, 1, 1]",195,103,92,12,6,0.11650485436893204,0.06521739130434782
"[1, 1, 1, 1, 1, 0, 0, 1, 1, 0, 1, 1, 0, 0, 1]",382,116,266,11,23,0.09482758620689655,0.08646616541353383
"[1, 1, 1, 0, 0, 1, 1, 0, 0, 0, 0, 1, 0, 0, 1]",279,89,190,8,22,0.0898876404494382,0.11578947368421053
"[0, 0, 0, 1, 0, 1, 1, 1, 0, 1, 1, 1, 1, 0, 0]",153,77,76,3,10,0.03896103896103896,0.13157894736842105
"[0, 1, 1, 1, 0, 0, 1, 0, 1, 1, 0, 0, 0, 1, 0]",93,42,51,6,4,0.14285714285714285,0.0784313725490196
"[1, 1, 1, 0, 1, 0, 0, 1, 1, 1, 0, 0, 1, 0, 1]",128,55,73,6,7,0.10909090909090909,0.0958904109589041
"[0, 1, 0, 1, 1, 1, 0, 1, 0, 1, 0, 1, 1, 0, 0]",118,56,62,4,5,0.07142857142857142,0.08064516129032258
"[0, 0, 0, 0, 1, 1, 0, 0, 1, 1, 1, 1, 0, 1, 1]",443,211,232,21,17,0.0995260663507109,0.07327586206896551
"[1, 1, 1, 1, 0, 0, 1, 1, 1, 1, 0, 1, 0, 1, 0]",361,131,230,11,29,0.08396946564885496,0.12608695652173912
"[0, 0, 1, 0, 0, 0, 1, 1, 0, 0, 0, 1, 0, 0, 0]",576,425,151,33,16,0.07764705882352942,0.10596026490066225
"[1, 0, 0, 1, 0, 1, 1, 1, 0, 1, 1, 1, 0, 0, 1]",162,62,100,5,13,0.08064516129032258,0.13
"[0, 0, 1, 0, 1, 0, 0, 1, 1, 1, 0, 0, 0, 0, 0]",331,224,107,23,13,0.10267857142857142,0.12149532710280374
"[1, 0, 1, 0, 0, 0, 0, 0, 0, 1, 0, 1, 0, 0, 1]",243,140,103,10,8,0.07142857142857142,0.07766990291262135
"[0, 1, 1, 0, 0, 1, 1, 1, 0, 0, 1, 1, 0, 1, 1]",175,88,87,7,8,0.07954545454545454,0.09195402298850575
"[1, 1, 0, 0, 0, 1, 1, 0, 1, 1, 0, 1, 1, 1, 1]",316,111,205,8,15,0.07207207207207207,0.07317073170731707
"[0, 0, 1, 0, 1, 0, 0, 0, 1, 1, 0, 0, 0, 1, 0]",218,137,81,13,12,0.0948905109489051,0.14814814814814814
"[0, 1, 1, 0, 1, 0, 0, 1, 0, 1, 0, 1, 1, 1, 0]",119,57,62,5,4,0.08771929824561403,0.06451612903225806
"[1, 0, 1, 0, 0, 0, 1, 1, 0, 1, 0, 0, 1, 0, 1]",100,52,48,3,4,0.057692307692307696,0.08333333333333333
"[1, 0, 1, 0, 0, 0, 0, 1, 0, 0, 1, 0, 0, 1, 0]",227,139,88,13,11,0.09352517985611511,0.125
"[1, 0, 1, 0, 0, 0, 0, 0, 0, 1, 0, 0, 1, 0, 0]",480,339,141,32,17,0.0943952802359882,0.12056737588652482
"[0, 1, 0, 1, 1, 1, 1, 1, 0, 1, 0, 1, 0, 1, 0]",122,48,74,2,7,0.041666666666666664,0.0945945945945946
"[0, 1, 1, 1, 1, 1, 0, 1, 0, 1, 0, 0, 0, 1, 0]",112,69,43,6,4,0.08695652173913043,0.09302325581395349
"[0, 1, 0, 0, 1, 1, 1, 1, 0, 0, 1, 0, 1, 1, 1]",200,99,101,9,12,0.09090909090909091,0.1188118811881188
"[0, 0, 1, 0, 1, 0, 1, 0, 1, 1, 1, 1, 0, 1, 1]",151,71,80,10,11,0.14084507042253522,0.1375
"[0, 1, 0, 0, 0, 0, 0, 1, 0, 1, 0, 1, 0, 1, 1]",146,93,53,9,5,0.0967741935483871,0.09433962264150944
"[1, 0, 0, 1, 1, 1, 1, 1, 0, 1, 1, 1, 1, 0, 1]",631,169,462,19,38,0.11242603550295859,0.08225108225108226
"[1, 0, 1, 0, 0, 0, 0, 0, 0, 0, 0, 1, 0, 1, 0]",515,349,166,29,10,0.0830945558739255,0.060240963855421686
"[1, 0, 0, 0, 0, 1, 0, 0, 1, 0, 0, 0, 0, 1, 0]",483,320,163,35,14,0.109375,0.08588957055214724
"[0, 1, 1, 0, 1, 0, 1, 0, 0, 1, 0, 0, 0, 0, 1]",158,91,67,2,5,0.02197802197802198,0.07462686567164178
"[0, 1, 1, 0, 0, 1, 0, 1, 0, 0, 1, 0, 1, 0, 0]",124,74,50,2,3,0.02702702702702703,0.06
"[0, 1, 0, 1, 0, 0, 0, 0, 1, 0, 0, 1, 1, 1, 1]",188,100,88,12,12,0.12,0.13636363636363635
"[0, 1, 1, 0, 0, 1, 0, 1, 0, 1, 0, 0, 1, 1, 1]",166,97,69,9,7,0.09278350515463918,0.10144927536231885
"[0, 1, 1, 0, 1, 0, 1, 0, 1, 0, 0, 0, 0, 0, 1]",156,96,60,9,5,0.09375,0.08333333333333333
"[0, 1, 1, 0, 0, 0, 0, 0, 0, 0, 0, 1, 0, 1, 0]",813,646,167,64,18,0.09907120743034056,0.10778443113772455
"[0, 0, 1, 1, 0, 1, 0, 1, 1, 0, 0, 0, 0, 1, 0]",151,83,68,8,4,0.0963855421686747,0.058823529411764705
"[0, 0, 1, 1, 0, 1, 0, 1, 0, 1, 1, 1, 1, 1, 1]",322,107,215,7,20,0.06542056074766354,0.09302325581395349
"[1, 0, 0, 0, 1, 1, 0, 1, 0, 1, 0, 1, 1, 1, 1]",174,72,102,8,7,0.1111111111111111,0.06862745098039216
"[0, 0, 1, 0, 0, 0, 1, 1, 0, 1, 0, 1, 0, 1, 1]",110,69,41,4,5,0.057971014492753624,0.12195121951219512
"[0, 0, 0, 0, 0, 1, 1, 0, 1, 0, 1, 1, 1, 0, 1]",125,70,55,10,4,0.14285714285714285,0.07272727272727272
"[1, 0, 1, 0, 0, 0, 0, 0, 1, 0, 0, 0, 0, 1, 0]",521,363,158,28,10,0.07713498622589532,0.06329113924050633
"[0, 0, 0, 1, 1, 1, 0, 0, 0, 0, 0, 1, 0, 1, 0]",263,161,102,18,10,0.11180124223602485,0.09803921568627451
"[1, 1, 1, 1, 1, 1, 0, 1, 1, 1, 0, 0, 1, 0, 0]",279,91,188,6,18,0.06593406593406594,0.09574468085106383
"[0, 0, 1, 1, 0, 0, 0, 1, 1, 0, 0, 1, 0, 1, 1]",178,78,100,6,4,0.07692307692307693,0.04
"[1, 0, 0, 0, 0, 0, 0, 0, 0, 1, 1, 0, 1, 0, 0]",729,418,311,34,27,0.08133971291866028,0.08681672025723473
"[1, 1, 1, 0, 0, 1, 0, 1, 1, 0, 1, 0, 1, 1, 1]",275,95,180,7,21,0.07368421052631578,0.11666666666666667
"[0, 1, 1, 0, 1, 1, 1, 1, 0, 0, 1, 0, 1, 1, 0]",148,60,88,6,8,0.1,0.09090909090909091
"[1, 0, 1, 0, 0, 0, 0, 0, 1, 1, 0, 1, 1, 1, 1]",139,65,74,6,10,0.09230769230769231,0.13513513513513514
"[1, 1, 0, 1, 0, 0, 0, 0, 0, 1, 1, 0, 1, 1, 1]",151,70,81,7,9,0.1,0.1111111111111111
"[1, 1, 0, 1, 1, 0, 1, 0, 0, 1, 0, 1, 1, 1, 1]",274,88,186,9,20,0.10227272727272728,0.10752688172043011
"[1, 1, 1, 0, 1, 1, 0, 1, 0, 0, 1, 0, 1, 1, 1]",274,94,180,15,13,0.1595744680851064,0.07222222222222222
"[0, 1, 0, 0, 0, 0, 0, 1, 1, 0, 0, 0, 1, 0, 1]",258,177,81,23,8,0.12994350282485875,0.09876543209876543
"[1, 0, 1, 1, 1, 0, 1, 0, 0, 0, 1, 0, 0, 0, 1]",96,42,54,6,8,0.14285714285714285,0.14814814814814814
"[0, 0, 1, 1, 0, 1, 0, 1, 1, 1, 0, 0, 0, 0, 0]",211,123,88,16,12,0.13008130081300814,0.13636363636363635
"[0, 1, 1, 0, 0, 0, 1, 1, 0, 0, 0, 0, 1, 1, 1]",398,251,147,18,11,0.07171314741035857,0.07482993197278912
"[1, 0, 0, 1, 0, 1, 1, 1, 0, 1, 1, 0, 1, 1, 1]",254,80,174,11,12,0.1375,0.06896551724137931
"[1, 0, 0, 1, 1, 1, 0, 0, 0, 1, 1, 1, 1, 0, 0]",194,68,126,6,9,0.08823529411764706,0.07142857142857142
"[1, 0, 1, 0, 1, 0, 0, 0, 0, 1, 1, 1, 0, 0, 1]",132,59,73,6,4,0.1016949152542373,0.0547945205479452
"[1, 1, 0, 0, 1, 0, 0, 1, 0, 1, 1, 1, 0, 1, 0]",100,37,63,1,8,0.02702702702702703,0.12698412698412698
"[0, 0, 0, 0, 1, 0, 0, 1, 0, 1, 0, 0, 1, 0, 1]",248,165,83,13,4,0.07878787878787878,0.04819277108433735
"[0, 1, 1, 0, 0, 0, 0, 0, 1, 0, 0, 1, 0, 1, 0]",245,162,83,14,8,0.08641975308641975,0.0963855421686747
"[1, 0, 1, 1, 1, 0, 0, 1, 1, 1, 1, 0, 0, 0, 1]",197,80,117,6,19,0.075,0.1623931623931624
"[0, 1, 0, 1, 0, 0, 1, 1, 0, 0, 0, 0, 1, 0, 0]",284,176,108,18,14,0.10227272727272728,0.12962962962962962
"[1, 0, 0, 0, 1, 0, 1, 0, 0, 0, 1, 1, 1, 0, 0]",153,81,72,10,5,0.12345679012345678,0.06944444444444445
"[0, 1, 0, 0, 0, 1, 0, 1, 0, 0, 0, 1, 1, 1, 0]",125,71,54,8,4,0.11267605633802817,0.07407407407407407
"[1, 1, 0, 0, 0, 1, 0, 1, 1, 1, 0, 1, 0, 1, 1]",150,65,85,7,8,0.1076923076923077,0.09411764705882353
"[1, 1, 0, 0, 0, 0, 1, 0, 1, 0, 0, 1, 0, 1, 0]",127,81,46,9,8,0.1111111111111111,0.17391304347826086
"[0, 1, 1, 0, 0, 0, 1, 0, 1, 1, 0, 1, 1, 1, 0]",102,58,44,6,11,0.10344827586206896,0.25
"[0, 1, 1, 0, 1, 1, 0, 0, 0, 1, 0, 1, 1, 0, 1]",98,42,56,6,3,0.14285714285714285,0.05357142857142857
"[0, 1, 0, 1, 0, 0, 1, 1, 0, 1, 1, 0, 1, 0, 0]",118,62,56,6,5,0.0967741935483871,0.08928571428571429
"[1, 0, 0, 1, 0, 1, 0, 0, 0, 0, 1, 0, 1, 0, 0]",243,159,84,9,5,0.05660377358490566,0.05952380952380952
"[0, 0, 1, 0, 0, 1, 0, 1, 0, 1, 1, 1, 0, 1, 0]",86,43,43,4,5,0.09302325581395349,0.11627906976744186
"[0, 0, 0, 1, 0, 0, 1, 0, 1, 0, 1, 1, 1, 0, 1]",87,46,41,3,5,0.06521739130434782,0.12195121951219512
"[0, 0, 0, 0, 1, 0, 0, 0, 1, 0, 1, 0, 1, 1, 0]",219,141,78,16,5,0.11347517730496454,0.0641025641025641
"[1, 0, 1, 0, 1, 1, 0, 1, 1, 1, 0, 1, 0, 1, 0]",114,42,72,5,5,0.11904761904761904,0.06944444444444445
"[0, 1, 0, 0, 1, 1, 1, 0, 0, 0, 0, 1, 0, 0, 0]",261,182,79,7,8,0.038461538461538464,0.10126582278481013
"[1, 1, 0, 1, 0, 0, 0, 1, 1, 1, 0, 1, 1, 1, 1]",285,98,187,11,25,0.11224489795918367,0.13368983957219252
"[1, 1, 1, 0, 1, 0, 0, 0, 1, 1, 1, 0, 1, 1, 1]",285,92,193,8,22,0.08695652173913043,0.11398963730569948
"[1, 0, 1, 0, 0, 1, 0, 0, 1, 1, 1, 1, 0, 0, 0]",173,78,95,6,9,0.07692307692307693,0.09473684210526316
"[0, 0, 0, 0, 1, 0, 1, 0, 0, 1, 0, 0, 1, 1, 1]",263,175,88,15,7,0.08571428571428572,0.07954545454545454
"[1, 0, 1, 0, 1, 1, 0, 0, 1, 0, 1, 1, 1, 1, 1]",270,93,177,10,18,0.10752688172043011,0.1016949152542373
"[1, 0, 1, 1, 0, 1, 0, 1, 0, 1, 1, 0, 0, 1, 0]",90,38,52,2,4,0.05263157894736842,0.07692307692307693
"[1, 0, 0, 1, 0, 1, 0, 0, 0, 0, 1, 1, 1, 0, 1]",126,60,66,2,5,0.03333333333333333,0.07575757575757576
"[1, 1, 0, 1, 0, 1, 0, 0, 1, 0, 1, 1, 1, 0, 0]",118,57,61,7,4,0.12280701754385964,0.06557377049180328
"[0, 1, 0, 0, 0, 0, 1, 0, 1, 1, 1, 0, 1, 0, 1]",102,56,46,4,5,0.07142857142857142,0.10869565217391304
"[1, 0, 0, 1, 0, 0, 0, 0, 1, 0, 1, 1, 1, 0, 1]",110,49,61,5,5,0.10204081632653061,0.08196721311475409
"[0, 1, 0, 0, 1, 0, 0, 0, 0, 1, 0, 1, 1, 1, 0]",124,76,48,8,6,0.10526315789473684,0.125
"[1, 1, 1, 0, 1, 0, 0, 1, 0, 0, 0, 0, 1, 0, 1]",118,51,67,4,3,0.0784313725490196,0.04477611940298507
"[1, 0, 0, 0, 1, 0, 1, 0, 1, 0, 1, 0, 1, 1, 1]",129,54,75,4,8,0.07407407407407407,0.10666666666666667
"[0, 1, 0, 1, 0, 1, 1, 0, 1, 1, 0, 0, 0, 0, 1]",135,67,68,4,10,0.05970149253731343,0.14705882352941177
"[1, 1, 0, 1, 0, 0, 1, 0, 1, 1, 0, 1, 1, 1, 0]",129,50,79,6,9,0.12,0.11392405063291139
"[0, 0, 1, 0, 1, 1, 1, 0, 1, 0, 1, 0, 0, 0, 1]",111,60,51,6,3,0.1,0.058823529411764705
"[1, 0, 0, 1, 1, 1, 0, 1, 0, 0, 1, 1, 0, 0, 1]",154,64,90,4,7,0.0625,0.07777777777777778
"[0, 1, 0, 0, 1, 1, 1, 1, 0, 1, 1, 1, 0, 0, 0]",145,61,84,5,9,0.08196721311475409,0.10714285714285714
"[0, 0, 0, 1, 0, 0, 0, 1, 0, 1, 0, 0, 0, 0, 1]",580,435,145,39,15,0.0896551724137931,0.10344827586206896
"[1, 0, 0, 0, 1, 1, 1, 0, 1, 0, 1, 1, 0, 0, 0]",132,77,55,3,2,0.03896103896103896,0.03636363636363636
"[0, 1, 1, 0, 1, 0, 1, 0, 0, 0, 1, 1, 1, 0, 1]",93,49,44,3,6,0.061224489795918366,0.13636363636363635
"[0, 1, 1, 0, 0, 0, 0, 1, 0, 1, 0, 1, 1, 1, 1]",196,131,65,15,9,0.11450381679389313,0.13846153846153847
"[1, 0, 0, 0, 0, 0, 0, 0, 1, 1, 1, 0, 1, 0, 1]",187,87,100,10,13,0.11494252873563218,0.13
"[1, 0, 1, 0, 1, 1, 1, 0, 0, 1, 1, 0, 1, 0, 0]",107,49,58,6,7,0.12244897959183673,0.1206896551724138
"[0, 1, 0, 0, 0, 0, 0, 0, 1, 0, 0, 1, 0, 1, 1]",267,178,89,18,10,0.10112359550561797,0.11235955056179775
"[0, 1, 1, 0, 1, 1, 0, 1, 0, 0, 0, 0, 0, 0, 0]",330,210,120,14,13,0.06666666666666667,0.10833333333333334
"[0, 0, 0, 0, 0, 0, 1, 1, 0, 1, 1, 1, 1, 1, 1]",389,217,172,15,16,0.06912442396313365,0.09302325581395349
"[0, 1, 0, 0, 1, 1, 1, 0, 1, 0, 1, 0, 1, 0, 0]",113,60,53,8,7,0.13333333333333333,0.1320754716981132
"[0, 1, 1, 1, 1, 0, 1, 0, 0, 1, 1, 1, 0, 1, 0]",154,65,89,9,9,0.13846153846153847,0.10112359550561797
"[1, 0, 0, 1, 1, 1, 0, 0, 1, 1, 0, 1, 0, 0, 0]",127,64,63,9,7,0.140625,0.1111111111111111
"[0, 0, 0, 1, 0, 0, 1, 1, 1, 0, 0, 0, 1, 0, 0]",258,152,106,14,10,0.09210526315789473,0.09433962264150944
"[1, 1, 1, 0, 0, 0, 0, 0, 1, 1, 0, 0, 1, 1, 0]",310,147,163,16,16,0.10884353741496598,0.09815950920245399
"[0, 1, 1, 1, 1, 0, 0, 0, 0, 0, 1, 1, 0, 0, 1]",256,163,93,21,16,0.12883435582822086,0.17204301075268819
"[1, 0, 0, 0, 1, 1, 0, 0, 1, 0, 1, 0, 1, 0, 1]",117,64,53,7,6,0.109375,0.11320754716981132
"[1, 0, 0, 1, 0, 0, 0, 1, 1, 0, 0, 1, 0, 1, 0]",126,74,52,8,4,0.10810810810810811,0.07692307692307693
"[0, 1, 0, 1, 1, 0, 0, 1, 0, 0, 0, 1, 1, 0, 0]",172,111,61,10,6,0.09009009009009009,0.09836065573770492
"[0, 0, 1, 1, 0, 1, 1, 0, 1, 1, 0, 0, 0, 0, 1]",162,90,72,11,5,0.12222222222222222,0.06944444444444445
"[1, 0, 0, 0, 0, 1, 1, 0, 1, 0, 0, 1, 0, 0, 1]",163,94,69,6,8,0.06382978723404255,0.11594202898550725
"[0, 1, 1, 1, 0, 1, 1, 1, 0, 1, 1, 0, 1, 1, 0]",222,80,142,8,11,0.1,0.07746478873239436
"[1, 1, 1, 1, 1, 0, 0, 0, 1, 1, 1, 0, 1, 1, 1]",755,197,558,21,55,0.1065989847715736,0.0985663082437276
"[1, 1, 0, 1, 1, 1, 1, 1, 1, 1, 1, 0, 0, 0, 1]",733,219,514,23,56,0.1050228310502283,0.10894941634241245
"[1, 0, 0, 0, 0, 0, 0, 0, 1, 1, 1, 0, 0, 1, 1]",290,154,136,18,10,0.11688311688311688,0.07352941176470588
"[1, 0, 0, 0, 1, 0, 1, 1, 0, 1, 0, 1, 1, 1, 1]",189,63,126,7,15,0.1111111111111111,0.11904761904761904
"[0, 0, 0, 1, 0, 1, 0, 1, 1, 1, 1, 1, 0, 0, 1]",142,75,67,7,7,0.09333333333333334,0.1044776119402985
"[0, 1, 1, 1, 1, 1, 1, 0, 0, 0, 1, 0, 1, 0, 1]",165,88,77,6,8,0.06818181818181818,0.1038961038961039
"[1, 0, 0, 1, 0, 1, 0, 0, 0, 1, 1, 1, 1, 0, 0]",178,98,80,9,14,0.09183673469387756,0.175
"[1, 0, 1, 1, 1, 0, 1, 0, 0, 0, 1, 1, 0, 1, 0]",120,47,73,4,7,0.0851063829787234,0.0958904109589041
"[1, 0, 1, 1, 0, 0, 0, 1, 0, 1, 1, 0, 1, 0, 1]",110,54,56,6,2,0.1111111111111111,0.03571428571428571
"[1, 1, 0, 1, 1, 1, 0, 1, 0, 1, 1, 0, 0, 0, 1]",144,61,83,10,9,0.16393442622950818,0.10843373493975904
"[0, 1, 0, 0, 0, 1, 1, 1, 0, 0, 0, 1, 1, 0, 1]",128,67,61,9,4,0.13432835820895522,0.06557377049180328
"[0, 1, 1, 1, 1, 0, 1, 0, 0, 0, 1, 1, 1, 0, 0]",126,70,56,5,7,0.07142857142857142,0.125
"[0, 1, 0, 1, 1, 1, 0, 0, 1, 1, 1, 1, 0, 1, 0]",151,67,84,5,11,0.07462686567164178,0.13095238095238096
"[1, 1, 1, 1, 0, 0, 1, 1, 0, 0, 0, 0, 0, 1, 0]",355,186,169,18,10,0.0967741935483871,0.05917159763313609
"[0, 1, 0, 1, 0, 0, 1, 1, 1, 0, 1, 0, 0, 0, 1]",109,47,62,4,4,0.0851063829787234,0.06451612903225806
"[1, 1, 1, 1, 0, 1, 0, 1, 1, 0, 0, 1, 1, 0, 0]",277,106,171,10,22,0.09433962264150944,0.1286549707602339
"[0, 1, 0, 1, 1, 1, 0, 0, 0, 1, 0, 0, 0, 1, 0]",142,80,62,9,7,0.1125,0.11290322580645161
"[0, 1, 0, 0, 1, 1, 1, 1, 1, 0, 1, 0, 1, 1, 1]",297,124,173,14,12,0.11290322580645161,0.06936416184971098
"[0, 0, 0, 0, 1, 1, 0, 1, 0, 0, 1, 1, 1, 1, 1]",255,139,116,14,8,0.10071942446043165,0.06896551724137931
"[1, 1, 1, 0, 0, 0, 1, 1, 1, 0, 1, 1, 1, 1, 1]",698,189,509,16,60,0.08465608465608465,0.11787819253438114
"[0, 0, 1, 1, 0, 0, 0, 1, 0, 1, 1, 1, 0, 0, 1]",159,81,78,9,5,0.1111111111111111,0.0641025641025641
"[0, 1, 1, 0, 0, 1, 0, 1, 0, 1, 1, 1, 1, 1, 0]",168,76,92,5,5,0.06578947368421052,0.05434782608695652
"[0, 1, 0, 1, 0, 1, 0, 1, 0, 1, 1, 0, 1, 0, 0]",111,54,57,2,8,0.037037037037037035,0.14035087719298245
"[0, 1, 1, 1, 0, 0, 1, 0, 1, 1, 0, 1, 0, 1, 1]",162,78,84,6,10,0.07692307692307693,0.11904761904761904
"[1, 1, 1, 0, 0, 1, 1, 1, 0, 0, 1, 0, 1, 1, 0]",175,81,94,7,5,0.08641975308641975,0.05319148936170213
"[0, 1, 0, 1, 1, 0, 0, 1, 1, 1, 1, 0, 1, 1, 0]",156,59,97,6,10,0.1016949152542373,0.10309278350515463
"[1, 0, 0, 1, 1, 1, 1, 0, 1, 0, 1, 1, 0, 0, 1]",186,71,115,4,10,0.056338028169014086,0.08695652173913043
"[0, 0, 1, 1, 1, 1, 1, 0, 0, 1, 0, 1, 0, 0, 1]",154,69,85,10,3,0.14492753623188406,0.03529411764705882
"[1, 0, 1, 1, 1, 1, 0, 1, 0, 0, 1, 0, 1, 0, 1]",145,42,103,1,8,0.023809523809523808,0.07766990291262135
"[1, 0, 0, 1, 1, 0, 0, 0, 0, 0, 1, 1, 1, 1, 0]",227,101,126,12,13,0.1188118811881188,0.10317460317460317
"[1, 1, 0, 0, 1, 1, 0, 0, 0, 0, 0, 1, 1, 1, 1]",542,279,263,27,31,0.0967741935483871,0.11787072243346007
"[0, 0, 1, 1, 1, 1, 1, 1, 1, 0, 0, 1, 0, 1, 1]",381,157,224,11,13,0.07006369426751592,0.05803571428571429
"[1, 0, 1, 0, 1, 0, 0, 1, 1, 1, 0, 1, 0, 0, 1]",97,49,48,4,2,0.08163265306122448,0.041666666666666664
"[1, 1, 1, 0, 0, 0, 1, 0, 1, 0, 1, 0, 0, 1, 1]",172,75,97,5,12,0.06666666666666667,0.12371134020618557
"[1, 1, 0, 1, 1, 1, 0, 0, 0, 1, 0, 1, 0, 1, 0]",94,44,50,4,9,0.09090909090909091,0.18
"[1, 1, 1, 0, 0, 1, 1, 1, 0, 1, 1, 1, 0, 0, 0]",227,79,148,4,15,0.05063291139240506,0.10135135135135136
"[1, 0, 0, 1, 0, 0, 1, 1, 0, 0, 1, 0, 0, 0, 1]",148,89,59,9,4,0.10112359550561797,0.06779661016949153
"[1, 0, 0, 0, 0, 0, 0, 1, 0, 0, 1, 0, 0, 1, 1]",385,217,168,22,12,0.10138248847926268,0.07142857142857142
"[1, 1, 1, 1, 0, 1, 1, 0, 0, 1, 0, 1, 1, 0, 1]",235,84,151,13,10,0.15476190476190477,0.06622516556291391
"[0, 1, 1, 0, 1, 1, 0, 0, 1, 0, 1, 1, 1, 1, 1]",318,128,190,17,15,0.1328125,0.07894736842105263
"[0, 1, 1, 1, 0, 0, 1, 1, 0, 1, 1, 0, 0, 1, 0]",125,68,57,4,6,0.058823529411764705,0.10526315789473684
"[1, 1, 0, 0, 1, 1, 0, 1, 1, 1, 0, 0, 1, 0, 1]",173,65,108,11,10,0.16923076923076924,0.09259259259259259
"[0, 0, 1, 1, 0, 1, 0, 1, 0, 0, 0, 1, 0, 1, 0]",127,80,47,4,4,0.05,0.0851063829787234
"[1, 0, 1, 0, 1, 0, 0, 1, 0, 1, 0, 1, 1, 0, 1]",88,42,46,5,3,0.11904761904761904,0.06521739130434782
"[1, 0, 1, 1, 1, 0, 1, 0, 0, 0, 1, 0, 1, 0, 1]",98,40,58,4,6,0.1,0.10344827586206896
"[0, 0, 0, 1, 1, 1, 1, 1, 0, 1, 1, 1, 0, 1, 0]",159,81,78,5,5,0.06172839506172839,0.0641025641025641
"[1, 1, 1, 0, 1, 0, 0, 1, 0, 1, 1, 0, 0, 1, 1]",207,82,125,7,17,0.08536585365853659,0.136
"[0, 1, 1, 1, 0, 1, 0, 0, 1, 0, 1, 1, 0, 0, 1]",135,68,67,9,6,0.1323529411764706,0.08955223880597014
"[0, 0, 1, 1, 0, 1, 0, 1, 1, 1, 1, 1, 0, 1, 1]",257,109,148,10,16,0.09174311926605505,0.10810810810810811
"[1, 1, 0, 0, 0, 0, 1, 0, 1, 0, 1, 0, 1, 1, 1]",211,107,104,10,12,0.09345794392523364,0.11538461538461539
"[1, 1, 0, 1, 0, 0, 0, 0, 1, 1, 0, 0, 0, 1, 1]",157,78,79,7,8,0.08974358974358974,0.10126582278481013
"[1, 1, 1, 0, 1, 0, 0, 0, 0, 1, 1, 0, 0, 0, 1]",146,69,77,5,9,0.07246376811594203,0.11688311688311688
"[0, 0, 1, 0, 1, 0, 0, 1, 0, 0, 0, 1, 0, 0, 0]",521,381,140,41,16,0.10761154855643044,0.11428571428571428
"[1, 0, 0, 0, 0, 1, 0, 1, 0, 0, 1, 0, 0, 0, 1]",237,135,102,15,12,0.1111111111111111,0.11764705882352941
"[1, 0, 0, 1, 0, 1, 1, 0, 0, 0, 0, 1, 0, 1, 0]",136,79,57,3,7,0.0379746835443038,0.12280701754385964
"[1, 1, 0, 0, 1, 0, 0, 0, 1, 0, 0, 0, 1, 0, 0]",272,171,101,14,13,0.08187134502923976,0.12871287128712872
"[1, 0, 1, 1, 0, 0, 1, 0, 0, 0, 1, 0, 0, 0, 1]",136,76,60,9,9,0.11842105263157894,0.15
"[1, 1, 0, 0, 0, 0, 1, 0, 0, 1, 0, 1, 0, 0, 1]",158,95,63,11,4,0.11578947368421053,0.06349206349206349
"[0, 0, 1, 0, 0, 0, 1, 0, 1, 1, 0, 1, 1, 1, 0]",120,56,64,1,6,0.017857142857142856,0.09375
"[0, 1, 0, 0, 0, 0, 0, 0, 1, 0, 0, 1, 1, 0, 1]",236,156,80,17,4,0.10897435897435898,0.05
"[0, 1, 0, 1, 1, 0, 0, 0, 0, 0, 0, 1, 1, 1, 1]",499,268,231,25,23,0.09328358208955224,0.09956709956709957
"[1, 0, 0, 0, 0, 0, 0, 1, 1, 1, 1, 0, 0, 0, 1]",432,150,282,15,25,0.1,0.08865248226950355
"[0, 1, 0, 1, 0, 1, 0, 1, 1, 0, 0, 0, 0, 0, 0]",356,219,137,20,12,0.091324200913242,0.08759124087591241
"[1, 0, 1, 1, 0, 1, 1, 0, 0, 1, 1, 0, 0, 1, 0]",119,43,76,5,8,0.11627906976744186,0.10526315789473684
"[1, 1, 0, 0, 0, 1, 1, 1, 0, 1, 1, 0, 1, 1, 0]",151,60,91,2,10,0.03333333333333333,0.10989010989010989
"[0, 0, 0, 1, 1, 0, 1, 1, 1, 0, 1, 0, 0, 1, 0]",99,55,44,9,2,0.16363636363636364,0.045454545454545456
"[1, 1, 0, 1, 1, 1, 0, 0, 0, 0, 1, 0, 1, 0, 1]",121,49,72,1,4,0.02040816326530612,0.05555555555555555
"[0, 0, 0, 1, 0, 1, 1, 0, 1, 1, 0, 0, 0, 0, 0]",322,193,129,18,9,0.09326424870466321,0.06976744186046512
"[1, 1, 0, 0, 0, 1, 0, 1, 1, 0, 1, 1, 0, 0, 0]",147,81,66,8,5,0.09876543209876543,0.07575757575757576
"[0, 1, 0, 1, 0, 0, 1, 1, 0, 1, 1, 1, 1, 0, 0]",130,67,63,3,4,0.04477611940298507,0.06349206349206349
"[1, 1, 1, 1, 1, 1, 0, 1, 1, 0, 0, 0, 0, 1, 0]",177,76,101,6,9,0.07894736842105263,0.0891089108910891
"[1, 1, 1, 1, 0, 0, 1, 0, 1, 0, 1, 1, 0, 1, 1]",320,117,203,10,23,0.08547008547008547,0.11330049261083744
"[1, 0, 1, 1, 1, 1, 0, 1, 0, 1, 0, 0, 1, 0, 0]",112,51,61,9,7,0.17647058823529413,0.11475409836065574
"[0, 0, 1, 0, 1, 1, 1, 0, 0, 1, 1, 0, 1, 0, 0]",117,65,52,2,4,0.03076923076923077,0.07692307692307693
"[1, 0, 1, 1, 0, 0, 1, 1, 1, 0, 1, 1, 1, 1, 0]",256,87,169,4,23,0.04597701149425287,0.13609467455621302
"[0, 1, 1, 1, 1, 1, 0, 0, 1, 1, 0, 0, 1, 0, 1]",196,87,109,12,10,0.13793103448275862,0.09174311926605505
"[1, 1, 0, 1, 0, 1, 1, 0, 1, 1, 0, 1, 1, 0, 1]",193,58,135,6,16,0.10344827586206896,0.11851851851851852
"[1, 1, 0, 1, 1, 0, 1, 1, 1, 0, 1, 0, 1, 1, 0]",222,73,149,4,16,0.0547945205479452,0.10738255033557047
"[1, 1, 1, 1, 1, 1, 0, 0, 1, 0, 0, 0, 1, 1, 0]",189,80,109,6,14,0.075,0.12844036697247707
"[0, 1, 0, 1, 1, 1, 1, 1, 0, 0, 0, 1, 0, 1, 0]",125,57,68,3,5,0.05263157894736842,0.07352941176470588
"[0, 0, 1, 0, 1, 1, 1, 1, 1, 0, 0, 0, 1, 0, 1]",112,56,56,5,5,0.08928571428571429,0.08928571428571429
"[0, 0, 0, 1, 0, 1, 0, 1, 0, 0, 0, 1, 1, 1, 0]",162,88,74,10,7,0.11363636363636363,0.0945945945945946
"[0, 1, 1, 1, 1, 0, 1, 0, 0, 0, 1, 0, 1, 0, 0]",118,61,57,4,3,0.06557377049180328,0.05263157894736842
"[1, 1, 0, 0, 0, 1, 1, 1, 0, 0, 0, 1, 0, 1, 1]",142,70,72,8,12,0.11428571428571428,0.16666666666666666
"[0, 1, 1, 0, 1, 0, 0, 0, 0, 0, 1, 1, 0, 1, 1]",121,67,54,6,3,0.08955223880597014,0.05555555555555555
"[1, 1, 1, 0, 0, 0, 0, 0, 1, 0, 0, 1, 1, 1, 1]",245,80,165,6,18,0.075,0.10909090909090909
"[1, 1, 0, 0, 1, 1, 1, 1, 1, 0, 1, 1, 0, 1, 0]",284,102,182,10,20,0.09803921568627451,0.10989010989010989
"[0, 1, 1, 0, 1, 0, 0, 1, 1, 0, 1, 1, 1, 1, 0]",138,50,88,4,9,0.08,0.10227272727272728
"[1, 0, 1, 1, 1, 1, 0, 1, 1, 0, 1, 0, 0, 1, 1]",260,99,161,8,18,0.08080808080808081,0.11180124223602485
"[0, 0, 0, 1, 0, 1, 0, 0, 1, 1, 1, 0, 0, 1, 0]",134,77,57,9,5,0.11688311688311688,0.08771929824561403
"[0, 0, 1, 0, 0, 0, 0, 0, 0, 1, 0, 1, 1, 0, 0]",586,429,157,35,19,0.08158508158508158,0.12101910828025478
"[1, 1, 0, 0, 1, 1, 1, 1, 0, 0, 0, 1, 1, 1, 0]",267,111,156,13,20,0.11711711711711711,0.1282051282051282
"[1, 0, 0, 0, 1, 1, 0, 0, 0, 1, 0, 0, 0, 1, 1]",192,108,84,11,6,0.10185185185185185,0.07142857142857142
"[0, 1, 1, 0, 0, 0, 1, 1, 0, 0, 0, 1, 0, 0, 0]",255,171,84,19,9,0.1111111111111111,0.10714285714285714
"[1, 0, 0, 1, 1, 0, 0, 0, 0, 0, 1, 0, 1, 1, 0]",197,96,101,7,11,0.07291666666666667,0.10891089108910891
"[1, 1, 0, 1, 1, 1, 0, 0, 0, 0, 0, 0, 1, 0, 0]",157,92,65,7,10,0.07608695652173914,0.15384615384615385
"[0, 1, 1, 0, 1, 1, 0, 1, 0, 1, 1, 1, 1, 1, 1]",624,202,422,21,40,0.10396039603960396,0.0947867298578199
"[1, 0, 1, 0, 0, 1, 1, 0, 1, 1, 1, 1, 1, 0, 0]",192,78,114,5,8,0.0641025641025641,0.07017543859649122
"[1, 1, 1, 0, 0, 1, 0, 0, 0, 0, 0, 1, 1, 0, 0]",252,137,115,10,13,0.072992700729927,0.11304347826086956
"[0, 1, 0, 0, 1, 0, 0, 1, 0, 1, 1, 1, 1, 1, 0]",114,54,60,6,5,0.1111111111111111,0.08333333333333333
"[1, 0, 1, 1, 0, 1, 1, 1, 0, 0, 1, 0, 1, 0, 0]",120,53,67,7,6,0.1320754716981132,0.08955223880597014
"[0, 1, 1, 1, 1, 0, 1, 1, 1, 0, 0, 1, 1, 0, 0]",242,118,124,13,11,0.11016949152542373,0.08870967741935484
"[0, 0, 0, 1, 0, 0, 0, 1, 0, 0, 1, 1, 1, 0, 0]",305,213,92,21,5,0.09859154929577464,0.05434782608695652
"[1, 0, 0, 0, 0, 0, 0, 1, 0, 0, 0, 1, 0, 0, 1]",576,377,199,42,21,0.11140583554376658,0.10552763819095477
"[1, 1, 1, 1, 0, 1, 0, 1, 0, 0, 1, 0, 0, 0, 1]",135,56,79,5,9,0.08928571428571429,0.11392405063291139
"[0, 0, 0, 1, 1, 0, 0, 1, 0, 1, 0, 1, 1, 1, 1]",227,159,68,12,5,0.07547169811320754,0.07352941176470588
"[0, 0, 1, 0, 1, 0, 0, 1, 1, 0, 1, 1, 1, 1, 1]",219,105,114,9,12,0.08571428571428572,0.10526315789473684
"[1, 0, 0, 0, 1, 1, 0, 0, 0, 0, 1, 1, 1, 0, 0]",203,112,91,9,5,0.08035714285714286,0.054945054945054944
"[0, 1, 0, 1, 1, 0, 1, 0, 0, 1, 1, 1, 0, 0, 0]",125,64,61,6,5,0.09375,0.08196721311475409
"[1, 0, 1, 0, 0, 0, 1, 0, 0, 0, 0, 1, 0, 0, 0]",539,377,162,33,11,0.08753315649867374,0.06790123456790123
"[1, 0, 1, 1, 1, 1, 0, 1, 1, 0, 0, 0, 0, 1, 1]",275,107,168,8,11,0.07476635514018691,0.06547619047619048
"[0, 1, 0, 1, 1, 1, 0, 0, 0, 1, 0, 0, 0, 0, 0]",256,162,94,18,8,0.1111111111111111,0.0851063829787234
"[0, 0, 0, 0, 1, 0, 1, 1, 1, 1, 1, 1, 1, 0, 1]",185,69,116,7,10,0.10144927536231885,0.08620689655172414
"[1, 0, 1, 1, 0, 0, 1, 0, 0, 1, 0, 0, 1, 0, 0]",131,70,61,8,5,0.11428571428571428,0.08196721311475409
"[0, 0, 0, 1, 0, 0, 0, 1, 1, 1, 0, 0, 1, 1, 0]",196,122,74,11,10,0.09016393442622951,0.13513513513513514
"[0, 0, 0, 1, 0, 0, 1, 1, 0, 1, 0, 0, 1, 1, 0]",157,92,65,7,3,0.07608695652173914,0.046153846153846156
"[1, 1, 1, 0, 1, 0, 1, 1, 0, 1, 1, 0, 0, 0, 0]",157,74,83,8,8,0.10810810810810811,0.0963855421686747
"[0, 0, 0, 1, 0, 0, 1, 0, 1, 1, 1, 0, 1, 1, 0]",116,67,49,7,6,0.1044776119402985,0.12244897959183673
"[1, 0, 0, 0, 0, 1, 0, 0, 1, 0, 1, 1, 1, 0, 1]",112,56,56,6,7,0.10714285714285714,0.125
"[0, 1, 0, 1, 1, 1, 0, 0, 1, 0, 0, 1, 1, 1, 0]",126,57,69,4,4,0.07017543859649122,0.057971014492753624
"[1, 1, 1, 1, 0, 0, 0, 1, 1, 0, 1, 0, 0, 0, 1]",161,65,96,8,8,0.12307692307692308,0.08333333333333333
"[0, 0, 0, 0, 1, 1, 0, 1, 1, 0, 1, 1, 0, 1, 1]",142,73,69,4,5,0.0547945205479452,0.07246376811594203
"[0, 1, 1, 1, 0, 0, 0, 0, 0, 1, 1, 0, 1, 1, 0]",115,63,52,3,7,0.047619047619047616,0.1346153846153846
"[0, 1, 0, 1, 0, 1, 1, 1, 0, 0, 0, 0, 0, 1, 1]",144,75,69,4,7,0.05333333333333334,0.10144927536231885
"[1, 0, 1, 0, 1, 0, 1, 0, 1, 0, 1, 1, 1, 0, 0]",128,60,68,7,3,0.11666666666666667,0.04411764705882353
"[0, 1, 0, 1, 1, 0, 1, 0, 0, 0, 0, 0, 1, 1, 1]",162,97,65,10,6,0.10309278350515463,0.09230769230769231
"[1, 0, 0, 1, 1, 1, 0, 0, 0, 0, 1, 0, 0, 0, 0]",265,171,94,14,6,0.08187134502923976,0.06382978723404255
"[0, 1, 0, 1, 1, 1, 1, 0, 1, 0, 1, 0, 1, 1, 0]",162,64,98,5,6,0.078125,0.061224489795918366
"[1, 0, 1, 1, 1, 0, 0, 1, 0, 1, 0, 1, 0, 0, 1]",112,53,59,10,4,0.18867924528301888,0.06779661016949153
"[1, 1, 1, 0, 1, 0, 1, 1, 0, 1, 0, 0, 1, 1, 1]",304,114,190,17,17,0.14912280701754385,0.08947368421052632
"[0, 0, 0, 1, 1, 0, 1, 1, 0, 1, 0, 0, 1, 1, 1]",158,83,75,7,7,0.08433734939759036,0.09333333333333334
"[0, 0, 0, 1, 0, 1, 0, 0, 1, 1, 1, 0, 1, 0, 1]",111,62,49,5,7,0.08064516129032258,0.14285714285714285
"[1, 0, 1, 0, 0, 1, 0, 1, 0, 0, 0, 0, 0, 0, 1]",277,167,110,16,8,0.09580838323353294,0.07272727272727272
"[0, 0, 0, 0, 1, 0, 1, 1, 1, 0, 0, 0, 0, 1, 1]",355,231,124,19,15,0.08225108225108226,0.12096774193548387
"[1, 1, 0, 0, 1, 1, 1, 0, 0, 1, 0, 0, 1, 0, 0]",135,70,65,5,4,0.07142857142857142,0.06153846153846154
"[1, 0, 1, 0, 0, 0, 1, 0, 0, 1, 1, 1, 0, 0, 1]",117,66,51,14,4,0.21212121212121213,0.0784313725490196
"[1, 1, 1, 0, 0, 1, 0, 1, 0, 0, 0, 1, 0, 0, 1]",124,72,52,8,7,0.1111111111111111,0.1346153846153846
"[1, 1, 0, 0, 0, 0, 1, 0, 1, 1, 0, 0, 1, 1, 1]",230,105,125,13,12,0.12380952380952381,0.096
"[1, 0, 1, 1, 1, 0, 1, 1, 0, 0, 0, 1, 0, 1, 1]",127,57,70,5,11,0.08771929824561403,0.15714285714285714
"[1, 1, 0, 1, 0, 0, 0, 1, 0, 1, 1, 1, 0, 1, 1]",152,55,97,4,10,0.07272727272727272,0.10309278350515463
"[0, 0, 0, 0, 0, 1, 0, 1, 0, 1, 1, 1, 1, 1, 0]",145,92,53,13,3,0.14130434782608695,0.05660377358490566
"[1, 0, 0, 1, 1, 0, 1, 1, 1, 0, 1, 0, 1, 1, 1]",275,90,185,13,12,0.14444444444444443,0.06486486486486487
"[0, 0, 1, 1, 0, 0, 1, 0, 1, 0, 0, 0, 1, 0, 1]",137,87,50,10,3,0.11494252873563218,0.06
"[1, 0, 1, 0, 0, 0, 0, 1, 0, 1, 1, 0, 0, 0, 1]",139,88,51,7,8,0.07954545454545454,0.1568627450980392
"[0, 0, 0, 0, 1, 0, 1, 1, 0, 0, 0, 0, 1, 0, 1]",248,165,83,16,3,0.09696969696969697,0.03614457831325301
"[1, 1, 1, 0, 0, 0, 0, 1, 0, 0, 0, 0, 1, 0, 1]",151,78,73,3,2,0.038461538461538464,0.0273972602739726
"[0, 1, 0, 0, 1, 1, 0, 0, 1, 1, 1, 0, 1, 1, 0]",104,40,64,3,6,0.075,0.09375
"[1, 1, 1, 0, 0, 0, 0, 1, 0, 0, 1, 1, 1, 0, 0]",166,69,97,8,17,0.11594202898550725,0.17525773195876287
"[1, 0, 1, 1, 0, 1, 0, 1, 0, 0, 0, 0, 0, 1, 1]",152,80,72,11,8,0.1375,0.1111111111111111
"[1, 0, 0, 1, 0, 1, 0, 1, 0, 1, 1, 0, 1, 0, 1]",99,44,55,0,8,0.0,0.14545454545454545
"[1, 1, 0, 1, 1, 0, 0, 1, 1, 0, 0, 1, 1, 1, 0]",192,61,131,2,12,0.03278688524590164,0.0916030534351145
"[0, 1, 0, 0, 0, 1, 0, 1, 0, 1, 1, 0, 1, 0, 0]",141,77,64,5,7,0.06493506493506493,0.109375
"[1, 1, 0, 0, 1, 0, 1, 1, 1, 1, 0, 1, 0, 1, 1]",241,76,165,7,13,0.09210526315789473,0.07878787878787878
"[0, 1, 1, 0, 0, 1, 0, 1, 1, 1, 1, 0, 1, 0, 1]",134,68,66,6,2,0.08823529411764706,0.030303030303030304
"[0, 0, 0, 0, 0, 1, 1, 0, 0, 1, 0, 1, 1, 1, 1]",360,248,112,27,12,0.10887096774193548,0.10714285714285714
"[0, 1, 1, 1, 1, 1, 0, 0, 1, 0, 1, 0, 1, 0, 1]",131,70,61,3,3,0.04285714285714286,0.04918032786885246
"[0, 0, 0, 0, 1, 1, 0, 1, 1, 1, 0, 0, 0, 0, 1]",211,116,95,12,6,0.10344827586206896,0.06315789473684211
"[1, 0, 0, 0, 0, 1, 1, 0, 1, 1, 1, 0, 0, 0, 0]",224,118,106,8,14,0.06779661016949153,0.1320754716981132
"[0, 1, 0, 1, 0, 1, 0, 1, 1, 1, 0, 1, 1, 0, 0]",117,53,64,5,6,0.09433962264150944,0.09375
"[0, 0, 1, 0, 1, 0, 1, 0, 1, 1, 1, 0, 1, 1, 0]",107,57,50,5,6,0.08771929824561403,0.12
"[0, 1, 1, 1, 1, 0, 0, 1, 1, 1, 1, 1, 0, 1, 0]",418,236,182,29,16,0.1228813559322034,0.08791208791208792
"[1, 0, 1, 0, 1, 0, 0, 0, 0, 0, 1, 1, 0, 1, 1]",106,59,47,3,3,0.05084745762711865,0.06382978723404255
"[1, 0, 1, 0, 1, 0, 1, 0, 1, 0, 0, 0, 0, 0, 1]",141,77,64,6,5,0.07792207792207792,0.078125
"[0, 1, 1, 0, 0, 1, 1, 0, 0, 0, 0, 0, 1, 0, 0]",498,383,115,22,11,0.057441253263707574,0.09565217391304348
"[1, 0, 1, 0, 0, 0, 1, 0, 1, 0, 1, 0, 1, 1, 1]",112,49,63,6,8,0.12244897959183673,0.12698412698412698
"[1, 0, 1, 1, 0, 0, 0, 0, 1, 0, 0, 0, 1, 1, 0]",166,102,64,6,9,0.058823529411764705,0.140625
"[0, 1, 0, 0, 1, 0, 0, 1, 0, 1, 0, 0, 1, 1, 1]",154,88,66,7,7,0.07954545454545454,0.10606060606060606
"[1, 1, 0, 0, 1, 1, 1, 0, 0, 0, 1, 0, 0, 1, 1]",169,88,81,10,4,0.11363636363636363,0.04938271604938271
"[0, 0, 0, 0, 0, 0, 1, 1, 1, 0, 0, 1, 1, 1, 0]",245,140,105,14,7,0.1,0.06666666666666667
"[0, 1, 1, 1, 0, 0, 0, 0, 1, 1, 0, 1, 0, 0, 0]",163,95,68,5,10,0.05263157894736842,0.14705882352941177
"[0, 1, 0, 1, 1, 1, 1, 0, 1, 1, 0, 0, 1, 1, 0]",178,78,100,6,11,0.07692307692307693,0.11
"[0, 1, 0, 0, 0, 1, 0, 0, 1, 0, 1, 1, 0, 0, 0]",277,195,82,19,4,0.09743589743589744,0.04878048780487805
"[1, 0, 1, 1, 1, 0, 1, 0, 0, 0, 1, 0, 0, 1, 0]",89,47,42,11,3,0.23404255319148937,0.07142857142857142
"[0, 0, 1, 0, 1, 0, 1, 0, 1, 0, 1, 0, 0, 0, 1]",159,94,65,10,7,0.10638297872340426,0.1076923076923077
"[0, 1, 0, 1, 1, 0, 0, 0, 1, 0, 1, 0, 0, 0, 0]",236,158,78,16,5,0.10126582278481013,0.0641025641025641
"[1, 1, 0, 0, 0, 1, 1, 0, 0, 1, 0, 0, 1, 1, 1]",194,90,104,7,16,0.07777777777777778,0.15384615384615385
"[0, 0, 1, 0, 1, 1, 0, 0, 0, 1, 1, 0, 0, 1, 0]",146,84,62,7,8,0.08333333333333333,0.12903225806451613
"[1, 0, 0, 1, 0, 1, 1, 0, 0, 0, 1, 1, 0, 0, 1]",154,74,80,9,9,0.12162162162162163,0.1125
"[0, 1, 1, 0, 1, 1, 0, 1, 0, 0, 1, 0, 0, 1, 0]",109,62,47,4,3,0.06451612903225806,0.06382978723404255
"[1, 1, 1, 0, 1, 1, 1, 0, 0, 1, 0, 1, 0, 0, 0]",138,65,73,6,9,0.09230769230769231,0.1232876712328767
"[1, 1, 1, 0, 1, 1, 0, 0, 1, 0, 0, 0, 1, 1, 0]",122,63,59,4,5,0.06349206349206349,0.0847457627118644
"[0, 0, 0, 1, 1, 0, 1, 1, 0, 0, 0, 0, 0, 0, 1]",426,279,147,17,10,0.06093189964157706,0.06802721088435375
"[0, 1, 0, 0, 1, 1, 0, 1, 0, 0, 0, 1, 1, 1, 0]",108,60,48,6,3,0.1,0.0625
"[0, 1, 1, 0, 0, 1, 1, 0, 1, 1, 1, 1, 0, 1, 1]",319,129,190,11,20,0.08527131782945736,0.10526315789473684
"[1, 0, 0, 0, 1, 1, 1, 1, 1, 0, 1, 0, 0, 0, 0]",142,62,80,5,10,0.08064516129032258,0.125
"[1, 0, 0, 0, 1, 0, 0, 1, 1, 0, 0, 0, 1, 0, 0]",222,141,81,16,16,0.11347517730496454,0.19753086419753085
"[0, 1, 0, 0, 0, 1, 0, 0, 1, 1, 0, 0, 0, 1, 0]",214,132,82,12,6,0.09090909090909091,0.07317073170731707
"[0, 0, 1, 0, 1, 1, 0, 1, 1, 0, 0, 1, 1, 0, 0]",155,79,76,6,4,0.0759493670886076,0.05263157894736842
"[0, 0, 0, 1, 0, 1, 0, 0, 0, 0, 1, 0, 0, 1, 0]",480,323,157,32,16,0.09907120743034056,0.10191082802547771
"[0, 1, 1, 0, 0, 1, 0, 1, 0, 1, 0, 0, 0, 1, 0]",137,87,50,13,2,0.14942528735632185,0.04
"[0, 0, 0, 0, 0, 1, 1, 1, 1, 0, 1, 0, 1, 1, 0]",183,116,67,10,8,0.08620689655172414,0.11940298507462686
"[1, 0, 1, 0, 1, 1, 1, 1, 0, 1, 0, 0, 0, 0, 1]",141,63,78,6,8,0.09523809523809523,0.10256410256410256
"[1, 0, 0, 1, 0, 1, 1, 1, 0, 1, 1, 0, 1, 0, 1]",129,56,73,6,9,0.10714285714285714,0.1232876712328767
"[0, 1, 0, 1, 1, 1, 1, 1, 0, 0, 1, 0, 0, 1, 0]",92,37,55,2,3,0.05405405405405406,0.05454545454545454
"[1, 0, 1, 0, 1, 1, 1, 1, 1, 0, 0, 1, 0, 0, 1]",133,52,81,3,5,0.057692307692307696,0.06172839506172839
"[1, 0, 0, 0, 0, 0, 0, 1, 0, 1, 1, 1, 1, 1, 0]",166,69,97,9,10,0.13043478260869565,0.10309278350515463
"[1, 1, 0, 0, 1, 0, 0, 1, 0, 1, 1, 0, 0, 0, 0]",204,116,88,11,6,0.09482758620689655,0.06818181818181818
"[1, 0, 0, 1, 0, 0, 0, 1, 1, 0, 1, 1, 1, 0, 0]",112,46,66,9,10,0.1956521739130435,0.15151515151515152
"[0, 0, 0, 0, 1, 1, 0, 1, 0, 1, 1, 0, 0, 1, 0]",161,99,62,9,10,0.09090909090909091,0.16129032258064516
"[1, 1, 1, 0, 0, 1, 1, 1, 0, 1, 0, 1, 1, 1, 0]",235,69,166,3,20,0.043478260869565216,0.12048192771084337
"[1, 0, 0, 1, 1, 1, 1, 0, 0, 1, 1, 1, 0, 1, 0]",253,62,191,5,17,0.08064516129032258,0.08900523560209424
"[0, 1, 0, 0, 1, 1, 0, 0, 1, 0, 0, 0, 1, 0, 1]",114,65,49,8,6,0.12307692307692308,0.12244897959183673
"[1, 1, 0, 0, 0, 0, 1, 0, 1, 0, 0, 1, 1, 0, 0]",262,154,108,12,12,0.07792207792207792,0.1111111111111111
"[1, 0, 0, 0, 0, 0, 1, 0, 0, 1, 1, 1, 0, 1, 0]",143,81,62,5,6,0.06172839506172839,0.0967741935483871
"[0, 1, 0, 0, 0, 0, 0, 1, 0, 0, 1, 1, 1, 0, 1]",133,89,44,8,6,0.0898876404494382,0.13636363636363635
"[1, 0, 0, 1, 0, 1, 0, 0, 1, 0, 1, 0, 1, 0, 0]",152,90,62,6,7,0.06666666666666667,0.11290322580645161
"[0, 0, 0, 0, 0, 1, 1, 0, 0, 0, 1, 0, 1, 1, 0]",317,236,81,24,6,0.1016949152542373,0.07407407407407407
"[0, 0, 0, 0, 0, 1, 0, 0, 0, 1, 0, 0, 1, 0, 1]",536,381,155,36,7,0.09448818897637795,0.04516129032258064
"[0, 0, 1, 1, 1, 0, 1, 1, 1, 1, 1, 0, 1, 1, 1]",640,211,429,13,34,0.061611374407582936,0.07925407925407925
"[1, 0, 0, 0, 1, 0, 0, 1, 1, 1, 1, 1, 0, 0, 0]",151,64,87,11,8,0.171875,0.09195402298850575
"[0, 0, 1, 0, 0, 0, 1, 0, 0, 1, 1, 1, 1, 1, 0]",129,67,62,7,7,0.1044776119402985,0.11290322580645161
"[1, 0, 1, 1, 1, 0, 0, 0, 0, 1, 1, 1, 1, 0, 1]",171,83,88,11,6,0.13253012048192772,0.06818181818181818
"[1, 1, 0, 1, 1, 0, 0, 1, 0, 1, 1, 0, 1, 1, 1]",252,82,170,4,14,0.04878048780487805,0.08235294117647059
"[0, 1, 0, 0, 0, 1, 0, 1, 1, 1, 1, 0, 0, 1, 0]",98,54,44,4,2,0.07407407407407407,0.045454545454545456
"[1, 0, 1, 0, 0, 1, 1, 1, 1, 0, 1, 1, 0, 0, 1]",166,81,85,9,10,0.1111111111111111,0.11764705882352941
"[0, 1, 0, 1, 0, 1, 0, 1, 0, 0, 1, 1, 1, 1, 0]",136,67,69,5,10,0.07462686567164178,0.14492753623188406
"[0, 0, 1, 0, 0, 1, 1, 0, 0, 1, 0, 1, 0, 1, 0]",163,92,71,14,6,0.15217391304347827,0.08450704225352113
"[1, 1, 1, 1, 1, 1, 0, 0, 1, 0, 0, 1, 1, 0, 1]",286,88,198,11,16,0.125,0.08080808080808081
"[1, 1, 0, 0, 1, 1, 0, 1, 1, 0, 1, 0, 1, 1, 1]",313,112,201,15,14,0.13392857142857142,0.06965174129353234
"[1, 0, 0, 0, 1, 0, 1, 1, 0, 1, 0, 0, 1, 1, 1]",166,76,90,4,6,0.05263157894736842,0.06666666666666667
"[0, 1, 0, 0, 0, 1, 0, 1, 1, 0, 1, 0, 0, 1, 1]",137,72,65,6,2,0.08333333333333333,0.03076923076923077
"[0, 0, 0, 0, 1, 1, 1, 0, 0, 0, 1, 1, 0, 1, 0]",141,93,48,6,3,0.06451612903225806,0.0625
"[1, 1, 1, 1, 0, 0, 0, 0, 0, 1, 1, 1, 0, 1, 0]",148,73,75,8,5,0.1095890410958904,0.06666666666666667
"[1, 1, 1, 1, 1, 0, 1, 1, 0, 0, 0, 0, 0, 1, 0]",131,63,68,6,4,0.09523809523809523,0.058823529411764705
"[1, 1, 0, 0, 1, 1, 1, 1, 1, 0, 1, 1, 0, 0, 0]",198,89,109,7,13,0.07865168539325842,0.11926605504587157
"[0, 0, 1, 1, 0, 1, 1, 1, 1, 0, 0, 0, 0, 0, 1]",140,77,63,8,4,0.1038961038961039,0.06349206349206349
"[1, 0, 1, 1, 0, 1, 0, 1, 1, 0, 0, 0, 1, 1, 0]",140,67,73,7,7,0.1044776119402985,0.0958904109589041
"[0, 1, 1, 1, 1, 1, 0, 0, 1, 0, 0, 1, 0, 0, 0]",111,63,48,4,5,0.06349206349206349,0.10416666666666667
"[1, 1, 1, 1, 0, 1, 0, 1, 1, 1, 1, 0, 0, 1, 0]",257,78,179,10,16,0.1282051282051282,0.0893854748603352
"[1, 1, 1, 0, 1, 1, 1, 1, 0, 1, 0, 1, 0, 0, 1]",223,79,144,6,11,0.0759493670886076,0.0763888888888889
"[1, 0, 0, 1, 1, 1, 0, 1, 1, 1, 0, 0, 1, 0, 0]",132,61,71,7,7,0.11475409836065574,0.09859154929577464
"[0, 0, 0, 0, 1, 0, 1, 0, 0, 1, 1, 1, 1, 0, 1]",113,54,59,3,3,0.05555555555555555,0.05084745762711865
"[1, 0, 0, 0, 0, 1, 0, 1, 0, 0, 1, 1, 1, 1, 0]",171,82,89,9,5,0.10975609756097561,0.056179775280898875
"[1, 0, 0, 1, 0, 0, 1, 0, 0, 0, 0, 1, 0, 1, 0]",228,154,74,13,11,0.08441558441558442,0.14864864864864866
"[0, 1, 0, 0, 1, 1, 1, 1, 0, 1, 0, 0, 0, 0, 1]",138,69,69,7,4,0.10144927536231885,0.057971014492753624
"[1, 0, 0, 0, 1, 1, 0, 1, 0, 1, 1, 1, 1, 1, 0]",165,67,98,11,13,0.16417910447761194,0.1326530612244898
"[1, 1, 1, 1, 1, 0, 0, 0, 1, 0, 0, 1, 1, 0, 1]",162,58,104,6,6,0.10344827586206896,0.057692307692307696
"[0, 1, 0, 1, 1, 0, 0, 0, 0, 0, 0, 1, 0, 1, 1]",194,119,75,7,8,0.058823529411764705,0.10666666666666667
"[1, 1, 0, 1, 0, 0, 0, 0, 1, 0, 1, 0, 0, 0, 1]",182,110,72,11,8,0.1,0.1111111111111111
"[0, 1, 1, 0, 0, 0, 0, 1, 1, 0, 0, 1, 1, 0, 1]",386,305,81,28,7,0.09180327868852459,0.08641975308641975
"[1, 0, 1, 1, 1, 0, 1, 1, 1, 0, 0, 0, 1, 1, 1]",276,100,176,16,13,0.16,0.07386363636363637
"[1, 1, 1, 1, 1, 0, 0, 0, 0, 0, 1, 1, 0, 1, 0]",164,66,98,4,13,0.06060606060606061,0.1326530612244898
"[0, 1, 1, 0, 0, 1, 1, 0, 1, 1, 1, 1, 1, 0, 0]",230,101,129,12,7,0.1188118811881188,0.05426356589147287
"[0, 1, 1, 1, 1, 0, 0, 1, 0, 1, 1, 0, 1, 0, 0]",134,77,57,7,4,0.09090909090909091,0.07017543859649122
"[0, 1, 0, 0, 0, 0, 0, 0, 1, 0, 1, 0, 1, 1, 1]",208,133,75,13,5,0.09774436090225563,0.06666666666666667
"[0, 0, 1, 1, 0, 0, 0, 1, 0, 0, 0, 0, 0, 1, 0]",533,377,156,35,14,0.09283819628647215,0.08974358974358974
"[0, 0, 0, 0, 0, 1, 0, 1, 0, 1, 0, 1, 1, 0, 0]",238,153,85,13,7,0.08496732026143791,0.08235294117647059
"[1, 1, 1, 0, 1, 0, 0, 0, 1, 0, 1, 1, 0, 0, 0]",120,65,55,6,4,0.09230769230769231,0.07272727272727272
"[1, 1, 0, 0, 1, 1, 1, 0, 1, 1, 1, 0, 1, 0, 0]",164,65,99,5,6,0.07692307692307693,0.06060606060606061
"[0, 1, 0, 1, 1, 1, 1, 0, 1, 1, 1, 0, 0, 1, 1]",288,100,188,13,30,0.13,0.1595744680851064
"[1, 1, 1, 0, 0, 1, 0, 1, 1, 1, 0, 1, 0, 1, 1]",267,94,173,12,16,0.1276595744680851,0.09248554913294797
"[0, 1, 1, 1, 0, 0, 0, 1, 0, 1, 1, 1, 0, 0, 1]",123,59,64,7,2,0.11864406779661017,0.03125
"[1, 1, 1, 0, 0, 0, 1, 1, 1, 0, 0, 0, 1, 0, 1]",129,59,70,6,8,0.1016949152542373,0.11428571428571428
"[1, 1, 0, 0, 0, 1, 1, 1, 1, 0, 0, 0, 1, 1, 1]",237,101,136,12,14,0.1188118811881188,0.10294117647058823
"[0, 1, 0, 1, 0, 0, 1, 1, 1, 0, 1, 1, 1, 0, 1]",146,57,89,4,10,0.07017543859649122,0.11235955056179775
"[1, 1, 1, 1, 1, 1, 0, 1, 0, 0, 1, 0, 1, 1, 0]",242,70,172,9,15,0.12857142857142856,0.0872093023255814
"[0, 0, 0, 1, 0, 0, 1, 0, 1, 0, 0, 0, 1, 0, 0]",502,342,160,40,15,0.11695906432748537,0.09375
"[1, 0, 1, 0, 1, 1, 0, 0, 1, 1, 0, 0, 0, 1, 0]",123,68,55,8,7,0.11764705882352941,0.12727272727272726
"[1, 1, 1, 0, 0, 1, 1, 1, 0, 1, 0, 1, 0, 1, 1]",322,93,229,8,23,0.08602150537634409,0.10043668122270742
"[0, 0, 1, 0, 0, 0, 0, 1, 0, 1, 0, 0, 1, 1, 0]",263,179,84,18,6,0.1005586592178771,0.07142857142857142
"[0, 0, 0, 1, 0, 0, 1, 0, 1, 0, 0, 0, 0, 1, 1]",337,221,116,21,21,0.09502262443438914,0.1810344827586207
"[1, 0, 1, 0, 1, 1, 1, 1, 0, 1, 1, 1, 0, 0, 1]",256,89,167,11,22,0.12359550561797752,0.1317365269461078
"[0, 1, 0, 1, 0, 1, 1, 1, 1, 0, 1, 1, 1, 0, 0]",169,75,94,8,15,0.10666666666666667,0.1595744680851064
"[0, 0, 0, 1, 0, 0, 0, 1, 1, 1, 1, 0, 0, 0, 0]",597,399,198,36,14,0.09022556390977443,0.0707070707070707
"[1, 1, 0, 0, 1, 0, 1, 1, 0, 0, 1, 1, 0, 0, 1]",211,94,117,9,13,0.09574468085106383,0.1111111111111111
"[0, 0, 0, 1, 0, 1, 1, 0, 0, 0, 0, 1, 0, 0, 1]",256,174,82,13,8,0.07471264367816093,0.0975609756097561
"[1, 1, 1, 1, 0, 1, 0, 0, 1, 1, 0, 0, 0, 1, 0]",131,67,64,7,8,0.1044776119402985,0.125
"[0, 1, 0, 0, 1, 1, 0, 1, 0, 1, 0, 0, 0, 1, 0]",135,90,45,5,5,0.05555555555555555,0.1111111111111111
"[1, 1, 0, 1, 1, 0, 1, 1, 1, 1, 0, 1, 0, 0, 1]",247,85,162,15,11,0.17647058823529413,0.06790123456790123
"[0, 0, 1, 1, 0, 1, 1, 0, 1, 1, 1, 1, 0, 1, 0]",138,55,83,10,8,0.18181818181818182,0.0963855421686747
"[1, 1, 0, 1, 1, 0, 0, 1, 1, 1, 0, 0, 1, 1, 1]",347,140,207,13,25,0.09285714285714286,0.12077294685990338
"[0, 1, 0, 0, 0, 0, 1, 0, 0, 1, 0, 1, 1, 0, 1]",120,75,45,10,5,0.13333333333333333,0.1111111111111111
"[1, 1, 0, 0, 0, 1, 0, 1, 1, 0, 0, 1, 0, 0, 0]",147,79,68,6,7,0.0759493670886076,0.10294117647058823
"[1, 1, 1, 0, 0, 0, 0, 1, 0, 1, 0, 0, 1, 0, 0]",183,79,104,12,17,0.1518987341772152,0.16346153846153846
"[1, 0, 1, 0, 1, 0, 1, 1, 1, 1, 0, 0, 0, 1, 0]",116,46,70,5,8,0.10869565217391304,0.11428571428571428
"[0, 0, 1, 0, 0, 0, 1, 1, 0, 1, 0, 0, 0, 1, 1]",179,102,77,10,9,0.09803921568627451,0.11688311688311688
"[1, 0, 0, 0, 1, 0, 1, 1, 1, 1, 0, 1, 1, 1, 1]",309,104,205,8,26,0.07692307692307693,0.12682926829268293
"[1, 0, 1, 1, 0, 1, 0, 0, 1, 0, 0, 1, 0, 0, 1]",113,59,54,6,5,0.1016949152542373,0.09259259259259259
"[0, 0, 0, 0, 0, 1, 0, 1, 1, 0, 1, 0, 1, 0, 1]",138,85,53,5,5,0.058823529411764705,0.09433962264150944
"[1, 0, 1, 0, 1, 1, 0, 1, 1, 0, 1, 0, 1, 0, 0]",121,61,60,8,5,0.13114754098360656,0.08333333333333333
"[1, 1, 1, 0, 0, 1, 1, 1, 0, 1, 0, 1, 0, 1, 0]",142,60,82,10,7,0.16666666666666666,0.08536585365853659
"[0, 1, 0, 0, 1, 1, 1, 1, 0, 0, 0, 0, 1, 0, 0]",177,101,76,10,9,0.09900990099009901,0.11842105263157894
"[0, 0, 1, 1, 1, 1, 0, 0, 1, 0, 0, 0, 1, 1, 1]",266,135,131,10,17,0.07407407407407407,0.1297709923664122
"[0, 1, 1, 1, 0, 0, 0, 1, 1, 0, 0, 0, 0, 1, 1]",282,155,127,18,11,0.11612903225806452,0.08661417322834646
"[0, 1, 1, 1, 0, 0, 0, 1, 0, 0, 0, 1, 0, 0, 0]",236,157,79,20,7,0.12738853503184713,0.08860759493670886
"[0, 0, 1, 0, 1, 0, 0, 1, 1, 1, 1, 0, 0, 1, 0]",123,70,53,7,3,0.1,0.05660377358490566
"[1, 0, 1, 0, 0, 0, 0, 1, 0, 1, 0, 1, 1, 0, 0]",144,81,63,10,9,0.12345679012345678,0.14285714285714285
"[0, 0, 0, 0, 1, 1, 1, 1, 0, 1, 0, 0, 1, 0, 1]",143,73,70,8,9,0.1095890410958904,0.12857142857142856
"[1, 0, 1, 0, 0, 0, 0, 0, 1, 0, 0, 0, 1, 1, 1]",224,132,92,9,7,0.06818181818181818,0.07608695652173914
"[1, 1, 0, 0, 1, 1, 1, 1, 1, 0, 0, 1, 1, 0, 0]",425,159,266,13,21,0.08176100628930817,0.07894736842105263
"[1, 0, 0, 1, 0, 1, 0, 1, 0, 0, 1, 1, 0, 0, 0]",192,93,99,7,12,0.07526881720430108,0.12121212121212122
"[0, 0, 0, 1, 1, 1, 1, 1, 0, 0, 0, 0, 1, 1, 1]",438,248,190,12,14,0.04838709677419355,0.07368421052631578
"[0, 1, 0, 1, 0, 0, 1, 1, 1, 0, 1, 1, 0, 1, 1]",127,43,84,0,9,0.0,0.10714285714285714
"[1, 1, 1, 0, 0, 0, 0, 0, 1, 0, 0, 1, 0, 1, 0]",157,82,75,8,4,0.0975609756097561,0.05333333333333334
"[0, 0, 0, 1, 0, 0, 1, 1, 1, 0, 0, 1, 0, 1, 1]",121,64,57,9,3,0.140625,0.05263157894736842
"[0, 1, 1, 0, 1, 1, 1, 0, 0, 0, 1, 1, 0, 1, 1]",173,84,89,5,6,0.05952380952380952,0.06741573033707865
"[1, 0, 0, 0, 1, 1, 1, 0, 1, 0, 0, 0, 1, 0, 1]",107,56,51,4,7,0.07142857142857142,0.13725490196078433
"[1, 0, 1, 0, 0, 1, 0, 1, 1, 0, 1, 1, 0, 1, 1]",128,52,76,5,9,0.09615384615384616,0.11842105263157894
"[0, 1, 0, 0, 1, 1, 1, 1, 1, 1, 1, 1, 1, 1, 0]",972,342,630,38,65,0.1111111111111111,0.10317460317460317
"[1, 0, 1, 0, 1, 0, 0, 1, 0, 1, 1, 1, 0, 0, 1]",121,56,65,1,8,0.017857142857142856,0.12307692307692308
"[1, 1, 1, 0, 0, 1, 1, 0, 1, 0, 1, 0, 0, 1, 0]",102,42,60,3,6,0.07142857142857142,0.1
"[0, 0, 1, 0, 0, 1, 0, 1, 0, 0, 0, 1, 0, 0, 1]",240,153,87,12,9,0.0784313725490196,0.10344827586206896
"[0, 0, 0, 0, 1, 1, 0, 1, 1, 1, 0, 1, 1, 0, 1]",120,50,70,5,6,0.1,0.08571428571428572
"[0, 0, 0, 0, 1, 0, 1, 1, 1, 1, 1, 0, 1, 1, 1]",197,85,112,11,15,0.12941176470588237,0.13392857142857142
"[1, 0, 1, 0, 0, 1, 1, 1, 0, 0, 0, 0, 1, 1, 1]",211,103,108,6,8,0.05825242718446602,0.07407407407407407
"[1, 0, 1, 0, 1, 0, 0, 0, 0, 0, 1, 0, 1, 1, 1]",142,84,58,6,5,0.07142857142857142,0.08620689655172414
"[0, 0, 1, 0, 0, 1, 1, 1, 0, 1, 0, 1, 0, 0, 0]",141,91,50,12,2,0.13186813186813187,0.04
"[0, 1, 1, 0, 0, 0, 1, 0, 1, 1, 0, 0, 1, 1, 0]",163,95,68,6,3,0.06315789473684211,0.04411764705882353
"[1, 0, 0, 1, 1, 0, 0, 0, 1, 0, 1, 1, 0, 0, 1]",129,64,65,3,7,0.046875,0.1076923076923077
"[1, 0, 0, 0, 1, 0, 0, 1, 1, 1, 1, 1, 0, 1, 0]",124,52,72,3,12,0.057692307692307696,0.16666666666666666
"[1, 1, 0, 1, 1, 0, 1, 0, 0, 0, 1, 0, 0, 1, 1]",122,75,47,11,4,0.14666666666666667,0.0851063829787234
"[0, 1, 0, 0, 0, 1, 1, 1, 0, 1, 1, 1, 1, 0, 1]",117,38,79,3,9,0.07894736842105263,0.11392405063291139
"[1, 0, 1, 1, 1, 0, 1, 0, 0, 0, 1, 1, 0, 0, 1]",148,62,86,8,10,0.12903225806451613,0.11627906976744186
"[1, 1, 1, 0, 1, 1, 1, 0, 1, 0, 0, 0, 1, 1, 0]",163,56,107,7,10,0.125,0.09345794392523364
"[1, 1, 0, 0, 0, 1, 1, 1, 1, 1, 1, 0, 0, 0, 1]",248,88,160,11,17,0.125,0.10625
"[0, 1, 0, 0, 1, 0, 1, 1, 0, 0, 0, 1, 1, 0, 1]",122,62,60,8,4,0.12903225806451613,0.06666666666666667
"[0, 1, 0, 0, 1, 1, 0, 1, 0, 1, 1, 1, 0, 1, 0]",104,43,61,6,6,0.13953488372093023,0.09836065573770492
"[1, 0, 1, 1, 1, 1, 1, 0, 0, 1, 1, 1, 0, 0, 1]",279,97,182,10,19,0.10309278350515463,0.1043956043956044
"[1, 1, 0, 0, 0, 1, 0, 1, 0, 0, 1, 0, 0, 0, 0]",295,183,112,16,11,0.08743169398907104,0.09821428571428571
"[1, 1, 0, 1, 0, 0, 1, 1, 1, 0, 0, 1, 0, 1, 0]",110,49,61,1,3,0.02040816326530612,0.04918032786885246
"[0, 1, 0, 0, 0, 0, 1, 1, 1, 0, 1, 0, 0, 1, 1]",137,72,65,8,10,0.1111111111111111,0.15384615384615385
"[1, 1, 1, 0, 1, 1, 0, 0, 1, 1, 0, 1, 0, 1, 0]",149,62,87,7,12,0.11290322580645161,0.13793103448275862
"[0, 1, 0, 1, 1, 1, 1, 0, 1, 1, 0, 1, 0, 1, 1]",269,95,174,9,14,0.09473684210526316,0.08045977011494253
"[1, 1, 0, 1, 0, 1, 1, 1, 1, 0, 1, 1, 0, 1, 0]",208,87,121,7,7,0.08045977011494253,0.05785123966942149
"[0, 1, 1, 0, 0, 0, 0, 0, 0, 0, 1, 1, 0, 1, 0]",299,195,104,21,12,0.1076923076923077,0.11538461538461539
"[1, 1, 1, 0, 1, 0, 0, 1, 0, 1, 1, 0, 0, 0, 0]",133,66,67,3,8,0.045454545454545456,0.11940298507462686
"[0, 1, 0, 1, 1, 0, 1, 1, 1, 0, 1, 1, 1, 0, 0]",144,59,85,3,6,0.05084745762711865,0.07058823529411765
"[0, 1, 0, 0, 1, 1, 0, 0, 0, 1, 0, 1, 1, 0, 1]",95,59,36,6,5,0.1016949152542373,0.1388888888888889
"[0, 1, 0, 0, 1, 1, 0, 1, 1, 0, 0, 1, 0, 1, 1]",110,52,58,2,7,0.038461538461538464,0.1206896551724138
"[0, 1, 0, 0, 1, 1, 0, 1, 0, 0, 0, 0, 0, 0, 1]",263,163,100,20,12,0.12269938650306748,0.12
"[0, 0, 1, 1, 1, 1, 0, 1, 1, 1, 1, 1, 0, 1, 0]",266,100,166,9,20,0.09,0.12048192771084337
"[1, 1, 1, 1, 1, 0, 0, 0, 1, 1, 1, 1, 0, 0, 0]",326,108,218,8,22,0.07407407407407407,0.10091743119266056
"[1, 0, 0, 0, 1, 1, 1, 1, 0, 0, 1, 0, 1, 0, 0]",119,63,56,3,5,0.047619047619047616,0.08928571428571429
"[1, 1, 0, 0, 0, 0, 1, 0, 0, 1, 0, 0, 0, 1, 0]",268,171,97,13,4,0.07602339181286549,0.041237113402061855
"[1, 0, 0, 0, 0, 1, 0, 0, 0, 0, 1, 1, 0, 1, 1]",194,95,99,10,7,0.10526315789473684,0.0707070707070707
"[0, 0, 0, 0, 1, 1, 0, 1, 0, 1, 0, 0, 1, 0, 0]",253,157,96,13,11,0.08280254777070063,0.11458333333333333
"[0, 0, 0, 0, 0, 1, 1, 0, 1, 0, 1, 0, 0, 1, 0]",262,172,90,13,12,0.0755813953488372,0.13333333333333333
"[1, 1, 1, 1, 0, 0, 1, 0, 0, 0, 1, 1, 1, 0, 0]",147,57,90,4,8,0.07017543859649122,0.08888888888888889
"[0, 1, 0, 0, 1, 0, 1, 1, 0, 0, 1, 0, 1, 0, 0]",130,86,44,9,5,0.10465116279069768,0.11363636363636363
"[0, 1, 0, 0, 1, 1, 1, 0, 1, 0, 0, 0, 0, 0, 1]",174,95,79,9,10,0.09473684210526316,0.12658227848101267
"[0, 0, 0, 0, 1, 0, 1, 1, 1, 1, 0, 1, 0, 1, 1]",139,77,62,14,6,0.18181818181818182,0.0967741935483871
"[0, 1, 0, 0, 1, 0, 0, 1, 0, 1, 0, 0, 1, 0, 1]",110,67,43,9,8,0.13432835820895522,0.18604651162790697
"[0, 0, 1, 1, 0, 0, 0, 0, 1, 1, 0, 1, 1, 0, 1]",218,110,108,6,13,0.05454545454545454,0.12037037037037036
"[1, 0, 1, 0, 0, 0, 0, 1, 1, 1, 0, 1, 0, 1, 1]",128,65,63,7,8,0.1076923076923077,0.12698412698412698
"[1, 1, 0, 1, 0, 0, 0, 0, 1, 1, 1, 0, 1, 0, 1]",108,52,56,3,6,0.057692307692307696,0.10714285714285714
"[1, 0, 0, 1, 1, 0, 1, 0, 0, 0, 0, 1, 1, 1, 0]",118,71,47,8,9,0.11267605633802817,0.19148936170212766
"[1, 1, 0, 1, 1, 0, 0, 0, 1, 0, 1, 0, 0, 1, 0]",88,54,34,8,1,0.14814814814814814,0.029411764705882353
"[1, 1, 0, 1, 0, 0, 1, 1, 1, 1, 0, 1, 1, 0, 0]",152,61,91,5,9,0.08196721311475409,0.0989010989010989
"[1, 0, 0, 0, 1, 0, 0, 1, 0, 0, 0, 1, 0, 0, 0]",529,364,165,35,19,0.09615384615384616,0.11515151515151516
"[1, 1, 0, 0, 1, 0, 1, 0, 1, 1, 0, 0, 1, 1, 1]",277,129,148,18,16,0.13953488372093023,0.10810810810810811
"[1, 0, 0, 0, 0, 0, 0, 1, 0, 1, 1, 0, 1, 1, 1]",191,75,116,7,14,0.09333333333333334,0.1206896551724138
"[1, 1, 0, 0, 1, 0, 0, 1, 0, 0, 1, 1, 1, 0, 0]",116,59,57,5,5,0.0847457627118644,0.08771929824561403
"[1, 1, 0, 1, 0, 1, 1, 1, 1, 0, 0, 0, 0, 0, 0]",326,150,176,14,20,0.09333333333333334,0.11363636363636363
"[0, 0, 1, 0, 1, 1, 0, 1, 1, 1, 1, 1, 0, 0, 0]",142,74,68,2,3,0.02702702702702703,0.04411764705882353
"[0, 1, 0, 0, 1, 1, 0, 0, 1, 1, 1, 0, 1, 1, 1]",181,91,90,11,12,0.12087912087912088,0.13333333333333333
"[1, 1, 1, 0, 1, 1, 0, 0, 1, 1, 0, 1, 0, 0, 1]",156,58,98,7,10,0.1206896551724138,0.10204081632653061
"[1, 1, 0, 1, 0, 0, 1, 0, 1, 1, 1, 1, 0, 1, 1]",264,101,163,10,15,0.09900990099009901,0.09202453987730061
"[1, 0, 1, 0, 0, 0, 1, 0, 1, 0, 1, 1, 0, 1, 0]",109,54,55,5,7,0.09259259259259259,0.12727272727272726
"[0, 1, 1, 1, 0, 1, 1, 0, 0, 1, 0, 1, 0, 0, 0]",118,56,62,4,5,0.07142857142857142,0.08064516129032258
"[0, 1, 0, 0, 1, 0, 1, 1, 1, 0, 1, 1, 0, 0, 1]",131,56,75,5,8,0.08928571428571429,0.10666666666666667
"[0, 0, 1, 1, 1, 0, 0, 0, 1, 1, 1, 0, 0, 1, 1]",166,86,80,12,8,0.13953488372093023,0.1
"[0, 1, 0, 1, 0, 0, 1, 1, 0, 0, 0, 0, 1, 0, 1]",168,97,71,7,4,0.07216494845360824,0.056338028169014086
"[0, 1, 1, 0, 1, 1, 1, 1, 1, 1, 0, 0, 1, 0, 1]",256,93,163,5,12,0.053763440860215055,0.0736196319018405
"[0, 1, 1, 1, 1, 1, 0, 0, 0, 1, 1, 0, 1, 1, 1]",311,140,171,15,18,0.10714285714285714,0.10526315789473684
"[1, 1, 0, 0, 0, 1, 0, 0, 1, 0, 0, 0, 1, 0, 0]",263,166,97,18,6,0.10843373493975904,0.061855670103092786
"[1, 0, 1, 0, 0, 0, 1, 0, 1, 1, 1, 1, 1, 0, 1]",132,56,76,4,5,0.07142857142857142,0.06578947368421052
"[1, 0, 1, 0, 1, 1, 0, 0, 0, 0, 1, 1, 1, 1, 0]",272,126,146,17,16,0.1349206349206349,0.1095890410958904
"[0, 0, 0, 1, 0, 0, 1, 1, 1, 1, 0, 1, 1, 0, 1]",124,62,62,6,9,0.0967741935483871,0.14516129032258066
"[0, 0, 1, 1, 0, 1, 0, 0, 0, 1, 1, 0, 1, 1, 0]",113,64,49,6,4,0.09375,0.08163265306122448
"[0, 1, 0, 0, 0, 1, 1, 0, 0, 1, 0, 1, 1, 1, 1]",144,70,74,4,7,0.05714285714285714,0.0945945945945946
"[0, 1, 1, 1, 0, 1, 0, 0, 0, 1, 1, 1, 0, 1, 1]",137,60,77,6,12,0.1,0.15584415584415584
"[1, 0, 1, 1, 0, 0, 0, 1, 1, 1, 1, 1, 0, 0, 0]",145,57,88,10,11,0.17543859649122806,0.125
"[0, 0, 0, 0, 0, 1, 1, 1, 0, 1, 0, 0, 0, 1, 0]",244,165,79,16,7,0.09696969696969697,0.08860759493670886
"[0, 0, 1, 0, 0, 0, 0, 0, 0, 1, 1, 1, 0, 1, 0]",269,177,92,23,9,0.12994350282485875,0.09782608695652174
"[1, 1, 0, 1, 1, 0, 0, 1, 1, 1, 1, 0, 1, 1, 1]",631,207,424,18,45,0.08695652173913043,0.10613207547169812
"[1, 1, 1, 0, 1, 1, 1, 1, 1, 0, 0, 0, 1, 0, 1]",226,80,146,12,13,0.15,0.08904109589041095
"[0, 1, 1, 0, 1, 1, 1, 0, 1, 0, 0, 0, 1, 1, 0]",130,60,70,7,3,0.11666666666666667,0.04285714285714286
"[0, 0, 0, 0, 0, 0, 1, 1, 1, 0, 1, 0, 1, 0, 1]",194,114,80,11,5,0.09649122807017543,0.0625
"[1, 0, 1, 0, 0, 0, 1, 1, 1, 1, 1, 1, 0, 1, 1]",281,108,173,12,14,0.1111111111111111,0.08092485549132948
"[0, 0, 1, 1, 1, 0, 0, 1, 0, 1, 1, 1, 1, 0, 0]",149,68,81,10,9,0.14705882352941177,0.1111111111111111
"[1, 1, 0, 0, 1, 1, 0, 1, 1, 0, 0, 0, 1, 0, 1]",118,55,63,6,10,0.10909090909090909,0.15873015873015872
"[0, 1, 0, 0, 1, 0, 1, 1, 0, 0, 1, 1, 0, 1, 0]",108,51,57,5,4,0.09803921568627451,0.07017543859649122
"[0, 0, 0, 1, 0, 0, 1, 1, 0, 0, 1, 0, 1, 1, 0]",148,89,59,8,3,0.0898876404494382,0.05084745762711865
"[0, 0, 1, 1, 1, 1, 0, 0, 0, 1, 1, 0, 1, 0, 0]",133,73,60,9,2,0.1232876712328767,0.03333333333333333
"[0, 0, 1, 1, 0, 0, 1, 0, 1, 0, 0, 1, 0, 1, 0]",124,73,51,3,3,0.0410958904109589,0.058823529411764705
"[0, 1, 1, 1, 0, 1, 1, 1, 1, 1, 1, 0, 0, 1, 0]",214,77,137,7,13,0.09090909090909091,0.0948905109489051
"[1, 1, 1, 0, 0, 0, 0, 0, 0, 1, 1, 0, 1, 0, 0]",260,104,156,10,14,0.09615384615384616,0.08974358974358974
"[1, 0, 0, 1, 1, 0, 1, 0, 1, 0, 0, 1, 1, 0, 1]",111,49,62,4,4,0.08163265306122448,0.06451612903225806
"[0, 1, 1, 0, 1, 1, 0, 0, 0, 0, 0, 1, 1, 0, 1]",135,83,52,9,5,0.10843373493975904,0.09615384615384616
"[0, 0, 1, 1, 1, 1, 0, 0, 0, 1, 1, 0, 0, 0, 0]",325,191,134,28,14,0.14659685863874344,0.1044776119402985
"[0, 0, 0, 1, 1, 0, 1, 0, 1, 0, 1, 1, 1, 1, 0]",126,60,66,7,4,0.11666666666666667,0.06060606060606061
"[1, 0, 1, 0, 1, 1, 1, 0, 1, 0, 0, 1, 0, 0, 1]",101,43,58,3,4,0.06976744186046512,0.06896551724137931
"[0, 1, 0, 0, 1, 1, 0, 1, 0, 0, 1, 1, 1, 0, 0]",130,71,59,5,3,0.07042253521126761,0.05084745762711865
"[1, 0, 1, 1, 0, 1, 0, 0, 1, 0, 1, 0, 0, 0, 1]",110,48,62,5,4,0.10416666666666667,0.06451612903225806
"[0, 1, 0, 1, 1, 0, 1, 0, 0, 1, 0, 1, 0, 0, 0]",151,95,56,7,7,0.07368421052631578,0.125
"[0, 0, 0, 1, 1, 0, 0, 0, 1, 0, 0, 1, 1, 1, 1]",285,178,107,16,5,0.0898876404494382,0.04672897196261682
"[1, 0, 0, 1, 1, 0, 0, 1, 1, 0, 0, 0, 1, 0, 0]",266,106,160,9,17,0.08490566037735849,0.10625
"[1, 1, 0, 0, 1, 0, 0, 0, 1, 0, 0, 0, 0, 1, 1]",203,112,91,7,9,0.0625,0.0989010989010989
"[0, 1, 1, 0, 1, 1, 1, 0, 0, 0, 0, 1, 0, 0, 1]",119,64,55,8,3,0.125,0.05454545454545454
"[1, 1, 0, 0, 1, 0, 0, 1, 1, 1, 1, 0, 0, 1, 0]",143,62,81,8,11,0.12903225806451613,0.13580246913580246
"[0, 1, 0, 0, 0, 1, 1, 1, 0, 0, 1, 1, 1, 0, 1]",120,53,67,5,10,0.09433962264150944,0.14925373134328357
"[0, 0, 1, 1, 0, 1, 0, 1, 0, 0, 0, 1, 1, 1, 1]",177,80,97,10,7,0.125,0.07216494845360824
"[1, 1, 1, 0, 1, 1, 0, 0, 1, 0, 1, 1, 0, 0, 0]",139,71,68,5,8,0.07042253521126761,0.11764705882352941
"[1, 1, 0, 0, 0, 0, 0, 1, 0, 0, 1, 1, 1, 0, 1]",122,60,62,5,4,0.08333333333333333,0.06451612903225806
"[0, 0, 0, 1, 1, 1, 0, 0, 0, 0, 0, 1, 0, 0, 1]",282,197,85,13,11,0.06598984771573604,0.12941176470588237
"[1, 1, 1, 1, 0, 1, 1, 0, 0, 0, 0, 0, 1, 1, 0]",148,71,77,6,10,0.08450704225352113,0.12987012987012986
"[0, 0, 1, 0, 0, 1, 1, 1, 1, 0, 1, 1, 0, 0, 0]",138,74,64,10,4,0.13513513513513514,0.0625
"[1, 1, 0, 0, 0, 1, 1, 0, 0, 1, 1, 0, 1, 1, 1]",214,94,120,7,11,0.07446808510638298,0.09166666666666666
"[0, 0, 1, 1, 1, 1, 1, 1, 0, 0, 0, 1, 0, 0, 1]",252,128,124,13,13,0.1015625,0.10483870967741936
"[0, 0, 1, 1, 1, 1, 1, 0, 0, 0, 1, 0, 0, 0, 1]",143,71,72,9,9,0.1267605633802817,0.125
"[1, 0, 0, 0, 1, 0, 0, 1, 0, 0, 0, 0, 0, 1, 1]",354,210,144,20,11,0.09523809523809523,0.0763888888888889
"[1, 1, 0, 1, 1, 1, 0, 0, 1, 1, 0, 1, 0, 1, 0]",152,62,90,4,12,0.06451612903225806,0.13333333333333333
"[0, 1, 1, 0, 1, 1, 1, 0, 0, 1, 1, 0, 1, 0, 1]",142,54,88,4,11,0.07407407407407407,0.125
"[1, 0, 0, 1, 0, 0, 0, 0, 1, 1, 1, 1, 1, 0, 0]",156,84,72,10,4,0.11904761904761904,0.05555555555555555
"[0, 1, 1, 0, 0, 0, 1, 1, 1, 0, 0, 1, 0, 1, 0]",99,60,39,9,2,0.15,0.05128205128205128
"[0, 0, 1, 0, 0, 1, 1, 1, 0, 0, 1, 1, 1, 1, 0]",189,105,84,6,5,0.05714285714285714,0.05952380952380952
"[0, 1, 0, 0, 1, 0, 0, 0, 1, 1, 0, 1, 0, 0, 1]",142,85,57,7,9,0.08235294117647059,0.15789473684210525
"[1, 1, 0, 1, 0, 1, 1, 0, 0, 1, 0, 0, 1, 0, 0]",100,48,52,5,5,0.10416666666666667,0.09615384615384616
"[0, 1, 1, 1, 1, 0, 0, 1, 0, 0, 0, 0, 1, 0, 0]",175,114,61,9,3,0.07894736842105263,0.04918032786885246
"[1, 1, 0, 1, 1, 1, 1, 0, 1, 1, 1, 0, 0, 0, 0]",257,101,156,9,20,0.0891089108910891,0.1282051282051282
"[1, 1, 1, 0, 0, 0, 0, 1, 1, 1, 0, 0, 1, 1, 0]",195,77,118,7,9,0.09090909090909091,0.07627118644067797
"[1, 0, 1, 0, 0, 0, 0, 1, 1, 0, 1, 0, 0, 1, 0]",154,101,53,11,6,0.10891089108910891,0.11320754716981132
"[1, 0, 0, 1, 0, 1, 0, 1, 0, 0, 0, 0, 1, 1, 0]",197,101,96,13,13,0.12871287128712872,0.13541666666666666
"[1, 0, 0, 1, 1, 0, 0, 1, 1, 1, 1, 0, 1, 0, 1]",310,86,224,4,24,0.046511627906976744,0.10714285714285714
"[0, 1, 1, 0, 1, 1, 0, 0, 0, 0, 1, 1, 1, 0, 1]",122,56,66,7,6,0.125,0.09090909090909091
"[1, 1, 1, 1, 0, 1, 1, 0, 0, 1, 0, 0, 0, 1, 0]",96,40,56,6,8,0.15,0.14285714285714285
"[0, 0, 1, 0, 0, 1, 1, 0, 1, 1, 1, 0, 0, 1, 0]",88,39,49,6,1,0.15384615384615385,0.02040816326530612
"[1, 1, 0, 1, 0, 1, 0, 1, 0, 0, 1, 0, 0, 0, 0]",149,86,63,7,8,0.08139534883720931,0.12698412698412698
"[1, 0, 0, 1, 0, 0, 1, 1, 1, 1, 0, 1, 0, 1, 1]",157,62,95,7,10,0.11290322580645161,0.10526315789473684
"[0, 0, 1, 0, 0, 0, 1, 0, 1, 1, 0, 0, 1, 0, 1]",128,85,43,3,4,0.03529411764705882,0.09302325581395349
"[0, 1, 1, 0, 1, 0, 1, 0, 0, 1, 1, 0, 1, 1, 1]",166,68,98,7,9,0.10294117647058823,0.09183673469387756
"[1, 0, 1, 0, 0, 0, 1, 0, 0, 1, 1, 1, 0, 0, 0]",179,104,75,13,10,0.125,0.13333333333333333
"[1, 1, 0, 1, 0, 0, 0, 0, 0, 0, 1, 1, 1, 0, 0]",178,111,67,10,6,0.09009009009009009,0.08955223880597014
"[1, 1, 1, 0, 1, 0, 1, 1, 1, 0, 0, 1, 1, 1, 0]",272,98,174,16,13,0.16326530612244897,0.07471264367816093
"[0, 1, 1, 1, 1, 1, 1, 1, 0, 0, 0, 1, 1, 0, 1]",274,101,173,15,19,0.1485148514851485,0.10982658959537572
"[1, 1, 0, 1, 0, 1, 1, 0, 0, 1, 0, 0, 1, 1, 1]",190,78,112,9,8,0.11538461538461539,0.07142857142857142
"[0, 0, 0, 1, 0, 1, 1, 1, 0, 1, 0, 1, 0, 0, 0]",155,88,67,5,6,0.056818181818181816,0.08955223880597014
"[1, 0, 1, 0, 1, 1, 0, 0, 1, 0, 0, 1, 1, 1, 0]",120,55,65,7,9,0.12727272727272726,0.13846153846153847
"[1, 1, 1, 0, 0, 1, 1, 1, 0, 1, 0, 1, 1, 0, 0]",211,66,145,10,9,0.15151515151515152,0.06206896551724138
"[1, 0, 0, 0, 1, 1, 1, 1, 0, 0, 1, 1, 0, 1, 1]",203,71,132,8,15,0.11267605633802817,0.11363636363636363
"[0, 0, 1, 1, 0, 1, 0, 1, 1, 1, 1, 1, 1, 1, 0]",296,113,183,9,12,0.07964601769911504,0.06557377049180328
"[1, 0, 0, 0, 0, 0, 1, 1, 1, 0, 1, 1, 1, 0, 0]",141,58,83,6,3,0.10344827586206896,0.03614457831325301
"[1, 1, 0, 1, 1, 0, 0, 1, 0, 1, 0, 0, 1, 1, 0]",117,57,60,6,4,0.10526315789473684,0.06666666666666667
"[1, 0, 1, 0, 1, 1, 0, 1, 0, 0, 0, 1, 1, 0, 1]",116,60,56,7,7,0.11666666666666667,0.125
"[1, 0, 0, 1, 1, 1, 0, 0, 0, 0, 1, 1, 0, 0, 0]",329,187,142,23,15,0.12299465240641712,0.1056338028169014
"[1, 0, 0, 1, 0, 1, 0, 0, 1, 1, 1, 1, 0, 0, 0]",189,103,86,11,5,0.10679611650485436,0.05813953488372093
"[1, 1, 0, 1, 1, 1, 0, 0, 1, 1, 1, 0, 1, 0, 0]",175,76,99,7,16,0.09210526315789473,0.16161616161616163
"[0, 1, 1, 1, 0, 0, 0, 1, 0, 1, 1, 0, 0, 1, 0]",113,71,42,5,5,0.07042253521126761,0.11904761904761904
"[1, 1, 1, 0, 0, 0, 0, 0, 1, 1, 1, 0, 0, 0, 1]",148,59,89,8,6,0.13559322033898305,0.06741573033707865
"[1, 1, 1, 1, 1, 0, 1, 0, 0, 1, 0, 1, 1, 1, 0]",251,87,164,7,12,0.08045977011494253,0.07317073170731707
"[0, 0, 1, 0, 0, 0, 0, 0, 1, 0, 1, 1, 1, 1, 1]",176,113,63,10,6,0.08849557522123894,0.09523809523809523
"[0, 0, 0, 0, 0, 1, 1, 0, 1, 1, 1, 1, 1, 0, 1]",124,59,65,5,8,0.0847457627118644,0.12307692307692308
"[1, 1, 0, 0, 1, 0, 0, 0, 0, 1, 1, 1, 0, 1, 0]",107,58,49,6,5,0.10344827586206896,0.10204081632653061
"[1, 1, 1, 1, 1, 0, 0, 0, 1, 1, 0, 1, 1, 0, 0]",203,66,137,5,11,0.07575757575757576,0.08029197080291971
"[1, 0, 0, 1, 0, 0, 1, 0, 1, 1, 0, 1, 1, 0, 1]",119,47,72,5,5,0.10638297872340426,0.06944444444444445
"[0, 0, 1, 0, 0, 1, 1, 1, 1, 0, 0, 1, 1, 1, 0]",141,69,72,7,6,0.10144927536231885,0.08333333333333333
"[1, 0, 0, 1, 1, 0, 0, 0, 1, 0, 1, 1, 1, 0, 0]",150,59,91,3,5,0.05084745762711865,0.054945054945054944
"[1, 1, 1, 0, 0, 1, 1, 0, 0, 0, 1, 0, 1, 1, 1]",319,66,253,4,16,0.06060606060606061,0.06324110671936758
"[0, 1, 1, 1, 0, 0, 1, 1, 0, 0, 0, 1, 0, 1, 1]",118,63,55,5,4,0.07936507936507936,0.07272727272727272
"[0, 1, 1, 1, 0, 1, 0, 0, 1, 1, 0, 1, 1, 0, 0]",112,53,59,6,5,0.11320754716981132,0.0847457627118644
"[1, 0, 1, 0, 1, 1, 1, 0, 0, 0, 0, 0, 0, 1, 0]",136,74,62,5,8,0.06756756756756757,0.12903225806451613
"[1, 0, 1, 1, 1, 1, 0, 1, 1, 0, 0, 1, 1, 0, 1]",244,88,156,10,13,0.11363636363636363,0.08333333333333333
"[1, 0, 1, 0, 1, 1, 0, 1, 1, 0, 1, 0, 1, 1, 1]",242,94,148,5,11,0.05319148936170213,0.07432432432432433
"[0, 1, 1, 0, 0, 0, 0, 1, 0, 0, 1, 1, 1, 0, 1]",119,67,52,10,8,0.14925373134328357,0.15384615384615385
"[0, 1, 0, 0, 0, 0, 1, 0, 0, 1, 1, 1, 1, 0, 0]",282,160,122,15,9,0.09375,0.07377049180327869
"[1, 0, 1, 0, 0, 0, 0, 1, 0, 0, 1, 1, 1, 1, 0]",170,86,84,7,4,0.08139534883720931,0.047619047619047616
"[1, 0, 1, 1, 1, 0, 0, 0, 0, 1, 1, 1, 0, 0, 1]",141,60,81,4,9,0.06666666666666667,0.1111111111111111
"[0, 1, 0, 0, 0, 0, 1, 1, 0, 0, 0, 1, 0, 1, 1]",199,125,74,13,5,0.104,0.06756756756756757
"[0, 1, 1, 0, 1, 1, 1, 1, 0, 0, 1, 1, 0, 1, 0]",117,45,72,7,7,0.15555555555555556,0.09722222222222222
"[1, 0, 1, 1, 1, 1, 0, 0, 0, 0, 0, 1, 0, 0, 0]",166,88,78,7,6,0.07954545454545454,0.07692307692307693
"[1, 0, 0, 1, 1, 0, 0, 1, 0, 1, 0, 0, 1, 1, 1]",195,72,123,6,9,0.08333333333333333,0.07317073170731707
"[0, 1, 1, 1, 1, 0, 1, 1, 0, 0, 0, 1, 0, 0, 0]",106,57,49,9,6,0.15789473684210525,0.12244897959183673
"[0, 0, 0, 0, 1, 1, 1, 1, 0, 1, 1, 0, 0, 0, 1]",183,106,77,14,8,0.1320754716981132,0.1038961038961039
"[1, 0, 0, 1, 0, 0, 0, 1, 0, 1, 0, 1, 1, 1, 1]",123,75,48,8,6,0.10666666666666667,0.125
"[0, 1, 0, 0, 0, 1, 0, 1, 1, 0, 1, 0, 0, 0, 1]",147,85,62,11,8,0.12941176470588237,0.12903225806451613
"[0, 1, 0, 0, 1, 0, 1, 1, 1, 0, 1, 0, 0, 0, 1]",116,58,58,8,5,0.13793103448275862,0.08620689655172414
"[0, 0, 1, 0, 0, 1, 0, 0, 1, 0, 1, 1, 1, 1, 1]",140,67,73,5,6,0.07462686567164178,0.0821917808219178
"[1, 1, 0, 0, 1, 0, 0, 1, 0, 0, 1, 0, 1, 1, 1]",145,70,75,9,10,0.12857142857142856,0.13333333333333333
"[0, 1, 0, 1, 0, 1, 0, 0, 0, 1, 1, 1, 0, 1, 0]",115,58,57,4,7,0.06896551724137931,0.12280701754385964
"[0, 0, 1, 1, 0, 1, 0, 1, 0, 1, 0, 1, 0, 1, 0]",108,61,47,8,2,0.13114754098360656,0.0425531914893617
"[1, 1, 0, 0, 1, 1, 0, 1, 0, 1, 0, 1, 0, 1, 0]",104,43,61,1,5,0.023255813953488372,0.08196721311475409
"[1, 1, 1, 1, 0, 1, 1, 0, 0, 0, 1, 0, 0, 1, 1]",165,71,94,8,11,0.11267605633802817,0.11702127659574468
"[1, 1, 1, 1, 1, 1, 0, 1, 0, 1, 1, 0, 1, 0, 1]",573,157,416,13,31,0.08280254777070063,0.07451923076923077
"[1, 1, 0, 1, 1, 0, 0, 0, 1, 1, 1, 0, 1, 0, 1]",142,54,88,5,9,0.09259259259259259,0.10227272727272728
"[1, 1, 1, 1, 0, 1, 0, 1, 0, 0, 0, 1, 1, 1, 0]",143,51,92,5,12,0.09803921568627451,0.13043478260869565
"[0, 0, 0, 0, 1, 0, 0, 0, 1, 0, 1, 1, 0, 0, 1]",295,188,107,11,10,0.05851063829787234,0.09345794392523364
"[0, 0, 0, 1, 0, 0, 1, 0, 0, 0, 1, 1, 1, 0, 1]",135,80,55,8,3,0.1,0.05454545454545454
"[0, 1, 1, 0, 0, 0, 0, 1, 1, 0, 0, 1, 1, 1, 0]",348,254,94,19,10,0.07480314960629922,0.10638297872340426
"[0, 1, 0, 1, 1, 0, 1, 1, 1, 1, 0, 0, 0, 0, 1]",194,98,96,5,10,0.05102040816326531,0.10416666666666667
"[0, 0, 1, 1, 1, 1, 1, 0, 1, 0, 1, 0, 1, 0, 0]",116,56,60,5,13,0.08928571428571429,0.21666666666666667
"[0, 1, 1, 1, 0, 0, 0, 1, 1, 1, 1, 1, 1, 1, 0]",333,134,199,9,10,0.06716417910447761,0.05025125628140704
"[0, 1, 0, 1, 0, 0, 1, 1, 1, 1, 1, 0, 1, 0, 1]",141,70,71,11,5,0.15714285714285714,0.07042253521126761
"[1, 1, 0, 0, 0, 1, 0, 1, 1, 1, 1, 1, 0, 1, 0]",142,48,94,6,11,0.125,0.11702127659574468
"[0, 1, 1, 1, 0, 0, 0, 1, 0, 1, 1, 1, 1, 1, 0]",187,84,103,8,10,0.09523809523809523,0.0970873786407767
"[0, 1, 1, 0, 1, 1, 0, 0, 1, 0, 0, 0, 1, 0, 1]",108,55,53,5,4,0.09090909090909091,0.07547169811320754
"[1, 1, 0, 0, 0, 1, 0, 1, 1, 0, 0, 0, 0, 1, 0]",144,96,48,11,8,0.11458333333333333,0.16666666666666666
"[1, 1, 0, 0, 1, 1, 1, 0, 1, 1, 0, 0, 0, 1, 0]",109,47,62,7,6,0.14893617021276595,0.0967741935483871
"[0, 1, 1, 0, 0, 1, 0, 0, 0, 0, 1, 0, 0, 1, 1]",184,119,65,16,6,0.13445378151260504,0.09230769230769231
"[1, 1, 0, 0, 0, 1, 1, 0, 0, 0, 0, 0, 0, 1, 1]",521,294,227,28,25,0.09523809523809523,0.11013215859030837
"[0, 1, 0, 0, 1, 0, 0, 1, 1, 1, 0, 1, 1, 0, 1]",106,43,63,4,7,0.09302325581395349,0.1111111111111111
"[0, 0, 1, 1, 0, 0, 1, 0, 1, 0, 1, 1, 0, 0, 1]",153,75,78,1,8,0.013333333333333334,0.10256410256410256
"[0, 0, 1, 1, 0, 0, 0, 0, 0, 1, 1, 1, 0, 0, 0]",355,213,142,17,17,0.07981220657276995,0.11971830985915492
"[0, 0, 0, 1, 0, 0, 0, 1, 1, 1, 1, 1, 0, 1, 1]",150,84,66,7,4,0.08333333333333333,0.06060606060606061
"[1, 1, 1, 1, 0, 1, 0, 0, 1, 1, 0, 0, 0, 0, 1]",201,87,114,5,9,0.05747126436781609,0.07894736842105263
"[1, 0, 1, 1, 0, 1, 0, 1, 1, 1, 1, 1, 0, 1, 0]",207,78,129,10,12,0.1282051282051282,0.09302325581395349
"[1, 1, 1, 1, 0, 0, 1, 1, 0, 1, 1, 0, 0, 1, 0]",186,75,111,8,11,0.10666666666666667,0.0990990990990991
"[1, 1, 1, 1, 0, 1, 1, 1, 0, 0, 0, 1, 1, 1, 0]",292,107,185,14,15,0.1308411214953271,0.08108108108108109
"[1, 1, 0, 0, 1, 0, 1, 0, 0, 0, 0, 0, 0, 0, 1]",351,216,135,14,11,0.06481481481481481,0.08148148148148149
"[0, 0, 0, 1, 1, 1, 1, 1, 0, 0, 0, 1, 1, 1, 0]",158,76,82,10,9,0.13157894736842105,0.10975609756097561
"[0, 0, 0, 0, 0, 1, 1, 1, 1, 1, 0, 0, 0, 1, 1]",263,172,91,20,9,0.11627906976744186,0.0989010989010989
"[1, 1, 0, 0, 0, 1, 1, 0, 1, 0, 1, 0, 1, 0, 0]",99,59,40,1,4,0.01694915254237288,0.1
"[1, 1, 1, 1, 1, 0, 0, 0, 1, 1, 0, 1, 0, 1, 0]",166,71,95,9,15,0.1267605633802817,0.15789473684210525
"[1, 1, 0, 1, 1, 1, 1, 1, 0, 0, 0, 1, 0, 0, 0]",111,50,61,6,4,0.12,0.06557377049180328
"[0, 1, 0, 1, 1, 0, 1, 0, 1, 0, 0, 0, 1, 0, 1]",89,48,41,2,1,0.041666666666666664,0.024390243902439025
"[0, 1, 1, 1, 0, 1, 0, 0, 0, 0, 0, 1, 0, 0, 1]",145,96,49,7,7,0.07291666666666667,0.14285714285714285
"[1, 1, 0, 1, 1, 0, 0, 0, 0, 0, 1, 1, 1, 0, 1]",116,42,74,2,6,0.047619047619047616,0.08108108108108109
"[0, 0, 1, 0, 1, 0, 1, 0, 0, 0, 1, 1, 1, 1, 1]",201,106,95,18,8,0.16981132075471697,0.08421052631578947
"[1, 0, 1, 1, 1, 0, 0, 0, 0, 0, 0, 0, 0, 1, 1]",484,274,210,26,12,0.0948905109489051,0.05714285714285714
"[0, 0, 1, 1, 0, 1, 0, 1, 0, 1, 0, 0, 1, 1, 0]",116,62,54,9,4,0.14516129032258066,0.07407407407407407
"[0, 0, 0, 1, 1, 1, 0, 0, 0, 1, 1, 1, 0, 1, 1]",128,76,52,8,3,0.10526315789473684,0.057692307692307696
"[1, 1, 1, 1, 0, 0, 0, 1, 0, 1, 0, 1, 0, 1, 0]",114,48,66,5,8,0.10416666666666667,0.12121212121212122
"[0, 1, 1, 1, 1, 1, 0, 1, 0, 0, 0, 1, 0, 0, 0]",123,67,56,9,3,0.13432835820895522,0.05357142857142857
"[0, 1, 1, 1, 1, 0, 0, 1, 0, 1, 1, 1, 0, 1, 1]",272,109,163,9,15,0.08256880733944955,0.09202453987730061
"[0, 0, 1, 1, 0, 0, 0, 1, 0, 1, 1, 1, 1, 0, 0]",178,95,83,12,5,0.12631578947368421,0.060240963855421686
"[0, 0, 0, 1, 1, 0, 0, 0, 1, 0, 1, 1, 1, 1, 0]",155,87,68,5,6,0.05747126436781609,0.08823529411764706
"[0, 0, 1, 1, 0, 0, 1, 0, 0, 1, 1, 1, 0, 0, 0]",223,135,88,9,7,0.06666666666666667,0.07954545454545454
"[0, 0, 0, 1, 1, 0, 0, 0, 1, 0, 0, 0, 0, 1, 0]",603,451,152,56,14,0.12416851441241686,0.09210526315789473
"[1, 0, 1, 1, 1, 0, 1, 1, 0, 0, 1, 0, 1, 1, 0]",148,59,89,7,8,0.11864406779661017,0.0898876404494382
"[0, 1, 0, 0, 1, 1, 0, 0, 0, 1, 0, 0, 0, 1, 1]",173,112,61,12,6,0.10714285714285714,0.09836065573770492
"[0, 0, 0, 1, 0, 1, 0, 1, 1, 1, 0, 1, 1, 1, 0]",108,45,63,3,8,0.06666666666666667,0.12698412698412698
"[0, 0, 0, 0, 1, 0, 1, 0, 1, 1, 1, 1, 1, 0, 0]",170,91,79,9,7,0.0989010989010989,0.08860759493670886
"[1, 1, 0, 0, 0, 0, 0, 1, 0, 0, 1, 0, 1, 1, 1]",228,139,89,11,7,0.07913669064748201,0.07865168539325842
"[0, 0, 1, 1, 0, 1, 1, 0, 0, 0, 1, 0, 0, 1, 1]",136,76,60,9,5,0.11842105263157894,0.08333333333333333
"[0, 1, 1, 1, 1, 0, 0, 0, 1, 0, 0, 1, 1, 0, 1]",120,72,48,6,2,0.08333333333333333,0.041666666666666664
"[1, 1, 1, 1, 0, 1, 1, 1, 0, 0, 1, 0, 0, 0, 1]",159,70,89,7,11,0.1,0.12359550561797752
"[1, 0, 1, 0, 0, 0, 1, 0, 1, 0, 1, 1, 0, 0, 1]",120,65,55,5,6,0.07692307692307693,0.10909090909090909
"[1, 0, 1, 1, 0, 1, 0, 0, 1, 1, 0, 1, 0, 0, 0]",126,59,67,4,4,0.06779661016949153,0.05970149253731343
"[1, 1, 0, 1, 0, 1, 0, 1, 1, 0, 0, 0, 1, 1, 1]",187,81,106,10,9,0.12345679012345678,0.08490566037735849
"[0, 0, 1, 0, 0, 0, 0, 1, 0, 1, 0, 1, 1, 1, 0]",139,74,65,5,6,0.06756756756756757,0.09230769230769231
"[1, 0, 0, 1, 1, 1, 0, 0, 0, 1, 0, 1, 1, 0, 0]",128,55,73,3,5,0.05454545454545454,0.0684931506849315
"[0, 1, 1, 1, 0, 0, 1, 0, 1, 0, 1, 1, 1, 0, 0]",129,63,66,9,4,0.14285714285714285,0.06060606060606061
"[1, 1, 0, 0, 0, 0, 1, 1, 1, 0, 0, 1, 0, 1, 0]",108,63,45,6,3,0.09523809523809523,0.06666666666666667
"[1, 0, 1, 1, 1, 0, 0, 1, 0, 1, 1, 0, 0, 1, 1]",176,64,112,6,12,0.09375,0.10714285714285714
"[1, 0, 0, 1, 1, 1, 0, 0, 0, 0, 0, 1, 0, 0, 0]",257,160,97,12,5,0.075,0.05154639175257732
"[0, 1, 0, 0, 0, 1, 0, 1, 0, 1, 0, 1, 1, 0, 0]",150,86,64,6,6,0.06976744186046512,0.09375
"[1, 0, 1, 1, 0, 0, 1, 1, 1, 1, 1, 0, 1, 0, 1]",234,74,160,10,14,0.13513513513513514,0.0875
"[1, 0, 0, 0, 1, 1, 1, 1, 0, 1, 0, 1, 1, 0, 1]",120,42,78,3,3,0.07142857142857142,0.038461538461538464
"[0, 0, 0, 0, 1, 1, 1, 0, 1, 0, 0, 0, 0, 0, 1]",337,210,127,19,11,0.09047619047619047,0.08661417322834646
"[1, 1, 0, 1, 0, 0, 0, 1, 1, 1, 0, 0, 1, 0, 0]",130,62,68,9,14,0.14516129032258066,0.20588235294117646
"[0, 0, 0, 0, 1, 1, 0, 1, 1, 0, 1, 1, 0, 1, 0]",113,60,53,4,4,0.06666666666666667,0.07547169811320754
"[0, 1, 0, 0, 0, 0, 1, 1, 0, 1, 1, 0, 1, 1, 0]",114,53,61,5,5,0.09433962264150944,0.08196721311475409
"[0, 1, 0, 0, 0, 1, 0, 1, 1, 1, 1, 1, 1, 0, 0]",215,109,106,19,12,0.1743119266055046,0.11320754716981132
"[0, 0, 0, 1, 1, 1, 0, 0, 1, 0, 1, 1, 1, 1, 1]",208,102,106,10,9,0.09803921568627451,0.08490566037735849
"[1, 0, 0, 1, 1, 1, 0, 1, 1, 0, 1, 0, 0, 0, 0]",130,56,74,7,8,0.125,0.10810810810810811
"[0, 1, 0, 1, 0, 0, 0, 0, 1, 1, 1, 0, 1, 1, 0]",107,60,47,4,3,0.06666666666666667,0.06382978723404255
"[0, 1, 0, 1, 1, 0, 1, 0, 1, 1, 0, 1, 1, 0, 0]",125,70,55,5,4,0.07142857142857142,0.07272727272727272
"[0, 1, 0, 0, 0, 1, 0, 0, 1, 0, 1, 0, 0, 1, 1]",169,100,69,10,6,0.1,0.08695652173913043
"[0, 0, 1, 0, 1, 1, 1, 0, 1, 0, 0, 1, 0, 1, 0]",99,51,48,3,7,0.058823529411764705,0.14583333333333334
"[1, 1, 1, 1, 1, 0, 0, 0, 1, 0, 1, 1, 0, 1, 1]",326,83,243,8,26,0.0963855421686747,0.10699588477366255
"[1, 1, 0, 0, 1, 0, 1, 1, 0, 0, 1, 0, 0, 0, 0]",192,126,66,6,7,0.047619047619047616,0.10606060606060606
"[1, 0, 0, 1, 0, 1, 1, 1, 0, 1, 0, 0, 0, 1, 1]",123,62,61,5,7,0.08064516129032258,0.11475409836065574
"[1, 1, 1, 1, 1, 0, 1, 0, 0, 1, 0, 1, 0, 0, 0]",138,58,80,4,5,0.06896551724137931,0.0625
"[0, 1, 0, 0, 1, 0, 0, 0, 1, 0, 0, 1, 1, 1, 1]",176,99,77,7,10,0.0707070707070707,0.12987012987012986
"[0, 0, 0, 0, 1, 1, 1, 1, 0, 1, 0, 0, 1, 0, 0]",205,131,74,14,4,0.10687022900763359,0.05405405405405406
"[0, 0, 1, 1, 0, 1, 0, 0, 0, 1, 0, 1, 1, 0, 0]",152,90,62,13,5,0.14444444444444443,0.08064516129032258
"[1, 1, 0, 0, 0, 1, 0, 1, 0, 0, 0, 1, 0, 1, 1]",136,70,66,4,6,0.05714285714285714,0.09090909090909091
"[1, 1, 1, 0, 0, 1, 1, 0, 1, 1, 0, 1, 0, 1, 0]",156,57,99,6,7,0.10526315789473684,0.0707070707070707
"[1, 1, 1, 0, 1, 0, 0, 1, 1, 0, 1, 0, 1, 1, 1]",237,103,134,10,8,0.0970873786407767,0.05970149253731343
"[0, 1, 1, 1, 1, 0, 1, 0, 0, 1, 1, 0, 1, 0, 1]",136,55,81,2,5,0.03636363636363636,0.06172839506172839
"[1, 1, 1, 0, 1, 1, 0, 1, 0, 1, 1, 1, 1, 0, 0]",329,120,209,12,25,0.1,0.11961722488038277
"[1, 0, 1, 0, 1, 0, 0, 0, 1, 0, 1, 0, 0, 0, 1]",122,73,49,10,4,0.136986301369863,0.08163265306122448
"[0, 0, 0, 0, 1, 0, 0, 1, 0, 1, 1, 0, 1, 0, 0]",203,133,70,10,3,0.07518796992481203,0.04285714285714286
"[1, 0, 1, 1, 1, 1, 0, 1, 0, 1, 1, 1, 0, 0, 0]",181,76,105,5,9,0.06578947368421052,0.08571428571428572
"[1, 1, 0, 1, 1, 0, 1, 1, 0, 0, 0, 1, 1, 0, 1]",156,70,86,9,10,0.12857142857142856,0.11627906976744186
"[1, 0, 1, 1, 1, 0, 0, 0, 1, 1, 0, 0, 0, 1, 1]",139,62,77,7,4,0.11290322580645161,0.05194805194805195
"[0, 1, 0, 1, 1, 0, 1, 1, 1, 0, 0, 1, 0, 0, 0]",126,60,66,4,4,0.06666666666666667,0.06060606060606061
"[0, 0, 1, 0, 0, 1, 1, 1, 0, 1, 1, 0, 1, 1, 0]",92,43,49,6,4,0.13953488372093023,0.08163265306122448
"[0, 0, 0, 0, 1, 0, 1, 1, 0, 0, 0, 1, 1, 1, 0]",160,114,46,8,2,0.07017543859649122,0.043478260869565216
"[0, 1, 1, 0, 1, 1, 1, 0, 1, 1, 1, 1, 1, 0, 0]",301,107,194,11,18,0.102803738317757,0.09278350515463918
"[0, 1, 1, 0, 0, 0, 1, 1, 1, 0, 0, 0, 1, 1, 0]",141,85,56,6,5,0.07058823529411765,0.08928571428571429
"[0, 0, 0, 0, 1, 1, 1, 0, 0, 0, 0, 1, 0, 1, 0]",264,168,96,14,6,0.08333333333333333,0.0625
"[0, 0, 1, 0, 1, 1, 0, 0, 0, 0, 1, 1, 0, 1, 1]",144,72,72,7,9,0.09722222222222222,0.125
"[0, 0, 0, 1, 0, 1, 1, 0, 0, 0, 0, 1, 1, 0, 1]",162,101,61,12,2,0.1188118811881188,0.03278688524590164
"[1, 1, 0, 1, 1, 0, 0, 0, 0, 0, 0, 1, 0, 0, 1]",172,103,69,4,4,0.038834951456310676,0.057971014492753624
"[1, 1, 1, 0, 1, 1, 0, 0, 0, 0, 0, 0, 1, 0, 0]",172,88,84,11,12,0.125,0.14285714285714285
"[1, 0, 1, 1, 1, 1, 0, 0, 0, 1, 1, 0, 1, 1, 0]",141,64,77,7,5,0.109375,0.06493506493506493
"[1, 1, 0, 0, 1, 0, 0, 1, 0, 1, 1, 0, 1, 1, 1]",161,80,81,3,7,0.0375,0.08641975308641975
"[1, 0, 0, 0, 0, 1, 0, 0, 0, 0, 1, 0, 1, 0, 1]",251,162,89,23,9,0.1419753086419753,0.10112359550561797
"[0, 0, 0, 1, 0, 0, 1, 1, 0, 0, 1, 1, 1, 0, 1]",117,57,60,3,4,0.05263157894736842,0.06666666666666667
"[1, 1, 1, 1, 0, 1, 0, 1, 0, 0, 0, 1, 0, 0, 0]",108,59,49,10,3,0.1694915254237288,0.061224489795918366
"[1, 1, 1, 0, 1, 0, 0, 1, 1, 0, 1, 1, 1, 1, 0]",266,95,171,6,14,0.06315789473684211,0.08187134502923976
"[0, 1, 0, 1, 0, 0, 1, 1, 0, 0, 1, 0, 1, 1, 0]",107,55,52,8,8,0.14545454545454545,0.15384615384615385
"[0, 1, 1, 1, 0, 1, 0, 0, 0, 0, 1, 0, 1, 0, 0]",142,83,59,7,5,0.08433734939759036,0.0847457627118644
"[1, 1, 0, 0, 0, 1, 1, 0, 1, 1, 1, 0, 1, 0, 0]",116,53,63,7,6,0.1320754716981132,0.09523809523809523
"[0, 0, 1, 1, 1, 1, 1, 0, 1, 1, 0, 0, 0, 0, 1]",169,77,92,10,15,0.12987012987012986,0.16304347826086957
"[0, 0, 1, 0, 0, 1, 1, 0, 0, 1, 1, 0, 0, 1, 0]",183,96,87,5,8,0.052083333333333336,0.09195402298850575
"[0, 0, 0, 0, 1, 0, 0, 1, 0, 1, 0, 1, 0, 1, 0]",248,168,80,24,9,0.14285714285714285,0.1125
"[0, 0, 0, 0, 0, 1, 0, 0, 1, 0, 1, 0, 1, 0, 1]",272,183,89,30,7,0.16393442622950818,0.07865168539325842
"[1, 0, 1, 0, 0, 1, 1, 1, 1, 1, 0, 1, 0, 0, 1]",145,56,89,4,6,0.07142857142857142,0.06741573033707865
"[0, 1, 1, 0, 1, 0, 0, 1, 0, 0, 1, 0, 1, 0, 1]",101,56,45,8,2,0.14285714285714285,0.044444444444444446
"[1, 0, 0, 1, 1, 1, 0, 1, 0, 1, 0, 1, 1, 0, 1]",126,47,79,7,7,0.14893617021276595,0.08860759493670886
"[1, 0, 0, 0, 0, 0, 1, 1, 0, 1, 0, 0, 1, 1, 0]",162,95,67,12,4,0.12631578947368421,0.05970149253731343
"[0, 0, 1, 1, 0, 1, 0, 0, 0, 0, 0, 1, 0, 1, 1]",198,119,79,14,6,0.11764705882352941,0.0759493670886076
"[0, 1, 1, 1, 0, 1, 0, 0, 0, 1, 1, 0, 1, 1, 1]",147,72,75,8,4,0.1111111111111111,0.05333333333333334
"[1, 0, 1, 1, 1, 0, 1, 0, 0, 1, 1, 1, 1, 0, 1]",203,60,143,2,13,0.03333333333333333,0.09090909090909091
"[0, 0, 1, 0, 1, 1, 0, 0, 0, 1, 1, 0, 1, 1, 1]",128,64,64,3,4,0.046875,0.0625
"[1, 1, 1, 0, 1, 0, 1, 0, 0, 1, 0, 1, 1, 1, 0]",142,49,93,4,11,0.08163265306122448,0.11827956989247312
"[0, 1, 1, 0, 1, 1, 0, 1, 1, 0, 0, 1, 0, 1, 0]",109,53,56,8,4,0.1509433962264151,0.07142857142857142
"[1, 1, 1, 1, 0, 1, 1, 0, 1, 0, 0, 0, 0, 0, 0]",213,102,111,11,7,0.10784313725490197,0.06306306306306306
"[0, 1, 1, 1, 1, 0, 0, 0, 0, 1, 0, 0, 0, 1, 0]",193,130,63,14,4,0.1076923076923077,0.06349206349206349
"[1, 0, 0, 0, 1, 0, 0, 1, 0, 1, 1, 1, 0, 1, 0]",119,55,64,7,7,0.12727272727272726,0.109375
"[0, 1, 1, 1, 0, 0, 0, 1, 0, 0, 1, 0, 1, 1, 1]",138,68,70,7,5,0.10294117647058823,0.07142857142857142
"[0, 0, 0, 1, 1, 1, 0, 0, 1, 1, 0, 0, 0, 1, 1]",188,113,75,8,5,0.07079646017699115,0.06666666666666667
"[0, 0, 0, 1, 1, 1, 0, 0, 1, 0, 1, 0, 1, 0, 1]",104,55,49,4,2,0.07272727272727272,0.04081632653061224
"[1, 0, 1, 0, 0, 0, 0, 0, 1, 0, 1, 1, 1, 1, 0]",137,62,75,6,12,0.0967741935483871,0.16
"[0, 0, 1, 1, 1, 0, 0, 1, 1, 0, 1, 0, 0, 0, 0]",179,99,80,11,7,0.1111111111111111,0.0875
"[1, 0, 1, 0, 1, 0, 0, 1, 1, 0, 0, 0, 1, 1, 0]",125,57,68,4,6,0.07017543859649122,0.08823529411764706
"[1, 1, 1, 1, 1, 0, 1, 0, 0, 1, 0, 1, 1, 0, 0]",159,68,91,7,4,0.10294117647058823,0.04395604395604396
"[0, 0, 0, 1, 0, 0, 1, 0, 0, 0, 1, 1, 1, 1, 0]",195,117,78,15,11,0.1282051282051282,0.14102564102564102
"[0, 0, 1, 1, 0, 1, 0, 1, 1, 0, 1, 0, 1, 0, 1]",104,53,51,4,4,0.07547169811320754,0.0784313725490196
"[0, 1, 1, 0, 1, 0, 0, 0, 1, 1, 0, 1, 0, 1, 1]",116,60,56,7,5,0.11666666666666667,0.08928571428571429
"[1, 1, 1, 0, 1, 0, 1, 1, 0, 0, 0, 1, 1, 0, 0]",161,74,87,4,8,0.05405405405405406,0.09195402298850575
"[0, 0, 0, 0, 1, 0, 1, 1, 0, 0, 0, 1, 0, 0, 1]",253,170,83,17,6,0.1,0.07228915662650602
"[0, 0, 0, 1, 0, 1, 1, 0, 0, 0, 0, 0, 1, 0, 1]",268,189,79,13,9,0.06878306878306878,0.11392405063291139
"[1, 0, 1, 1, 0, 0, 1, 1, 0, 0, 0, 1, 1, 0, 0]",152,76,76,6,7,0.07894736842105263,0.09210526315789473
"[1, 0, 0, 1, 0, 0, 0, 1, 0, 0, 1, 1, 0, 0, 1]",189,98,91,11,9,0.11224489795918367,0.0989010989010989
"[1, 0, 1, 0, 0, 0, 1, 0, 1, 1, 1, 0, 1, 1, 1]",163,66,97,6,11,0.09090909090909091,0.1134020618556701
"[0, 0, 0, 1, 1, 0, 0, 0, 0, 0, 1, 0, 1, 1, 0]",315,235,80,23,7,0.09787234042553192,0.0875
"[0, 1, 0, 0, 1, 0, 0, 0, 1, 1, 1, 0, 1, 1, 0]",102,47,55,1,4,0.02127659574468085,0.07272727272727272
"[1, 1, 0, 0, 0, 0, 1, 1, 0, 0, 1, 0, 0, 1, 1]",306,155,151,16,12,0.1032258064516129,0.07947019867549669
"[1, 1, 0, 1, 1, 0, 1, 0, 0, 1, 1, 1, 0, 1, 0]",134,50,84,3,7,0.06,0.08333333333333333
"[0, 0, 1, 1, 0, 1, 1, 0, 0, 1, 1, 1, 1, 0, 1]",163,78,85,12,4,0.15384615384615385,0.047058823529411764
"[0, 1, 1, 1, 0, 1, 1, 1, 0, 0, 1, 1, 1, 0, 1]",233,86,147,12,16,0.13953488372093023,0.10884353741496598
"[1, 1, 0, 0, 1, 1, 1, 0, 1, 1, 1, 0, 0, 0, 0]",181,81,100,8,10,0.09876543209876543,0.1
"[0, 1, 0, 0, 0, 0, 0, 0, 0, 1, 1, 1, 1, 1, 0]",241,144,97,13,9,0.09027777777777778,0.09278350515463918
"[1, 0, 1, 0, 1, 0, 1, 0, 1, 1, 1, 0, 1, 0, 0]",107,55,52,2,7,0.03636363636363636,0.1346153846153846
"[0, 1, 1, 0, 0, 0, 1, 0, 1, 0, 1, 1, 0, 0, 1]",129,65,64,6,6,0.09230769230769231,0.09375
"[0, 1, 0, 0, 1, 1, 1, 0, 1, 1, 0, 1, 0, 0, 0]",106,62,44,6,2,0.0967741935483871,0.045454545454545456
"[1, 0, 1, 0, 0, 1, 1, 1, 0, 1, 1, 0, 1, 0, 0]",125,54,71,9,7,0.16666666666666666,0.09859154929577464
"[1, 1, 1, 1, 0, 1, 1, 1, 1, 0, 0, 0, 0, 0, 0]",381,157,224,17,24,0.10828025477707007,0.10714285714285714
"[1, 0, 1, 0, 0, 1, 0, 0, 0, 1, 0, 1, 0, 0, 1]",150,93,57,9,2,0.0967741935483871,0.03508771929824561
"[1, 0, 1, 1, 0, 0, 1, 0, 0, 1, 0, 1, 1, 0, 1]",115,52,63,4,8,0.07692307692307693,0.12698412698412698
"[0, 0, 0, 1, 0, 1, 1, 1, 0, 1, 1, 0, 1, 1, 0]",126,58,68,8,9,0.13793103448275862,0.1323529411764706
"[0, 1, 0, 0, 0, 0, 0, 1, 1, 1, 1, 0, 1, 0, 0]",164,106,58,8,5,0.07547169811320754,0.08620689655172414
"[1, 0, 0, 1, 0, 1, 1, 1, 0, 0, 1, 1, 1, 0, 1]",133,52,81,5,10,0.09615384615384616,0.12345679012345678
"[1, 0, 0, 0, 0, 0, 1, 1, 0, 0, 1, 0, 1, 1, 1]",212,100,112,6,12,0.06,0.10714285714285714
"[1, 1, 1, 0, 1, 0, 0, 0, 0, 0, 1, 1, 0, 0, 1]",202,95,107,11,11,0.11578947368421053,0.102803738317757
"[0, 0, 1, 1, 0, 0, 0, 1, 1, 0, 1, 1, 0, 0, 0]",207,128,79,17,4,0.1328125,0.05063291139240506
"[1, 0, 1, 0, 1, 1, 0, 1, 1, 0, 1, 1, 0, 0, 0]",124,58,66,8,7,0.13793103448275862,0.10606060606060606
"[0, 0, 1, 0, 1, 0, 1, 1, 0, 1, 1, 0, 1, 1, 0]",114,59,55,6,3,0.1016949152542373,0.05454545454545454
"[1, 1, 0, 1, 0, 0, 1, 0, 1, 1, 0, 0, 1, 0, 1]",102,48,54,9,7,0.1875,0.12962962962962962
"[1, 1, 0, 1, 0, 1, 1, 0, 0, 0, 1, 0, 0, 0, 0]",165,94,71,10,8,0.10638297872340426,0.11267605633802817
"[1, 0, 0, 1, 1, 0, 0, 1, 1, 0, 0, 0, 1, 0, 1]",223,71,152,8,15,0.11267605633802817,0.09868421052631579
"[1, 1, 0, 1, 0, 0, 0, 1, 1, 1, 0, 1, 0, 1, 0]",104,50,54,3,8,0.06,0.14814814814814814
"[0, 1, 0, 0, 0, 1, 1, 0, 0, 0, 1, 1, 0, 1, 0]",145,80,65,11,2,0.1375,0.03076923076923077
"[0, 0, 1, 1, 0, 1, 1, 0, 1, 0, 0, 0, 1, 0, 1]",90,51,39,4,4,0.0784313725490196,0.10256410256410256
"[0, 0, 0, 1, 0, 0, 1, 0, 1, 0, 1, 1, 1, 1, 1]",160,80,80,6,9,0.075,0.1125
"[0, 0, 1, 1, 0, 0, 0, 1, 0, 1, 1, 1, 1, 0, 1]",131,65,66,8,4,0.12307692307692308,0.06060606060606061
"[0, 0, 0, 0, 1, 0, 1, 1, 1, 0, 1, 1, 0, 1, 1]",135,63,72,6,5,0.09523809523809523,0.06944444444444445
"[1, 0, 0, 1, 0, 0, 0, 1, 0, 1, 1, 1, 0, 0, 1]",132,72,60,5,9,0.06944444444444445,0.15
"[0, 0, 1, 1, 1, 0, 1, 0, 1, 1, 0, 0, 0, 0, 0]",235,135,100,14,8,0.1037037037037037,0.08
"[1, 1, 0, 0, 0, 0, 1, 0, 0, 1, 0, 1, 1, 0, 0]",140,89,51,7,6,0.07865168539325842,0.11764705882352941
"[0, 1, 1, 0, 0, 1, 0, 0, 1, 1, 0, 0, 1, 0, 1]",107,61,46,12,6,0.19672131147540983,0.13043478260869565
"[0, 0, 1, 0, 1, 1, 1, 1, 0, 1, 0, 0, 0, 1, 0]",104,61,43,8,5,0.13114754098360656,0.11627906976744186
"[1, 1, 0, 1, 1, 1, 0, 1, 0, 0, 1, 1, 0, 0, 1]",195,82,113,10,14,0.12195121951219512,0.12389380530973451
"[1, 1, 0, 1, 1, 0, 0, 0, 0, 1, 1, 1, 0, 1, 0]",119,54,65,2,7,0.037037037037037035,0.1076923076923077
"[0, 1, 1, 1, 0, 1, 0, 1, 0, 0, 1, 1, 1, 0, 0]",118,44,74,2,7,0.045454545454545456,0.0945945945945946
"[1, 0, 1, 1, 0, 1, 0, 0, 0, 0, 0, 1, 0, 1, 0]",118,73,45,12,3,0.1643835616438356,0.06666666666666667
"[0, 1, 0, 0, 1, 1, 1, 1, 0, 0, 1, 1, 1, 0, 1]",170,68,102,6,6,0.08823529411764706,0.058823529411764705
"[0, 1, 0, 1, 0, 0, 1, 1, 0, 0, 1, 0, 1, 1, 1]",154,82,72,11,5,0.13414634146341464,0.06944444444444445
"[0, 0, 1, 0, 0, 0, 1, 1, 1, 0, 0, 1, 0, 0, 0]",247,158,89,21,8,0.13291139240506328,0.0898876404494382
"[0, 1, 1, 1, 0, 1, 0, 0, 0, 0, 1, 0, 1, 1, 1]",133,72,61,7,15,0.09722222222222222,0.2459016393442623
"[1, 0, 0, 0, 0, 0, 1, 1, 1, 0, 1, 0, 0, 1, 1]",150,70,80,6,9,0.08571428571428572,0.1125
"[1, 0, 1, 1, 0, 1, 0, 1, 1, 0, 1, 1, 1, 0, 1]",222,78,144,10,15,0.1282051282051282,0.10416666666666667
"[0, 0, 1, 1, 1, 0, 0, 0, 0, 0, 1, 1, 0, 1, 0]",161,96,65,11,3,0.11458333333333333,0.046153846153846156
"[1, 1, 0, 0, 0, 0, 1, 0, 1, 1, 1, 1, 1, 0, 1]",164,64,100,8,8,0.125,0.08
"[1, 1, 1, 1, 0, 0, 1, 0, 1, 0, 0, 1, 1, 1, 0]",159,73,86,6,9,0.0821917808219178,0.10465116279069768
"[1, 0, 0, 1, 1, 0, 1, 1, 1, 0, 0, 0, 0, 1, 0]",124,57,67,2,1,0.03508771929824561,0.014925373134328358
"[1, 0, 1, 0, 0, 1, 0, 1, 0, 0, 1, 1, 0, 1, 1]",115,56,59,8,11,0.14285714285714285,0.1864406779661017
"[0, 1, 0, 1, 1, 1, 0, 0, 1, 1, 0, 1, 1, 0, 1]",157,61,96,5,5,0.08196721311475409,0.052083333333333336
"[1, 1, 0, 0, 1, 1, 0, 0, 1, 0, 1, 0, 1, 0, 0]",152,67,85,3,12,0.04477611940298507,0.1411764705882353
"[1, 1, 1, 0, 1, 0, 1, 1, 0, 0, 1, 0, 1, 1, 0]",149,55,94,7,8,0.12727272727272726,0.0851063829787234
"[1, 0, 1, 0, 1, 0, 1, 0, 0, 0, 1, 0, 1, 0, 0]",124,70,54,5,7,0.07142857142857142,0.12962962962962962
"[0, 1, 1, 1, 1, 0, 1, 1, 1, 1, 0, 0, 0, 0, 0]",236,125,111,12,8,0.096,0.07207207207207207
"[1, 0, 0, 1, 1, 0, 1, 0, 0, 1, 0, 0, 0, 0, 1]",178,87,91,2,9,0.022988505747126436,0.0989010989010989
"[1, 0, 0, 1, 1, 1, 1, 0, 0, 1, 0, 1, 0, 0, 0]",176,71,105,8,9,0.11267605633802817,0.08571428571428572
"[0, 0, 1, 1, 0, 1, 0, 0, 0, 1, 0, 0, 0, 1, 0]",211,129,82,10,8,0.07751937984496124,0.0975609756097561
"[0, 0, 1, 0, 1, 1, 0, 1, 0, 1, 0, 1, 1, 0, 0]",112,63,49,8,6,0.12698412698412698,0.12244897959183673
"[0, 0, 1, 0, 1, 0, 0, 1, 1, 1, 1, 1, 0, 1, 0]",129,61,68,7,9,0.11475409836065574,0.1323529411764706
"[0, 0, 1, 1, 0, 1, 0, 0, 0, 1, 1, 1, 0, 1, 1]",124,60,64,3,8,0.05,0.125
"[0, 0, 0, 1, 0, 1, 1, 0, 1, 1, 0, 1, 1, 1, 1]",194,84,110,11,11,0.13095238095238096,0.1
"[1, 0, 0, 1, 0, 0, 1, 1, 1, 0, 0, 1, 1, 1, 0]",89,39,50,4,3,0.10256410256410256,0.06
"[1, 1, 1, 0, 1, 0, 0, 1, 0, 0, 1, 1, 1, 0, 0]",112,42,70,7,6,0.16666666666666666,0.08571428571428572
"[0, 1, 1, 0, 0, 1, 0, 0, 0, 0, 0, 1, 0, 1, 1]",186,122,64,8,7,0.06557377049180328,0.109375
"[1, 0, 0, 1, 0, 0, 1, 0, 1, 0, 1, 1, 0, 0, 0]",178,100,78,12,6,0.12,0.07692307692307693
"[0, 1, 1, 0, 0, 1, 0, 0, 1, 0, 1, 0, 1, 1, 0]",97,50,47,6,7,0.12,0.14893617021276595
"[0, 1, 1, 1, 0, 1, 0, 1, 0, 0, 1, 0, 1, 0, 1]",84,35,49,2,1,0.05714285714285714,0.02040816326530612
"[0, 0, 1, 1, 0, 0, 0, 0, 1, 0, 1, 1, 1, 0, 1]",149,78,71,7,7,0.08974358974358974,0.09859154929577464
"[1, 1, 0, 1, 1, 0, 0, 0, 1, 0, 0, 0, 0, 1, 1]",143,76,67,8,7,0.10526315789473684,0.1044776119402985
"[0, 0, 1, 0, 1, 1, 1, 1, 0, 1, 1, 0, 0, 0, 1]",106,55,51,2,1,0.03636363636363636,0.0196078431372549
"[1, 0, 0, 0, 1, 1, 0, 0, 0, 1, 1, 0, 1, 0, 1]",103,59,44,10,6,0.1694915254237288,0.13636363636363635
"[0, 1, 0, 1, 1, 1, 1, 0, 0, 0, 0, 1, 0, 0, 1]",125,62,63,6,5,0.0967741935483871,0.07936507936507936
"[0, 1, 0, 0, 0, 1, 0, 1, 1, 1, 1, 0, 0, 0, 0]",236,144,92,9,15,0.0625,0.16304347826086957
"[0, 1, 1, 0, 1, 0, 0, 0, 1, 0, 0, 0, 1, 1, 0]",170,89,81,16,9,0.1797752808988764,0.1111111111111111
"[0, 0, 0, 0, 0, 1, 1, 1, 0, 1, 1, 0, 1, 1, 1]",217,127,90,11,9,0.08661417322834646,0.1
"[1, 0, 1, 0, 0, 0, 1, 0, 1, 1, 0, 1, 1, 1, 0]",86,38,48,7,4,0.18421052631578946,0.08333333333333333
"[0, 1, 1, 1, 0, 0, 1, 1, 0, 0, 0, 1, 1, 1, 0]",133,63,70,8,6,0.12698412698412698,0.08571428571428572
"[1, 1, 1, 1, 1, 0, 0, 1, 0, 1, 0, 0, 0, 1, 0]",116,41,75,7,8,0.17073170731707318,0.10666666666666667
"[1, 1, 0, 1, 0, 0, 0, 0, 0, 1, 0, 1, 1, 1, 0]",111,57,54,4,0,0.07017543859649122,0.0
"[1, 0, 1, 1, 0, 1, 1, 0, 0, 0, 1, 0, 0, 0, 0]",157,88,69,12,8,0.13636363636363635,0.11594202898550725
"[1, 1, 0, 1, 0, 0, 0, 0, 0, 0, 1, 0, 1, 1, 0]",141,94,47,10,4,0.10638297872340426,0.0851063829787234
"[1, 0, 1, 0, 0, 1, 1, 0, 1, 1, 1, 0, 1, 1, 1]",264,90,174,8,18,0.08888888888888889,0.10344827586206896
"[0, 0, 1, 0, 0, 1, 1, 1, 1, 0, 0, 0, 1, 1, 1]",198,96,102,7,9,0.07291666666666667,0.08823529411764706
"[1, 0, 0, 1, 1, 1, 0, 0, 0, 1, 1, 0, 0, 0, 0]",229,125,104,13,9,0.104,0.08653846153846154
"[0, 1, 1, 0, 1, 0, 1, 0, 1, 1, 0, 1, 1, 1, 0]",145,63,82,6,9,0.09523809523809523,0.10975609756097561
"[0, 0, 0, 1, 1, 0, 1, 0, 1, 0, 1, 0, 1, 0, 1]",113,63,50,9,1,0.14285714285714285,0.02
"[1, 0, 0, 1, 0, 0, 0, 1, 0, 1, 1, 1, 1, 0, 0]",160,85,75,7,5,0.08235294117647059,0.06666666666666667
"[0, 1, 1, 1, 0, 1, 1, 1, 0, 0, 1, 0, 1, 0, 1]",125,56,69,6,7,0.10714285714285714,0.10144927536231885
"[1, 1, 0, 0, 1, 0, 0, 0, 1, 1, 0, 1, 0, 1, 0]",85,42,43,4,3,0.09523809523809523,0.06976744186046512
"[0, 0, 1, 0, 1, 0, 1, 0, 1, 1, 0, 0, 0, 0, 1]",182,103,79,12,6,0.11650485436893204,0.0759493670886076
"[0, 0, 1, 1, 1, 1, 0, 1, 1, 0, 0, 1, 0, 0, 0]",116,58,58,4,6,0.06896551724137931,0.10344827586206896
"[1, 0, 1, 0, 1, 0, 1, 1, 0, 1, 0, 0, 1, 0, 1]",99,47,52,3,2,0.06382978723404255,0.038461538461538464
"[1, 1, 0, 0, 0, 0, 1, 0, 1, 1, 0, 1, 1, 1, 0]",124,50,74,3,12,0.06,0.16216216216216217
"[0, 1, 1, 0, 1, 0, 0, 1, 0, 0, 0, 0, 1, 1, 1]",192,112,80,12,10,0.10714285714285714,0.125
"[1, 0, 1, 1, 0, 1, 0, 1, 0, 1, 0, 0, 0, 1, 0]",105,53,52,4,4,0.07547169811320754,0.07692307692307693
"[1, 1, 0, 0, 0, 1, 0, 1, 1, 0, 1, 0, 1, 0, 1]",89,37,52,1,4,0.02702702702702703,0.07692307692307693
"[0, 0, 1, 0, 1, 1, 0, 0, 1, 0, 1, 0, 1, 1, 0]",105,53,52,1,9,0.018867924528301886,0.17307692307692307
"[0, 0, 1, 1, 1, 1, 1, 0, 1, 0, 0, 1, 0, 1, 1]",155,63,92,7,6,0.1111111111111111,0.06521739130434782
"[0, 0, 0, 0, 0, 0, 1, 1, 1, 0, 0, 1, 0, 1, 1]",276,168,108,17,10,0.10119047619047619,0.09259259259259259
"[1, 0, 0, 0, 1, 0, 0, 1, 0, 0, 1, 1, 0, 0, 1]",183,106,77,12,11,0.11320754716981132,0.14285714285714285
"[0, 0, 0, 1, 0, 1, 1, 0, 0, 1, 0, 1, 1, 0, 1]",104,49,55,5,4,0.10204081632653061,0.07272727272727272
"[0, 1, 0, 0, 1, 1, 1, 1, 0, 0, 1, 0, 0, 1, 1]",173,86,87,7,6,0.08139534883720931,0.06896551724137931
"[1, 0, 1, 0, 1, 0, 0, 0, 1, 0, 1, 0, 0, 1, 1]",130,77,53,9,5,0.11688311688311688,0.09433962264150944
"[1, 0, 0, 1, 1, 0, 0, 0, 0, 1, 0, 1, 1, 1, 0]",155,59,96,8,7,0.13559322033898305,0.07291666666666667
"[1, 1, 0, 0, 0, 1, 1, 1, 1, 0, 0, 0, 0, 0, 1]",171,97,74,8,5,0.08247422680412371,0.06756756756756757
"[1, 1, 0, 0, 0, 0, 0, 1, 1, 0, 1, 0, 0, 0, 1]",185,119,66,12,13,0.10084033613445378,0.19696969696969696
"[0, 1, 0, 1, 1, 0, 0, 1, 0, 1, 1, 0, 0, 0, 0]",177,102,75,10,13,0.09803921568627451,0.17333333333333334
"[1, 0, 0, 0, 0, 1, 0, 1, 1, 0, 0, 1, 0, 1, 1]",138,59,79,9,10,0.15254237288135594,0.12658227848101267
"[0, 0, 0, 0, 1, 1, 1, 0, 1, 1, 0, 0, 0, 1, 0]",166,101,65,7,3,0.06930693069306931,0.046153846153846156
"[0, 0, 0, 1, 1, 1, 0, 1, 0, 1, 0, 1, 1, 0, 0]",121,69,52,5,0,0.07246376811594203,0.0
"[0, 0, 0, 1, 1, 1, 0, 0, 0, 1, 1, 1, 0, 1, 0]",141,81,60,13,6,0.16049382716049382,0.1
"[0, 1, 1, 0, 1, 0, 0, 0, 0, 1, 1, 0, 1, 0, 0]",139,87,52,7,4,0.08045977011494253,0.07692307692307693
"[1, 1, 0, 1, 0, 0, 0, 0, 1, 0, 1, 1, 0, 1, 0]",94,48,46,2,7,0.041666666666666664,0.15217391304347827
"[0, 1, 1, 0, 1, 0, 0, 1, 0, 0, 0, 0, 1, 1, 0]",213,124,89,14,12,0.11290322580645161,0.1348314606741573
"[0, 1, 1, 0, 0, 1, 0, 0, 1, 1, 0, 1, 0, 0, 1]",116,68,48,6,2,0.08823529411764706,0.041666666666666664
"[1, 0, 1, 0, 0, 0, 1, 0, 1, 0, 0, 0, 1, 1, 0]",126,67,59,3,6,0.04477611940298507,0.1016949152542373
"[1, 0, 1, 1, 0, 0, 1, 1, 1, 1, 1, 0, 1, 1, 0]",227,76,151,8,16,0.10526315789473684,0.10596026490066225
"[1, 1, 0, 1, 0, 0, 1, 1, 0, 1, 0, 0, 1, 1, 0]",102,46,56,4,4,0.08695652173913043,0.07142857142857142
"[1, 1, 1, 1, 0, 1, 1, 1, 0, 0, 0, 0, 0, 0, 1]",231,88,143,15,9,0.17045454545454544,0.06293706293706294
"[1, 0, 0, 0, 0, 1, 1, 0, 1, 0, 1, 0, 1, 0, 0]",157,84,73,4,6,0.047619047619047616,0.0821917808219178
"[1, 0, 1, 1, 0, 0, 1, 1, 1, 0, 0, 0, 0, 1, 1]",194,92,102,7,13,0.07608695652173914,0.12745098039215685
"[0, 0, 0, 1, 1, 1, 0, 1, 0, 1, 1, 0, 1, 0, 0]",111,61,50,4,7,0.06557377049180328,0.14
"[1, 0, 0, 0, 1, 1, 1, 0, 1, 0, 1, 1, 0, 1, 0]",110,58,52,6,4,0.10344827586206896,0.07692307692307693
"[1, 1, 0, 1, 1, 0, 0, 1, 0, 1, 0, 1, 0, 1, 1]",134,55,79,6,11,0.10909090909090909,0.13924050632911392
"[1, 0, 1, 1, 0, 0, 0, 0, 0, 1, 0, 0, 1, 0, 0]",234,150,84,14,9,0.09333333333333334,0.10714285714285714
"[1, 1, 0, 1, 0, 1, 0, 1, 0, 0, 0, 1, 1, 1, 0]",123,57,66,9,6,0.15789473684210525,0.09090909090909091
"[0, 1, 0, 0, 1, 1, 0, 0, 0, 1, 0, 0, 1, 0, 0]",244,162,82,15,11,0.09259259259259259,0.13414634146341464
"[0, 0, 0, 0, 0, 1, 1, 1, 1, 1, 0, 1, 1, 0, 1]",176,109,67,9,11,0.08256880733944955,0.16417910447761194
"[1, 0, 0, 1, 1, 0, 1, 0, 1, 0, 0, 0, 0, 1, 0]",139,76,63,6,5,0.07894736842105263,0.07936507936507936
"[1, 0, 1, 0, 1, 1, 0, 1, 0, 0, 1, 1, 0, 1, 0]",89,44,45,2,5,0.045454545454545456,0.1111111111111111
"[0, 0, 1, 1, 0, 1, 1, 0, 1, 0, 1, 1, 0, 1, 0]",82,34,48,1,2,0.029411764705882353,0.041666666666666664
"[1, 0, 1, 0, 0, 0, 0, 0, 1, 1, 0, 0, 0, 1, 1]",208,119,89,11,11,0.09243697478991597,0.12359550561797752
"[0, 1, 0, 1, 1, 1, 1, 1, 0, 1, 1, 0, 0, 0, 0]",157,74,83,10,8,0.13513513513513514,0.0963855421686747
"[0, 1, 1, 0, 1, 0, 1, 1, 1, 1, 1, 0, 1, 1, 0]",240,94,146,8,10,0.0851063829787234,0.0684931506849315
"[1, 1, 1, 1, 0, 1, 0, 0, 1, 1, 0, 1, 1, 0, 0]",168,74,94,10,11,0.13513513513513514,0.11702127659574468
"[0, 0, 1, 1, 0, 0, 1, 0, 0, 0, 1, 1, 0, 0, 1]",206,130,76,12,4,0.09230769230769231,0.05263157894736842
"[0, 1, 1, 0, 1, 0, 0, 1, 0, 0, 0, 1, 1, 1, 0]",126,70,56,8,3,0.11428571428571428,0.05357142857142857
"[0, 0, 0, 1, 1, 1, 0, 0, 0, 1, 1, 1, 1, 0, 0]",223,122,101,8,11,0.06557377049180328,0.10891089108910891
"[0, 0, 1, 0, 1, 0, 0, 0, 0, 1, 0, 1, 0, 1, 0]",206,140,66,12,9,0.08571428571428572,0.13636363636363635
"[1, 0, 1, 1, 1, 1, 1, 1, 0, 1, 0, 0, 1, 1, 0]",270,102,168,11,17,0.10784313725490197,0.10119047619047619
"[1, 0, 1, 0, 0, 1, 1, 1, 0, 0, 1, 0, 1, 1, 1]",147,75,72,9,10,0.12,0.1388888888888889
"[1, 0, 0, 0, 1, 0, 1, 1, 1, 1, 0, 0, 0, 0, 0]",287,148,139,18,15,0.12162162162162163,0.1079136690647482
"[0, 0, 0, 0, 1, 1, 0, 1, 1, 0, 1, 1, 1, 0, 0]",140,78,62,9,5,0.11538461538461539,0.08064516129032258
"[1, 1, 0, 1, 0, 1, 1, 0, 0, 1, 1, 1, 0, 0, 0]",157,85,72,10,7,0.11764705882352941,0.09722222222222222
"[1, 0, 1, 1, 0, 0, 1, 1, 1, 0, 0, 0, 1, 0, 0]",129,76,53,5,5,0.06578947368421052,0.09433962264150944
"[0, 1, 1, 1, 0, 0, 1, 0, 1, 1, 1, 0, 0, 1, 0]",130,61,69,7,5,0.11475409836065574,0.07246376811594203
"[0, 0, 1, 0, 0, 0, 0, 0, 1, 0, 1, 0, 0, 1, 1]",266,172,94,14,4,0.08139534883720931,0.0425531914893617
"[0, 0, 1, 1, 1, 0, 1, 1, 0, 0, 0, 1, 1, 1, 1]",248,121,127,8,15,0.06611570247933884,0.11811023622047244
"[1, 1, 1, 1, 0, 1, 1, 0, 1, 0, 1, 0, 0, 1, 0]",137,59,78,11,4,0.1864406779661017,0.05128205128205128
"[0, 0, 1, 0, 0, 1, 1, 0, 1, 0, 0, 1, 1, 0, 0]",179,108,71,10,8,0.09259259259259259,0.11267605633802817
"[1, 0, 1, 0, 0, 1, 0, 0, 1, 0, 1, 0, 1, 1, 1]",119,56,63,5,5,0.08928571428571429,0.07936507936507936
"[1, 1, 1, 1, 0, 1, 0, 1, 0, 1, 0, 1, 0, 0, 1]",161,75,86,8,6,0.10666666666666667,0.06976744186046512
"[1, 0, 0, 1, 1, 0, 0, 0, 1, 0, 1, 1, 1, 1, 1]",268,76,192,12,11,0.15789473684210525,0.057291666666666664
"[1, 0, 1, 1, 0, 1, 0, 1, 1, 0, 1, 0, 1, 0, 0]",98,48,50,4,5,0.08333333333333333,0.1
"[1, 0, 0, 0, 1, 1, 0, 0, 0, 0, 1, 0, 1, 1, 1]",169,106,63,14,6,0.1320754716981132,0.09523809523809523
"[0, 0, 1, 1, 1, 1, 1, 0, 1, 0, 1, 1, 0, 1, 0]",136,64,72,4,9,0.0625,0.125
"[0, 0, 1, 1, 1, 1, 1, 0, 0, 1, 0, 1, 1, 0, 0]",132,64,68,9,3,0.140625,0.04411764705882353
"[1, 0, 1, 1, 1, 0, 0, 1, 0, 0, 0, 1, 1, 0, 1]",96,48,48,4,7,0.08333333333333333,0.14583333333333334
"[1, 1, 1, 0, 1, 0, 0, 1, 0, 1, 1, 0, 1, 0, 0]",113,52,61,6,8,0.11538461538461539,0.13114754098360656
"[0, 1, 1, 0, 1, 1, 0, 1, 0, 1, 0, 1, 1, 0, 0]",133,58,75,7,8,0.1206896551724138,0.10666666666666667
"[0, 0, 1, 0, 1, 1, 1, 1, 1, 0, 0, 1, 0, 1, 1]",154,57,97,4,4,0.07017543859649122,0.041237113402061855
"[0, 1, 0, 0, 1, 0, 0, 1, 0, 1, 1, 1, 1, 0, 0]",157,87,70,9,11,0.10344827586206896,0.15714285714285714
"[0, 0, 1, 0, 0, 1, 0, 0, 1, 0, 1, 1, 1, 1, 0]",129,72,57,9,7,0.125,0.12280701754385964
"[1, 0, 1, 0, 0, 1, 0, 1, 0, 1, 1, 0, 0, 0, 1]",133,67,66,5,8,0.07462686567164178,0.12121212121212122
"[0, 1, 0, 1, 1, 0, 1, 1, 1, 1, 0, 1, 0, 0, 1]",144,69,75,7,8,0.10144927536231885,0.10666666666666667
"[1, 0, 0, 0, 0, 0, 1, 1, 0, 1, 1, 1, 1, 0, 1]",122,51,71,3,4,0.058823529411764705,0.056338028169014086
"[0, 0, 0, 1, 0, 1, 0, 1, 0, 1, 1, 1, 1, 1, 0]",127,71,56,9,6,0.1267605633802817,0.10714285714285714
"[1, 1, 0, 0, 0, 0, 0, 1, 1, 0, 0, 0, 1, 0, 0]",302,191,111,13,9,0.06806282722513089,0.08108108108108109
"[0, 0, 0, 1, 0, 0, 0, 1, 1, 1, 1, 0, 0, 1, 0]",164,99,65,8,6,0.08080808080808081,0.09230769230769231
"[0, 1, 1, 1, 1, 0, 0, 1, 1, 0, 1, 1, 1, 0, 0]",202,99,103,9,10,0.09090909090909091,0.0970873786407767
"[0, 0, 0, 0, 1, 1, 0, 0, 0, 1, 0, 0, 1, 1, 1]",474,295,179,34,21,0.1152542372881356,0.11731843575418995
"[1, 1, 1, 0, 1, 0, 0, 0, 0, 0, 0, 1, 1, 1, 0]",136,62,74,3,1,0.04838709677419355,0.013513513513513514
"[1, 1, 1, 0, 0, 0, 1, 1, 1, 0, 0, 1, 0, 0, 1]",127,44,83,4,11,0.09090909090909091,0.13253012048192772
"[0, 0, 0, 1, 0, 0, 1, 1, 1, 0, 0, 1, 0, 1, 0]",124,72,52,9,9,0.125,0.17307692307692307
"[1, 0, 1, 1, 1, 0, 1, 1, 1, 0, 0, 1, 0, 0, 0]",115,58,57,2,3,0.034482758620689655,0.05263157894736842
"[0, 1, 0, 0, 0, 1, 1, 1, 0, 1, 0, 1, 0, 1, 0]",97,52,45,3,6,0.057692307692307696,0.13333333333333333
"[0, 1, 0, 1, 0, 0, 1, 0, 0, 0, 1, 1, 1, 0, 1]",120,60,60,5,5,0.08333333333333333,0.08333333333333333
"[1, 0, 1, 1, 0, 1, 1, 0, 0, 1, 1, 0, 1, 0, 0]",108,48,60,4,5,0.08333333333333333,0.08333333333333333
"[1, 0, 0, 1, 0, 0, 1, 1, 0, 1, 1, 0, 0, 0, 1]",127,59,68,4,7,0.06779661016949153,0.10294117647058823
"[1, 0, 1, 1, 0, 0, 1, 1, 1, 0, 1, 1, 0, 0, 0]",134,59,75,1,7,0.01694915254237288,0.09333333333333334
"[1, 1, 0, 0, 1, 1, 0, 1, 0, 1, 0, 0, 1, 1, 0]",149,66,83,5,6,0.07575757575757576,0.07228915662650602
"[1, 0, 0, 0, 1, 0, 1, 1, 1, 0, 0, 1, 1, 0, 1]",114,46,68,5,5,0.10869565217391304,0.07352941176470588
"[1, 0, 1, 0, 0, 1, 0, 0, 0, 1, 0, 0, 1, 1, 0]",163,95,68,14,10,0.14736842105263157,0.14705882352941177
"[0, 1, 1, 0, 1, 0, 0, 1, 1, 0, 0, 1, 1, 0, 1]",132,57,75,8,14,0.14035087719298245,0.18666666666666668
"[0, 1, 0, 1, 0, 0, 1, 0, 0, 1, 1, 1, 1, 1, 0]",131,63,68,1,6,0.015873015873015872,0.08823529411764706
"[1, 0, 0, 0, 0, 1, 1, 1, 1, 1, 1, 0, 1, 0, 1]",297,85,212,9,23,0.10588235294117647,0.10849056603773585
"[0, 1, 0, 1, 0, 0, 1, 1, 0, 1, 1, 0, 1, 0, 1]",111,52,59,5,2,0.09615384615384616,0.03389830508474576
"[0, 0, 0, 0, 1, 0, 0, 1, 1, 1, 1, 0, 1, 1, 1]",168,80,88,5,7,0.0625,0.07954545454545454
"[0, 1, 1, 1, 0, 1, 0, 1, 0, 0, 1, 1, 0, 0, 0]",147,75,72,9,8,0.12,0.1111111111111111
"[1, 1, 0, 0, 1, 0, 1, 1, 0, 1, 0, 0, 1, 1, 0]",128,60,68,5,6,0.08333333333333333,0.08823529411764706
"[0, 0, 1, 1, 0, 1, 0, 1, 0, 1, 1, 0, 0, 1, 0]",91,47,44,5,1,0.10638297872340426,0.022727272727272728
"[0, 0, 1, 1, 1, 1, 1, 0, 0, 0, 1, 1, 0, 1, 0]",146,63,83,6,6,0.09523809523809523,0.07228915662650602
"[0, 1, 1, 0, 0, 0, 0, 0, 1, 1, 0, 1, 0, 1, 0]",167,107,60,12,8,0.11214953271028037,0.13333333333333333
"[1, 0, 0, 1, 1, 1, 0, 1, 0, 1, 1, 0, 1, 1, 1]",289,91,198,13,19,0.14285714285714285,0.09595959595959595
"[0, 0, 1, 1, 0, 1, 1, 0, 0, 1, 1, 1, 0, 1, 1]",175,74,101,10,11,0.13513513513513514,0.10891089108910891
"[1, 0, 1, 0, 1, 0, 0, 1, 0, 0, 1, 1, 0, 0, 0]",190,112,78,15,4,0.13392857142857142,0.05128205128205128
"[0, 1, 0, 0, 1, 0, 0, 0, 1, 1, 0, 0, 1, 0, 1]",136,79,57,7,8,0.08860759493670886,0.14035087719298245
"[1, 1, 1, 0, 0, 1, 0, 0, 1, 1, 0, 0, 1, 0, 0]",119,66,53,4,10,0.06060606060606061,0.18867924528301888
"[1, 0, 0, 0, 0, 1, 1, 1, 1, 0, 1, 0, 0, 1, 0]",141,55,86,6,8,0.10909090909090909,0.09302325581395349
"[0, 0, 1, 1, 0, 0, 1, 1, 1, 1, 1, 0, 1, 1, 0]",246,95,151,9,16,0.09473684210526316,0.10596026490066225
"[1, 0, 1, 0, 0, 0, 1, 1, 0, 1, 0, 0, 1, 0, 0]",146,78,68,11,8,0.14102564102564102,0.11764705882352941
"[1, 0, 0, 1, 0, 0, 0, 0, 0, 1, 1, 0, 0, 0, 1]",273,175,98,11,11,0.06285714285714286,0.11224489795918367
"[1, 0, 0, 0, 1, 0, 1, 1, 0, 0, 1, 0, 1, 1, 1]",137,60,77,5,6,0.08333333333333333,0.07792207792207792
"[1, 0, 0, 1, 1, 0, 0, 1, 0, 1, 0, 0, 0, 1, 0]",140,68,72,5,9,0.07352941176470588,0.125
"[1, 1, 0, 1, 0, 0, 0, 0, 0, 1, 0, 1, 0, 1, 0]",129,67,62,7,8,0.1044776119402985,0.12903225806451613
"[1, 0, 1, 0, 1, 0, 0, 1, 0, 0, 0, 1, 1, 0, 1]",103,49,54,8,4,0.16326530612244897,0.07407407407407407
"[1, 0, 0, 0, 0, 0, 1, 1, 1, 0, 1, 1, 0, 1, 0]",110,61,49,6,2,0.09836065573770492,0.04081632653061224
"[0, 1, 0, 1, 0, 0, 1, 0, 1, 0, 0, 0, 1, 0, 1]",115,72,43,6,3,0.08333333333333333,0.06976744186046512
"[1, 0, 1, 0, 1, 0, 1, 0, 0, 0, 0, 1, 0, 0, 0]",258,154,104,19,6,0.12337662337662338,0.057692307692307696
"[0, 1, 0, 1, 1, 0, 1, 0, 0, 1, 1, 0, 0, 1, 1]",171,93,78,6,4,0.06451612903225806,0.05128205128205128
"[1, 1, 0, 0, 1, 1, 1, 1, 0, 1, 0, 0, 0, 1, 0]",129,62,67,3,6,0.04838709677419355,0.08955223880597014
"[1, 1, 0, 0, 1, 0, 1, 1, 0, 0, 0, 1, 0, 1, 0]",97,63,34,5,5,0.07936507936507936,0.14705882352941177
"[1, 1, 0, 1, 1, 0, 1, 0, 0, 0, 1, 0, 1, 1, 1]",119,48,71,6,11,0.125,0.15492957746478872
"[1, 0, 1, 0, 0, 1, 1, 1, 1, 0, 0, 1, 0, 1, 0]",110,55,55,9,4,0.16363636363636364,0.07272727272727272
"[0, 0, 1, 0, 0, 1, 0, 1, 0, 1, 0, 1, 0, 1, 1]",113,62,51,4,7,0.06451612903225806,0.13725490196078433
"[0, 0, 1, 0, 0, 0, 1, 1, 0, 1, 1, 1, 1, 1, 0]",130,69,61,4,5,0.057971014492753624,0.08196721311475409
"[1, 1, 0, 0, 0, 1, 1, 0, 0, 1, 1, 1, 1, 0, 1]",186,79,107,9,9,0.11392405063291139,0.08411214953271028
"[1, 1, 0, 1, 1, 1, 1, 0, 0, 0, 0, 1, 0, 1, 1]",173,66,107,6,12,0.09090909090909091,0.11214953271028037
"[0, 0, 0, 0, 1, 1, 1, 1, 0, 1, 0, 0, 0, 1, 1]",228,127,101,11,6,0.08661417322834646,0.0594059405940594
"[0, 1, 0, 0, 1, 0, 0, 1, 0, 1, 0, 1, 1, 0, 1]",108,46,62,3,4,0.06521739130434782,0.06451612903225806
"[0, 0, 1, 0, 1, 1, 1, 0, 0, 0, 1, 1, 1, 0, 0]",126,71,55,5,1,0.07042253521126761,0.01818181818181818
"[0, 1, 0, 1, 0, 1, 0, 0, 1, 1, 0, 1, 1, 1, 0]",117,51,66,3,9,0.058823529411764705,0.13636363636363635
"[1, 1, 0, 1, 1, 0, 1, 1, 0, 1, 1, 0, 1, 0, 1]",207,83,124,4,6,0.04819277108433735,0.04838709677419355
"[0, 0, 0, 0, 1, 1, 1, 0, 0, 1, 0, 0, 0, 0, 1]",309,188,121,13,12,0.06914893617021277,0.09917355371900827
"[1, 0, 0, 0, 0, 1, 0, 0, 1, 1, 1, 1, 0, 1, 1]",143,65,78,4,4,0.06153846153846154,0.05128205128205128
"[0, 0, 1, 1, 1, 1, 0, 1, 1, 1, 1, 0, 0, 0, 1]",169,75,94,7,2,0.09333333333333334,0.02127659574468085
"[1, 1, 1, 1, 0, 0, 1, 0, 0, 1, 1, 0, 1, 0, 1]",150,66,84,3,8,0.045454545454545456,0.09523809523809523
"[1, 1, 1, 1, 1, 1, 0, 0, 0, 1, 0, 0, 0, 1, 0]",129,59,70,4,7,0.06779661016949153,0.1
"[1, 1, 0, 1, 0, 1, 0, 0, 1, 0, 0, 1, 0, 0, 1]",99,55,44,5,3,0.09090909090909091,0.06818181818181818
"[0, 1, 0, 1, 1, 1, 0, 1, 0, 1, 1, 0, 0, 1, 1]",195,72,123,10,16,0.1388888888888889,0.13008130081300814
"[0, 0, 0, 1, 0, 1, 1, 1, 0, 0, 1, 0, 0, 0, 1]",149,85,64,9,4,0.10588235294117647,0.0625
"[0, 1, 1, 1, 1, 0, 0, 1, 0, 1, 0, 1, 1, 0, 1]",176,90,86,9,5,0.1,0.05813953488372093
"[0, 0, 1, 0, 1, 1, 0, 1, 1, 0, 0, 0, 1, 1, 0]",139,74,65,5,8,0.06756756756756757,0.12307692307692308
"[1, 1, 0, 0, 1, 0, 1, 1, 0, 1, 1, 0, 0, 0, 1]",124,65,59,7,7,0.1076923076923077,0.11864406779661017
"[0, 1, 0, 0, 0, 1, 0, 1, 0, 1, 0, 1, 1, 1, 1]",127,72,55,5,7,0.06944444444444445,0.12727272727272726
"[1, 0, 1, 1, 1, 0, 1, 0, 1, 1, 0, 1, 0, 1, 0]",112,33,79,2,11,0.06060606060606061,0.13924050632911392
"[0, 1, 0, 1, 0, 1, 0, 1, 1, 1, 1, 1, 0, 0, 0]",162,73,89,6,9,0.0821917808219178,0.10112359550561797
"[1, 1, 1, 1, 0, 1, 1, 0, 1, 0, 0, 0, 1, 0, 1]",123,57,66,10,5,0.17543859649122806,0.07575757575757576
"[0, 1, 0, 0, 0, 1, 1, 1, 0, 0, 0, 1, 0, 1, 1]",117,61,56,6,5,0.09836065573770492,0.08928571428571429
"[0, 1, 0, 1, 0, 1, 0, 0, 1, 1, 0, 1, 1, 0, 1]",108,54,54,6,4,0.1111111111111111,0.07407407407407407
"[1, 0, 0, 0, 1, 0, 1, 0, 0, 1, 0, 0, 0, 1, 1]",188,89,99,10,8,0.11235955056179775,0.08080808080808081
"[1, 0, 0, 1, 0, 1, 0, 1, 0, 0, 1, 0, 0, 1, 0]",130,73,57,10,4,0.136986301369863,0.07017543859649122
"[1, 0, 1, 1, 0, 1, 1, 0, 1, 1, 0, 0, 0, 1, 0]",97,42,55,4,6,0.09523809523809523,0.10909090909090909
"[0, 0, 0, 1, 0, 1, 1, 0, 1, 1, 0, 0, 0, 1, 1]",150,81,69,8,2,0.09876543209876543,0.028985507246376812
"[1, 0, 0, 0, 0, 0, 1, 0, 1, 1, 1, 1, 0, 1, 0]",119,58,61,9,6,0.15517241379310345,0.09836065573770492
"[0, 0, 1, 0, 1, 0, 1, 1, 0, 0, 0, 1, 1, 0, 0]",172,94,78,7,7,0.07446808510638298,0.08974358974358974
"[1, 0, 0, 0, 1, 1, 1, 0, 0, 1, 1, 0, 1, 0, 0]",104,60,44,5,7,0.08333333333333333,0.1590909090909091
"[0, 1, 0, 1, 1, 1, 0, 1, 1, 0, 1, 1, 0, 0, 0]",118,64,54,9,8,0.140625,0.14814814814814814
"[0, 1, 1, 1, 1, 1, 1, 0, 1, 0, 0, 0, 0, 1, 0]",132,73,59,5,2,0.0684931506849315,0.03389830508474576
"[1, 0, 0, 1, 0, 1, 0, 0, 0, 1, 0, 0, 0, 1, 1]",172,103,69,7,5,0.06796116504854369,0.07246376811594203
"[1, 1, 0, 1, 0, 0, 1, 0, 1, 0, 1, 1, 0, 1, 1]",136,48,88,7,7,0.14583333333333334,0.07954545454545454
"[1, 0, 1, 1, 1, 0, 0, 0, 1, 1, 1, 0, 0, 0, 1]",119,52,67,6,7,0.11538461538461539,0.1044776119402985
"[0, 0, 0, 1, 1, 0, 1, 0, 0, 0, 1, 1, 1, 1, 0]",159,98,61,6,8,0.061224489795918366,0.13114754098360656
"[0, 1, 0, 0, 0, 0, 1, 0, 1, 0, 1, 1, 0, 0, 1]",151,90,61,13,6,0.14444444444444443,0.09836065573770492
"[1, 0, 0, 1, 1, 1, 0, 1, 0, 1, 0, 1, 1, 1, 0]",147,56,91,6,8,0.10714285714285714,0.08791208791208792
"[1, 1, 0, 1, 1, 0, 1, 1, 1, 0, 0, 0, 1, 0, 0]",98,49,49,3,2,0.061224489795918366,0.04081632653061224
"[0, 1, 0, 1, 0, 1, 0, 1, 0, 0, 0, 1, 0, 0, 1]",163,95,68,12,3,0.12631578947368421,0.04411764705882353
"[0, 0, 1, 1, 0, 0, 0, 0, 0, 1, 0, 1, 1, 0, 1]",188,111,77,14,8,0.12612612612612611,0.1038961038961039
"[0, 0, 1, 0, 1, 0, 0, 1, 0, 1, 1, 0, 1, 0, 1]",101,50,51,4,7,0.08,0.13725490196078433
"[1, 0, 0, 1, 0, 1, 1, 0, 1, 1, 0, 0, 1, 0, 1]",93,45,48,7,6,0.15555555555555556,0.125
"[0, 1, 1, 1, 0, 1, 1, 0, 1, 0, 0, 1, 0, 1, 1]",142,75,67,8,9,0.10666666666666667,0.13432835820895522
"[0, 1, 1, 1, 0, 1, 1, 0, 0, 1, 0, 0, 0, 1, 1]",149,74,75,11,2,0.14864864864864866,0.02666666666666667
"[0, 1, 0, 0, 1, 0, 0, 0, 1, 1, 1, 1, 0, 1, 0]",100,61,39,4,0,0.06557377049180328,0.0
"[0, 0, 1, 0, 1, 1, 0, 1, 0, 0, 1, 1, 0, 1, 0]",112,55,57,6,5,0.10909090909090909,0.08771929824561403
"[0, 1, 1, 0, 1, 1, 0, 1, 0, 0, 1, 1, 0, 0, 1]",160,96,64,8,4,0.08333333333333333,0.0625
"[0, 1, 0, 1, 1, 0, 0, 0, 1, 0, 0, 1, 0, 0, 1]",125,66,59,9,3,0.13636363636363635,0.05084745762711865
"[1, 0, 1, 0, 1, 0, 0, 1, 1, 1, 0, 0, 1, 0, 0]",118,60,58,1,3,0.016666666666666666,0.05172413793103448
"[1, 1, 0, 0, 0, 1, 0, 1, 1, 1, 0, 0, 0, 1, 0]",103,51,52,7,6,0.13725490196078433,0.11538461538461539
"[0, 1, 1, 0, 1, 0, 0, 1, 1, 0, 0, 1, 0, 0, 1]",111,56,55,6,3,0.10714285714285714,0.05454545454545454
"[0, 1, 1, 1, 0, 0, 0, 0, 1, 1, 0, 1, 0, 0, 1]",158,94,64,7,7,0.07446808510638298,0.109375
"[0, 1, 1, 0, 0, 0, 0, 1, 0, 0, 1, 0, 1, 0, 1]",163,102,61,5,12,0.049019607843137254,0.19672131147540983
"[1, 0, 1, 0, 0, 1, 0, 1, 0, 0, 0, 1, 1, 1, 0]",119,63,56,6,4,0.09523809523809523,0.07142857142857142
"[0, 1, 1, 1, 0, 1, 0, 0, 1, 0, 1, 0, 0, 0, 1]",109,59,50,6,6,0.1016949152542373,0.12
"[1, 0, 0, 1, 1, 1, 0, 1, 0, 1, 1, 0, 0, 0, 0]",176,79,97,9,10,0.11392405063291139,0.10309278350515463
"[1, 0, 0, 1, 0, 0, 0, 1, 0, 1, 1, 0, 1, 1, 0]",103,62,41,3,4,0.04838709677419355,0.0975609756097561
"[0, 1, 0, 1, 1, 1, 0, 0, 0, 1, 1, 1, 0, 1, 0]",113,58,55,3,4,0.05172413793103448,0.07272727272727272
"[1, 1, 0, 1, 0, 1, 1, 0, 1, 0, 0, 0, 0, 0, 1]",105,54,51,6,2,0.1111111111111111,0.0392156862745098
"[0, 0, 0, 1, 1, 0, 1, 1, 1, 1, 1, 0, 0, 1, 0]",118,54,64,8,3,0.14814814814814814,0.046875
"[1, 1, 0, 0, 1, 1, 1, 0, 0, 0, 1, 1, 0, 0, 0]",177,86,91,9,8,0.10465116279069768,0.08791208791208792
"[0, 0, 1, 1, 1, 0, 1, 0, 0, 1, 1, 1, 1, 0, 1]",152,64,88,4,8,0.0625,0.09090909090909091
"[0, 1, 1, 0, 0, 1, 0, 0, 1, 0, 1, 0, 1, 0, 1]",100,53,47,4,2,0.07547169811320754,0.0425531914893617
"[1, 0, 1, 1, 0, 0, 0, 1, 1, 0, 1, 0, 0, 1, 0]",111,60,51,4,4,0.06666666666666667,0.0784313725490196
"[1, 1, 1, 1, 0, 0, 1, 1, 0, 1, 0, 1, 0, 1, 0]",172,70,102,5,11,0.07142857142857142,0.10784313725490197
"[0, 1, 1, 0, 1, 0, 1, 1, 0, 0, 1, 0, 1, 1, 0]",118,59,59,4,6,0.06779661016949153,0.1016949152542373
"[0, 0, 0, 1, 1, 0, 1, 0, 0, 0, 0, 1, 1, 1, 0]",142,95,47,7,2,0.07368421052631578,0.0425531914893617
"[0, 1, 1, 1, 0, 1, 1, 1, 1, 0, 1, 0, 0, 0, 0]",141,64,77,7,6,0.109375,0.07792207792207792
"[0, 1, 0, 1, 0, 0, 1, 1, 1, 0, 1, 0, 1, 1, 1]",163,69,94,10,13,0.14492753623188406,0.13829787234042554
"[1, 0, 1, 1, 1, 0, 0, 0, 1, 1, 1, 0, 1, 1, 0]",141,48,93,3,11,0.0625,0.11827956989247312
"[0, 0, 1, 1, 0, 1, 0, 1, 1, 0, 1, 1, 0, 0, 1]",128,56,72,5,4,0.08928571428571429,0.05555555555555555
"[0, 1, 1, 0, 0, 0, 1, 0, 1, 1, 0, 1, 0, 1, 0]",97,51,46,9,8,0.17647058823529413,0.17391304347826086
"[0, 0, 1, 1, 1, 0, 1, 1, 0, 1, 0, 1, 0, 0, 1]",134,62,72,5,8,0.08064516129032258,0.1111111111111111
"[0, 1, 1, 0, 1, 0, 0, 1, 1, 0, 0, 0, 1, 1, 0]",135,68,67,5,7,0.07352941176470588,0.1044776119402985
"[1, 0, 0, 1, 0, 0, 1, 1, 0, 0, 1, 1, 0, 1, 1]",134,66,68,4,5,0.06060606060606061,0.07352941176470588
"[0, 1, 0, 0, 1, 1, 0, 1, 1, 0, 1, 0, 0, 1, 0]",103,50,53,6,2,0.12,0.03773584905660377
"[1, 0, 1, 0, 1, 1, 1, 1, 1, 0, 0, 0, 0, 0, 1]",163,82,81,3,9,0.036585365853658534,0.1111111111111111
"[0, 1, 1, 1, 0, 0, 0, 1, 0, 1, 1, 0, 0, 0, 1]",104,60,44,3,5,0.05,0.11363636363636363
"[1, 1, 1, 1, 0, 1, 0, 1, 0, 0, 0, 0, 1, 0, 0]",102,56,46,7,6,0.125,0.13043478260869565
"[1, 1, 1, 1, 1, 1, 0, 0, 1, 0, 1, 0, 0, 0, 1]",214,76,138,8,13,0.10526315789473684,0.09420289855072464
"[1, 1, 0, 1, 1, 0, 1, 0, 0, 1, 0, 0, 0, 0, 1]",122,62,60,5,6,0.08064516129032258,0.1
"[1, 0, 0, 0, 1, 1, 0, 1, 0, 0, 1, 0, 1, 1, 1]",120,50,70,3,5,0.06,0.07142857142857142
"[0, 1, 0, 1, 0, 1, 1, 1, 0, 1, 0, 1, 0, 1, 0]",97,54,43,4,5,0.07407407407407407,0.11627906976744186
"[1, 0, 1, 0, 1, 0, 0, 1, 1, 0, 1, 0, 0, 0, 1]",115,64,51,12,5,0.1875,0.09803921568627451
"[0, 0, 0, 1, 0, 0, 1, 1, 1, 0, 1, 1, 1, 1, 0]",135,55,80,3,5,0.05454545454545454,0.0625
"[1, 0, 1, 0, 1, 0, 0, 1, 0, 0, 1, 0, 1, 0, 1]",105,58,47,6,6,0.10344827586206896,0.1276595744680851
"[1, 0, 0, 1, 0, 0, 0, 1, 1, 1, 0, 0, 1, 0, 0]",148,91,57,6,6,0.06593406593406594,0.10526315789473684
"[0, 0, 0, 1, 0, 1, 1, 1, 1, 0, 0, 0, 1, 1, 0]",143,82,61,10,7,0.12195121951219512,0.11475409836065574
"[0, 1, 1, 0, 0, 1, 1, 0, 1, 0, 0, 1, 0, 1, 0]",118,65,53,3,3,0.046153846153846156,0.05660377358490566
"[0, 1, 1, 0, 1, 0, 0, 0, 0, 0, 1, 0, 1, 0, 1]",117,75,42,12,5,0.16,0.11904761904761904
"[0, 1, 1, 0, 0, 1, 0, 1, 0, 0, 1, 1, 0, 0, 1]",152,78,74,11,4,0.14102564102564102,0.05405405405405406
"[1, 1, 0, 1, 1, 0, 1, 1, 1, 1, 0, 1, 0, 0, 0]",146,53,93,11,14,0.20754716981132076,0.15053763440860216
"[0, 1, 1, 0, 1, 0, 1, 0, 1, 0, 1, 0, 0, 1, 0]",105,51,54,4,4,0.0784313725490196,0.07407407407407407
"[1, 0, 1, 1, 0, 0, 1, 1, 1, 0, 0, 0, 0, 0, 1]",129,76,53,7,3,0.09210526315789473,0.05660377358490566
"[0, 1, 0, 0, 0, 1, 0, 1, 1, 0, 1, 0, 1, 0, 1]",93,54,39,1,4,0.018518518518518517,0.10256410256410256
"[1, 1, 0, 0, 1, 1, 0, 1, 0, 0, 1, 0, 1, 0, 1]",117,56,61,3,4,0.05357142857142857,0.06557377049180328
"[0, 0, 1, 0, 0, 1, 0, 0, 1, 1, 1, 0, 0, 1, 0]",123,76,47,6,4,0.07894736842105263,0.0851063829787234
"[1, 1, 1, 1, 0, 0, 1, 0, 1, 0, 0, 0, 0, 1, 0]",112,44,68,3,5,0.06818181818181818,0.07352941176470588
"[1, 0, 1, 1, 0, 0, 1, 1, 1, 0, 0, 1, 0, 0, 0]",131,76,55,10,5,0.13157894736842105,0.09090909090909091
"[0, 1, 1, 0, 0, 1, 0, 1, 1, 1, 1, 1, 1, 1, 0]",282,113,169,11,17,0.09734513274336283,0.10059171597633136
"[0, 0, 0, 0, 1, 1, 0, 0, 1, 0, 1, 1, 1, 0, 1]",164,88,76,6,6,0.06818181818181818,0.07894736842105263
"[0, 0, 0, 1, 1, 0, 1, 1, 1, 0, 1, 1, 0, 0, 0]",122,60,62,2,5,0.03333333333333333,0.08064516129032258
"[0, 1, 0, 1, 1, 1, 1, 1, 0, 0, 1, 0, 0, 0, 1]",107,41,66,6,3,0.14634146341463414,0.045454545454545456
"[0, 1, 0, 0, 1, 0, 0, 0, 0, 1, 1, 1, 0, 0, 1]",164,90,74,12,4,0.13333333333333333,0.05405405405405406
"[0, 1, 0, 0, 0, 1, 1, 0, 1, 1, 0, 1, 0, 1, 0]",101,60,41,6,3,0.1,0.07317073170731707
"[1, 0, 1, 0, 1, 0, 1, 0, 0, 1, 1, 0, 0, 1, 0]",94,45,49,5,3,0.1111111111111111,0.061224489795918366
"[0, 1, 0, 1, 1, 0, 1, 1, 0, 1, 1, 1, 0, 0, 0]",122,47,75,2,12,0.0425531914893617,0.16
"[0, 1, 0, 1, 0, 0, 1, 0, 1, 0, 1, 0, 1, 1, 0]",103,49,54,8,3,0.16326530612244897,0.05555555555555555
"[1, 0, 0, 0, 1, 0, 1, 1, 1, 0, 1, 0, 1, 1, 0]",112,49,63,3,5,0.061224489795918366,0.07936507936507936
"[0, 1, 1, 1, 0, 1, 0, 0, 1, 0, 0, 0, 1, 1, 0]",115,65,50,7,4,0.1076923076923077,0.08
"[1, 0, 1, 1, 1, 0, 1, 0, 0, 1, 0, 0, 0, 1, 1]",110,54,56,6,7,0.1111111111111111,0.125
"[0, 0, 0, 1, 0, 0, 0, 1, 1, 1, 1, 1, 1, 0, 1]",134,64,70,6,7,0.09375,0.1
"[1, 0, 1, 1, 0, 0, 0, 1, 0, 1, 0, 0, 1, 0, 0]",140,93,47,8,1,0.08602150537634409,0.02127659574468085
"[0, 1, 1, 1, 0, 1, 0, 0, 0, 0, 0, 1, 1, 0, 1]",123,79,44,8,5,0.10126582278481013,0.11363636363636363
"[0, 0, 0, 0, 0, 1, 0, 1, 1, 1, 0, 1, 0, 1, 1]",123,77,46,9,2,0.11688311688311688,0.043478260869565216
"[0, 1, 0, 0, 1, 0, 1, 0, 1, 1, 0, 0, 1, 1, 0]",123,71,52,10,5,0.14084507042253522,0.09615384615384616
"[1, 0, 1, 1, 1, 0, 0, 1, 1, 0, 0, 0, 1, 0, 1]",100,46,54,4,6,0.08695652173913043,0.1111111111111111
"[1, 1, 0, 0, 1, 0, 1, 0, 0, 0, 0, 1, 1, 0, 1]",106,58,48,7,4,0.1206896551724138,0.08333333333333333
"[0, 0, 0, 0, 1, 1, 1, 0, 0, 1, 0, 0, 0, 0, 0]",724,501,223,56,26,0.11177644710578842,0.11659192825112108
"[0, 0, 0, 1, 0, 0, 1, 1, 0, 0, 0, 1, 1, 1, 1]",223,127,96,16,7,0.12598425196850394,0.07291666666666667
"[0, 1, 1, 0, 0, 0, 0, 1, 1, 0, 1, 0, 1, 1, 1]",295,219,76,27,2,0.1232876712328767,0.02631578947368421
"[0, 0, 0, 0, 1, 1, 0, 0, 0, 0, 1, 1, 0, 1, 0]",558,359,199,33,25,0.09192200557103064,0.12562814070351758
"[1, 0, 1, 0, 0, 0, 0, 1, 1, 0, 0, 0, 0, 1, 1]",516,290,226,33,21,0.11379310344827587,0.09292035398230089
"[0, 0, 1, 1, 0, 0, 1, 0, 0, 0, 0, 1, 1, 0, 0]",409,259,150,25,17,0.09652509652509653,0.11333333333333333
"[1, 1, 0, 1, 0, 0, 0, 1, 1, 0, 0, 1, 0, 0, 0]",154,89,65,8,9,0.0898876404494382,0.13846153846153847
"[1, 1, 0, 1, 1, 1, 0, 0, 0, 1, 1, 0, 1, 0, 0]",113,51,62,9,4,0.17647058823529413,0.06451612903225806
"[0, 1, 0, 0, 1, 1, 1, 1, 1, 1, 0, 0, 1, 1, 1]",797,312,485,32,41,0.10256410256410256,0.08453608247422681
"[1, 0, 1, 1, 1, 1, 0, 1, 1, 0, 1, 1, 0, 1, 1]",495,144,351,16,34,0.1111111111111111,0.09686609686609686
"[1, 1, 0, 1, 0, 1, 1, 1, 1, 0, 1, 1, 1, 1, 1]",1809,422,1387,40,124,0.0947867298578199,0.08940158615717375
"[0, 0, 0, 0, 0, 1, 1, 1, 1, 1, 1, 1, 1, 0, 0]",1702,1353,349,127,28,0.09386548410938655,0.08022922636103152
"[0, 0, 0, 0, 0, 0, 0, 0, 1, 1, 1, 1, 1, 1, 1]",2425,1327,1098,145,106,0.1092690278824416,0.0965391621129326
"[1, 1, 1, 1, 1, 0, 0, 0, 0, 0, 0, 0, 0, 0, 0]",2635,741,1894,66,180,0.08906882591093117,0.09503695881731784
"[0, 1, 1, 1, 1, 1, 0, 1, 1, 1, 1, 1, 1, 1, 1]",9089,2026,7063,178,676,0.087857847976308,0.09571003822738214
"[1, 1, 1, 1, 1, 1, 1, 1, 0, 1, 1, 1, 1, 1, 0]",7600,1380,6220,127,622,0.09202898550724638,0.1
"[0, 1, 1, 0, 0, 1, 0, 0, 0, 0, 0, 0, 0, 0, 1]",744,523,221,37,24,0.07074569789674952,0.1085972850678733
"[0, 1, 0, 0, 0, 0, 1, 1, 0, 0, 1, 0, 0, 0, 0]",575,413,162,31,14,0.07506053268765134,0.08641975308641975
"[1, 0, 0, 0, 1, 0, 1, 0, 0, 0, 0, 1, 1, 0, 0]",371,233,138,21,11,0.09012875536480687,0.07971014492753623
"[0, 0, 0, 1, 1, 0, 0, 0, 0, 0, 0, 0, 0, 0, 0]",26678,23891,2787,2258,270,0.09451257795822694,0.0968783638320775
"[0, 0, 0, 0, 0, 0, 0, 0, 0, 1, 1, 0, 0, 0, 0]",28609,25425,3184,2378,292,0.09352999016715831,0.09170854271356783
"[0, 0, 0, 0, 0, 0, 0, 0, 0, 0, 0, 0, 1, 0, 0]",57507,50907,6600,4892,634,0.09609680397587758,0.09606060606060605
"[1, 1, 1, 1, 1, 1, 1, 1, 1, 1, 1, 1, 0, 0, 1]",28634,4865,23769,488,2295,0.10030832476875642,0.09655433547898523
"[1, 0, 1, 1, 1, 0, 1, 1, 0, 1, 1, 1, 1, 0, 1]",485,151,334,8,27,0.052980132450331126,0.08083832335329341
"[1, 1, 1, 0, 1, 1, 0, 1, 0, 1, 1, 1, 1, 1, 1]",1911,474,1437,47,136,0.09915611814345991,0.09464161447459986
"[1, 1, 1, 0, 1, 0, 1, 1, 1, 0, 1, 1, 0, 1, 0]",228,87,141,8,20,0.09195402298850575,0.14184397163120568
"[1, 1, 1, 1, 1, 1, 1, 0, 1, 0, 1, 1, 1, 0, 1]",1648,373,1275,36,136,0.09651474530831099,0.10666666666666667
"[1, 0, 0, 0, 0, 1, 0, 1, 0, 1, 1, 1, 0, 0, 0]",170,92,78,7,8,0.07608695652173914,0.10256410256410256
"[1, 0, 1, 0, 0, 0, 0, 1, 0, 1, 0, 1, 1, 1, 0]",110,64,46,8,5,0.125,0.10869565217391304
"[0, 1, 0, 0, 1, 1, 1, 0, 1, 1, 0, 0, 1, 0, 0]",154,75,79,9,9,0.12,0.11392405063291139
"[1, 1, 0, 0, 0, 1, 0, 0, 1, 1, 0, 0, 0, 0, 1]",230,120,110,14,8,0.11666666666666667,0.07272727272727272
"[1, 1, 1, 0, 0, 0, 1, 0, 0, 1, 1, 0, 0, 0, 0]",261,123,138,8,13,0.06504065040650407,0.09420289855072464
"[0, 0, 0, 0, 0, 1, 0, 0, 0, 1, 0, 0, 0, 0, 0]",7596,6265,1331,615,136,0.09816440542697526,0.10217881292261458
"[0, 0, 0, 0, 0, 1, 0, 0, 0, 0, 1, 1, 1, 0, 0]",627,443,184,40,23,0.09029345372460497,0.125
"[0, 0, 1, 0, 0, 1, 0, 0, 0, 0, 0, 0, 0, 0, 0]",8907,7330,1577,737,124,0.10054570259208731,0.07863031071655041
"[0, 0, 1, 1, 1, 1, 1, 1, 1, 1, 0, 1, 1, 0, 1]",788,235,553,26,46,0.11063829787234042,0.08318264014466546
"[1, 0, 1, 0, 1, 1, 0, 0, 0, 0, 0, 1, 1, 1, 1]",250,117,133,9,9,0.07692307692307693,0.06766917293233082
"[1, 1, 1, 1, 1, 1, 0, 0, 0, 1, 1, 0, 0, 1, 1]",594,208,386,19,27,0.09134615384615384,0.06994818652849741
"[1, 1, 1, 1, 1, 1, 1, 1, 1, 1, 1, 1, 0, 0, 0]",7648,1863,5785,175,572,0.0939345142243693,0.09887640449438202
"[0, 1, 1, 1, 0, 1, 0, 0, 0, 0, 1, 1, 0, 0, 0]",249,150,99,13,8,0.08666666666666667,0.08080808080808081
"[0, 1, 1, 1, 0, 1, 0, 1, 1, 1, 0, 1, 0, 1, 1]",227,80,147,7,16,0.0875,0.10884353741496598
"[0, 1, 1, 0, 0, 1, 1, 1, 1, 0, 0, 1, 1, 1, 1]",2517,1856,661,178,63,0.09590517241379311,0.09531013615733737
"[0, 1, 0, 1, 0, 0, 0, 0, 0, 0, 0, 0, 1, 0, 1]",546,387,159,39,12,0.10077519379844961,0.07547169811320754
"[1, 0, 0, 0, 0, 0, 0, 1, 0, 1, 0, 0, 0, 0, 0]",1899,1381,518,141,42,0.10209992758870384,0.08108108108108109
"[0, 0, 1, 0, 0, 0, 0, 0, 0, 1, 0, 1, 0, 0, 0]",1666,1268,398,125,38,0.09858044164037855,0.09547738693467336
"[0, 1, 1, 0, 0, 1, 1, 1, 1, 0, 0, 0, 0, 1, 1]",1677,1329,348,100,24,0.07524454477050414,0.06896551724137931
"[0, 0, 1, 1, 0, 0, 1, 1, 0, 0, 1, 1, 1, 1, 0]",1487,719,768,65,84,0.09040333796940195,0.109375
"[0, 1, 1, 1, 0, 0, 1, 1, 0, 0, 1, 1, 0, 0, 1]",428,206,222,16,20,0.07766990291262135,0.09009009009009009
"[0, 1, 1, 1, 0, 0, 0, 0, 1, 0, 1, 0, 0, 0, 1]",147,85,62,7,10,0.08235294117647059,0.16129032258064516
"[1, 0, 0, 1, 0, 0, 0, 0, 0, 0, 0, 0, 0, 0, 0]",10048,7896,2152,780,209,0.09878419452887538,0.09711895910780668
"[0, 0, 0, 0, 0, 1, 0, 0, 1, 0, 0, 0, 0, 0, 0]",8257,6851,1406,696,138,0.10159100861188147,0.09815078236130868
"[1, 1, 1, 1, 0, 1, 1, 0, 1, 1, 1, 0, 1, 1, 1]",1693,441,1252,39,112,0.08843537414965986,0.08945686900958466
"[1, 0, 0, 1, 1, 1, 1, 0, 1, 1, 1, 1, 0, 1, 1]",672,178,494,16,40,0.0898876404494382,0.08097165991902834
"[1, 1, 1, 0, 0, 1, 1, 1, 1, 0, 1, 1, 1, 1, 0]",720,161,559,8,52,0.049689440993788817,0.09302325581395349
"[1, 1, 0, 1, 1, 0, 1, 1, 1, 1, 0, 0, 1, 1, 1]",916,266,650,25,60,0.09398496240601503,0.09230769230769231
"[1, 1, 1, 1, 0, 1, 1, 1, 1, 1, 0, 1, 1, 0, 1]",1521,367,1154,30,107,0.08174386920980926,0.0927209705372617
"[1, 0, 1, 1, 1, 1, 1, 1, 1, 1, 0, 1, 0, 1, 1]",1668,406,1262,42,108,0.10344827586206896,0.08557844690966719
"[1, 0, 1, 0, 1, 0, 0, 1, 1, 1, 0, 0, 0, 0, 0]",184,108,76,19,8,0.17592592592592593,0.10526315789473684
"[1, 0, 0, 0, 1, 0, 1, 0, 1, 0, 0, 1, 1, 1, 0]",121,62,59,6,3,0.0967741935483871,0.05084745762711865
"[0, 0, 1, 0, 1, 0, 1, 1, 1, 1, 0, 1, 0, 1, 0]",113,51,62,7,7,0.13725490196078433,0.11290322580645161
"[0, 1, 0, 0, 0, 0, 0, 0, 1, 0, 1, 0, 0, 1, 1]",328,223,105,15,10,0.06726457399103139,0.09523809523809523
"[0, 0, 1, 0, 0, 1, 0, 0, 0, 0, 0, 0, 1, 0, 1]",498,353,145,26,14,0.07365439093484419,0.09655172413793103
"[0, 0, 1, 1, 1, 0, 0, 0, 0, 0, 0, 1, 1, 1, 1]",592,324,268,23,17,0.07098765432098765,0.06343283582089553
"[1, 1, 0, 0, 1, 0, 0, 1, 1, 1, 0, 1, 0, 0, 1]",125,64,61,4,7,0.0625,0.11475409836065574
"[1, 0, 1, 0, 1, 0, 0, 0, 0, 1, 0, 0, 0, 0, 0]",558,399,159,38,19,0.09523809523809523,0.11949685534591195
"[0, 0, 0, 0, 0, 1, 0, 0, 1, 0, 1, 0, 1, 0, 0]",524,378,146,40,11,0.10582010582010581,0.07534246575342465
"[0, 1, 0, 0, 0, 0, 0, 1, 0, 0, 1, 0, 1, 0, 1]",224,145,79,20,9,0.13793103448275862,0.11392405063291139
"[0, 0, 0, 0, 0, 0, 0, 1, 0, 0, 0, 0, 0, 1, 0]",6850,5698,1152,549,111,0.09634959634959635,0.09635416666666667
"[0, 0, 0, 0, 0, 0, 0, 0, 1, 0, 0, 0, 0, 0, 1]",8872,7387,1485,683,144,0.09245972654663598,0.09696969696969697
"[0, 1, 1, 0, 0, 0, 0, 0, 0, 0, 0, 1, 0, 0, 0]",2479,2075,404,216,46,0.10409638554216867,0.11386138613861387
"[0, 0, 0, 0, 1, 0, 0, 0, 1, 0, 0, 0, 1, 1, 0]",617,442,175,39,20,0.08823529411764706,0.11428571428571428
"[1, 1, 1, 1, 1, 1, 1, 1, 0, 0, 1, 1, 1, 0, 1]",2733,645,2088,67,209,0.10387596899224806,0.10009578544061302
"[1, 1, 1, 0, 1, 1, 1, 1, 1, 1, 1, 0, 1, 1, 1]",7421,1364,6057,122,593,0.08944281524926687,0.09790325243519894
"[1, 1, 1, 1, 0, 1, 1, 1, 1, 1, 1, 1, 0, 1, 1]",7105,1277,5828,141,554,0.11041503523884104,0.09505833905284831
"[1, 1, 1, 0, 1, 1, 0, 1, 1, 1, 1, 1, 0, 1, 1]",1541,367,1174,39,114,0.10626702997275204,0.09710391822827939
"[0, 1, 0, 1, 1, 1, 1, 0, 1, 1, 0, 1, 1, 1, 1]",585,184,401,18,39,0.09782608695652174,0.09725685785536159
"[0, 0, 0, 0, 0, 0, 1, 1, 0, 0, 1, 1, 0, 1, 0]",563,356,207,25,23,0.0702247191011236,0.1111111111111111
"[0, 1, 1, 0, 0, 0, 0, 1, 1, 0, 0, 0, 0, 1, 1]",2081,1789,292,177,24,0.09893795416433762,0.0821917808219178
"[1, 1, 1, 0, 1, 1, 1, 1, 1, 1, 1, 1, 0, 1, 1]",7252,1271,5981,136,577,0.10700236034618411,0.09647216184584517
"[1, 0, 1, 0, 0, 0, 0, 0, 0, 0, 0, 0, 1, 1, 1]",775,511,264,39,25,0.07632093933463796,0.0946969696969697
"[0, 0, 0, 0, 1, 0, 0, 0, 0, 1, 0, 1, 1, 0, 0]",563,398,165,34,17,0.08542713567839195,0.10303030303030303
"[0, 1, 1, 1, 0, 0, 1, 1, 0, 1, 0, 1, 1, 0, 0]",131,61,70,8,12,0.13114754098360656,0.17142857142857143
"[0, 0, 1, 0, 0, 1, 1, 1, 0, 0, 1, 1, 0, 1, 0]",106,55,51,4,8,0.07272727272727272,0.1568627450980392
"[1, 0, 0, 0, 0, 0, 0, 1, 1, 0, 0, 0, 0, 1, 1]",2483,709,1774,67,144,0.09449929478138223,0.08117249154453213
"[0, 0, 0, 0, 0, 0, 0, 1, 0, 0, 0, 1, 1, 1, 1]",939,720,219,68,19,0.09444444444444444,0.0867579908675799
"[0, 0, 0, 0, 1, 0, 0, 0, 0, 1, 1, 0, 0, 0, 0]",2919,2265,654,193,56,0.08520971302428255,0.0856269113149847
"[1, 1, 0, 1, 0, 1, 0, 1, 1, 1, 0, 0, 0, 1, 1]",172,68,104,6,12,0.08823529411764706,0.11538461538461539
"[1, 1, 1, 1, 1, 1, 0, 0, 1, 1, 1, 1, 0, 1, 1]",3157,776,2381,71,202,0.09149484536082474,0.08483830323393532
"[0, 0, 0, 1, 1, 0, 0, 1, 1, 1, 1, 0, 0, 0, 0]",2007,1655,352,148,21,0.08942598187311178,0.05965909090909091
"[1, 1, 1, 1, 0, 1, 1, 1, 0, 0, 0, 1, 1, 1, 1]",767,223,544,23,37,0.1031390134529148,0.06801470588235294
"[1, 1, 1, 0, 0, 0, 0, 1, 1, 0, 1, 1, 1, 1, 1]",608,137,471,15,49,0.10948905109489052,0.1040339702760085
"[1, 1, 1, 1, 1, 1, 0, 0, 0, 0, 1, 1, 0, 1, 1]",811,274,537,30,58,0.10948905109489052,0.10800744878957169
"[0, 1, 1, 1, 1, 1, 1, 0, 0, 0, 0, 1, 1, 0, 1]",426,295,131,22,8,0.07457627118644068,0.061068702290076333
"[1, 1, 0, 1, 0, 0, 1, 0, 0, 1, 1, 1, 1, 1, 0]",176,79,97,10,11,0.12658227848101267,0.1134020618556701
"[0, 0, 0, 0, 1, 1, 0, 0, 1, 1, 1, 0, 0, 0, 1]",294,179,115,18,14,0.1005586592178771,0.12173913043478261
"[0, 0, 0, 0, 0, 1, 1, 0, 0, 1, 1, 1, 0, 0, 0]",535,409,126,32,9,0.07823960880195599,0.07142857142857142
"[0, 1, 1, 0, 0, 1, 0, 0, 0, 0, 0, 1, 1, 0, 0]",382,266,116,25,16,0.09398496240601503,0.13793103448275862
"[0, 0, 0, 1, 0, 1, 0, 0, 1, 0, 1, 0, 0, 1, 0]",207,143,64,13,4,0.09090909090909091,0.0625
"[0, 0, 0, 0, 0, 0, 1, 0, 1, 0, 0, 1, 0, 1, 0]",566,429,137,36,13,0.08391608391608392,0.0948905109489051
"[1, 0, 0, 0, 1, 0, 0, 0, 0, 0, 1, 1, 0, 0, 1]",365,236,129,21,17,0.08898305084745763,0.13178294573643412
"[0, 1, 1, 0, 0, 0, 1, 0, 0, 0, 0, 0, 1, 1, 0]",314,224,90,24,4,0.10714285714285714,0.044444444444444446
"[0, 0, 0, 0, 0, 1, 1, 0, 0, 1, 0, 0, 0, 0, 1]",803,633,170,62,18,0.09794628751974724,0.10588235294117647
"[0, 0, 0, 0, 0, 0, 0, 1, 1, 0, 0, 1, 0, 0, 0]",2407,1947,460,176,53,0.0903954802259887,0.11521739130434783
"[0, 1, 1, 1, 1, 1, 1, 1, 1, 1, 1, 1, 0, 1, 1]",8454,2311,6143,235,572,0.10168758113370835,0.09311411362526453
"[0, 0, 1, 0, 0, 1, 0, 0, 0, 1, 1, 0, 0, 0, 0]",743,531,212,49,14,0.09227871939736347,0.0660377358490566
"[0, 1, 0, 0, 1, 1, 1, 1, 1, 0, 0, 0, 0, 1, 0]",132,75,57,5,4,0.06666666666666667,0.07017543859649122
"[0, 0, 0, 1, 0, 0, 1, 1, 1, 1, 1, 0, 0, 0, 0]",299,202,97,21,11,0.10396039603960396,0.1134020618556701
"[1, 0, 0, 0, 0, 1, 0, 0, 1, 1, 1, 1, 1, 0, 0]",169,88,81,8,5,0.09090909090909091,0.06172839506172839
"[1, 0, 1, 0, 1, 1, 1, 1, 1, 0, 1, 1, 1, 1, 1]",1802,401,1401,34,129,0.08478802992518704,0.09207708779443255
"[1, 1, 0, 1, 0, 1, 0, 1, 1, 1, 1, 0, 0, 1, 1]",369,125,244,11,24,0.088,0.09836065573770492
"[1, 1, 1, 0, 1, 0, 1, 0, 1, 1, 1, 1, 0, 0, 1]",335,121,214,14,30,0.11570247933884298,0.14018691588785046
"[0, 1, 1, 1, 0, 1, 0, 1, 1, 1, 1, 1, 1, 0, 0]",379,139,240,12,25,0.08633093525179857,0.10416666666666667
"[1, 1, 1, 1, 1, 1, 0, 0, 0, 0, 1, 1, 0, 0, 0]",1649,767,882,82,90,0.10691003911342895,0.10204081632653061
"[0, 1, 1, 0, 1, 1, 1, 1, 1, 1, 1, 0, 0, 1, 0]",247,95,152,16,15,0.16842105263157894,0.09868421052631579
"[0, 1, 0, 1, 1, 1, 0, 1, 1, 0, 1, 1, 1, 1, 1]",582,166,416,16,39,0.0963855421686747,0.09375
"[0, 1, 0, 0, 1, 1, 1, 1, 1, 1, 1, 1, 0, 1, 0]",277,108,169,10,22,0.09259259259259259,0.1301775147928994
"[0, 0, 1, 1, 1, 1, 0, 1, 0, 1, 0, 0, 0, 1, 0]",114,56,58,8,4,0.14285714285714285,0.06896551724137931
"[1, 0, 0, 1, 0, 0, 0, 0, 1, 1, 1, 1, 0, 1, 0]",123,66,57,3,8,0.045454545454545456,0.14035087719298245
"[0, 0, 0, 0, 0, 0, 0, 1, 0, 1, 0, 0, 0, 0, 0]",8154,6804,1350,649,129,0.09538506760728983,0.09555555555555556
"[0, 0, 1, 0, 0, 0, 1, 0, 1, 1, 1, 1, 1, 0, 0]",156,80,76,11,6,0.1375,0.07894736842105263
"[0, 0, 0, 1, 1, 0, 0, 0, 0, 1, 0, 0, 0, 1, 0]",599,457,142,33,15,0.07221006564551423,0.1056338028169014
"[0, 1, 1, 0, 0, 0, 0, 1, 1, 0, 0, 0, 0, 1, 0]",632,500,132,49,9,0.098,0.06818181818181818
"[0, 0, 1, 1, 1, 0, 1, 0, 0, 0, 0, 0, 0, 0, 0]",808,567,241,54,18,0.09523809523809523,0.07468879668049792
"[1, 0, 1, 0, 0, 0, 1, 0, 1, 0, 0, 0, 0, 0, 0]",603,417,186,41,20,0.09832134292565947,0.10752688172043011
"[0, 0, 0, 0, 0, 1, 0, 0, 0, 0, 1, 0, 1, 0, 0]",1592,1226,366,128,26,0.10440456769983687,0.07103825136612021
"[1, 0, 0, 1, 1, 0, 1, 0, 0, 1, 1, 0, 0, 1, 1]",203,89,114,6,10,0.06741573033707865,0.08771929824561403
"[1, 1, 1, 1, 0, 1, 0, 1, 1, 1, 1, 0, 1, 0, 1]",506,148,358,13,39,0.08783783783783784,0.10893854748603352
"[1, 0, 1, 1, 1, 1, 1, 1, 1, 1, 0, 1, 0, 0, 0]",292,116,176,10,25,0.08620689655172414,0.14204545454545456
"[1, 1, 0, 1, 1, 1, 1, 1, 1, 1, 1, 0, 1, 0, 0]",604,177,427,19,54,0.10734463276836158,0.12646370023419204
"[1, 1, 0, 0, 1, 1, 1, 1, 1, 1, 0, 1, 1, 1, 1]",3086,740,2346,73,229,0.09864864864864865,0.09761295822676896
"[0, 0, 0, 0, 0, 1, 1, 1, 1, 1, 1, 0, 1, 1, 1]",525,392,133,30,14,0.07653061224489796,0.10526315789473684
"[0, 0, 0, 1, 0, 0, 0, 1, 1, 0, 0, 1, 1, 1, 0]",154,87,67,12,6,0.13793103448275862,0.08955223880597014
"[0, 1, 1, 1, 1, 0, 1, 0, 1, 1, 1, 0, 0, 0, 1]",161,65,96,8,8,0.12307692307692308,0.08333333333333333
"[1, 0, 1, 1, 1, 1, 1, 1, 1, 0, 1, 1, 1, 0, 0]",644,188,456,19,39,0.10106382978723404,0.08552631578947369
"[0, 0, 1, 1, 0, 0, 0, 0, 0, 0, 0, 0, 0, 1, 1]",2751,2040,711,164,74,0.0803921568627451,0.10407876230661041
"[0, 0, 1, 1, 0, 0, 0, 0, 0, 0, 1, 1, 0, 0, 0]",4357,3045,1312,240,117,0.07881773399014778,0.08917682926829268
"[0, 1, 0, 0, 1, 0, 0, 0, 0, 0, 0, 0, 1, 1, 1]",592,401,191,39,22,0.09725685785536159,0.11518324607329843
"[0, 0, 0, 0, 0, 0, 0, 0, 1, 0, 0, 1, 0, 0, 1]",1931,1505,426,141,45,0.09368770764119601,0.1056338028169014
"[0, 0, 0, 1, 0, 0, 0, 0, 0, 1, 0, 0, 1, 0, 0]",1586,1204,382,107,35,0.0888704318936877,0.09162303664921466
"[1, 1, 1, 1, 0, 1, 1, 0, 0, 0, 1, 1, 1, 1, 0]",330,115,215,19,22,0.16521739130434782,0.10232558139534884
"[1, 0, 1, 0, 1, 1, 1, 0, 0, 1, 1, 1, 1, 1, 1]",995,283,712,24,62,0.08480565371024736,0.08707865168539326
"[1, 1, 0, 1, 0, 1, 1, 1, 0, 0, 1, 1, 1, 1, 1]",920,272,648,21,62,0.07720588235294118,0.09567901234567901
"[1, 0, 1, 1, 0, 0, 0, 0, 0, 0, 1, 1, 1, 1, 1]",543,245,298,28,28,0.11428571428571428,0.09395973154362416
"[0, 1, 1, 1, 0, 0, 1, 0, 0, 1, 0, 1, 1, 0, 0]",131,65,66,11,11,0.16923076923076924,0.16666666666666666
"[0, 0, 0, 1, 1, 1, 0, 1, 1, 1, 1, 1, 1, 1, 1]",965,369,596,39,54,0.10569105691056911,0.09060402684563758
"[0, 1, 1, 0, 0, 0, 0, 0, 1, 1, 1, 0, 1, 1, 1]",220,127,93,7,7,0.05511811023622047,0.07526881720430108
"[0, 1, 0, 1, 1, 0, 1, 1, 1, 0, 1, 1, 0, 0, 1]",130,53,77,12,8,0.22641509433962265,0.1038961038961039
"[0, 0, 1, 1, 1, 1, 0, 0, 1, 0, 1, 1, 0, 1, 1]",225,102,123,8,14,0.0784313725490196,0.11382113821138211
"[0, 1, 1, 1, 1, 0, 0, 1, 0, 1, 1, 1, 0, 0, 1]",201,93,108,8,8,0.08602150537634409,0.07407407407407407
"[0, 0, 0, 0, 0, 0, 1, 1, 0, 1, 0, 1, 1, 0, 1]",189,115,74,8,8,0.06956521739130435,0.10810810810810811
"[0, 0, 0, 0, 0, 1, 0, 1, 1, 0, 0, 0, 0, 0, 0]",2322,1777,545,171,47,0.09622960045019696,0.08623853211009175
"[0, 0, 1, 1, 1, 1, 0, 0, 0, 0, 0, 1, 0, 1, 1]",304,169,135,15,12,0.08875739644970414,0.08888888888888889
"[1, 0, 0, 0, 0, 0, 0, 0, 0, 0, 1, 1, 1, 1, 0]",1046,622,424,48,53,0.07717041800643087,0.125
"[0, 1, 1, 1, 0, 0, 0, 0, 0, 0, 0, 0, 0, 1, 1]",728,501,227,43,16,0.08582834331337326,0.07048458149779736
"[0, 0, 0, 1, 0, 1, 1, 0, 1, 0, 1, 1, 1, 0, 0]",117,71,46,9,4,0.1267605633802817,0.08695652173913043
"[1, 0, 0, 0, 0, 1, 0, 1, 1, 0, 1, 0, 1, 1, 1]",123,56,67,9,6,0.16071428571428573,0.08955223880597014
"[0, 0, 0, 1, 0, 0, 0, 1, 0, 0, 1, 0, 0, 0, 0]",1682,1272,410,103,28,0.0809748427672956,0.06829268292682927
"[0, 0, 0, 0, 1, 0, 0, 0, 1, 0, 0, 1, 0, 0, 0]",1611,1222,389,126,22,0.10310965630114566,0.056555269922879174
"[0, 0, 1, 0, 0, 0, 1, 0, 0, 0, 1, 1, 0, 0, 1]",310,214,96,18,9,0.08411214953271028,0.09375
"[0, 1, 0, 0, 0, 0, 0, 0, 1, 0, 0, 0, 1, 0, 0]",1504,1125,379,127,32,0.11288888888888889,0.08443271767810026
"[0, 1, 0, 1, 1, 0, 0, 1, 0, 1, 0, 0, 0, 1, 0]",134,67,67,10,8,0.14925373134328357,0.11940298507462686
"[0, 1, 1, 0, 0, 1, 0, 1, 1, 0, 0, 1, 0, 1, 0]",104,60,44,9,6,0.15,0.13636363636363635
"[1, 0, 0, 0, 0, 0, 0, 0, 0, 0, 1, 1, 0, 0, 0]",3758,2626,1132,239,108,0.09101294744859101,0.09540636042402827
"[0, 0, 0, 1, 0, 0, 1, 1, 0, 0, 0, 0, 0, 0, 0]",2914,2225,689,183,75,0.08224719101123595,0.10885341074020319
"[0, 0, 1, 0, 0, 0, 0, 0, 0, 0, 1, 0, 0, 1, 1]",795,575,220,60,17,0.10434782608695652,0.07727272727272727
"[1, 0, 0, 0, 0, 1, 0, 1, 0, 0, 1, 0, 1, 0, 0]",219,140,79,10,8,0.07142857142857142,0.10126582278481013
"[0, 0, 0, 0, 1, 1, 1, 1, 1, 1, 1, 1, 0, 0, 0]",1636,853,783,81,81,0.09495896834701055,0.10344827586206896
"[1, 1, 0, 0, 1, 1, 0, 0, 1, 1, 1, 1, 1, 0, 1]",628,221,407,33,41,0.1493212669683258,0.10073710073710074
"[1, 1, 1, 1, 1, 0, 0, 1, 1, 0, 0, 1, 1, 1, 1]",5439,751,4688,78,439,0.10386151797603196,0.09364334470989762
"[1, 0, 1, 1, 1, 0, 1, 0, 0, 1, 1, 1, 0, 0, 1]",168,73,95,8,8,0.1095890410958904,0.08421052631578947
"[0, 0, 1, 1, 1, 0, 1, 0, 0, 0, 0, 1, 1, 1, 1]",255,108,147,8,11,0.07407407407407407,0.07482993197278912
"[1, 0, 0, 1, 0, 1, 1, 0, 0, 1, 1, 1, 0, 1, 0]",127,57,70,7,5,0.12280701754385964,0.07142857142857142
"[0, 0, 1, 0, 0, 0, 1, 0, 0, 1, 0, 1, 1, 0, 0]",277,183,94,19,11,0.10382513661202186,0.11702127659574468
"[0, 0, 0, 0, 0, 1, 0, 0, 0, 0, 0, 0, 1, 0, 0]",6771,5615,1156,557,89,0.09919857524487978,0.07698961937716263
"[1, 0, 0, 0, 1, 1, 0, 0, 0, 0, 0, 0, 1, 1, 0]",716,459,257,42,19,0.0915032679738562,0.07392996108949416
"[0, 0, 0, 0, 0, 0, 0, 0, 0, 1, 0, 0, 0, 1, 1]",4244,3519,725,309,78,0.08780903665814152,0.10758620689655173
"[0, 0, 0, 0, 0, 0, 0, 0, 0, 1, 0, 1, 1, 0, 0]",2253,1754,499,163,44,0.09293044469783353,0.08817635270541083
"[0, 1, 1, 0, 0, 1, 0, 0, 0, 0, 0, 0, 0, 0, 0]",2479,1904,575,172,53,0.09033613445378151,0.09217391304347826
"[1, 1, 0, 1, 1, 0, 0, 1, 0, 0, 0, 0, 0, 0, 0]",364,221,143,17,14,0.07692307692307693,0.0979020979020979
"[1, 0, 1, 1, 0, 1, 1, 0, 0, 1, 0, 0, 0, 0, 0]",168,92,76,7,9,0.07608695652173914,0.11842105263157894
"[0, 0, 0, 0, 0, 0, 0, 0, 0, 1, 0, 1, 1, 0, 1]",684,509,175,59,11,0.11591355599214145,0.06285714285714286
"[0, 0, 1, 0, 1, 0, 0, 1, 1, 0, 0, 0, 0, 0, 0]",1006,698,308,68,22,0.09742120343839542,0.07142857142857142
"[1, 0, 0, 0, 0, 1, 1, 0, 1, 1, 1, 0, 0, 1, 1]",202,79,123,5,13,0.06329113924050633,0.10569105691056911
"[1, 0, 1, 1, 1, 1, 0, 0, 0, 1, 0, 0, 0, 0, 1]",149,79,70,7,5,0.08860759493670886,0.07142857142857142
"[0, 1, 0, 0, 1, 1, 1, 0, 1, 0, 0, 0, 1, 1, 1]",158,88,70,11,12,0.125,0.17142857142857143
"[1, 1, 1, 0, 1, 0, 1, 0, 0, 1, 0, 0, 1, 1, 1]",178,66,112,8,8,0.12121212121212122,0.07142857142857142
"[0, 1, 1, 1, 1, 1, 0, 1, 1, 0, 0, 0, 0, 0, 1]",150,70,80,6,5,0.08571428571428572,0.0625
"[0, 1, 0, 0, 1, 0, 1, 0, 1, 0, 0, 0, 0, 1, 1]",195,110,85,11,12,0.1,0.1411764705882353
"[1, 1, 0, 1, 0, 1, 0, 0, 0, 1, 1, 1, 1, 0, 0]",178,93,85,8,3,0.08602150537634409,0.03529411764705882
"[0, 0, 1, 0, 1, 0, 1, 0, 0, 1, 1, 1, 0, 1, 1]",125,58,67,7,7,0.1206896551724138,0.1044776119402985
"[0, 1, 1, 1, 1, 1, 0, 1, 1, 1, 1, 1, 0, 1, 0]",503,187,316,18,29,0.0962566844919786,0.09177215189873418
"[0, 0, 1, 0, 0, 0, 1, 1, 1, 1, 1, 0, 1, 1, 1]",194,86,108,7,11,0.08139534883720931,0.10185185185185185
"[1, 0, 1, 0, 0, 1, 0, 0, 0, 1, 1, 1, 1, 1, 0]",128,61,67,7,8,0.11475409836065574,0.11940298507462686
"[1, 1, 0, 0, 1, 1, 0, 1, 0, 0, 1, 0, 0, 0, 1]",125,70,55,8,12,0.11428571428571428,0.21818181818181817
"[1, 0, 0, 1, 1, 0, 0, 0, 1, 1, 1, 0, 1, 0, 1]",132,52,80,2,6,0.038461538461538464,0.075
"[0, 0, 1, 0, 0, 0, 1, 1, 1, 1, 0, 1, 0, 0, 1]",141,78,63,11,1,0.14102564102564102,0.015873015873015872
"[1, 1, 1, 0, 0, 1, 0, 0, 0, 1, 1, 1, 1, 0, 1]",165,59,106,6,12,0.1016949152542373,0.11320754716981132
"[0, 1, 0, 1, 1, 1, 1, 1, 1, 0, 0, 1, 0, 0, 0]",149,73,76,6,2,0.0821917808219178,0.02631578947368421
"[0, 0, 0, 1, 1, 0, 1, 0, 1, 0, 0, 0, 1, 0, 0]",238,172,66,17,2,0.09883720930232558,0.030303030303030304
"[1, 0, 0, 0, 0, 1, 0, 0, 0, 0, 0, 0, 0, 0, 1]",2045,1476,569,129,55,0.08739837398373984,0.09666080843585237
"[0, 1, 1, 0, 0, 0, 0, 1, 1, 0, 0, 0, 0, 0, 1]",840,694,146,58,16,0.08357348703170028,0.1095890410958904
"[0, 0, 0, 1, 1, 0, 0, 0, 0, 1, 1, 0, 0, 0, 0]",4696,4042,654,393,67,0.09722909450766946,0.10244648318042814
"[0, 1, 0, 0, 0, 0, 0, 0, 0, 0, 0, 1, 1, 0, 0]",3445,2662,783,260,75,0.09767092411720511,0.09578544061302682
"[1, 0, 0, 1, 1, 0, 0, 0, 0, 0, 0, 1, 0, 0, 0]",822,445,377,42,27,0.09438202247191012,0.07161803713527852
"[1, 0, 0, 0, 1, 0, 0, 1, 0, 1, 1, 1, 1, 0, 1]",99,36,63,2,6,0.05555555555555555,0.09523809523809523
"[0, 1, 0, 1, 1, 1, 1, 1, 1, 1, 1, 1, 0, 0, 1]",1006,301,705,30,75,0.09966777408637874,0.10638297872340426
"[0, 0, 0, 1, 1, 1, 0, 1, 0, 1, 1, 1, 1, 1, 1]",381,183,198,15,22,0.08196721311475409,0.1111111111111111
"[1, 1, 0, 0, 0, 1, 0, 0, 0, 1, 1, 1, 0, 1, 0]",96,50,46,6,3,0.12,0.06521739130434782
"[0, 1, 1, 1, 1, 0, 0, 1, 1, 1, 1, 1, 0, 1, 1]",966,479,487,54,50,0.1127348643006263,0.1026694045174538
"[1, 0, 1, 1, 1, 0, 1, 1, 1, 1, 1, 0, 0, 1, 0]",246,82,164,6,19,0.07317073170731707,0.11585365853658537
"[1, 0, 1, 1, 1, 1, 1, 0, 1, 1, 1, 1, 0, 1, 1]",1599,388,1211,36,104,0.09278350515463918,0.08587943848059455
"[1, 1, 0, 1, 1, 1, 1, 1, 0, 1, 1, 1, 1, 0, 1]",1495,325,1170,24,120,0.07384615384615385,0.10256410256410256
"[0, 1, 1, 1, 1, 1, 0, 1, 1, 0, 1, 1, 1, 1, 1]",1836,521,1315,59,124,0.11324376199616124,0.09429657794676806
"[0, 0, 1, 1, 0, 0, 0, 0, 0, 1, 1, 1, 0, 0, 1]",214,124,90,8,9,0.06451612903225806,0.1
"[0, 0, 0, 1, 0, 0, 0, 1, 1, 0, 0, 1, 1, 0, 0]",629,416,213,53,22,0.12740384615384615,0.10328638497652583
"[0, 0, 0, 1, 0, 1, 1, 1, 0, 1, 1, 1, 0, 1, 0]",115,54,61,6,3,0.1111111111111111,0.04918032786885246
"[1, 0, 1, 1, 1, 1, 0, 1, 1, 1, 0, 0, 0, 1, 1]",297,97,200,12,24,0.12371134020618557,0.12
"[1, 0, 0, 0, 0, 1, 0, 0, 1, 0, 1, 1, 1, 1, 0]",112,55,57,2,8,0.03636363636363636,0.14035087719298245
"[0, 0, 0, 0, 1, 1, 0, 0, 0, 0, 1, 0, 0, 1, 0]",760,531,229,53,20,0.09981167608286252,0.08733624454148471
"[0, 1, 0, 1, 1, 0, 0, 0, 0, 0, 0, 0, 1, 0, 1]",242,154,88,8,6,0.05194805194805195,0.06818181818181818
"[0, 0, 0, 0, 1, 0, 1, 0, 1, 1, 1, 0, 0, 1, 1]",159,85,74,10,7,0.11764705882352941,0.0945945945945946
"[1, 0, 0, 1, 1, 1, 0, 0, 1, 0, 1, 0, 0, 1, 1]",151,76,75,7,9,0.09210526315789473,0.12
"[1, 1, 1, 0, 0, 0, 1, 1, 0, 0, 1, 0, 0, 0, 0]",166,77,89,10,6,0.12987012987012986,0.06741573033707865
"[1, 1, 0, 1, 0, 0, 0, 0, 0, 0, 1, 1, 0, 0, 0]",498,300,198,27,19,0.09,0.09595959595959595
"[1, 0, 1, 1, 0, 1, 1, 0, 0, 0, 0, 0, 0, 0, 0]",463,265,198,26,16,0.09811320754716982,0.08080808080808081
"[1, 0, 0, 0, 1, 1, 0, 1, 1, 1, 1, 1, 1, 0, 1]",245,68,177,1,19,0.014705882352941176,0.10734463276836158
"[1, 1, 0, 1, 0, 1, 0, 0, 0, 1, 1, 0, 1, 1, 1]",171,75,96,7,10,0.09333333333333334,0.10416666666666667
"[1, 1, 1, 0, 1, 1, 0, 1, 0, 0, 0, 1, 1, 1, 0]",141,52,89,8,6,0.15384615384615385,0.06741573033707865
"[1, 0, 1, 0, 1, 0, 0, 0, 1, 0, 1, 1, 0, 0, 1]",149,73,76,6,7,0.0821917808219178,0.09210526315789473
"[1, 0, 0, 1, 0, 0, 1, 0, 0, 0, 1, 1, 1, 1, 1]",182,81,101,9,8,0.1111111111111111,0.07920792079207921
"[1, 1, 1, 1, 1, 0, 1, 1, 0, 1, 1, 1, 0, 0, 0]",342,105,237,10,19,0.09523809523809523,0.08016877637130802
"[1, 0, 0, 1, 0, 0, 1, 1, 1, 0, 1, 1, 1, 0, 0]",137,63,74,5,9,0.07936507936507936,0.12162162162162163
"[0, 0, 0, 0, 0, 0, 1, 1, 1, 1, 0, 0, 1, 1, 0]",2065,1259,806,116,82,0.09213661636219221,0.10173697270471464
"[0, 0, 0, 0, 0, 0, 0, 1, 1, 0, 0, 0, 1, 0, 0]",2365,1901,464,183,46,0.09626512361914781,0.09913793103448276
"[0, 0, 1, 1, 1, 1, 1, 1, 0, 0, 0, 1, 0, 1, 1]",361,161,200,11,19,0.06832298136645963,0.095
"[0, 1, 0, 0, 0, 0, 0, 1, 1, 1, 1, 1, 1, 0, 0]",468,262,206,28,19,0.10687022900763359,0.09223300970873786
"[1, 0, 0, 0, 0, 0, 0, 1, 0, 0, 0, 0, 0, 1, 1]",957,599,358,48,32,0.08013355592654424,0.0893854748603352
"[1, 0, 0, 0, 0, 0, 0, 1, 0, 0, 0, 1, 1, 0, 0]",725,474,251,42,16,0.08860759493670886,0.06374501992031872
"[0, 0, 0, 1, 0, 0, 0, 1, 1, 0, 0, 0, 1, 0, 0]",589,407,182,24,28,0.05896805896805897,0.15384615384615385
"[1, 0, 0, 0, 1, 0, 0, 0, 1, 1, 0, 0, 0, 1, 0]",279,169,110,21,13,0.1242603550295858,0.11818181818181818
"[0, 0, 0, 0, 0, 0, 1, 0, 0, 1, 0, 0, 0, 0, 1]",1814,1404,410,116,40,0.08262108262108261,0.0975609756097561
"[1, 1, 1, 1, 0, 0, 0, 0, 0, 0, 1, 1, 0, 0, 1]",1582,758,824,66,62,0.0870712401055409,0.07524271844660194
"[0, 0, 1, 0, 1, 1, 1, 1, 1, 1, 0, 0, 0, 0, 0]",313,181,132,22,11,0.12154696132596685,0.08333333333333333
"[1, 1, 0, 0, 1, 0, 1, 1, 1, 1, 1, 1, 0, 0, 0]",271,119,152,12,14,0.10084033613445378,0.09210526315789473
"[0, 1, 1, 1, 0, 0, 0, 0, 1, 1, 1, 0, 1, 1, 1]",237,106,131,7,7,0.0660377358490566,0.05343511450381679
"[0, 0, 1, 0, 0, 1, 0, 1, 0, 1, 0, 1, 1, 0, 1]",115,62,53,7,4,0.11290322580645161,0.07547169811320754
"[1, 1, 1, 1, 1, 0, 1, 0, 0, 0, 1, 0, 0, 1, 0]",94,47,47,7,4,0.14893617021276595,0.0851063829787234
"[0, 1, 1, 1, 1, 0, 1, 1, 0, 0, 0, 0, 1, 0, 0]",104,55,49,10,5,0.18181818181818182,0.10204081632653061
"[1, 0, 0, 0, 0, 0, 0, 0, 0, 0, 0, 0, 0, 1, 1]",8686,4069,4617,347,461,0.08527893831408208,0.099848386398094
"[0, 1, 1, 0, 1, 1, 1, 0, 0, 0, 0, 1, 1, 0, 0]",266,125,141,13,8,0.104,0.05673758865248227
"[0, 1, 0, 1, 1, 1, 0, 1, 0, 0, 1, 0, 1, 1, 0]",116,58,58,8,9,0.13793103448275862,0.15517241379310345
"[0, 1, 1, 1, 0, 1, 0, 0, 1, 0, 1, 0, 0, 0, 0]",189,120,69,16,10,0.13333333333333333,0.14492753623188406
"[1, 0, 1, 0, 0, 1, 0, 0, 0, 0, 0, 1, 1, 1, 0]",152,91,61,8,5,0.08791208791208792,0.08196721311475409
"[0, 0, 0, 0, 0, 1, 1, 0, 0, 0, 0, 0, 0, 1, 1]",5927,5163,764,481,68,0.09316288979275615,0.08900523560209424
"[0, 0, 0, 0, 0, 0, 0, 0, 0, 1, 0, 1, 0, 0, 1]",2119,1666,453,154,40,0.09243697478991597,0.08830022075055188
"[0, 0, 0, 1, 1, 1, 1, 0, 0, 0, 0, 0, 1, 1, 1]",600,472,128,47,14,0.09957627118644068,0.109375
"[0, 1, 1, 1, 1, 1, 1, 1, 0, 0, 1, 1, 0, 0, 0]",554,249,305,23,29,0.09236947791164658,0.09508196721311475
"[0, 1, 0, 0, 0, 0, 1, 1, 0, 1, 1, 0, 0, 0, 1]",179,106,73,6,9,0.05660377358490566,0.1232876712328767
"[0, 0, 1, 0, 1, 1, 1, 0, 0, 1, 1, 0, 0, 0, 0]",340,192,148,19,20,0.09895833333333333,0.13513513513513514
"[1, 0, 1, 1, 0, 0, 0, 0, 0, 1, 0, 1, 0, 0, 1]",154,90,64,13,5,0.14444444444444443,0.078125
"[0, 1, 1, 0, 1, 1, 0, 0, 0, 0, 1, 0, 0, 0, 1]",131,72,59,6,9,0.08333333333333333,0.15254237288135594
"[0, 1, 0, 0, 1, 1, 1, 1, 1, 1, 0, 1, 1, 1, 0]",256,95,161,10,9,0.10526315789473684,0.055900621118012424
"[1, 1, 1, 0, 0, 1, 0, 1, 1, 1, 0, 0, 0, 1, 0]",110,45,65,5,6,0.1111111111111111,0.09230769230769231
"[0, 1, 0, 0, 1, 0, 0, 1, 1, 0, 0, 1, 1, 1, 1]",281,146,135,14,13,0.0958904109589041,0.0962962962962963
"[0, 1, 0, 0, 1, 0, 0, 1, 0, 0, 1, 0, 0, 1, 1]",181,112,69,4,5,0.03571428571428571,0.07246376811594203
"[1, 1, 0, 0, 1, 1, 1, 1, 0, 1, 0, 0, 1, 0, 0]",157,74,83,6,9,0.08108108108108109,0.10843373493975904
"[0, 0, 1, 1, 1, 0, 0, 1, 1, 1, 1, 0, 1, 0, 0]",131,67,64,11,4,0.16417910447761194,0.0625
"[1, 1, 1, 0, 0, 1, 1, 1, 0, 0, 1, 1, 1, 1, 0]",428,136,292,9,25,0.0661764705882353,0.08561643835616438
"[0, 1, 0, 1, 0, 0, 0, 0, 0, 1, 1, 1, 0, 1, 0]",151,90,61,5,7,0.05555555555555555,0.11475409836065574
"[0, 1, 0, 0, 0, 0, 0, 1, 0, 0, 0, 0, 0, 1, 1]",809,575,234,63,32,0.10956521739130434,0.13675213675213677
"[0, 0, 1, 1, 0, 0, 1, 0, 1, 1, 0, 1, 0, 0, 0]",148,86,62,6,4,0.06976744186046512,0.06451612903225806
"[0, 0, 1, 1, 0, 1, 0, 1, 0, 0, 0, 0, 0, 1, 1]",229,144,85,20,6,0.1388888888888889,0.07058823529411765
"[0, 1, 0, 1, 1, 1, 0, 1, 1, 1, 0, 0, 0, 1, 0]",105,46,59,4,6,0.08695652173913043,0.1016949152542373
"[1, 1, 1, 0, 0, 0, 0, 0, 0, 0, 1, 0, 0, 0, 1]",358,170,188,15,20,0.08823529411764706,0.10638297872340426
"[0, 1, 1, 1, 0, 0, 1, 0, 1, 0, 0, 0, 0, 0, 0]",343,213,130,21,10,0.09859154929577464,0.07692307692307693
"[0, 0, 0, 0, 1, 1, 0, 1, 1, 0, 0, 1, 1, 1, 0]",137,70,67,9,3,0.12857142857142856,0.04477611940298507
"[0, 1, 1, 0, 1, 1, 1, 0, 0, 0, 0, 0, 1, 1, 1]",201,102,99,8,12,0.0784313725490196,0.12121212121212122
"[0, 1, 0, 1, 1, 0, 0, 1, 0, 1, 0, 1, 0, 1, 1]",126,68,58,5,3,0.07352941176470588,0.05172413793103448
"[0, 1, 1, 0, 0, 0, 1, 0, 1, 0, 1, 0, 0, 0, 0]",274,180,94,25,10,0.1388888888888889,0.10638297872340426
"[0, 0, 0, 1, 0, 0, 0, 0, 1, 0, 1, 1, 0, 0, 0]",584,410,174,36,17,0.08780487804878048,0.09770114942528736
"[0, 1, 0, 0, 0, 1, 0, 1, 0, 0, 0, 1, 0, 1, 0]",227,154,73,11,7,0.07142857142857142,0.0958904109589041
"[0, 0, 1, 0, 0, 0, 0, 0, 1, 0, 0, 0, 1, 0, 0]",1442,1097,345,113,37,0.10300820419325434,0.1072463768115942
"[0, 1, 0, 1, 1, 1, 0, 0, 1, 0, 0, 0, 1, 0, 0]",147,79,68,9,9,0.11392405063291139,0.1323529411764706
"[0, 1, 1, 0, 1, 1, 0, 1, 0, 1, 0, 1, 1, 1, 1]",259,106,153,8,12,0.07547169811320754,0.0784313725490196
"[1, 1, 1, 1, 1, 0, 1, 0, 0, 1, 1, 1, 0, 1, 1]",574,160,414,10,53,0.0625,0.1280193236714976
"[1, 1, 1, 1, 1, 1, 0, 1, 0, 0, 1, 1, 1, 0, 1]",549,149,400,14,30,0.09395973154362416,0.075
"[0, 1, 1, 0, 0, 0, 1, 1, 1, 1, 1, 1, 1, 1, 0]",478,195,283,30,26,0.15384615384615385,0.09187279151943463
"[1, 0, 1, 1, 1, 0, 1, 0, 1, 1, 1, 1, 0, 0, 0]",199,80,119,10,15,0.125,0.12605042016806722
"[0, 1, 0, 1, 1, 1, 0, 1, 0, 1, 1, 1, 1, 0, 0]",187,75,112,3,12,0.04,0.10714285714285714
"[1, 1, 0, 0, 1, 0, 1, 1, 1, 0, 1, 0, 1, 1, 1]",289,108,181,5,16,0.046296296296296294,0.08839779005524862
"[1, 1, 1, 1, 1, 0, 1, 0, 0, 1, 1, 1, 1, 0, 0]",462,160,302,17,31,0.10625,0.10264900662251655
"[1, 1, 1, 1, 1, 1, 1, 0, 1, 1, 1, 0, 1, 1, 0]",1728,423,1305,38,132,0.08983451536643026,0.10114942528735632
"[0, 1, 1, 0, 0, 0, 1, 0, 0, 0, 0, 1, 1, 1, 1]",284,186,98,13,5,0.06989247311827956,0.05102040816326531
"[0, 0, 1, 0, 1, 1, 0, 0, 0, 0, 1, 0, 1, 1, 0]",149,78,71,7,3,0.08974358974358974,0.04225352112676056
"[0, 0, 0, 0, 1, 0, 0, 1, 0, 0, 0, 0, 0, 1, 1]",895,682,213,56,19,0.08211143695014662,0.0892018779342723
"[0, 0, 1, 0, 0, 0, 0, 1, 0, 0, 1, 0, 0, 0, 0]",1598,1214,384,116,38,0.09555189456342669,0.09895833333333333
"[0, 1, 0, 0, 1, 0, 0, 1, 0, 0, 0, 0, 1, 0, 0]",481,350,131,30,16,0.08571428571428572,0.12213740458015267
"[1, 0, 1, 0, 0, 0, 0, 0, 1, 1, 1, 0, 0, 0, 1]",159,91,68,9,8,0.0989010989010989,0.11764705882352941
"[1, 1, 0, 1, 0, 0, 0, 0, 0, 1, 1, 1, 0, 0, 0]",207,119,88,11,5,0.09243697478991597,0.056818181818181816
"[0, 1, 1, 1, 0, 0, 1, 1, 1, 1, 1, 1, 0, 0, 0]",485,226,259,26,24,0.11504424778761062,0.09266409266409266
"[1, 1, 0, 1, 1, 0, 1, 1, 1, 1, 0, 1, 1, 0, 1]",508,144,364,14,35,0.09722222222222222,0.09615384615384616
"[1, 1, 1, 1, 1, 0, 0, 1, 1, 0, 0, 1, 0, 0, 0]",262,89,173,5,25,0.056179775280898875,0.14450867052023122
"[0, 0, 1, 1, 0, 0, 1, 1, 1, 1, 1, 1, 1, 1, 1]",5392,1704,3688,162,366,0.09507042253521127,0.0992407809110629
"[1, 1, 1, 1, 1, 0, 0, 1, 0, 1, 0, 1, 0, 1, 0]",129,41,88,3,8,0.07317073170731707,0.09090909090909091
"[1, 1, 1, 1, 1, 1, 1, 0, 0, 1, 0, 1, 0, 1, 0]",295,97,198,7,10,0.07216494845360824,0.050505050505050504
"[0, 1, 0, 1, 0, 1, 1, 1, 0, 1, 0, 1, 1, 0, 1]",118,46,72,5,4,0.10869565217391304,0.05555555555555555
"[1, 1, 1, 1, 0, 1, 1, 1, 0, 0, 0, 0, 0, 1, 1]",243,85,158,7,15,0.08235294117647059,0.0949367088607595
"[0, 0, 1, 0, 0, 1, 0, 1, 1, 1, 1, 1, 0, 1, 1]",152,61,91,6,5,0.09836065573770492,0.054945054945054944
"[0, 1, 1, 0, 0, 1, 1, 0, 0, 0, 1, 1, 0, 1, 1]",217,136,81,11,10,0.08088235294117647,0.12345679012345678
"[0, 0, 1, 0, 0, 1, 1, 1, 1, 0, 1, 0, 0, 1, 0]",126,51,75,3,6,0.058823529411764705,0.08
"[1, 0, 0, 1, 0, 0, 1, 1, 1, 1, 0, 1, 0, 0, 1]",140,59,81,0,6,0.0,0.07407407407407407
"[1, 1, 1, 0, 0, 1, 1, 0, 0, 1, 0, 0, 1, 1, 1]",342,98,244,5,25,0.05102040816326531,0.10245901639344263
"[1, 0, 1, 0, 1, 1, 1, 1, 0, 1, 0, 1, 0, 1, 1]",261,101,160,13,11,0.12871287128712872,0.06875
"[1, 1, 0, 1, 0, 1, 1, 1, 1, 0, 1, 0, 1, 0, 1]",232,77,155,11,16,0.14285714285714285,0.1032258064516129
"[1, 1, 1, 1, 0, 1, 0, 1, 1, 1, 0, 1, 0, 1, 1]",513,165,348,13,28,0.07878787878787878,0.08045977011494253
"[0, 0, 0, 0, 1, 0, 1, 0, 1, 0, 1, 0, 0, 0, 0]",572,389,183,33,16,0.08483290488431877,0.08743169398907104
"[0, 0, 1, 1, 1, 1, 1, 1, 0, 1, 1, 0, 1, 1, 1]",839,234,605,23,58,0.09829059829059829,0.09586776859504133
"[1, 1, 0, 0, 1, 1, 0, 0, 1, 1, 1, 1, 1, 1, 0]",2107,798,1309,60,124,0.07518796992481203,0.09472880061115355
"[1, 1, 0, 1, 1, 1, 1, 0, 0, 1, 0, 1, 0, 0, 0]",109,53,56,6,3,0.11320754716981132,0.05357142857142857
"[1, 1, 0, 0, 1, 1, 0, 0, 1, 1, 1, 0, 1, 1, 1]",674,228,446,22,46,0.09649122807017543,0.1031390134529148
"[0, 1, 0, 1, 1, 0, 1, 1, 0, 1, 0, 0, 0, 1, 0]",105,59,46,4,5,0.06779661016949153,0.10869565217391304
"[1, 0, 1, 0, 1, 0, 1, 1, 0, 1, 1, 0, 1, 0, 0]",113,49,64,4,10,0.08163265306122448,0.15625
"[0, 1, 1, 1, 0, 0, 1, 0, 1, 0, 1, 0, 1, 1, 0]",119,47,72,4,7,0.0851063829787234,0.09722222222222222
"[1, 0, 1, 0, 1, 0, 1, 1, 0, 1, 0, 1, 1, 1, 0]",127,55,72,4,6,0.07272727272727272,0.08333333333333333
"[0, 1, 0, 1, 0, 1, 0, 0, 0, 1, 1, 0, 0, 0, 0]",364,233,131,21,8,0.09012875536480687,0.061068702290076333
"[0, 0, 0, 1, 0, 0, 1, 0, 1, 0, 1, 0, 0, 0, 1]",244,148,96,15,5,0.10135135135135136,0.052083333333333336
"[0, 0, 0, 0, 0, 1, 1, 1, 1, 0, 0, 1, 1, 1, 1]",1925,1520,405,138,35,0.09078947368421053,0.08641975308641975
"[0, 1, 0, 0, 1, 0, 0, 0, 1, 1, 0, 0, 1, 1, 1]",206,114,92,12,12,0.10526315789473684,0.13043478260869565
"[1, 0, 1, 1, 0, 1, 0, 1, 0, 0, 1, 0, 0, 0, 1]",117,64,53,7,6,0.109375,0.11320754716981132
"[1, 1, 0, 0, 1, 0, 1, 0, 1, 0, 1, 0, 0, 0, 0]",139,85,54,10,4,0.11764705882352941,0.07407407407407407
"[1, 1, 0, 1, 0, 1, 1, 0, 0, 1, 1, 1, 0, 0, 1]",179,86,93,6,6,0.06976744186046512,0.06451612903225806
"[1, 1, 0, 1, 1, 0, 1, 0, 1, 1, 0, 0, 1, 1, 1]",316,111,205,11,18,0.0990990990990991,0.08780487804878048
"[0, 0, 0, 1, 1, 1, 0, 1, 1, 1, 0, 1, 1, 1, 0]",151,57,94,3,10,0.05263157894736842,0.10638297872340426
"[0, 0, 1, 1, 1, 0, 1, 0, 0, 1, 0, 0, 0, 1, 1]",133,67,66,9,8,0.13432835820895522,0.12121212121212122
"[1, 1, 0, 0, 1, 1, 0, 0, 1, 1, 1, 1, 0, 0, 1]",1984,796,1188,87,115,0.1092964824120603,0.0968013468013468
"[1, 0, 0, 1, 1, 1, 1, 0, 1, 1, 0, 1, 1, 1, 1]",809,198,611,21,65,0.10606060606060606,0.10638297872340426
"[1, 1, 1, 0, 0, 1, 1, 1, 1, 0, 1, 1, 0, 1, 1]",809,194,615,14,63,0.07216494845360824,0.1024390243902439
"[1, 1, 1, 1, 1, 0, 0, 1, 1, 1, 1, 0, 1, 1, 0]",831,210,621,23,74,0.10952380952380952,0.11916264090177134
"[0, 1, 0, 1, 0, 0, 0, 0, 1, 1, 0, 0, 0, 1, 1]",189,109,80,13,8,0.11926605504587157,0.1
"[1, 0, 1, 1, 1, 1, 0, 0, 0, 0, 1, 1, 0, 0, 1]",432,203,229,25,17,0.12315270935960591,0.07423580786026202
"[0, 1, 0, 1, 0, 0, 0, 0, 1, 0, 1, 0, 0, 1, 0]",212,131,81,10,7,0.07633587786259542,0.08641975308641975
"[1, 1, 1, 0, 1, 1, 1, 0, 0, 1, 0, 1, 0, 1, 0]",128,52,76,5,8,0.09615384615384616,0.10526315789473684
"[0, 1, 0, 0, 1, 1, 1, 1, 1, 0, 1, 0, 0, 0, 0]",152,83,69,10,4,0.12048192771084337,0.057971014492753624
"[1, 1, 0, 1, 0, 0, 1, 1, 1, 1, 1, 0, 1, 0, 0]",141,54,87,3,12,0.05555555555555555,0.13793103448275862
"[0, 0, 0, 1, 1, 0, 1, 0, 0, 0, 1, 0, 0, 0, 1]",242,165,77,16,3,0.09696969696969697,0.03896103896103896
"[0, 1, 0, 0, 0, 1, 1, 0, 0, 0, 0, 0, 0, 1, 0]",611,408,203,39,17,0.09558823529411764,0.08374384236453201
"[0, 0, 0, 0, 1, 1, 0, 0, 0, 1, 1, 0, 0, 1, 0]",325,224,101,22,5,0.09821428571428571,0.04950495049504951
"[1, 1, 1, 0, 1, 1, 1, 1, 1, 1, 0, 1, 1, 1, 0]",1517,352,1165,34,124,0.09659090909090909,0.10643776824034334
"[1, 0, 1, 0, 1, 0, 1, 0, 0, 1, 1, 1, 1, 1, 1]",422,152,270,16,29,0.10526315789473684,0.10740740740740741
"[1, 1, 0, 1, 0, 0, 1, 0, 1, 0, 1, 0, 1, 0, 0]",101,54,47,5,2,0.09259259259259259,0.0425531914893617
"[1, 1, 1, 1, 1, 1, 0, 1, 0, 0, 1, 0, 1, 0, 1]",239,80,159,11,20,0.1375,0.12578616352201258
"[0, 1, 0, 1, 0, 0, 1, 1, 1, 0, 0, 1, 1, 1, 0]",118,59,59,5,6,0.0847457627118644,0.1016949152542373
"[0, 1, 1, 1, 0, 0, 1, 1, 0, 1, 0, 1, 0, 1, 0]",91,46,45,6,2,0.13043478260869565,0.044444444444444446
"[0, 0, 0, 1, 0, 1, 1, 1, 0, 0, 1, 1, 1, 0, 0]",118,51,67,6,2,0.11764705882352941,0.029850746268656716
"[1, 1, 0, 0, 0, 0, 1, 1, 0, 0, 0, 1, 0, 1, 1]",281,160,121,14,13,0.0875,0.10743801652892562
"[1, 1, 1, 0, 0, 0, 0, 1, 1, 0, 0, 0, 1, 0, 1]",211,65,146,5,15,0.07692307692307693,0.10273972602739725
"[1, 1, 0, 0, 0, 0, 0, 0, 0, 1, 1, 1, 1, 1, 1]",720,341,379,34,41,0.09970674486803519,0.10817941952506596
"[1, 0, 1, 1, 0, 0, 0, 0, 0, 0, 0, 1, 1, 1, 1]",356,185,171,18,14,0.0972972972972973,0.08187134502923976
"[1, 0, 0, 1, 1, 1, 1, 1, 1, 1, 0, 1, 1, 0, 1]",630,168,462,21,50,0.125,0.10822510822510822
"[1, 1, 0, 0, 1, 1, 1, 1, 1, 1, 1, 0, 1, 1, 0]",694,221,473,18,49,0.08144796380090498,0.10359408033826638
"[0, 1, 0, 0, 1, 1, 1, 1, 1, 0, 1, 1, 0, 0, 1]",177,78,99,11,14,0.14102564102564102,0.1414141414141414
"[0, 1, 1, 0, 1, 0, 0, 1, 1, 1, 1, 1, 0, 1, 1]",264,99,165,10,11,0.10101010101010101,0.06666666666666667
"[0, 1, 0, 1, 0, 1, 1, 1, 1, 0, 1, 1, 1, 1, 0]",250,92,158,10,13,0.10869565217391304,0.08227848101265822
"[0, 0, 1, 0, 1, 0, 0, 1, 0, 0, 0, 0, 1, 0, 0]",501,353,148,30,11,0.08498583569405099,0.07432432432432433
"[1, 0, 0, 1, 1, 0, 0, 1, 1, 1, 0, 1, 1, 1, 1]",537,100,437,14,39,0.14,0.08924485125858124
"[0, 1, 1, 1, 1, 1, 0, 1, 0, 1, 1, 0, 0, 0, 1]",164,77,87,8,9,0.1038961038961039,0.10344827586206896
"[0, 1, 1, 0, 0, 0, 1, 1, 1, 1, 1, 0, 1, 0, 1]",146,53,93,6,8,0.11320754716981132,0.08602150537634409
"[1, 0, 1, 1, 0, 0, 0, 1, 1, 0, 0, 1, 1, 1, 1]",354,146,208,17,16,0.11643835616438356,0.07692307692307693
"[1, 0, 0, 1, 0, 1, 1, 0, 1, 1, 0, 0, 0, 0, 0]",203,108,95,12,8,0.1111111111111111,0.08421052631578947
"[0, 0, 0, 0, 0, 0, 0, 0, 1, 0, 0, 1, 0, 1, 1]",976,734,242,74,25,0.1008174386920981,0.10330578512396695
"[1, 0, 0, 0, 1, 0, 0, 0, 1, 0, 1, 0, 1, 0, 0]",241,146,95,12,14,0.0821917808219178,0.14736842105263157
"[0, 1, 0, 1, 1, 1, 1, 1, 0, 0, 0, 1, 0, 0, 0]",125,64,61,7,6,0.109375,0.09836065573770492
"[0, 0, 0, 1, 0, 0, 1, 0, 0, 1, 1, 0, 1, 0, 0]",220,135,85,14,8,0.1037037037037037,0.09411764705882353
"[1, 0, 0, 1, 0, 0, 1, 1, 0, 0, 1, 1, 0, 0, 0]",348,192,156,23,15,0.11979166666666667,0.09615384615384616
"[1, 0, 0, 0, 0, 1, 0, 1, 0, 0, 0, 1, 0, 0, 1]",263,172,91,17,6,0.09883720930232558,0.06593406593406594
"[0, 1, 1, 1, 0, 1, 0, 1, 0, 1, 0, 0, 0, 0, 1]",143,80,63,5,7,0.0625,0.1111111111111111
"[1, 0, 0, 0, 1, 1, 0, 0, 0, 1, 0, 1, 1, 1, 0]",117,64,53,8,5,0.125,0.09433962264150944
"[0, 1, 1, 1, 0, 1, 0, 0, 0, 1, 0, 0, 1, 1, 1]",143,64,79,7,11,0.109375,0.13924050632911392
"[0, 0, 0, 0, 0, 0, 1, 0, 0, 0, 0, 1, 1, 1, 1]",957,694,263,55,25,0.0792507204610951,0.09505703422053231
"[1, 0, 0, 0, 0, 1, 0, 0, 0, 0, 1, 1, 1, 0, 0]",272,171,101,11,13,0.06432748538011696,0.12871287128712872
"[0, 1, 0, 1, 1, 0, 0, 1, 1, 1, 0, 0, 1, 1, 0]",153,76,77,9,9,0.11842105263157894,0.11688311688311688
"[1, 0, 1, 0, 0, 0, 0, 0, 1, 1, 0, 0, 0, 0, 0]",1026,708,318,84,37,0.11864406779661017,0.11635220125786164
"[0, 0, 0, 1, 0, 1, 0, 0, 0, 1, 0, 0, 0, 0, 0]",1632,1229,403,122,38,0.09926769731489016,0.09429280397022333
"[0, 0, 0, 1, 0, 1, 1, 0, 0, 0, 1, 0, 1, 0, 0]",245,160,85,19,9,0.11875,0.10588235294117647
"[1, 1, 1, 0, 0, 1, 0, 0, 1, 1, 1, 1, 0, 1, 1]",306,105,201,11,18,0.10476190476190476,0.08955223880597014
"[1, 0, 0, 0, 0, 0, 0, 0, 1, 0, 0, 1, 1, 1, 1]",393,198,195,25,22,0.12626262626262627,0.11282051282051282
"[0, 1, 1, 0, 1, 0, 1, 1, 0, 0, 0, 0, 0, 0, 0]",405,261,144,29,14,0.1111111111111111,0.09722222222222222
"[0, 0, 0, 0, 0, 0, 0, 1, 1, 0, 1, 0, 1, 1, 0]",357,247,110,27,9,0.10931174089068826,0.08181818181818182
"[0, 1, 0, 0, 0, 0, 0, 0, 1, 1, 0, 1, 0, 0, 0]",543,379,164,37,16,0.09762532981530343,0.0975609756097561
"[1, 0, 0, 1, 0, 0, 0, 0, 0, 0, 1, 1, 0, 1, 0]",252,158,94,12,6,0.0759493670886076,0.06382978723404255
"[0, 1, 1, 1, 1, 0, 1, 1, 1, 0, 0, 1, 1, 1, 1]",866,302,564,26,54,0.08609271523178808,0.09574468085106383
"[0, 0, 1, 1, 1, 1, 0, 1, 1, 1, 0, 0, 1, 1, 1]",425,157,268,17,26,0.10828025477707007,0.09701492537313433
"[1, 0, 0, 0, 0, 1, 0, 0, 0, 0, 0, 1, 1, 0, 0]",798,527,271,55,22,0.10436432637571158,0.08118081180811808
"[0, 1, 1, 0, 1, 1, 0, 1, 1, 1, 0, 0, 0, 0, 1]",190,81,109,10,11,0.12345679012345678,0.10091743119266056
"[1, 1, 1, 1, 0, 1, 0, 0, 0, 0, 0, 0, 0, 0, 0]",492,281,211,40,25,0.1423487544483986,0.11848341232227488
"[0, 1, 0, 1, 0, 0, 1, 1, 0, 0, 1, 0, 0, 0, 0]",288,180,108,20,12,0.1111111111111111,0.1111111111111111
"[0, 0, 0, 0, 1, 1, 1, 0, 0, 0, 0, 1, 0, 0, 0]",657,467,190,38,17,0.08137044967880086,0.08947368421052632
"[1, 0, 0, 0, 0, 1, 1, 1, 0, 0, 0, 0, 1, 0, 0]",294,178,116,12,15,0.06741573033707865,0.12931034482758622
"[0, 0, 1, 0, 0, 0, 0, 1, 1, 1, 0, 0, 0, 0, 1]",317,198,119,18,13,0.09090909090909091,0.1092436974789916
"[1, 1, 1, 1, 1, 1, 1, 0, 0, 0, 1, 1, 1, 1, 0]",894,264,630,27,67,0.10227272727272728,0.10634920634920635
"[1, 0, 0, 0, 1, 1, 1, 0, 0, 1, 1, 1, 1, 0, 0]",266,122,144,6,14,0.04918032786885246,0.09722222222222222
"[1, 1, 1, 0, 1, 0, 0, 0, 1, 1, 1, 0, 0, 1, 1]",214,94,120,8,11,0.0851063829787234,0.09166666666666666
"[0, 0, 1, 1, 1, 1, 1, 1, 0, 1, 0, 0, 0, 1, 1]",247,118,129,8,12,0.06779661016949153,0.09302325581395349
"[1, 0, 1, 0, 0, 0, 1, 0, 1, 1, 1, 1, 0, 1, 0]",104,43,61,4,5,0.09302325581395349,0.08196721311475409
"[1, 0, 0, 1, 1, 0, 1, 0, 1, 0, 1, 1, 1, 1, 0]",178,63,115,5,16,0.07936507936507936,0.1391304347826087
"[1, 1, 1, 1, 1, 0, 0, 1, 1, 0, 1, 1, 0, 0, 0]",245,97,148,14,20,0.14432989690721648,0.13513513513513514
"[0, 0, 1, 1, 1, 1, 1, 0, 0, 0, 0, 0, 1, 0, 1]",146,76,70,5,12,0.06578947368421052,0.17142857142857143
"[1, 0, 0, 1, 1, 0, 0, 1, 1, 1, 1, 0, 0, 1, 1]",2082,325,1757,23,166,0.07076923076923076,0.09447922595332954
"[0, 0, 1, 1, 1, 0, 1, 1, 1, 1, 0, 0, 1, 1, 0]",268,118,150,9,12,0.07627118644067797,0.08
"[1, 1, 1, 1, 0, 0, 1, 1, 1, 1, 0, 1, 0, 1, 1]",964,285,679,33,51,0.11578947368421053,0.07511045655375552
"[1, 0, 0, 1, 1, 1, 0, 1, 1, 1, 1, 1, 1, 1, 0]",622,181,441,21,45,0.11602209944751381,0.10204081632653061
"[0, 1, 1, 1, 0, 0, 1, 1, 1, 0, 1, 1, 1, 1, 1]",670,208,462,25,41,0.1201923076923077,0.08874458874458875
"[1, 1, 1, 1, 1, 0, 1, 1, 1, 0, 0, 1, 1, 1, 0]",576,172,404,15,43,0.0872093023255814,0.10643564356435643
"[0, 1, 0, 1, 0, 1, 1, 0, 1, 1, 1, 1, 0, 1, 1]",232,95,137,10,12,0.10526315789473684,0.08759124087591241
"[1, 0, 1, 0, 1, 0, 1, 1, 0, 1, 1, 1, 1, 0, 1]",206,76,130,4,12,0.05263157894736842,0.09230769230769231
"[0, 0, 1, 1, 1, 1, 1, 1, 1, 0, 1, 0, 0, 1, 0]",176,72,104,10,10,0.1388888888888889,0.09615384615384616
"[0, 1, 1, 1, 1, 0, 0, 0, 1, 1, 1, 1, 1, 1, 1]",1128,457,671,51,77,0.11159737417943107,0.11475409836065574
"[0, 0, 1, 1, 1, 1, 0, 1, 1, 1, 1, 1, 1, 1, 0]",666,216,450,17,35,0.0787037037037037,0.07777777777777778
"[0, 0, 0, 0, 0, 1, 0, 0, 1, 1, 0, 0, 0, 0, 1]",948,686,262,56,27,0.08163265306122448,0.10305343511450382
"[0, 0, 0, 1, 0, 0, 0, 0, 0, 0, 1, 0, 0, 1, 1]",778,570,208,54,27,0.09473684210526316,0.12980769230769232
"[0, 1, 0, 1, 0, 0, 0, 0, 0, 0, 1, 1, 0, 0, 0]",1006,732,274,66,30,0.09016393442622951,0.10948905109489052
"[0, 0, 0, 1, 1, 0, 0, 1, 1, 0, 0, 1, 1, 1, 1]",1742,1402,340,120,29,0.08559201141226819,0.08529411764705883
"[0, 0, 1, 1, 0, 0, 0, 0, 1, 1, 1, 1, 1, 1, 0]",1545,788,757,78,65,0.09898477157360407,0.08586525759577279
"[0, 0, 1, 0, 1, 0, 1, 1, 1, 1, 1, 1, 0, 0, 1]",258,124,134,14,17,0.11290322580645161,0.12686567164179105
"[0, 0, 1, 0, 1, 0, 1, 0, 1, 1, 0, 0, 1, 1, 1]",177,88,89,9,5,0.10227272727272728,0.056179775280898875
"[1, 1, 0, 1, 1, 1, 0, 1, 1, 1, 0, 0, 1, 0, 1]",209,84,125,9,14,0.10714285714285714,0.112
"[0, 0, 1, 1, 1, 0, 1, 0, 0, 0, 1, 0, 0, 1, 0]",145,92,53,10,6,0.10869565217391304,0.11320754716981132
"[1, 0, 1, 1, 1, 1, 1, 1, 0, 1, 1, 0, 0, 0, 1]",264,92,172,10,13,0.10869565217391304,0.0755813953488372
"[0, 1, 1, 0, 0, 1, 0, 0, 1, 0, 0, 0, 0, 0, 0]",703,528,175,53,12,0.10037878787878787,0.06857142857142857
"[1, 0, 1, 1, 0, 1, 0, 0, 0, 0, 0, 0, 1, 1, 0]",232,118,114,12,10,0.1016949152542373,0.08771929824561403
"[1, 0, 1, 0, 0, 0, 1, 0, 1, 0, 0, 0, 1, 0, 0]",203,134,69,11,3,0.08208955223880597,0.043478260869565216
"[0, 1, 0, 1, 0, 0, 0, 1, 0, 1, 0, 0, 0, 1, 0]",205,134,71,11,8,0.08208955223880597,0.11267605633802817
"[0, 0, 0, 1, 1, 0, 0, 1, 0, 0, 0, 1, 0, 1, 0]",236,159,77,25,6,0.15723270440251572,0.07792207792207792
"[1, 1, 0, 1, 1, 0, 1, 1, 0, 0, 1, 1, 1, 1, 1]",880,271,609,26,54,0.0959409594095941,0.08866995073891626
"[0, 1, 0, 0, 1, 1, 1, 1, 1, 0, 0, 1, 0, 1, 1]",151,71,80,9,6,0.1267605633802817,0.075
"[0, 0, 0, 1, 1, 0, 0, 0, 1, 1, 0, 0, 1, 1, 0]",287,169,118,11,12,0.0650887573964497,0.1016949152542373
"[0, 1, 0, 1, 1, 0, 1, 1, 1, 1, 0, 1, 0, 1, 0]",110,53,57,7,7,0.1320754716981132,0.12280701754385964
"[0, 0, 1, 0, 1, 1, 0, 1, 1, 1, 1, 0, 1, 0, 1]",141,60,81,7,6,0.11666666666666667,0.07407407407407407
"[0, 0, 1, 0, 0, 0, 1, 0, 0, 1, 0, 1, 1, 0, 1]",118,70,48,8,4,0.11428571428571428,0.08333333333333333
"[1, 0, 0, 0, 1, 1, 0, 0, 1, 1, 0, 0, 1, 1, 0]",447,219,228,20,19,0.091324200913242,0.08333333333333333
"[1, 1, 1, 1, 1, 1, 0, 0, 0, 0, 0, 0, 0, 1, 0]",379,195,184,26,14,0.13333333333333333,0.07608695652173914
"[1, 0, 0, 1, 1, 1, 1, 0, 0, 1, 0, 0, 1, 1, 1]",354,114,240,9,24,0.07894736842105263,0.1
"[1, 0, 0, 1, 1, 1, 1, 1, 1, 0, 0, 1, 1, 0, 1]",654,133,521,5,44,0.03759398496240601,0.08445297504798464
"[1, 1, 1, 1, 0, 0, 1, 1, 1, 1, 1, 1, 0, 0, 1]",4619,1368,3251,133,277,0.09722222222222222,0.08520455244540141
"[1, 1, 1, 0, 1, 0, 0, 0, 0, 0, 0, 0, 1, 1, 1]",296,143,153,15,12,0.1048951048951049,0.0784313725490196
"[1, 0, 1, 0, 1, 0, 1, 0, 1, 1, 1, 1, 0, 1, 0]",129,65,64,5,7,0.07692307692307693,0.109375
"[1, 1, 0, 1, 0, 1, 0, 1, 1, 1, 1, 1, 1, 0, 1]",464,141,323,22,34,0.15602836879432624,0.10526315789473684
"[1, 1, 1, 1, 0, 1, 0, 1, 0, 1, 1, 1, 1, 1, 1]",1900,451,1449,58,138,0.1286031042128603,0.09523809523809523
"[0, 0, 0, 1, 0, 1, 0, 1, 1, 1, 0, 1, 0, 0, 1]",125,58,67,5,13,0.08620689655172414,0.19402985074626866
"[1, 1, 1, 0, 0, 1, 1, 1, 1, 1, 1, 1, 0, 0, 0]",601,176,425,10,48,0.056818181818181816,0.11294117647058824
"[0, 1, 0, 1, 1, 1, 1, 1, 0, 1, 1, 1, 0, 0, 1]",262,93,169,10,20,0.10752688172043011,0.11834319526627218
"[1, 1, 1, 0, 0, 0, 1, 1, 1, 1, 1, 0, 1, 1, 0]",263,93,170,5,21,0.053763440860215055,0.12352941176470589
"[0, 0, 0, 1, 1, 1, 1, 1, 0, 1, 0, 1, 1, 1, 0]",143,63,80,6,10,0.09523809523809523,0.125
"[1, 1, 0, 0, 1, 0, 0, 0, 0, 1, 0, 0, 1, 0, 0]",203,139,64,15,5,0.1079136690647482,0.078125
"[0, 0, 1, 0, 0, 0, 0, 1, 1, 1, 1, 0, 0, 0, 0]",869,557,312,55,26,0.09874326750448834,0.08333333333333333
"[0, 0, 0, 1, 0, 0, 0, 1, 0, 0, 0, 0, 1, 1, 1]",551,403,148,37,11,0.09181141439205956,0.07432432432432433
"[0, 1, 0, 1, 0, 0, 0, 0, 0, 1, 1, 0, 0, 0, 1]",269,179,90,12,10,0.0670391061452514,0.1111111111111111
"[1, 1, 1, 0, 1, 1, 0, 0, 1, 1, 0, 1, 1, 0, 1]",217,67,150,3,13,0.04477611940298507,0.08666666666666667
"[0, 1, 1, 0, 1, 1, 1, 1, 0, 1, 1, 0, 1, 1, 1]",567,191,376,18,28,0.09424083769633508,0.07446808510638298
"[1, 0, 1, 1, 1, 1, 1, 0, 0, 1, 1, 0, 1, 1, 1]",620,169,451,14,44,0.08284023668639054,0.0975609756097561
"[1, 0, 1, 1, 0, 0, 1, 1, 0, 0, 1, 1, 1, 1, 0]",447,186,261,18,19,0.0967741935483871,0.07279693486590039
"[1, 0, 1, 1, 1, 0, 1, 0, 1, 1, 0, 0, 1, 1, 0]",193,88,105,12,16,0.13636363636363635,0.1523809523809524
"[0, 1, 0, 0, 1, 0, 1, 0, 1, 0, 1, 0, 0, 0, 0]",277,171,106,17,9,0.09941520467836257,0.08490566037735849
"[1, 1, 1, 1, 1, 1, 0, 0, 0, 1, 0, 1, 0, 0, 1]",231,87,144,12,14,0.13793103448275862,0.09722222222222222
"[1, 0, 1, 1, 0, 0, 1, 1, 1, 1, 1, 0, 0, 1, 0]",161,60,101,9,11,0.15,0.10891089108910891
"[1, 1, 1, 1, 1, 0, 0, 1, 1, 1, 1, 1, 0, 0, 1]",1201,277,924,17,85,0.061371841155234655,0.09199134199134198
"[0, 1, 1, 0, 0, 1, 0, 0, 0, 1, 1, 1, 1, 1, 1]",287,137,150,7,20,0.051094890510948905,0.13333333333333333
"[1, 1, 0, 0, 1, 1, 1, 1, 0, 0, 0, 0, 0, 0, 1]",1566,798,768,72,91,0.09022556390977443,0.11848958333333333
"[0, 1, 0, 1, 0, 0, 0, 0, 1, 1, 1, 1, 0, 0, 1]",280,158,122,18,9,0.11392405063291139,0.07377049180327869
"[1, 1, 1, 1, 1, 0, 1, 0, 1, 0, 0, 0, 0, 1, 1]",253,80,173,5,17,0.0625,0.09826589595375723
"[1, 1, 0, 0, 0, 0, 1, 0, 1, 1, 1, 1, 0, 0, 1]",168,78,90,8,11,0.10256410256410256,0.12222222222222222
"[0, 0, 0, 1, 1, 1, 0, 0, 0, 0, 1, 0, 0, 1, 0]",236,150,86,12,11,0.08,0.12790697674418605
"[1, 1, 1, 0, 0, 1, 1, 0, 0, 1, 0, 1, 0, 0, 1]",168,69,99,6,9,0.08695652173913043,0.09090909090909091
"[0, 1, 0, 1, 1, 1, 0, 0, 1, 1, 0, 0, 1, 0, 1]",157,75,82,8,9,0.10666666666666667,0.10975609756097561
"[0, 0, 1, 0, 1, 0, 1, 1, 1, 0, 0, 1, 1, 0, 0]",189,108,81,9,3,0.08333333333333333,0.037037037037037035
"[1, 1, 1, 0, 1, 1, 0, 1, 1, 1, 1, 1, 0, 0, 1]",722,225,497,19,38,0.08444444444444445,0.07645875251509054
"[1, 0, 0, 0, 0, 1, 1, 0, 0, 1, 0, 0, 0, 1, 0]",294,150,144,15,11,0.1,0.0763888888888889
"[1, 1, 0, 0, 0, 0, 1, 1, 0, 0, 1, 0, 0, 0, 1]",303,173,130,10,13,0.057803468208092484,0.1
"[1, 1, 0, 0, 0, 0, 1, 0, 0, 0, 0, 0, 0, 1, 1]",552,364,188,37,13,0.10164835164835165,0.06914893617021277
"[0, 1, 1, 0, 0, 0, 0, 1, 0, 0, 0, 0, 0, 0, 1]",761,576,185,50,23,0.08680555555555555,0.12432432432432433
"[1, 0, 0, 0, 0, 0, 0, 1, 0, 0, 0, 0, 1, 1, 0]",734,489,245,34,28,0.06952965235173825,0.11428571428571428
"[0, 1, 1, 0, 0, 1, 1, 0, 1, 1, 0, 0, 0, 0, 0]",228,146,82,22,6,0.1506849315068493,0.07317073170731707
"[1, 1, 1, 1, 1, 0, 1, 1, 0, 1, 0, 1, 0, 0, 1]",272,105,167,9,23,0.08571428571428572,0.1377245508982036
"[0, 0, 1, 1, 1, 0, 1, 1, 0, 1, 1, 1, 1, 1, 1]",722,227,495,23,43,0.1013215859030837,0.08686868686868687
"[1, 1, 1, 1, 1, 0, 0, 1, 1, 1, 0, 1, 1, 0, 1]",676,157,519,19,53,0.12101910828025478,0.10211946050096339
"[1, 1, 1, 1, 1, 1, 0, 0, 1, 1, 1, 0, 1, 1, 0]",766,223,543,20,51,0.08968609865470852,0.09392265193370165
"[0, 0, 0, 0, 1, 1, 0, 0, 0, 1, 0, 1, 0, 0, 1]",335,216,119,21,18,0.09722222222222222,0.15126050420168066
"[1, 0, 1, 1, 0, 0, 0, 0, 1, 1, 1, 1, 1, 1, 0]",472,197,275,25,25,0.12690355329949238,0.09090909090909091
"[1, 0, 0, 1, 0, 0, 1, 1, 1, 1, 1, 0, 1, 0, 1]",135,50,85,4,9,0.08,0.10588235294117647
"[1, 0, 0, 1, 0, 1, 0, 0, 0, 0, 1, 1, 1, 0, 0]",158,98,60,12,6,0.12244897959183673,0.1
"[1, 1, 0, 1, 0, 1, 1, 0, 0, 1, 0, 1, 0, 0, 0]",110,53,57,9,4,0.16981132075471697,0.07017543859649122
"[1, 1, 1, 0, 1, 1, 0, 1, 0, 1, 1, 0, 0, 1, 0]",152,60,92,9,13,0.15,0.14130434782608695
"[1, 1, 0, 0, 0, 1, 1, 1, 1, 1, 1, 1, 0, 0, 0]",312,124,188,10,15,0.08064516129032258,0.0797872340425532
"[0, 1, 0, 1, 1, 0, 0, 0, 1, 0, 1, 1, 0, 0, 0]",179,98,81,17,4,0.17346938775510204,0.04938271604938271
"[0, 0, 0, 1, 1, 1, 0, 0, 1, 0, 1, 1, 1, 0, 0]",156,95,61,11,6,0.11578947368421053,0.09836065573770492
"[0, 1, 0, 1, 0, 1, 0, 0, 0, 1, 1, 0, 0, 1, 1]",183,103,80,8,6,0.07766990291262135,0.075
"[0, 0, 1, 0, 1, 0, 0, 0, 0, 0, 0, 0, 1, 1, 0]",868,603,265,61,27,0.1011608623548922,0.1018867924528302
"[1, 0, 1, 1, 0, 0, 0, 0, 0, 0, 0, 1, 0, 1, 0]",236,161,75,12,7,0.07453416149068323,0.09333333333333334
"[0, 1, 1, 1, 0, 1, 1, 1, 1, 1, 0, 1, 1, 1, 0]",531,175,356,18,34,0.10285714285714286,0.09550561797752809
"[0, 0, 1, 1, 0, 1, 1, 1, 0, 1, 1, 1, 1, 1, 0]",257,89,168,6,15,0.06741573033707865,0.08928571428571429
"[0, 1, 1, 1, 0, 0, 1, 0, 0, 1, 0, 0, 1, 1, 0]",111,62,49,6,2,0.0967741935483871,0.04081632653061224
"[1, 0, 1, 1, 0, 0, 1, 0, 1, 1, 1, 0, 0, 1, 0]",106,62,44,7,3,0.11290322580645161,0.06818181818181818
"[0, 0, 1, 0, 0, 1, 0, 1, 0, 1, 0, 1, 1, 0, 0]",157,89,68,11,4,0.12359550561797752,0.058823529411764705
"[1, 0, 0, 1, 0, 0, 0, 1, 0, 0, 1, 0, 1, 0, 1]",137,88,49,13,6,0.14772727272727273,0.12244897959183673
"[1, 1, 0, 0, 0, 0, 0, 1, 1, 1, 0, 0, 1, 0, 0]",173,102,71,7,8,0.06862745098039216,0.11267605633802817
"[0, 1, 1, 1, 0, 0, 1, 1, 0, 0, 0, 0, 0, 0, 0]",765,502,263,56,24,0.11155378486055777,0.09125475285171103
"[1, 0, 1, 0, 1, 1, 1, 0, 0, 1, 1, 0, 0, 0, 0]",287,129,158,8,17,0.06201550387596899,0.10759493670886076
"[1, 1, 1, 0, 1, 0, 1, 0, 1, 1, 1, 0, 0, 1, 1]",319,114,205,10,21,0.08771929824561403,0.1024390243902439
"[0, 0, 0, 1, 0, 1, 1, 1, 0, 1, 0, 1, 0, 1, 1]",130,66,64,7,10,0.10606060606060606,0.15625
"[1, 1, 1, 0, 0, 1, 0, 0, 1, 0, 1, 1, 1, 1, 0]",162,72,90,5,6,0.06944444444444445,0.06666666666666667
"[1, 0, 1, 0, 0, 0, 1, 1, 1, 1, 0, 1, 0, 1, 1]",165,58,107,8,11,0.13793103448275862,0.102803738317757
"[1, 0, 1, 1, 1, 1, 1, 1, 1, 1, 1, 1, 1, 0, 0]",3515,825,2690,85,244,0.10303030303030303,0.09070631970260223
"[1, 0, 1, 0, 0, 1, 1, 0, 1, 1, 1, 1, 1, 1, 1]",699,198,501,16,39,0.08080808080808081,0.07784431137724551
"[1, 1, 1, 0, 1, 1, 0, 1, 1, 1, 0, 1, 0, 0, 1]",267,94,173,8,15,0.0851063829787234,0.08670520231213873
"[1, 1, 0, 0, 0, 1, 1, 1, 1, 0, 1, 1, 0, 1, 1]",280,98,182,6,20,0.061224489795918366,0.10989010989010989
"[0, 1, 1, 1, 1, 1, 0, 0, 0, 1, 1, 1, 1, 0, 1]",267,100,167,6,16,0.06,0.09580838323353294
"[1, 1, 1, 1, 1, 1, 1, 0, 0, 0, 0, 0, 1, 0, 0]",264,86,178,8,15,0.09302325581395349,0.08426966292134831
"[0, 1, 1, 0, 1, 0, 1, 0, 0, 1, 1, 1, 0, 0, 0]",110,69,41,4,4,0.057971014492753624,0.0975609756097561
"[1, 0, 0, 0, 1, 0, 1, 1, 0, 0, 0, 0, 0, 0, 0]",775,518,257,45,21,0.08687258687258688,0.08171206225680934
"[0, 0, 0, 0, 1, 1, 1, 1, 0, 1, 0, 0, 0, 0, 1]",246,146,100,17,13,0.11643835616438356,0.13
"[0, 1, 0, 0, 0, 0, 1, 1, 1, 1, 0, 1, 0, 0, 0]",177,122,55,10,7,0.08196721311475409,0.12727272727272726
"[1, 1, 0, 0, 1, 0, 1, 0, 1, 0, 0, 1, 0, 0, 0]",133,75,58,10,7,0.13333333333333333,0.1206896551724138
"[1, 0, 1, 0, 0, 1, 1, 0, 0, 0, 0, 0, 0, 1, 0]",286,175,111,15,8,0.08571428571428572,0.07207207207207207
"[0, 0, 1, 1, 0, 0, 1, 0, 1, 0, 0, 0, 0, 0, 0]",788,553,235,52,18,0.09403254972875226,0.07659574468085106
"[1, 0, 0, 0, 0, 0, 1, 0, 1, 1, 1, 1, 1, 1, 0]",158,69,89,6,8,0.08695652173913043,0.0898876404494382
"[0, 0, 1, 1, 1, 1, 0, 0, 0, 1, 0, 0, 0, 0, 1]",218,119,99,9,9,0.07563025210084033,0.09090909090909091
"[1, 0, 1, 1, 1, 1, 1, 0, 1, 0, 0, 1, 0, 1, 1]",253,82,171,1,15,0.012195121951219513,0.08771929824561403
"[1, 0, 0, 0, 1, 1, 0, 0, 0, 1, 0, 1, 1, 0, 0]",175,98,77,12,4,0.12244897959183673,0.05194805194805195
"[1, 0, 0, 1, 1, 0, 0, 0, 0, 0, 0, 1, 1, 1, 1]",1878,427,1451,47,122,0.11007025761124122,0.08407994486560992
"[1, 1, 1, 1, 0, 1, 1, 1, 1, 0, 0, 1, 1, 0, 0]",659,250,409,29,32,0.116,0.07823960880195599
"[1, 0, 1, 0, 1, 1, 0, 1, 1, 0, 1, 1, 1, 0, 1]",213,73,140,8,11,0.1095890410958904,0.07857142857142857
"[0, 0, 1, 0, 1, 0, 1, 1, 1, 1, 1, 1, 1, 1, 0]",320,118,202,13,21,0.11016949152542373,0.10396039603960396
"[0, 1, 1, 1, 1, 0, 1, 1, 1, 1, 1, 0, 0, 0, 1]",268,103,165,9,15,0.08737864077669903,0.09090909090909091
"[0, 1, 0, 0, 1, 1, 0, 0, 1, 1, 0, 0, 1, 1, 0]",420,240,180,21,24,0.0875,0.13333333333333333
"[1, 1, 0, 0, 1, 0, 0, 0, 0, 0, 0, 0, 1, 1, 0]",405,267,138,25,15,0.09363295880149813,0.10869565217391304
"[0, 1, 0, 1, 1, 0, 0, 0, 0, 1, 1, 0, 0, 1, 0]",152,84,68,5,8,0.05952380952380952,0.11764705882352941
"[0, 0, 0, 1, 0, 1, 1, 0, 0, 0, 0, 1, 1, 0, 0]",523,343,180,19,13,0.05539358600583091,0.07222222222222222
"[0, 0, 1, 0, 1, 0, 0, 0, 1, 0, 1, 1, 0, 0, 0]",288,193,95,20,12,0.10362694300518134,0.12631578947368421
"[1, 0, 1, 1, 1, 0, 0, 0, 1, 0, 0, 0, 0, 0, 1]",144,79,65,8,3,0.10126582278481013,0.046153846153846156
"[0, 1, 1, 1, 1, 0, 1, 1, 1, 0, 1, 1, 1, 0, 0]",292,121,171,15,15,0.12396694214876033,0.08771929824561403
"[1, 0, 1, 1, 0, 1, 1, 0, 0, 1, 1, 1, 0, 0, 0]",129,66,63,6,5,0.09090909090909091,0.07936507936507936
"[0, 0, 0, 0, 1, 0, 1, 1, 0, 1, 1, 0, 0, 1, 1]",135,72,63,8,7,0.1111111111111111,0.1111111111111111
"[1, 1, 0, 0, 0, 0, 1, 0, 1, 1, 0, 1, 1, 0, 0]",142,75,67,7,8,0.09333333333333334,0.11940298507462686
"[1, 1, 1, 1, 1, 0, 0, 0, 0, 1, 0, 0, 0, 0, 0]",298,141,157,16,12,0.11347517730496454,0.07643312101910828
"[0, 0, 1, 1, 1, 1, 1, 0, 0, 0, 0, 1, 0, 0, 0]",202,107,95,9,8,0.08411214953271028,0.08421052631578947
"[1, 0, 1, 0, 0, 1, 1, 1, 0, 1, 0, 1, 1, 1, 0]",150,66,84,7,10,0.10606060606060606,0.11904761904761904
"[1, 1, 1, 1, 1, 1, 1, 1, 0, 0, 0, 1, 0, 0, 1]",448,151,297,15,29,0.09933774834437085,0.09764309764309764
"[0, 1, 0, 0, 0, 0, 0, 1, 1, 0, 0, 1, 1, 1, 1]",482,281,201,28,27,0.099644128113879,0.13432835820895522
"[0, 0, 0, 1, 0, 1, 1, 1, 1, 0, 1, 1, 0, 1, 0]",99,42,57,3,3,0.07142857142857142,0.05263157894736842
"[0, 1, 0, 0, 0, 0, 1, 0, 1, 1, 1, 1, 0, 1, 1]",121,52,69,5,10,0.09615384615384616,0.14492753623188406
"[0, 1, 1, 1, 1, 1, 1, 1, 1, 0, 1, 1, 1, 0, 0]",737,266,471,29,44,0.10902255639097744,0.09341825902335456
"[1, 1, 1, 1, 0, 0, 1, 1, 1, 1, 0, 1, 0, 0, 1]",423,175,248,24,25,0.13714285714285715,0.10080645161290322
"[1, 0, 1, 1, 0, 1, 0, 1, 1, 1, 0, 1, 1, 0, 0]",143,63,80,4,8,0.06349206349206349,0.1
"[1, 1, 1, 0, 1, 1, 0, 0, 0, 0, 0, 0, 1, 0, 1]",132,74,58,5,7,0.06756756756756757,0.1206896551724138
"[1, 1, 0, 0, 1, 1, 1, 1, 1, 1, 0, 1, 0, 0, 1]",410,144,266,8,35,0.05555555555555555,0.13157894736842105
"[1, 1, 1, 0, 1, 0, 1, 0, 0, 1, 0, 1, 0, 0, 0]",114,58,56,9,11,0.15517241379310345,0.19642857142857142
"[0, 0, 1, 0, 1, 1, 0, 0, 1, 0, 1, 1, 0, 1, 1]",95,54,41,3,6,0.05555555555555555,0.14634146341463414
"[1, 1, 0, 1, 0, 0, 0, 0, 1, 0, 0, 0, 0, 0, 0]",582,386,196,42,16,0.10880829015544041,0.08163265306122448
"[0, 0, 1, 1, 1, 1, 0, 0, 1, 1, 0, 1, 1, 1, 1]",755,283,472,21,39,0.07420494699646643,0.0826271186440678
"[1, 0, 1, 0, 1, 0, 1, 1, 1, 1, 0, 0, 0, 0, 0]",217,106,111,8,9,0.07547169811320754,0.08108108108108109
"[0, 0, 0, 0, 0, 1, 1, 0, 1, 1, 1, 0, 0, 0, 1]",180,116,64,11,6,0.09482758620689655,0.09375
"[1, 1, 0, 0, 0, 0, 0, 0, 1, 1, 0, 1, 1, 1, 0]",205,99,106,14,4,0.1414141414141414,0.03773584905660377
"[0, 0, 1, 1, 0, 0, 1, 1, 1, 0, 0, 0, 1, 1, 1]",279,139,140,9,13,0.06474820143884892,0.09285714285714286
"[0, 1, 1, 1, 1, 1, 1, 0, 1, 0, 0, 0, 1, 0, 1]",119,76,43,10,4,0.13157894736842105,0.09302325581395349
"[0, 1, 1, 1, 1, 0, 0, 1, 0, 1, 0, 0, 0, 1, 0]",121,70,51,7,2,0.1,0.0392156862745098
"[1, 1, 0, 1, 0, 1, 0, 1, 1, 1, 1, 0, 0, 1, 0]",154,57,97,5,9,0.08771929824561403,0.09278350515463918
"[1, 0, 1, 0, 0, 0, 1, 1, 1, 0, 1, 1, 0, 1, 1]",158,74,84,4,10,0.05405405405405406,0.11904761904761904
"[1, 1, 0, 1, 0, 1, 0, 0, 1, 1, 1, 1, 1, 1, 1]",888,279,609,27,72,0.0967741935483871,0.11822660098522167
"[0, 0, 0, 1, 0, 1, 1, 1, 0, 1, 1, 0, 0, 0, 0]",170,103,67,5,5,0.04854368932038835,0.07462686567164178
"[0, 0, 0, 0, 0, 0, 1, 0, 1, 1, 1, 0, 1, 1, 0]",165,96,69,9,9,0.09375,0.13043478260869565
"[1, 0, 0, 1, 1, 0, 1, 0, 0, 0, 1, 1, 0, 0, 0]",234,136,98,16,11,0.11764705882352941,0.11224489795918367
"[0, 1, 0, 0, 0, 0, 1, 1, 1, 1, 1, 0, 1, 0, 1]",120,62,58,7,7,0.11290322580645161,0.1206896551724138
"[0, 1, 0, 1, 0, 1, 1, 1, 1, 1, 1, 0, 1, 0, 0]",142,58,84,6,4,0.10344827586206896,0.047619047619047616
"[0, 0, 1, 0, 0, 0, 0, 0, 0, 1, 0, 1, 1, 1, 1]",262,164,98,17,13,0.10365853658536585,0.1326530612244898
"[1, 0, 0, 0, 0, 0, 1, 0, 0, 1, 1, 0, 0, 0, 1]",274,173,101,25,14,0.14450867052023122,0.13861386138613863
"[0, 0, 0, 1, 1, 0, 1, 0, 0, 1, 0, 0, 0, 0, 0]",674,478,196,38,15,0.0794979079497908,0.07653061224489796
"[0, 1, 0, 0, 0, 1, 1, 0, 1, 0, 0, 1, 0, 0, 0]",250,162,88,17,8,0.10493827160493827,0.09090909090909091
"[1, 0, 0, 0, 1, 1, 1, 0, 1, 1, 1, 1, 1, 1, 0]",278,92,186,6,16,0.06521739130434782,0.08602150537634409
"[0, 1, 1, 0, 0, 1, 1, 0, 0, 0, 1, 1, 1, 0, 1]",168,94,74,12,8,0.1276595744680851,0.10810810810810811
"[1, 0, 1, 0, 1, 1, 0, 1, 1, 1, 1, 0, 0, 1, 0]",154,65,89,7,6,0.1076923076923077,0.06741573033707865
"[1, 1, 0, 1, 0, 1, 1, 0, 1, 1, 1, 1, 0, 0, 1]",312,98,214,13,22,0.1326530612244898,0.102803738317757
"[1, 0, 1, 1, 1, 1, 1, 1, 1, 0, 0, 0, 1, 1, 1]",771,219,552,15,61,0.0684931506849315,0.1105072463768116
"[1, 0, 0, 1, 1, 1, 1, 1, 1, 1, 0, 1, 0, 1, 1]",879,188,691,27,62,0.14361702127659576,0.08972503617945007
"[1, 0, 0, 0, 0, 0, 0, 1, 1, 1, 0, 1, 1, 0, 0]",222,92,130,7,16,0.07608695652173914,0.12307692307692308
"[1, 1, 0, 0, 0, 0, 0, 0, 1, 1, 1, 0, 1, 1, 0]",233,112,121,13,14,0.11607142857142858,0.11570247933884298
"[1, 0, 0, 0, 1, 0, 0, 1, 0, 0, 1, 1, 0, 0, 0]",323,203,120,14,11,0.06896551724137931,0.09166666666666666
"[0, 1, 1, 1, 0, 1, 1, 0, 0, 0, 1, 1, 1, 1, 1]",371,143,228,10,21,0.06993006993006994,0.09210526315789473
"[0, 0, 1, 0, 1, 1, 1, 0, 1, 1, 0, 0, 0, 1, 1]",161,86,75,10,9,0.11627906976744186,0.12
"[0, 0, 0, 0, 1, 1, 0, 0, 1, 1, 1, 0, 1, 1, 0]",214,109,105,10,7,0.09174311926605505,0.06666666666666667
"[1, 1, 0, 1, 1, 1, 1, 0, 0, 0, 0, 1, 1, 0, 0]",434,201,233,15,16,0.07462686567164178,0.06866952789699571
"[1, 0, 1, 1, 0, 1, 1, 1, 1, 1, 1, 1, 1, 0, 1]",1608,395,1213,37,105,0.09367088607594937,0.08656224237427865
"[0, 1, 0, 0, 1, 1, 0, 1, 1, 0, 1, 1, 1, 1, 1]",305,119,186,10,16,0.08403361344537816,0.08602150537634409
"[1, 0, 1, 0, 0, 1, 1, 0, 1, 1, 0, 1, 1, 1, 1]",281,92,189,11,18,0.11956521739130435,0.09523809523809523
"[0, 1, 1, 1, 0, 1, 0, 0, 1, 1, 0, 1, 1, 0, 1]",151,58,93,4,10,0.06896551724137931,0.10752688172043011
"[0, 0, 1, 1, 1, 1, 1, 1, 1, 1, 1, 1, 1, 0, 1]",2887,747,2140,77,187,0.10307898259705489,0.08738317757009346
"[0, 1, 1, 1, 1, 1, 1, 0, 1, 1, 0, 0, 0, 0, 0]",216,119,97,11,9,0.09243697478991597,0.09278350515463918
"[1, 1, 1, 0, 0, 0, 1, 0, 0, 0, 1, 0, 1, 1, 1]",144,60,84,7,4,0.11666666666666667,0.047619047619047616
"[1, 0, 1, 1, 1, 0, 0, 0, 1, 0, 0, 0, 1, 0, 1]",115,61,54,2,5,0.03278688524590164,0.09259259259259259
"[1, 0, 1, 0, 1, 0, 0, 0, 1, 0, 1, 1, 1, 1, 0]",134,59,75,5,5,0.0847457627118644,0.06666666666666667
"[0, 0, 0, 1, 1, 1, 0, 0, 1, 1, 1, 0, 0, 0, 1]",137,80,57,7,6,0.0875,0.10526315789473684
"[0, 0, 0, 1, 0, 1, 1, 0, 0, 0, 0, 1, 1, 1, 0]",170,109,61,10,3,0.09174311926605505,0.04918032786885246
"[0, 0, 0, 1, 1, 0, 1, 0, 0, 0, 1, 0, 0, 1, 0]",225,152,73,14,5,0.09210526315789473,0.0684931506849315
"[1, 1, 0, 0, 0, 0, 0, 0, 1, 1, 1, 1, 1, 0, 0]",413,219,194,22,14,0.1004566210045662,0.07216494845360824
"[0, 1, 0, 0, 1, 1, 0, 0, 0, 0, 0, 0, 1, 1, 1]",677,399,278,31,30,0.07769423558897243,0.1079136690647482
"[0, 0, 1, 0, 0, 1, 1, 0, 0, 0, 0, 0, 0, 1, 1]",821,555,266,58,28,0.1045045045045045,0.10526315789473684
"[1, 0, 0, 0, 0, 0, 0, 1, 1, 0, 0, 1, 1, 1, 0]",436,149,287,15,19,0.10067114093959731,0.06620209059233449
"[1, 1, 0, 0, 1, 1, 1, 1, 1, 1, 0, 0, 1, 0, 0]",415,211,204,17,28,0.08056872037914692,0.13725490196078433
"[0, 1, 1, 0, 0, 1, 1, 1, 1, 1, 1, 0, 0, 1, 0]",394,262,132,25,9,0.09541984732824428,0.06818181818181818
"[0, 0, 1, 1, 0, 1, 1, 0, 0, 0, 0, 1, 1, 0, 0]",331,179,152,13,14,0.07262569832402235,0.09210526315789473
"[0, 0, 0, 0, 0, 1, 0, 1, 1, 0, 1, 0, 0, 0, 1]",254,168,86,18,5,0.10714285714285714,0.05813953488372093
"[0, 1, 0, 0, 1, 0, 0, 0, 0, 0, 0, 1, 0, 1, 1]",274,171,103,18,12,0.10526315789473684,0.11650485436893204
"[0, 1, 0, 1, 0, 1, 1, 0, 1, 0, 1, 0, 0, 1, 1]",134,59,75,6,2,0.1016949152542373,0.02666666666666667
"[1, 0, 0, 0, 0, 1, 1, 0, 1, 0, 0, 0, 0, 1, 1]",267,127,140,10,17,0.07874015748031496,0.12142857142857143
"[0, 0, 1, 1, 1, 1, 0, 0, 0, 0, 1, 1, 0, 1, 0]",329,180,149,11,16,0.06111111111111111,0.10738255033557047
"[0, 0, 0, 1, 0, 1, 0, 1, 0, 1, 0, 1, 1, 1, 1]",141,79,62,4,6,0.05063291139240506,0.0967741935483871
"[1, 1, 1, 1, 0, 0, 0, 0, 1, 0, 1, 0, 1, 0, 1]",162,71,91,6,7,0.08450704225352113,0.07692307692307693
"[1, 0, 1, 0, 1, 1, 1, 1, 0, 0, 0, 0, 1, 0, 1]",121,47,74,5,5,0.10638297872340426,0.06756756756756757
"[0, 1, 0, 0, 0, 1, 0, 1, 0, 1, 0, 1, 0, 0, 1]",126,72,54,2,5,0.027777777777777776,0.09259259259259259
"[1, 1, 1, 1, 0, 1, 1, 1, 0, 1, 0, 1, 0, 0, 0]",147,63,84,6,6,0.09523809523809523,0.07142857142857142
"[0, 0, 0, 0, 1, 0, 1, 0, 1, 1, 0, 0, 0, 0, 1]",299,179,120,22,13,0.12290502793296089,0.10833333333333334
"[1, 0, 0, 0, 0, 1, 0, 1, 0, 1, 1, 0, 0, 0, 0]",356,211,145,23,15,0.10900473933649289,0.10344827586206896
"[0, 0, 0, 1, 1, 0, 0, 0, 0, 1, 0, 1, 0, 1, 1]",302,224,78,26,9,0.11607142857142858,0.11538461538461539
"[1, 1, 0, 1, 1, 0, 0, 0, 0, 0, 0, 0, 1, 1, 0]",229,124,105,12,20,0.0967741935483871,0.19047619047619047
"[0, 0, 0, 1, 1, 1, 0, 1, 1, 0, 1, 0, 0, 0, 0]",175,107,68,8,7,0.07476635514018691,0.10294117647058823
"[0, 1, 1, 0, 1, 0, 1, 1, 0, 1, 1, 1, 1, 1, 1]",671,239,432,18,45,0.07531380753138076,0.10416666666666667
"[1, 0, 1, 1, 0, 0, 1, 1, 0, 1, 0, 1, 1, 0, 1]",135,54,81,6,9,0.1111111111111111,0.1111111111111111
"[1, 1, 1, 1, 0, 1, 1, 0, 0, 1, 1, 0, 1, 0, 1]",248,90,158,11,12,0.12222222222222222,0.0759493670886076
"[0, 0, 1, 1, 1, 1, 1, 0, 1, 1, 0, 0, 1, 1, 0]",216,91,125,9,9,0.0989010989010989,0.072
"[1, 1, 1, 1, 0, 1, 0, 1, 1, 1, 1, 1, 0, 1, 0]",513,157,356,22,34,0.14012738853503184,0.09550561797752809
"[1, 0, 1, 1, 1, 1, 1, 0, 0, 1, 1, 1, 1, 1, 0]",634,165,469,14,48,0.08484848484848485,0.1023454157782516
"[0, 1, 0, 0, 0, 0, 1, 1, 1, 0, 0, 0, 0, 1, 1]",272,161,111,17,13,0.10559006211180125,0.11711711711711711
"[1, 0, 1, 1, 0, 0, 0, 0, 0, 0, 1, 1, 0, 0, 0]",682,441,241,41,30,0.09297052154195011,0.12448132780082988
"[0, 1, 0, 1, 1, 1, 1, 1, 0, 1, 1, 0, 1, 0, 0]",126,57,69,7,7,0.12280701754385964,0.10144927536231885
"[1, 1, 0, 1, 1, 0, 1, 0, 1, 1, 0, 1, 0, 1, 0]",121,50,71,3,7,0.06,0.09859154929577464
"[1, 1, 1, 0, 0, 0, 0, 0, 0, 0, 0, 1, 1, 0, 0]",2128,562,1566,58,151,0.10320284697508897,0.09642401021711366
"[0, 0, 0, 0, 1, 1, 0, 0, 0, 0, 1, 0, 0, 1, 1]",684,470,214,44,24,0.09361702127659574,0.11214953271028037
"[0, 0, 1, 0, 1, 0, 0, 0, 1, 1, 0, 1, 0, 1, 1]",114,64,50,5,3,0.078125,0.06
"[1, 1, 0, 0, 1, 0, 1, 1, 0, 1, 1, 1, 1, 1, 1]",698,219,479,28,33,0.1278538812785388,0.06889352818371608
"[1, 1, 1, 0, 0, 1, 1, 0, 1, 1, 1, 1, 0, 0, 0]",251,73,178,7,14,0.0958904109589041,0.07865168539325842
"[1, 0, 0, 0, 0, 1, 0, 0, 0, 1, 0, 0, 1, 0, 0]",512,342,170,31,16,0.09064327485380116,0.09411764705882353
"[1, 0, 1, 0, 0, 0, 0, 0, 0, 0, 0, 0, 0, 1, 1]",1426,1003,423,109,42,0.10867397806580259,0.09929078014184398
"[0, 1, 1, 1, 0, 0, 1, 0, 1, 1, 0, 0, 0, 0, 0]",208,122,86,13,12,0.10655737704918032,0.13953488372093023
"[1, 1, 0, 0, 0, 0, 0, 1, 0, 1, 1, 0, 1, 1, 1]",186,91,95,8,9,0.08791208791208792,0.09473684210526316
"[0, 0, 1, 0, 1, 1, 1, 1, 0, 0, 0, 1, 1, 0, 0]",158,81,77,6,4,0.07407407407407407,0.05194805194805195
"[0, 1, 0, 1, 1, 1, 1, 1, 0, 0, 0, 0, 1, 0, 0]",145,79,66,4,8,0.05063291139240506,0.12121212121212122
"[0, 0, 1, 0, 1, 1, 1, 0, 1, 1, 1, 1, 1, 0, 1]",217,83,134,10,11,0.12048192771084337,0.08208955223880597
"[1, 1, 0, 0, 1, 0, 1, 1, 1, 0, 1, 1, 1, 1, 1]",686,213,473,17,34,0.07981220657276995,0.07188160676532769
"[1, 1, 0, 1, 1, 1, 1, 1, 0, 1, 0, 0, 0, 0, 0]",168,80,88,7,5,0.0875,0.056818181818181816
"[0, 1, 0, 1, 1, 1, 1, 1, 0, 1, 1, 1, 0, 1, 0]",206,60,146,7,9,0.11666666666666667,0.06164383561643835
"[1, 0, 1, 1, 0, 1, 1, 1, 0, 0, 1, 1, 1, 1, 0]",337,107,230,16,31,0.14953271028037382,0.13478260869565217
"[0, 0, 1, 1, 1, 1, 1, 1, 0, 1, 1, 1, 0, 0, 1]",388,134,254,12,24,0.08955223880597014,0.09448818897637795
"[0, 0, 1, 0, 1, 0, 0, 1, 1, 0, 1, 0, 1, 1, 1]",151,79,72,6,7,0.0759493670886076,0.09722222222222222
"[0, 0, 0, 1, 0, 0, 1, 1, 1, 1, 0, 0, 0, 0, 0]",652,446,206,43,14,0.09641255605381166,0.06796116504854369
"[0, 1, 0, 1, 0, 0, 1, 0, 1, 0, 1, 1, 0, 0, 0]",163,91,72,5,5,0.054945054945054944,0.06944444444444445
"[0, 0, 1, 0, 1, 0, 0, 1, 0, 1, 0, 1, 1, 0, 0]",148,79,69,3,6,0.0379746835443038,0.08695652173913043
"[0, 0, 1, 1, 1, 0, 0, 0, 1, 1, 0, 0, 0, 1, 1]",157,81,76,9,9,0.1111111111111111,0.11842105263157894
"[0, 1, 1, 1, 1, 1, 1, 1, 0, 1, 0, 0, 1, 1, 1]",750,279,471,20,37,0.07168458781362007,0.07855626326963906
"[1, 0, 1, 1, 1, 1, 1, 1, 1, 0, 1, 0, 0, 1, 1]",619,181,438,15,50,0.08287292817679558,0.1141552511415525
"[0, 1, 1, 0, 1, 1, 1, 1, 1, 1, 1, 0, 1, 0, 0]",247,95,152,5,10,0.05263157894736842,0.06578947368421052
"[0, 0, 1, 0, 0, 1, 0, 0, 0, 0, 0, 1, 0, 0, 1]",511,369,142,40,12,0.10840108401084012,0.08450704225352113
"[0, 1, 0, 1, 1, 1, 1, 1, 1, 1, 1, 0, 0, 1, 1]",1242,378,864,25,75,0.06613756613756613,0.08680555555555555
"[0, 0, 0, 1, 1, 1, 0, 0, 1, 1, 0, 0, 1, 1, 1]",337,177,160,18,20,0.1016949152542373,0.125
"[0, 0, 0, 0, 1, 0, 1, 0, 1, 0, 1, 1, 0, 1, 0]",145,81,64,8,7,0.09876543209876543,0.109375
"[1, 1, 1, 0, 1, 0, 1, 1, 1, 0, 1, 1, 0, 0, 1]",273,83,190,11,22,0.13253012048192772,0.11578947368421053
"[1, 0, 0, 1, 1, 0, 0, 1, 1, 1, 0, 0, 1, 0, 0]",157,63,94,3,8,0.047619047619047616,0.0851063829787234
"[1, 1, 1, 1, 0, 0, 1, 1, 1, 0, 0, 0, 0, 0, 1]",201,101,100,10,7,0.09900990099009901,0.07
"[0, 1, 1, 1, 1, 1, 0, 0, 1, 0, 0, 0, 0, 1, 1]",199,105,94,12,9,0.11428571428571428,0.09574468085106383
"[0, 1, 1, 0, 0, 1, 0, 1, 1, 0, 1, 1, 1, 1, 1]",302,132,170,16,18,0.12121212121212122,0.10588235294117647
"[1, 1, 1, 0, 0, 1, 1, 0, 0, 1, 0, 1, 1, 0, 1]",194,68,126,1,12,0.014705882352941176,0.09523809523809523
"[1, 1, 1, 1, 0, 0, 1, 1, 0, 0, 1, 0, 1, 1, 0]",252,105,147,5,17,0.047619047619047616,0.11564625850340136
"[1, 0, 0, 1, 1, 1, 1, 0, 0, 1, 0, 0, 0, 0, 1]",187,72,115,6,6,0.08333333333333333,0.05217391304347826
"[0, 1, 0, 1, 0, 0, 1, 0, 1, 0, 1, 1, 0, 0, 1]",125,60,65,6,6,0.1,0.09230769230769231
"[0, 1, 0, 1, 0, 0, 0, 1, 0, 1, 1, 0, 1, 0, 1]",110,54,56,1,5,0.018518518518518517,0.08928571428571429
"[0, 0, 0, 0, 0, 0, 0, 1, 0, 1, 1, 0, 1, 1, 1]",359,249,110,29,11,0.11646586345381527,0.1
"[0, 0, 1, 1, 1, 1, 0, 1, 1, 0, 1, 1, 0, 1, 1]",278,103,175,7,21,0.06796116504854369,0.12
"[1, 0, 0, 0, 0, 1, 1, 1, 0, 0, 1, 0, 0, 1, 1]",178,71,107,2,6,0.028169014084507043,0.056074766355140186
"[0, 0, 1, 0, 0, 1, 1, 0, 0, 1, 0, 0, 1, 1, 1]",165,99,66,13,6,0.13131313131313133,0.09090909090909091
"[0, 1, 0, 0, 0, 0, 1, 1, 1, 0, 0, 0, 1, 0, 0]",237,152,85,13,7,0.08552631578947369,0.08235294117647059
"[1, 1, 0, 1, 0, 1, 0, 0, 0, 0, 1, 1, 1, 0, 0]",161,75,86,9,8,0.12,0.09302325581395349
"[1, 0, 1, 1, 0, 1, 0, 1, 0, 0, 0, 0, 1, 1, 1]",169,72,97,5,8,0.06944444444444445,0.08247422680412371
"[0, 1, 0, 1, 0, 1, 1, 0, 1, 1, 1, 0, 1, 1, 1]",215,91,124,7,10,0.07692307692307693,0.08064516129032258
"[1, 1, 0, 1, 0, 1, 0, 1, 0, 1, 1, 0, 1, 1, 1]",229,85,144,10,12,0.11764705882352941,0.08333333333333333
"[0, 0, 1, 1, 1, 1, 0, 1, 0, 1, 0, 1, 0, 1, 1]",152,71,81,9,10,0.1267605633802817,0.12345679012345678
"[0, 0, 0, 1, 1, 1, 0, 0, 0, 1, 1, 1, 1, 0, 1]",140,65,75,7,11,0.1076923076923077,0.14666666666666667
"[1, 0, 0, 0, 1, 1, 1, 0, 0, 0, 1, 1, 1, 1, 0]",171,69,102,6,11,0.08695652173913043,0.10784313725490197
"[1, 1, 1, 0, 0, 1, 0, 0, 1, 0, 0, 0, 0, 0, 0]",328,188,140,23,11,0.12234042553191489,0.07857142857142857
"[0, 1, 1, 1, 0, 0, 1, 0, 0, 1, 0, 0, 0, 0, 0]",283,179,104,12,12,0.0670391061452514,0.11538461538461539
"[0, 0, 0, 0, 1, 1, 1, 0, 0, 1, 0, 0, 1, 0, 0]",280,177,103,13,9,0.07344632768361582,0.08737864077669903
"[0, 0, 1, 0, 0, 0, 0, 0, 0, 1, 1, 1, 0, 0, 1]",308,178,130,20,14,0.11235955056179775,0.1076923076923077
"[1, 0, 1, 0, 1, 0, 1, 1, 0, 0, 1, 0, 1, 0, 0]",107,47,60,3,2,0.06382978723404255,0.03333333333333333
"[1, 0, 1, 0, 1, 0, 1, 0, 1, 1, 0, 0, 1, 0, 1]",99,44,55,3,12,0.06818181818181818,0.21818181818181817
"[0, 1, 0, 1, 1, 1, 1, 0, 1, 1, 1, 0, 1, 0, 1]",223,66,157,5,17,0.07575757575757576,0.10828025477707007
"[1, 0, 0, 1, 1, 0, 0, 0, 0, 1, 1, 0, 0, 0, 1]",461,138,323,8,31,0.057971014492753624,0.09597523219814241
"[0, 0, 1, 0, 0, 0, 1, 1, 1, 0, 0, 0, 0, 0, 0]",802,561,241,61,40,0.10873440285204991,0.16597510373443983
"[1, 1, 0, 0, 0, 1, 0, 0, 0, 1, 1, 1, 0, 0, 0]",165,100,65,12,6,0.12,0.09230769230769231
"[1, 0, 0, 0, 0, 1, 0, 1, 0, 0, 1, 1, 1, 1, 1]",196,77,119,11,13,0.14285714285714285,0.1092436974789916
"[0, 1, 1, 0, 0, 1, 1, 0, 0, 0, 0, 1, 0, 1, 0]",269,210,59,18,4,0.08571428571428572,0.06779661016949153
"[0, 1, 0, 1, 1, 0, 1, 0, 0, 1, 1, 1, 0, 1, 1]",139,56,83,6,5,0.10714285714285714,0.060240963855421686
"[1, 0, 1, 1, 0, 1, 0, 1, 1, 0, 1, 0, 0, 1, 1]",158,66,92,5,12,0.07575757575757576,0.13043478260869565
"[0, 0, 1, 1, 0, 1, 1, 0, 1, 1, 1, 1, 0, 1, 1]",286,101,185,9,16,0.0891089108910891,0.08648648648648649
"[0, 0, 0, 0, 1, 0, 0, 1, 1, 0, 1, 1, 0, 1, 1]",136,72,64,3,5,0.041666666666666664,0.078125
"[0, 0, 1, 1, 1, 0, 0, 0, 1, 1, 1, 1, 1, 1, 0]",288,144,144,16,20,0.1111111111111111,0.1388888888888889
"[0, 0, 1, 0, 0, 1, 0, 0, 0, 0, 0, 1, 1, 1, 0]",262,165,97,19,7,0.11515151515151516,0.07216494845360824
"[0, 0, 0, 1, 0, 0, 1, 0, 0, 0, 0, 0, 1, 1, 1]",570,402,168,30,16,0.07462686567164178,0.09523809523809523
"[0, 0, 1, 1, 1, 0, 1, 1, 1, 1, 1, 1, 0, 0, 1]",422,158,264,14,21,0.08860759493670886,0.07954545454545454
"[1, 0, 0, 1, 1, 0, 1, 0, 1, 1, 1, 1, 1, 1, 1]",763,222,541,16,47,0.07207207207207207,0.08687615526802218
"[0, 0, 1, 1, 1, 0, 1, 0, 1, 0, 1, 1, 1, 1, 1]",337,133,204,16,17,0.12030075187969924,0.08333333333333333
"[1, 1, 0, 1, 1, 0, 1, 0, 0, 0, 0, 1, 0, 0, 0]",143,73,70,8,6,0.1095890410958904,0.08571428571428572
"[0, 0, 1, 1, 0, 0, 1, 1, 1, 0, 0, 1, 0, 1, 1]",199,102,97,11,9,0.10784313725490197,0.09278350515463918
"[1, 1, 0, 0, 0, 1, 0, 1, 1, 0, 1, 0, 0, 1, 1]",154,62,92,5,11,0.08064516129032258,0.11956521739130435
"[1, 0, 1, 1, 1, 0, 0, 0, 1, 0, 1, 1, 0, 1, 0]",111,51,60,7,6,0.13725490196078433,0.1
"[1, 0, 1, 0, 0, 1, 1, 0, 1, 0, 1, 1, 1, 1, 0]",130,66,64,6,3,0.09090909090909091,0.046875
"[1, 0, 1, 1, 1, 0, 0, 0, 0, 1, 1, 0, 0, 0, 0]",457,276,181,30,17,0.10869565217391304,0.09392265193370165
"[0, 1, 0, 1, 1, 0, 1, 1, 0, 1, 1, 1, 0, 1, 0]",129,57,72,3,8,0.05263157894736842,0.1111111111111111
"[1, 0, 0, 0, 0, 1, 1, 1, 1, 1, 1, 0, 1, 1, 0]",292,75,217,7,22,0.09333333333333334,0.10138248847926268
"[1, 0, 0, 0, 0, 0, 1, 1, 0, 1, 1, 1, 1, 1, 0]",125,48,77,6,11,0.125,0.14285714285714285
"[0, 1, 1, 1, 0, 0, 0, 1, 0, 0, 1, 0, 1, 0, 0]",146,87,59,8,5,0.09195402298850575,0.0847457627118644
"[0, 1, 1, 1, 1, 1, 0, 1, 0, 1, 0, 0, 0, 0, 1]",129,58,71,6,5,0.10344827586206896,0.07042253521126761
"[1, 1, 0, 1, 0, 1, 0, 0, 1, 0, 1, 0, 1, 1, 1]",121,54,67,4,6,0.07407407407407407,0.08955223880597014
"[0, 0, 1, 0, 1, 1, 0, 1, 1, 1, 0, 0, 0, 0, 1]",143,80,63,7,5,0.0875,0.07936507936507936
"[1, 1, 0, 0, 1, 0, 1, 1, 0, 1, 1, 1, 0, 0, 0]",133,61,72,8,8,0.13114754098360656,0.1111111111111111
"[0, 0, 0, 1, 1, 1, 1, 1, 1, 1, 1, 0, 0, 1, 0]",411,285,126,31,12,0.10877192982456141,0.09523809523809523
"[1, 0, 1, 1, 1, 0, 1, 0, 1, 0, 1, 1, 0, 0, 1]",165,63,102,7,4,0.1111111111111111,0.0392156862745098
"[1, 1, 0, 1, 1, 1, 0, 1, 0, 1, 0, 1, 1, 0, 0]",171,66,105,4,9,0.06060606060606061,0.08571428571428572
"[0, 0, 0, 0, 1, 1, 0, 1, 0, 1, 0, 1, 0, 0, 0]",285,182,103,11,14,0.06043956043956044,0.13592233009708737
"[1, 0, 1, 0, 0, 0, 1, 0, 0, 0, 0, 0, 0, 0, 1]",598,388,210,28,17,0.07216494845360824,0.08095238095238096
"[1, 0, 1, 1, 0, 0, 0, 1, 1, 1, 0, 1, 1, 1, 1]",274,103,171,8,17,0.07766990291262135,0.09941520467836257
"[0, 0, 1, 1, 0, 1, 0, 0, 1, 0, 0, 0, 1, 0, 0]",266,172,94,13,6,0.0755813953488372,0.06382978723404255
"[0, 1, 1, 0, 0, 0, 1, 0, 1, 1, 0, 1, 1, 0, 1]",122,61,61,2,9,0.03278688524590164,0.14754098360655737
"[1, 1, 1, 0, 0, 1, 1, 1, 0, 0, 1, 0, 1, 0, 1]",174,79,95,7,11,0.08860759493670886,0.11578947368421053
"[0, 1, 1, 0, 1, 1, 1, 0, 0, 1, 1, 0, 0, 1, 1]",344,144,200,14,25,0.09722222222222222,0.125
"[1, 0, 0, 0, 1, 0, 1, 1, 1, 1, 1, 0, 0, 1, 0]",104,44,60,3,8,0.06818181818181818,0.13333333333333333
"[0, 1, 1, 0, 0, 0, 1, 0, 0, 0, 0, 1, 0, 0, 1]",265,184,81,17,10,0.09239130434782608,0.12345679012345678
"[1, 0, 1, 0, 0, 1, 1, 0, 0, 1, 1, 1, 0, 0, 0]",146,83,63,5,5,0.060240963855421686,0.07936507936507936
"[0, 1, 0, 1, 0, 0, 1, 1, 0, 0, 1, 1, 1, 0, 0]",141,74,67,10,6,0.13513513513513514,0.08955223880597014
"[0, 0, 0, 1, 1, 1, 1, 1, 1, 0, 1, 1, 0, 0, 1]",248,130,118,6,15,0.046153846153846156,0.1271186440677966
"[1, 1, 1, 1, 0, 1, 0, 0, 1, 1, 0, 1, 1, 1, 0]",282,93,189,7,16,0.07526881720430108,0.08465608465608465
"[1, 0, 1, 0, 1, 0, 1, 0, 1, 1, 1, 0, 0, 1, 1]",176,58,118,4,15,0.06896551724137931,0.1271186440677966
"[1, 0, 0, 1, 1, 1, 0, 1, 1, 0, 1, 0, 1, 1, 1]",316,106,210,8,17,0.07547169811320754,0.08095238095238096
"[0, 1, 1, 1, 1, 1, 1, 1, 1, 0, 1, 0, 0, 1, 1]",742,263,479,22,38,0.08365019011406843,0.07933194154488518
"[0, 1, 1, 1, 1, 1, 0, 0, 1, 1, 1, 0, 1, 1, 1]",645,228,417,16,48,0.07017543859649122,0.11510791366906475
"[1, 1, 0, 0, 1, 1, 0, 1, 0, 0, 0, 1, 0, 1, 0]",121,60,61,5,6,0.08333333333333333,0.09836065573770492
"[0, 1, 0, 0, 1, 1, 0, 1, 1, 0, 0, 1, 1, 0, 1]",101,50,51,5,4,0.1,0.0784313725490196
"[1, 0, 1, 1, 1, 1, 0, 1, 1, 1, 1, 0, 1, 0, 1]",498,155,343,20,43,0.12903225806451613,0.12536443148688048
"[1, 0, 0, 1, 0, 1, 0, 1, 0, 1, 0, 1, 0, 0, 1]",122,69,53,5,4,0.07246376811594203,0.07547169811320754
"[1, 1, 0, 0, 1, 0, 1, 0, 1, 0, 1, 0, 1, 0, 0]",114,58,56,7,7,0.1206896551724138,0.125
"[1, 0, 0, 0, 1, 0, 0, 1, 0, 1, 0, 0, 0, 1, 0]",238,154,84,23,9,0.14935064935064934,0.10714285714285714
"[1, 0, 0, 0, 1, 0, 0, 0, 0, 0, 0, 1, 0, 0, 0]",1620,1247,373,108,39,0.08660785886126704,0.10455764075067024
"[1, 1, 1, 1, 1, 1, 0, 0, 1, 0, 0, 1, 0, 1, 1]",359,121,238,17,33,0.14049586776859505,0.13865546218487396
"[1, 0, 1, 0, 0, 1, 1, 1, 1, 1, 0, 0, 1, 1, 1]",426,148,278,18,36,0.12162162162162163,0.12949640287769784
"[1, 1, 1, 0, 1, 1, 0, 1, 1, 0, 0, 1, 1, 1, 1]",834,229,605,26,52,0.11353711790393013,0.0859504132231405
"[1, 1, 1, 1, 0, 0, 0, 0, 1, 1, 0, 1, 0, 0, 1]",205,90,115,9,6,0.1,0.05217391304347826
"[1, 1, 1, 0, 1, 1, 0, 1, 0, 1, 1, 0, 1, 1, 1]",568,181,387,15,41,0.08287292817679558,0.10594315245478036
"[0, 1, 0, 1, 0, 0, 0, 0, 1, 0, 0, 0, 1, 1, 1]",204,130,74,12,4,0.09230769230769231,0.05405405405405406
"[1, 1, 1, 1, 1, 0, 1, 1, 0, 0, 1, 1, 1, 1, 0]",847,239,608,14,56,0.058577405857740586,0.09210526315789473
"[1, 1, 1, 1, 0, 1, 1, 1, 0, 0, 1, 0, 1, 1, 1]",649,166,483,11,55,0.06626506024096386,0.11387163561076605
"[0, 1, 1, 1, 0, 1, 0, 0, 0, 0, 1, 1, 1, 1, 1]",317,151,166,12,20,0.07947019867549669,0.12048192771084337
"[1, 1, 1, 0, 1, 1, 1, 0, 1, 0, 0, 0, 0, 1, 1]",207,80,127,10,15,0.125,0.11811023622047244
"[1, 1, 1, 0, 1, 1, 1, 1, 0, 1, 0, 1, 1, 0, 1]",470,149,321,21,42,0.14093959731543623,0.1308411214953271
"[0, 0, 1, 1, 1, 0, 0, 1, 1, 1, 1, 0, 1, 0, 1]",181,70,111,7,7,0.1,0.06306306306306306
"[0, 0, 0, 1, 1, 1, 0, 0, 0, 0, 0, 1, 1, 1, 0]",192,117,75,12,6,0.10256410256410256,0.08
"[1, 1, 0, 1, 0, 1, 0, 0, 0, 0, 1, 0, 0, 0, 1]",149,83,66,6,8,0.07228915662650602,0.12121212121212122
"[0, 0, 1, 1, 1, 1, 0, 1, 1, 0, 0, 0, 1, 0, 1]",104,56,48,4,9,0.07142857142857142,0.1875
"[1, 0, 0, 1, 1, 1, 1, 1, 1, 0, 0, 0, 0, 1, 0]",360,75,285,7,21,0.09333333333333334,0.07368421052631578
"[0, 1, 1, 0, 0, 1, 1, 1, 1, 1, 1, 0, 0, 0, 0]",1550,1198,352,99,27,0.08263772954924875,0.07670454545454546
"[1, 0, 1, 0, 1, 0, 0, 0, 1, 1, 0, 0, 1, 1, 1]",178,87,91,7,8,0.08045977011494253,0.08791208791208792
"[1, 1, 1, 0, 0, 0, 0, 0, 1, 0, 1, 0, 0, 1, 0]",175,101,74,11,6,0.10891089108910891,0.08108108108108109
"[0, 1, 0, 0, 1, 1, 0, 1, 1, 1, 1, 0, 1, 1, 1]",265,118,147,13,12,0.11016949152542373,0.08163265306122448
"[1, 1, 1, 0, 0, 1, 0, 1, 1, 1, 1, 1, 0, 1, 0]",202,67,135,10,14,0.14925373134328357,0.1037037037037037
"[1, 1, 0, 0, 1, 1, 1, 0, 1, 1, 1, 1, 0, 0, 1]",391,139,252,16,23,0.11510791366906475,0.09126984126984126
"[1, 1, 0, 1, 0, 1, 1, 0, 1, 0, 0, 0, 0, 1, 0]",108,64,44,4,5,0.0625,0.11363636363636363
"[0, 0, 0, 0, 0, 1, 0, 1, 0, 0, 1, 1, 0, 1, 0]",226,148,78,12,7,0.08108108108108109,0.08974358974358974
"[1, 0, 0, 0, 1, 1, 0, 0, 0, 0, 1, 0, 0, 0, 0]",632,419,213,51,17,0.12171837708830549,0.07981220657276995
"[1, 1, 1, 0, 0, 1, 0, 1, 0, 0, 1, 0, 0, 0, 0]",184,103,81,16,6,0.1553398058252427,0.07407407407407407
"[0, 0, 1, 0, 0, 0, 1, 0, 0, 0, 0, 0, 1, 0, 1]",498,335,163,45,17,0.13432835820895522,0.10429447852760736
"[0, 1, 1, 0, 0, 1, 0, 0, 0, 1, 0, 0, 0, 0, 0]",591,415,176,42,21,0.10120481927710843,0.11931818181818182
"[1, 0, 1, 1, 1, 1, 1, 0, 0, 0, 0, 1, 1, 1, 0]",184,77,107,7,11,0.09090909090909091,0.102803738317757
"[0, 1, 0, 1, 1, 1, 1, 1, 1, 0, 0, 0, 1, 1, 0]",182,86,96,11,7,0.12790697674418605,0.07291666666666667
"[0, 0, 0, 1, 0, 0, 1, 0, 0, 1, 1, 0, 0, 0, 0]",825,593,232,44,21,0.07419898819561552,0.09051724137931035
"[0, 0, 0, 0, 1, 0, 0, 1, 0, 0, 1, 1, 0, 0, 0]",760,549,211,50,19,0.09107468123861566,0.09004739336492891
"[1, 1, 1, 0, 0, 1, 1, 1, 0, 0, 0, 1, 0, 1, 1]",213,90,123,5,4,0.05555555555555555,0.032520325203252036
"[0, 1, 0, 1, 1, 1, 0, 1, 1, 1, 0, 0, 1, 1, 1]",314,125,189,6,18,0.048,0.09523809523809523
"[1, 0, 0, 0, 1, 1, 0, 0, 1, 1, 1, 1, 0, 0, 1]",406,177,229,18,18,0.1016949152542373,0.07860262008733625
"[1, 0, 1, 0, 1, 1, 0, 0, 0, 0, 0, 0, 1, 1, 0]",343,193,150,25,14,0.12953367875647667,0.09333333333333334
"[1, 1, 0, 1, 1, 1, 0, 1, 0, 1, 1, 0, 0, 0, 0]",149,62,87,5,5,0.08064516129032258,0.05747126436781609
"[1, 1, 0, 1, 1, 0, 0, 1, 0, 0, 1, 1, 1, 0, 1]",157,65,92,9,8,0.13846153846153847,0.08695652173913043
"[0, 1, 1, 0, 1, 0, 0, 1, 1, 1, 0, 0, 0, 1, 1]",126,54,72,4,4,0.07407407407407407,0.05555555555555555
"[1, 1, 1, 0, 1, 1, 0, 1, 0, 0, 1, 1, 1, 0, 0]",147,55,92,5,12,0.09090909090909091,0.13043478260869565
"[0, 1, 1, 0, 1, 1, 0, 0, 0, 1, 0, 0, 0, 0, 0]",290,194,96,14,15,0.07216494845360824,0.15625
"[0, 1, 0, 1, 0, 1, 0, 0, 1, 1, 1, 0, 1, 1, 1]",160,73,87,10,9,0.136986301369863,0.10344827586206896
"[0, 1, 0, 1, 0, 1, 1, 0, 0, 1, 1, 0, 0, 1, 1]",255,123,132,14,11,0.11382113821138211,0.08333333333333333
"[0, 1, 1, 1, 0, 0, 1, 0, 0, 0, 1, 1, 0, 1, 1]",122,60,62,7,9,0.11666666666666667,0.14516129032258066
"[0, 0, 1, 1, 1, 0, 0, 1, 0, 0, 0, 1, 1, 0, 1]",121,61,60,7,9,0.11475409836065574,0.15
"[0, 0, 0, 0, 0, 0, 0, 1, 1, 0, 0, 1, 1, 1, 0]",660,509,151,42,10,0.0825147347740668,0.06622516556291391
"[1, 0, 1, 1, 1, 1, 1, 0, 1, 1, 1, 1, 0, 0, 1]",771,213,558,24,48,0.11267605633802817,0.08602150537634409
"[0, 1, 0, 1, 1, 1, 0, 0, 0, 0, 0, 1, 1, 0, 0]",217,134,83,14,5,0.1044776119402985,0.060240963855421686
"[0, 0, 1, 0, 0, 0, 0, 0, 0, 1, 1, 1, 1, 0, 1]",235,158,77,15,4,0.0949367088607595,0.05194805194805195
"[0, 0, 0, 1, 0, 0, 0, 0, 0, 0, 1, 1, 1, 1, 0]",677,452,225,46,16,0.10176991150442478,0.07111111111111111
"[0, 1, 0, 0, 0, 1, 0, 0, 0, 0, 0, 0, 1, 1, 1]",553,385,168,38,20,0.0987012987012987,0.11904761904761904
"[0, 1, 0, 0, 1, 1, 1, 1, 1, 0, 0, 1, 0, 0, 0]",112,51,61,7,6,0.13725490196078433,0.09836065573770492
"[1, 1, 0, 1, 1, 0, 0, 1, 1, 0, 0, 0, 1, 1, 1]",230,95,135,11,8,0.11578947368421053,0.05925925925925926
"[0, 1, 0, 0, 0, 0, 1, 1, 1, 0, 1, 1, 0, 0, 1]",124,70,54,10,6,0.14285714285714285,0.1111111111111111
"[1, 0, 0, 0, 1, 1, 1, 0, 0, 1, 0, 1, 0, 0, 0]",158,98,60,9,5,0.09183673469387756,0.08333333333333333
"[0, 1, 1, 0, 0, 1, 1, 0, 1, 1, 0, 1, 0, 1, 0]",117,61,56,6,3,0.09836065573770492,0.05357142857142857
"[0, 0, 0, 1, 0, 1, 1, 0, 0, 1, 1, 0, 1, 1, 0]",124,64,60,3,5,0.046875,0.08333333333333333
"[0, 1, 0, 0, 1, 0, 0, 1, 0, 1, 1, 0, 1, 0, 0]",128,70,58,6,8,0.08571428571428572,0.13793103448275862
"[1, 1, 1, 0, 1, 1, 1, 0, 0, 0, 1, 1, 0, 1, 1]",243,81,162,6,19,0.07407407407407407,0.11728395061728394
"[1, 1, 1, 1, 1, 1, 1, 0, 1, 0, 1, 1, 0, 0, 1]",783,210,573,21,62,0.1,0.1082024432809773
"[0, 1, 0, 1, 1, 1, 0, 1, 0, 1, 0, 0, 0, 0, 1]",128,69,59,10,7,0.14492753623188406,0.11864406779661017
"[0, 1, 1, 0, 1, 0, 1, 0, 1, 1, 1, 0, 1, 0, 1]",135,47,88,6,10,0.1276595744680851,0.11363636363636363
"[0, 1, 0, 1, 1, 0, 1, 0, 1, 0, 1, 1, 1, 0, 1]",123,45,78,6,7,0.13333333333333333,0.08974358974358974
"[0, 1, 0, 1, 0, 0, 1, 0, 0, 1, 0, 0, 0, 1, 1]",160,91,69,8,6,0.08791208791208792,0.08695652173913043
"[0, 1, 0, 0, 0, 1, 0, 1, 0, 0, 1, 0, 0, 1, 0]",197,132,65,14,10,0.10606060606060606,0.15384615384615385
"[0, 1, 0, 1, 0, 0, 0, 0, 0, 1, 1, 0, 0, 1, 1]",378,227,151,26,17,0.1145374449339207,0.11258278145695365
"[1, 0, 1, 0, 0, 0, 1, 1, 0, 0, 0, 0, 0, 0, 0]",961,656,305,71,26,0.10823170731707317,0.08524590163934426
"[0, 0, 0, 0, 0, 0, 0, 0, 1, 0, 1, 0, 0, 0, 1]",1903,1480,423,152,47,0.10270270270270271,0.1111111111111111
"[1, 1, 0, 1, 0, 1, 1, 0, 1, 0, 0, 0, 0, 1, 1]",127,57,70,3,4,0.05263157894736842,0.05714285714285714
"[1, 0, 1, 0, 0, 1, 0, 0, 0, 0, 0, 0, 0, 1, 1]",412,256,156,22,22,0.0859375,0.14102564102564102
"[1, 0, 1, 0, 0, 1, 0, 1, 1, 1, 1, 0, 1, 0, 0]",109,45,64,8,7,0.17777777777777778,0.109375
"[1, 1, 1, 0, 0, 1, 0, 1, 1, 0, 0, 0, 1, 1, 0]",126,57,69,3,7,0.05263157894736842,0.10144927536231885
"[0, 0, 1, 0, 1, 0, 0, 1, 0, 0, 0, 0, 0, 1, 1]",344,224,120,22,6,0.09821428571428571,0.05
"[1, 1, 1, 0, 0, 0, 0, 0, 0, 1, 0, 1, 0, 0, 1]",218,115,103,11,10,0.09565217391304348,0.0970873786407767
"[0, 0, 1, 0, 0, 1, 1, 1, 1, 0, 0, 1, 0, 0, 0]",170,106,64,7,8,0.0660377358490566,0.125
"[0, 0, 1, 1, 1, 1, 1, 0, 1, 1, 1, 0, 0, 0, 1]",184,78,106,13,13,0.16666666666666666,0.12264150943396226
"[0, 0, 0, 1, 0, 1, 0, 0, 1, 1, 1, 0, 0, 0, 1]",142,86,56,12,6,0.13953488372093023,0.10714285714285714
"[1, 0, 1, 0, 1, 1, 0, 0, 0, 1, 1, 1, 1, 1, 1]",392,146,246,13,22,0.08904109589041095,0.08943089430894309
"[0, 0, 1, 1, 0, 1, 0, 1, 1, 1, 0, 1, 1, 1, 1]",315,125,190,6,14,0.048,0.07368421052631578
"[1, 1, 0, 1, 0, 1, 0, 0, 1, 0, 0, 1, 1, 0, 1]",103,47,56,7,7,0.14893617021276595,0.125
"[1, 1, 1, 1, 0, 0, 0, 1, 1, 0, 1, 0, 0, 1, 1]",177,67,110,6,9,0.08955223880597014,0.08181818181818182
"[1, 1, 0, 1, 1, 0, 1, 1, 1, 0, 1, 1, 0, 1, 1]",474,131,343,11,33,0.08396946564885496,0.09620991253644315
"[0, 1, 1, 0, 0, 0, 0, 0, 0, 1, 1, 1, 0, 0, 1]",325,252,73,27,8,0.10714285714285714,0.1095890410958904
"[0, 1, 1, 1, 0, 1, 0, 0, 0, 0, 0, 0, 1, 1, 0]",249,160,89,9,6,0.05625,0.06741573033707865
"[0, 1, 0, 1, 1, 0, 0, 0, 0, 1, 1, 0, 1, 1, 0]",143,74,69,5,9,0.06756756756756757,0.13043478260869565
"[1, 1, 1, 1, 1, 0, 0, 1, 0, 0, 1, 1, 0, 0, 1]",265,93,172,6,16,0.06451612903225806,0.09302325581395349
"[0, 1, 0, 1, 1, 1, 1, 1, 1, 1, 1, 0, 1, 0, 1]",573,173,400,12,36,0.06936416184971098,0.09
"[0, 1, 0, 1, 1, 0, 0, 0, 0, 0, 1, 1, 0, 0, 0]",386,235,151,23,19,0.09787234042553192,0.12582781456953643
"[0, 1, 1, 1, 0, 0, 1, 0, 0, 0, 0, 0, 1, 0, 0]",244,169,75,19,7,0.11242603550295859,0.09333333333333334
"[0, 0, 1, 1, 1, 0, 0, 1, 0, 0, 0, 0, 0, 1, 0]",250,172,78,14,12,0.08139534883720931,0.15384615384615385
"[1, 1, 0, 0, 1, 0, 1, 0, 1, 0, 1, 0, 1, 1, 0]",92,41,51,5,1,0.12195121951219512,0.0196078431372549
"[0, 0, 0, 0, 0, 1, 0, 1, 1, 1, 1, 1, 1, 1, 0]",202,118,84,9,8,0.07627118644067797,0.09523809523809523
"[1, 0, 1, 1, 1, 0, 1, 1, 1, 1, 1, 0, 1, 0, 1]",458,133,325,12,32,0.09022556390977443,0.09846153846153846
"[0, 0, 1, 0, 0, 1, 1, 1, 1, 1, 1, 0, 0, 1, 1]",499,226,273,23,27,0.10176991150442478,0.0989010989010989
"[1, 0, 1, 1, 0, 0, 1, 0, 0, 1, 1, 1, 1, 1, 1]",408,147,261,11,21,0.07482993197278912,0.08045977011494253
"[0, 0, 0, 0, 0, 0, 0, 0, 1, 1, 0, 1, 0, 0, 0]",2194,1693,501,152,50,0.0897814530419374,0.0998003992015968
"[0, 0, 1, 0, 0, 0, 0, 1, 1, 0, 1, 0, 0, 0, 0]",558,379,179,35,15,0.09234828496042216,0.08379888268156424
"[0, 1, 0, 1, 0, 0, 1, 0, 0, 1, 1, 0, 0, 1, 0]",130,74,56,11,5,0.14864864864864866,0.08928571428571429
"[1, 0, 1, 0, 0, 1, 0, 1, 0, 0, 0, 0, 1, 0, 0]",189,116,73,11,5,0.09482758620689655,0.0684931506849315
"[0, 0, 1, 1, 1, 0, 0, 1, 1, 1, 1, 0, 0, 0, 0]",444,256,188,19,11,0.07421875,0.05851063829787234
"[0, 0, 0, 1, 1, 0, 1, 1, 0, 1, 1, 0, 0, 0, 0]",226,138,88,11,3,0.07971014492753623,0.03409090909090909
"[0, 1, 0, 1, 0, 0, 0, 1, 1, 1, 1, 0, 0, 0, 0]",313,196,117,21,11,0.10714285714285714,0.09401709401709402
"[1, 0, 0, 0, 0, 1, 0, 1, 1, 1, 0, 1, 0, 0, 0]",168,102,66,7,6,0.06862745098039216,0.09090909090909091
"[1, 0, 1, 1, 1, 0, 0, 1, 1, 0, 1, 1, 1, 0, 1]",217,76,141,3,13,0.039473684210526314,0.09219858156028368
"[0, 0, 0, 0, 0, 0, 1, 1, 1, 0, 1, 1, 1, 1, 1]",378,196,182,22,17,0.11224489795918367,0.09340659340659341
"[1, 1, 0, 1, 0, 0, 0, 1, 0, 1, 1, 1, 1, 1, 1]",309,99,210,14,17,0.1414141414141414,0.08095238095238096
"[0, 0, 0, 1, 0, 1, 0, 0, 1, 0, 0, 0, 0, 1, 1]",362,243,119,26,11,0.10699588477366255,0.09243697478991597
"[1, 1, 1, 1, 0, 0, 1, 1, 0, 0, 0, 0, 0, 1, 1]",529,276,253,35,27,0.12681159420289856,0.1067193675889328
"[0, 1, 1, 1, 1, 0, 0, 1, 1, 0, 0, 0, 0, 0, 1]",461,343,118,40,12,0.11661807580174927,0.1016949152542373
"[0, 1, 0, 0, 1, 0, 0, 1, 1, 1, 1, 0, 0, 1, 1]",258,135,123,7,13,0.05185185185185185,0.10569105691056911
"[1, 0, 0, 1, 0, 0, 0, 0, 1, 0, 0, 1, 0, 0, 1]",223,143,80,8,5,0.055944055944055944,0.0625
"[1, 1, 1, 0, 1, 0, 0, 1, 1, 1, 0, 0, 0, 1, 0]",113,53,60,4,9,0.07547169811320754,0.15
"[1, 0, 1, 0, 1, 1, 1, 0, 1, 0, 0, 1, 1, 1, 0]",137,61,76,9,7,0.14754098360655737,0.09210526315789473
"[0, 1, 1, 0, 1, 1, 1, 0, 1, 1, 0, 1, 1, 0, 0]",145,76,69,6,8,0.07894736842105263,0.11594202898550725
"[1, 1, 0, 0, 1, 1, 0, 1, 1, 1, 1, 1, 0, 0, 1]",373,141,232,17,26,0.12056737588652482,0.11206896551724138
"[0, 0, 0, 0, 1, 1, 1, 0, 1, 0, 1, 0, 1, 1, 1]",196,109,87,14,8,0.12844036697247707,0.09195402298850575
"[0, 1, 1, 1, 1, 1, 0, 0, 0, 0, 1, 1, 1, 0, 1]",181,90,91,10,13,0.1111111111111111,0.14285714285714285
"[0, 1, 0, 1, 0, 0, 0, 1, 0, 0, 0, 1, 0, 1, 0]",196,118,78,8,7,0.06779661016949153,0.08974358974358974
"[0, 0, 0, 0, 0, 0, 0, 0, 1, 0, 1, 0, 1, 1, 0]",707,521,186,44,15,0.08445297504798464,0.08064516129032258
"[0, 1, 1, 0, 1, 0, 0, 1, 1, 0, 1, 1, 0, 0, 1]",120,58,62,6,6,0.10344827586206896,0.0967741935483871
"[0, 0, 0, 1, 0, 0, 0, 0, 1, 1, 0, 1, 0, 0, 1]",238,155,83,18,9,0.11612903225806452,0.10843373493975904
"[1, 0, 0, 0, 1, 1, 1, 1, 1, 0, 0, 0, 0, 0, 0]",385,199,186,21,12,0.10552763819095477,0.06451612903225806
"[1, 1, 0, 1, 0, 1, 1, 1, 1, 0, 0, 1, 1, 0, 1]",262,91,171,11,14,0.12087912087912088,0.08187134502923976
"[1, 1, 0, 0, 1, 1, 0, 1, 0, 0, 1, 1, 0, 1, 1]",152,57,95,6,8,0.10526315789473684,0.08421052631578947
"[1, 1, 0, 0, 0, 1, 0, 1, 0, 1, 0, 1, 0, 0, 0]",148,83,65,5,11,0.060240963855421686,0.16923076923076924
"[1, 1, 0, 0, 0, 1, 0, 1, 1, 1, 0, 0, 0, 0, 1]",166,97,69,9,9,0.09278350515463918,0.13043478260869565
"[1, 0, 1, 0, 0, 1, 1, 1, 1, 0, 0, 1, 0, 0, 1]",134,66,68,4,5,0.06060606060606061,0.07352941176470588
"[0, 1, 0, 1, 0, 1, 1, 0, 0, 0, 0, 0, 0, 1, 1]",356,218,138,27,12,0.12385321100917432,0.08695652173913043
"[0, 0, 0, 1, 1, 0, 0, 1, 0, 1, 1, 1, 1, 0, 0]",176,104,72,12,7,0.11538461538461539,0.09722222222222222
"[1, 0, 0, 0, 1, 1, 0, 0, 1, 1, 0, 0, 1, 0, 0]",190,123,67,12,10,0.0975609756097561,0.14925373134328357
"[0, 0, 1, 0, 0, 1, 1, 1, 0, 0, 0, 0, 0, 1, 1]",247,151,96,20,9,0.13245033112582782,0.09375
"[1, 0, 1, 0, 0, 1, 1, 0, 0, 0, 0, 1, 1, 1, 1]",472,246,226,26,15,0.10569105691056911,0.06637168141592921
"[1, 0, 1, 1, 1, 1, 0, 0, 1, 1, 1, 0, 1, 0, 0]",128,55,73,6,7,0.10909090909090909,0.0958904109589041
"[0, 1, 1, 1, 1, 1, 0, 0, 1, 0, 1, 0, 0, 0, 1]",105,50,55,8,8,0.16,0.14545454545454545
"[1, 0, 1, 0, 0, 1, 1, 1, 0, 0, 1, 1, 1, 1, 1]",403,154,249,13,22,0.08441558441558442,0.08835341365461848
"[0, 0, 1, 1, 0, 1, 0, 0, 1, 1, 1, 0, 0, 1, 1]",166,83,83,8,5,0.0963855421686747,0.060240963855421686
"[1, 1, 1, 1, 0, 1, 1, 1, 1, 0, 0, 1, 1, 0, 1]",602,189,413,17,41,0.08994708994708994,0.09927360774818401
"[0, 1, 1, 0, 1, 1, 0, 1, 1, 1, 1, 0, 0, 1, 1]",384,149,235,14,24,0.09395973154362416,0.10212765957446808
"[1, 0, 1, 1, 0, 1, 1, 0, 1, 1, 1, 1, 0, 0, 1]",312,113,199,9,19,0.07964601769911504,0.09547738693467336
"[0, 0, 1, 0, 1, 0, 0, 1, 1, 1, 1, 1, 1, 1, 1]",512,206,306,24,34,0.11650485436893204,0.1111111111111111
"[1, 1, 1, 1, 1, 1, 1, 0, 0, 1, 0, 1, 0, 0, 1]",373,123,250,12,14,0.0975609756097561,0.056
"[1, 1, 1, 1, 1, 1, 1, 1, 0, 0, 1, 0, 1, 0, 0]",407,142,265,11,25,0.07746478873239436,0.09433962264150944
"[1, 0, 1, 1, 1, 1, 0, 1, 0, 0, 0, 0, 1, 1, 0]",155,67,88,5,8,0.07462686567164178,0.09090909090909091
"[0, 1, 0, 1, 1, 1, 0, 0, 0, 0, 1, 0, 1, 0, 0]",155,86,69,6,9,0.06976744186046512,0.13043478260869565
"[1, 1, 0, 1, 1, 1, 0, 0, 1, 1, 0, 1, 0, 1, 1]",236,83,153,7,18,0.08433734939759036,0.11764705882352941
"[0, 0, 0, 1, 1, 1, 0, 0, 0, 0, 1, 0, 1, 1, 1]",191,124,67,11,8,0.08870967741935484,0.11940298507462686
"[0, 0, 0, 0, 1, 0, 1, 0, 0, 0, 1, 1, 1, 1, 1]",237,139,98,16,4,0.11510791366906475,0.04081632653061224
"[1, 0, 0, 0, 1, 1, 0, 0, 1, 0, 1, 1, 1, 0, 0]",116,45,71,4,11,0.08888888888888889,0.15492957746478872
"[0, 1, 1, 1, 0, 0, 1, 0, 0, 0, 1, 1, 0, 0, 1]",142,79,63,5,5,0.06329113924050633,0.07936507936507936
"[1, 1, 0, 1, 0, 1, 1, 0, 0, 1, 1, 1, 1, 1, 1]",961,313,648,24,50,0.07667731629392971,0.07716049382716049
"[0, 1, 1, 1, 1, 0, 0, 0, 0, 0, 0, 0, 1, 1, 1]",710,550,160,45,19,0.08181818181818182,0.11875
"[0, 0, 1, 0, 0, 1, 1, 1, 0, 1, 0, 0, 0, 1, 0]",136,67,69,7,11,0.1044776119402985,0.15942028985507245
"[0, 1, 1, 0, 1, 1, 1, 1, 0, 0, 0, 0, 1, 1, 1]",411,172,239,14,30,0.08139534883720931,0.12552301255230125
"[0, 0, 1, 0, 0, 1, 1, 0, 1, 1, 1, 1, 0, 0, 0]",148,81,67,7,4,0.08641975308641975,0.05970149253731343
"[1, 1, 1, 0, 0, 0, 1, 1, 1, 1, 1, 1, 1, 0, 1]",677,184,493,12,40,0.06521739130434782,0.08113590263691683
"[0, 0, 0, 0, 1, 1, 1, 1, 0, 0, 0, 0, 1, 1, 1]",2103,1181,922,113,83,0.09568162574089754,0.09002169197396963
"[1, 0, 0, 1, 0, 1, 0, 0, 0, 0, 1, 0, 1, 1, 0]",131,84,47,7,4,0.08333333333333333,0.0851063829787234
"[0, 1, 0, 1, 1, 0, 1, 0, 0, 0, 1, 0, 1, 1, 1]",124,63,61,4,6,0.06349206349206349,0.09836065573770492
"[1, 1, 1, 1, 0, 0, 1, 0, 1, 0, 0, 1, 0, 1, 1]",193,81,112,9,11,0.1111111111111111,0.09821428571428571
"[0, 1, 0, 1, 0, 1, 0, 0, 0, 1, 1, 0, 0, 0, 1]",139,96,43,10,2,0.10416666666666667,0.046511627906976744
"[1, 0, 1, 0, 0, 0, 1, 1, 0, 0, 1, 0, 0, 1, 1]",137,70,67,11,5,0.15714285714285714,0.07462686567164178
"[1, 0, 1, 0, 1, 0, 0, 0, 1, 1, 0, 0, 1, 0, 0]",125,71,54,5,6,0.07042253521126761,0.1111111111111111
"[0, 0, 1, 1, 1, 1, 0, 0, 0, 1, 0, 1, 0, 1, 0]",129,74,55,10,4,0.13513513513513514,0.07272727272727272
"[0, 1, 0, 0, 0, 0, 1, 0, 1, 0, 0, 0, 1, 1, 1]",223,128,95,16,11,0.125,0.11578947368421053
"[0, 0, 0, 0, 1, 1, 1, 1, 0, 1, 1, 1, 1, 0, 1]",237,110,127,11,16,0.1,0.12598425196850394
"[1, 1, 1, 0, 0, 1, 0, 0, 1, 0, 1, 1, 1, 0, 0]",125,49,76,5,6,0.10204081632653061,0.07894736842105263
"[0, 1, 1, 1, 0, 0, 1, 0, 0, 1, 0, 1, 1, 1, 0]",112,60,52,7,9,0.11666666666666667,0.17307692307692307
"[0, 1, 1, 0, 0, 1, 0, 0, 1, 0, 1, 1, 0, 1, 0]",115,57,58,2,5,0.03508771929824561,0.08620689655172414
"[0, 0, 1, 1, 0, 1, 1, 0, 0, 0, 1, 0, 0, 1, 0]",140,92,48,9,5,0.09782608695652174,0.10416666666666667
"[1, 0, 0, 1, 1, 1, 0, 1, 1, 0, 0, 0, 1, 1, 0]",121,52,69,3,7,0.057692307692307696,0.10144927536231885
"[0, 1, 1, 0, 1, 1, 1, 0, 0, 1, 1, 1, 0, 1, 1]",262,98,164,11,14,0.11224489795918367,0.08536585365853659
"[0, 0, 1, 0, 1, 1, 1, 1, 1, 0, 0, 1, 1, 0, 1]",143,49,94,5,7,0.10204081632653061,0.07446808510638298
"[0, 0, 1, 0, 0, 0, 0, 1, 0, 1, 1, 1, 1, 1, 0]",151,76,75,8,2,0.10526315789473684,0.02666666666666667
"[0, 1, 1, 0, 0, 0, 1, 1, 0, 0, 0, 1, 1, 0, 0]",243,167,76,21,9,0.12574850299401197,0.11842105263157894
"[0, 0, 0, 1, 1, 0, 0, 1, 1, 0, 0, 0, 1, 1, 0]",300,224,76,22,11,0.09821428571428571,0.14473684210526316
"[1, 0, 1, 0, 1, 0, 0, 1, 1, 0, 0, 0, 0, 0, 0]",473,297,176,34,15,0.11447811447811448,0.08522727272727272
"[0, 1, 0, 0, 1, 0, 0, 0, 0, 1, 1, 0, 0, 0, 1]",280,177,103,20,9,0.11299435028248588,0.08737864077669903
"[0, 1, 1, 0, 0, 1, 1, 1, 1, 0, 1, 0, 1, 0, 1]",210,121,89,10,8,0.08264462809917356,0.0898876404494382
"[0, 0, 0, 0, 0, 1, 1, 0, 0, 1, 1, 1, 1, 0, 1]",397,306,91,32,10,0.10457516339869281,0.10989010989010989
"[1, 0, 0, 1, 1, 0, 0, 0, 0, 1, 1, 0, 1, 0, 0]",247,98,149,4,16,0.04081632653061224,0.10738255033557047
"[1, 0, 1, 1, 0, 0, 1, 1, 0, 0, 0, 0, 1, 1, 0]",413,202,211,24,15,0.1188118811881188,0.07109004739336493
"[0, 1, 1, 0, 1, 0, 0, 0, 1, 1, 1, 1, 1, 0, 1]",136,55,81,5,6,0.09090909090909091,0.07407407407407407
"[1, 0, 0, 1, 1, 0, 1, 1, 0, 0, 1, 0, 1, 0, 1]",112,51,61,1,9,0.0196078431372549,0.14754098360655737
"[1, 0, 1, 0, 0, 1, 1, 0, 1, 1, 0, 0, 1, 0, 1]",111,59,52,6,3,0.1016949152542373,0.057692307692307696
"[1, 0, 0, 1, 1, 1, 1, 0, 1, 0, 0, 1, 1, 1, 1]",410,108,302,8,26,0.07407407407407407,0.08609271523178808
"[0, 0, 0, 1, 0, 1, 1, 1, 0, 1, 1, 1, 1, 1, 0]",164,73,91,4,9,0.0547945205479452,0.0989010989010989
"[0, 0, 1, 0, 1, 1, 0, 1, 1, 0, 0, 1, 1, 0, 1]",107,51,56,4,5,0.0784313725490196,0.08928571428571429
"[1, 1, 0, 0, 0, 1, 0, 1, 1, 0, 1, 1, 0, 0, 1]",123,44,79,4,15,0.09090909090909091,0.189873417721519
"[1, 0, 0, 1, 1, 0, 0, 0, 0, 0, 1, 0, 0, 0, 1]",302,153,149,14,13,0.0915032679738562,0.087248322147651
"[0, 0, 0, 0, 1, 1, 0, 0, 0, 1, 1, 1, 0, 1, 1]",219,118,101,11,13,0.09322033898305085,0.12871287128712872
"[0, 1, 0, 1, 0, 1, 0, 1, 0, 0, 1, 0, 0, 0, 0]",229,156,73,15,7,0.09615384615384616,0.0958904109589041
"[1, 0, 1, 0, 0, 0, 0, 1, 0, 0, 0, 0, 0, 0, 1]",582,422,160,48,10,0.11374407582938388,0.0625
"[0, 1, 0, 0, 1, 1, 1, 0, 0, 0, 1, 0, 1, 0, 0]",132,82,50,9,4,0.10975609756097561,0.08
"[0, 1, 0, 1, 0, 0, 1, 1, 1, 0, 0, 0, 1, 0, 1]",105,56,49,6,4,0.10714285714285714,0.08163265306122448
"[0, 1, 0, 1, 1, 0, 1, 1, 0, 0, 1, 0, 0, 0, 1]",113,51,62,4,5,0.0784313725490196,0.08064516129032258
"[0, 1, 0, 1, 0, 1, 0, 1, 1, 0, 1, 1, 0, 0, 1]",122,61,61,6,3,0.09836065573770492,0.04918032786885246
"[0, 1, 1, 0, 1, 0, 1, 1, 0, 1, 1, 0, 1, 0, 1]",132,57,75,3,5,0.05263157894736842,0.06666666666666667
"[1, 1, 1, 0, 0, 1, 1, 0, 1, 1, 0, 1, 0, 1, 1]",281,87,194,5,19,0.05747126436781609,0.0979381443298969
"[0, 0, 0, 0, 0, 1, 0, 0, 0, 1, 1, 0, 1, 1, 0]",270,176,94,25,9,0.14204545454545456,0.09574468085106383
"[1, 0, 1, 0, 0, 0, 1, 0, 1, 0, 0, 1, 0, 0, 0]",231,155,76,11,4,0.07096774193548387,0.05263157894736842
"[1, 1, 1, 1, 1, 1, 1, 0, 0, 1, 0, 1, 1, 1, 0]",620,156,464,14,35,0.08974358974358974,0.07543103448275862
"[0, 1, 0, 1, 1, 0, 0, 0, 1, 1, 0, 0, 0, 1, 0]",130,79,51,7,8,0.08860759493670886,0.1568627450980392
"[0, 0, 0, 1, 0, 1, 1, 0, 0, 0, 1, 1, 0, 0, 0]",314,194,120,21,11,0.10824742268041238,0.09166666666666666
"[0, 0, 0, 1, 1, 1, 0, 1, 0, 0, 1, 1, 1, 0, 0]",122,65,57,8,6,0.12307692307692308,0.10526315789473684
"[0, 1, 0, 0, 1, 0, 0, 0, 1, 0, 0, 0, 1, 1, 1]",208,125,83,8,5,0.064,0.060240963855421686
"[0, 1, 0, 1, 1, 1, 0, 1, 0, 1, 1, 1, 1, 1, 1]",618,214,404,22,47,0.102803738317757,0.11633663366336634
"[0, 0, 0, 1, 1, 0, 0, 1, 1, 0, 1, 1, 0, 1, 1]",206,137,69,11,4,0.08029197080291971,0.057971014492753624
"[0, 0, 0, 1, 0, 0, 0, 1, 1, 0, 0, 1, 1, 0, 1]",145,92,53,4,6,0.043478260869565216,0.11320754716981132
"[0, 0, 0, 1, 1, 1, 0, 0, 1, 0, 0, 1, 1, 0, 1]",136,73,63,4,9,0.0547945205479452,0.14285714285714285
"[0, 1, 0, 0, 1, 1, 0, 0, 0, 1, 1, 1, 0, 0, 1]",128,64,64,2,9,0.03125,0.140625
"[1, 1, 0, 0, 0, 1, 1, 0, 0, 1, 0, 1, 0, 0, 1]",125,63,62,7,4,0.1111111111111111,0.06451612903225806
"[0, 0, 0, 0, 1, 0, 0, 1, 1, 1, 0, 1, 1, 0, 0]",165,102,63,7,6,0.06862745098039216,0.09523809523809523
"[0, 1, 1, 0, 1, 0, 1, 0, 0, 1, 0, 1, 0, 1, 1]",101,49,52,6,4,0.12244897959183673,0.07692307692307693
"[1, 0, 0, 1, 0, 1, 1, 0, 0, 1, 1, 1, 0, 0, 1]",136,72,64,11,4,0.1527777777777778,0.0625
"[1, 0, 1, 0, 0, 1, 0, 1, 1, 0, 0, 1, 1, 1, 0]",142,65,77,8,8,0.12307692307692308,0.1038961038961039
"[1, 1, 1, 1, 0, 0, 0, 1, 0, 1, 1, 0, 0, 1, 0]",118,55,63,2,5,0.03636363636363636,0.07936507936507936
"[0, 1, 1, 1, 1, 0, 0, 0, 1, 0, 1, 1, 0, 0, 1]",148,90,58,8,4,0.08888888888888889,0.06896551724137931
"[1, 0, 1, 0, 0, 0, 0, 0, 1, 1, 1, 1, 0, 0, 0]",378,237,141,25,9,0.10548523206751055,0.06382978723404255
"[1, 1, 1, 1, 1, 0, 1, 0, 1, 0, 0, 1, 1, 0, 0]",243,92,151,13,15,0.14130434782608695,0.09933774834437085
"[0, 0, 1, 1, 0, 1, 0, 1, 1, 0, 1, 1, 1, 1, 0]",132,51,81,3,5,0.058823529411764705,0.06172839506172839
"[1, 1, 0, 0, 0, 1, 0, 0, 0, 1, 0, 0, 0, 1, 0]",228,155,73,17,8,0.10967741935483871,0.1095890410958904
"[1, 0, 0, 1, 0, 0, 0, 0, 1, 1, 1, 1, 1, 1, 0]",306,137,169,19,15,0.1386861313868613,0.08875739644970414
"[0, 1, 1, 1, 1, 1, 1, 1, 0, 0, 1, 0, 0, 0, 0]",185,103,82,8,9,0.07766990291262135,0.10975609756097561
"[0, 1, 1, 0, 1, 0, 0, 0, 1, 1, 0, 1, 1, 1, 1]",183,84,99,11,11,0.13095238095238096,0.1111111111111111
"[1, 0, 1, 1, 1, 0, 1, 0, 0, 0, 0, 1, 0, 0, 1]",95,44,51,5,4,0.11363636363636363,0.0784313725490196
"[0, 0, 0, 1, 0, 1, 0, 1, 1, 0, 1, 1, 0, 1, 0]",105,46,59,4,8,0.08695652173913043,0.13559322033898305
"[0, 1, 0, 0, 1, 0, 0, 0, 1, 0, 1, 0, 1, 1, 0]",128,78,50,9,6,0.11538461538461539,0.12
"[1, 1, 0, 0, 1, 0, 0, 1, 0, 0, 0, 1, 0, 1, 0]",159,93,66,12,4,0.12903225806451613,0.06060606060606061
"[0, 1, 1, 0, 0, 1, 1, 0, 0, 1, 1, 1, 0, 0, 1]",243,173,70,18,5,0.10404624277456648,0.07142857142857142
"[1, 1, 0, 1, 1, 1, 1, 0, 0, 0, 0, 1, 1, 1, 0]",193,71,122,6,10,0.08450704225352113,0.08196721311475409
"[1, 0, 1, 0, 0, 1, 1, 0, 0, 0, 0, 1, 0, 1, 0]",177,98,79,10,7,0.10204081632653061,0.08860759493670886
"[1, 1, 1, 0, 1, 0, 0, 1, 1, 0, 0, 0, 0, 1, 0]",126,76,50,14,5,0.18421052631578946,0.1
"[0, 0, 0, 0, 1, 0, 1, 1, 1, 0, 1, 0, 0, 1, 1]",158,92,66,6,9,0.06521739130434782,0.13636363636363635
"[0, 0, 0, 0, 1, 1, 1, 0, 0, 0, 0, 0, 1, 0, 1]",282,183,99,24,5,0.13114754098360656,0.050505050505050504
"[1, 0, 0, 1, 1, 0, 0, 0, 1, 1, 1, 1, 0, 0, 0]",242,121,121,13,10,0.10743801652892562,0.08264462809917356
"[0, 0, 1, 1, 0, 1, 0, 0, 0, 0, 1, 0, 1, 0, 0]",248,153,95,19,5,0.12418300653594772,0.05263157894736842
"[0, 0, 1, 0, 1, 0, 1, 0, 0, 1, 1, 0, 1, 0, 0]",139,84,55,6,4,0.07142857142857142,0.07272727272727272
"[1, 1, 0, 0, 1, 0, 1, 0, 1, 0, 0, 1, 1, 0, 1]",117,53,64,5,6,0.09433962264150944,0.09375
"[1, 1, 0, 1, 0, 1, 1, 0, 0, 1, 1, 0, 0, 0, 0]",307,139,168,11,17,0.07913669064748201,0.10119047619047619
"[0, 1, 1, 0, 1, 0, 1, 1, 0, 0, 1, 1, 0, 0, 0]",197,115,82,5,11,0.043478260869565216,0.13414634146341464
"[1, 0, 0, 0, 1, 0, 1, 1, 0, 1, 0, 1, 1, 0, 0]",116,51,65,4,4,0.0784313725490196,0.06153846153846154
"[0, 1, 1, 1, 1, 0, 0, 0, 1, 0, 0, 0, 1, 0, 0]",181,116,65,9,6,0.07758620689655173,0.09230769230769231
"[1, 1, 1, 0, 0, 1, 0, 1, 0, 0, 0, 0, 1, 0, 0]",139,79,60,10,3,0.12658227848101267,0.05
"[1, 1, 0, 1, 1, 1, 0, 0, 1, 1, 1, 1, 1, 0, 0]",336,103,233,7,17,0.06796116504854369,0.07296137339055794
"[1, 1, 1, 0, 0, 0, 1, 0, 0, 0, 0, 0, 0, 0, 1]",341,190,151,19,10,0.1,0.06622516556291391
"[1, 1, 1, 0, 1, 1, 0, 1, 0, 1, 0, 1, 1, 1, 1]",547,160,387,18,21,0.1125,0.05426356589147287
"[0, 1, 0, 1, 0, 1, 1, 0, 1, 0, 1, 1, 1, 1, 1]",292,98,194,7,15,0.07142857142857142,0.07731958762886598
"[0, 1, 0, 1, 0, 1, 1, 0, 1, 0, 1, 0, 1, 1, 1]",185,80,105,8,8,0.1,0.0761904761904762
"[0, 1, 1, 0, 0, 1, 1, 1, 1, 1, 0, 0, 0, 0, 0]",319,202,117,25,13,0.12376237623762376,0.1111111111111111
"[0, 0, 0, 1, 1, 1, 1, 0, 0, 1, 0, 0, 1, 0, 1]",174,123,51,12,1,0.0975609756097561,0.0196078431372549
"[1, 1, 1, 1, 1, 1, 0, 1, 1, 0, 0, 1, 1, 0, 0]",554,196,358,15,35,0.07653061224489796,0.09776536312849161
"[1, 0, 1, 1, 1, 1, 1, 1, 0, 1, 1, 0, 0, 0, 0]",234,67,167,6,15,0.08955223880597014,0.08982035928143713
"[1, 1, 1, 0, 0, 1, 0, 0, 0, 1, 1, 1, 1, 1, 1]",443,130,313,11,31,0.08461538461538462,0.09904153354632587
"[1, 0, 1, 0, 0, 0, 1, 1, 1, 1, 0, 1, 0, 1, 0]",97,43,54,5,7,0.11627906976744186,0.12962962962962962
"[1, 1, 0, 0, 0, 0, 1, 1, 1, 1, 1, 0, 1, 1, 0]",272,116,156,8,17,0.06896551724137931,0.10897435897435898
"[0, 0, 1, 0, 0, 1, 1, 0, 0, 1, 0, 0, 0, 0, 0]",620,433,187,42,17,0.09699769053117784,0.09090909090909091
"[0, 1, 1, 0, 1, 0, 0, 1, 1, 0, 0, 0, 0, 1, 1]",266,152,114,12,10,0.07894736842105263,0.08771929824561403
"[1, 1, 1, 1, 0, 0, 0, 1, 0, 0, 0, 1, 1, 0, 0]",193,94,99,8,14,0.0851063829787234,0.1414141414141414
"[1, 0, 0, 1, 0, 0, 0, 0, 0, 0, 0, 0, 0, 1, 1]",1163,754,409,77,39,0.10212201591511937,0.09535452322738386
"[1, 0, 1, 0, 0, 0, 0, 0, 1, 1, 0, 1, 1, 0, 1]",93,44,49,5,3,0.11363636363636363,0.061224489795918366
"[1, 0, 0, 1, 1, 1, 1, 0, 1, 1, 0, 0, 1, 0, 1]",176,60,116,5,13,0.08333333333333333,0.11206896551724138
"[0, 0, 1, 1, 1, 1, 1, 0, 1, 1, 1, 0, 1, 1, 1]",686,231,455,25,55,0.10822510822510822,0.12087912087912088
"[0, 0, 0, 1, 0, 0, 0, 0, 0, 0, 1, 0, 1, 1, 1]",503,375,128,38,15,0.10133333333333333,0.1171875
"[0, 0, 1, 0, 0, 1, 1, 0, 1, 0, 0, 1, 0, 0, 1]",140,87,53,11,4,0.12643678160919541,0.07547169811320754
"[1, 0, 0, 1, 1, 0, 0, 1, 1, 1, 1, 1, 0, 0, 0]",271,85,186,10,30,0.11764705882352941,0.16129032258064516
"[0, 0, 0, 1, 1, 0, 1, 0, 1, 1, 0, 0, 1, 1, 0]",161,101,60,4,5,0.039603960396039604,0.08333333333333333
"[1, 0, 1, 1, 1, 1, 1, 1, 0, 1, 0, 0, 0, 0, 0]",174,79,95,5,7,0.06329113924050633,0.07368421052631578
"[1, 1, 1, 0, 1, 0, 0, 0, 1, 0, 0, 0, 1, 1, 1]",130,50,80,6,6,0.12,0.075
"[0, 1, 0, 1, 0, 1, 1, 1, 0, 1, 0, 1, 1, 1, 1]",281,115,166,12,23,0.10434782608695652,0.13855421686746988
"[0, 0, 0, 0, 1, 0, 0, 0, 0, 0, 1, 1, 1, 0, 1]",239,156,83,15,11,0.09615384615384616,0.13253012048192772
"[0, 1, 0, 1, 1, 0, 1, 0, 0, 0, 0, 0, 0, 1, 1]",226,141,85,15,11,0.10638297872340426,0.12941176470588237
"[1, 0, 0, 0, 0, 1, 0, 1, 1, 1, 1, 1, 1, 1, 1]",536,160,376,18,38,0.1125,0.10106382978723404
"[1, 1, 0, 1, 0, 1, 1, 0, 0, 0, 0, 1, 0, 1, 1]",115,52,63,10,7,0.19230769230769232,0.1111111111111111
"[1, 0, 1, 1, 1, 1, 0, 0, 1, 0, 0, 1, 0, 0, 0]",111,57,54,1,3,0.017543859649122806,0.05555555555555555
"[0, 1, 0, 1, 0, 0, 1, 1, 1, 1, 1, 0, 1, 1, 1]",289,106,183,8,21,0.07547169811320754,0.11475409836065574
"[0, 0, 1, 1, 1, 0, 1, 1, 0, 1, 1, 0, 1, 1, 0]",135,53,82,1,13,0.018867924528301886,0.15853658536585366
"[1, 0, 1, 1, 0, 0, 1, 1, 1, 0, 1, 0, 1, 1, 0]",183,84,99,6,8,0.07142857142857142,0.08080808080808081
"[0, 1, 1, 0, 0, 1, 0, 1, 1, 0, 0, 1, 1, 1, 0]",122,55,67,4,7,0.07272727272727272,0.1044776119402985
"[0, 1, 0, 0, 0, 1, 1, 0, 0, 1, 0, 1, 1, 0, 0]",141,93,48,12,6,0.12903225806451613,0.125
"[1, 0, 1, 0, 0, 0, 1, 1, 0, 0, 1, 0, 1, 1, 0]",100,44,56,5,6,0.11363636363636363,0.10714285714285714
"[0, 0, 1, 1, 1, 0, 0, 0, 1, 0, 0, 0, 1, 1, 0]",168,108,60,12,1,0.1111111111111111,0.016666666666666666
"[1, 1, 0, 1, 0, 0, 0, 0, 0, 1, 1, 1, 1, 1, 1]",415,160,255,10,28,0.0625,0.10980392156862745
"[0, 0, 1, 1, 0, 0, 0, 1, 1, 1, 1, 1, 0, 1, 0]",114,47,67,1,6,0.02127659574468085,0.08955223880597014
"[0, 1, 1, 0, 0, 1, 1, 1, 1, 1, 1, 1, 0, 0, 0]",384,216,168,17,21,0.0787037037037037,0.125
"[0, 1, 0, 1, 0, 1, 0, 0, 1, 0, 1, 1, 1, 1, 1]",200,85,115,7,6,0.08235294117647059,0.05217391304347826
"[1, 1, 1, 1, 0, 1, 0, 1, 1, 0, 0, 1, 0, 1, 0]",118,39,79,1,2,0.02564102564102564,0.02531645569620253
"[1, 1, 1, 1, 1, 0, 1, 1, 1, 0, 0, 0, 0, 0, 0]",272,108,164,13,10,0.12037037037037036,0.06097560975609756
"[1, 1, 1, 1, 1, 0, 0, 0, 1, 1, 0, 0, 0, 0, 0]",294,125,169,16,16,0.128,0.09467455621301775
"[1, 1, 0, 0, 1, 1, 1, 1, 1, 0, 0, 0, 1, 1, 0]",251,115,136,11,10,0.09565217391304348,0.07352941176470588
"[1, 1, 0, 1, 1, 0, 0, 0, 0, 0, 1, 0, 1, 0, 1]",105,56,49,9,1,0.16071428571428573,0.02040816326530612
"[1, 0, 1, 1, 0, 0, 0, 0, 0, 1, 1, 0, 1, 0, 1]",122,63,59,6,4,0.09523809523809523,0.06779661016949153
"[0, 1, 0, 0, 0, 0, 0, 1, 0, 0, 1, 0, 1, 1, 1]",208,125,83,18,9,0.144,0.10843373493975904
"[0, 1, 0, 0, 0, 1, 1, 0, 0, 1, 1, 1, 0, 1, 0]",121,63,58,8,9,0.12698412698412698,0.15517241379310345
"[1, 0, 0, 0, 0, 1, 0, 0, 1, 1, 0, 1, 0, 1, 0]",154,82,72,6,9,0.07317073170731707,0.125
"[1, 0, 0, 0, 0, 0, 1, 1, 0, 1, 0, 0, 0, 0, 1]",267,151,116,15,10,0.09933774834437085,0.08620689655172414
"[0, 1, 0, 0, 1, 1, 0, 1, 0, 0, 1, 1, 0, 0, 0]",177,107,70,7,4,0.06542056074766354,0.05714285714285714
"[1, 0, 0, 0, 1, 0, 0, 0, 1, 0, 1, 1, 1, 0, 1]",111,64,47,9,10,0.140625,0.2127659574468085
"[0, 0, 1, 0, 0, 0, 1, 0, 0, 0, 1, 0, 1, 1, 1]",214,142,72,15,5,0.1056338028169014,0.06944444444444445
"[0, 0, 1, 0, 0, 0, 1, 0, 0, 0, 1, 0, 0, 0, 1]",492,342,150,33,12,0.09649122807017543,0.08
"[0, 0, 1, 0, 0, 1, 1, 0, 1, 0, 0, 0, 0, 1, 0]",222,143,79,13,10,0.09090909090909091,0.12658227848101267
"[0, 0, 0, 1, 0, 0, 1, 1, 0, 1, 0, 0, 0, 0, 1]",273,181,92,15,13,0.08287292817679558,0.14130434782608695
"[0, 0, 1, 1, 1, 0, 0, 1, 0, 0, 0, 0, 1, 0, 0]",239,154,85,15,9,0.09740259740259741,0.10588235294117647
"[1, 1, 1, 0, 0, 1, 0, 1, 1, 1, 0, 1, 1, 0, 0]",189,63,126,6,15,0.09523809523809523,0.11904761904761904
"[0, 1, 0, 0, 1, 1, 0, 1, 1, 1, 0, 0, 1, 0, 1]",93,42,51,2,6,0.047619047619047616,0.11764705882352941
"[0, 1, 0, 1, 0, 0, 0, 0, 1, 0, 0, 0, 1, 1, 0]",271,175,96,12,8,0.06857142857142857,0.08333333333333333
"[1, 0, 0, 0, 0, 0, 1, 1, 0, 0, 0, 1, 1, 1, 0]",169,94,75,9,5,0.09574468085106383,0.06666666666666667
"[0, 1, 0, 1, 1, 1, 0, 1, 1, 1, 1, 1, 1, 0, 1]",511,151,360,9,31,0.059602649006622516,0.08611111111111111
"[1, 1, 0, 1, 1, 1, 1, 1, 1, 0, 0, 1, 0, 0, 0]",169,70,99,7,7,0.1,0.0707070707070707
"[0, 0, 1, 0, 0, 0, 1, 1, 0, 0, 1, 0, 0, 0, 1]",227,140,87,18,6,0.12857142857142856,0.06896551724137931
"[0, 0, 0, 0, 1, 0, 0, 0, 1, 1, 0, 0, 1, 0, 0]",492,370,122,34,10,0.0918918918918919,0.08196721311475409
"[0, 1, 1, 0, 0, 1, 1, 1, 1, 1, 1, 1, 0, 1, 0]",389,229,160,25,17,0.1091703056768559,0.10625
"[1, 0, 0, 0, 1, 1, 1, 1, 0, 1, 1, 1, 0, 1, 1]",257,90,167,8,19,0.08888888888888889,0.11377245508982035
"[0, 0, 1, 0, 1, 1, 0, 0, 0, 1, 1, 1, 1, 0, 0]",214,118,96,10,14,0.0847457627118644,0.14583333333333334
"[0, 0, 1, 0, 0, 1, 1, 0, 0, 0, 1, 0, 1, 0, 1]",147,89,58,9,4,0.10112359550561797,0.06896551724137931
"[1, 1, 0, 0, 1, 0, 1, 0, 1, 1, 1, 0, 1, 1, 1]",257,100,157,5,5,0.05,0.03184713375796178
"[1, 0, 1, 1, 0, 1, 1, 1, 0, 0, 0, 0, 1, 0, 1]",118,53,65,9,5,0.16981132075471697,0.07692307692307693
"[0, 0, 0, 0, 1, 0, 0, 0, 1, 0, 0, 1, 1, 0, 1]",211,129,82,19,7,0.14728682170542637,0.08536585365853659
"[1, 1, 0, 0, 1, 0, 0, 0, 0, 0, 1, 0, 1, 0, 1]",138,85,53,6,4,0.07058823529411765,0.07547169811320754
"[0, 1, 1, 0, 1, 1, 0, 0, 1, 0, 0, 0, 0, 0, 1]",140,88,52,7,1,0.07954545454545454,0.019230769230769232
"[0, 0, 0, 0, 0, 1, 0, 1, 1, 0, 1, 1, 1, 1, 0]",148,82,66,9,6,0.10975609756097561,0.09090909090909091
"[1, 0, 0, 1, 1, 1, 0, 1, 1, 1, 0, 0, 0, 1, 0]",107,48,59,6,4,0.125,0.06779661016949153
"[1, 0, 1, 1, 1, 0, 0, 1, 1, 1, 1, 0, 1, 1, 0]",261,94,167,8,26,0.0851063829787234,0.15568862275449102
"[1, 0, 1, 0, 0, 0, 0, 0, 0, 0, 1, 1, 1, 1, 1]",375,193,182,9,22,0.046632124352331605,0.12087912087912088
"[1, 1, 0, 0, 0, 1, 0, 1, 1, 1, 1, 1, 0, 0, 1]",221,87,134,7,12,0.08045977011494253,0.08955223880597014
"[0, 1, 1, 1, 1, 1, 1, 1, 0, 1, 1, 1, 1, 0, 0]",772,267,505,22,48,0.08239700374531835,0.09504950495049505
"[1, 1, 1, 0, 0, 1, 1, 0, 0, 1, 0, 1, 0, 1, 1]",258,75,183,5,17,0.06666666666666667,0.09289617486338798
"[1, 1, 0, 0, 1, 0, 1, 1, 0, 1, 1, 0, 0, 1, 1]",202,84,118,11,9,0.13095238095238096,0.07627118644067797
"[1, 0, 0, 1, 1, 1, 0, 1, 0, 1, 0, 0, 1, 0, 1]",99,49,50,4,5,0.08163265306122448,0.1
"[0, 0, 1, 1, 0, 1, 1, 0, 0, 1, 1, 0, 0, 0, 1]",118,66,52,6,6,0.09090909090909091,0.11538461538461539
"[1, 0, 0, 1, 0, 1, 1, 0, 1, 1, 0, 1, 1, 0, 1]",137,50,87,8,10,0.16,0.11494252873563218
"[0, 1, 1, 1, 1, 1, 1, 0, 1, 1, 1, 1, 1, 1, 0]",1779,505,1274,51,125,0.100990099009901,0.09811616954474098
"[0, 1, 1, 0, 1, 1, 1, 1, 1, 0, 0, 0, 0, 1, 1]",387,158,229,12,19,0.0759493670886076,0.08296943231441048
"[1, 1, 0, 1, 1, 1, 0, 0, 0, 1, 1, 0, 0, 0, 1]",135,56,79,4,4,0.07142857142857142,0.05063291139240506
"[0, 1, 1, 0, 1, 0, 0, 0, 0, 0, 0, 1, 0, 1, 0]",248,160,88,13,10,0.08125,0.11363636363636363
"[1, 0, 1, 1, 0, 1, 1, 0, 1, 0, 0, 1, 1, 1, 1]",310,125,185,14,11,0.112,0.05945945945945946
"[1, 1, 0, 1, 1, 0, 1, 1, 0, 1, 0, 0, 1, 1, 1]",268,99,169,11,18,0.1111111111111111,0.10650887573964497
"[1, 0, 0, 1, 1, 0, 1, 1, 0, 1, 1, 0, 1, 0, 0]",110,45,65,3,4,0.06666666666666667,0.06153846153846154
"[0, 0, 1, 0, 0, 1, 0, 1, 1, 1, 0, 0, 1, 0, 0]",157,91,66,12,5,0.13186813186813187,0.07575757575757576
"[1, 0, 1, 1, 0, 0, 0, 0, 1, 1, 0, 1, 1, 1, 0]",121,56,65,7,7,0.125,0.1076923076923077
"[1, 1, 1, 1, 1, 1, 0, 1, 0, 1, 0, 1, 1, 0, 0]",295,109,186,7,20,0.06422018348623854,0.10752688172043011
"[1, 0, 0, 1, 1, 0, 0, 0, 1, 1, 1, 1, 0, 0, 1]",227,69,158,6,17,0.08695652173913043,0.10759493670886076
"[1, 1, 1, 1, 0, 0, 0, 0, 0, 1, 0, 0, 0, 1, 0]",219,124,95,10,8,0.08064516129032258,0.08421052631578947
"[0, 0, 1, 1, 0, 1, 0, 1, 0, 0, 0, 0, 0, 0, 0]",756,504,252,53,19,0.10515873015873016,0.07539682539682539
"[1, 0, 1, 1, 0, 0, 1, 1, 1, 1, 0, 0, 0, 0, 0]",412,240,172,26,15,0.10833333333333334,0.0872093023255814
"[1, 0, 0, 1, 1, 1, 0, 1, 1, 0, 0, 0, 0, 1, 0]",125,69,56,11,5,0.15942028985507245,0.08928571428571429
"[1, 1, 0, 0, 0, 0, 1, 1, 0, 0, 0, 1, 1, 0, 1]",208,109,99,9,10,0.08256880733944955,0.10101010101010101
"[0, 0, 1, 0, 1, 0, 0, 1, 1, 1, 0, 1, 1, 0, 0]",127,71,56,7,12,0.09859154929577464,0.21428571428571427
"[1, 0, 0, 0, 0, 1, 0, 0, 1, 0, 1, 0, 0, 1, 1]",201,122,79,7,7,0.05737704918032787,0.08860759493670886
"[0, 0, 1, 1, 1, 1, 1, 0, 1, 1, 1, 1, 0, 0, 1]",355,141,214,17,26,0.12056737588652482,0.12149532710280374
"[0, 1, 1, 1, 1, 1, 0, 1, 0, 1, 0, 1, 0, 1, 0]",129,51,78,3,9,0.058823529411764705,0.11538461538461539
"[0, 0, 0, 1, 0, 1, 1, 1, 1, 0, 1, 0, 0, 0, 1]",124,76,48,5,5,0.06578947368421052,0.10416666666666667
"[0, 0, 1, 1, 1, 1, 0, 0, 1, 1, 0, 1, 1, 0, 1]",280,113,167,12,14,0.10619469026548672,0.08383233532934131
"[1, 1, 0, 0, 1, 0, 1, 0, 0, 0, 1, 0, 0, 1, 1]",141,70,71,7,12,0.1,0.16901408450704225
"[1, 1, 0, 1, 1, 0, 0, 1, 0, 1, 0, 0, 0, 1, 0]",95,51,44,2,1,0.0392156862745098,0.022727272727272728
"[0, 0, 0, 0, 0, 1, 1, 0, 1, 1, 0, 0, 1, 0, 1]",195,138,57,11,2,0.07971014492753623,0.03508771929824561
"[0, 0, 1, 0, 0, 1, 1, 1, 0, 0, 1, 0, 1, 0, 0]",164,96,68,12,10,0.125,0.14705882352941177
"[1, 0, 0, 1, 0, 0, 1, 1, 1, 0, 0, 1, 0, 1, 0]",112,53,59,2,4,0.03773584905660377,0.06779661016949153
"[0, 0, 0, 0, 1, 1, 0, 1, 1, 1, 0, 1, 1, 0, 0]",127,63,64,3,7,0.047619047619047616,0.109375
"[1, 1, 0, 0, 1, 1, 1, 1, 0, 1, 0, 0, 1, 0, 1]",189,84,105,11,9,0.13095238095238096,0.08571428571428572
"[0, 0, 0, 0, 1, 0, 1, 0, 0, 1, 1, 1, 0, 0, 0]",291,192,99,16,8,0.08333333333333333,0.08080808080808081
"[0, 1, 1, 1, 0, 0, 1, 1, 0, 1, 1, 0, 1, 0, 0]",117,59,58,5,3,0.0847457627118644,0.05172413793103448
"[1, 0, 0, 0, 1, 1, 0, 0, 1, 1, 1, 0, 0, 1, 1]",177,67,110,7,7,0.1044776119402985,0.06363636363636363
"[1, 1, 1, 0, 0, 1, 1, 1, 0, 0, 0, 1, 1, 0, 0]",174,84,90,9,7,0.10714285714285714,0.07777777777777778
"[0, 0, 1, 1, 0, 1, 0, 1, 1, 1, 0, 0, 1, 1, 1]",271,107,164,15,11,0.14018691588785046,0.06707317073170732
"[1, 1, 0, 0, 1, 1, 0, 1, 0, 1, 1, 1, 0, 0, 1]",217,91,126,6,16,0.06593406593406594,0.12698412698412698
"[1, 1, 1, 0, 1, 0, 1, 0, 0, 1, 1, 1, 0, 0, 1]",164,71,93,5,13,0.07042253521126761,0.13978494623655913
"[0, 0, 1, 1, 1, 0, 0, 0, 1, 1, 0, 1, 1, 0, 1]",112,64,48,5,4,0.078125,0.08333333333333333
"[0, 0, 0, 0, 0, 1, 1, 0, 0, 1, 0, 0, 1, 0, 0]",660,498,162,45,14,0.09036144578313253,0.08641975308641975
"[1, 0, 0, 1, 0, 1, 1, 0, 0, 1, 0, 0, 1, 0, 0]",141,89,52,11,7,0.12359550561797752,0.1346153846153846
"[1, 1, 1, 0, 0, 1, 1, 1, 0, 1, 1, 0, 0, 0, 0]",194,69,125,6,14,0.08695652173913043,0.112
"[1, 0, 1, 0, 0, 1, 0, 1, 0, 1, 1, 1, 0, 1, 1]",151,59,92,6,6,0.1016949152542373,0.06521739130434782
"[0, 1, 1, 0, 1, 0, 1, 0, 0, 0, 1, 1, 0, 1, 0]",90,49,41,5,2,0.10204081632653061,0.04878048780487805
"[0, 0, 1, 0, 1, 1, 0, 1, 0, 1, 0, 0, 0, 1, 1]",136,75,61,7,5,0.09333333333333334,0.08196721311475409
"[0, 0, 1, 0, 0, 1, 0, 0, 1, 0, 1, 1, 0, 1, 0]",137,79,58,10,3,0.12658227848101267,0.05172413793103448
"[1, 1, 0, 1, 0, 0, 0, 0, 1, 0, 0, 1, 0, 0, 1]",162,94,68,7,6,0.07446808510638298,0.08823529411764706
"[1, 1, 1, 0, 1, 1, 1, 0, 1, 1, 0, 0, 1, 1, 0]",310,102,208,8,22,0.0784313725490196,0.10576923076923077
"[1, 0, 0, 1, 0, 1, 1, 0, 1, 1, 1, 0, 1, 0, 0]",100,40,60,5,1,0.125,0.016666666666666666
"[0, 1, 0, 0, 0, 1, 0, 1, 0, 1, 1, 1, 1, 1, 0]",113,55,58,7,6,0.12727272727272726,0.10344827586206896
"[0, 0, 1, 1, 1, 1, 1, 0, 1, 0, 1, 0, 0, 0, 1]",133,71,62,5,11,0.07042253521126761,0.1774193548387097
"[1, 1, 0, 1, 1, 1, 0, 1, 0, 0, 1, 1, 1, 1, 0]",295,111,184,8,15,0.07207207207207207,0.08152173913043478
"[1, 0, 0, 0, 0, 0, 1, 1, 1, 0, 1, 1, 1, 0, 1]",128,54,74,7,9,0.12962962962962962,0.12162162162162163
"[0, 1, 0, 1, 0, 1, 0, 1, 1, 1, 1, 0, 1, 1, 0]",154,69,85,7,13,0.10144927536231885,0.15294117647058825
"[1, 0, 0, 0, 0, 0, 1, 0, 1, 0, 1, 0, 1, 1, 1]",165,79,86,7,8,0.08860759493670886,0.09302325581395349
"[0, 1, 0, 1, 0, 1, 0, 0, 0, 0, 0, 1, 0, 1, 0]",198,126,72,12,4,0.09523809523809523,0.05555555555555555
"[0, 1, 0, 0, 0, 0, 1, 1, 1, 1, 1, 1, 0, 0, 1]",455,239,216,34,25,0.14225941422594143,0.11574074074074074
"[0, 0, 1, 0, 0, 0, 0, 1, 1, 1, 1, 1, 1, 0, 0]",501,275,226,25,29,0.09090909090909091,0.12831858407079647
"[1, 1, 1, 1, 1, 0, 0, 1, 1, 0, 0, 1, 0, 1, 1]",545,127,418,13,40,0.10236220472440945,0.09569377990430622
"[1, 0, 0, 1, 0, 0, 0, 0, 1, 0, 1, 0, 1, 0, 0]",233,161,72,12,8,0.07453416149068323,0.1111111111111111
"[0, 1, 1, 0, 1, 1, 0, 1, 0, 1, 0, 0, 1, 0, 0]",116,60,56,8,4,0.13333333333333333,0.07142857142857142
"[1, 0, 0, 1, 0, 0, 0, 1, 1, 0, 1, 0, 1, 0, 1]",97,58,39,7,2,0.1206896551724138,0.05128205128205128
"[0, 0, 0, 1, 0, 0, 0, 0, 0, 1, 0, 1, 1, 0, 1]",246,157,89,14,6,0.08917197452229299,0.06741573033707865
"[0, 0, 1, 0, 1, 0, 0, 1, 0, 1, 1, 1, 1, 1, 0]",123,58,65,8,10,0.13793103448275862,0.15384615384615385
"[0, 0, 0, 1, 0, 0, 0, 0, 1, 1, 0, 1, 1, 0, 1]",153,89,64,10,6,0.11235955056179775,0.09375
"[0, 0, 1, 0, 0, 1, 0, 0, 0, 1, 1, 0, 1, 0, 0]",222,151,71,10,3,0.06622516556291391,0.04225352112676056
"[0, 0, 0, 0, 1, 0, 0, 1, 0, 0, 0, 1, 1, 0, 1]",225,159,66,17,6,0.1069182389937107,0.09090909090909091
"[1, 0, 0, 0, 0, 1, 0, 0, 0, 0, 1, 0, 1, 1, 1]",244,133,111,20,10,0.15037593984962405,0.09009009009009009
"[0, 1, 0, 0, 1, 1, 0, 0, 1, 1, 0, 1, 0, 0, 0]",174,92,82,12,12,0.13043478260869565,0.14634146341463414
"[0, 1, 0, 1, 0, 0, 0, 1, 0, 0, 0, 1, 0, 0, 0]",525,360,165,29,12,0.08055555555555556,0.07272727272727272
"[0, 1, 0, 0, 0, 0, 0, 1, 1, 0, 1, 1, 1, 1, 0]",124,70,54,4,8,0.05714285714285714,0.14814814814814814
"[1, 0, 0, 0, 0, 0, 0, 0, 0, 0, 1, 1, 0, 1, 0]",668,420,248,50,17,0.11904761904761904,0.06854838709677419
"[0, 0, 0, 0, 0, 0, 0, 1, 1, 1, 0, 0, 0, 0, 1]",998,763,235,77,20,0.10091743119266056,0.0851063829787234
"[1, 0, 1, 0, 1, 1, 0, 0, 1, 0, 1, 1, 1, 1, 0]",143,60,83,2,8,0.03333333333333333,0.0963855421686747
"[0, 0, 0, 0, 0, 0, 0, 0, 1, 1, 0, 1, 1, 0, 1]",401,264,137,24,9,0.09090909090909091,0.06569343065693431
"[1, 0, 1, 1, 0, 0, 0, 0, 1, 1, 1, 1, 1, 1, 1]",920,344,576,38,59,0.11046511627906977,0.10243055555555555
"[1, 0, 0, 0, 1, 0, 0, 1, 1, 1, 1, 1, 1, 1, 0]",216,84,132,8,12,0.09523809523809523,0.09090909090909091
"[1, 1, 1, 1, 0, 0, 0, 0, 0, 1, 1, 1, 1, 0, 0]",343,165,178,19,11,0.11515151515151516,0.06179775280898876
"[1, 1, 1, 1, 1, 0, 0, 0, 0, 0, 1, 1, 1, 1, 0]",323,115,208,10,20,0.08695652173913043,0.09615384615384616
"[1, 0, 0, 0, 1, 1, 0, 0, 1, 1, 1, 0, 0, 0, 1]",126,61,65,8,7,0.13114754098360656,0.1076923076923077
"[0, 1, 0, 1, 0, 0, 0, 1, 1, 0, 0, 1, 1, 1, 0]",119,72,47,8,2,0.1111111111111111,0.0425531914893617
"[1, 1, 1, 1, 0, 1, 0, 0, 1, 1, 0, 0, 0, 0, 0]",242,119,123,12,12,0.10084033613445378,0.0975609756097561
"[0, 0, 0, 1, 1, 1, 1, 1, 0, 0, 1, 0, 0, 1, 0]",127,64,63,9,8,0.140625,0.12698412698412698
"[1, 0, 1, 1, 0, 0, 0, 0, 0, 1, 0, 0, 1, 0, 1]",160,102,58,10,5,0.09803921568627451,0.08620689655172414
"[0, 0, 1, 0, 0, 1, 0, 1, 1, 0, 0, 0, 0, 0, 1]",258,170,88,10,13,0.058823529411764705,0.14772727272727273
"[1, 0, 0, 0, 0, 1, 0, 1, 0, 1, 0, 1, 1, 1, 0]",121,63,58,4,6,0.06349206349206349,0.10344827586206896
"[1, 0, 1, 0, 0, 0, 1, 1, 1, 0, 0, 1, 0, 1, 0]",122,63,59,5,5,0.07936507936507936,0.0847457627118644
"[0, 1, 0, 0, 0, 1, 0, 0, 1, 0, 0, 0, 1, 0, 1]",220,146,74,17,9,0.11643835616438356,0.12162162162162163
"[1, 0, 1, 0, 0, 0, 1, 0, 0, 1, 0, 0, 0, 1, 0]",209,133,76,15,7,0.11278195488721804,0.09210526315789473
"[0, 0, 0, 0, 1, 1, 1, 0, 0, 0, 0, 0, 0, 0, 1]",820,580,240,39,23,0.06724137931034482,0.09583333333333334
"[0, 1, 0, 1, 1, 1, 0, 1, 0, 1, 1, 1, 0, 1, 0]",104,33,71,1,7,0.030303030303030304,0.09859154929577464
"[0, 0, 1, 1, 1, 0, 1, 1, 1, 1, 1, 0, 0, 0, 1]",171,81,90,10,8,0.12345679012345678,0.08888888888888889
"[1, 1, 0, 1, 0, 0, 0, 1, 1, 0, 1, 1, 0, 0, 0]",128,70,58,8,6,0.11428571428571428,0.10344827586206896
"[0, 1, 1, 0, 1, 0, 0, 0, 1, 1, 0, 1, 1, 0, 0]",126,58,68,5,9,0.08620689655172414,0.1323529411764706
"[0, 0, 0, 0, 0, 1, 0, 0, 1, 0, 1, 0, 1, 1, 1]",254,169,85,12,8,0.07100591715976332,0.09411764705882353
"[1, 0, 0, 0, 0, 0, 0, 0, 1, 0, 0, 1, 0, 1, 0]",528,350,178,32,12,0.09142857142857143,0.06741573033707865
"[0, 0, 1, 1, 1, 1, 0, 1, 0, 0, 1, 1, 0, 1, 1]",184,75,109,5,9,0.06666666666666667,0.08256880733944955
"[0, 0, 1, 1, 1, 1, 0, 0, 0, 0, 0, 1, 0, 0, 1]",320,198,122,12,14,0.06060606060606061,0.11475409836065574
"[1, 0, 0, 1, 1, 1, 1, 0, 0, 0, 0, 0, 1, 0, 0]",279,109,170,7,18,0.06422018348623854,0.10588235294117647
"[1, 0, 0, 1, 1, 0, 1, 0, 1, 1, 0, 0, 1, 1, 1]",242,97,145,10,11,0.10309278350515463,0.07586206896551724
"[0, 1, 1, 1, 0, 0, 1, 1, 0, 1, 0, 0, 1, 1, 0]",123,59,64,6,5,0.1016949152542373,0.078125
"[0, 0, 0, 0, 1, 0, 1, 1, 0, 0, 0, 0, 1, 1, 0]",441,295,146,29,17,0.09830508474576272,0.11643835616438356
"[1, 1, 1, 1, 0, 0, 1, 0, 1, 0, 0, 0, 0, 1, 1]",164,75,89,10,11,0.13333333333333333,0.12359550561797752
"[1, 1, 0, 0, 0, 0, 1, 1, 1, 1, 1, 0, 0, 1, 0]",189,101,88,15,11,0.1485148514851485,0.125
"[1, 1, 0, 1, 1, 1, 0, 0, 1, 1, 1, 0, 0, 0, 0]",160,79,81,10,6,0.12658227848101267,0.07407407407407407
"[0, 1, 0, 1, 1, 1, 0, 0, 0, 0, 0, 1, 1, 0, 1]",117,63,54,6,5,0.09523809523809523,0.09259259259259259
"[0, 1, 0, 0, 0, 0, 1, 1, 0, 1, 0, 1, 0, 0, 1]",150,98,52,7,4,0.07142857142857142,0.07692307692307693
"[1, 1, 1, 0, 1, 0, 1, 0, 0, 0, 1, 1, 0, 0, 1]",135,55,80,3,9,0.05454545454545454,0.1125
"[1, 1, 0, 0, 1, 0, 1, 1, 1, 0, 0, 0, 0, 0, 0]",261,142,119,13,15,0.09154929577464789,0.12605042016806722
"[1, 0, 0, 1, 1, 0, 0, 1, 1, 1, 0, 1, 0, 0, 1]",197,64,133,8,11,0.125,0.08270676691729323
"[0, 0, 1, 0, 1, 1, 0, 0, 1, 1, 1, 1, 1, 1, 1]",563,233,330,29,31,0.12446351931330472,0.09393939393939393
"[0, 1, 1, 0, 0, 0, 0, 1, 1, 0, 0, 1, 0, 1, 1]",273,199,74,15,9,0.07537688442211055,0.12162162162162163
"[1, 0, 1, 1, 0, 0, 0, 0, 1, 1, 0, 0, 1, 0, 1]",139,64,75,5,6,0.078125,0.08
"[1, 0, 1, 0, 1, 0, 0, 1, 0, 1, 1, 0, 1, 0, 0]",111,63,48,5,4,0.07936507936507936,0.08333333333333333
"[1, 1, 0, 1, 0, 1, 0, 0, 1, 0, 1, 1, 0, 1, 0]",92,44,48,8,5,0.18181818181818182,0.10416666666666667
"[0, 1, 1, 1, 1, 0, 1, 0, 1, 0, 0, 1, 0, 1, 1]",156,74,82,6,9,0.08108108108108109,0.10975609756097561
"[0, 0, 1, 0, 0, 1, 1, 1, 1, 0, 1, 0, 1, 0, 0]",124,64,60,6,7,0.09375,0.11666666666666667
"[1, 1, 1, 0, 0, 0, 1, 1, 0, 1, 1, 1, 0, 0, 1]",198,74,124,11,15,0.14864864864864866,0.12096774193548387
"[0, 1, 1, 0, 0, 0, 0, 1, 0, 0, 0, 1, 1, 0, 0]",348,229,119,17,15,0.07423580786026202,0.12605042016806722
"[0, 0, 0, 1, 0, 1, 1, 1, 1, 0, 1, 1, 0, 0, 0]",119,71,48,5,4,0.07042253521126761,0.08333333333333333
"[0, 0, 0, 0, 1, 0, 1, 1, 1, 1, 0, 1, 1, 0, 0]",134,68,66,7,4,0.10294117647058823,0.06060606060606061
"[1, 1, 1, 0, 0, 0, 0, 0, 0, 1, 1, 1, 0, 1, 0]",238,72,166,7,17,0.09722222222222222,0.10240963855421686
"[1, 0, 0, 0, 0, 0, 0, 1, 0, 0, 1, 0, 1, 1, 0]",243,143,100,7,12,0.04895104895104895,0.12
"[1, 0, 1, 0, 0, 0, 0, 0, 0, 1, 0, 0, 1, 0, 1]",239,161,78,19,6,0.11801242236024845,0.07692307692307693
"[1, 1, 0, 1, 0, 0, 0, 0, 0, 0, 1, 0, 0, 1, 0]",207,120,87,16,10,0.13333333333333333,0.11494252873563218
"[1, 1, 1, 0, 1, 0, 0, 0, 0, 0, 0, 1, 0, 0, 1]",150,82,68,9,8,0.10975609756097561,0.11764705882352941
"[0, 0, 0, 0, 1, 0, 0, 1, 1, 0, 1, 1, 1, 1, 0]",133,78,55,9,7,0.11538461538461539,0.12727272727272726
"[0, 0, 1, 1, 1, 0, 1, 1, 0, 1, 1, 0, 1, 0, 0]",125,67,58,7,6,0.1044776119402985,0.10344827586206896
"[1, 1, 1, 1, 0, 0, 0, 1, 0, 1, 1, 0, 0, 1, 1]",241,96,145,8,15,0.08333333333333333,0.10344827586206896
"[1, 0, 0, 1, 0, 1, 1, 0, 0, 1, 1, 1, 1, 0, 0]",249,113,136,14,10,0.12389380530973451,0.07352941176470588
"[0, 0, 1, 1, 0, 1, 0, 1, 0, 0, 1, 0, 0, 0, 0]",270,176,94,11,12,0.0625,0.1276595744680851
"[0, 0, 0, 0, 0, 0, 0, 1, 1, 0, 1, 1, 1, 1, 1]",395,275,120,24,11,0.08727272727272728,0.09166666666666666
"[0, 1, 0, 1, 0, 0, 0, 0, 0, 0, 1, 1, 1, 1, 0]",382,246,136,25,11,0.1016260162601626,0.08088235294117647
"[0, 0, 0, 1, 0, 1, 0, 0, 1, 0, 0, 1, 1, 1, 0]",156,91,65,8,4,0.08791208791208792,0.06153846153846154
"[0, 1, 0, 1, 0, 1, 0, 1, 1, 1, 0, 1, 1, 0, 1]",129,57,72,9,13,0.15789473684210525,0.18055555555555555
"[0, 1, 1, 0, 0, 1, 1, 0, 0, 1, 0, 1, 1, 1, 0]",137,81,56,8,7,0.09876543209876543,0.125
"[1, 1, 1, 0, 1, 1, 1, 1, 0, 0, 0, 0, 0, 1, 1]",268,103,165,5,15,0.04854368932038835,0.09090909090909091
"[1, 0, 0, 0, 0, 0, 0, 1, 0, 1, 1, 0, 0, 1, 1]",231,111,120,8,11,0.07207207207207207,0.09166666666666666
"[1, 0, 1, 1, 0, 0, 1, 0, 0, 1, 1, 0, 1, 1, 0]",109,47,62,4,5,0.0851063829787234,0.08064516129032258
"[0, 0, 0, 0, 1, 1, 0, 1, 0, 0, 1, 0, 0, 1, 0]",261,173,88,10,6,0.057803468208092484,0.06818181818181818
"[0, 1, 0, 1, 1, 1, 1, 1, 0, 0, 0, 0, 0, 1, 0]",140,79,61,7,3,0.08860759493670886,0.04918032786885246
"[1, 0, 0, 0, 1, 0, 0, 1, 0, 0, 1, 1, 1, 0, 1]",104,50,54,2,10,0.04,0.18518518518518517
"[1, 1, 1, 1, 1, 1, 1, 0, 0, 0, 1, 1, 1, 0, 1]",704,141,563,13,51,0.09219858156028368,0.0905861456483126
"[0, 1, 1, 0, 0, 1, 0, 1, 1, 1, 0, 0, 0, 0, 1]",147,82,65,7,6,0.08536585365853659,0.09230769230769231
"[1, 0, 0, 0, 1, 1, 0, 1, 1, 1, 1, 0, 0, 0, 1]",133,59,74,3,4,0.05084745762711865,0.05405405405405406
"[1, 0, 0, 1, 1, 0, 0, 0, 1, 0, 1, 0, 1, 1, 0]",133,63,70,7,7,0.1111111111111111,0.1
"[0, 1, 0, 0, 0, 0, 0, 1, 1, 0, 0, 0, 1, 1, 0]",321,214,107,32,12,0.14953271028037382,0.11214953271028037
"[0, 0, 1, 0, 0, 1, 1, 1, 1, 1, 1, 1, 0, 1, 0]",175,80,95,9,7,0.1125,0.07368421052631578
"[1, 1, 0, 1, 0, 1, 1, 0, 0, 0, 1, 0, 1, 1, 0]",134,62,72,7,2,0.11290322580645161,0.027777777777777776
"[1, 1, 1, 1, 0, 0, 0, 1, 0, 0, 1, 0, 0, 0, 1]",154,83,71,14,4,0.1686746987951807,0.056338028169014086
"[0, 1, 1, 1, 1, 1, 1, 1, 0, 0, 0, 1, 0, 0, 1]",179,91,88,9,10,0.0989010989010989,0.11363636363636363
"[0, 1, 1, 0, 0, 1, 1, 0, 0, 0, 0, 1, 1, 1, 0]",345,265,80,23,8,0.08679245283018867,0.1
"[0, 1, 0, 1, 1, 1, 1, 1, 1, 1, 0, 1, 1, 0, 0]",263,96,167,9,20,0.09375,0.11976047904191617
"[1, 0, 0, 1, 0, 0, 0, 1, 0, 1, 1, 1, 1, 1, 1]",227,91,136,6,18,0.06593406593406594,0.1323529411764706
"[1, 0, 1, 1, 0, 1, 1, 1, 1, 0, 0, 0, 0, 0, 0]",288,144,144,10,6,0.06944444444444445,0.041666666666666664
"[0, 0, 1, 0, 0, 0, 1, 0, 1, 0, 1, 0, 1, 0, 1]",121,74,47,5,4,0.06756756756756757,0.0851063829787234
"[0, 0, 1, 1, 1, 1, 1, 0, 0, 1, 0, 1, 0, 1, 1]",175,74,101,11,9,0.14864864864864866,0.0891089108910891
"[0, 0, 0, 0, 0, 1, 1, 1, 1, 1, 0, 0, 1, 0, 1]",216,136,80,15,6,0.11029411764705882,0.075
"[0, 1, 1, 1, 1, 1, 0, 1, 0, 1, 0, 0, 0, 0, 0]",147,76,71,5,4,0.06578947368421052,0.056338028169014086
"[0, 0, 1, 1, 1, 1, 0, 0, 1, 1, 1, 1, 1, 0, 0]",461,190,271,16,25,0.08421052631578947,0.09225092250922509
"[0, 0, 1, 1, 1, 0, 0, 0, 1, 1, 1, 0, 1, 1, 1]",175,76,99,5,8,0.06578947368421052,0.08080808080808081
"[0, 1, 1, 1, 0, 0, 0, 0, 0, 0, 1, 0, 1, 0, 1]",152,99,53,8,6,0.08080808080808081,0.11320754716981132
"[1, 1, 1, 1, 1, 1, 0, 1, 1, 0, 0, 1, 0, 1, 0]",249,79,170,8,25,0.10126582278481013,0.14705882352941177
"[1, 1, 1, 0, 0, 1, 1, 0, 0, 0, 0, 1, 1, 0, 1]",373,80,293,8,40,0.1,0.13651877133105803
"[0, 1, 1, 0, 1, 0, 1, 1, 1, 0, 0, 1, 0, 1, 1]",160,57,103,4,12,0.07017543859649122,0.11650485436893204
"[1, 0, 0, 1, 1, 1, 0, 0, 1, 1, 1, 0, 0, 1, 0]",135,61,74,8,0,0.13114754098360656,0.0
"[1, 1, 1, 0, 1, 1, 1, 1, 1, 1, 0, 1, 0, 0, 1]",570,166,404,14,42,0.08433734939759036,0.10396039603960396
"[1, 1, 1, 0, 1, 1, 0, 0, 1, 1, 0, 0, 0, 0, 0]",307,163,144,21,21,0.12883435582822086,0.14583333333333334
"[0, 1, 0, 1, 1, 1, 0, 1, 0, 1, 1, 1, 1, 1, 0]",228,75,153,7,12,0.09333333333333334,0.0784313725490196
"[0, 0, 0, 1, 0, 1, 1, 0, 0, 1, 0, 1, 0, 1, 1]",116,56,60,4,4,0.07142857142857142,0.06666666666666667
"[1, 0, 1, 1, 0, 0, 0, 0, 1, 1, 0, 0, 0, 0, 0]",710,450,260,36,26,0.08,0.1
"[0, 1, 1, 0, 0, 1, 1, 0, 1, 1, 0, 1, 1, 0, 0]",160,94,66,9,8,0.09574468085106383,0.12121212121212122
"[1, 1, 0, 1, 0, 0, 0, 0, 1, 1, 0, 1, 1, 1, 1]",172,82,90,14,11,0.17073170731707318,0.12222222222222222
"[0, 1, 0, 1, 0, 0, 1, 1, 1, 0, 1, 0, 0, 1, 0]",91,50,41,2,4,0.04,0.0975609756097561
"[1, 1, 1, 0, 1, 1, 1, 0, 0, 0, 1, 0, 1, 0, 1]",130,45,85,1,9,0.022222222222222223,0.10588235294117647
"[1, 1, 0, 0, 1, 1, 1, 0, 1, 1, 1, 0, 0, 0, 1]",198,69,129,4,12,0.057971014492753624,0.09302325581395349
"[1, 0, 1, 1, 0, 0, 1, 1, 0, 1, 0, 0, 0, 0, 0]",168,108,60,9,6,0.08333333333333333,0.1
"[1, 0, 1, 1, 0, 0, 1, 0, 1, 0, 1, 1, 1, 1, 0]",160,63,97,9,9,0.14285714285714285,0.09278350515463918
"[0, 1, 1, 0, 1, 1, 1, 0, 0, 1, 0, 1, 1, 1, 1]",274,99,175,7,27,0.0707070707070707,0.15428571428571428
"[1, 1, 0, 1, 1, 1, 1, 0, 1, 0, 1, 0, 0, 0, 0]",123,55,68,5,5,0.09090909090909091,0.07352941176470588
"[0, 1, 0, 0, 0, 1, 1, 0, 1, 0, 1, 0, 0, 0, 1]",102,62,40,9,5,0.14516129032258066,0.125
"[0, 0, 0, 1, 0, 1, 0, 1, 0, 0, 1, 0, 1, 0, 1]",138,86,52,11,4,0.12790697674418605,0.07692307692307693
"[0, 1, 1, 1, 0, 1, 1, 0, 0, 1, 1, 0, 1, 1, 1]",285,107,178,18,15,0.16822429906542055,0.08426966292134831
"[0, 0, 0, 0, 0, 0, 1, 0, 1, 0, 0, 0, 1, 0, 1]",570,429,141,47,14,0.10955710955710955,0.09929078014184398
"[0, 1, 1, 1, 1, 1, 1, 0, 1, 1, 1, 1, 0, 1, 0]",538,177,361,19,34,0.10734463276836158,0.09418282548476455
"[1, 1, 0, 1, 1, 0, 0, 0, 1, 1, 1, 0, 0, 0, 0]",155,85,70,8,6,0.09411764705882353,0.08571428571428572
"[0, 1, 1, 0, 1, 1, 0, 0, 1, 0, 0, 0, 1, 0, 0]",146,85,61,8,12,0.09411764705882353,0.19672131147540983
"[0, 1, 0, 1, 0, 0, 1, 0, 0, 0, 1, 0, 0, 0, 1]",225,149,76,14,11,0.09395973154362416,0.14473684210526316
"[0, 1, 1, 0, 1, 0, 1, 0, 1, 1, 1, 0, 1, 0, 0]",88,40,48,3,3,0.075,0.0625
"[1, 1, 0, 0, 0, 0, 0, 1, 1, 0, 1, 0, 1, 0, 1]",122,64,58,5,3,0.078125,0.05172413793103448
"[0, 1, 1, 1, 1, 0, 0, 0, 0, 0, 1, 1, 0, 1, 0]",142,87,55,8,6,0.09195402298850575,0.10909090909090909
"[1, 1, 0, 1, 0, 0, 1, 0, 1, 1, 0, 0, 1, 1, 0]",133,56,77,3,9,0.05357142857142857,0.11688311688311688
"[0, 1, 1, 0, 1, 0, 0, 1, 0, 1, 1, 0, 0, 1, 1]",149,67,82,5,12,0.07462686567164178,0.14634146341463414
"[1, 0, 1, 0, 1, 0, 1, 1, 0, 0, 0, 0, 0, 0, 1]",215,125,90,8,11,0.064,0.12222222222222222
"[1, 1, 0, 1, 1, 0, 0, 1, 1, 0, 0, 1, 0, 1, 0]",101,47,54,4,4,0.0851063829787234,0.07407407407407407
"[1, 0, 0, 0, 0, 0, 0, 0, 1, 0, 1, 1, 1, 0, 1]",177,95,82,7,11,0.07368421052631578,0.13414634146341464
"[1, 1, 0, 0, 1, 1, 1, 0, 0, 0, 0, 1, 0, 0, 0]",156,101,55,5,3,0.04950495049504951,0.05454545454545454
"[0, 0, 1, 0, 1, 0, 0, 1, 1, 0, 1, 1, 1, 1, 0]",111,52,59,8,4,0.15384615384615385,0.06779661016949153
"[1, 0, 0, 0, 0, 1, 0, 1, 0, 0, 1, 1, 0, 1, 1]",124,52,72,5,4,0.09615384615384616,0.05555555555555555
"[1, 0, 1, 1, 0, 1, 1, 0, 0, 0, 1, 0, 0, 1, 1]",126,60,66,2,8,0.03333333333333333,0.12121212121212122
"[1, 1, 1, 0, 0, 1, 0, 1, 0, 1, 1, 0, 1, 1, 0]",156,52,104,2,8,0.038461538461538464,0.07692307692307693
"[0, 0, 0, 0, 1, 0, 1, 1, 1, 0, 0, 1, 1, 0, 1]",105,59,46,11,5,0.1864406779661017,0.10869565217391304
"[1, 0, 0, 1, 0, 1, 1, 0, 0, 1, 1, 1, 0, 1, 1]",171,64,107,7,12,0.109375,0.11214953271028037
"[1, 0, 1, 1, 1, 1, 1, 1, 1, 1, 0, 1, 0, 1, 0]",539,178,361,20,31,0.11235955056179775,0.08587257617728532
"[1, 1, 1, 0, 0, 0, 1, 1, 1, 1, 0, 1, 1, 1, 1]",722,209,513,27,49,0.1291866028708134,0.09551656920077972
"[0, 1, 0, 1, 0, 1, 0, 0, 0, 0, 1, 0, 0, 0, 1]",258,163,95,18,4,0.11042944785276074,0.042105263157894736
"[0, 0, 0, 1, 0, 1, 0, 1, 0, 0, 0, 0, 1, 0, 0]",494,345,149,21,15,0.06086956521739131,0.10067114093959731
"[0, 1, 1, 1, 1, 1, 0, 0, 0, 1, 0, 1, 0, 0, 0]",127,67,60,7,5,0.1044776119402985,0.08333333333333333
"[1, 1, 0, 1, 0, 1, 1, 0, 1, 1, 0, 1, 0, 0, 0]",114,50,64,4,6,0.08,0.09375
"[0, 1, 0, 1, 0, 0, 0, 1, 1, 1, 0, 0, 1, 1, 1]",176,93,83,6,5,0.06451612903225806,0.060240963855421686
"[1, 1, 1, 1, 1, 0, 1, 1, 1, 1, 0, 0, 1, 0, 0]",270,100,170,8,10,0.08,0.058823529411764705
"[0, 0, 0, 0, 1, 1, 1, 1, 0, 1, 0, 0, 0, 1, 0]",171,108,63,8,6,0.07407407407407407,0.09523809523809523
"[0, 1, 0, 1, 1, 0, 0, 0, 0, 1, 0, 1, 1, 0, 1]",93,53,40,7,4,0.1320754716981132,0.1
"[0, 0, 1, 0, 1, 1, 0, 0, 1, 1, 0, 0, 1, 0, 0]",159,84,75,6,8,0.07142857142857142,0.10666666666666667
"[1, 1, 1, 0, 1, 0, 1, 0, 0, 1, 1, 1, 0, 1, 0]",134,53,81,4,6,0.07547169811320754,0.07407407407407407
"[0, 1, 1, 0, 0, 0, 1, 1, 1, 0, 0, 0, 1, 0, 1]",125,83,42,12,2,0.14457831325301204,0.047619047619047616
"[0, 0, 1, 0, 1, 0, 0, 1, 1, 1, 0, 0, 1, 0, 0]",152,95,57,9,4,0.09473684210526316,0.07017543859649122
"[1, 1, 0, 0, 0, 0, 0, 0, 1, 0, 1, 1, 1, 1, 0]",189,96,93,5,13,0.052083333333333336,0.13978494623655913
"[0, 1, 1, 1, 0, 0, 1, 1, 1, 1, 0, 0, 0, 0, 1]",450,205,245,18,32,0.08780487804878048,0.1306122448979592
"[1, 1, 0, 1, 0, 0, 0, 0, 1, 1, 1, 0, 1, 1, 0]",103,53,50,10,7,0.18867924528301888,0.14
"[1, 1, 1, 0, 1, 1, 1, 0, 0, 1, 1, 0, 0, 1, 0]",164,65,99,6,9,0.09230769230769231,0.09090909090909091
"[1, 1, 0, 0, 0, 0, 0, 1, 0, 1, 1, 0, 0, 0, 1]",170,102,68,10,2,0.09803921568627451,0.029411764705882353
"[1, 1, 1, 1, 0, 0, 1, 0, 0, 0, 0, 0, 1, 1, 0]",190,95,95,6,10,0.06315789473684211,0.10526315789473684
"[1, 1, 1, 1, 0, 0, 1, 0, 1, 1, 1, 1, 0, 0, 1]",381,133,248,12,20,0.09022556390977443,0.08064516129032258
"[1, 1, 0, 0, 0, 0, 1, 0, 0, 1, 0, 0, 1, 0, 1]",178,116,62,11,4,0.09482758620689655,0.06451612903225806
"[0, 0, 0, 0, 0, 1, 0, 0, 1, 1, 1, 1, 0, 0, 1]",294,190,104,13,8,0.06842105263157895,0.07692307692307693
"[1, 1, 0, 1, 1, 1, 0, 0, 1, 0, 1, 0, 0, 0, 0]",141,68,73,7,7,0.10294117647058823,0.0958904109589041
"[1, 0, 0, 1, 1, 1, 0, 0, 1, 0, 0, 1, 0, 0, 1]",137,60,77,7,10,0.11666666666666667,0.12987012987012986
"[1, 1, 0, 1, 1, 0, 0, 1, 1, 0, 1, 1, 1, 1, 0]",272,91,181,10,19,0.10989010989010989,0.10497237569060773
"[1, 0, 0, 0, 1, 0, 1, 1, 1, 0, 1, 1, 1, 1, 1]",314,111,203,7,23,0.06306306306306306,0.11330049261083744
"[1, 0, 1, 0, 0, 0, 1, 1, 1, 1, 1, 0, 0, 1, 1]",235,96,139,9,15,0.09375,0.1079136690647482
"[1, 0, 0, 1, 0, 1, 0, 0, 1, 1, 0, 1, 0, 0, 0]",133,71,62,5,6,0.07042253521126761,0.0967741935483871
"[0, 1, 0, 1, 0, 0, 1, 1, 0, 1, 1, 1, 1, 1, 0]",158,89,69,6,5,0.06741573033707865,0.07246376811594203
"[1, 1, 0, 0, 0, 1, 0, 1, 0, 0, 0, 0, 0, 1, 0]",227,140,87,14,7,0.1,0.08045977011494253
"[1, 0, 0, 1, 0, 1, 0, 1, 1, 1, 1, 0, 0, 0, 0]",189,90,99,10,12,0.1111111111111111,0.12121212121212122
"[0, 1, 1, 0, 0, 1, 0, 1, 0, 1, 1, 1, 1, 0, 0]",152,83,69,7,6,0.08433734939759036,0.08695652173913043
"[0, 1, 0, 0, 0, 0, 1, 1, 0, 0, 1, 0, 1, 0, 1]",164,97,67,12,4,0.12371134020618557,0.05970149253731343
"[0, 1, 0, 1, 1, 1, 1, 0, 1, 1, 0, 0, 0, 0, 1]",145,65,80,3,7,0.046153846153846156,0.0875
"[1, 1, 0, 0, 1, 0, 1, 1, 1, 0, 0, 0, 1, 0, 0]",111,58,53,8,3,0.13793103448275862,0.05660377358490566
"[0, 0, 0, 0, 1, 0, 0, 1, 0, 1, 1, 1, 0, 1, 1]",123,65,58,9,4,0.13846153846153847,0.06896551724137931
"[1, 0, 0, 0, 1, 0, 1, 1, 1, 0, 0, 1, 0, 0, 1]",114,54,60,5,5,0.09259259259259259,0.08333333333333333
"[0, 0, 0, 1, 1, 0, 0, 0, 1, 1, 1, 1, 0, 1, 0]",130,85,45,5,4,0.058823529411764705,0.08888888888888889
"[0, 0, 0, 1, 1, 1, 0, 1, 0, 0, 1, 1, 1, 0, 1]",125,76,49,6,5,0.07894736842105263,0.10204081632653061
"[0, 1, 1, 1, 0, 0, 0, 1, 0, 1, 0, 0, 0, 1, 0]",140,77,63,10,4,0.12987012987012986,0.06349206349206349
"[0, 1, 1, 1, 0, 1, 1, 1, 1, 0, 0, 1, 0, 1, 1]",254,112,142,8,16,0.07142857142857142,0.11267605633802817
"[1, 1, 0, 1, 1, 0, 1, 1, 0, 0, 0, 1, 1, 1, 1]",365,133,232,13,18,0.09774436090225563,0.07758620689655173
"[1, 0, 1, 1, 0, 1, 1, 0, 1, 1, 0, 0, 0, 1, 1]",178,79,99,8,7,0.10126582278481013,0.0707070707070707
"[1, 0, 0, 0, 0, 1, 0, 1, 0, 1, 1, 0, 0, 1, 0]",133,70,63,8,4,0.11428571428571428,0.06349206349206349
"[1, 1, 1, 0, 0, 1, 0, 1, 1, 1, 1, 0, 1, 0, 1]",251,63,188,5,13,0.07936507936507936,0.06914893617021277
"[0, 0, 1, 0, 1, 1, 0, 1, 1, 1, 1, 0, 0, 1, 0]",133,67,66,9,5,0.13432835820895522,0.07575757575757576
"[1, 0, 0, 1, 0, 0, 0, 1, 1, 0, 0, 0, 1, 1, 1]",201,102,99,10,11,0.09803921568627451,0.1111111111111111
"[0, 1, 1, 0, 1, 1, 1, 0, 0, 1, 0, 1, 0, 1, 0]",126,65,61,5,4,0.07692307692307693,0.06557377049180328
"[1, 0, 0, 1, 0, 0, 0, 0, 0, 1, 1, 0, 1, 1, 0]",182,93,89,5,7,0.053763440860215055,0.07865168539325842
"[1, 1, 1, 0, 1, 0, 1, 1, 0, 0, 1, 0, 0, 0, 0]",129,63,66,9,7,0.14285714285714285,0.10606060606060606
"[0, 1, 0, 0, 0, 1, 0, 0, 0, 0, 0, 1, 0, 1, 1]",280,183,97,19,8,0.10382513661202186,0.08247422680412371
"[1, 0, 0, 1, 0, 0, 1, 1, 0, 0, 0, 0, 0, 1, 1]",221,130,91,18,8,0.13846153846153847,0.08791208791208792
"[1, 1, 0, 1, 0, 1, 1, 0, 1, 1, 0, 1, 1, 1, 1]",577,160,417,18,40,0.1125,0.09592326139088729
"[0, 0, 1, 0, 1, 0, 0, 0, 0, 0, 0, 1, 0, 1, 0]",519,364,155,27,13,0.07417582417582418,0.08387096774193549
"[1, 0, 0, 1, 0, 1, 0, 0, 0, 0, 0, 0, 1, 0, 1]",224,152,72,12,4,0.07894736842105263,0.05555555555555555
"[0, 0, 0, 0, 1, 1, 0, 1, 1, 0, 1, 1, 1, 0, 1]",120,63,57,8,6,0.12698412698412698,0.10526315789473684
"[0, 0, 1, 0, 1, 0, 0, 0, 0, 0, 1, 0, 1, 1, 0]",252,168,84,21,6,0.125,0.07142857142857142
"[0, 1, 1, 1, 0, 1, 0, 0, 0, 0, 1, 1, 0, 1, 1]",117,56,61,5,5,0.08928571428571429,0.08196721311475409
"[1, 0, 0, 0, 0, 0, 0, 1, 0, 1, 1, 1, 0, 0, 1]",185,93,92,8,9,0.08602150537634409,0.09782608695652174
"[0, 1, 1, 1, 0, 1, 0, 1, 1, 0, 0, 1, 1, 1, 1]",395,176,219,20,24,0.11363636363636363,0.1095890410958904
"[0, 0, 1, 1, 1, 1, 0, 0, 1, 0, 0, 1, 1, 0, 0]",179,94,85,4,3,0.0425531914893617,0.03529411764705882
"[0, 1, 0, 1, 0, 1, 1, 1, 0, 1, 1, 0, 0, 0, 0]",122,68,54,5,8,0.07352941176470588,0.14814814814814814
"[1, 1, 1, 1, 1, 0, 0, 0, 0, 1, 1, 0, 0, 1, 0]",344,89,255,9,29,0.10112359550561797,0.11372549019607843
"[0, 1, 0, 1, 0, 1, 0, 1, 0, 1, 0, 1, 0, 0, 0]",143,89,54,9,7,0.10112359550561797,0.12962962962962962
"[0, 0, 1, 0, 1, 0, 1, 0, 0, 0, 0, 0, 1, 0, 1]",209,140,69,10,5,0.07142857142857142,0.07246376811594203
"[1, 0, 1, 1, 0, 1, 0, 0, 1, 0, 0, 0, 1, 0, 0]",153,97,56,5,7,0.05154639175257732,0.125
"[0, 0, 0, 1, 1, 0, 0, 1, 0, 0, 1, 0, 1, 1, 0]",156,98,58,9,2,0.09183673469387756,0.034482758620689655
"[0, 0, 1, 0, 0, 0, 1, 1, 0, 0, 1, 0, 0, 1, 0]",204,136,68,8,8,0.058823529411764705,0.11764705882352941
"[0, 0, 1, 1, 0, 1, 1, 1, 1, 1, 1, 1, 1, 0, 0]",544,211,333,14,27,0.06635071090047394,0.08108108108108109
"[0, 0, 1, 0, 1, 1, 1, 0, 0, 0, 0, 0, 0, 0, 1]",320,204,116,27,16,0.1323529411764706,0.13793103448275862
"[0, 0, 1, 0, 1, 1, 0, 0, 1, 1, 1, 1, 0, 1, 1]",170,81,89,7,4,0.08641975308641975,0.0449438202247191
"[0, 0, 0, 1, 0, 0, 1, 0, 1, 1, 0, 0, 0, 0, 1]",278,174,104,12,10,0.06896551724137931,0.09615384615384616
"[0, 0, 0, 1, 0, 1, 1, 1, 0, 1, 0, 0, 0, 1, 0]",126,79,47,10,3,0.12658227848101267,0.06382978723404255
"[1, 0, 1, 0, 1, 0, 1, 0, 1, 0, 0, 0, 1, 0, 1]",104,53,51,3,6,0.05660377358490566,0.11764705882352941
"[0, 0, 1, 0, 1, 0, 1, 0, 0, 0, 0, 0, 1, 1, 1]",262,150,112,11,6,0.07333333333333333,0.05357142857142857
"[1, 0, 0, 0, 1, 0, 0, 0, 1, 1, 0, 0, 1, 0, 1]",142,87,55,13,3,0.14942528735632185,0.05454545454545454
"[0, 0, 1, 0, 0, 1, 0, 1, 1, 0, 0, 0, 1, 1, 0]",168,104,64,15,6,0.14423076923076922,0.09375
"[0, 1, 0, 1, 1, 1, 1, 1, 1, 0, 0, 1, 0, 1, 1]",262,100,162,5,18,0.05,0.1111111111111111
"[1, 1, 1, 1, 1, 0, 1, 1, 1, 0, 0, 1, 0, 1, 0]",211,75,136,3,10,0.04,0.07352941176470588
"[1, 0, 0, 1, 0, 0, 0, 1, 1, 0, 0, 1, 0, 0, 1]",138,78,60,11,5,0.14102564102564102,0.08333333333333333
"[1, 1, 0, 0, 1, 0, 1, 1, 1, 0, 0, 1, 1, 1, 0]",140,50,90,5,7,0.1,0.07777777777777778
"[0, 1, 1, 0, 0, 1, 0, 1, 0, 0, 0, 1, 0, 1, 0]",115,63,52,4,2,0.06349206349206349,0.038461538461538464
"[0, 0, 0, 0, 0, 0, 1, 0, 1, 0, 1, 0, 0, 1, 1]",365,252,113,15,11,0.05952380952380952,0.09734513274336283
"[1, 0, 0, 0, 1, 0, 1, 0, 0, 0, 0, 0, 1, 1, 1]",253,137,116,12,9,0.08759124087591241,0.07758620689655173
"[1, 1, 1, 0, 1, 1, 0, 1, 0, 1, 1, 1, 0, 0, 0]",165,63,102,7,10,0.1111111111111111,0.09803921568627451
"[0, 1, 1, 0, 1, 1, 0, 1, 1, 0, 0, 0, 1, 0, 0]",108,55,53,5,8,0.09090909090909091,0.1509433962264151
"[1, 0, 0, 0, 1, 1, 0, 1, 0, 0, 1, 1, 1, 1, 1]",230,97,133,8,13,0.08247422680412371,0.09774436090225563
"[0, 1, 1, 1, 1, 0, 0, 1, 1, 0, 1, 0, 1, 1, 1]",372,208,164,19,17,0.09134615384615384,0.10365853658536585
"[0, 1, 0, 1, 1, 0, 0, 0, 0, 1, 1, 0, 1, 0, 1]",123,70,53,5,4,0.07142857142857142,0.07547169811320754
"[1, 1, 1, 1, 0, 0, 1, 0, 0, 1, 0, 1, 1, 0, 0]",139,66,73,2,5,0.030303030303030304,0.0684931506849315
"[0, 1, 1, 1, 1, 1, 1, 0, 0, 1, 0, 0, 1, 0, 1]",195,103,92,15,8,0.14563106796116504,0.08695652173913043
"[0, 0, 0, 1, 1, 0, 1, 1, 1, 0, 0, 0, 1, 1, 1]",171,94,77,9,9,0.09574468085106383,0.11688311688311688
"[1, 1, 1, 1, 1, 0, 0, 0, 1, 0, 1, 0, 0, 0, 0]",166,71,95,9,6,0.1267605633802817,0.06315789473684211
"[1, 0, 1, 0, 0, 1, 1, 0, 0, 1, 0, 0, 0, 1, 0]",134,81,53,7,6,0.08641975308641975,0.11320754716981132
"[1, 1, 1, 1, 1, 0, 1, 0, 0, 0, 1, 1, 0, 1, 1]",281,91,190,11,8,0.12087912087912088,0.042105263157894736
"[1, 1, 0, 0, 0, 1, 1, 1, 1, 0, 0, 1, 1, 0, 0]",473,233,240,21,34,0.09012875536480687,0.14166666666666666
"[1, 1, 1, 1, 0, 1, 0, 0, 0, 0, 0, 0, 0, 1, 0]",152,81,71,14,7,0.1728395061728395,0.09859154929577464
"[0, 1, 0, 1, 1, 1, 1, 1, 1, 1, 0, 1, 1, 0, 1]",493,166,327,22,40,0.13253012048192772,0.12232415902140673
"[0, 1, 1, 1, 1, 0, 1, 0, 1, 1, 1, 1, 1, 0, 1]",512,163,349,15,40,0.09202453987730061,0.11461318051575932
"[1, 0, 0, 1, 1, 1, 1, 0, 1, 0, 1, 1, 1, 0, 0]",204,62,142,10,14,0.16129032258064516,0.09859154929577464
"[0, 0, 1, 0, 0, 0, 0, 1, 0, 1, 0, 1, 1, 0, 0]",297,170,127,14,18,0.08235294117647059,0.14173228346456693
"[0, 1, 0, 0, 1, 0, 0, 0, 0, 1, 0, 1, 0, 1, 1]",183,119,64,12,7,0.10084033613445378,0.109375
"[0, 0, 0, 0, 0, 1, 1, 1, 1, 1, 1, 1, 0, 0, 1]",348,229,119,25,9,0.1091703056768559,0.07563025210084033
"[1, 0, 1, 0, 1, 1, 1, 1, 0, 1, 0, 1, 0, 0, 1]",130,49,81,5,11,0.10204081632653061,0.13580246913580246
"[1, 1, 0, 1, 1, 1, 0, 1, 0, 0, 0, 1, 0, 1, 1]",143,55,88,9,14,0.16363636363636364,0.1590909090909091
"[0, 1, 1, 0, 1, 1, 1, 0, 1, 0, 0, 0, 1, 0, 1]",101,48,53,1,8,0.020833333333333332,0.1509433962264151
"[1, 0, 1, 1, 0, 0, 1, 1, 0, 1, 1, 1, 0, 1, 0]",152,66,86,7,8,0.10606060606060606,0.09302325581395349
"[0, 0, 0, 0, 0, 1, 1, 0, 0, 0, 0, 0, 1, 0, 1]",928,725,203,80,13,0.1103448275862069,0.06403940886699508
"[0, 1, 1, 0, 1, 1, 0, 0, 1, 1, 1, 1, 0, 0, 1]",348,148,200,9,16,0.060810810810810814,0.08
"[1, 1, 0, 1, 0, 0, 0, 1, 1, 0, 1, 1, 1, 0, 0]",119,54,65,5,5,0.09259259259259259,0.07692307692307693
"[0, 1, 1, 1, 0, 0, 1, 1, 1, 1, 0, 0, 0, 1, 1]",247,105,142,12,18,0.11428571428571428,0.1267605633802817
"[0, 1, 1, 1, 0, 0, 0, 1, 1, 0, 1, 0, 0, 0, 0]",142,90,52,8,6,0.08888888888888889,0.11538461538461539
"[1, 1, 1, 0, 0, 1, 0, 0, 1, 0, 0, 0, 0, 1, 1]",171,90,81,11,12,0.12222222222222222,0.14814814814814814
"[0, 1, 1, 1, 0, 1, 1, 0, 0, 1, 0, 1, 0, 1, 1]",146,65,81,8,5,0.12307692307692308,0.06172839506172839
"[0, 1, 0, 0, 0, 0, 1, 0, 1, 0, 0, 1, 1, 1, 1]",173,92,81,6,7,0.06521739130434782,0.08641975308641975
"[1, 0, 1, 0, 1, 0, 0, 0, 1, 1, 0, 1, 0, 1, 0]",82,39,43,4,5,0.10256410256410256,0.11627906976744186
"[1, 1, 0, 0, 1, 0, 1, 0, 0, 1, 0, 1, 1, 0, 0]",121,65,56,7,11,0.1076923076923077,0.19642857142857142
"[1, 1, 1, 1, 0, 0, 1, 0, 0, 0, 0, 1, 0, 1, 1]",154,79,75,7,4,0.08860759493670886,0.05333333333333334
"[1, 0, 1, 0, 1, 1, 0, 1, 0, 1, 0, 1, 0, 0, 0]",100,60,40,10,4,0.16666666666666666,0.1
"[0, 0, 1, 0, 1, 1, 0, 1, 0, 0, 0, 1, 0, 0, 0]",251,166,85,22,10,0.13253012048192772,0.11764705882352941
"[1, 0, 1, 0, 0, 0, 0, 0, 0, 0, 1, 1, 1, 0, 1]",178,94,84,11,5,0.11702127659574468,0.05952380952380952
"[0, 0, 1, 0, 1, 1, 0, 1, 1, 1, 0, 0, 1, 0, 0]",115,64,51,6,6,0.09375,0.11764705882352941
"[0, 0, 0, 0, 0, 1, 0, 1, 0, 1, 1, 1, 0, 0, 0]",303,204,99,23,11,0.11274509803921569,0.1111111111111111
"[0, 1, 1, 0, 0, 0, 1, 1, 0, 1, 0, 0, 0, 1, 0]",141,88,53,7,9,0.07954545454545454,0.16981132075471697
"[0, 0, 0, 1, 0, 1, 0, 1, 0, 1, 1, 0, 0, 0, 1]",158,95,63,10,3,0.10526315789473684,0.047619047619047616
"[1, 1, 1, 1, 0, 0, 1, 0, 1, 0, 1, 0, 0, 1, 1]",202,76,126,4,16,0.05263157894736842,0.12698412698412698
"[0, 1, 1, 1, 1, 1, 0, 0, 1, 0, 1, 1, 1, 1, 0]",278,98,180,13,13,0.1326530612244898,0.07222222222222222
"[1, 0, 1, 0, 1, 0, 1, 0, 1, 0, 1, 1, 1, 0, 1]",123,60,63,7,2,0.11666666666666667,0.031746031746031744
"[0, 0, 1, 1, 1, 0, 0, 1, 1, 1, 1, 0, 1, 1, 0]",166,71,95,11,6,0.15492957746478872,0.06315789473684211
"[1, 1, 0, 1, 0, 0, 1, 1, 1, 0, 0, 0, 1, 0, 0]",116,59,57,3,5,0.05084745762711865,0.08771929824561403
"[0, 0, 1, 1, 0, 0, 0, 1, 0, 1, 0, 0, 1, 0, 0]",259,179,80,16,9,0.0893854748603352,0.1125
"[1, 1, 0, 0, 0, 0, 0, 1, 0, 0, 0, 0, 1, 0, 1]",266,175,91,19,9,0.10857142857142857,0.0989010989010989
"[0, 1, 0, 0, 1, 1, 1, 0, 1, 0, 1, 0, 0, 1, 1]",104,49,55,4,2,0.08163265306122448,0.03636363636363636
"[1, 0, 1, 0, 1, 1, 0, 1, 1, 0, 0, 0, 0, 1, 1]",198,81,117,9,8,0.1111111111111111,0.06837606837606838
"[1, 0, 1, 1, 0, 1, 0, 1, 1, 0, 1, 1, 0, 0, 0]",142,64,78,6,5,0.09375,0.0641025641025641
"[1, 0, 0, 0, 1, 0, 1, 0, 0, 1, 1, 1, 1, 1, 1]",299,110,189,15,20,0.13636363636363635,0.10582010582010581
"[0, 1, 0, 1, 0, 0, 0, 1, 1, 0, 0, 0, 1, 0, 1]",138,85,53,17,7,0.2,0.1320754716981132
"[1, 1, 1, 1, 1, 0, 0, 0, 1, 0, 0, 0, 0, 1, 1]",211,78,133,4,9,0.05128205128205128,0.06766917293233082
"[1, 0, 1, 0, 0, 0, 1, 0, 0, 0, 0, 0, 1, 1, 1]",262,162,100,11,7,0.06790123456790123,0.07
"[0, 0, 1, 1, 0, 0, 0, 1, 0, 0, 1, 1, 1, 1, 1]",293,147,146,11,17,0.07482993197278912,0.11643835616438356
"[1, 0, 1, 1, 0, 0, 1, 1, 0, 0, 0, 1, 0, 0, 1]",130,72,58,6,3,0.08333333333333333,0.05172413793103448
"[1, 0, 0, 0, 1, 1, 1, 0, 1, 1, 1, 1, 0, 1, 0]",116,52,64,8,4,0.15384615384615385,0.0625
"[1, 1, 0, 0, 0, 1, 1, 0, 1, 1, 1, 1, 0, 0, 1]",225,103,122,8,16,0.07766990291262135,0.13114754098360656
"[0, 1, 1, 1, 1, 0, 0, 0, 1, 1, 0, 0, 0, 1, 1]",201,116,85,9,4,0.07758620689655173,0.047058823529411764
"[0, 1, 0, 0, 0, 1, 0, 0, 0, 1, 0, 0, 0, 1, 1]",278,190,88,18,12,0.09473684210526316,0.13636363636363635
"[0, 0, 1, 1, 0, 1, 1, 1, 0, 0, 1, 0, 1, 1, 0]",116,55,61,6,10,0.10909090909090909,0.16393442622950818
"[0, 1, 0, 0, 1, 1, 0, 0, 1, 1, 0, 1, 1, 1, 1]",207,92,115,9,7,0.09782608695652174,0.06086956521739131
"[0, 1, 0, 1, 0, 0, 1, 1, 0, 0, 1, 1, 0, 1, 1]",111,53,58,6,3,0.11320754716981132,0.05172413793103448
"[1, 1, 1, 0, 1, 1, 1, 1, 0, 0, 1, 0, 0, 1, 0]",134,51,83,7,1,0.13725490196078433,0.012048192771084338
"[0, 0, 1, 0, 0, 0, 0, 1, 1, 1, 0, 1, 1, 1, 1]",163,84,79,8,5,0.09523809523809523,0.06329113924050633
"[1, 0, 1, 1, 0, 0, 0, 0, 1, 0, 0, 1, 0, 0, 0]",247,160,87,20,8,0.125,0.09195402298850575
"[0, 0, 1, 0, 1, 1, 0, 0, 0, 0, 1, 0, 0, 1, 0]",227,147,80,15,11,0.10204081632653061,0.1375
"[1, 0, 0, 1, 1, 1, 0, 1, 0, 1, 1, 1, 1, 1, 1]",753,206,547,14,39,0.06796116504854369,0.0712979890310786
"[0, 0, 0, 1, 1, 1, 1, 1, 0, 1, 0, 0, 1, 1, 0]",133,76,57,9,3,0.11842105263157894,0.05263157894736842
"[1, 0, 1, 0, 0, 0, 0, 0, 0, 1, 1, 0, 1, 0, 0]",251,156,95,21,9,0.1346153846153846,0.09473684210526316
"[1, 1, 1, 0, 0, 0, 1, 0, 0, 1, 0, 1, 1, 0, 1]",106,47,59,2,5,0.0425531914893617,0.0847457627118644
"[0, 0, 1, 0, 0, 0, 0, 1, 1, 1, 1, 0, 0, 1, 0]",194,113,81,8,5,0.07079646017699115,0.06172839506172839
"[0, 0, 1, 1, 0, 1, 0, 1, 0, 0, 1, 0, 1, 0, 0]",139,86,53,13,7,0.1511627906976744,0.1320754716981132
"[1, 1, 0, 1, 0, 0, 0, 0, 1, 0, 1, 0, 0, 1, 0]",118,69,49,4,7,0.057971014492753624,0.14285714285714285
"[1, 1, 1, 0, 1, 0, 0, 0, 0, 1, 0, 1, 0, 0, 1]",114,48,66,6,7,0.125,0.10606060606060606
"[1, 1, 1, 1, 0, 1, 0, 0, 0, 0, 1, 0, 1, 0, 0]",139,63,76,7,9,0.1111111111111111,0.11842105263157894
"[0, 1, 0, 1, 0, 1, 0, 1, 0, 1, 1, 1, 1, 0, 0]",142,62,80,4,7,0.06451612903225806,0.0875
"[1, 0, 1, 1, 1, 1, 0, 1, 1, 1, 1, 0, 0, 1, 0]",237,85,152,4,11,0.047058823529411764,0.07236842105263158
"[1, 1, 1, 0, 0, 0, 1, 0, 1, 1, 1, 1, 0, 1, 1]",281,97,184,8,17,0.08247422680412371,0.09239130434782608
"[0, 0, 0, 1, 1, 0, 1, 0, 1, 1, 0, 0, 0, 1, 0]",156,94,62,12,7,0.1276595744680851,0.11290322580645161
"[1, 0, 1, 0, 1, 1, 0, 1, 0, 0, 1, 0, 0, 1, 0]",101,55,46,9,2,0.16363636363636364,0.043478260869565216
"[1, 0, 1, 0, 1, 1, 1, 0, 1, 1, 1, 0, 0, 1, 1]",295,104,191,9,21,0.08653846153846154,0.1099476439790576
"[1, 1, 0, 1, 0, 1, 1, 1, 0, 1, 1, 1, 0, 0, 1]",263,91,172,8,26,0.08791208791208792,0.1511627906976744
"[1, 0, 1, 0, 1, 1, 0, 0, 1, 1, 1, 0, 1, 1, 1]",268,107,161,8,17,0.07476635514018691,0.10559006211180125
"[0, 1, 1, 1, 1, 0, 0, 1, 0, 0, 0, 1, 1, 1, 0]",108,57,51,7,4,0.12280701754385964,0.0784313725490196
"[0, 1, 0, 1, 0, 0, 1, 1, 1, 0, 0, 1, 1, 1, 1]",251,117,134,9,12,0.07692307692307693,0.08955223880597014
"[1, 0, 1, 1, 1, 0, 0, 1, 0, 1, 0, 0, 1, 1, 1]",170,69,101,11,5,0.15942028985507245,0.04950495049504951
"[1, 1, 1, 0, 0, 0, 1, 0, 1, 1, 1, 0, 0, 1, 0]",125,60,65,7,1,0.11666666666666667,0.015384615384615385
"[1, 0, 0, 0, 1, 1, 0, 0, 1, 1, 0, 1, 0, 1, 0]",132,65,67,7,8,0.1076923076923077,0.11940298507462686
"[0, 1, 0, 0, 0, 1, 1, 0, 0, 1, 1, 0, 1, 0, 1]",128,55,73,0,6,0.0,0.0821917808219178
"[1, 1, 1, 0, 1, 0, 0, 0, 1, 1, 0, 0, 1, 1, 0]",199,82,117,9,13,0.10975609756097561,0.1111111111111111
"[0, 1, 0, 0, 1, 0, 0, 1, 1, 0, 1, 0, 0, 0, 1]",140,79,61,11,5,0.13924050632911392,0.08196721311475409
"[0, 1, 1, 1, 0, 1, 0, 0, 1, 0, 0, 0, 1, 0, 0]",128,76,52,4,5,0.05263157894736842,0.09615384615384616
"[1, 0, 1, 1, 1, 1, 0, 1, 1, 1, 0, 1, 0, 0, 1]",266,90,176,3,19,0.03333333333333333,0.10795454545454546
"[0, 0, 0, 1, 0, 0, 1, 0, 1, 0, 0, 1, 0, 1, 0]",229,140,89,14,10,0.1,0.11235955056179775
"[1, 0, 1, 1, 0, 0, 0, 1, 1, 0, 0, 1, 0, 0, 0]",152,94,58,10,3,0.10638297872340426,0.05172413793103448
"[0, 0, 0, 1, 1, 0, 0, 1, 1, 1, 1, 0, 0, 1, 0]",317,242,75,29,6,0.11983471074380166,0.08
"[1, 0, 0, 1, 0, 1, 1, 1, 1, 1, 1, 0, 1, 1, 1]",612,168,444,19,43,0.1130952380952381,0.09684684684684684
"[1, 1, 1, 1, 1, 1, 0, 1, 0, 1, 0, 1, 0, 0, 1]",260,78,182,11,15,0.14102564102564102,0.08241758241758242
"[1, 1, 0, 1, 1, 1, 1, 1, 0, 1, 1, 0, 1, 0, 1]",471,120,351,6,28,0.05,0.07977207977207977
"[0, 1, 0, 0, 0, 0, 0, 1, 0, 0, 0, 1, 1, 1, 0]",249,168,81,24,5,0.14285714285714285,0.06172839506172839
"[1, 0, 0, 1, 1, 1, 1, 1, 0, 0, 1, 1, 0, 0, 0]",311,134,177,12,11,0.08955223880597014,0.062146892655367235
"[0, 1, 1, 1, 1, 0, 0, 1, 0, 1, 0, 1, 0, 0, 1]",123,66,57,3,4,0.045454545454545456,0.07017543859649122
"[1, 1, 1, 1, 0, 1, 0, 0, 1, 0, 0, 0, 0, 1, 1]",164,76,88,4,8,0.05263157894736842,0.09090909090909091
"[0, 1, 0, 0, 1, 0, 0, 0, 1, 1, 0, 1, 1, 1, 0]",92,49,43,4,6,0.08163265306122448,0.13953488372093023
"[0, 0, 1, 0, 0, 1, 0, 0, 0, 1, 1, 0, 1, 1, 1]",126,80,46,8,4,0.1,0.08695652173913043
"[1, 1, 0, 1, 0, 0, 0, 1, 0, 0, 1, 1, 1, 0, 0]",122,62,60,5,5,0.08064516129032258,0.08333333333333333
"[0, 0, 1, 1, 0, 0, 0, 1, 0, 1, 0, 0, 1, 0, 1]",129,70,59,7,5,0.1,0.0847457627118644
"[0, 1, 1, 0, 0, 0, 1, 0, 0, 1, 0, 1, 0, 1, 0]",126,79,47,2,3,0.02531645569620253,0.06382978723404255
"[1, 1, 0, 1, 1, 1, 0, 0, 0, 1, 1, 0, 1, 1, 0]",136,68,68,9,9,0.1323529411764706,0.1323529411764706
"[0, 1, 0, 1, 1, 1, 1, 0, 1, 0, 1, 1, 0, 1, 0]",117,48,69,9,9,0.1875,0.13043478260869565
"[0, 0, 0, 0, 0, 1, 1, 1, 1, 0, 1, 1, 0, 1, 0]",152,97,55,8,6,0.08247422680412371,0.10909090909090909
"[1, 1, 1, 1, 1, 1, 0, 0, 0, 0, 0, 0, 1, 0, 1]",373,157,216,8,20,0.050955414012738856,0.09259259259259259
"[0, 1, 0, 0, 1, 0, 0, 0, 1, 0, 1, 0, 1, 0, 0]",209,137,72,10,6,0.072992700729927,0.08333333333333333
"[0, 0, 1, 0, 1, 0, 0, 0, 1, 1, 1, 0, 0, 0, 1]",149,88,61,8,2,0.09090909090909091,0.03278688524590164
"[1, 1, 0, 1, 0, 0, 0, 0, 0, 1, 0, 1, 1, 0, 0]",172,104,68,9,8,0.08653846153846154,0.11764705882352941
"[0, 1, 0, 0, 1, 1, 1, 0, 0, 0, 0, 1, 1, 1, 1]",300,171,129,21,17,0.12280701754385964,0.13178294573643412
"[1, 1, 1, 1, 0, 1, 0, 0, 1, 1, 1, 0, 0, 0, 0]",184,77,107,4,10,0.05194805194805195,0.09345794392523364
"[1, 1, 0, 1, 1, 1, 0, 0, 1, 1, 0, 0, 0, 1, 1]",187,76,111,6,10,0.07894736842105263,0.09009009009009009
"[0, 0, 1, 1, 0, 0, 0, 1, 0, 1, 1, 0, 0, 1, 1]",189,109,80,10,12,0.09174311926605505,0.15
"[1, 0, 1, 0, 0, 0, 0, 0, 1, 0, 0, 0, 1, 0, 1]",232,153,79,12,3,0.0784313725490196,0.0379746835443038
"[1, 0, 0, 1, 0, 0, 0, 0, 0, 0, 1, 1, 1, 0, 1]",172,104,68,10,5,0.09615384615384616,0.07352941176470588
"[1, 0, 1, 0, 0, 0, 1, 1, 1, 0, 1, 1, 1, 1, 0]",147,60,87,6,9,0.1,0.10344827586206896
"[1, 1, 1, 0, 0, 0, 0, 0, 0, 0, 1, 0, 0, 0, 0]",798,472,326,48,30,0.1016949152542373,0.09202453987730061
"[0, 1, 0, 0, 0, 1, 0, 0, 1, 1, 0, 1, 0, 0, 1]",138,67,71,8,9,0.11940298507462686,0.1267605633802817
"[1, 1, 1, 1, 0, 0, 0, 0, 0, 0, 1, 1, 0, 1, 1]",484,232,252,13,25,0.05603448275862069,0.0992063492063492
"[0, 0, 0, 1, 1, 1, 0, 0, 0, 1, 0, 1, 0, 1, 0]",149,95,54,12,5,0.12631578947368421,0.09259259259259259
"[0, 1, 0, 0, 0, 0, 0, 0, 1, 0, 0, 1, 1, 1, 0]",255,170,85,14,15,0.08235294117647059,0.17647058823529413
"[0, 0, 0, 1, 0, 1, 0, 1, 1, 1, 1, 1, 1, 0, 1]",148,70,78,6,5,0.08571428571428572,0.0641025641025641
"[0, 1, 0, 0, 1, 1, 1, 0, 1, 1, 0, 0, 0, 1, 0]",96,54,42,1,5,0.018518518518518517,0.11904761904761904
"[1, 1, 1, 0, 1, 0, 0, 1, 1, 1, 0, 1, 1, 0, 0]",163,57,106,5,11,0.08771929824561403,0.10377358490566038
"[1, 0, 1, 0, 0, 1, 1, 0, 1, 0, 1, 1, 1, 0, 1]",138,63,75,8,9,0.12698412698412698,0.12
"[0, 1, 0, 1, 0, 0, 0, 0, 0, 0, 1, 0, 1, 0, 1]",254,166,88,18,7,0.10843373493975904,0.07954545454545454
"[0, 0, 1, 0, 1, 0, 1, 0, 1, 0, 1, 0, 1, 1, 1]",156,80,76,11,6,0.1375,0.07894736842105263
"[1, 1, 1, 1, 1, 0, 0, 0, 1, 1, 1, 1, 1, 0, 0]",395,111,284,8,19,0.07207207207207207,0.06690140845070422
"[1, 0, 1, 0, 0, 1, 0, 1, 1, 1, 1, 0, 1, 1, 0]",158,64,94,5,8,0.078125,0.0851063829787234
"[1, 0, 1, 0, 1, 0, 0, 1, 0, 1, 1, 1, 1, 0, 1]",126,52,74,6,9,0.11538461538461539,0.12162162162162163
"[1, 1, 0, 1, 0, 1, 0, 0, 0, 0, 1, 0, 1, 1, 1]",143,73,70,7,5,0.0958904109589041,0.07142857142857142
"[0, 1, 1, 0, 1, 0, 1, 0, 0, 1, 0, 1, 1, 0, 1]",99,50,49,7,7,0.14,0.14285714285714285
"[0, 1, 0, 0, 1, 1, 1, 0, 0, 1, 0, 1, 0, 0, 1]",123,67,56,10,7,0.14925373134328357,0.125
"[1, 1, 1, 0, 0, 0, 1, 1, 1, 0, 0, 0, 1, 1, 1]",324,111,213,6,16,0.05405405405405406,0.07511737089201878
"[0, 0, 0, 1, 1, 0, 0, 0, 1, 0, 0, 1, 0, 1, 1]",241,148,93,11,6,0.07432432432432433,0.06451612903225806
"[1, 0, 0, 1, 0, 0, 0, 0, 1, 1, 0, 0, 1, 0, 0]",274,180,94,20,9,0.1111111111111111,0.09574468085106383
"[1, 0, 0, 0, 0, 1, 0, 0, 1, 1, 0, 1, 1, 0, 0]",151,88,63,3,5,0.03409090909090909,0.07936507936507936
"[1, 1, 0, 1, 0, 0, 1, 1, 0, 0, 0, 1, 0, 1, 0]",95,48,47,4,3,0.08333333333333333,0.06382978723404255
"[0, 0, 0, 1, 0, 1, 1, 1, 0, 1, 1, 0, 1, 1, 1]",175,82,93,9,5,0.10975609756097561,0.053763440860215055
"[1, 1, 1, 0, 0, 1, 0, 1, 0, 0, 0, 1, 1, 1, 0]",127,64,63,7,6,0.109375,0.09523809523809523
"[1, 0, 1, 0, 0, 1, 0, 0, 0, 0, 1, 1, 1, 0, 0]",171,94,77,4,13,0.0425531914893617,0.16883116883116883
"[0, 1, 1, 1, 1, 0, 1, 0, 0, 1, 1, 0, 1, 1, 0]",167,75,92,3,11,0.04,0.11956521739130435
"[0, 1, 1, 1, 0, 1, 0, 0, 0, 0, 0, 1, 1, 1, 1]",263,154,109,14,8,0.09090909090909091,0.07339449541284404
"[1, 0, 1, 0, 1, 0, 0, 1, 1, 0, 1, 0, 0, 1, 1]",113,42,71,1,6,0.023809523809523808,0.08450704225352113
"[1, 0, 1, 0, 1, 0, 0, 1, 1, 0, 0, 1, 0, 1, 0]",82,40,42,2,4,0.05,0.09523809523809523
"[0, 1, 0, 0, 1, 1, 0, 1, 0, 0, 0, 0, 1, 1, 1]",168,108,60,6,6,0.05555555555555555,0.1
"[1, 1, 0, 1, 1, 0, 0, 0, 0, 0, 0, 1, 1, 0, 1]",146,74,72,8,9,0.10810810810810811,0.125
"[1, 1, 0, 0, 0, 0, 0, 0, 1, 0, 1, 1, 0, 1, 1]",181,103,78,9,8,0.08737864077669903,0.10256410256410256
"[1, 1, 0, 0, 1, 0, 1, 0, 1, 0, 0, 1, 1, 1, 0]",122,68,54,8,7,0.11764705882352941,0.12962962962962962
"[1, 1, 0, 0, 1, 0, 1, 1, 1, 0, 1, 0, 0, 0, 1]",112,58,54,6,6,0.10344827586206896,0.1111111111111111
"[1, 0, 0, 1, 0, 0, 1, 1, 0, 0, 1, 1, 1, 0, 1]",126,58,68,6,9,0.10344827586206896,0.1323529411764706
"[1, 0, 1, 0, 1, 0, 0, 0, 0, 0, 1, 1, 1, 1, 0]",184,96,88,5,6,0.052083333333333336,0.06818181818181818
"[1, 0, 0, 1, 1, 0, 1, 0, 0, 1, 0, 1, 1, 1, 1]",228,89,139,8,10,0.0898876404494382,0.07194244604316546
"[1, 1, 1, 1, 0, 1, 1, 0, 0, 1, 1, 0, 0, 0, 1]",193,77,116,13,11,0.16883116883116883,0.09482758620689655
"[0, 1, 1, 1, 0, 1, 1, 0, 1, 1, 0, 0, 0, 1, 0]",104,48,56,7,4,0.14583333333333334,0.07142857142857142
"[0, 1, 0, 1, 0, 0, 1, 0, 0, 1, 0, 1, 1, 1, 0]",88,41,47,3,1,0.07317073170731707,0.02127659574468085
"[0, 0, 0, 1, 0, 1, 0, 0, 0, 1, 1, 0, 0, 1, 0]",242,159,83,9,7,0.05660377358490566,0.08433734939759036
"[0, 0, 1, 1, 1, 1, 0, 0, 0, 1, 1, 1, 1, 1, 0]",246,114,132,13,13,0.11403508771929824,0.09848484848484848
"[1, 1, 1, 1, 1, 1, 1, 1, 0, 1, 0, 0, 0, 0, 0]",305,109,196,13,20,0.11926605504587157,0.10204081632653061
"[0, 1, 1, 1, 0, 0, 1, 0, 1, 0, 0, 1, 0, 1, 0]",109,54,55,13,5,0.24074074074074073,0.09090909090909091
"[1, 1, 0, 0, 0, 0, 0, 0, 1, 1, 0, 0, 0, 1, 0]",561,360,201,37,29,0.10277777777777777,0.14427860696517414
"[1, 1, 1, 1, 0, 0, 0, 0, 1, 1, 0, 1, 1, 1, 0]",260,105,155,10,18,0.09523809523809523,0.11612903225806452
"[0, 1, 0, 1, 1, 1, 1, 0, 0, 0, 0, 1, 1, 0, 1]",150,77,73,10,7,0.12987012987012986,0.0958904109589041
"[0, 1, 0, 1, 0, 1, 1, 0, 0, 0, 0, 1, 1, 1, 1]",315,158,157,14,14,0.08860759493670886,0.08917197452229299
"[0, 1, 1, 0, 1, 0, 1, 0, 0, 1, 1, 0, 1, 0, 1]",109,57,52,8,6,0.14035087719298245,0.11538461538461539
"[1, 0, 0, 1, 1, 0, 0, 0, 0, 1, 1, 0, 1, 1, 1]",417,98,319,12,35,0.12244897959183673,0.109717868338558
"[0, 1, 1, 0, 0, 1, 1, 0, 1, 0, 1, 1, 1, 1, 0]",159,72,87,9,11,0.125,0.12643678160919541
"[1, 0, 1, 0, 0, 0, 1, 1, 1, 0, 1, 1, 0, 1, 0]",92,41,51,4,7,0.0975609756097561,0.13725490196078433
"[0, 1, 1, 1, 1, 1, 0, 0, 0, 1, 0, 1, 1, 0, 0]",136,77,59,8,4,0.1038961038961039,0.06779661016949153
"[0, 1, 1, 1, 1, 0, 1, 0, 1, 0, 0, 1, 0, 1, 0]",99,43,56,6,4,0.13953488372093023,0.07142857142857142
"[0, 0, 0, 1, 0, 1, 1, 1, 1, 1, 1, 0, 1, 1, 0]",148,65,83,6,8,0.09230769230769231,0.0963855421686747
"[0, 0, 0, 0, 1, 0, 1, 1, 1, 1, 0, 0, 1, 1, 1]",253,131,122,10,7,0.07633587786259542,0.05737704918032787
"[0, 1, 1, 0, 0, 0, 1, 1, 1, 1, 1, 0, 0, 0, 0]",208,119,89,6,7,0.05042016806722689,0.07865168539325842
"[1, 1, 1, 0, 0, 1, 0, 1, 1, 0, 0, 0, 1, 1, 1]",209,91,118,8,16,0.08791208791208792,0.13559322033898305
"[1, 1, 0, 1, 0, 1, 1, 1, 1, 0, 0, 1, 0, 1, 1]",270,99,171,11,18,0.1111111111111111,0.10526315789473684
"[1, 1, 0, 0, 1, 0, 1, 0, 0, 1, 0, 0, 0, 0, 1]",163,91,72,8,9,0.08791208791208792,0.125
"[1, 1, 0, 1, 1, 0, 0, 1, 0, 1, 0, 0, 1, 0, 0]",126,67,59,5,6,0.07462686567164178,0.1016949152542373
"[1, 0, 1, 0, 1, 1, 1, 1, 0, 1, 1, 1, 1, 0, 1]",476,141,335,16,31,0.11347517730496454,0.09253731343283582
"[1, 1, 0, 0, 0, 0, 0, 1, 1, 1, 0, 1, 0, 1, 1]",157,70,87,5,9,0.07142857142857142,0.10344827586206896
"[0, 1, 1, 1, 0, 1, 1, 1, 1, 1, 0, 0, 0, 1, 0]",136,60,76,7,4,0.11666666666666667,0.05263157894736842
"[1, 0, 0, 1, 0, 0, 1, 1, 1, 1, 0, 1, 1, 1, 1]",337,107,230,11,15,0.102803738317757,0.06521739130434782
"[1, 0, 1, 1, 0, 1, 1, 1, 0, 1, 0, 0, 0, 1, 1]",166,67,99,7,8,0.1044776119402985,0.08080808080808081
"[0, 1, 1, 0, 1, 1, 1, 0, 0, 0, 1, 1, 0, 0, 1]",142,79,63,9,3,0.11392405063291139,0.047619047619047616
"[0, 0, 1, 0, 1, 1, 0, 1, 0, 1, 1, 0, 1, 0, 0]",123,57,66,2,10,0.03508771929824561,0.15151515151515152
"[1, 0, 1, 0, 1, 0, 1, 0, 0, 0, 0, 1, 1, 1, 0]",109,44,65,4,5,0.09090909090909091,0.07692307692307693
"[0, 0, 1, 1, 0, 0, 1, 0, 1, 1, 0, 1, 0, 1, 1]",140,65,75,2,5,0.03076923076923077,0.06666666666666667
"[1, 1, 0, 0, 0, 1, 0, 0, 1, 1, 0, 0, 1, 0, 1]",112,62,50,8,4,0.12903225806451613,0.08
"[0, 0, 0, 1, 0, 0, 0, 1, 0, 1, 0, 1, 0, 1, 0]",194,126,68,9,10,0.07142857142857142,0.14705882352941177
"[1, 1, 1, 0, 1, 0, 1, 0, 1, 0, 1, 1, 0, 0, 1]",153,62,91,7,12,0.11290322580645161,0.13186813186813187
"[1, 1, 0, 1, 1, 0, 0, 1, 0, 1, 0, 1, 0, 1, 0]",111,49,62,2,6,0.04081632653061224,0.0967741935483871
"[1, 1, 1, 1, 0, 1, 1, 0, 0, 1, 0, 1, 0, 1, 0]",130,56,74,7,11,0.125,0.14864864864864866
"[1, 0, 1, 0, 1, 1, 0, 1, 0, 0, 0, 1, 0, 1, 0]",94,46,48,6,4,0.13043478260869565,0.08333333333333333
"[1, 1, 0, 1, 0, 1, 1, 0, 1, 0, 0, 0, 1, 0, 1]",100,50,50,3,5,0.06,0.1
"[1, 1, 0, 1, 1, 0, 1, 1, 1, 1, 0, 0, 1, 0, 1]",216,93,123,6,8,0.06451612903225806,0.06504065040650407
"[1, 1, 1, 0, 0, 0, 0, 0, 0, 1, 0, 1, 0, 0, 0]",296,145,151,17,23,0.11724137931034483,0.152317880794702
"[1, 1, 0, 0, 1, 1, 1, 1, 1, 0, 0, 1, 0, 1, 1]",370,130,240,14,21,0.1076923076923077,0.0875
"[1, 1, 1, 1, 0, 1, 0, 0, 0, 1, 0, 0, 0, 1, 0]",108,58,50,4,6,0.06896551724137931,0.12
"[1, 1, 1, 1, 1, 1, 0, 1, 0, 0, 0, 1, 0, 0, 0]",132,57,75,7,10,0.12280701754385964,0.13333333333333333
"[1, 0, 1, 1, 0, 0, 0, 0, 0, 1, 1, 0, 1, 1, 0]",132,64,68,10,10,0.15625,0.14705882352941177
"[1, 1, 0, 1, 1, 0, 0, 0, 0, 0, 1, 1, 0, 1, 1]",133,66,67,7,5,0.10606060606060606,0.07462686567164178
"[0, 1, 1, 0, 0, 0, 1, 1, 0, 1, 1, 1, 0, 0, 1]",137,67,70,8,7,0.11940298507462686,0.1
"[1, 1, 0, 0, 1, 1, 1, 1, 0, 0, 0, 1, 1, 0, 0]",291,116,175,13,24,0.11206896551724138,0.13714285714285715
"[1, 1, 0, 1, 1, 0, 1, 0, 0, 0, 1, 1, 0, 0, 0]",164,88,76,12,9,0.13636363636363635,0.11842105263157894
"[1, 0, 1, 1, 1, 1, 0, 1, 0, 1, 0, 1, 1, 1, 0]",237,75,162,7,20,0.09333333333333334,0.12345679012345678
"[1, 0, 0, 1, 1, 1, 0, 0, 1, 0, 1, 1, 0, 1, 1]",156,50,106,3,13,0.06,0.12264150943396226
"[1, 1, 0, 0, 1, 0, 1, 0, 0, 1, 0, 0, 1, 0, 0]",126,71,55,7,7,0.09859154929577464,0.12727272727272726
"[0, 0, 0, 1, 0, 1, 1, 0, 1, 0, 0, 1, 0, 1, 0]",141,87,54,12,6,0.13793103448275862,0.1111111111111111
"[0, 0, 0, 0, 1, 0, 1, 1, 0, 1, 0, 0, 1, 0, 1]",148,98,50,11,6,0.11224489795918367,0.12
"[1, 0, 1, 1, 0, 0, 1, 1, 1, 0, 0, 1, 0, 1, 1]",138,61,77,3,2,0.04918032786885246,0.025974025974025976
"[0, 1, 0, 0, 0, 0, 1, 0, 1, 1, 0, 1, 0, 0, 1]",134,87,47,6,4,0.06896551724137931,0.0851063829787234
"[0, 0, 0, 0, 0, 1, 0, 1, 1, 1, 0, 1, 1, 1, 1]",198,108,90,10,5,0.09259259259259259,0.05555555555555555
"[0, 1, 0, 0, 1, 1, 1, 1, 0, 0, 0, 0, 1, 1, 1]",475,239,236,29,26,0.12133891213389121,0.11016949152542373
"[0, 1, 1, 1, 0, 1, 0, 0, 0, 1, 0, 1, 0, 0, 0]",134,76,58,2,4,0.02631578947368421,0.06896551724137931
"[0, 0, 1, 1, 1, 0, 1, 0, 0, 0, 1, 0, 1, 0, 0]",126,76,50,4,3,0.05263157894736842,0.06
"[1, 0, 1, 0, 1, 1, 0, 0, 0, 0, 0, 1, 1, 1, 0]",124,70,54,6,6,0.08571428571428572,0.1111111111111111
"[1, 1, 1, 1, 0, 0, 0, 1, 1, 0, 0, 0, 1, 0, 0]",145,89,56,6,6,0.06741573033707865,0.10714285714285714
"[0, 1, 1, 1, 1, 0, 0, 0, 1, 1, 0, 0, 0, 1, 0]",153,86,67,10,7,0.11627906976744186,0.1044776119402985
"[1, 0, 0, 1, 0, 1, 0, 1, 1, 1, 0, 0, 1, 0, 1]",115,48,67,3,7,0.0625,0.1044776119402985
"[1, 0, 0, 0, 1, 0, 1, 1, 1, 1, 1, 0, 1, 1, 0]",138,47,91,5,7,0.10638297872340426,0.07692307692307693
"[0, 1, 0, 0, 0, 0, 0, 0, 1, 1, 0, 1, 1, 0, 1]",156,98,58,8,6,0.08163265306122448,0.10344827586206896
"[0, 0, 0, 1, 0, 1, 1, 1, 0, 1, 0, 0, 0, 1, 1]",130,74,56,8,7,0.10810810810810811,0.125
"[1, 1, 0, 0, 1, 0, 0, 0, 0, 1, 0, 1, 1, 1, 0]",110,59,51,8,5,0.13559322033898305,0.09803921568627451
"[0, 0, 0, 1, 0, 1, 0, 1, 1, 1, 1, 0, 1, 1, 1]",190,79,111,8,11,0.10126582278481013,0.0990990990990991
"[0, 1, 0, 1, 1, 1, 0, 1, 0, 1, 0, 1, 0, 1, 1]",146,64,82,7,9,0.109375,0.10975609756097561
"[0, 0, 0, 0, 0, 1, 0, 1, 1, 1, 0, 1, 0, 1, 0]",130,86,44,6,3,0.06976744186046512,0.06818181818181818
"[1, 0, 0, 0, 1, 1, 0, 1, 0, 1, 1, 0, 1, 1, 0]",121,60,61,1,7,0.016666666666666666,0.11475409836065574
"[1, 1, 1, 0, 0, 1, 1, 0, 1, 1, 0, 0, 0, 1, 1]",205,64,141,6,22,0.09375,0.15602836879432624
"[1, 0, 0, 0, 0, 1, 1, 0, 1, 0, 0, 1, 0, 1, 0]",148,82,66,6,8,0.07317073170731707,0.12121212121212122
"[1, 1, 1, 1, 0, 0, 1, 0, 0, 1, 0, 0, 0, 0, 0]",210,121,89,11,10,0.09090909090909091,0.11235955056179775
"[0, 0, 0, 1, 1, 1, 1, 0, 0, 1, 0, 0, 1, 0, 0]",228,165,63,13,8,0.07878787878787878,0.12698412698412698
"[1, 0, 1, 0, 0, 0, 0, 1, 1, 1, 1, 0, 0, 1, 0]",134,68,66,8,6,0.11764705882352941,0.09090909090909091
"[1, 0, 0, 0, 0, 1, 0, 1, 0, 0, 0, 1, 1, 1, 0]",176,95,81,13,12,0.1368421052631579,0.14814814814814814
"[0, 1, 1, 1, 0, 0, 0, 1, 1, 1, 0, 1, 0, 1, 0]",124,63,61,11,1,0.1746031746031746,0.01639344262295082
"[1, 1, 0, 0, 1, 1, 1, 0, 0, 0, 1, 1, 1, 0, 1]",149,61,88,2,10,0.03278688524590164,0.11363636363636363
"[0, 1, 1, 1, 1, 1, 1, 0, 1, 0, 1, 0, 1, 0, 0]",140,73,67,9,4,0.1232876712328767,0.05970149253731343
"[1, 0, 1, 0, 0, 1, 0, 0, 1, 1, 1, 1, 0, 1, 0]",115,63,52,4,6,0.06349206349206349,0.11538461538461539
"[0, 1, 0, 1, 0, 0, 1, 0, 0, 1, 1, 1, 1, 0, 1]",117,52,65,5,6,0.09615384615384616,0.09230769230769231
"[1, 0, 1, 0, 0, 0, 1, 0, 1, 0, 0, 0, 1, 1, 1]",140,73,67,8,6,0.1095890410958904,0.08955223880597014
"[0, 0, 0, 0, 1, 0, 1, 0, 1, 1, 1, 0, 1, 1, 1]",149,82,67,4,4,0.04878048780487805,0.05970149253731343
"[0, 0, 1, 0, 1, 1, 0, 1, 0, 0, 0, 1, 1, 1, 1]",165,90,75,5,7,0.05555555555555555,0.09333333333333334
"[1, 1, 0, 0, 1, 1, 1, 0, 1, 1, 1, 1, 1, 0, 1]",532,166,366,13,25,0.0783132530120482,0.06830601092896176
"[0, 0, 0, 1, 0, 0, 0, 0, 1, 1, 0, 0, 0, 1, 0]",567,386,181,42,21,0.10880829015544041,0.11602209944751381
"[1, 0, 0, 0, 0, 0, 1, 0, 1, 1, 0, 1, 0, 0, 0]",246,150,96,18,8,0.12,0.08333333333333333
"[0, 1, 0, 1, 1, 1, 0, 1, 1, 0, 1, 0, 0, 0, 0]",113,63,50,6,4,0.09523809523809523,0.08
"[1, 0, 0, 1, 1, 0, 1, 1, 0, 0, 1, 0, 0, 1, 1]",138,65,73,4,6,0.06153846153846154,0.0821917808219178
"[0, 1, 0, 0, 1, 0, 1, 0, 0, 1, 1, 1, 1, 0, 0]",190,101,89,9,7,0.0891089108910891,0.07865168539325842
"[1, 1, 1, 1, 0, 1, 0, 0, 1, 0, 1, 1, 1, 0, 0]",140,62,78,4,8,0.06451612903225806,0.10256410256410256
"[1, 0, 1, 1, 0, 1, 0, 1, 0, 1, 0, 1, 0, 0, 0]",134,64,70,6,6,0.09375,0.08571428571428572
"[1, 0, 0, 0, 0, 1, 1, 1, 0, 1, 0, 0, 0, 0, 1]",187,101,86,14,5,0.13861386138613863,0.05813953488372093
"[1, 0, 0, 1, 0, 0, 0, 0, 1, 1, 1, 0, 1, 0, 0]",138,91,47,5,3,0.054945054945054944,0.06382978723404255
"[0, 1, 1, 1, 0, 1, 0, 1, 1, 0, 1, 0, 0, 1, 1]",159,74,85,9,9,0.12162162162162163,0.10588235294117647
"[1, 1, 1, 0, 1, 1, 1, 0, 1, 0, 1, 1, 0, 1, 0]",229,83,146,8,13,0.0963855421686747,0.08904109589041095
"[1, 0, 1, 0, 1, 1, 1, 0, 1, 1, 1, 0, 1, 1, 1]",541,148,393,15,41,0.10135135135135136,0.10432569974554708
"[1, 1, 1, 0, 1, 0, 1, 0, 1, 0, 0, 0, 1, 1, 0]",133,56,77,3,12,0.05357142857142857,0.15584415584415584
"[1, 0, 0, 0, 1, 0, 0, 1, 0, 0, 1, 0, 1, 0, 1]",131,66,65,8,5,0.12121212121212122,0.07692307692307693
"[1, 0, 0, 0, 1, 1, 0, 0, 0, 0, 1, 0, 0, 0, 1]",262,160,102,17,10,0.10625,0.09803921568627451
"[1, 1, 0, 1, 0, 1, 1, 0, 0, 0, 0, 0, 1, 1, 0]",153,87,66,16,7,0.1839080459770115,0.10606060606060606
"[1, 0, 0, 0, 1, 1, 1, 0, 1, 1, 1, 0, 0, 0, 0]",137,61,76,9,7,0.14754098360655737,0.09210526315789473
"[0, 0, 0, 1, 0, 1, 0, 0, 0, 1, 1, 0, 1, 1, 1]",164,110,54,8,1,0.07272727272727272,0.018518518518518517
"[0, 0, 1, 1, 0, 0, 1, 1, 0, 1, 1, 0, 1, 0, 0]",148,78,70,11,3,0.14102564102564102,0.04285714285714286
"[0, 0, 0, 1, 1, 0, 0, 0, 1, 1, 1, 0, 1, 0, 1]",130,72,58,9,5,0.125,0.08620689655172414
"[0, 1, 0, 0, 1, 1, 1, 0, 0, 1, 0, 1, 1, 1, 1]",181,88,93,6,15,0.06818181818181818,0.16129032258064516
"[0, 1, 0, 0, 1, 0, 0, 0, 1, 0, 1, 0, 1, 1, 1]",138,79,59,12,2,0.1518987341772152,0.03389830508474576
"[0, 0, 1, 1, 0, 0, 1, 1, 0, 1, 0, 1, 1, 1, 0]",173,92,81,6,5,0.06521739130434782,0.06172839506172839
"[0, 0, 0, 1, 1, 1, 0, 1, 1, 0, 0, 0, 1, 1, 1]",186,99,87,9,4,0.09090909090909091,0.04597701149425287
"[0, 0, 0, 1, 0, 0, 0, 1, 0, 1, 1, 0, 0, 1, 1]",250,142,108,14,13,0.09859154929577464,0.12037037037037036
"[0, 1, 1, 0, 1, 0, 1, 1, 0, 0, 0, 0, 0, 1, 0]",162,95,67,10,5,0.10526315789473684,0.07462686567164178
"[1, 1, 0, 0, 1, 0, 0, 0, 1, 0, 0, 0, 1, 1, 1]",138,76,62,9,11,0.11842105263157894,0.1774193548387097
"[1, 0, 1, 1, 0, 0, 1, 0, 1, 1, 1, 0, 1, 0, 0]",114,57,57,3,4,0.05263157894736842,0.07017543859649122
"[0, 0, 1, 0, 1, 0, 1, 1, 0, 0, 1, 1, 0, 1, 0]",113,63,50,8,3,0.12698412698412698,0.06
"[0, 0, 1, 1, 0, 0, 1, 1, 1, 0, 0, 1, 0, 0, 1]",160,88,72,6,8,0.06818181818181818,0.1111111111111111
"[1, 1, 1, 1, 0, 1, 1, 1, 0, 0, 0, 1, 0, 1, 1]",275,87,188,6,16,0.06896551724137931,0.0851063829787234
"[0, 1, 0, 1, 1, 0, 1, 0, 1, 0, 1, 1, 0, 1, 1]",141,54,87,3,7,0.05555555555555555,0.08045977011494253
"[1, 0, 0, 1, 0, 0, 1, 0, 1, 1, 1, 0, 0, 0, 0]",161,84,77,8,7,0.09523809523809523,0.09090909090909091
"[0, 1, 0, 0, 1, 0, 0, 1, 0, 1, 1, 1, 0, 0, 0]",138,90,48,6,3,0.06666666666666667,0.0625
"[0, 0, 0, 0, 1, 0, 1, 0, 0, 1, 0, 0, 1, 0, 1]",213,127,86,17,8,0.13385826771653545,0.09302325581395349
"[1, 0, 0, 0, 1, 0, 0, 1, 0, 1, 0, 1, 1, 0, 0]",172,103,69,12,10,0.11650485436893204,0.14492753623188406
"[1, 0, 1, 0, 0, 1, 0, 0, 0, 1, 1, 0, 1, 1, 0]",121,63,58,6,5,0.09523809523809523,0.08620689655172414
"[0, 0, 1, 0, 0, 1, 1, 1, 0, 1, 1, 0, 1, 0, 1]",113,56,57,6,9,0.10714285714285714,0.15789473684210525
"[0, 1, 1, 0, 0, 1, 0, 1, 0, 1, 0, 0, 1, 0, 0]",134,77,57,5,7,0.06493506493506493,0.12280701754385964
"[1, 1, 1, 1, 1, 0, 0, 0, 0, 0, 0, 1, 0, 1, 0]",218,70,148,6,11,0.08571428571428572,0.07432432432432433
"[0, 0, 1, 1, 0, 0, 1, 1, 0, 1, 1, 1, 1, 1, 1]",577,213,364,21,26,0.09859154929577464,0.07142857142857142
"[1, 0, 0, 1, 0, 1, 0, 1, 1, 0, 0, 0, 0, 0, 1]",160,110,50,4,3,0.03636363636363636,0.06
"[1, 0, 1, 1, 0, 0, 0, 0, 0, 1, 0, 1, 1, 0, 1]",117,63,54,5,4,0.07936507936507936,0.07407407407407407
"[0, 0, 0, 1, 0, 0, 0, 1, 1, 1, 1, 0, 0, 1, 1]",325,191,134,18,15,0.09424083769633508,0.11194029850746269
"[1, 0, 1, 0, 0, 0, 0, 1, 1, 0, 1, 0, 0, 0, 0]",257,158,99,12,13,0.0759493670886076,0.13131313131313133
"[0, 0, 0, 1, 0, 0, 1, 1, 1, 0, 1, 1, 0, 1, 0]",108,65,43,3,7,0.046153846153846156,0.16279069767441862
"[0, 0, 1, 1, 1, 1, 0, 0, 1, 0, 0, 0, 1, 0, 1]",142,81,61,13,9,0.16049382716049382,0.14754098360655737
"[0, 0, 1, 0, 0, 1, 0, 0, 0, 1, 0, 1, 1, 0, 0]",244,165,79,15,7,0.09090909090909091,0.08860759493670886
"[1, 1, 0, 0, 1, 1, 0, 0, 0, 0, 0, 1, 0, 0, 1]",320,185,135,18,14,0.0972972972972973,0.1037037037037037
"[1, 0, 1, 1, 1, 0, 1, 1, 1, 0, 1, 0, 0, 1, 0]",130,59,71,2,10,0.03389830508474576,0.14084507042253522
"[0, 0, 1, 0, 0, 1, 0, 1, 1, 1, 0, 1, 0, 0, 1]",101,56,45,9,7,0.16071428571428573,0.15555555555555556
"[0, 1, 0, 1, 1, 1, 0, 1, 1, 0, 0, 1, 0, 0, 0]",123,71,52,8,6,0.11267605633802817,0.11538461538461539
"[0, 0, 1, 1, 0, 1, 0, 1, 1, 1, 0, 1, 1, 1, 0]",139,58,81,5,6,0.08620689655172414,0.07407407407407407
"[1, 0, 1, 1, 1, 0, 0, 0, 0, 1, 1, 0, 1, 0, 1]",135,64,71,6,6,0.09375,0.08450704225352113
"[1, 0, 1, 0, 0, 0, 1, 0, 0, 0, 0, 1, 0, 1, 0]",211,136,75,12,4,0.08823529411764706,0.05333333333333334
"[0, 1, 1, 0, 0, 0, 0, 0, 1, 1, 1, 1, 1, 0, 1]",146,72,74,10,8,0.1388888888888889,0.10810810810810811
"[1, 0, 1, 1, 1, 0, 1, 1, 1, 0, 0, 0, 1, 1, 0]",136,52,84,6,6,0.11538461538461539,0.07142857142857142
"[0, 0, 0, 1, 1, 0, 1, 0, 0, 0, 0, 1, 1, 0, 1]",152,93,59,7,6,0.07526881720430108,0.1016949152542373
"[1, 1, 0, 1, 0, 0, 1, 1, 0, 0, 1, 0, 0, 1, 1]",149,67,82,7,7,0.1044776119402985,0.08536585365853659
"[0, 1, 1, 0, 1, 1, 0, 1, 1, 1, 0, 1, 1, 0, 0]",176,73,103,4,10,0.0547945205479452,0.0970873786407767
"[0, 1, 0, 1, 0, 1, 0, 0, 1, 1, 0, 0, 1, 1, 1]",199,97,102,9,12,0.09278350515463918,0.11764705882352941
"[0, 1, 0, 0, 0, 0, 1, 1, 1, 1, 1, 0, 0, 0, 0]",265,156,109,18,6,0.11538461538461539,0.05504587155963303
"[0, 0, 0, 0, 0, 1, 0, 1, 0, 1, 1, 0, 1, 1, 1]",186,116,70,9,4,0.07758620689655173,0.05714285714285714
"[0, 1, 0, 0, 0, 0, 1, 0, 0, 1, 1, 1, 0, 1, 1]",114,53,61,5,10,0.09433962264150944,0.16393442622950818
"[0, 0, 0, 1, 0, 0, 0, 1, 1, 1, 0, 1, 1, 1, 1]",142,66,76,4,1,0.06060606060606061,0.013157894736842105
"[1, 0, 0, 1, 1, 1, 1, 0, 1, 0, 0, 0, 0, 0, 1]",154,61,93,4,8,0.06557377049180328,0.08602150537634409
"[1, 1, 1, 0, 1, 1, 1, 0, 1, 1, 0, 0, 0, 0, 1]",227,87,140,5,16,0.05747126436781609,0.11428571428571428
"[0, 0, 1, 0, 1, 1, 0, 0, 1, 0, 0, 0, 1, 0, 0]",220,154,66,15,5,0.09740259740259741,0.07575757575757576
"[1, 0, 1, 1, 0, 0, 1, 1, 0, 1, 1, 0, 0, 0, 1]",109,46,63,4,5,0.08695652173913043,0.07936507936507936
"[1, 1, 0, 1, 1, 0, 0, 1, 1, 0, 1, 1, 0, 0, 0]",131,63,68,5,7,0.07936507936507936,0.10294117647058823
"[1, 0, 1, 0, 1, 1, 0, 0, 0, 1, 0, 1, 1, 0, 0]",142,77,65,2,7,0.025974025974025976,0.1076923076923077
"[0, 0, 0, 1, 0, 1, 1, 0, 1, 1, 1, 1, 1, 1, 1]",379,135,244,16,22,0.11851851851851852,0.09016393442622951
"[1, 0, 0, 1, 1, 0, 0, 1, 0, 0, 1, 1, 0, 1, 1]",135,52,83,8,6,0.15384615384615385,0.07228915662650602
"[0, 0, 1, 0, 1, 1, 1, 1, 0, 1, 1, 1, 1, 0, 0]",176,81,95,4,10,0.04938271604938271,0.10526315789473684
"[0, 1, 1, 1, 1, 0, 0, 0, 0, 1, 1, 1, 0, 1, 1]",359,258,101,25,11,0.09689922480620156,0.10891089108910891
"[0, 1, 0, 0, 1, 1, 0, 1, 1, 0, 0, 0, 1, 0, 0]",133,78,55,6,4,0.07692307692307693,0.07272727272727272
"[0, 0, 0, 1, 0, 0, 1, 1, 0, 1, 1, 0, 0, 0, 1]",152,86,66,7,7,0.08139534883720931,0.10606060606060606
"[1, 1, 1, 1, 0, 1, 0, 0, 1, 1, 1, 0, 0, 1, 1]",319,104,215,4,25,0.038461538461538464,0.11627906976744186
"[0, 0, 1, 1, 0, 0, 1, 1, 1, 1, 0, 1, 1, 0, 0]",244,114,130,8,16,0.07017543859649122,0.12307692307692308
"[1, 0, 1, 0, 0, 1, 0, 0, 0, 0, 1, 0, 1, 0, 1]",135,77,58,11,6,0.14285714285714285,0.10344827586206896
"[0, 0, 0, 0, 0, 1, 1, 1, 0, 1, 0, 1, 0, 0, 0]",291,208,83,14,4,0.0673076923076923,0.04819277108433735
"[0, 1, 0, 1, 1, 1, 1, 1, 1, 0, 0, 1, 0, 1, 0]",153,54,99,5,9,0.09259259259259259,0.09090909090909091
"[0, 1, 1, 0, 0, 0, 0, 1, 1, 1, 1, 1, 0, 0, 1]",289,208,81,19,9,0.09134615384615384,0.1111111111111111
"[1, 0, 1, 1, 0, 0, 0, 0, 1, 1, 1, 1, 1, 0, 0]",173,71,102,4,10,0.056338028169014086,0.09803921568627451
"[0, 0, 0, 1, 1, 1, 0, 1, 1, 0, 0, 1, 0, 1, 0]",93,55,38,5,6,0.09090909090909091,0.15789473684210525
"[0, 0, 0, 0, 1, 1, 1, 0, 1, 1, 0, 0, 1, 0, 1]",128,61,67,5,9,0.08196721311475409,0.13432835820895522
"[0, 0, 1, 0, 1, 0, 0, 1, 1, 1, 1, 0, 1, 0, 0]",118,59,59,4,4,0.06779661016949153,0.06779661016949153
"[1, 0, 0, 1, 1, 0, 1, 0, 0, 0, 1, 1, 0, 0, 1]",165,95,70,12,6,0.12631578947368421,0.08571428571428572
"[1, 1, 1, 0, 0, 0, 0, 1, 0, 1, 1, 0, 1, 0, 0]",120,61,59,8,5,0.13114754098360656,0.0847457627118644
"[0, 0, 0, 0, 0, 0, 0, 1, 1, 1, 1, 0, 1, 0, 1]",329,251,78,23,14,0.09163346613545817,0.1794871794871795
"[1, 0, 1, 1, 0, 0, 1, 0, 0, 0, 0, 1, 0, 1, 1]",113,58,55,4,4,0.06896551724137931,0.07272727272727272
"[0, 0, 1, 0, 1, 1, 1, 1, 0, 1, 0, 1, 1, 1, 0]",152,73,79,7,3,0.0958904109589041,0.0379746835443038
"[1, 0, 0, 1, 0, 1, 1, 0, 0, 1, 0, 0, 0, 0, 0]",288,173,115,18,12,0.10404624277456648,0.10434782608695652
"[1, 0, 0, 1, 1, 0, 0, 1, 0, 0, 0, 0, 1, 0, 1]",171,83,88,5,6,0.060240963855421686,0.06818181818181818
"[0, 1, 0, 1, 0, 0, 0, 1, 0, 0, 0, 0, 1, 1, 0]",305,194,111,16,9,0.08247422680412371,0.08108108108108109
"[1, 1, 1, 0, 1, 0, 0, 1, 0, 1, 0, 0, 0, 0, 1]",121,68,53,7,5,0.10294117647058823,0.09433962264150944
"[1, 0, 0, 1, 1, 1, 1, 1, 0, 0, 0, 1, 0, 1, 1]",205,69,136,6,16,0.08695652173913043,0.11764705882352941
"[1, 1, 0, 1, 0, 0, 1, 1, 1, 1, 1, 0, 0, 0, 1]",165,60,105,8,8,0.13333333333333333,0.0761904761904762
"[1, 1, 1, 1, 0, 1, 0, 0, 1, 1, 1, 1, 1, 0, 0]",327,117,210,10,19,0.08547008547008547,0.09047619047619047
"[0, 0, 1, 0, 1, 0, 0, 0, 1, 0, 1, 1, 1, 1, 0]",109,63,46,7,4,0.1111111111111111,0.08695652173913043
"[1, 0, 1, 0, 1, 0, 0, 1, 0, 0, 1, 0, 1, 0, 0]",121,70,51,6,12,0.08571428571428572,0.23529411764705882
"[0, 1, 1, 0, 1, 1, 1, 0, 0, 1, 0, 0, 1, 0, 0]",108,61,47,4,2,0.06557377049180328,0.0425531914893617
"[0, 0, 1, 1, 1, 0, 0, 0, 0, 0, 1, 0, 0, 0, 1]",297,196,101,28,7,0.14285714285714285,0.06930693069306931
"[0, 0, 0, 0, 1, 1, 0, 1, 0, 1, 1, 1, 1, 0, 1]",140,68,72,5,13,0.07352941176470588,0.18055555555555555
"[0, 1, 1, 1, 0, 0, 0, 0, 0, 0, 1, 0, 1, 1, 1]",208,115,93,11,11,0.09565217391304348,0.11827956989247312
"[0, 1, 1, 1, 1, 1, 0, 0, 1, 0, 0, 1, 1, 0, 0]",179,96,83,6,9,0.0625,0.10843373493975904
"[0, 0, 0, 1, 1, 1, 0, 0, 1, 1, 0, 0, 0, 1, 0]",149,85,64,5,6,0.058823529411764705,0.09375
"[1, 0, 0, 1, 1, 0, 1, 0, 1, 0, 0, 1, 0, 1, 0]",94,48,46,5,4,0.10416666666666667,0.08695652173913043
"[1, 1, 0, 1, 0, 0, 1, 1, 0, 1, 0, 1, 1, 1, 0]",132,59,73,3,6,0.05084745762711865,0.0821917808219178
"[1, 0, 0, 1, 0, 0, 0, 0, 1, 1, 0, 1, 0, 1, 1]",103,49,54,5,4,0.10204081632653061,0.07407407407407407
"[0, 0, 1, 0, 0, 1, 0, 1, 1, 0, 1, 0, 0, 0, 1]",119,67,52,7,5,0.1044776119402985,0.09615384615384616
"[1, 0, 1, 1, 0, 1, 1, 0, 0, 0, 1, 1, 0, 1, 1]",151,48,103,5,14,0.10416666666666667,0.13592233009708737
"[1, 0, 1, 1, 1, 0, 0, 1, 0, 0, 1, 0, 0, 0, 0]",170,97,73,10,5,0.10309278350515463,0.0684931506849315
"[0, 0, 1, 0, 1, 0, 1, 1, 1, 0, 0, 1, 0, 0, 1]",126,68,58,7,5,0.10294117647058823,0.08620689655172414
"[1, 1, 1, 1, 0, 1, 1, 0, 1, 0, 1, 0, 0, 0, 1]",136,49,87,7,9,0.14285714285714285,0.10344827586206896
"[0, 1, 1, 0, 1, 0, 1, 0, 0, 0, 1, 0, 1, 1, 0]",119,65,54,6,4,0.09230769230769231,0.07407407407407407
"[1, 1, 0, 1, 1, 0, 1, 0, 1, 0, 0, 0, 1, 0, 1]",125,54,71,7,10,0.12962962962962962,0.14084507042253522
"[0, 0, 1, 1, 0, 0, 1, 0, 0, 1, 0, 0, 1, 0, 0]",237,160,77,19,7,0.11875,0.09090909090909091
"[0, 0, 0, 1, 0, 1, 1, 1, 0, 0, 0, 1, 0, 0, 1]",159,105,54,6,4,0.05714285714285714,0.07407407407407407
"[1, 0, 1, 0, 0, 0, 0, 0, 1, 1, 1, 1, 1, 0, 1]",124,57,67,9,5,0.15789473684210525,0.07462686567164178
"[1, 1, 0, 1, 1, 0, 1, 0, 0, 0, 0, 1, 0, 0, 1]",126,67,59,2,8,0.029850746268656716,0.13559322033898305
"[0, 1, 1, 1, 0, 1, 1, 0, 1, 1, 0, 1, 0, 1, 1]",252,88,164,12,14,0.13636363636363635,0.08536585365853659
"[0, 0, 1, 1, 0, 1, 1, 0, 1, 0, 0, 1, 1, 1, 1]",226,93,133,7,10,0.07526881720430108,0.07518796992481203
"[0, 1, 0, 0, 0, 1, 0, 0, 0, 1, 1, 1, 0, 0, 1]",166,98,68,8,2,0.08163265306122448,0.029411764705882353
"[1, 0, 1, 1, 0, 0, 1, 0, 1, 1, 0, 1, 1, 0, 0]",119,54,65,3,6,0.05555555555555555,0.09230769230769231
"[1, 0, 0, 0, 0, 1, 0, 1, 0, 1, 1, 0, 0, 1, 1]",178,84,94,7,11,0.08333333333333333,0.11702127659574468
"[1, 1, 0, 1, 1, 0, 0, 0, 0, 1, 0, 1, 0, 1, 0]",126,66,60,6,3,0.09090909090909091,0.05
"[1, 0, 1, 1, 0, 1, 0, 1, 1, 1, 0, 0, 0, 1, 1]",147,57,90,6,10,0.10526315789473684,0.1111111111111111
"[0, 1, 0, 1, 0, 1, 0, 0, 1, 0, 1, 0, 1, 0, 1]",101,50,51,5,9,0.1,0.17647058823529413
"[1, 1, 1, 0, 1, 0, 1, 0, 1, 0, 0, 0, 0, 1, 1]",173,77,96,8,9,0.1038961038961039,0.09375
"[0, 1, 1, 0, 1, 0, 0, 0, 1, 0, 0, 0, 0, 1, 1]",222,133,89,11,12,0.08270676691729323,0.1348314606741573
"[1, 1, 0, 0, 0, 1, 0, 1, 0, 1, 1, 0, 0, 1, 0]",99,56,43,6,6,0.10714285714285714,0.13953488372093023
"[1, 0, 1, 0, 0, 1, 1, 0, 1, 1, 0, 1, 0, 0, 1]",122,56,66,3,5,0.05357142857142857,0.07575757575757576
"[0, 1, 0, 1, 1, 0, 0, 1, 1, 0, 0, 0, 1, 0, 1]",118,58,60,6,3,0.10344827586206896,0.05
"[1, 0, 1, 0, 0, 1, 1, 0, 0, 1, 0, 1, 1, 0, 0]",131,73,58,11,5,0.1506849315068493,0.08620689655172414
"[1, 0, 0, 0, 0, 0, 1, 1, 1, 1, 1, 0, 1, 1, 0]",123,56,67,2,5,0.03571428571428571,0.07462686567164178
"[1, 1, 1, 0, 1, 1, 0, 1, 0, 0, 0, 0, 0, 1, 1]",154,63,91,11,9,0.1746031746031746,0.0989010989010989
"[1, 0, 1, 0, 0, 0, 1, 1, 1, 1, 0, 0, 1, 0, 0]",131,66,65,7,4,0.10606060606060606,0.06153846153846154
"[0, 1, 1, 0, 0, 1, 1, 0, 1, 0, 0, 0, 0, 1, 0]",164,112,52,8,6,0.07142857142857142,0.11538461538461539
"[1, 0, 0, 0, 1, 1, 0, 1, 0, 0, 0, 0, 0, 1, 0]",258,161,97,22,8,0.13664596273291926,0.08247422680412371
"[0, 1, 0, 0, 0, 1, 1, 0, 1, 0, 0, 0, 0, 0, 1]",267,169,98,17,8,0.10059171597633136,0.08163265306122448
"[1, 1, 1, 1, 1, 1, 0, 0, 0, 0, 0, 1, 1, 0, 0]",394,168,226,22,20,0.13095238095238096,0.08849557522123894
"[0, 0, 0, 0, 1, 0, 1, 1, 0, 1, 1, 0, 1, 0, 1]",88,54,34,4,3,0.07407407407407407,0.08823529411764706
"[0, 0, 0, 1, 1, 1, 1, 1, 0, 1, 0, 0, 1, 1, 1]",278,158,120,26,13,0.16455696202531644,0.10833333333333334
"[1, 1, 1, 0, 0, 1, 1, 1, 0, 1, 0, 1, 0, 0, 0]",140,67,73,11,8,0.16417910447761194,0.1095890410958904
"[1, 1, 0, 0, 1, 0, 1, 1, 0, 1, 0, 0, 1, 1, 1]",185,72,113,9,11,0.125,0.09734513274336283
"[1, 1, 1, 0, 0, 1, 0, 1, 1, 0, 1, 0, 0, 1, 1]",180,68,112,10,7,0.14705882352941177,0.0625
"[1, 0, 0, 1, 1, 1, 1, 0, 1, 1, 1, 1, 0, 0, 0]",212,83,129,9,9,0.10843373493975904,0.06976744186046512
"[0, 1, 1, 1, 0, 1, 1, 1, 0, 1, 0, 0, 0, 1, 1]",152,63,89,7,12,0.1111111111111111,0.1348314606741573
"[1, 0, 1, 1, 1, 0, 0, 0, 0, 0, 0, 0, 1, 1, 0]",220,126,94,16,3,0.12698412698412698,0.031914893617021274
"[0, 1, 0, 0, 0, 1, 1, 1, 1, 1, 1, 0, 0, 0, 1]",164,85,79,6,7,0.07058823529411765,0.08860759493670886
"[0, 1, 1, 0, 1, 1, 0, 0, 1, 1, 0, 1, 1, 0, 1]",130,56,74,7,8,0.125,0.10810810810810811
"[0, 1, 1, 1, 1, 1, 0, 0, 0, 0, 1, 1, 0, 1, 0]",145,79,66,7,5,0.08860759493670886,0.07575757575757576
"[1, 0, 1, 1, 1, 0, 0, 0, 1, 0, 0, 1, 0, 1, 1]",110,46,64,0,5,0.0,0.078125
"[1, 1, 1, 1, 1, 0, 0, 1, 1, 1, 0, 1, 0, 0, 0]",237,85,152,6,13,0.07058823529411765,0.08552631578947369
"[0, 1, 1, 1, 1, 0, 1, 0, 0, 0, 1, 1, 0, 0, 1]",150,86,64,8,10,0.09302325581395349,0.15625
"[0, 0, 1, 0, 1, 0, 1, 1, 0, 0, 1, 1, 0, 0, 0]",255,162,93,11,14,0.06790123456790123,0.15053763440860216
"[1, 0, 1, 0, 1, 0, 0, 1, 0, 0, 0, 0, 0, 1, 0]",244,158,86,17,4,0.10759493670886076,0.046511627906976744
"[1, 1, 0, 0, 1, 0, 0, 1, 1, 1, 0, 1, 0, 0, 0]",123,68,55,7,9,0.10294117647058823,0.16363636363636364
"[1, 0, 0, 1, 0, 1, 0, 1, 1, 0, 0, 1, 0, 0, 0]",131,87,44,12,2,0.13793103448275862,0.045454545454545456
"[1, 1, 1, 0, 1, 0, 1, 1, 0, 0, 0, 0, 1, 0, 0]",135,74,61,8,8,0.10810810810810811,0.13114754098360656
"[1, 0, 0, 0, 1, 0, 0, 0, 0, 1, 1, 1, 0, 1, 0]",161,98,63,16,6,0.16326530612244897,0.09523809523809523
"[1, 0, 1, 1, 0, 0, 1, 0, 0, 1, 1, 0, 0, 0, 1]",129,61,68,5,7,0.08196721311475409,0.10294117647058823
"[1, 1, 0, 0, 1, 0, 0, 1, 1, 0, 0, 1, 1, 1, 0]",134,58,76,9,5,0.15517241379310345,0.06578947368421052
"[1, 1, 0, 0, 1, 1, 1, 0, 0, 1, 0, 0, 1, 1, 1]",277,111,166,16,12,0.14414414414414414,0.07228915662650602
"[1, 1, 1, 1, 0, 0, 1, 1, 1, 0, 0, 1, 0, 0, 1]",220,84,136,7,13,0.08333333333333333,0.09558823529411764
"[1, 0, 1, 1, 0, 1, 0, 0, 1, 1, 1, 0, 1, 0, 1]",139,56,83,7,8,0.125,0.0963855421686747
"[0, 1, 1, 1, 0, 0, 1, 1, 0, 1, 1, 1, 0, 1, 0]",134,60,74,5,8,0.08333333333333333,0.10810810810810811
"[1, 0, 0, 1, 0, 1, 1, 0, 0, 1, 1, 1, 0, 0, 0]",134,72,62,7,9,0.09722222222222222,0.14516129032258066
"[1, 0, 0, 1, 1, 0, 1, 0, 0, 0, 0, 0, 0, 1, 1]",293,143,150,11,15,0.07692307692307693,0.1
"[0, 0, 1, 0, 1, 0, 1, 1, 1, 1, 0, 0, 1, 0, 0]",126,57,69,4,6,0.07017543859649122,0.08695652173913043
"[1, 0, 0, 0, 1, 1, 0, 1, 1, 0, 0, 1, 0, 1, 1]",93,45,48,3,8,0.06666666666666667,0.16666666666666666
"[1, 0, 1, 1, 0, 0, 1, 0, 0, 1, 1, 1, 1, 0, 0]",176,77,99,8,11,0.1038961038961039,0.1111111111111111
"[0, 0, 0, 0, 0, 1, 1, 0, 0, 1, 1, 1, 0, 1, 0]",275,195,80,21,4,0.1076923076923077,0.05
"[1, 0, 1, 1, 1, 0, 1, 0, 1, 0, 0, 0, 0, 0, 1]",118,58,60,2,6,0.034482758620689655,0.1
"[1, 0, 0, 1, 0, 1, 0, 0, 1, 0, 1, 0, 1, 1, 1]",125,61,64,5,8,0.08196721311475409,0.125
"[1, 0, 1, 0, 0, 1, 0, 1, 1, 1, 1, 0, 1, 1, 1]",267,91,176,13,14,0.14285714285714285,0.07954545454545454
"[1, 1, 0, 1, 0, 1, 0, 1, 0, 0, 1, 0, 1, 1, 1]",149,62,87,3,8,0.04838709677419355,0.09195402298850575
"[1, 1, 1, 1, 0, 1, 0, 0, 0, 0, 1, 1, 0, 0, 1]",224,107,117,7,9,0.06542056074766354,0.07692307692307693
"[1, 0, 1, 1, 0, 0, 1, 0, 0, 0, 1, 1, 0, 1, 0]",105,54,51,5,7,0.09259259259259259,0.13725490196078433
"[1, 0, 0, 0, 1, 1, 0, 0, 0, 1, 1, 0, 1, 1, 0]",134,71,63,3,8,0.04225352112676056,0.12698412698412698
"[1, 1, 0, 0, 1, 1, 0, 1, 1, 1, 0, 1, 0, 0, 1]",151,63,88,8,9,0.12698412698412698,0.10227272727272728
"[0, 1, 0, 1, 0, 1, 0, 1, 1, 1, 0, 0, 0, 1, 0]",91,47,44,4,6,0.0851063829787234,0.13636363636363635
"[0, 0, 0, 0, 1, 0, 1, 0, 1, 1, 0, 1, 1, 0, 1]",93,49,44,5,3,0.10204081632653061,0.06818181818181818
"[1, 1, 0, 1, 0, 0, 1, 1, 0, 1, 0, 0, 0, 0, 1]",108,59,49,7,5,0.11864406779661017,0.10204081632653061
"[0, 0, 1, 0, 0, 0, 1, 1, 0, 0, 1, 0, 1, 0, 0]",237,161,76,19,12,0.11801242236024845,0.15789473684210525
"[1, 1, 0, 0, 0, 0, 1, 1, 0, 0, 1, 0, 1, 0, 1]",244,121,123,15,12,0.12396694214876033,0.0975609756097561
"[0, 0, 0, 0, 0, 1, 1, 0, 1, 1, 0, 1, 1, 0, 0]",185,132,53,12,9,0.09090909090909091,0.16981132075471697
"[0, 1, 0, 1, 1, 0, 1, 0, 1, 1, 0, 0, 1, 0, 0]",120,63,57,9,2,0.14285714285714285,0.03508771929824561
"[1, 1, 0, 0, 1, 1, 0, 0, 1, 1, 0, 0, 1, 0, 1]",335,169,166,11,16,0.0650887573964497,0.0963855421686747
"[1, 0, 1, 1, 0, 1, 0, 1, 0, 0, 0, 1, 0, 0, 1]",94,47,47,4,5,0.0851063829787234,0.10638297872340426
"[0, 0, 1, 1, 1, 1, 0, 0, 0, 0, 1, 0, 0, 1, 1]",343,190,153,17,14,0.08947368421052632,0.0915032679738562
"[1, 1, 0, 1, 1, 0, 1, 0, 1, 1, 0, 0, 1, 0, 0]",117,49,68,5,8,0.10204081632653061,0.11764705882352941
"[0, 0, 0, 0, 0, 1, 0, 1, 1, 1, 0, 1, 1, 0, 1]",114,59,55,4,5,0.06779661016949153,0.09090909090909091
"[1, 1, 0, 0, 1, 0, 1, 1, 0, 1, 1, 1, 1, 0, 0]",208,82,126,5,12,0.06097560975609756,0.09523809523809523
"[1, 0, 0, 1, 1, 1, 1, 1, 0, 0, 0, 1, 0, 1, 0]",119,47,72,7,4,0.14893617021276595,0.05555555555555555
"[1, 0, 1, 1, 0, 0, 1, 0, 0, 1, 1, 0, 0, 1, 0]",102,53,49,3,2,0.05660377358490566,0.04081632653061224
"[1, 0, 1, 1, 1, 1, 0, 1, 0, 0, 0, 1, 0, 1, 0]",108,56,52,4,6,0.07142857142857142,0.11538461538461539
"[1, 0, 1, 0, 0, 0, 0, 0, 1, 1, 1, 0, 0, 1, 0]",164,90,74,9,4,0.1,0.05405405405405406
"[1, 0, 1, 0, 0, 1, 0, 1, 1, 0, 0, 0, 1, 1, 0]",121,65,56,3,5,0.046153846153846156,0.08928571428571429
"[0, 1, 0, 0, 0, 1, 0, 1, 0, 0, 1, 0, 1, 1, 0]",160,105,55,9,6,0.08571428571428572,0.10909090909090909
"[0, 1, 0, 0, 0, 1, 0, 1, 0, 1, 0, 0, 1, 1, 0]",136,82,54,6,10,0.07317073170731707,0.18518518518518517
"[0, 0, 1, 0, 0, 1, 0, 0, 0, 1, 0, 1, 0, 1, 0]",203,131,72,14,6,0.10687022900763359,0.08333333333333333
"[1, 1, 0, 0, 0, 0, 1, 1, 1, 0, 1, 0, 0, 1, 0]",138,86,52,3,5,0.03488372093023256,0.09615384615384616
"[1, 0, 1, 1, 0, 1, 1, 1, 1, 1, 0, 0, 0, 0, 1]",289,115,174,10,16,0.08695652173913043,0.09195402298850575
"[1, 0, 1, 0, 1, 1, 0, 0, 1, 1, 0, 0, 1, 0, 0]",119,67,52,3,3,0.04477611940298507,0.057692307692307696
"[1, 0, 1, 0, 1, 0, 1, 0, 1, 1, 0, 0, 1, 1, 0]",140,61,79,9,4,0.14754098360655737,0.05063291139240506
"[0, 1, 1, 0, 0, 0, 1, 1, 1, 0, 0, 1, 1, 0, 1]",124,69,55,7,2,0.10144927536231885,0.03636363636363636
"[0, 0, 0, 1, 0, 0, 0, 0, 1, 1, 0, 1, 1, 1, 1]",179,101,78,12,6,0.1188118811881188,0.07692307692307693
"[0, 1, 0, 0, 1, 0, 0, 0, 1, 0, 1, 1, 0, 0, 1]",172,95,77,14,11,0.14736842105263157,0.14285714285714285
"[1, 1, 1, 0, 1, 0, 1, 0, 1, 0, 1, 0, 0, 1, 0]",116,59,57,8,8,0.13559322033898305,0.14035087719298245
"[0, 1, 0, 1, 1, 1, 0, 1, 0, 1, 0, 1, 0, 1, 0]",107,53,54,2,6,0.03773584905660377,0.1111111111111111
"[1, 0, 1, 0, 1, 1, 1, 0, 0, 1, 0, 0, 1, 1, 0]",117,58,59,6,7,0.10344827586206896,0.11864406779661017
"[1, 0, 0, 0, 0, 1, 1, 1, 0, 1, 1, 1, 0, 0, 1]",173,57,116,7,13,0.12280701754385964,0.11206896551724138
"[1, 1, 0, 0, 0, 1, 0, 0, 0, 1, 1, 1, 1, 1, 1]",282,116,166,6,16,0.05172413793103448,0.0963855421686747
"[1, 0, 0, 0, 0, 0, 1, 0, 1, 1, 1, 1, 0, 1, 1]",120,63,57,6,5,0.09523809523809523,0.08771929824561403
"[1, 0, 1, 1, 1, 1, 1, 0, 0, 0, 0, 0, 1, 0, 1]",131,64,67,6,8,0.09375,0.11940298507462686
"[0, 0, 1, 1, 1, 1, 1, 0, 1, 1, 0, 0, 0, 1, 0]",123,59,64,4,5,0.06779661016949153,0.078125
"[1, 0, 1, 1, 0, 0, 1, 1, 1, 0, 0, 0, 0, 1, 0]",102,61,41,3,3,0.04918032786885246,0.07317073170731707
"[1, 1, 0, 1, 1, 0, 0, 1, 1, 1, 0, 0, 0, 0, 1]",142,61,81,3,8,0.04918032786885246,0.09876543209876543
"[0, 1, 0, 0, 1, 0, 0, 1, 0, 0, 0, 1, 0, 0, 1]",231,152,79,16,3,0.10526315789473684,0.0379746835443038
"[0, 1, 1, 1, 0, 0, 0, 1, 0, 0, 1, 0, 0, 1, 0]",146,87,59,9,2,0.10344827586206896,0.03389830508474576
"[0, 0, 1, 1, 1, 1, 0, 1, 0, 1, 1, 1, 1, 0, 0]",215,89,126,6,9,0.06741573033707865,0.07142857142857142
"[1, 1, 1, 0, 1, 1, 0, 0, 1, 1, 0, 0, 1, 0, 0]",125,57,68,10,6,0.17543859649122806,0.08823529411764706
"[1, 1, 0, 1, 0, 1, 1, 0, 1, 1, 1, 0, 0, 1, 0]",125,55,70,5,7,0.09090909090909091,0.1
"[0, 1, 1, 0, 1, 0, 1, 1, 1, 0, 0, 0, 1, 1, 0]",113,53,60,3,4,0.05660377358490566,0.06666666666666667
"[0, 1, 1, 0, 1, 0, 0, 0, 1, 1, 1, 1, 1, 1, 1]",398,141,257,16,25,0.11347517730496454,0.09727626459143969
"[0, 0, 0, 1, 0, 1, 1, 1, 1, 1, 1, 1, 1, 0, 1]",260,104,156,14,16,0.1346153846153846,0.10256410256410256
"[0, 1, 1, 1, 1, 0, 0, 1, 0, 1, 0, 1, 0, 0, 0]",144,90,54,10,4,0.1111111111111111,0.07407407407407407
"[0, 1, 1, 0, 0, 0, 1, 1, 0, 1, 0, 1, 1, 1, 1]",190,96,94,9,7,0.09375,0.07446808510638298
"[1, 0, 1, 0, 1, 1, 0, 0, 0, 0, 1, 0, 0, 1, 0]",148,87,61,10,10,0.11494252873563218,0.16393442622950818
"[0, 1, 0, 1, 1, 1, 0, 0, 0, 0, 0, 1, 1, 1, 0]",125,69,56,6,8,0.08695652173913043,0.14285714285714285
"[1, 1, 0, 1, 0, 1, 1, 1, 1, 0, 0, 1, 0, 1, 0]",143,49,94,1,10,0.02040816326530612,0.10638297872340426
"[0, 0, 1, 0, 0, 0, 1, 1, 1, 1, 0, 0, 1, 0, 0]",175,101,74,6,9,0.0594059405940594,0.12162162162162163
"[1, 1, 1, 1, 0, 1, 1, 1, 0, 0, 0, 0, 1, 0, 0]",136,66,70,7,4,0.10606060606060606,0.05714285714285714
"[1, 0, 0, 0, 0, 0, 1, 1, 0, 1, 1, 0, 0, 1, 0]",155,89,66,8,5,0.0898876404494382,0.07575757575757576
"[1, 1, 0, 1, 1, 1, 1, 1, 1, 0, 0, 1, 0, 0, 1]",249,103,146,12,14,0.11650485436893204,0.0958904109589041
"[0, 0, 1, 1, 1, 1, 1, 0, 0, 1, 0, 0, 1, 1, 0]",170,90,80,9,7,0.1,0.0875
"[1, 0, 0, 0, 0, 1, 1, 0, 1, 0, 0, 1, 1, 0, 0]",219,104,115,14,11,0.1346153846153846,0.09565217391304348
"[1, 0, 1, 0, 1, 0, 1, 1, 0, 1, 1, 0, 1, 1, 0]",108,45,63,5,5,0.1111111111111111,0.07936507936507936
"[1, 1, 0, 0, 1, 0, 1, 1, 1, 0, 1, 1, 1, 0, 0]",160,72,88,5,11,0.06944444444444445,0.125
"[1, 0, 1, 1, 0, 0, 0, 1, 1, 1, 1, 0, 0, 1, 0]",119,54,65,7,6,0.12962962962962962,0.09230769230769231
"[0, 0, 1, 0, 1, 1, 1, 1, 0, 0, 0, 0, 1, 0, 0]",163,102,61,7,11,0.06862745098039216,0.18032786885245902
"[0, 0, 0, 0, 0, 1, 1, 0, 1, 0, 1, 0, 1, 1, 0]",173,103,70,6,4,0.05825242718446602,0.05714285714285714
"[0, 1, 1, 1, 0, 1, 1, 0, 1, 1, 0, 0, 0, 0, 1]",134,64,70,4,11,0.0625,0.15714285714285714
"[1, 0, 0, 0, 0, 0, 1, 0, 0, 1, 1, 0, 1, 1, 1]",163,77,86,6,4,0.07792207792207792,0.046511627906976744
"[0, 0, 1, 1, 1, 0, 0, 1, 0, 1, 1, 0, 0, 1, 0]",104,61,43,4,6,0.06557377049180328,0.13953488372093023
"[0, 0, 1, 1, 0, 0, 0, 0, 0, 1, 1, 1, 0, 1, 0]",187,104,83,12,5,0.11538461538461539,0.060240963855421686
"[0, 1, 1, 1, 0, 0, 1, 0, 0, 0, 0, 0, 0, 1, 1]",273,166,107,12,9,0.07228915662650602,0.08411214953271028
"[0, 0, 1, 0, 1, 1, 0, 0, 0, 1, 1, 1, 0, 0, 1]",135,71,64,7,6,0.09859154929577464,0.09375
"[0, 1, 0, 1, 1, 1, 1, 0, 0, 1, 0, 0, 0, 0, 1]",123,64,59,6,8,0.09375,0.13559322033898305
"[0, 1, 0, 1, 1, 0, 0, 1, 0, 1, 0, 0, 1, 1, 1]",134,59,75,4,7,0.06779661016949153,0.09333333333333334
"[0, 0, 1, 0, 1, 1, 1, 1, 0, 0, 0, 1, 1, 1, 0]",119,57,62,10,5,0.17543859649122806,0.08064516129032258
"[0, 1, 0, 0, 1, 1, 1, 1, 0, 0, 0, 0, 1, 0, 1]",139,79,60,8,9,0.10126582278481013,0.15
"[1, 1, 0, 0, 0, 1, 0, 0, 0, 0, 1, 1, 1, 0, 1]",128,70,58,7,7,0.1,0.1206896551724138
"[1, 0, 0, 0, 0, 1, 1, 0, 1, 0, 1, 0, 1, 0, 1]",144,53,91,3,5,0.05660377358490566,0.054945054945054944
"[0, 1, 0, 1, 0, 0, 1, 0, 1, 1, 1, 1, 0, 1, 0]",101,48,53,2,8,0.041666666666666664,0.1509433962264151
"[1, 1, 1, 1, 0, 1, 1, 0, 0, 1, 0, 1, 0, 0, 0]",112,58,54,4,6,0.06896551724137931,0.1111111111111111
"[1, 0, 1, 0, 0, 1, 1, 0, 1, 0, 0, 0, 1, 0, 0]",127,74,53,5,4,0.06756756756756757,0.07547169811320754
"[0, 0, 0, 1, 0, 1, 0, 0, 1, 1, 0, 1, 0, 0, 0]",239,151,88,15,6,0.09933774834437085,0.06818181818181818
"[0, 0, 0, 0, 1, 0, 1, 0, 0, 1, 0, 1, 0, 1, 1]",153,94,59,10,8,0.10638297872340426,0.13559322033898305
"[0, 1, 0, 1, 0, 1, 1, 0, 0, 0, 1, 0, 0, 0, 0]",244,161,83,9,7,0.055900621118012424,0.08433734939759036
"[1, 0, 1, 0, 1, 0, 1, 1, 0, 0, 0, 1, 0, 0, 0]",143,83,60,6,4,0.07228915662650602,0.06666666666666667
"[0, 0, 1, 1, 1, 0, 0, 0, 0, 1, 0, 1, 1, 0, 1]",111,62,49,7,3,0.11290322580645161,0.061224489795918366
"[0, 1, 1, 1, 0, 1, 0, 0, 1, 1, 0, 1, 0, 0, 0]",125,64,61,6,4,0.09375,0.06557377049180328
"[1, 1, 0, 1, 1, 1, 1, 0, 1, 1, 0, 0, 0, 1, 0]",134,54,80,6,8,0.1111111111111111,0.1
"[0, 0, 0, 1, 1, 1, 1, 0, 0, 0, 0, 1, 0, 0, 1]",336,247,89,22,6,0.08906882591093117,0.06741573033707865
"[1, 1, 0, 0, 0, 1, 1, 1, 0, 1, 0, 1, 0, 0, 1]",116,46,70,0,5,0.0,0.07142857142857142
"[1, 0, 0, 1, 0, 0, 0, 1, 0, 0, 1, 1, 0, 1, 1]",131,82,49,8,6,0.0975609756097561,0.12244897959183673
"[0, 0, 1, 0, 0, 1, 1, 0, 0, 0, 1, 0, 1, 0, 0]",282,172,110,24,9,0.13953488372093023,0.08181818181818182
"[1, 1, 0, 1, 1, 1, 1, 0, 1, 0, 1, 0, 0, 0, 1]",152,51,101,5,9,0.09803921568627451,0.0891089108910891
"[0, 0, 1, 1, 0, 1, 0, 1, 1, 0, 0, 1, 0, 1, 0]",105,53,52,6,6,0.11320754716981132,0.11538461538461539
"[1, 1, 0, 1, 0, 1, 1, 0, 0, 1, 0, 0, 0, 1, 0]",119,70,49,5,4,0.07142857142857142,0.08163265306122448
"[1, 0, 0, 1, 0, 1, 1, 1, 1, 0, 1, 0, 1, 1, 0]",140,58,82,9,5,0.15517241379310345,0.06097560975609756
"[0, 1, 1, 1, 1, 1, 1, 1, 0, 0, 0, 1, 0, 1, 0]",182,94,88,9,9,0.09574468085106383,0.10227272727272728
"[1, 0, 1, 0, 1, 1, 1, 0, 1, 0, 1, 1, 0, 1, 0]",125,43,82,5,6,0.11627906976744186,0.07317073170731707
"[1, 1, 0, 1, 1, 1, 0, 0, 1, 0, 1, 1, 0, 1, 0]",119,52,67,7,11,0.1346153846153846,0.16417910447761194
"[0, 0, 0, 1, 0, 0, 1, 0, 1, 1, 0, 1, 0, 1, 1]",118,70,48,8,2,0.11428571428571428,0.041666666666666664
"[1, 1, 1, 0, 0, 0, 0, 1, 1, 1, 0, 1, 1, 0, 0]",195,76,119,5,10,0.06578947368421052,0.08403361344537816
"[1, 0, 1, 0, 1, 1, 1, 1, 1, 0, 0, 0, 0, 1, 0]",129,57,72,5,6,0.08771929824561403,0.08333333333333333
"[0, 1, 0, 1, 0, 0, 1, 0, 1, 1, 0, 0, 0, 1, 0]",122,81,41,10,9,0.12345679012345678,0.21951219512195122
"[1, 1, 0, 0, 1, 0, 0, 0, 1, 0, 1, 1, 0, 1, 1]",128,55,73,7,10,0.12727272727272726,0.136986301369863
"[0, 0, 1, 0, 0, 0, 0, 1, 1, 1, 1, 1, 0, 1, 0]",113,56,57,0,4,0.0,0.07017543859649122
"[1, 1, 0, 0, 0, 1, 0, 0, 1, 0, 1, 1, 0, 0, 1]",120,67,53,2,11,0.029850746268656716,0.20754716981132076
"[1, 0, 1, 0, 0, 0, 1, 0, 1, 0, 0, 1, 1, 1, 0]",112,62,50,3,10,0.04838709677419355,0.2
"[0, 0, 0, 1, 1, 0, 1, 0, 0, 1, 1, 1, 1, 0, 1]",127,68,59,8,6,0.11764705882352941,0.1016949152542373
"[1, 0, 1, 1, 0, 1, 0, 0, 0, 0, 0, 1, 1, 0, 1]",108,56,52,6,2,0.10714285714285714,0.038461538461538464
"[1, 1, 0, 1, 1, 1, 0, 0, 0, 1, 0, 1, 0, 0, 0]",124,64,60,11,0,0.171875,0.0
"[0, 0, 1, 0, 1, 0, 1, 0, 0, 0, 0, 1, 0, 0, 1]",221,137,84,9,8,0.06569343065693431,0.09523809523809523
"[0, 1, 0, 1, 0, 0, 1, 1, 0, 1, 0, 1, 1, 1, 1]",180,82,98,8,11,0.0975609756097561,0.11224489795918367
"[0, 0, 1, 0, 1, 1, 0, 1, 1, 0, 0, 0, 0, 1, 1]",200,114,86,10,7,0.08771929824561403,0.08139534883720931
"[0, 1, 0, 0, 0, 0, 1, 1, 0, 1, 0, 1, 0, 1, 0]",134,73,61,5,6,0.0684931506849315,0.09836065573770492
"[0, 1, 1, 1, 0, 1, 0, 1, 0, 0, 1, 0, 0, 0, 0]",153,91,62,9,4,0.0989010989010989,0.06451612903225806
"[1, 0, 1, 0, 1, 0, 1, 1, 1, 0, 1, 0, 1, 0, 1]",113,52,61,6,9,0.11538461538461539,0.14754098360655737
"[0, 1, 0, 1, 0, 1, 0, 1, 1, 1, 0, 1, 0, 1, 0]",94,48,46,2,5,0.041666666666666664,0.10869565217391304
"[1, 1, 0, 0, 1, 0, 1, 0, 1, 0, 1, 1, 1, 0, 1]",123,59,64,9,4,0.15254237288135594,0.0625
"[1, 0, 1, 1, 1, 1, 0, 1, 1, 0, 0, 0, 0, 1, 0]",105,44,61,8,5,0.18181818181818182,0.08196721311475409
"[1, 0, 1, 0, 1, 1, 0, 0, 1, 0, 1, 0, 1, 1, 0]",102,47,55,7,5,0.14893617021276595,0.09090909090909091
"[0, 0, 0, 1, 1, 0, 0, 1, 0, 1, 0, 1, 1, 1, 0]",115,65,50,9,5,0.13846153846153847,0.1
"[0, 1, 0, 0, 0, 0, 0, 1, 1, 1, 1, 1, 0, 1, 1]",133,71,62,4,4,0.056338028169014086,0.06451612903225806
"[0, 1, 1, 1, 0, 0, 0, 1, 1, 0, 1, 1, 1, 1, 0]",168,82,86,12,8,0.14634146341463414,0.09302325581395349
"[1, 1, 0, 0, 0, 1, 1, 1, 0, 0, 0, 1, 1, 0, 0]",160,80,80,10,5,0.125,0.0625
"[0, 0, 0, 1, 1, 0, 1, 1, 0, 1, 1, 1, 0, 1, 0]",102,50,52,6,6,0.12,0.11538461538461539
"[1, 0, 1, 1, 1, 0, 0, 0, 1, 1, 0, 1, 1, 0, 1]",137,54,83,4,8,0.07407407407407407,0.0963855421686747
"[0, 1, 1, 1, 1, 1, 0, 1, 0, 0, 0, 0, 0, 1, 0]",112,65,47,4,4,0.06153846153846154,0.0851063829787234
"[1, 1, 1, 0, 0, 0, 0, 1, 1, 1, 1, 1, 0, 0, 0]",291,102,189,8,12,0.0784313725490196,0.06349206349206349
"[1, 0, 1, 1, 1, 1, 0, 0, 0, 0, 1, 0, 0, 0, 0]",171,104,67,11,6,0.10576923076923077,0.08955223880597014
"[0, 1, 1, 1, 0, 1, 0, 1, 0, 1, 1, 0, 1, 0, 0]",98,46,52,3,2,0.06521739130434782,0.038461538461538464
"[0, 0, 1, 0, 0, 0, 0, 1, 0, 1, 1, 0, 0, 1, 1]",199,116,83,12,7,0.10344827586206896,0.08433734939759036
"[0, 1, 1, 0, 1, 1, 0, 0, 0, 1, 0, 1, 1, 1, 0]",107,57,50,4,6,0.07017543859649122,0.12
"[1, 0, 0, 0, 1, 1, 0, 1, 1, 0, 1, 0, 0, 0, 0]",169,96,73,11,13,0.11458333333333333,0.1780821917808219
"[1, 0, 0, 0, 1, 1, 1, 1, 0, 0, 0, 0, 0, 1, 1]",229,119,110,12,13,0.10084033613445378,0.11818181818181818
"[1, 1, 1, 0, 0, 0, 1, 1, 1, 0, 1, 0, 1, 0, 0]",131,66,65,9,4,0.13636363636363635,0.06153846153846154
"[0, 0, 1, 0, 0, 1, 1, 0, 0, 0, 0, 1, 1, 0, 1]",201,127,74,21,6,0.16535433070866143,0.08108108108108109
"[0, 1, 0, 0, 1, 1, 1, 0, 1, 0, 1, 0, 0, 0, 0]",167,89,78,5,5,0.056179775280898875,0.0641025641025641
"[1, 1, 0, 0, 0, 0, 1, 0, 1, 0, 0, 1, 1, 1, 0]",130,60,70,7,6,0.11666666666666667,0.08571428571428572
"[1, 1, 1, 0, 0, 1, 1, 0, 0, 1, 0, 1, 1, 1, 0]",204,65,139,7,10,0.1076923076923077,0.07194244604316546
"[1, 0, 0, 1, 0, 0, 1, 1, 0, 0, 0, 1, 0, 0, 1]",144,83,61,10,4,0.12048192771084337,0.06557377049180328
"[0, 0, 0, 0, 1, 1, 1, 1, 1, 0, 1, 0, 0, 1, 0]",129,79,50,6,3,0.0759493670886076,0.06
"[0, 0, 1, 1, 1, 1, 1, 1, 0, 1, 0, 1, 0, 0, 0]",158,79,79,8,11,0.10126582278481013,0.13924050632911392
"[1, 1, 1, 0, 1, 1, 0, 1, 0, 0, 0, 1, 0, 1, 1]",117,43,74,2,6,0.046511627906976744,0.08108108108108109
"[0, 1, 1, 1, 0, 1, 1, 0, 1, 0, 0, 0, 1, 0, 1]",79,35,44,5,1,0.14285714285714285,0.022727272727272728
"[0, 1, 1, 0, 0, 1, 1, 1, 1, 1, 0, 0, 0, 1, 1]",284,161,123,22,14,0.13664596273291926,0.11382113821138211
"[0, 1, 0, 1, 0, 0, 1, 0, 0, 1, 0, 1, 0, 1, 1]",124,75,49,12,4,0.16,0.08163265306122448
"[1, 0, 1, 1, 1, 0, 0, 0, 1, 1, 0, 0, 1, 0, 0]",106,53,53,7,6,0.1320754716981132,0.11320754716981132
"[1, 1, 0, 0, 0, 1, 0, 0, 1, 0, 0, 1, 0, 1, 0]",139,81,58,7,6,0.08641975308641975,0.10344827586206896
"[1, 0, 1, 1, 1, 1, 1, 0, 1, 1, 1, 0, 0, 0, 1]",234,87,147,8,9,0.09195402298850575,0.061224489795918366
"[0, 1, 1, 0, 0, 0, 1, 0, 0, 1, 1, 0, 1, 0, 0]",147,88,59,11,7,0.125,0.11864406779661017
"[1, 1, 1, 0, 1, 0, 0, 1, 1, 0, 1, 0, 1, 0, 1]",129,58,71,4,8,0.06896551724137931,0.11267605633802817
"[0, 0, 0, 0, 1, 0, 0, 0, 1, 1, 1, 1, 1, 0, 1]",150,86,64,10,2,0.11627906976744186,0.03125
"[1, 0, 0, 0, 0, 1, 0, 0, 1, 1, 0, 1, 0, 0, 1]",165,94,71,6,10,0.06382978723404255,0.14084507042253522
"[0, 0, 0, 0, 0, 1, 0, 1, 1, 1, 1, 0, 0, 1, 0]",147,88,59,10,2,0.11363636363636363,0.03389830508474576
"[1, 0, 1, 1, 1, 0, 0, 1, 0, 0, 1, 0, 1, 0, 1]",124,63,61,7,5,0.1111111111111111,0.08196721311475409
"[1, 1, 1, 1, 0, 1, 0, 0, 1, 0, 1, 1, 0, 1, 0]",131,60,71,6,8,0.1,0.11267605633802817
"[0, 0, 1, 1, 1, 1, 0, 0, 1, 1, 0, 1, 0, 1, 0]",184,91,93,9,5,0.0989010989010989,0.053763440860215055
"[1, 0, 1, 1, 0, 1, 0, 1, 0, 0, 1, 0, 0, 1, 0]",105,53,52,3,3,0.05660377358490566,0.057692307692307696
"[1, 1, 0, 0, 0, 1, 0, 0, 1, 1, 1, 1, 1, 1, 0]",243,118,125,10,12,0.0847457627118644,0.096
"[1, 1, 0, 0, 0, 1, 1, 0, 1, 1, 1, 0, 1, 0, 1]",145,55,90,5,9,0.09090909090909091,0.1
"[0, 0, 1, 0, 1, 1, 1, 0, 0, 1, 0, 1, 0, 1, 0]",113,56,57,3,7,0.05357142857142857,0.12280701754385964
"[0, 1, 0, 0, 1, 1, 0, 1, 0, 1, 1, 1, 0, 0, 1]",125,67,58,5,4,0.07462686567164178,0.06896551724137931
"[1, 1, 0, 1, 0, 0, 0, 1, 0, 0, 1, 1, 0, 1, 0]",108,54,54,0,6,0.0,0.1111111111111111
"[0, 0, 1, 0, 1, 0, 1, 1, 0, 1, 1, 1, 1, 0, 1]",150,59,91,8,8,0.13559322033898305,0.08791208791208792
"[1, 1, 1, 0, 1, 1, 0, 0, 0, 1, 0, 0, 0, 1, 1]",126,53,73,6,5,0.11320754716981132,0.0684931506849315
"[0, 1, 1, 0, 0, 1, 1, 1, 1, 1, 0, 0, 0, 1, 0]",159,96,63,13,10,0.13541666666666666,0.15873015873015872
"[1, 1, 0, 1, 1, 1, 0, 1, 0, 0, 1, 0, 1, 1, 1]",269,106,163,8,9,0.07547169811320754,0.05521472392638037
"[1, 0, 1, 0, 1, 1, 1, 0, 1, 0, 1, 0, 1, 0, 1]",130,50,80,5,9,0.1,0.1125
"[1, 0, 0, 0, 0, 1, 1, 1, 1, 1, 0, 0, 1, 0, 0]",155,73,82,7,14,0.0958904109589041,0.17073170731707318
"[0, 1, 0, 0, 0, 0, 1, 0, 1, 1, 0, 0, 0, 1, 1]",147,87,60,4,7,0.04597701149425287,0.11666666666666667
"[1, 0, 0, 0, 1, 1, 0, 1, 0, 1, 0, 1, 1, 0, 1]",100,53,47,8,2,0.1509433962264151,0.0425531914893617
"[1, 0, 1, 0, 0, 0, 1, 1, 0, 1, 0, 1, 0, 1, 1]",136,69,67,5,9,0.07246376811594203,0.13432835820895522
"[0, 1, 1, 0, 0, 1, 0, 1, 1, 0, 1, 0, 0, 1, 0]",106,51,55,2,6,0.0392156862745098,0.10909090909090909
"[0, 1, 0, 0, 1, 1, 0, 1, 0, 1, 1, 0, 1, 1, 1]",145,61,84,7,8,0.11475409836065574,0.09523809523809523
"[1, 0, 1, 1, 0, 0, 1, 1, 1, 0, 1, 1, 1, 0, 1]",223,84,139,12,11,0.14285714285714285,0.07913669064748201
"[0, 0, 1, 1, 0, 0, 1, 0, 1, 0, 1, 0, 1, 0, 1]",109,56,53,5,4,0.08928571428571429,0.07547169811320754
"[1, 1, 1, 0, 1, 1, 1, 0, 0, 0, 1, 1, 1, 0, 1]",264,83,181,10,23,0.12048192771084337,0.1270718232044199
"[0, 1, 1, 1, 0, 0, 0, 1, 0, 0, 1, 0, 1, 1, 0]",101,60,41,7,4,0.11666666666666667,0.0975609756097561
"[0, 0, 1, 1, 1, 0, 0, 1, 1, 0, 1, 1, 0, 1, 1]",154,70,84,7,8,0.1,0.09523809523809523
"[0, 0, 1, 1, 0, 0, 1, 1, 1, 0, 1, 1, 0, 0, 1]",165,85,80,10,7,0.11764705882352941,0.0875
"[0, 0, 0, 0, 0, 0, 1, 0, 1, 1, 0, 1, 1, 0, 1]",149,93,56,7,10,0.07526881720430108,0.17857142857142858
"[1, 1, 0, 0, 0, 1, 0, 1, 1, 1, 1, 0, 1, 0, 1]",141,50,91,4,6,0.08,0.06593406593406594
"[0, 1, 1, 1, 0, 1, 0, 1, 0, 1, 1, 1, 0, 1, 0]",113,52,61,8,4,0.15384615384615385,0.06557377049180328
"[1, 1, 1, 0, 0, 1, 0, 0, 1, 1, 0, 1, 1, 0, 0]",144,61,83,5,6,0.08196721311475409,0.07228915662650602
"[0, 0, 0, 1, 0, 0, 0, 1, 0, 1, 0, 1, 0, 1, 1]",163,98,65,8,6,0.08163265306122448,0.09230769230769231
"[1, 0, 1, 0, 0, 1, 1, 0, 0, 1, 1, 1, 0, 0, 1]",129,59,70,7,4,0.11864406779661017,0.05714285714285714
"[0, 1, 1, 0, 0, 1, 0, 0, 1, 0, 0, 0, 1, 0, 1]",142,84,58,17,9,0.20238095238095238,0.15517241379310345
"[0, 0, 1, 1, 1, 1, 0, 1, 0, 1, 0, 1, 1, 0, 0]",153,78,75,4,10,0.05128205128205128,0.13333333333333333
"[0, 0, 1, 1, 0, 1, 1, 1, 1, 0, 1, 1, 1, 1, 0]",255,82,173,6,13,0.07317073170731707,0.07514450867052024
"[1, 1, 0, 0, 1, 0, 0, 0, 1, 0, 0, 1, 1, 0, 1]",98,60,38,9,6,0.15,0.15789473684210525
"[0, 1, 1, 0, 0, 1, 0, 0, 0, 1, 0, 0, 1, 1, 0]",178,125,53,15,6,0.12,0.11320754716981132
"[0, 1, 1, 0, 1, 1, 0, 1, 0, 1, 0, 0, 1, 1, 0]",125,72,53,6,4,0.08333333333333333,0.07547169811320754
"[1, 0, 0, 1, 0, 1, 0, 1, 1, 1, 1, 1, 0, 0, 0]",163,66,97,5,4,0.07575757575757576,0.041237113402061855
"[0, 1, 0, 0, 1, 1, 0, 0, 0, 0, 0, 1, 1, 1, 0]",158,86,72,10,7,0.11627906976744186,0.09722222222222222
"[1, 1, 0, 1, 1, 0, 0, 0, 0, 1, 0, 1, 0, 0, 0]",179,102,77,8,8,0.0784313725490196,0.1038961038961039
"[0, 1, 0, 1, 1, 1, 0, 1, 0, 1, 0, 0, 1, 1, 0]",107,55,52,3,4,0.05454545454545454,0.07692307692307693
"[1, 1, 0, 1, 0, 1, 1, 0, 1, 1, 0, 0, 1, 0, 0]",109,50,59,5,3,0.1,0.05084745762711865
"[1, 1, 0, 0, 1, 1, 1, 0, 0, 1, 0, 0, 0, 0, 0]",233,138,95,13,11,0.09420289855072464,0.11578947368421053
"[1, 1, 0, 0, 1, 1, 1, 0, 1, 0, 1, 1, 0, 1, 1]",285,105,180,11,16,0.10476190476190476,0.08888888888888889
"[1, 0, 0, 0, 1, 1, 0, 1, 1, 0, 0, 1, 1, 1, 0]",116,46,70,6,10,0.13043478260869565,0.14285714285714285
"[1, 1, 1, 0, 0, 0, 0, 1, 0, 0, 1, 1, 1, 0, 1]",117,48,69,3,3,0.0625,0.043478260869565216
"[1, 1, 0, 0, 1, 1, 1, 1, 1, 0, 0, 0, 1, 0, 1]",204,91,113,5,8,0.054945054945054944,0.07079646017699115
"[1, 0, 1, 0, 0, 1, 0, 0, 0, 1, 1, 1, 1, 0, 1]",93,40,53,3,5,0.075,0.09433962264150944
"[0, 1, 1, 0, 0, 0, 1, 0, 0, 0, 0, 1, 0, 1, 1]",189,122,67,10,8,0.08196721311475409,0.11940298507462686
"[1, 0, 1, 1, 1, 0, 0, 0, 1, 0, 1, 1, 1, 0, 1]",148,52,96,6,9,0.11538461538461539,0.09375
"[1, 0, 1, 1, 0, 0, 1, 0, 1, 1, 1, 1, 0, 0, 0]",146,66,80,4,3,0.06060606060606061,0.0375
"[1, 0, 1, 0, 0, 0, 0, 1, 0, 1, 0, 1, 0, 0, 0]",240,149,91,16,4,0.10738255033557047,0.04395604395604396
"[1, 1, 0, 1, 1, 0, 1, 1, 1, 0, 0, 0, 0, 0, 1]",137,62,75,3,8,0.04838709677419355,0.10666666666666667
"[1, 1, 1, 0, 1, 1, 0, 1, 1, 1, 0, 0, 0, 0, 0]",193,89,104,9,6,0.10112359550561797,0.057692307692307696
"[1, 0, 1, 0, 0, 0, 0, 0, 0, 1, 1, 1, 1, 1, 0]",173,97,76,10,6,0.10309278350515463,0.07894736842105263
"[0, 0, 0, 1, 0, 0, 0, 0, 0, 1, 1, 1, 0, 1, 1]",159,96,63,5,7,0.052083333333333336,0.1111111111111111
"[1, 1, 0, 1, 0, 0, 0, 0, 1, 1, 0, 1, 1, 0, 1]",115,44,71,3,2,0.06818181818181818,0.028169014084507043
"[1, 1, 1, 0, 0, 1, 1, 1, 0, 0, 0, 0, 1, 0, 0]",117,56,61,4,4,0.07142857142857142,0.06557377049180328
"[0, 1, 1, 1, 0, 0, 0, 0, 0, 1, 1, 1, 0, 1, 0]",128,69,59,7,6,0.10144927536231885,0.1016949152542373
"[1, 1, 0, 1, 0, 1, 1, 1, 1, 0, 0, 0, 0, 0, 1]",165,84,81,9,7,0.10714285714285714,0.08641975308641975
"[1, 0, 1, 0, 1, 1, 1, 1, 0, 0, 0, 0, 0, 1, 0]",115,59,56,9,7,0.15254237288135594,0.125
"[0, 0, 0, 1, 0, 1, 1, 0, 1, 0, 0, 0, 1, 0, 1]",140,79,61,11,8,0.13924050632911392,0.13114754098360656
"[1, 0, 1, 0, 0, 1, 0, 1, 0, 0, 0, 1, 0, 1, 1]",100,55,45,8,4,0.14545454545454545,0.08888888888888889
"[1, 1, 1, 0, 1, 1, 0, 0, 0, 1, 0, 0, 1, 1, 0]",113,49,64,4,3,0.08163265306122448,0.046875
"[0, 0, 1, 0, 1, 1, 0, 1, 0, 0, 1, 1, 0, 0, 1]",151,79,72,8,2,0.10126582278481013,0.027777777777777776
"[0, 0, 1, 1, 0, 0, 1, 0, 1, 1, 1, 1, 0, 0, 1]",172,81,91,11,9,0.13580246913580246,0.0989010989010989
"[1, 1, 0, 0, 1, 1, 0, 1, 1, 0, 0, 1, 0, 0, 1]",138,50,88,6,6,0.12,0.06818181818181818
"[0, 0, 1, 0, 0, 1, 1, 0, 1, 0, 1, 0, 1, 1, 1]",132,56,76,10,8,0.17857142857142858,0.10526315789473684
"[0, 0, 1, 0, 0, 0, 1, 1, 1, 0, 0, 1, 1, 0, 1]",116,64,52,3,1,0.046875,0.019230769230769232
"[1, 1, 1, 0, 0, 1, 0, 0, 0, 1, 1, 1, 0, 0, 1]",132,42,90,4,14,0.09523809523809523,0.15555555555555556
"[0, 1, 1, 1, 0, 1, 0, 0, 1, 0, 0, 0, 0, 0, 1]",163,104,59,11,4,0.10576923076923077,0.06779661016949153
"[0, 1, 1, 1, 0, 1, 1, 1, 1, 0, 0, 1, 0, 1, 0]",127,47,80,5,9,0.10638297872340426,0.1125
"[1, 1, 1, 0, 1, 1, 1, 1, 0, 0, 0, 0, 1, 0, 1]",165,65,100,9,15,0.13846153846153847,0.15
"[0, 1, 0, 1, 1, 0, 0, 1, 0, 0, 1, 0, 1, 0, 1]",91,43,48,2,4,0.046511627906976744,0.08333333333333333
"[0, 1, 0, 1, 0, 1, 1, 0, 0, 1, 0, 0, 1, 0, 1]",101,52,49,7,5,0.1346153846153846,0.10204081632653061
"[1, 1, 1, 0, 0, 0, 1, 0, 1, 1, 0, 0, 0, 0, 1]",132,50,82,2,7,0.04,0.08536585365853659
"[0, 1, 1, 0, 1, 1, 1, 1, 0, 1, 1, 0, 1, 0, 0]",160,75,85,3,10,0.04,0.11764705882352941
"[1, 1, 1, 1, 0, 1, 0, 1, 0, 1, 0, 0, 1, 0, 0]",116,57,59,5,6,0.08771929824561403,0.1016949152542373
"[0, 1, 0, 1, 0, 1, 1, 1, 1, 1, 0, 0, 0, 1, 0]",109,56,53,3,4,0.05357142857142857,0.07547169811320754
"[0, 0, 0, 1, 0, 1, 1, 1, 0, 0, 0, 1, 1, 1, 0]",125,67,58,8,8,0.11940298507462686,0.13793103448275862
"[0, 0, 1, 1, 1, 0, 0, 1, 0, 1, 0, 0, 1, 1, 1]",170,74,96,8,10,0.10810810810810811,0.10416666666666667
"[1, 1, 0, 0, 0, 1, 0, 0, 1, 0, 1, 0, 0, 1, 1]",138,84,54,7,3,0.08333333333333333,0.05555555555555555
"[1, 0, 0, 1, 0, 1, 0, 1, 0, 0, 0, 1, 0, 1, 1]",123,68,55,8,6,0.11764705882352941,0.10909090909090909
"[0, 0, 1, 0, 0, 1, 1, 0, 1, 0, 1, 1, 0, 1, 0]",100,52,48,8,3,0.15384615384615385,0.0625
"[0, 0, 1, 0, 0, 1, 0, 1, 1, 0, 0, 1, 1, 0, 1]",115,59,56,4,2,0.06779661016949153,0.03571428571428571
"[0, 0, 1, 0, 0, 1, 0, 0, 0, 1, 1, 1, 1, 0, 1]",121,57,64,4,3,0.07017543859649122,0.046875
"[1, 1, 0, 1, 0, 0, 1, 0, 0, 0, 1, 0, 1, 1, 1]",127,56,71,5,11,0.08928571428571429,0.15492957746478872
"[1, 0, 0, 1, 0, 0, 1, 0, 1, 0, 1, 1, 0, 0, 1]",108,68,40,4,4,0.058823529411764705,0.1
"[1, 0, 1, 1, 0, 0, 0, 0, 1, 1, 1, 0, 1, 1, 0]",124,56,68,10,5,0.17857142857142858,0.07352941176470588
"[0, 0, 0, 1, 1, 1, 1, 1, 1, 1, 0, 1, 0, 0, 1]",219,126,93,9,8,0.07142857142857142,0.08602150537634409
"[0, 1, 0, 1, 1, 0, 1, 1, 0, 0, 1, 0, 1, 0, 1]",101,47,54,5,4,0.10638297872340426,0.07407407407407407
"[1, 1, 1, 0, 0, 1, 1, 0, 1, 0, 0, 0, 0, 1, 1]",193,60,133,9,13,0.15,0.09774436090225563
"[1, 0, 0, 1, 1, 0, 1, 1, 0, 0, 1, 0, 0, 0, 0]",158,91,67,5,3,0.054945054945054944,0.04477611940298507
"[1, 1, 1, 0, 0, 0, 0, 1, 1, 1, 0, 0, 1, 0, 1]",153,41,112,5,11,0.12195121951219512,0.09821428571428571
"[1, 0, 1, 1, 0, 1, 0, 0, 1, 0, 0, 0, 1, 0, 1]",102,56,46,5,2,0.08928571428571429,0.043478260869565216
"[0, 1, 1, 0, 0, 0, 1, 1, 1, 1, 1, 0, 0, 1, 0]",120,69,51,3,6,0.043478260869565216,0.11764705882352941
"[1, 1, 1, 0, 1, 0, 0, 1, 0, 1, 0, 0, 1, 0, 1]",115,50,65,4,5,0.08,0.07692307692307693
"[1, 1, 0, 0, 0, 1, 1, 0, 1, 1, 0, 1, 1, 0, 0]",139,62,77,5,4,0.08064516129032258,0.05194805194805195
"[1, 1, 0, 1, 1, 0, 0, 0, 1, 1, 1, 0, 0, 1, 1]",201,87,114,6,5,0.06896551724137931,0.043859649122807015
"[0, 1, 1, 0, 0, 0, 1, 1, 0, 0, 1, 1, 1, 0, 1]",132,69,63,7,7,0.10144927536231885,0.1111111111111111
"[0, 0, 0, 1, 0, 0, 1, 1, 1, 0, 0, 0, 1, 1, 1]",183,98,85,9,6,0.09183673469387756,0.07058823529411765
"[0, 1, 0, 1, 1, 0, 1, 0, 1, 1, 1, 1, 0, 0, 1]",196,75,121,7,11,0.09333333333333334,0.09090909090909091
"[0, 0, 0, 1, 0, 1, 0, 1, 0, 0, 1, 1, 0, 1, 1]",115,62,53,6,4,0.0967741935483871,0.07547169811320754
"[1, 1, 0, 0, 1, 0, 1, 0, 0, 0, 1, 1, 0, 1, 0]",91,44,47,5,4,0.11363636363636363,0.0851063829787234
"[0, 1, 1, 0, 0, 1, 0, 1, 0, 0, 0, 1, 1, 0, 1]",100,48,52,5,5,0.10416666666666667,0.09615384615384616
"[0, 1, 0, 0, 1, 0, 0, 0, 1, 0, 1, 1, 1, 0, 0]",159,90,69,4,5,0.044444444444444446,0.07246376811594203
"[0, 1, 0, 1, 1, 0, 1, 0, 0, 1, 0, 1, 0, 1, 1]",99,53,46,5,4,0.09433962264150944,0.08695652173913043
"[0, 0, 1, 0, 1, 1, 0, 1, 0, 0, 1, 0, 1, 0, 1]",92,59,33,8,4,0.13559322033898305,0.12121212121212122
"[1, 1, 1, 0, 1, 0, 0, 0, 0, 1, 1, 0, 1, 0, 1]",103,44,59,4,4,0.09090909090909091,0.06779661016949153
"[0, 0, 0, 0, 0, 0, 1, 0, 1, 0, 1, 1, 1, 1, 0]",217,136,81,25,13,0.18382352941176472,0.16049382716049382
"[1, 1, 1, 0, 1, 1, 0, 1, 1, 0, 0, 0, 1, 1, 0]",158,59,99,5,11,0.0847457627118644,0.1111111111111111
"[1, 0, 0, 0, 0, 0, 1, 0, 1, 1, 0, 0, 0, 0, 1]",328,211,117,19,8,0.09004739336492891,0.06837606837606838
"[0, 0, 0, 1, 1, 0, 0, 1, 1, 1, 0, 1, 1, 1, 0]",156,107,49,10,8,0.09345794392523364,0.16326530612244897
"[0, 1, 1, 0, 0, 0, 0, 1, 1, 1, 0, 1, 0, 0, 1]",185,123,62,4,1,0.032520325203252036,0.016129032258064516
"[0, 1, 0, 1, 1, 0, 0, 1, 0, 0, 1, 0, 0, 1, 0]",109,64,45,4,6,0.0625,0.13333333333333333
"[1, 0, 0, 1, 0, 1, 0, 1, 1, 1, 0, 0, 1, 0, 0]",119,67,52,9,3,0.13432835820895522,0.057692307692307696
"[0, 1, 0, 1, 1, 0, 0, 1, 0, 0, 1, 1, 0, 1, 0]",99,50,49,3,6,0.06,0.12244897959183673
"[1, 1, 1, 0, 1, 1, 1, 1, 0, 0, 0, 1, 0, 0, 0]",125,50,75,4,9,0.08,0.12
"[1, 1, 1, 0, 0, 0, 1, 0, 0, 0, 1, 0, 1, 1, 0]",131,79,52,8,3,0.10126582278481013,0.057692307692307696
"[0, 0, 0, 1, 1, 1, 0, 0, 0, 0, 1, 1, 0, 1, 1]",167,108,59,7,6,0.06481481481481481,0.1016949152542373
"[1, 0, 1, 0, 1, 0, 1, 0, 1, 0, 1, 0, 0, 1, 0]",101,50,51,5,7,0.1,0.13725490196078433
"[1, 1, 0, 0, 0, 1, 1, 1, 0, 1, 0, 1, 0, 0, 0]",125,62,63,6,9,0.0967741935483871,0.14285714285714285
"[0, 0, 1, 0, 0, 0, 1, 1, 1, 0, 1, 1, 0, 0, 1]",120,61,59,6,7,0.09836065573770492,0.11864406779661017
"[0, 1, 1, 1, 1, 1, 0, 1, 0, 0, 1, 0, 0, 0, 1]",103,56,47,4,8,0.07142857142857142,0.1702127659574468
"[1, 1, 1, 1, 1, 0, 1, 0, 0, 0, 0, 1, 0, 0, 0]",136,65,71,1,6,0.015384615384615385,0.08450704225352113
"[0, 0, 1, 1, 1, 0, 1, 0, 1, 0, 1, 1, 1, 0, 1]",142,54,88,9,11,0.16666666666666666,0.125
"[1, 1, 0, 0, 0, 0, 0, 1, 1, 1, 1, 1, 1, 1, 0]",293,121,172,10,6,0.08264462809917356,0.03488372093023256
"[1, 0, 1, 1, 1, 1, 1, 1, 0, 0, 0, 1, 0, 0, 1]",166,60,106,4,6,0.06666666666666667,0.05660377358490566
"[1, 1, 0, 1, 1, 1, 1, 1, 1, 0, 0, 0, 1, 0, 0]",187,84,103,8,8,0.09523809523809523,0.07766990291262135
"[0, 1, 0, 0, 1, 0, 1, 1, 0, 1, 1, 0, 0, 0, 1]",126,71,55,3,4,0.04225352112676056,0.07272727272727272
"[1, 0, 1, 1, 1, 0, 1, 0, 1, 0, 1, 0, 0, 0, 1]",104,41,63,4,6,0.0975609756097561,0.09523809523809523
"[0, 1, 0, 0, 0, 1, 1, 1, 0, 0, 0, 1, 1, 1, 0]",127,68,59,7,6,0.10294117647058823,0.1016949152542373
"[0, 0, 1, 0, 1, 0, 0, 1, 0, 1, 0, 1, 0, 1, 1]",109,67,42,9,5,0.13432835820895522,0.11904761904761904
"[1, 0, 1, 0, 1, 1, 1, 0, 0, 1, 0, 0, 0, 0, 0]",182,104,78,8,4,0.07692307692307693,0.05128205128205128
"[1, 1, 0, 1, 1, 1, 0, 0, 0, 0, 0, 1, 1, 0, 1]",105,46,59,3,7,0.06521739130434782,0.11864406779661017
"[1, 0, 0, 1, 0, 0, 0, 1, 1, 1, 1, 0, 1, 0, 1]",98,43,55,4,5,0.09302325581395349,0.09090909090909091
"[1, 1, 0, 0, 0, 1, 0, 1, 1, 1, 1, 0, 0, 1, 0]",103,37,66,3,5,0.08108108108108109,0.07575757575757576
"[1, 0, 1, 0, 0, 1, 1, 1, 1, 0, 0, 0, 0, 0, 1]",154,81,73,2,7,0.024691358024691357,0.0958904109589041
"[0, 1, 1, 1, 0, 1, 1, 1, 1, 1, 0, 1, 0, 0, 0]",152,61,91,5,9,0.08196721311475409,0.0989010989010989
"[1, 0, 0, 0, 1, 1, 1, 1, 0, 1, 1, 1, 1, 0, 1]",223,72,151,7,15,0.09722222222222222,0.09933774834437085
"[1, 0, 0, 0, 1, 0, 0, 0, 1, 1, 1, 1, 1, 1, 0]",195,101,94,6,12,0.0594059405940594,0.1276595744680851
"[1, 0, 1, 1, 1, 0, 1, 0, 0, 1, 0, 1, 0, 1, 1]",125,43,82,4,3,0.09302325581395349,0.036585365853658534
"[1, 0, 1, 0, 1, 1, 0, 0, 0, 1, 1, 1, 0, 0, 1]",136,66,70,5,3,0.07575757575757576,0.04285714285714286
"[0, 1, 1, 0, 1, 0, 1, 1, 0, 0, 1, 1, 0, 1, 0]",130,66,64,12,5,0.18181818181818182,0.078125
"[1, 0, 0, 0, 0, 1, 1, 0, 1, 1, 0, 1, 0, 1, 0]",109,58,51,5,4,0.08620689655172414,0.0784313725490196
"[1, 0, 0, 1, 0, 0, 1, 0, 0, 0, 0, 1, 1, 0, 1]",145,76,69,6,5,0.07894736842105263,0.07246376811594203
"[0, 1, 1, 1, 1, 0, 0, 0, 1, 1, 0, 0, 1, 0, 1]",135,77,58,7,6,0.09090909090909091,0.10344827586206896
"[0, 1, 0, 1, 1, 0, 1, 1, 0, 0, 0, 1, 1, 1, 0]",117,62,55,10,4,0.16129032258064516,0.07272727272727272
"[1, 0, 1, 1, 1, 1, 1, 1, 0, 0, 0, 0, 0, 1, 0]",127,60,67,3,2,0.05,0.029850746268656716
"[0, 0, 1, 0, 0, 0, 1, 0, 1, 1, 0, 1, 0, 1, 0]",137,94,43,8,8,0.0851063829787234,0.18604651162790697
"[0, 0, 0, 1, 0, 0, 1, 1, 1, 0, 1, 0, 1, 1, 0]",105,61,44,8,0,0.13114754098360656,0.0
"[0, 1, 0, 1, 1, 0, 0, 1, 0, 0, 1, 1, 1, 0, 1]",108,48,60,3,6,0.0625,0.1
"[1, 0, 1, 1, 0, 0, 0, 1, 1, 0, 0, 0, 1, 0, 1]",103,54,49,6,5,0.1111111111111111,0.10204081632653061
"[1, 1, 1, 0, 0, 0, 1, 1, 0, 1, 1, 0, 1, 1, 0]",161,64,97,9,16,0.140625,0.16494845360824742
"[1, 0, 0, 1, 1, 0, 0, 0, 1, 0, 1, 1, 1, 1, 0]",148,52,96,3,9,0.057692307692307696,0.09375
"[1, 1, 1, 0, 0, 0, 0, 0, 1, 0, 1, 0, 1, 0, 1]",122,59,63,4,5,0.06779661016949153,0.07936507936507936
"[1, 0, 0, 0, 1, 1, 1, 1, 1, 1, 0, 1, 1, 0, 0]",197,82,115,11,14,0.13414634146341464,0.12173913043478261
"[1, 0, 1, 0, 1, 1, 0, 0, 1, 0, 0, 0, 1, 1, 0]",108,51,57,5,5,0.09803921568627451,0.08771929824561403
"[1, 1, 1, 0, 1, 1, 0, 0, 0, 0, 1, 1, 1, 0, 0]",150,77,73,3,13,0.03896103896103896,0.1780821917808219
"[0, 1, 1, 0, 0, 0, 0, 1, 1, 1, 1, 0, 1, 1, 0]",219,144,75,13,4,0.09027777777777778,0.05333333333333334
"[0, 0, 1, 1, 0, 1, 0, 0, 0, 0, 1, 1, 1, 0, 0]",154,83,71,11,8,0.13253012048192772,0.11267605633802817
"[1, 0, 0, 1, 1, 0, 1, 0, 1, 1, 0, 1, 1, 1, 0]",150,50,100,7,12,0.14,0.12
"[0, 1, 0, 1, 1, 0, 0, 0, 1, 0, 1, 0, 1, 1, 0]",128,65,63,6,5,0.09230769230769231,0.07936507936507936
"[1, 1, 0, 1, 1, 1, 0, 0, 1, 0, 0, 0, 1, 1, 1]",190,77,113,13,7,0.16883116883116883,0.061946902654867256
"[0, 0, 0, 1, 1, 0, 1, 0, 0, 0, 1, 1, 1, 1, 1]",214,116,98,14,12,0.1206896551724138,0.12244897959183673
"[0, 1, 0, 1, 0, 1, 0, 0, 1, 0, 0, 1, 0, 0, 1]",143,84,59,7,5,0.08333333333333333,0.0847457627118644
"[1, 0, 1, 0, 1, 0, 1, 0, 1, 0, 0, 1, 0, 1, 0]",99,47,52,2,6,0.0425531914893617,0.11538461538461539
"[1, 1, 1, 0, 1, 0, 1, 1, 1, 0, 0, 0, 1, 0, 1]",131,44,87,4,10,0.09090909090909091,0.11494252873563218
"[0, 0, 1, 1, 0, 1, 0, 1, 1, 0, 1, 1, 1, 0, 1]",143,59,84,4,9,0.06779661016949153,0.10714285714285714
"[0, 0, 1, 1, 1, 1, 0, 0, 0, 1, 1, 1, 0, 0, 1]",183,81,102,5,7,0.06172839506172839,0.06862745098039216
"[1, 1, 0, 0, 0, 1, 1, 0, 1, 0, 0, 1, 0, 1, 1]",115,61,54,13,6,0.21311475409836064,0.1111111111111111
"[1, 1, 1, 0, 1, 0, 1, 0, 1, 1, 0, 1, 1, 1, 0]",238,76,162,5,19,0.06578947368421052,0.11728395061728394
"[0, 0, 1, 0, 0, 1, 1, 0, 1, 1, 0, 1, 0, 1, 1]",112,47,65,3,11,0.06382978723404255,0.16923076923076924
"[0, 1, 1, 0, 1, 0, 0, 0, 1, 0, 0, 1, 1, 0, 1]",97,59,38,3,4,0.05084745762711865,0.10526315789473684
"[0, 1, 1, 0, 0, 0, 1, 0, 0, 1, 0, 0, 0, 1, 1]",156,102,54,11,3,0.10784313725490197,0.05555555555555555
"[0, 0, 1, 1, 1, 0, 1, 0, 1, 0, 1, 0, 1, 0, 0]",107,65,42,6,4,0.09230769230769231,0.09523809523809523
"[0, 1, 1, 0, 1, 1, 0, 1, 0, 1, 0, 0, 0, 1, 0]",103,58,45,9,3,0.15517241379310345,0.06666666666666667
"[1, 0, 1, 0, 1, 0, 0, 1, 0, 0, 0, 1, 1, 1, 0]",113,55,58,8,10,0.14545454545454545,0.1724137931034483
"[1, 0, 1, 0, 1, 0, 0, 1, 0, 1, 0, 1, 1, 1, 0]",109,57,52,8,10,0.14035087719298245,0.19230769230769232
"[0, 1, 1, 1, 0, 1, 0, 0, 1, 0, 1, 0, 0, 1, 0]",105,62,43,6,3,0.0967741935483871,0.06976744186046512
"[1, 1, 1, 0, 0, 1, 1, 0, 0, 1, 0, 1, 0, 0, 0]",182,72,110,5,11,0.06944444444444445,0.1
"[0, 0, 1, 0, 1, 1, 0, 1, 0, 1, 0, 0, 1, 0, 1]",102,55,47,2,4,0.03636363636363636,0.0851063829787234
"[1, 0, 1, 0, 0, 1, 1, 0, 1, 0, 0, 1, 0, 1, 0]",86,42,44,2,4,0.047619047619047616,0.09090909090909091
"[0, 1, 1, 1, 0, 0, 1, 0, 0, 0, 1, 1, 1, 0, 1]",105,41,64,3,6,0.07317073170731707,0.09375
"[0, 0, 1, 0, 1, 0, 0, 1, 1, 0, 0, 1, 0, 0, 1]",141,73,68,9,9,0.1232876712328767,0.1323529411764706
"[0, 0, 0, 0, 1, 1, 1, 0, 1, 1, 0, 1, 0, 1, 0]",122,67,55,5,6,0.07462686567164178,0.10909090909090909
"[1, 0, 1, 1, 1, 0, 0, 1, 0, 0, 0, 1, 1, 1, 0]",109,48,61,6,3,0.125,0.04918032786885246
"[0, 1, 1, 1, 1, 0, 1, 1, 0, 1, 0, 0, 0, 0, 1]",143,79,64,11,6,0.13924050632911392,0.09375
"[1, 1, 1, 1, 0, 0, 1, 0, 0, 0, 0, 1, 0, 1, 0]",111,51,60,11,4,0.21568627450980393,0.06666666666666667
"[0, 0, 0, 1, 0, 1, 1, 0, 0, 0, 1, 1, 0, 1, 0]",132,74,58,7,8,0.0945945945945946,0.13793103448275862
"[1, 0, 0, 1, 0, 0, 0, 1, 0, 1, 1, 1, 0, 1, 0]",96,49,47,5,4,0.10204081632653061,0.0851063829787234
"[0, 0, 0, 1, 1, 0, 1, 0, 1, 1, 0, 1, 1, 1, 0]",114,53,61,3,5,0.05660377358490566,0.08196721311475409
"[0, 1, 1, 1, 0, 0, 1, 1, 0, 1, 0, 0, 0, 1, 0]",87,49,38,6,7,0.12244897959183673,0.18421052631578946
"[1, 0, 1, 1, 1, 1, 0, 1, 0, 1, 1, 0, 0, 1, 0]",119,52,67,4,4,0.07692307692307693,0.05970149253731343
"[1, 0, 0, 0, 0, 0, 1, 0, 1, 1, 1, 0, 1, 0, 1]",89,42,47,1,3,0.023809523809523808,0.06382978723404255
"[0, 0, 0, 0, 0, 1, 1, 1, 0, 0, 1, 0, 0, 0, 0]",675,486,189,45,21,0.09259259259259259,0.1111111111111111
"[1, 1, 1, 1, 1, 1, 0, 0, 0, 0, 0, 0, 0, 1, 1]",710,310,400,34,38,0.10967741935483871,0.095
"[1, 0, 0, 0, 1, 0, 0, 1, 1, 0, 0, 0, 1, 1, 1]",175,87,88,8,7,0.09195402298850575,0.07954545454545454
"[0, 0, 0, 1, 0, 1, 0, 0, 0, 1, 0, 0, 1, 1, 0]",281,202,79,15,7,0.07425742574257425,0.08860759493670886
"[0, 0, 1, 1, 0, 1, 0, 1, 0, 0, 0, 0, 1, 1, 0]",222,141,81,9,7,0.06382978723404255,0.08641975308641975
"[1, 0, 0, 0, 1, 1, 0, 0, 1, 0, 0, 0, 0, 1, 1]",219,130,89,7,12,0.05384615384615385,0.1348314606741573
"[1, 1, 1, 1, 1, 1, 1, 1, 1, 1, 1, 0, 1, 1, 1]",62635,7172,55463,626,5264,0.08728388176240937,0.09491012026035375
"[1, 1, 1, 1, 0, 1, 0, 1, 1, 1, 0, 1, 0, 0, 1]",254,104,150,14,16,0.1346153846153846,0.10666666666666667
"[1, 1, 0, 1, 0, 1, 0, 1, 1, 1, 1, 0, 1, 1, 0]",242,94,148,14,20,0.14893617021276595,0.13513513513513514
"[0, 0, 0, 0, 0, 0, 1, 1, 1, 1, 1, 1, 1, 1, 0]",1691,886,805,75,69,0.08465011286681716,0.08571428571428572
"[1, 1, 1, 1, 1, 1, 0, 0, 0, 0, 0, 0, 0, 0, 0]",2332,1298,1034,125,105,0.0963020030816641,0.10154738878143134
"[1, 1, 1, 1, 1, 0, 1, 1, 1, 1, 1, 1, 1, 1, 1]",63029,7598,55431,738,5203,0.09713082390102659,0.0938644440836355
"[1, 1, 0, 1, 1, 1, 1, 1, 0, 1, 1, 1, 1, 1, 1]",8004,1450,6554,136,623,0.09379310344827586,0.09505645407384804
"[0, 0, 1, 0, 0, 0, 0, 0, 0, 0, 0, 1, 1, 1, 0]",648,456,192,42,14,0.09210526315789473,0.07291666666666667
"[1, 0, 1, 0, 0, 0, 0, 1, 1, 0, 0, 1, 0, 0, 0]",243,147,96,15,12,0.10204081632653061,0.125
"[0, 0, 0, 0, 0, 1, 1, 0, 0, 0, 0, 0, 0, 0, 0]",27544,24548,2996,2269,277,0.0924311552875998,0.092456608811749
"[0, 0, 1, 0, 0, 0, 0, 0, 0, 0, 0, 1, 0, 0, 0]",7060,5815,1245,557,119,0.09578675838349097,0.09558232931726908
"[0, 0, 0, 0, 0, 0, 0, 0, 0, 1, 0, 0, 0, 0, 0]",56409,49895,6514,4694,595,0.09407756288205231,0.09134172551427694
"[0, 1, 0, 0, 0, 0, 0, 0, 0, 0, 0, 0, 0, 0, 0]",68124,59214,8910,5570,825,0.09406559259634546,0.09259259259259259
"[1, 1, 1, 1, 1, 1, 1, 1, 1, 1, 1, 1, 1, 1, 1]",1281893,77715,1204178,7400,115125,0.09521971305410795,0.09560463652383618
"[1, 1, 1, 1, 1, 1, 1, 1, 1, 1, 1, 0, 0, 1, 1]",30128,3459,26669,325,2523,0.09395779126915293,0.09460422213056358
"[1, 0, 1, 1, 1, 1, 1, 1, 1, 1, 1, 1, 1, 1, 0]",9044,1771,7273,166,682,0.09373235460191982,0.09377148356936615
"[1, 1, 1, 0, 1, 1, 1, 1, 1, 1, 1, 1, 1, 1, 1]",65987,8164,57823,759,5397,0.09296913277804998,0.09333656157584352
"[1, 1, 1, 1, 1, 1, 1, 0, 1, 1, 1, 1, 1, 1, 1]",61527,7161,54366,715,5136,0.09984639016897082,0.09447080896148329
"[1, 1, 1, 1, 1, 1, 1, 1, 0, 1, 1, 1, 1, 1, 1]",61512,7281,54231,750,5199,0.10300782859497322,0.0958676771588206
"[1, 0, 0, 0, 1, 1, 1, 1, 0, 0, 0, 1, 1, 1, 1]",279,130,149,12,11,0.09230769230769231,0.0738255033557047
"[1, 1, 1, 0, 1, 1, 0, 1, 1, 1, 1, 0, 0, 1, 0]",208,74,134,6,12,0.08108108108108109,0.08955223880597014
"[0, 1, 1, 1, 1, 0, 1, 1, 0, 1, 1, 1, 1, 0, 0]",328,117,211,8,21,0.06837606837606838,0.0995260663507109
"[1, 1, 0, 1, 0, 0, 0, 0, 0, 1, 1, 1, 1, 0, 1]",134,67,67,6,9,0.08955223880597014,0.13432835820895522
"[1, 1, 1, 1, 1, 1, 1, 0, 1, 1, 1, 0, 1, 0, 1]",1696,389,1307,39,131,0.10025706940874037,0.10022953328232594
"[1, 1, 1, 0, 1, 0, 0, 0, 1, 1, 1, 1, 1, 1, 1]",994,300,694,33,77,0.11,0.11095100864553314
"[1, 1, 0, 1, 1, 1, 0, 1, 1, 0, 1, 1, 1, 1, 0]",516,139,377,7,21,0.050359712230215826,0.05570291777188329
"[1, 0, 1, 1, 1, 0, 1, 1, 1, 1, 0, 1, 1, 1, 1]",1668,422,1246,39,107,0.0924170616113744,0.08587479935794542
"[1, 0, 1, 1, 0, 1, 0, 1, 1, 1, 1, 1, 1, 1, 1]",2089,543,1546,34,164,0.06261510128913444,0.10608020698576973
"[1, 0, 1, 1, 1, 1, 0, 0, 0, 1, 1, 0, 1, 1, 1]",266,84,182,3,23,0.03571428571428571,0.12637362637362637
"[1, 0, 0, 1, 0, 1, 1, 1, 1, 1, 0, 1, 1, 1, 1]",620,175,445,17,44,0.09714285714285714,0.09887640449438202
"[1, 1, 1, 0, 1, 0, 0, 1, 0, 1, 1, 1, 1, 1, 0]",279,101,178,9,19,0.0891089108910891,0.10674157303370786
"[1, 0, 1, 0, 1, 1, 1, 0, 0, 0, 1, 0, 1, 0, 0]",114,62,52,4,6,0.06451612903225806,0.11538461538461539
"[0, 1, 0, 0, 0, 0, 1, 0, 1, 0, 1, 1, 1, 0, 0]",154,88,66,11,6,0.125,0.09090909090909091
"[1, 1, 0, 1, 0, 1, 0, 0, 0, 0, 1, 0, 1, 0, 1]",100,50,50,5,7,0.1,0.14
"[1, 1, 0, 1, 1, 0, 0, 1, 0, 0, 0, 1, 0, 1, 0]",100,53,47,3,11,0.05660377358490566,0.23404255319148937
"[0, 0, 0, 1, 1, 0, 1, 0, 0, 1, 1, 1, 0, 1, 1]",125,66,59,4,5,0.06060606060606061,0.0847457627118644
"[0, 0, 0, 0, 1, 1, 0, 1, 0, 0, 1, 1, 1, 0, 1]",117,63,54,8,4,0.12698412698412698,0.07407407407407407
"[1, 1, 0, 0, 1, 1, 0, 0, 0, 0, 0, 1, 1, 0, 1]",234,116,118,12,9,0.10344827586206896,0.07627118644067797
"[0, 0, 1, 1, 1, 1, 1, 0, 1, 0, 0, 0, 1, 1, 1]",263,115,148,8,14,0.06956521739130435,0.0945945945945946
"[0, 0, 0, 0, 1, 1, 1, 1, 1, 0, 1, 0, 0, 0, 1]",176,97,79,9,9,0.09278350515463918,0.11392405063291139
"[0, 0, 1, 0, 0, 0, 0, 0, 1, 1, 1, 1, 1, 0, 0]",275,167,108,12,10,0.0718562874251497,0.09259259259259259
"[1, 1, 0, 0, 0, 0, 0, 0, 0, 0, 1, 0, 0, 0, 1]",901,631,270,54,32,0.08557844690966719,0.11851851851851852
"[1, 0, 0, 0, 0, 0, 0, 0, 0, 0, 1, 0, 0, 0, 0]",7787,5932,1855,581,195,0.09794335805799056,0.10512129380053908
"[0, 1, 0, 0, 0, 1, 0, 0, 1, 0, 0, 0, 0, 0, 0]",1744,1336,408,132,41,0.09880239520958084,0.10049019607843138
"[0, 0, 1, 0, 0, 1, 0, 0, 0, 1, 0, 0, 1, 0, 0]",460,332,128,29,18,0.08734939759036145,0.140625
"[0, 0, 0, 0, 0, 0, 0, 0, 0, 0, 0, 0, 1, 0, 1]",10800,9067,1733,912,176,0.10058453733318629,0.10155799192152337
"[0, 0, 0, 1, 1, 1, 1, 1, 1, 1, 1, 0, 1, 1, 0]",400,217,183,39,21,0.17972350230414746,0.11475409836065574
"[0, 0, 0, 0, 0, 1, 1, 1, 1, 1, 1, 1, 1, 0, 1]",499,341,158,41,14,0.12023460410557185,0.08860759493670886
"[1, 0, 0, 0, 0, 0, 0, 0, 0, 1, 1, 1, 1, 0, 0]",2371,774,1597,62,146,0.08010335917312661,0.09142141515341265
"[0, 1, 1, 1, 1, 1, 1, 0, 1, 0, 0, 0, 1, 1, 1]",367,167,200,14,21,0.08383233532934131,0.105
"[0, 0, 0, 0, 0, 0, 0, 1, 0, 1, 1, 0, 0, 1, 1]",536,384,152,46,15,0.11979166666666667,0.09868421052631579
"[0, 0, 0, 0, 1, 0, 1, 0, 0, 0, 0, 0, 0, 0, 0]",8746,7226,1520,681,141,0.09424301134791033,0.09276315789473684
"[0, 1, 1, 1, 1, 0, 0, 0, 0, 1, 1, 0, 0, 0, 0]",1965,1659,306,151,27,0.09101868595539482,0.08823529411764706
"[0, 0, 1, 0, 1, 1, 1, 0, 0, 1, 1, 0, 0, 1, 1]",281,138,143,15,11,0.10869565217391304,0.07692307692307693
"[0, 1, 0, 0, 0, 1, 0, 0, 0, 0, 1, 0, 1, 1, 1]",179,116,63,9,7,0.07758620689655173,0.1111111111111111
"[1, 1, 0, 1, 1, 1, 0, 0, 0, 0, 1, 0, 1, 0, 0]",105,56,49,5,5,0.08928571428571429,0.10204081632653061
"[1, 1, 1, 0, 0, 1, 1, 0, 1, 1, 1, 1, 1, 1, 1]",2515,503,2012,49,202,0.09741550695825049,0.10039761431411531
"[1, 1, 1, 1, 0, 1, 1, 0, 1, 1, 1, 1, 1, 1, 1]",8629,1597,7032,144,658,0.09016906700062617,0.09357224118316268
"[0, 1, 1, 1, 0, 1, 1, 1, 1, 1, 1, 0, 0, 1, 1]",1030,351,679,31,87,0.08831908831908832,0.12812960235640647
"[1, 0, 1, 0, 0, 1, 1, 1, 0, 0, 0, 0, 0, 1, 0]",161,97,64,8,3,0.08247422680412371,0.046875
"[0, 0, 1, 0, 1, 0, 1, 0, 0, 1, 1, 1, 0, 0, 0]",170,103,67,13,11,0.1262135922330097,0.16417910447761194
"[0, 0, 0, 1, 0, 1, 0, 1, 0, 0, 1, 1, 1, 0, 0]",155,93,62,10,5,0.10752688172043011,0.08064516129032258
"[0, 1, 0, 1, 1, 1, 1, 0, 1, 0, 1, 0, 0, 0, 1]",105,47,58,3,13,0.06382978723404255,0.22413793103448276
"[0, 0, 0, 0, 0, 1, 0, 1, 0, 0, 1, 1, 0, 0, 1]",326,217,109,24,13,0.11059907834101383,0.11926605504587157
"[0, 1, 0, 0, 0, 0, 0, 1, 0, 0, 1, 0, 0, 0, 0]",1645,1255,390,115,44,0.09163346613545817,0.11282051282051282
"[1, 1, 1, 1, 0, 1, 0, 1, 1, 0, 0, 0, 0, 0, 0]",262,118,144,11,13,0.09322033898305085,0.09027777777777778
"[1, 1, 1, 1, 1, 1, 1, 0, 1, 0, 1, 1, 0, 0, 0]",355,120,235,7,20,0.058333333333333334,0.0851063829787234
"[0, 0, 0, 1, 1, 1, 0, 1, 0, 1, 0, 0, 0, 1, 1]",153,90,63,6,3,0.06666666666666667,0.047619047619047616
"[1, 0, 0, 0, 0, 1, 1, 1, 0, 1, 0, 1, 0, 0, 0]",169,76,93,7,6,0.09210526315789473,0.06451612903225806
"[1, 0, 0, 0, 0, 1, 1, 0, 0, 0, 0, 0, 1, 0, 0]",759,392,367,31,40,0.07908163265306123,0.10899182561307902
"[0, 1, 0, 1, 0, 0, 0, 0, 1, 1, 0, 0, 0, 0, 0]",1022,712,310,67,30,0.09410112359550561,0.0967741935483871
"[0, 0, 0, 0, 0, 1, 0, 1, 0, 0, 0, 0, 1, 1, 0]",792,579,213,55,23,0.09499136442141623,0.107981220657277
"[1, 0, 0, 0, 0, 0, 1, 0, 0, 0, 0, 1, 1, 0, 0]",826,547,279,42,27,0.07678244972577697,0.0967741935483871
"[0, 0, 1, 0, 0, 0, 0, 0, 1, 0, 0, 0, 0, 1, 1]",814,591,223,53,14,0.08967851099830795,0.06278026905829596
"[1, 0, 0, 0, 0, 0, 0, 1, 0, 0, 0, 0, 0, 0, 1]",1994,1409,585,132,39,0.0936834634492548,0.06666666666666667
"[0, 0, 0, 0, 1, 0, 0, 0, 0, 0, 1, 0, 0, 1, 0]",1545,1185,360,112,32,0.09451476793248945,0.08888888888888889
"[1, 0, 0, 1, 1, 1, 0, 1, 1, 1, 1, 1, 1, 1, 1]",2491,511,1980,42,181,0.0821917808219178,0.09141414141414142
"[1, 1, 0, 0, 1, 1, 1, 0, 1, 1, 1, 1, 1, 1, 1]",2516,608,1908,57,194,0.09375,0.10167714884696016
"[1, 1, 1, 0, 1, 1, 0, 0, 1, 1, 1, 1, 1, 1, 1]",3099,702,2397,80,221,0.11396011396011396,0.09219858156028368
"[1, 1, 0, 1, 1, 1, 1, 1, 1, 1, 0, 1, 1, 1, 1]",7464,1305,6159,124,648,0.0950191570881226,0.10521188504627374
"[1, 1, 1, 1, 0, 1, 1, 0, 1, 1, 1, 1, 1, 0, 1]",1497,368,1129,37,97,0.10054347826086957,0.08591674047829938
"[1, 1, 0, 1, 1, 1, 1, 1, 0, 1, 1, 1, 1, 1, 0]",1532,355,1177,45,110,0.1267605633802817,0.09345794392523364
"[0, 1, 0, 0, 0, 0, 0, 0, 0, 0, 0, 1, 1, 1, 1]",1213,816,397,83,34,0.1017156862745098,0.08564231738035265
"[1, 1, 0, 1, 0, 0, 0, 0, 0, 0, 0, 0, 0, 1, 1]",559,342,217,32,14,0.0935672514619883,0.06451612903225806
"[0, 1, 0, 0, 1, 0, 1, 1, 1, 0, 1, 0, 0, 0, 0]",159,88,71,6,9,0.06818181818181818,0.1267605633802817
"[0, 1, 0, 0, 0, 0, 0, 1, 0, 0, 1, 0, 0, 1, 0]",508,369,139,36,12,0.0975609756097561,0.08633093525179857
"[0, 0, 0, 1, 0, 0, 0, 1, 0, 1, 0, 0, 0, 0, 0]",1718,1314,404,118,29,0.0898021308980213,0.07178217821782178
"[1, 1, 0, 0, 1, 0, 0, 0, 0, 1, 0, 0, 0, 1, 0]",235,146,89,9,6,0.06164383561643835,0.06741573033707865
"[0, 1, 0, 0, 0, 0, 1, 0, 1, 1, 0, 0, 1, 0, 0]",235,153,82,14,8,0.0915032679738562,0.0975609756097561
"[1, 1, 1, 1, 0, 0, 0, 0, 1, 0, 0, 1, 0, 0, 1]",167,90,77,7,6,0.07777777777777778,0.07792207792207792
"[0, 1, 1, 1, 0, 1, 1, 1, 1, 1, 1, 1, 1, 0, 0]",1014,330,684,28,47,0.08484848484848485,0.06871345029239766
"[0, 0, 1, 0, 0, 0, 0, 0, 0, 0, 0, 0, 0, 1, 0]",6830,5569,1261,560,119,0.10055665289998204,0.0943695479777954
"[0, 0, 0, 0, 0, 1, 0, 0, 1, 1, 0, 1, 1, 1, 1]",217,132,85,8,8,0.06060606060606061,0.09411764705882353
"[1, 1, 1, 1, 0, 0, 1, 1, 0, 0, 0, 0, 0, 0, 0]",2114,1200,914,119,72,0.09916666666666667,0.0787746170678337
"[1, 0, 0, 0, 0, 1, 0, 0, 0, 0, 0, 0, 0, 1, 1]",1050,706,344,73,33,0.10339943342776203,0.09593023255813954
"[0, 1, 0, 0, 0, 0, 1, 1, 0, 0, 0, 0, 1, 0, 0]",627,464,163,43,12,0.09267241379310345,0.0736196319018405
"[0, 0, 0, 0, 0, 1, 0, 0, 0, 0, 1, 1, 0, 0, 0]",2680,2084,596,197,50,0.09452975047984645,0.08389261744966443
"[0, 1, 0, 0, 1, 1, 0, 1, 1, 1, 1, 1, 0, 1, 1]",237,79,158,7,14,0.08860759493670886,0.08860759493670886
"[1, 1, 1, 0, 0, 0, 1, 1, 1, 1, 1, 1, 1, 1, 1]",3545,809,2736,62,253,0.07663782447466007,0.09247076023391813
"[1, 1, 0, 0, 0, 0, 1, 1, 0, 1, 1, 1, 1, 1, 0]",226,94,132,12,15,0.1276595744680851,0.11363636363636363
"[1, 0, 0, 1, 1, 1, 1, 1, 0, 0, 1, 1, 1, 1, 1]",1374,342,1032,36,99,0.10526315789473684,0.09593023255813954
"[0, 1, 0, 0, 0, 0, 0, 1, 1, 0, 0, 1, 1, 1, 0]",193,115,78,13,5,0.11304347826086956,0.0641025641025641
"[0, 0, 1, 0, 0, 0, 0, 0, 1, 1, 0, 0, 1, 1, 1]",462,302,160,28,14,0.09271523178807947,0.0875
"[1, 0, 0, 1, 0, 0, 0, 0, 0, 1, 1, 0, 0, 0, 0]",951,633,318,56,41,0.08846761453396525,0.1289308176100629
"[0, 0, 1, 0, 1, 0, 0, 1, 0, 0, 1, 0, 0, 0, 0]",542,388,154,36,20,0.09278350515463918,0.12987012987012986
"[0, 0, 0, 1, 0, 0, 0, 0, 0, 1, 1, 0, 0, 1, 1]",674,468,206,44,24,0.09401709401709402,0.11650485436893204
"[0, 0, 0, 1, 1, 1, 1, 0, 0, 0, 1, 0, 0, 0, 0]",406,298,108,24,11,0.08053691275167785,0.10185185185185185
"[0, 1, 0, 1, 0, 0, 0, 0, 0, 0, 0, 1, 1, 1, 1]",427,273,154,23,14,0.08424908424908426,0.09090909090909091
"[0, 1, 1, 0, 1, 1, 0, 1, 0, 1, 0, 1, 0, 0, 0]",102,58,44,5,1,0.08620689655172414,0.022727272727272728
"[0, 1, 0, 0, 0, 1, 1, 0, 0, 0, 1, 0, 0, 0, 0]",573,424,149,40,13,0.09433962264150944,0.087248322147651
"[0, 0, 0, 1, 1, 0, 0, 1, 0, 0, 0, 0, 1, 0, 0]",600,449,151,40,13,0.08908685968819599,0.08609271523178808
"[1, 1, 1, 1, 1, 0, 1, 0, 1, 1, 1, 0, 1, 1, 1]",1809,392,1417,40,125,0.10204081632653061,0.08821453775582216
"[1, 1, 0, 0, 0, 0, 0, 0, 0, 1, 0, 0, 1, 1, 1]",493,306,187,36,17,0.11764705882352941,0.09090909090909091
"[0, 0, 1, 0, 0, 0, 0, 1, 1, 0, 0, 1, 0, 1, 1]",195,117,78,15,7,0.1282051282051282,0.08974358974358974
"[1, 1, 0, 0, 1, 1, 1, 0, 0, 1, 1, 1, 0, 1, 0]",163,73,90,8,9,0.1095890410958904,0.1
"[0, 1, 1, 1, 1, 0, 0, 1, 1, 1, 0, 0, 1, 1, 1]",552,307,245,29,19,0.09446254071661238,0.07755102040816327
"[1, 0, 0, 0, 1, 1, 1, 1, 1, 0, 1, 0, 1, 0, 1]",141,57,84,6,10,0.10526315789473684,0.11904761904761904
"[1, 1, 1, 1, 0, 0, 0, 1, 1, 1, 1, 1, 0, 1, 0]",268,88,180,11,23,0.125,0.12777777777777777
"[1, 0, 1, 1, 0, 1, 1, 1, 0, 1, 1, 1, 0, 1, 1]",484,131,353,15,34,0.11450381679389313,0.09631728045325778
"[1, 0, 1, 1, 1, 1, 0, 1, 1, 1, 1, 1, 1, 0, 0]",778,236,542,26,52,0.11016949152542373,0.0959409594095941
"[1, 1, 0, 0, 1, 0, 1, 1, 1, 1, 0, 1, 1, 1, 1]",648,188,460,19,53,0.10106382978723404,0.11521739130434783
"[1, 1, 1, 1, 1, 1, 1, 0, 0, 1, 0, 1, 1, 1, 1]",2485,527,1958,45,176,0.08538899430740038,0.0898876404494382
"[1, 1, 0, 1, 1, 1, 1, 1, 1, 1, 0, 0, 1, 0, 1]",591,164,427,18,29,0.10975609756097561,0.06791569086651054
"[1, 0, 1, 1, 0, 1, 1, 1, 1, 1, 1, 1, 0, 0, 1]",828,190,638,17,65,0.08947368421052632,0.10188087774294671
"[1, 1, 1, 0, 1, 1, 0, 1, 1, 1, 1, 1, 1, 1, 0]",1774,384,1390,43,124,0.11197916666666667,0.08920863309352518
"[0, 1, 1, 1, 0, 1, 1, 0, 1, 1, 1, 1, 1, 1, 1]",2004,523,1481,49,159,0.09369024856596558,0.10735989196488858
"[1, 0, 1, 1, 1, 1, 1, 0, 1, 1, 1, 0, 1, 0, 1]",501,137,364,8,39,0.058394160583941604,0.10714285714285714
"[0, 1, 0, 1, 1, 0, 1, 1, 1, 1, 1, 0, 1, 1, 1]",565,178,387,17,32,0.09550561797752809,0.082687338501292
"[0, 1, 0, 0, 0, 0, 0, 0, 0, 1, 0, 0, 0, 0, 0]",7331,5998,1333,566,156,0.09436478826275425,0.11702925731432859
"[0, 1, 1, 0, 1, 0, 0, 0, 0, 1, 0, 0, 0, 0, 0]",529,370,159,30,13,0.08108108108108109,0.08176100628930817
"[0, 0, 0, 1, 0, 0, 0, 0, 0, 0, 0, 1, 0, 1, 1]",745,543,202,61,17,0.11233885819521179,0.08415841584158416
"[1, 0, 1, 1, 0, 1, 0, 0, 0, 0, 0, 0, 0, 1, 0]",208,139,69,12,7,0.08633093525179857,0.10144927536231885
"[0, 0, 1, 1, 1, 1, 1, 1, 1, 1, 0, 0, 0, 0, 1]",1984,842,1142,97,87,0.11520190023752969,0.07618213660245184
"[1, 0, 1, 1, 1, 1, 1, 1, 1, 1, 0, 1, 1, 1, 0]",1647,382,1265,47,114,0.12303664921465969,0.09011857707509881
"[1, 0, 0, 0, 0, 1, 0, 0, 1, 1, 1, 0, 1, 0, 0]",141,80,61,8,6,0.1,0.09836065573770492
"[0, 1, 1, 1, 1, 1, 1, 1, 1, 0, 0, 0, 0, 0, 0]",1728,1334,394,115,30,0.08620689655172414,0.07614213197969544
"[0, 1, 1, 0, 1, 0, 0, 1, 1, 0, 0, 1, 1, 0, 0]",257,155,102,10,6,0.06451612903225806,0.058823529411764705
"[1, 1, 0, 0, 1, 1, 0, 1, 0, 0, 1, 1, 0, 0, 1]",176,91,85,4,5,0.04395604395604396,0.058823529411764705
"[1, 1, 1, 0, 1, 0, 1, 1, 1, 1, 0, 1, 0, 1, 1]",520,153,367,16,34,0.10457516339869281,0.09264305177111716
"[0, 1, 1, 1, 0, 1, 1, 1, 0, 0, 1, 1, 1, 1, 1]",861,281,580,28,50,0.099644128113879,0.08620689655172414
"[1, 0, 0, 1, 1, 1, 0, 1, 1, 1, 0, 0, 1, 1, 1]",380,123,257,11,17,0.08943089430894309,0.06614785992217899
"[0, 0, 1, 1, 1, 0, 0, 1, 1, 1, 0, 1, 1, 1, 0]",135,68,67,3,4,0.04411764705882353,0.05970149253731343
"[1, 0, 1, 0, 0, 1, 1, 1, 1, 0, 0, 0, 0, 0, 0]",468,268,200,28,15,0.1044776119402985,0.075
"[0, 1, 0, 0, 0, 0, 1, 1, 1, 1, 0, 1, 0, 0, 1]",133,71,62,4,5,0.056338028169014086,0.08064516129032258
"[1, 0, 0, 1, 1, 1, 0, 0, 0, 0, 0, 0, 0, 0, 1]",480,268,212,21,16,0.07835820895522388,0.07547169811320754
"[1, 1, 1, 0, 1, 0, 1, 1, 1, 0, 0, 0, 1, 0, 0]",119,49,70,4,4,0.08163265306122448,0.05714285714285714
"[0, 1, 1, 1, 1, 1, 0, 0, 0, 0, 1, 1, 0, 1, 1]",262,119,143,17,13,0.14285714285714285,0.09090909090909091
"[1, 0, 1, 1, 1, 1, 1, 0, 0, 0, 0, 1, 1, 0, 1]",205,77,128,5,12,0.06493506493506493,0.09375
"[1, 0, 1, 1, 1, 0, 0, 1, 1, 1, 1, 1, 1, 1, 1]",3338,847,2491,65,234,0.07674144037780402,0.09393817743877961
"[1, 1, 1, 1, 1, 0, 1, 0, 1, 1, 1, 1, 1, 1, 1]",8995,1568,7427,138,764,0.08801020408163265,0.10286791436650061
"[0, 1, 0, 0, 1, 0, 0, 0, 0, 0, 0, 0, 0, 1, 1]",1109,783,326,88,30,0.1123882503192848,0.09202453987730061
"[0, 0, 0, 1, 1, 1, 0, 0, 0, 1, 1, 0, 0, 0, 0]",400,266,134,23,10,0.08646616541353383,0.07462686567164178
"[0, 0, 0, 0, 1, 0, 0, 0, 0, 1, 1, 0, 0, 0, 1]",644,457,187,43,20,0.09409190371991247,0.10695187165775401
"[1, 0, 0, 1, 0, 0, 1, 0, 0, 0, 0, 0, 0, 0, 1]",627,432,195,40,27,0.09259259259259259,0.13846153846153847
"[0, 0, 0, 0, 0, 0, 1, 0, 0, 1, 0, 0, 1, 0, 0]",1628,1220,408,119,42,0.09754098360655737,0.10294117647058823
"[0, 1, 1, 0, 0, 1, 1, 0, 0, 0, 1, 0, 0, 0, 0]",421,325,96,38,12,0.11692307692307692,0.125
"[0, 1, 1, 1, 1, 1, 1, 1, 0, 1, 0, 1, 1, 1, 0]",552,209,343,19,37,0.09090909090909091,0.10787172011661808
"[1, 1, 1, 1, 1, 1, 1, 0, 1, 1, 0, 1, 0, 1, 1]",1769,399,1370,36,128,0.09022556390977443,0.09343065693430656
"[1, 0, 1, 0, 0, 1, 1, 1, 1, 1, 1, 0, 1, 1, 1]",642,195,447,14,41,0.07179487179487179,0.09172259507829977
"[1, 1, 0, 0, 1, 1, 0, 0, 0, 0, 0, 0, 0, 0, 0]",4570,3196,1374,287,114,0.08979974968710888,0.08296943231441048
"[0, 1, 0, 0, 1, 0, 1, 1, 0, 0, 1, 1, 0, 0, 0]",233,136,97,12,6,0.08823529411764706,0.061855670103092786
"[1, 1, 0, 0, 1, 0, 0, 1, 0, 1, 1, 0, 0, 1, 1]",166,84,82,9,7,0.10714285714285714,0.08536585365853659
"[0, 1, 1, 0, 1, 1, 1, 0, 0, 1, 0, 0, 1, 0, 1]",109,38,71,5,8,0.13157894736842105,0.11267605633802817
"[1, 1, 1, 1, 1, 1, 1, 0, 0, 0, 1, 1, 1, 1, 1]",3423,655,2768,84,275,0.1282442748091603,0.09934971098265896
"[0, 1, 1, 0, 0, 1, 1, 1, 0, 0, 1, 1, 0, 0, 0]",219,126,93,18,7,0.14285714285714285,0.07526881720430108
"[1, 0, 1, 0, 1, 1, 0, 0, 1, 1, 0, 1, 1, 0, 0]",122,52,70,4,8,0.07692307692307693,0.11428571428571428
"[0, 1, 1, 1, 1, 1, 0, 1, 1, 0, 1, 0, 1, 1, 0]",247,97,150,12,14,0.12371134020618557,0.09333333333333334
"[1, 1, 0, 1, 1, 0, 0, 1, 0, 0, 1, 0, 0, 1, 1]",133,62,71,5,7,0.08064516129032258,0.09859154929577464
"[0, 1, 1, 1, 0, 1, 1, 0, 0, 1, 0, 0, 1, 0, 0]",121,61,60,6,7,0.09836065573770492,0.11666666666666667
"[1, 1, 0, 0, 1, 0, 0, 0, 1, 1, 1, 1, 0, 0, 1]",237,105,132,7,17,0.06666666666666667,0.12878787878787878
"[1, 1, 0, 0, 1, 1, 0, 0, 0, 0, 1, 1, 1, 0, 0]",318,167,151,17,14,0.10179640718562874,0.09271523178807947
"[1, 1, 1, 0, 0, 1, 1, 0, 0, 0, 0, 1, 1, 1, 0]",346,74,272,1,26,0.013513513513513514,0.09558823529411764
"[1, 1, 1, 1, 1, 1, 1, 1, 1, 0, 0, 1, 1, 0, 0]",5051,799,4252,76,410,0.0951188986232791,0.09642521166509878
"[0, 1, 0, 0, 1, 0, 0, 0, 0, 0, 0, 0, 1, 0, 0]",1546,1183,363,119,30,0.10059171597633136,0.08264462809917356
"[0, 0, 0, 0, 0, 1, 0, 1, 0, 0, 1, 0, 0, 0, 0]",1712,1330,382,134,33,0.10075187969924812,0.08638743455497382
"[0, 1, 1, 1, 1, 1, 0, 1, 1, 1, 1, 1, 1, 0, 1]",1513,427,1086,35,110,0.08196721311475409,0.10128913443830571
"[0, 0, 0, 1, 1, 1, 1, 1, 0, 1, 1, 1, 1, 1, 1]",920,384,536,20,54,0.052083333333333336,0.10074626865671642
"[0, 0, 0, 0, 1, 0, 1, 1, 0, 0, 0, 0, 0, 0, 0]",2427,1846,581,155,57,0.08396533044420368,0.0981067125645439
"[1, 0, 0, 0, 1, 1, 0, 0, 1, 0, 0, 0, 0, 0, 1]",248,160,88,10,5,0.0625,0.056818181818181816
"[1, 1, 1, 0, 0, 1, 0, 0, 0, 0, 0, 0, 1, 0, 0]",247,139,108,23,13,0.16546762589928057,0.12037037037037036
"[0, 0, 0, 0, 0, 1, 0, 1, 0, 0, 0, 1, 0, 0, 0]",1559,1210,349,118,40,0.09752066115702479,0.11461318051575932
"[0, 0, 0, 0, 0, 0, 1, 0, 1, 0, 0, 0, 1, 0, 0]",1539,1182,357,126,34,0.1065989847715736,0.09523809523809523
"[0, 0, 0, 1, 1, 0, 1, 1, 0, 0, 1, 0, 1, 1, 0]",104,59,45,6,4,0.1016949152542373,0.08888888888888889
"[1, 1, 0, 0, 0, 0, 1, 1, 0, 1, 1, 0, 0, 1, 0]",147,68,79,7,6,0.10294117647058823,0.0759493670886076
"[0, 0, 1, 0, 1, 0, 0, 1, 0, 1, 0, 0, 0, 0, 0]",567,431,136,33,12,0.0765661252900232,0.08823529411764706
"[1, 1, 1, 0, 0, 0, 0, 0, 0, 1, 0, 0, 0, 0, 1]",390,185,205,17,26,0.0918918918918919,0.12682926829268293
"[1, 1, 1, 1, 0, 0, 1, 1, 0, 0, 1, 1, 1, 1, 1]",5543,1614,3929,135,347,0.08364312267657993,0.08831763807584628
"[0, 0, 0, 0, 0, 0, 1, 1, 0, 1, 1, 1, 0, 1, 0]",181,98,83,5,8,0.05102040816326531,0.0963855421686747
"[1, 1, 1, 0, 0, 1, 1, 1, 1, 0, 0, 1, 1, 0, 0]",1968,324,1644,23,144,0.07098765432098765,0.08759124087591241
"[1, 0, 1, 0, 0, 0, 0, 1, 1, 1, 1, 0, 0, 1, 1]",421,213,208,16,16,0.07511737089201878,0.07692307692307693
"[1, 1, 0, 1, 0, 0, 0, 0, 1, 1, 1, 1, 0, 0, 1]",269,120,149,14,13,0.11666666666666667,0.087248322147651
"[1, 0, 0, 1, 1, 1, 0, 1, 0, 0, 0, 0, 1, 1, 1]",228,95,133,10,13,0.10526315789473684,0.09774436090225563
"[0, 0, 1, 0, 0, 0, 1, 1, 0, 0, 0, 0, 0, 0, 1]",928,653,275,59,27,0.0903522205206738,0.09818181818181818
"[0, 0, 0, 0, 0, 1, 0, 1, 1, 0, 1, 1, 0, 0, 1]",149,92,57,7,8,0.07608695652173914,0.14035087719298245
"[0, 0, 1, 0, 0, 1, 0, 1, 1, 1, 1, 0, 0, 0, 1]",108,55,53,3,8,0.05454545454545454,0.1509433962264151
"[1, 1, 0, 1, 0, 0, 0, 1, 1, 1, 1, 0, 1, 1, 0]",163,70,93,5,9,0.07142857142857142,0.0967741935483871
"[0, 0, 0, 1, 1, 1, 1, 1, 0, 1, 0, 1, 0, 0, 1]",138,68,70,3,8,0.04411764705882353,0.11428571428571428
"[1, 0, 1, 1, 0, 0, 0, 0, 0, 1, 1, 1, 1, 0, 0]",317,154,163,11,16,0.07142857142857142,0.09815950920245399
"[0, 1, 0, 0, 0, 1, 0, 0, 1, 0, 1, 0, 1, 0, 0]",221,147,74,15,2,0.10204081632653061,0.02702702702702703
"[1, 1, 1, 0, 0, 1, 0, 1, 0, 1, 1, 1, 0, 0, 0]",146,74,72,8,10,0.10810810810810811,0.1388888888888889
"[0, 0, 1, 1, 1, 1, 0, 0, 1, 0, 1, 0, 1, 1, 1]",275,115,160,12,17,0.10434782608695652,0.10625
"[1, 0, 1, 0, 0, 1, 1, 1, 0, 1, 1, 0, 1, 0, 1]",154,62,92,6,9,0.0967741935483871,0.09782608695652174
"[0, 1, 0, 1, 0, 1, 0, 0, 1, 1, 1, 0, 1, 1, 0]",120,57,63,5,6,0.08771929824561403,0.09523809523809523
"[1, 0, 0, 0, 1, 1, 1, 1, 1, 0, 1, 1, 1, 1, 1]",731,179,552,16,47,0.0893854748603352,0.08514492753623189
"[1, 0, 1, 0, 1, 1, 1, 1, 1, 0, 0, 1, 0, 1, 1]",238,85,153,6,9,0.07058823529411765,0.058823529411764705
"[1, 0, 1, 0, 1, 0, 1, 1, 1, 1, 1, 0, 0, 1, 0]",150,70,80,7,5,0.1,0.0625
"[0, 0, 0, 1, 1, 1, 0, 1, 0, 1, 1, 1, 1, 1, 0]",164,69,95,10,5,0.14492753623188406,0.05263157894736842
"[0, 1, 1, 0, 1, 0, 1, 0, 0, 0, 1, 0, 0, 1, 0]",127,84,43,7,4,0.08333333333333333,0.09302325581395349
"[0, 0, 0, 0, 0, 0, 1, 1, 0, 0, 0, 1, 0, 0, 0]",2323,1797,526,167,34,0.09293266555370061,0.06463878326996197
"[0, 1, 1, 1, 0, 1, 0, 1, 1, 1, 1, 1, 1, 1, 1]",2180,605,1575,50,135,0.08264462809917356,0.08571428571428572
"[1, 0, 0, 0, 1, 0, 0, 0, 1, 1, 1, 0, 1, 0, 1]",128,78,50,5,4,0.0641025641025641,0.08
"[1, 1, 0, 1, 1, 1, 0, 0, 0, 1, 0, 0, 0, 1, 1]",129,50,79,5,6,0.1,0.0759493670886076
"[1, 0, 1, 1, 1, 1, 1, 0, 0, 1, 0, 0, 1, 0, 1]",132,51,81,3,5,0.058823529411764705,0.06172839506172839
"[1, 0, 1, 1, 1, 1, 1, 1, 1, 1, 1, 1, 0, 1, 0]",1661,405,1256,26,124,0.06419753086419754,0.09872611464968153
"[0, 1, 1, 1, 1, 1, 1, 0, 1, 0, 1, 1, 1, 1, 1]",1926,643,1283,64,127,0.09953343701399689,0.0989867498051442
"[0, 0, 0, 1, 1, 1, 0, 0, 1, 1, 0, 0, 1, 1, 0]",274,157,117,11,15,0.07006369426751592,0.1282051282051282
"[0, 1, 1, 0, 0, 1, 1, 0, 0, 0, 0, 0, 1, 1, 1]",625,488,137,45,14,0.09221311475409837,0.10218978102189781
"[1, 0, 0, 0, 0, 0, 1, 0, 0, 0, 1, 1, 0, 0, 1]",353,219,134,17,7,0.0776255707762557,0.05223880597014925
"[0, 1, 1, 1, 0, 1, 1, 1, 0, 1, 0, 0, 0, 0, 0]",153,83,70,9,9,0.10843373493975904,0.12857142857142856
"[0, 1, 1, 0, 0, 0, 0, 0, 0, 0, 1, 0, 1, 1, 1]",509,428,81,31,7,0.07242990654205607,0.08641975308641975
"[0, 1, 0, 0, 1, 1, 1, 0, 0, 0, 1, 1, 0, 0, 1]",141,87,54,9,3,0.10344827586206896,0.05555555555555555
"[0, 0, 1, 1, 1, 0, 0, 1, 0, 0, 1, 0, 1, 0, 1]",105,56,49,4,5,0.07142857142857142,0.10204081632653061
"[0, 1, 0, 1, 0, 1, 1, 1, 0, 0, 1, 1, 1, 1, 1]",376,143,233,16,24,0.11188811188811189,0.10300429184549356
"[0, 0, 1, 1, 1, 0, 0, 1, 0, 1, 0, 0, 1, 1, 0]",122,65,57,4,10,0.06153846153846154,0.17543859649122806
"[0, 0, 1, 0, 0, 1, 1, 1, 1, 0, 0, 0, 1, 1, 0]",141,78,63,6,3,0.07692307692307693,0.047619047619047616
"[1, 1, 0, 0, 0, 1, 0, 0, 1, 1, 1, 1, 0, 0, 0]",197,92,105,9,7,0.09782608695652174,0.06666666666666667
"[0, 0, 1, 1, 0, 0, 0, 1, 0, 0, 1, 1, 1, 1, 0]",162,95,67,15,7,0.15789473684210525,0.1044776119402985
"[1, 0, 1, 1, 1, 1, 1, 0, 0, 1, 1, 0, 0, 0, 1]",179,88,91,11,4,0.125,0.04395604395604396
"[0, 1, 1, 0, 1, 1, 1, 1, 1, 0, 0, 1, 1, 0, 0]",334,132,202,10,21,0.07575757575757576,0.10396039603960396
"[0, 0, 0, 1, 0, 1, 0, 0, 1, 1, 1, 1, 0, 0, 0]",271,164,107,12,7,0.07317073170731707,0.06542056074766354
"[1, 0, 1, 1, 0, 0, 0, 0, 0, 0, 1, 0, 0, 0, 0]",634,441,193,48,20,0.10884353741496598,0.10362694300518134
"[1, 1, 1, 0, 1, 0, 0, 0, 0, 0, 0, 1, 1, 0, 0]",334,182,152,14,18,0.07692307692307693,0.11842105263157894
"[1, 0, 1, 1, 1, 1, 1, 0, 1, 0, 0, 0, 0, 0, 0]",165,77,88,6,3,0.07792207792207792,0.03409090909090909
"[1, 0, 1, 0, 1, 1, 1, 1, 1, 0, 1, 0, 0, 0, 0]",137,62,75,5,1,0.08064516129032258,0.013333333333333334
"[0, 1, 0, 1, 0, 1, 1, 1, 1, 1, 0, 1, 0, 0, 0]",118,59,59,5,5,0.0847457627118644,0.0847457627118644
"[1, 0, 1, 0, 0, 1, 1, 1, 1, 0, 0, 1, 1, 0, 0]",421,202,219,23,27,0.11386138613861387,0.1232876712328767
"[0, 1, 0, 0, 0, 0, 0, 0, 0, 0, 0, 0, 0, 0, 1]",9747,7888,1859,760,165,0.09634888438133875,0.08875739644970414
"[1, 0, 1, 0, 0, 0, 1, 1, 0, 1, 1, 1, 1, 1, 1]",354,129,225,15,17,0.11627906976744186,0.07555555555555556
"[0, 1, 1, 0, 0, 0, 0, 1, 0, 0, 0, 0, 1, 1, 1]",376,286,90,24,8,0.08391608391608392,0.08888888888888889
"[0, 1, 0, 0, 1, 0, 0, 1, 0, 0, 0, 1, 1, 1, 1]",172,97,75,10,7,0.10309278350515463,0.09333333333333334
"[1, 1, 1, 0, 0, 1, 1, 0, 1, 0, 0, 1, 0, 0, 1]",133,61,72,5,5,0.08196721311475409,0.06944444444444445
"[1, 0, 0, 0, 1, 1, 1, 1, 0, 0, 0, 0, 0, 0, 1]",519,267,252,20,20,0.0749063670411985,0.07936507936507936
"[1, 1, 1, 0, 0, 0, 1, 1, 1, 1, 0, 0, 0, 0, 0]",323,158,165,19,16,0.12025316455696203,0.09696969696969697
"[0, 1, 1, 0, 1, 1, 1, 1, 1, 0, 1, 1, 0, 1, 1]",506,145,361,9,41,0.06206896551724138,0.11357340720221606
"[0, 1, 0, 0, 0, 1, 0, 1, 0, 0, 1, 0, 0, 0, 0]",545,393,152,28,23,0.07124681933842239,0.1513157894736842
"[0, 0, 1, 1, 1, 0, 0, 0, 0, 0, 1, 0, 1, 1, 1]",181,97,84,6,8,0.061855670103092786,0.09523809523809523
"[0, 0, 1, 0, 1, 0, 0, 0, 0, 0, 0, 1, 0, 0, 0]",1687,1281,406,111,33,0.08665105386416862,0.0812807881773399
"[0, 0, 0, 1, 0, 1, 0, 0, 0, 0, 0, 0, 1, 0, 0]",1596,1234,362,117,19,0.09481361426256078,0.052486187845303865
"[0, 0, 1, 0, 0, 0, 1, 1, 0, 0, 0, 1, 0, 0, 1]",284,183,101,17,12,0.09289617486338798,0.1188118811881188
"[0, 0, 1, 0, 1, 1, 0, 0, 0, 1, 0, 0, 0, 1, 1]",176,106,70,11,5,0.10377358490566038,0.07142857142857142
"[0, 1, 0, 1, 0, 1, 0, 1, 1, 0, 1, 1, 1, 0, 0]",119,51,68,2,7,0.0392156862745098,0.10294117647058823
"[0, 0, 0, 0, 1, 0, 0, 1, 1, 1, 1, 1, 0, 1, 0]",111,57,54,8,4,0.14035087719298245,0.07407407407407407
"[1, 1, 1, 1, 0, 1, 1, 0, 0, 0, 0, 1, 0, 0, 1]",139,52,87,7,7,0.1346153846153846,0.08045977011494253
"[0, 0, 0, 0, 0, 1, 0, 1, 0, 1, 1, 0, 0, 0, 0]",762,564,198,59,17,0.10460992907801418,0.08585858585858586
"[0, 0, 0, 1, 1, 1, 1, 1, 1, 1, 0, 0, 1, 1, 1]",798,391,407,37,39,0.09462915601023018,0.09582309582309582
"[0, 1, 0, 1, 0, 0, 1, 0, 0, 1, 1, 1, 0, 1, 0]",114,56,58,2,10,0.03571428571428571,0.1724137931034483
"[1, 0, 0, 0, 0, 0, 0, 0, 1, 0, 0, 0, 0, 0, 1]",1805,1272,533,118,50,0.09276729559748427,0.09380863039399624
"[0, 0, 0, 0, 1, 1, 1, 1, 0, 0, 0, 0, 0, 1, 1]",730,451,279,40,23,0.08869179600886919,0.08243727598566308
"[0, 0, 0, 0, 1, 0, 1, 0, 1, 0, 0, 0, 0, 0, 0]",1881,1445,436,136,41,0.09411764705882353,0.09403669724770643
"[1, 0, 0, 0, 0, 0, 0, 0, 1, 0, 1, 1, 1, 0, 0]",307,174,133,20,13,0.11494252873563218,0.09774436090225563
"[0, 1, 0, 0, 0, 0, 1, 1, 0, 0, 1, 1, 0, 0, 1]",477,276,201,36,19,0.13043478260869565,0.0945273631840796
"[1, 0, 0, 0, 1, 1, 1, 1, 1, 0, 1, 0, 0, 0, 1]",116,53,63,5,3,0.09433962264150944,0.047619047619047616
"[0, 1, 1, 1, 0, 0, 0, 1, 1, 1, 1, 1, 0, 1, 0]",131,55,76,4,2,0.07272727272727272,0.02631578947368421
"[1, 1, 1, 0, 1, 0, 0, 1, 1, 1, 1, 1, 1, 0, 1]",536,141,395,15,37,0.10638297872340426,0.09367088607594937
"[0, 1, 0, 0, 1, 1, 0, 0, 1, 1, 1, 1, 0, 0, 0]",431,227,204,16,27,0.07048458149779736,0.1323529411764706
"[1, 0, 0, 1, 0, 0, 1, 0, 0, 1, 0, 0, 1, 1, 0]",154,102,52,7,5,0.06862745098039216,0.09615384615384616
"[1, 0, 0, 1, 1, 1, 0, 0, 1, 1, 1, 1, 0, 1, 0]",172,71,101,6,7,0.08450704225352113,0.06930693069306931
"[1, 1, 0, 0, 1, 1, 1, 0, 0, 1, 1, 1, 1, 0, 1]",285,89,196,9,12,0.10112359550561797,0.061224489795918366
"[0, 0, 0, 0, 0, 1, 0, 0, 0, 0, 0, 1, 1, 0, 0]",2740,2166,574,192,43,0.0886426592797784,0.07491289198606271
"[1, 0, 0, 0, 1, 0, 0, 1, 0, 0, 0, 0, 0, 0, 1]",627,428,199,50,21,0.11682242990654206,0.10552763819095477
"[1, 0, 1, 0, 1, 0, 0, 0, 0, 0, 1, 1, 0, 0, 1]",240,133,107,12,9,0.09022556390977443,0.08411214953271028
"[1, 1, 0, 1, 0, 1, 0, 0, 0, 0, 0, 1, 1, 0, 0]",228,136,92,13,8,0.09558823529411764,0.08695652173913043
"[0, 0, 0, 1, 0, 0, 1, 0, 0, 1, 1, 0, 1, 0, 1]",147,87,60,6,4,0.06896551724137931,0.06666666666666667
"[1, 1, 0, 0, 1, 0, 1, 0, 1, 0, 0, 0, 1, 0, 0]",148,85,63,9,3,0.10588235294117647,0.047619047619047616
"[0, 1, 1, 1, 0, 0, 1, 0, 1, 0, 1, 0, 0, 0, 1]",105,49,56,5,9,0.10204081632653061,0.16071428571428573
"[1, 1, 0, 0, 1, 0, 0, 0, 0, 1, 1, 1, 0, 0, 1]",135,58,77,4,12,0.06896551724137931,0.15584415584415584
"[0, 1, 0, 0, 0, 0, 1, 0, 1, 1, 1, 0, 1, 1, 1]",141,71,70,15,8,0.2112676056338028,0.11428571428571428
"[0, 0, 1, 0, 0, 1, 0, 0, 0, 1, 0, 1, 1, 0, 1]",139,73,66,7,7,0.0958904109589041,0.10606060606060606
"[0, 0, 0, 0, 0, 1, 0, 0, 0, 1, 0, 0, 1, 1, 1]",578,445,133,37,13,0.08314606741573034,0.09774436090225563
"[0, 0, 0, 0, 0, 0, 0, 1, 0, 0, 0, 1, 0, 0, 1]",1827,1418,409,151,34,0.10648801128349789,0.08312958435207823
"[1, 0, 0, 0, 0, 0, 0, 0, 1, 0, 0, 0, 1, 0, 0]",1568,1096,472,92,51,0.08394160583941605,0.10805084745762712
"[1, 1, 1, 1, 0, 0, 0, 0, 0, 0, 0, 1, 0, 0, 0]",509,325,184,20,19,0.06153846153846154,0.10326086956521739
"[0, 1, 1, 1, 1, 0, 0, 0, 0, 0, 0, 0, 1, 0, 0]",506,382,124,26,8,0.06806282722513089,0.06451612903225806
"[0, 1, 0, 0, 0, 0, 0, 0, 0, 0, 1, 1, 0, 0, 1]",1242,890,352,78,35,0.08764044943820225,0.09943181818181818
"[0, 0, 1, 1, 1, 0, 0, 1, 0, 1, 0, 0, 0, 0, 0]",307,196,111,15,14,0.07653061224489796,0.12612612612612611
"[0, 1, 0, 0, 1, 0, 0, 0, 0, 0, 0, 0, 1, 0, 1]",544,411,133,38,11,0.09245742092457421,0.08270676691729323
"[1, 1, 0, 0, 0, 1, 0, 0, 0, 0, 0, 0, 1, 0, 0]",518,379,139,32,15,0.08443271767810026,0.1079136690647482
"[0, 1, 1, 0, 0, 0, 1, 0, 0, 0, 0, 0, 0, 1, 0]",533,394,139,42,18,0.1065989847715736,0.12949640287769784
"[0, 1, 0, 0, 1, 0, 1, 0, 0, 0, 0, 0, 0, 0, 1]",653,470,183,43,15,0.09148936170212765,0.08196721311475409
"[1, 0, 0, 0, 0, 1, 0, 0, 0, 0, 0, 0, 0, 1, 0]",1544,1154,390,109,43,0.09445407279029462,0.11025641025641025
"[0, 0, 1, 0, 0, 0, 0, 1, 0, 1, 1, 0, 0, 0, 1]",213,134,79,19,5,0.1417910447761194,0.06329113924050633
"[1, 1, 0, 0, 1, 1, 1, 1, 1, 0, 0, 1, 1, 1, 1]",1445,441,1004,43,102,0.09750566893424037,0.10159362549800798
"[0, 1, 1, 1, 0, 0, 1, 1, 1, 1, 1, 0, 0, 1, 1]",428,175,253,16,23,0.09142857142857143,0.09090909090909091
"[1, 1, 0, 1, 1, 0, 0, 1, 0, 1, 1, 1, 0, 0, 1]",148,68,80,4,6,0.058823529411764705,0.075
"[1, 0, 0, 1, 1, 1, 0, 1, 1, 0, 1, 1, 0, 1, 0]",138,51,87,0,9,0.0,0.10344827586206896
"[1, 1, 0, 1, 0, 0, 1, 1, 1, 0, 1, 1, 0, 1, 1]",234,95,139,9,6,0.09473684210526316,0.04316546762589928
"[1, 0, 1, 1, 0, 0, 0, 1, 1, 1, 1, 1, 1, 1, 1]",1020,302,718,28,70,0.09271523178807947,0.09749303621169916
"[0, 1, 0, 1, 1, 1, 1, 0, 0, 0, 1, 0, 1, 1, 0]",117,48,69,4,5,0.08333333333333333,0.07246376811594203
"[1, 1, 0, 1, 0, 1, 1, 1, 1, 0, 0, 0, 1, 0, 1]",142,56,86,3,11,0.05357142857142857,0.12790697674418605
"[0, 1, 1, 1, 0, 1, 0, 1, 1, 1, 1, 0, 0, 0, 1]",157,59,98,9,13,0.15254237288135594,0.1326530612244898
"[1, 0, 1, 0, 1, 1, 0, 0, 1, 0, 1, 1, 1, 0, 1]",152,60,92,4,10,0.06666666666666667,0.10869565217391304
"[1, 1, 1, 1, 0, 1, 0, 0, 1, 1, 1, 1, 0, 0, 1]",472,162,310,16,31,0.09876543209876543,0.1
"[0, 0, 1, 1, 1, 1, 1, 1, 1, 0, 1, 1, 1, 0, 1]",651,204,447,16,47,0.0784313725490196,0.10514541387024609
"[0, 0, 0, 0, 0, 0, 0, 1, 1, 1, 1, 1, 1, 1, 0]",452,340,112,31,8,0.09117647058823529,0.07142857142857142
"[0, 0, 1, 0, 0, 0, 0, 1, 1, 1, 1, 0, 0, 0, 1]",218,138,80,16,4,0.11594202898550725,0.05
"[0, 1, 0, 1, 0, 0, 1, 1, 0, 0, 0, 1, 0, 0, 0]",247,166,81,16,5,0.0963855421686747,0.06172839506172839
"[0, 0, 0, 1, 0, 1, 0, 1, 0, 0, 1, 1, 0, 0, 0]",339,234,105,29,6,0.12393162393162394,0.05714285714285714
"[0, 0, 0, 0, 0, 1, 1, 0, 0, 0, 1, 0, 0, 0, 1]",750,578,172,42,11,0.0726643598615917,0.06395348837209303
"[0, 1, 0, 1, 0, 1, 0, 1, 1, 0, 0, 0, 0, 1, 1]",202,103,99,11,5,0.10679611650485436,0.050505050505050504
"[1, 0, 0, 0, 0, 0, 1, 0, 1, 0, 1, 0, 1, 0, 1]",155,95,60,5,9,0.05263157894736842,0.15
"[1, 1, 1, 1, 0, 1, 1, 0, 0, 0, 0, 1, 1, 0, 0]",299,138,161,10,18,0.07246376811594203,0.11180124223602485
"[0, 0, 0, 0, 1, 1, 1, 1, 1, 1, 1, 0, 1, 1, 0]",295,134,161,16,16,0.11940298507462686,0.09937888198757763
"[0, 1, 1, 0, 1, 1, 1, 0, 0, 1, 1, 1, 1, 1, 1]",933,305,628,28,58,0.09180327868852459,0.09235668789808917
"[1, 1, 0, 1, 1, 0, 1, 1, 0, 1, 1, 1, 0, 0, 1]",262,107,155,6,12,0.056074766355140186,0.07741935483870968
"[1, 1, 0, 1, 1, 1, 1, 0, 1, 1, 0, 1, 1, 0, 1]",469,139,330,17,28,0.1223021582733813,0.08484848484848485
"[0, 0, 1, 1, 1, 1, 0, 1, 1, 1, 1, 1, 1, 0, 1]",609,193,416,18,40,0.09326424870466321,0.09615384615384616
"[0, 1, 0, 0, 1, 1, 1, 1, 1, 0, 0, 1, 1, 0, 0]",259,136,123,7,9,0.051470588235294115,0.07317073170731707
"[0, 1, 1, 0, 1, 1, 1, 1, 1, 1, 0, 1, 1, 1, 1]",1769,500,1269,36,126,0.072,0.09929078014184398
"[1, 1, 1, 1, 0, 1, 1, 1, 1, 1, 1, 0, 1, 0, 1]",1541,380,1161,37,89,0.09736842105263158,0.07665805340223945
"[1, 1, 0, 0, 1, 1, 0, 0, 1, 1, 1, 1, 1, 1, 1]",5427,1531,3896,150,340,0.09797517962116264,0.08726899383983573
"[1, 0, 1, 1, 1, 1, 1, 0, 0, 1, 1, 1, 1, 1, 1]",3403,813,2590,80,236,0.0984009840098401,0.09111969111969112
"[0, 1, 1, 1, 0, 1, 1, 1, 1, 1, 1, 1, 0, 1, 1]",1714,410,1304,36,128,0.08780487804878048,0.09815950920245399
"[1, 0, 1, 1, 0, 1, 1, 1, 1, 1, 1, 1, 1, 1, 0]",1905,474,1431,54,106,0.11392405063291139,0.07407407407407407
"[1, 0, 1, 0, 1, 1, 0, 1, 1, 1, 1, 1, 1, 1, 1]",2118,479,1639,28,147,0.05845511482254697,0.0896888346552776
"[1, 0, 1, 1, 1, 0, 1, 0, 1, 1, 0, 1, 1, 1, 1]",593,165,428,9,34,0.05454545454545454,0.0794392523364486
"[0, 1, 0, 1, 1, 1, 0, 1, 0, 1, 1, 0, 1, 1, 1]",250,93,157,12,14,0.12903225806451613,0.08917197452229299
"[1, 1, 0, 0, 0, 1, 0, 1, 1, 1, 0, 0, 0, 0, 0]",229,126,103,11,9,0.0873015873015873,0.08737864077669903
"[0, 0, 0, 0, 0, 1, 1, 0, 0, 0, 1, 0, 1, 1, 1]",518,400,118,40,6,0.1,0.05084745762711865
"[0, 1, 0, 1, 0, 0, 0, 0, 0, 0, 0, 0, 0, 0, 1]",2172,1613,559,162,49,0.10043397396156231,0.08765652951699464
"[0, 0, 1, 0, 0, 0, 0, 0, 0, 0, 1, 0, 0, 1, 0]",1541,1188,353,115,33,0.0968013468013468,0.09348441926345609
"[1, 0, 1, 0, 1, 1, 1, 1, 0, 1, 1, 1, 1, 1, 1]",1897,448,1449,47,138,0.10491071428571429,0.09523809523809523
"[0, 0, 0, 1, 0, 0, 0, 0, 0, 1, 1, 0, 1, 1, 1]",253,169,84,13,11,0.07692307692307693,0.13095238095238096
"[0, 1, 0, 0, 0, 1, 0, 0, 0, 0, 0, 1, 1, 0, 1]",237,148,89,14,7,0.0945945945945946,0.07865168539325842
"[1, 0, 1, 1, 1, 1, 0, 1, 0, 1, 0, 1, 1, 1, 1]",536,172,364,26,42,0.1511627906976744,0.11538461538461539
"[1, 0, 0, 0, 0, 0, 0, 0, 0, 0, 1, 0, 1, 0, 1]",627,401,226,33,24,0.08229426433915212,0.10619469026548672
"[0, 0, 1, 1, 1, 1, 0, 1, 1, 1, 1, 1, 0, 0, 0]",242,110,132,8,14,0.07272727272727272,0.10606060606060606
"[1, 0, 1, 0, 0, 0, 1, 1, 1, 1, 0, 1, 0, 0, 1]",121,63,58,5,5,0.07936507936507936,0.08620689655172414
"[1, 0, 1, 1, 0, 1, 1, 1, 0, 1, 1, 1, 1, 0, 0]",314,105,209,12,22,0.11428571428571428,0.10526315789473684
"[0, 0, 1, 1, 0, 0, 1, 1, 1, 1, 1, 1, 0, 1, 1]",787,285,502,23,48,0.08070175438596491,0.09561752988047809
"[0, 0, 0, 0, 0, 0, 0, 0, 0, 1, 1, 0, 1, 1, 1]",1399,1146,253,112,25,0.09773123909249563,0.09881422924901186
"[0, 0, 0, 0, 0, 0, 0, 0, 0, 0, 0, 1, 1, 0, 1]",3222,2602,620,251,63,0.0964642582628747,0.10161290322580645
"[1, 1, 0, 1, 0, 0, 0, 1, 0, 0, 1, 0, 0, 1, 0]",121,74,47,4,3,0.05405405405405406,0.06382978723404255
"[0, 0, 1, 0, 1, 0, 1, 0, 1, 1, 0, 1, 1, 0, 1]",112,58,54,6,4,0.10344827586206896,0.07407407407407407
"[0, 0, 0, 0, 0, 0, 0, 1, 1, 0, 0, 1, 0, 0, 1]",936,731,205,65,25,0.08891928864569083,0.12195121951219512
"[1, 0, 0, 1, 0, 1, 0, 1, 0, 0, 0, 1, 1, 0, 0]",165,99,66,6,4,0.06060606060606061,0.06060606060606061
"[1, 1, 0, 1, 0, 1, 0, 0, 0, 0, 0, 0, 0, 0, 1]",376,238,138,26,17,0.1092436974789916,0.12318840579710146
"[1, 0, 1, 1, 0, 1, 0, 1, 0, 0, 0, 0, 0, 0, 0]",341,199,142,20,12,0.10050251256281408,0.08450704225352113
"[0, 1, 1, 1, 0, 1, 1, 0, 1, 0, 1, 0, 0, 0, 0]",137,73,64,9,6,0.1232876712328767,0.09375
"[1, 1, 0, 1, 0, 1, 0, 0, 1, 0, 0, 0, 1, 1, 0]",124,72,52,6,3,0.08333333333333333,0.057692307692307696
"[0, 0, 0, 1, 0, 1, 1, 0, 1, 0, 1, 0, 0, 1, 0]",152,85,67,13,10,0.15294117647058825,0.14925373134328357
"[0, 0, 0, 0, 1, 0, 1, 1, 0, 1, 0, 1, 0, 0, 1]",147,83,64,5,6,0.060240963855421686,0.09375
"[0, 0, 1, 1, 1, 0, 0, 0, 0, 0, 1, 0, 1, 1, 0]",154,95,59,6,10,0.06315789473684211,0.1694915254237288
"[0, 1, 1, 0, 0, 1, 1, 1, 1, 0, 0, 1, 1, 1, 0]",410,268,142,29,17,0.10820895522388059,0.11971830985915492
"[0, 0, 0, 1, 1, 0, 0, 1, 1, 1, 1, 0, 0, 1, 1]",1752,1416,336,142,40,0.10028248587570622,0.11904761904761904
"[1, 1, 0, 0, 1, 1, 1, 0, 0, 1, 0, 1, 0, 1, 0]",122,57,65,5,6,0.08771929824561403,0.09230769230769231
"[1, 1, 0, 0, 1, 0, 1, 0, 1, 0, 0, 0, 0, 1, 1]",170,88,82,5,8,0.056818181818181816,0.0975609756097561
"[1, 1, 0, 1, 1, 0, 1, 1, 1, 1, 1, 1, 0, 1, 1]",1594,388,1206,53,114,0.13659793814432988,0.0945273631840796
"[1, 1, 0, 0, 1, 0, 1, 1, 1, 0, 0, 1, 1, 0, 0]",210,96,114,8,8,0.08333333333333333,0.07017543859649122
"[0, 0, 0, 0, 0, 1, 0, 1, 0, 1, 1, 0, 1, 0, 1]",154,87,67,9,5,0.10344827586206896,0.07462686567164178
"[0, 0, 0, 1, 1, 0, 0, 0, 1, 1, 1, 1, 1, 1, 0]",244,147,97,10,8,0.06802721088435375,0.08247422680412371
"[0, 0, 1, 0, 1, 0, 0, 1, 0, 1, 1, 1, 1, 0, 0]",138,71,67,6,5,0.08450704225352113,0.07462686567164178
"[0, 1, 0, 0, 0, 0, 1, 0, 1, 0, 0, 1, 0, 1, 1]",164,102,62,17,5,0.16666666666666666,0.08064516129032258
"[0, 0, 0, 1, 1, 1, 0, 1, 0, 1, 0, 0, 0, 0, 0]",285,187,98,19,10,0.10160427807486631,0.10204081632653061
"[0, 1, 0, 0, 0, 1, 0, 1, 0, 1, 0, 0, 0, 0, 1]",270,177,93,19,11,0.10734463276836158,0.11827956989247312
"[1, 1, 0, 1, 0, 0, 0, 1, 0, 1, 0, 1, 0, 0, 0]",148,91,57,7,3,0.07692307692307693,0.05263157894736842
"[0, 0, 0, 0, 1, 1, 0, 1, 0, 0, 0, 1, 0, 0, 0]",620,443,177,39,17,0.08803611738148984,0.096045197740113
"[0, 0, 0, 0, 0, 0, 1, 0, 0, 0, 0, 1, 1, 0, 1]",601,432,169,50,10,0.11574074074074074,0.05917159763313609
"[1, 0, 1, 1, 0, 1, 0, 0, 0, 0, 0, 0, 0, 0, 0]",812,562,250,50,17,0.08896797153024912,0.068
"[1, 0, 0, 1, 1, 0, 0, 1, 0, 1, 0, 1, 0, 1, 1]",147,52,95,7,5,0.1346153846153846,0.05263157894736842
"[1, 1, 1, 1, 0, 1, 0, 0, 1, 0, 1, 0, 1, 0, 1]",146,67,79,4,16,0.05970149253731343,0.20253164556962025
"[1, 1, 1, 1, 1, 0, 1, 0, 0, 1, 0, 1, 0, 1, 0]",140,60,80,10,7,0.16666666666666666,0.0875
"[1, 0, 0, 0, 0, 0, 1, 0, 1, 1, 1, 0, 0, 1, 1]",171,84,87,10,12,0.11904761904761904,0.13793103448275862
"[0, 1, 1, 1, 1, 1, 0, 1, 1, 0, 1, 1, 0, 1, 1]",506,164,342,18,34,0.10975609756097561,0.09941520467836257
"[0, 0, 1, 1, 1, 1, 1, 0, 1, 1, 0, 1, 1, 0, 1]",246,96,150,14,24,0.14583333333333334,0.16
"[0, 0, 1, 1, 1, 1, 1, 1, 1, 0, 1, 1, 0, 1, 1]",729,243,486,17,48,0.06995884773662552,0.09876543209876543
"[1, 1, 1, 0, 0, 0, 1, 1, 0, 1, 0, 1, 1, 0, 1]",165,60,105,9,10,0.15,0.09523809523809523
"[0, 1, 0, 1, 1, 1, 1, 0, 1, 1, 1, 1, 0, 0, 0]",189,75,114,8,8,0.10666666666666667,0.07017543859649122
"[0, 0, 0, 0, 0, 1, 1, 0, 0, 0, 0, 0, 0, 1, 0]",2932,2449,483,220,42,0.08983258472846059,0.08695652173913043
"[0, 0, 1, 0, 0, 1, 0, 1, 0, 0, 1, 0, 0, 0, 0]",575,405,170,36,13,0.08888888888888889,0.07647058823529412
"[0, 1, 1, 0, 0, 0, 0, 0, 1, 1, 0, 0, 1, 1, 0]",393,244,149,17,12,0.06967213114754098,0.08053691275167785
"[1, 0, 0, 0, 0, 1, 1, 1, 1, 1, 1, 1, 1, 0, 0]",1928,340,1588,33,145,0.09705882352941177,0.09130982367758186
"[1, 0, 1, 1, 0, 0, 0, 1, 1, 1, 1, 1, 0, 1, 0]",152,55,97,4,8,0.07272727272727272,0.08247422680412371
"[0, 1, 1, 1, 1, 1, 1, 1, 1, 1, 0, 1, 1, 0, 0]",759,274,485,25,47,0.09124087591240876,0.09690721649484536
"[1, 1, 0, 0, 1, 1, 0, 1, 0, 0, 1, 1, 1, 1, 0]",198,79,119,7,13,0.08860759493670886,0.1092436974789916
"[0, 0, 1, 1, 1, 1, 1, 1, 0, 1, 0, 1, 0, 1, 1]",306,109,197,11,22,0.10091743119266056,0.1116751269035533
"[1, 1, 0, 1, 0, 1, 1, 1, 1, 1, 1, 0, 1, 0, 0]",251,93,158,7,11,0.07526881720430108,0.06962025316455696
"[0, 1, 0, 1, 1, 0, 1, 1, 0, 0, 0, 0, 0, 1, 0]",170,98,72,10,10,0.10204081632653061,0.1388888888888889
"[1, 0, 0, 0, 0, 0, 1, 0, 0, 1, 0, 0, 0, 1, 0]",489,321,168,36,16,0.11214953271028037,0.09523809523809523
"[0, 0, 0, 0, 1, 1, 0, 0, 0, 0, 0, 1, 0, 0, 1]",866,623,243,56,27,0.0898876404494382,0.1111111111111111
"[1, 1, 1, 1, 0, 0, 0, 0, 0, 1, 1, 1, 1, 1, 1]",910,279,631,24,60,0.08602150537634409,0.09508716323296355
"[1, 1, 1, 1, 1, 0, 0, 0, 0, 0, 1, 1, 1, 1, 1]",879,230,649,19,55,0.08260869565217391,0.0847457627118644
"[0, 0, 1, 0, 0, 1, 0, 0, 1, 1, 0, 1, 0, 0, 0]",212,141,71,10,7,0.07092198581560284,0.09859154929577464
"[1, 0, 0, 0, 0, 0, 1, 0, 0, 1, 0, 0, 1, 1, 0]",302,192,110,16,11,0.08333333333333333,0.1
"[1, 1, 0, 0, 1, 0, 0, 0, 0, 0, 1, 0, 0, 1, 0]",242,170,72,19,9,0.11176470588235295,0.125
"[0, 1, 0, 1, 0, 1, 1, 1, 0, 1, 0, 1, 0, 0, 1]",96,44,52,5,5,0.11363636363636363,0.09615384615384616
"[0, 0, 1, 0, 1, 0, 1, 1, 1, 0, 1, 0, 1, 0, 0]",102,55,47,4,6,0.07272727272727272,0.1276595744680851
"[0, 0, 1, 1, 0, 1, 1, 1, 0, 0, 0, 1, 0, 1, 0]",105,56,49,11,7,0.19642857142857142,0.14285714285714285
"[0, 0, 1, 1, 0, 0, 1, 1, 0, 1, 1, 1, 0, 0, 0]",170,95,75,9,5,0.09473684210526316,0.06666666666666667
"[1, 1, 1, 1, 1, 0, 0, 0, 1, 1, 0, 0, 0, 1, 0]",128,58,70,5,6,0.08620689655172414,0.08571428571428572
"[0, 0, 1, 0, 0, 1, 1, 0, 1, 1, 1, 0, 1, 0, 0]",108,52,56,3,6,0.057692307692307696,0.10714285714285714
"[0, 0, 0, 1, 0, 0, 0, 0, 0, 0, 0, 0, 1, 1, 1]",2227,1767,460,173,43,0.09790605546123372,0.09347826086956522
"[0, 0, 0, 0, 1, 0, 1, 0, 1, 0, 0, 0, 0, 0, 1]",543,381,162,38,13,0.09973753280839895,0.08024691358024691
"[0, 0, 0, 0, 0, 1, 0, 1, 1, 0, 0, 0, 1, 0, 1]",261,172,89,20,9,0.11627906976744186,0.10112359550561797
"[0, 0, 1, 0, 1, 0, 1, 1, 0, 0, 1, 1, 0, 1, 1]",126,58,68,8,7,0.13793103448275862,0.10294117647058823
"[0, 0, 0, 0, 0, 0, 1, 0, 0, 0, 0, 0, 1, 0, 1]",1783,1342,441,129,42,0.09612518628912071,0.09523809523809523
"[0, 0, 0, 1, 1, 0, 1, 0, 1, 1, 0, 0, 0, 0, 0]",368,259,109,20,12,0.07722007722007722,0.11009174311926606
"[0, 0, 1, 0, 1, 0, 0, 0, 0, 0, 1, 1, 0, 0, 1]",376,244,132,35,12,0.14344262295081966,0.09090909090909091
"[0, 1, 0, 0, 1, 1, 0, 1, 0, 0, 0, 1, 1, 1, 1]",147,73,74,11,7,0.1506849315068493,0.0945945945945946
"[0, 0, 1, 1, 0, 0, 1, 0, 0, 1, 1, 0, 1, 0, 0]",155,86,69,7,4,0.08139534883720931,0.057971014492753624
"[0, 1, 0, 1, 0, 1, 1, 0, 0, 0, 1, 0, 1, 1, 1]",152,81,71,9,8,0.1111111111111111,0.11267605633802817
"[1, 0, 1, 0, 0, 1, 0, 1, 0, 1, 0, 1, 1, 0, 0]",122,62,60,5,4,0.08064516129032258,0.06666666666666667
"[0, 0, 1, 1, 0, 1, 0, 0, 1, 0, 1, 0, 1, 0, 1]",91,55,36,7,1,0.12727272727272726,0.027777777777777776
"[0, 0, 0, 0, 0, 1, 1, 1, 1, 1, 1, 0, 1, 0, 0]",260,176,84,15,10,0.08522727272727272,0.11904761904761904
"[0, 0, 1, 1, 1, 0, 0, 0, 0, 1, 0, 0, 0, 0, 0]",651,472,179,37,17,0.07838983050847458,0.09497206703910614
"[1, 1, 0, 0, 0, 0, 0, 0, 1, 1, 0, 1, 0, 0, 0]",443,291,152,27,10,0.09278350515463918,0.06578947368421052
"[0, 1, 1, 0, 0, 0, 0, 0, 0, 1, 1, 0, 1, 0, 0]",460,346,114,33,7,0.0953757225433526,0.06140350877192982
"[1, 1, 0, 0, 0, 1, 1, 1, 1, 1, 1, 0, 1, 0, 0]",155,72,83,5,8,0.06944444444444445,0.0963855421686747
"[1, 1, 1, 1, 0, 0, 0, 1, 1, 1, 1, 1, 1, 0, 1]",679,193,486,15,45,0.07772020725388601,0.09259259259259259
"[1, 0, 1, 0, 1, 1, 1, 1, 1, 0, 0, 0, 1, 1, 1]",326,119,207,7,17,0.058823529411764705,0.0821256038647343
"[1, 0, 0, 0, 1, 0, 1, 1, 1, 1, 0, 1, 0, 1, 1]",170,64,106,7,8,0.109375,0.07547169811320754
"[1, 0, 0, 1, 1, 0, 1, 1, 0, 0, 0, 0, 0, 0, 1]",226,117,109,9,14,0.07692307692307693,0.12844036697247707
"[1, 1, 1, 0, 0, 1, 1, 0, 1, 1, 0, 0, 0, 0, 0]",217,96,121,9,8,0.09375,0.06611570247933884
"[0, 0, 0, 1, 0, 1, 0, 1, 1, 0, 0, 1, 1, 1, 0]",124,75,49,5,2,0.06666666666666667,0.04081632653061224
"[0, 1, 0, 1, 1, 1, 0, 1, 1, 0, 0, 1, 1, 1, 0]",141,56,85,4,14,0.07142857142857142,0.16470588235294117
"[0, 1, 0, 0, 0, 0, 0, 1, 1, 0, 1, 0, 1, 0, 1]",134,80,54,9,1,0.1125,0.018518518518518517
"[0, 0, 1, 1, 1, 1, 0, 1, 0, 1, 1, 0, 1, 1, 1]",361,129,232,12,19,0.09302325581395349,0.08189655172413793
"[1, 1, 1, 0, 1, 1, 1, 0, 0, 1, 1, 1, 0, 1, 1]",574,163,411,28,39,0.17177914110429449,0.0948905109489051
"[0, 0, 1, 0, 0, 1, 0, 0, 0, 0, 1, 0, 0, 0, 0]",1609,1218,391,120,32,0.09852216748768473,0.08184143222506395
"[1, 0, 0, 1, 0, 1, 0, 0, 0, 0, 0, 1, 0, 0, 0]",564,401,163,32,12,0.0798004987531172,0.0736196319018405
"[1, 0, 0, 1, 1, 1, 1, 1, 1, 1, 0, 1, 0, 0, 1]",335,91,244,8,25,0.08791208791208792,0.10245901639344263
"[1, 0, 1, 0, 0, 1, 1, 1, 1, 1, 1, 1, 0, 1, 0]",249,101,148,12,15,0.1188118811881188,0.10135135135135136
"[1, 1, 1, 0, 1, 0, 1, 0, 1, 1, 0, 1, 1, 1, 1]",578,180,398,17,33,0.09444444444444444,0.0829145728643216
"[1, 0, 0, 1, 1, 0, 1, 1, 1, 1, 0, 0, 1, 0, 0]",128,59,69,3,5,0.05084745762711865,0.07246376811594203
"[0, 0, 0, 1, 0, 0, 1, 1, 0, 0, 0, 0, 1, 1, 0]",626,426,200,44,27,0.10328638497652583,0.135
"[0, 0, 0, 0, 0, 0, 1, 1, 0, 0, 1, 1, 0, 0, 1]",2302,1456,846,132,77,0.09065934065934066,0.09101654846335698
"[1, 0, 0, 1, 1, 0, 0, 1, 1, 0, 0, 0, 0, 0, 0]",2178,629,1549,62,130,0.0985691573926868,0.08392511297611362
"[0, 1, 0, 0, 1, 1, 0, 0, 1, 1, 0, 0, 0, 0, 0]",781,503,278,49,19,0.09741550695825049,0.0683453237410072
"[0, 1, 1, 0, 0, 1, 0, 1, 0, 1, 0, 1, 1, 0, 0]",132,75,57,9,6,0.12,0.10526315789473684
"[1, 1, 1, 1, 1, 1, 0, 0, 1, 1, 0, 0, 1, 0, 1]",613,235,378,28,40,0.11914893617021277,0.10582010582010581
"[1, 0, 1, 1, 1, 0, 1, 1, 1, 0, 1, 1, 1, 0, 0]",255,95,160,14,16,0.14736842105263157,0.1
"[1, 0, 0, 1, 0, 1, 1, 1, 0, 1, 1, 1, 0, 1, 1]",236,81,155,12,14,0.14814814814814814,0.09032258064516129
"[0, 0, 0, 1, 1, 1, 0, 1, 0, 0, 0, 1, 0, 0, 1]",173,96,77,13,6,0.13541666666666666,0.07792207792207792
"[0, 0, 1, 1, 0, 0, 0, 0, 0, 0, 0, 0, 1, 1, 0]",4120,2863,1257,252,138,0.08801955990220049,0.10978520286396182
"[0, 0, 0, 1, 1, 1, 0, 0, 0, 1, 1, 0, 0, 1, 0]",153,98,55,11,12,0.11224489795918367,0.21818181818181817
"[1, 0, 0, 1, 1, 0, 1, 1, 0, 1, 0, 0, 0, 0, 0]",177,100,77,17,7,0.17,0.09090909090909091
"[0, 0, 0, 1, 1, 1, 0, 0, 1, 0, 0, 0, 1, 0, 0]",245,166,79,22,10,0.13253012048192772,0.12658227848101267
"[1, 0, 0, 0, 1, 0, 0, 1, 0, 0, 1, 0, 1, 0, 0]",208,131,77,14,9,0.10687022900763359,0.11688311688311688
"[1, 1, 0, 0, 1, 0, 0, 0, 1, 0, 1, 0, 0, 0, 1]",160,96,64,8,10,0.08333333333333333,0.15625
"[0, 1, 1, 1, 1, 0, 1, 0, 1, 1, 0, 0, 0, 1, 0]",121,66,55,4,8,0.06060606060606061,0.14545454545454545
"[0, 0, 0, 1, 0, 0, 1, 1, 1, 1, 1, 0, 0, 1, 0]",119,62,57,6,6,0.0967741935483871,0.10526315789473684
"[1, 1, 0, 1, 0, 1, 0, 0, 1, 1, 1, 1, 1, 0, 0]",175,71,104,3,9,0.04225352112676056,0.08653846153846154
"[1, 0, 0, 0, 0, 0, 0, 0, 1, 0, 0, 0, 1, 0, 1]",571,388,183,30,14,0.07731958762886598,0.07650273224043716
"[0, 0, 1, 0, 0, 1, 1, 1, 0, 0, 0, 0, 0, 0, 0]",883,647,236,67,22,0.1035548686244204,0.09322033898305085
"[0, 0, 0, 0, 1, 1, 0, 0, 0, 0, 0, 0, 0, 1, 0]",2599,1982,617,191,67,0.0963673057517659,0.1085899513776337
"[0, 0, 1, 1, 0, 0, 1, 1, 0, 0, 1, 1, 1, 1, 1]",2262,927,1335,82,121,0.08845738942826321,0.09063670411985018
"[0, 0, 1, 0, 0, 0, 1, 1, 0, 0, 1, 1, 0, 0, 1]",348,221,127,19,11,0.08597285067873303,0.08661417322834646
"[1, 1, 1, 1, 0, 0, 0, 0, 1, 1, 1, 1, 1, 0, 0]",439,162,277,13,26,0.08024691358024691,0.09386281588447654
"[0, 0, 0, 1, 0, 0, 0, 0, 1, 0, 0, 1, 1, 1, 1]",283,194,89,30,9,0.15463917525773196,0.10112359550561797
"[0, 0, 0, 1, 0, 0, 1, 1, 1, 1, 1, 1, 1, 1, 1]",655,305,350,23,31,0.07540983606557378,0.08857142857142856
"[1, 0, 1, 0, 0, 0, 0, 1, 0, 0, 1, 1, 1, 1, 1]",193,95,98,10,11,0.10526315789473684,0.11224489795918367
"[1, 1, 1, 0, 0, 1, 1, 0, 1, 1, 1, 1, 0, 1, 0]",241,78,163,6,9,0.07692307692307693,0.05521472392638037
"[0, 1, 1, 1, 1, 0, 0, 1, 1, 1, 1, 1, 1, 0, 0]",2173,1498,675,147,58,0.09813084112149532,0.08592592592592592
"[1, 1, 1, 0, 0, 0, 1, 1, 1, 1, 1, 0, 1, 1, 1]",743,211,532,19,53,0.09004739336492891,0.09962406015037593
"[1, 0, 0, 0, 0, 0, 0, 0, 1, 1, 1, 0, 0, 0, 1]",332,193,139,18,15,0.09326424870466321,0.1079136690647482
"[0, 1, 1, 1, 0, 1, 0, 1, 0, 1, 0, 1, 1, 1, 1]",288,111,177,12,15,0.10810810810810811,0.0847457627118644
"[1, 0, 1, 1, 1, 0, 1, 0, 1, 0, 1, 0, 1, 1, 1]",265,86,179,6,10,0.06976744186046512,0.055865921787709494
"[1, 1, 1, 1, 0, 1, 1, 1, 0, 1, 0, 1, 0, 1, 0]",232,95,137,10,9,0.10526315789473684,0.06569343065693431
"[1, 0, 1, 0, 1, 1, 1, 1, 0, 1, 1, 1, 0, 1, 1]",487,137,350,10,24,0.072992700729927,0.06857142857142857
"[0, 1, 1, 0, 1, 0, 1, 1, 1, 1, 0, 1, 1, 1, 0]",220,73,147,5,14,0.0684931506849315,0.09523809523809523
"[0, 1, 0, 0, 0, 1, 1, 1, 1, 1, 0, 1, 0, 1, 1]",177,86,91,9,7,0.10465116279069768,0.07692307692307693
"[0, 1, 0, 0, 0, 0, 1, 1, 1, 1, 0, 0, 0, 0, 0]",857,567,290,54,28,0.09523809523809523,0.09655172413793103
"[1, 1, 0, 1, 0, 1, 0, 0, 0, 0, 0, 1, 0, 1, 0]",124,79,45,4,4,0.05063291139240506,0.08888888888888889
"[0, 0, 0, 0, 0, 1, 1, 1, 1, 0, 1, 0, 1, 0, 0]",200,139,61,16,6,0.11510791366906475,0.09836065573770492
"[1, 1, 1, 1, 0, 0, 0, 0, 0, 1, 1, 1, 1, 0, 1]",248,97,151,10,15,0.10309278350515463,0.09933774834437085
"[1, 1, 1, 0, 1, 1, 1, 1, 1, 0, 1, 1, 0, 0, 1]",659,185,474,6,47,0.032432432432432434,0.09915611814345991
"[0, 0, 1, 1, 1, 1, 1, 1, 0, 1, 1, 1, 1, 0, 1]",687,233,454,25,43,0.1072961373390558,0.0947136563876652
"[1, 0, 0, 1, 1, 0, 1, 1, 1, 1, 0, 1, 1, 0, 1]",245,86,159,9,14,0.10465116279069768,0.0880503144654088
"[0, 1, 0, 1, 1, 0, 0, 1, 1, 0, 0, 1, 1, 1, 1]",490,226,264,18,23,0.07964601769911504,0.08712121212121213
"[1, 1, 0, 1, 1, 1, 1, 1, 1, 0, 0, 0, 1, 0, 1]",248,91,157,6,21,0.06593406593406594,0.1337579617834395
"[0, 0, 0, 1, 1, 0, 0, 0, 0, 1, 0, 1, 1, 1, 1]",329,251,78,15,7,0.05976095617529881,0.08974358974358974
"[1, 0, 0, 0, 0, 1, 1, 0, 0, 0, 0, 1, 0, 1, 1]",320,114,206,17,17,0.14912280701754385,0.0825242718446602
"[1, 1, 1, 0, 0, 0, 0, 1, 0, 0, 1, 0, 0, 0, 0]",307,154,153,19,17,0.12337662337662338,0.1111111111111111
"[1, 1, 0, 0, 0, 1, 1, 1, 0, 0, 0, 0, 0, 0, 1]",264,132,132,9,10,0.06818181818181818,0.07575757575757576
"[0, 1, 0, 0, 0, 1, 1, 1, 1, 0, 1, 0, 1, 0, 0]",92,55,37,3,4,0.05454545454545454,0.10810810810810811
"[0, 0, 1, 0, 0, 0, 1, 1, 1, 1, 0, 1, 0, 1, 0]",105,60,45,5,5,0.08333333333333333,0.1111111111111111
"[0, 1, 0, 1, 0, 1, 0, 0, 0, 1, 0, 1, 0, 1, 1]",106,58,48,5,2,0.08620689655172414,0.041666666666666664
"[0, 1, 1, 0, 0, 1, 0, 1, 0, 0, 1, 0, 0, 1, 1]",148,82,66,6,5,0.07317073170731707,0.07575757575757576
"[1, 1, 0, 1, 1, 1, 1, 0, 1, 1, 0, 0, 1, 1, 1]",797,247,550,22,48,0.08906882591093117,0.08727272727272728
"[0, 1, 0, 0, 1, 1, 1, 1, 0, 1, 1, 0, 0, 1, 1]",203,95,108,10,14,0.10526315789473684,0.12962962962962962
"[0, 0, 0, 1, 0, 0, 1, 1, 1, 1, 0, 1, 1, 0, 0]",137,77,60,6,7,0.07792207792207792,0.11666666666666667
"[1, 0, 0, 0, 1, 0, 0, 0, 1, 1, 0, 0, 1, 1, 0]",260,146,114,14,13,0.0958904109589041,0.11403508771929824
"[0, 1, 0, 0, 0, 1, 0, 0, 0, 1, 1, 0, 0, 1, 1]",258,159,99,10,11,0.06289308176100629,0.1111111111111111
"[0, 0, 1, 1, 1, 1, 1, 1, 0, 0, 1, 0, 1, 0, 1]",255,113,142,13,12,0.11504424778761062,0.08450704225352113
"[0, 1, 0, 0, 1, 1, 1, 1, 1, 1, 0, 0, 1, 0, 1]",183,83,100,6,9,0.07228915662650602,0.09
"[1, 1, 1, 1, 1, 1, 1, 1, 0, 1, 1, 0, 1, 0, 1]",1716,416,1300,43,113,0.10336538461538461,0.08692307692307692
"[0, 1, 0, 0, 1, 0, 1, 1, 1, 1, 1, 1, 1, 1, 1]",860,287,573,39,78,0.13588850174216027,0.13612565445026178
"[1, 1, 1, 0, 0, 0, 1, 0, 0, 1, 0, 1, 1, 1, 1]",205,75,130,8,16,0.10666666666666667,0.12307692307692308
"[1, 0, 1, 1, 1, 1, 0, 0, 1, 1, 1, 1, 1, 1, 0]",1144,351,793,21,88,0.05982905982905983,0.11097099621689786
"[0, 1, 0, 1, 1, 0, 0, 1, 1, 1, 1, 1, 1, 1, 1]",1246,417,829,39,68,0.09352517985611511,0.08202653799758745
"[1, 0, 1, 0, 0, 1, 1, 1, 0, 0, 0, 0, 1, 0, 0]",129,78,51,4,0,0.05128205128205128,0.0
"[1, 1, 1, 1, 0, 1, 0, 1, 1, 1, 0, 0, 1, 0, 1]",241,85,156,12,17,0.1411764705882353,0.10897435897435898
"[1, 1, 1, 1, 0, 1, 1, 1, 1, 1, 0, 1, 0, 1, 1]",1587,375,1212,34,114,0.09066666666666667,0.09405940594059406
"[1, 1, 1, 1, 1, 0, 1, 0, 1, 1, 0, 0, 0, 0, 1]",255,106,149,5,13,0.04716981132075472,0.087248322147651
"[1, 0, 0, 1, 1, 1, 1, 1, 0, 1, 0, 1, 1, 0, 0]",228,80,148,12,17,0.15,0.11486486486486487
"[1, 1, 1, 0, 0, 1, 1, 1, 1, 1, 0, 1, 1, 0, 0]",372,102,270,9,19,0.08823529411764706,0.07037037037037037
"[0, 1, 1, 0, 0, 1, 0, 1, 0, 0, 0, 0, 1, 1, 1]",209,124,85,14,7,0.11290322580645161,0.08235294117647059
"[1, 0, 1, 1, 1, 1, 0, 1, 1, 0, 1, 0, 1, 1, 0]",267,94,173,4,16,0.0425531914893617,0.09248554913294797
"[1, 1, 0, 0, 0, 1, 0, 0, 1, 0, 1, 1, 0, 0, 0]",196,117,79,12,7,0.10256410256410256,0.08860759493670886
"[1, 0, 0, 0, 0, 0, 1, 0, 0, 0, 0, 0, 1, 1, 1]",535,311,224,36,27,0.1157556270096463,0.12053571428571429
"[1, 1, 1, 0, 0, 0, 0, 0, 1, 0, 0, 0, 0, 0, 1]",317,187,130,25,10,0.13368983957219252,0.07692307692307693
"[0, 1, 0, 0, 0, 1, 1, 0, 0, 1, 1, 0, 0, 0, 1]",220,134,86,13,8,0.09701492537313433,0.09302325581395349
"[1, 0, 1, 1, 1, 0, 0, 1, 1, 1, 0, 1, 1, 0, 1]",256,86,170,8,21,0.09302325581395349,0.12352941176470589
"[1, 1, 1, 0, 0, 0, 0, 0, 1, 1, 0, 1, 1, 1, 0]",154,60,94,11,7,0.18333333333333332,0.07446808510638298
"[1, 1, 1, 1, 0, 0, 0, 0, 0, 1, 1, 0, 1, 1, 1]",366,154,212,16,27,0.1038961038961039,0.12735849056603774
"[1, 1, 1, 1, 1, 1, 1, 0, 0, 0, 0, 0, 1, 1, 0]",426,131,295,11,26,0.08396946564885496,0.08813559322033898
"[0, 1, 1, 1, 1, 1, 1, 1, 0, 0, 0, 0, 0, 1, 1]",350,168,182,17,13,0.10119047619047619,0.07142857142857142
"[1, 1, 1, 0, 0, 1, 0, 0, 0, 1, 0, 0, 1, 0, 1]",127,66,61,11,5,0.16666666666666666,0.08196721311475409
"[0, 1, 1, 1, 0, 0, 1, 0, 0, 0, 1, 0, 0, 1, 0]",139,87,52,9,3,0.10344827586206896,0.057692307692307696
"[0, 0, 1, 1, 1, 0, 0, 1, 0, 0, 0, 1, 0, 0, 1]",172,100,72,13,8,0.13,0.1111111111111111
"[1, 0, 0, 0, 0, 0, 1, 1, 1, 0, 0, 1, 0, 0, 0]",284,172,112,16,9,0.09302325581395349,0.08035714285714286
"[0, 0, 0, 0, 1, 0, 1, 1, 1, 0, 1, 0, 1, 0, 1]",114,53,61,4,5,0.07547169811320754,0.08196721311475409
"[0, 0, 1, 0, 0, 1, 0, 1, 1, 1, 1, 0, 0, 0, 0]",243,138,105,12,12,0.08695652173913043,0.11428571428571428
"[1, 1, 0, 0, 0, 1, 1, 0, 1, 0, 1, 1, 0, 1, 1]",170,67,103,4,13,0.05970149253731343,0.1262135922330097
"[0, 1, 0, 1, 0, 0, 0, 1, 1, 1, 1, 0, 1, 0, 1]",99,52,47,3,6,0.057692307692307696,0.1276595744680851
"[1, 1, 1, 0, 0, 1, 1, 0, 0, 0, 0, 1, 0, 1, 1]",318,70,248,9,22,0.12857142857142856,0.08870967741935484
"[1, 1, 1, 0, 0, 0, 0, 0, 1, 0, 0, 0, 0, 1, 1]",326,164,162,13,20,0.07926829268292683,0.12345679012345678
"[1, 0, 0, 0, 1, 1, 1, 0, 0, 0, 0, 1, 1, 1, 1]",320,133,187,11,21,0.08270676691729323,0.11229946524064172
"[0, 0, 1, 1, 1, 0, 0, 0, 1, 1, 1, 0, 1, 0, 0]",144,88,56,7,7,0.07954545454545454,0.125
"[0, 0, 0, 1, 1, 0, 1, 1, 0, 0, 0, 0, 0, 0, 0]",900,678,222,71,21,0.10471976401179942,0.0945945945945946
"[1, 0, 0, 0, 1, 1, 1, 1, 1, 0, 0, 1, 0, 0, 0]",164,88,76,11,6,0.125,0.07894736842105263
"[1, 0, 1, 1, 0, 0, 1, 1, 1, 0, 1, 0, 1, 1, 1]",252,98,154,9,19,0.09183673469387756,0.12337662337662338
"[0, 0, 0, 0, 1, 1, 1, 1, 0, 0, 1, 1, 0, 1, 1]",491,240,251,21,24,0.0875,0.09561752988047809
"[1, 0, 0, 0, 0, 1, 0, 1, 0, 0, 0, 0, 1, 1, 1]",272,136,136,8,12,0.058823529411764705,0.08823529411764706
"[0, 0, 1, 0, 0, 0, 0, 1, 0, 1, 0, 0, 0, 0, 1]",583,408,175,46,14,0.11274509803921569,0.08
"[1, 0, 0, 1, 0, 0, 0, 0, 1, 0, 1, 0, 0, 0, 0]",562,385,177,34,14,0.08831168831168831,0.07909604519774012
"[1, 0, 0, 0, 1, 1, 1, 1, 1, 0, 0, 1, 0, 1, 0]",117,52,65,9,7,0.17307692307692307,0.1076923076923077
"[0, 1, 1, 0, 1, 0, 1, 1, 1, 1, 1, 0, 0, 1, 1]",387,136,251,15,34,0.11029411764705882,0.13545816733067728
"[1, 1, 1, 1, 1, 0, 1, 1, 0, 1, 0, 1, 1, 0, 1]",490,149,341,16,26,0.10738255033557047,0.07624633431085044
"[0, 1, 1, 0, 1, 1, 1, 1, 0, 0, 1, 1, 0, 1, 1]",266,103,163,9,18,0.08737864077669903,0.11042944785276074
"[0, 0, 1, 1, 0, 1, 1, 1, 1, 0, 0, 1, 1, 0, 1]",145,62,83,9,9,0.14516129032258066,0.10843373493975904
"[0, 1, 1, 1, 1, 1, 1, 0, 1, 0, 0, 1, 0, 1, 1]",253,101,152,11,13,0.10891089108910891,0.08552631578947369
"[0, 0, 1, 1, 0, 0, 1, 1, 0, 0, 0, 0, 0, 1, 0]",619,402,217,31,21,0.07711442786069651,0.0967741935483871
"[0, 1, 1, 1, 0, 0, 0, 1, 1, 0, 1, 0, 0, 1, 1]",130,69,61,2,4,0.028985507246376812,0.06557377049180328
"[1, 0, 1, 1, 1, 0, 0, 0, 1, 1, 0, 1, 0, 0, 1]",111,48,63,2,4,0.041666666666666664,0.06349206349206349
"[1, 1, 1, 0, 1, 0, 0, 1, 0, 1, 1, 1, 1, 0, 0]",194,79,115,9,17,0.11392405063291139,0.14782608695652175
"[0, 0, 0, 0, 1, 1, 1, 0, 0, 1, 0, 1, 0, 1, 1]",154,91,63,6,6,0.06593406593406594,0.09523809523809523
"[0, 1, 0, 1, 1, 1, 1, 1, 1, 1, 0, 1, 1, 1, 1]",1749,410,1339,39,131,0.0951219512195122,0.09783420463032114
"[0, 0, 1, 1, 1, 1, 0, 1, 1, 1, 1, 0, 0, 1, 1]",496,168,328,17,31,0.10119047619047619,0.09451219512195122
"[1, 1, 1, 0, 0, 0, 0, 0, 1, 1, 1, 1, 0, 1, 1]",256,97,159,11,10,0.1134020618556701,0.06289308176100629
"[1, 1, 1, 0, 0, 0, 1, 1, 0, 0, 0, 1, 0, 1, 0]",121,58,63,8,6,0.13793103448275862,0.09523809523809523
"[0, 1, 1, 0, 0, 1, 1, 0, 0, 1, 1, 0, 0, 0, 0]",1937,1600,337,143,34,0.089375,0.10089020771513353
"[1, 0, 0, 1, 0, 0, 1, 1, 0, 0, 1, 1, 0, 0, 1]",280,139,141,14,9,0.10071942446043165,0.06382978723404255
"[1, 0, 0, 0, 0, 0, 0, 0, 0, 1, 0, 0, 1, 1, 1]",813,376,437,39,50,0.10372340425531915,0.11441647597254005
"[1, 1, 1, 0, 0, 0, 1, 0, 0, 0, 0, 0, 1, 0, 0]",261,157,104,9,10,0.05732484076433121,0.09615384615384616
"[0, 0, 0, 0, 0, 0, 0, 0, 1, 1, 1, 1, 0, 1, 1]",608,390,218,45,26,0.11538461538461539,0.11926605504587157
"[0, 0, 1, 1, 1, 0, 0, 0, 0, 0, 0, 1, 1, 0, 1]",204,116,88,7,11,0.0603448275862069,0.125
"[1, 0, 0, 0, 0, 1, 0, 1, 1, 0, 1, 1, 0, 0, 1]",121,57,64,4,8,0.07017543859649122,0.125
"[1, 1, 0, 0, 0, 1, 1, 1, 1, 0, 1, 0, 0, 0, 1]",138,63,75,4,4,0.06349206349206349,0.05333333333333334
"[0, 1, 1, 0, 0, 1, 1, 0, 0, 0, 1, 1, 1, 1, 0]",206,111,95,9,6,0.08108108108108109,0.06315789473684211
"[1, 1, 1, 1, 1, 0, 1, 0, 0, 1, 1, 1, 0, 1, 0]",229,77,152,12,15,0.15584415584415584,0.09868421052631579
"[0, 1, 1, 1, 1, 1, 0, 1, 0, 0, 1, 1, 1, 0, 1]",229,91,138,9,12,0.0989010989010989,0.08695652173913043
"[0, 1, 1, 1, 1, 1, 1, 1, 1, 0, 0, 0, 1, 0, 0]",251,150,101,12,12,0.08,0.1188118811881188
"[0, 0, 0, 0, 1, 0, 1, 1, 0, 0, 0, 0, 1, 0, 0]",558,406,152,34,16,0.08374384236453201,0.10526315789473684
"[1, 0, 0, 0, 0, 1, 0, 1, 1, 0, 0, 0, 0, 1, 0]",223,127,96,10,9,0.07874015748031496,0.09375
"[1, 1, 1, 1, 0, 1, 1, 0, 1, 0, 0, 1, 0, 0, 1]",139,55,84,6,9,0.10909090909090909,0.10714285714285714
"[1, 1, 1, 1, 1, 0, 0, 1, 0, 0, 1, 0, 0, 1, 1]",249,87,162,8,23,0.09195402298850575,0.1419753086419753
"[0, 1, 0, 1, 1, 0, 1, 1, 1, 1, 0, 0, 1, 1, 1]",375,141,234,11,22,0.07801418439716312,0.09401709401709402
"[1, 0, 1, 0, 0, 0, 1, 0, 0, 1, 0, 1, 0, 1, 1]",123,50,73,6,5,0.12,0.0684931506849315
"[0, 1, 1, 0, 1, 1, 1, 0, 1, 1, 0, 0, 0, 0, 0]",174,91,83,6,13,0.06593406593406594,0.1566265060240964
"[0, 1, 0, 0, 1, 1, 0, 1, 1, 1, 0, 1, 1, 0, 0]",111,54,57,4,6,0.07407407407407407,0.10526315789473684
"[1, 0, 1, 0, 1, 1, 0, 1, 1, 0, 0, 1, 1, 1, 1]",410,152,258,10,20,0.06578947368421052,0.07751937984496124
"[1, 1, 1, 1, 1, 0, 0, 0, 0, 0, 1, 0, 1, 1, 1]",333,84,249,5,29,0.05952380952380952,0.11646586345381527
"[0, 0, 0, 0, 1, 0, 1, 1, 1, 0, 1, 1, 0, 1, 0]",97,52,45,4,5,0.07692307692307693,0.1111111111111111
"[0, 1, 1, 1, 0, 1, 1, 1, 0, 0, 0, 0, 1, 0, 1]",106,48,58,3,5,0.0625,0.08620689655172414
"[1, 0, 1, 1, 1, 1, 1, 0, 0, 1, 0, 1, 1, 0, 0]",188,77,111,8,15,0.1038961038961039,0.13513513513513514
"[1, 0, 1, 0, 0, 1, 1, 1, 1, 1, 1, 1, 0, 0, 1]",432,155,277,18,35,0.11612903225806452,0.1263537906137184
"[1, 1, 0, 1, 0, 0, 1, 1, 1, 1, 1, 1, 1, 0, 0]",436,160,276,21,24,0.13125,0.08695652173913043
"[1, 0, 1, 1, 0, 1, 0, 1, 0, 1, 0, 1, 1, 1, 1]",248,87,161,7,13,0.08045977011494253,0.08074534161490683
"[0, 1, 0, 1, 0, 1, 1, 0, 1, 0, 1, 0, 1, 0, 1]",91,49,42,8,3,0.16326530612244897,0.07142857142857142
"[1, 1, 0, 0, 1, 1, 1, 0, 0, 0, 1, 1, 1, 1, 1]",468,171,297,14,25,0.08187134502923976,0.08417508417508418
"[1, 0, 0, 1, 1, 0, 0, 1, 0, 0, 1, 0, 0, 0, 0]",313,184,129,28,14,0.15217391304347827,0.10852713178294573
"[0, 1, 1, 0, 0, 0, 1, 0, 0, 1, 0, 1, 1, 1, 1]",182,95,87,9,7,0.09473684210526316,0.08045977011494253
"[1, 1, 0, 0, 1, 1, 0, 0, 0, 1, 0, 0, 1, 0, 1]",151,80,71,8,5,0.1,0.07042253521126761
"[1, 0, 1, 0, 1, 1, 1, 1, 0, 0, 1, 0, 1, 0, 0]",108,53,55,10,4,0.18867924528301888,0.07272727272727272
"[1, 0, 0, 0, 1, 1, 1, 0, 1, 1, 0, 1, 1, 0, 1]",132,42,90,5,7,0.11904761904761904,0.07777777777777778
"[0, 0, 0, 0, 0, 0, 1, 1, 0, 0, 0, 0, 1, 0, 0]",2690,2045,645,190,60,0.09290953545232274,0.09302325581395349
"[0, 0, 0, 0, 0, 1, 0, 1, 0, 0, 1, 0, 1, 1, 1]",245,161,84,13,6,0.08074534161490683,0.07142857142857142
"[1, 0, 1, 1, 0, 0, 1, 0, 0, 1, 1, 0, 1, 0, 0]",105,53,52,3,5,0.05660377358490566,0.09615384615384616
"[1, 0, 1, 1, 0, 0, 1, 1, 0, 1, 1, 1, 0, 1, 1]",217,68,149,10,14,0.14705882352941177,0.09395973154362416
"[0, 1, 1, 1, 1, 0, 1, 1, 0, 1, 1, 0, 0, 1, 1]",346,146,200,13,24,0.08904109589041095,0.12
"[1, 0, 1, 1, 0, 0, 0, 0, 0, 1, 0, 0, 1, 1, 0]",175,107,68,7,1,0.06542056074766354,0.014705882352941176
"[0, 1, 1, 0, 0, 0, 1, 1, 1, 0, 1, 1, 1, 1, 1]",349,147,202,16,23,0.10884353741496598,0.11386138613861387
"[1, 0, 0, 0, 0, 1, 1, 1, 0, 0, 1, 1, 0, 0, 1]",217,96,121,6,11,0.0625,0.09090909090909091
"[1, 1, 0, 0, 1, 1, 1, 1, 1, 1, 1, 0, 1, 0, 1]",913,250,663,24,68,0.096,0.10256410256410256
"[0, 0, 0, 1, 1, 1, 0, 1, 1, 0, 0, 1, 1, 1, 1]",299,145,154,14,13,0.09655172413793103,0.08441558441558442
"[0, 0, 1, 0, 1, 1, 0, 0, 0, 0, 1, 0, 0, 0, 1]",237,156,81,12,9,0.07692307692307693,0.1111111111111111
"[1, 0, 0, 1, 0, 1, 1, 0, 0, 0, 0, 1, 0, 0, 0]",259,169,90,13,8,0.07692307692307693,0.08888888888888889
"[0, 1, 1, 0, 0, 0, 0, 0, 0, 0, 1, 1, 0, 0, 0]",1264,965,299,91,35,0.09430051813471503,0.11705685618729098
"[0, 0, 1, 1, 0, 0, 0, 1, 1, 0, 0, 0, 0, 0, 0]",1143,813,330,79,36,0.0971709717097171,0.10909090909090909
"[1, 0, 1, 1, 0, 0, 1, 1, 1, 1, 1, 1, 0, 0, 1]",739,245,494,20,48,0.08163265306122448,0.09716599190283401
"[1, 1, 0, 1, 0, 1, 1, 1, 0, 1, 1, 1, 0, 1, 0]",225,82,143,11,16,0.13414634146341464,0.11188811188811189
"[1, 0, 0, 1, 1, 1, 1, 1, 1, 0, 1, 1, 0, 0, 0]",211,71,140,8,11,0.11267605633802817,0.07857142857142857
"[1, 1, 0, 0, 0, 1, 0, 0, 0, 1, 0, 1, 1, 1, 1]",165,82,83,10,7,0.12195121951219512,0.08433734939759036
"[1, 1, 1, 0, 0, 0, 1, 0, 0, 1, 1, 1, 0, 1, 1]",164,55,109,7,14,0.12727272727272726,0.12844036697247707
"[0, 1, 1, 1, 1, 0, 0, 0, 1, 0, 0, 1, 1, 1, 0]",120,60,60,4,7,0.06666666666666667,0.11666666666666667
"[1, 0, 1, 1, 0, 1, 1, 1, 1, 1, 1, 1, 1, 0, 0]",1013,283,730,31,68,0.10954063604240283,0.09315068493150686
"[1, 0, 0, 1, 1, 1, 1, 1, 1, 0, 0, 1, 0, 0, 0]",250,75,175,6,16,0.08,0.09142857142857143
"[1, 1, 0, 0, 0, 0, 1, 1, 0, 1, 1, 0, 0, 0, 0]",273,160,113,24,12,0.15,0.10619469026548672
"[1, 1, 0, 1, 0, 0, 0, 0, 0, 0, 1, 0, 0, 0, 0]",558,380,178,34,20,0.08947368421052632,0.11235955056179775
"[0, 1, 1, 0, 1, 0, 0, 0, 0, 0, 0, 1, 0, 0, 0]",540,369,171,38,20,0.10298102981029811,0.11695906432748537
"[1, 0, 1, 1, 0, 1, 0, 0, 0, 0, 0, 0, 1, 0, 0]",236,143,93,11,8,0.07692307692307693,0.08602150537634409
"[0, 1, 0, 1, 1, 0, 1, 0, 0, 0, 0, 0, 0, 1, 0]",232,147,85,8,10,0.05442176870748299,0.11764705882352941
"[1, 0, 0, 0, 0, 0, 0, 1, 0, 1, 0, 1, 1, 0, 1]",162,80,82,12,14,0.15,0.17073170731707318
"[1, 0, 0, 1, 1, 1, 0, 0, 0, 0, 0, 1, 0, 0, 1]",169,111,58,11,2,0.0990990990990991,0.034482758620689655
"[0, 1, 0, 0, 0, 0, 1, 0, 0, 1, 1, 1, 0, 0, 0]",272,182,90,16,8,0.08791208791208792,0.08888888888888889
"[1, 1, 0, 1, 0, 0, 0, 0, 1, 0, 0, 0, 0, 1, 0]",241,149,92,15,14,0.10067114093959731,0.15217391304347827
"[0, 1, 1, 0, 0, 0, 1, 0, 0, 0, 0, 0, 1, 1, 1]",315,226,89,26,9,0.11504424778761062,0.10112359550561797
"[0, 1, 1, 0, 0, 1, 0, 0, 1, 0, 0, 0, 0, 1, 0]",231,155,76,15,8,0.0967741935483871,0.10526315789473684
"[1, 0, 1, 1, 0, 0, 1, 0, 0, 1, 0, 0, 0, 0, 1]",168,105,63,9,1,0.08571428571428572,0.015873015873015872
"[0, 0, 1, 0, 1, 0, 1, 0, 1, 1, 1, 1, 0, 0, 0]",146,73,73,8,11,0.1095890410958904,0.1506849315068493
"[1, 1, 0, 0, 1, 0, 1, 0, 1, 0, 1, 1, 1, 1, 0]",156,62,94,5,9,0.08064516129032258,0.09574468085106383
"[1, 0, 1, 0, 0, 1, 0, 1, 1, 0, 0, 1, 0, 1, 0]",97,49,48,7,4,0.14285714285714285,0.08333333333333333
"[1, 0, 1, 0, 0, 0, 1, 0, 1, 0, 1, 0, 1, 0, 0]",135,72,63,6,6,0.08333333333333333,0.09523809523809523
"[0, 1, 1, 1, 0, 1, 0, 1, 0, 0, 0, 1, 0, 1, 0]",106,62,44,5,2,0.08064516129032258,0.045454545454545456
"[1, 1, 1, 1, 0, 0, 1, 1, 1, 1, 0, 1, 1, 1, 0]",768,237,531,18,47,0.0759493670886076,0.08851224105461393
"[1, 0, 1, 0, 1, 1, 0, 1, 1, 0, 0, 0, 0, 0, 0]",233,127,106,9,19,0.07086614173228346,0.1792452830188679
"[0, 0, 1, 1, 0, 0, 0, 0, 0, 1, 1, 0, 1, 1, 0]",226,128,98,6,6,0.046875,0.061224489795918366
"[1, 0, 1, 0, 1, 1, 1, 1, 1, 0, 1, 0, 0, 1, 1]",266,97,169,15,16,0.15463917525773196,0.09467455621301775
"[1, 1, 0, 1, 0, 1, 1, 1, 1, 1, 0, 1, 0, 0, 1]",229,76,153,4,15,0.05263157894736842,0.09803921568627451
"[1, 1, 1, 1, 1, 0, 0, 1, 1, 1, 1, 1, 0, 1, 0]",795,166,629,17,52,0.10240963855421686,0.08267090620031796
"[1, 1, 0, 1, 1, 0, 1, 1, 0, 1, 0, 1, 1, 1, 1]",571,166,405,20,38,0.12048192771084337,0.09382716049382717
"[1, 1, 1, 1, 1, 0, 1, 1, 0, 1, 1, 0, 1, 0, 1]",486,145,341,10,37,0.06896551724137931,0.10850439882697947
"[1, 0, 1, 0, 1, 1, 1, 1, 1, 1, 0, 1, 1, 0, 1]",462,142,320,15,29,0.1056338028169014,0.090625
"[0, 1, 1, 1, 1, 1, 1, 1, 0, 0, 0, 0, 1, 0, 0]",203,116,87,11,12,0.09482758620689655,0.13793103448275862
"[0, 0, 0, 0, 1, 1, 1, 0, 0, 1, 1, 1, 1, 1, 1]",483,234,249,19,18,0.0811965811965812,0.07228915662650602
"[1, 0, 0, 0, 0, 1, 1, 1, 0, 0, 1, 1, 1, 1, 1]",373,116,257,11,15,0.09482758620689655,0.058365758754863814
"[1, 1, 1, 0, 0, 0, 1, 0, 1, 0, 1, 0, 0, 1, 0]",93,55,38,4,5,0.07272727272727272,0.13157894736842105
"[1, 0, 0, 0, 0, 0, 0, 0, 0, 0, 0, 1, 0, 1, 0]",1765,1161,604,111,54,0.09560723514211886,0.08940397350993377
"[0, 0, 0, 0, 1, 1, 0, 0, 1, 1, 1, 0, 0, 0, 0]",567,359,208,30,12,0.08356545961002786,0.057692307692307696
"[1, 1, 0, 1, 1, 0, 0, 0, 0, 0, 0, 1, 1, 0, 0]",463,257,206,25,18,0.09727626459143969,0.08737864077669903
"[0, 1, 0, 0, 1, 1, 0, 1, 0, 0, 0, 0, 0, 1, 1]",202,116,86,10,12,0.08620689655172414,0.13953488372093023
"[0, 0, 0, 0, 0, 0, 1, 0, 0, 1, 1, 0, 1, 0, 0]",584,423,161,34,10,0.08037825059101655,0.062111801242236024
"[1, 0, 0, 1, 0, 0, 1, 1, 1, 1, 0, 0, 0, 0, 0]",364,206,158,20,14,0.0970873786407767,0.08860759493670886
"[0, 1, 1, 0, 1, 0, 1, 0, 0, 0, 0, 1, 0, 0, 1]",174,110,64,8,9,0.07272727272727272,0.140625
"[0, 0, 0, 0, 1, 0, 0, 1, 1, 0, 0, 0, 1, 0, 1]",276,188,88,19,10,0.10106382978723404,0.11363636363636363
"[0, 0, 1, 1, 0, 0, 0, 0, 1, 1, 0, 1, 0, 0, 0]",421,279,142,25,15,0.08960573476702509,0.1056338028169014
"[0, 0, 1, 0, 1, 0, 1, 1, 1, 0, 0, 0, 0, 0, 0]",412,275,137,28,17,0.10181818181818182,0.12408759124087591
"[0, 0, 0, 1, 0, 1, 0, 1, 1, 1, 0, 0, 0, 0, 0]",354,227,127,18,10,0.07929515418502203,0.07874015748031496
"[1, 1, 1, 0, 1, 0, 0, 0, 0, 1, 0, 1, 0, 1, 1]",101,50,51,3,6,0.06,0.11764705882352941
"[1, 1, 0, 1, 0, 0, 1, 1, 0, 0, 0, 0, 0, 1, 0]",161,98,63,5,9,0.05102040816326531,0.14285714285714285
"[0, 0, 1, 0, 0, 0, 1, 1, 0, 1, 0, 0, 1, 1, 0]",149,86,63,6,3,0.06976744186046512,0.047619047619047616
"[1, 0, 1, 0, 1, 0, 1, 1, 1, 1, 1, 0, 1, 0, 1]",213,81,132,4,12,0.04938271604938271,0.09090909090909091
"[1, 0, 1, 0, 1, 0, 1, 1, 1, 1, 1, 1, 0, 0, 1]",347,112,235,7,14,0.0625,0.059574468085106386
"[1, 1, 0, 0, 1, 1, 0, 1, 1, 1, 1, 1, 1, 1, 0]",625,212,413,25,37,0.1179245283018868,0.08958837772397095
"[1, 0, 0, 0, 1, 1, 1, 1, 1, 1, 0, 1, 0, 1, 1]",284,97,187,10,15,0.10309278350515463,0.08021390374331551
"[0, 0, 1, 1, 0, 0, 0, 0, 1, 0, 1, 1, 1, 1, 1]",307,143,164,9,12,0.06293706293706294,0.07317073170731707
"[0, 1, 0, 1, 1, 1, 0, 0, 1, 0, 1, 1, 0, 0, 0]",138,64,74,4,9,0.0625,0.12162162162162163
"[0, 0, 1, 0, 1, 1, 1, 0, 0, 1, 0, 1, 1, 0, 0]",121,64,57,8,8,0.125,0.14035087719298245
"[0, 1, 1, 1, 1, 0, 0, 0, 1, 1, 0, 0, 0, 0, 1]",253,135,118,17,13,0.1259259259259259,0.11016949152542373
"[1, 1, 1, 0, 0, 1, 0, 1, 1, 1, 1, 0, 0, 0, 1]",180,64,116,9,12,0.140625,0.10344827586206896
"[1, 0, 1, 0, 1, 1, 1, 1, 0, 0, 1, 0, 1, 1, 1]",277,93,184,6,19,0.06451612903225806,0.10326086956521739
"[1, 0, 0, 1, 0, 1, 0, 1, 1, 1, 1, 0, 0, 1, 0]",125,62,63,1,7,0.016129032258064516,0.1111111111111111
"[1, 1, 1, 0, 0, 1, 0, 0, 0, 0, 1, 1, 0, 0, 1]",192,88,104,7,10,0.07954545454545454,0.09615384615384616
"[0, 0, 1, 1, 1, 0, 0, 1, 1, 1, 0, 0, 1, 0, 0]",144,78,66,5,5,0.0641025641025641,0.07575757575757576
"[1, 0, 0, 1, 0, 0, 1, 1, 1, 1, 0, 1, 1, 0, 0]",142,60,82,8,8,0.13333333333333333,0.0975609756097561
"[0, 1, 1, 1, 0, 0, 1, 0, 0, 1, 1, 1, 1, 0, 1]",157,72,85,10,7,0.1388888888888889,0.08235294117647059
"[0, 1, 1, 1, 0, 1, 1, 1, 0, 0, 1, 0, 0, 1, 1]",168,69,99,6,4,0.08695652173913043,0.04040404040404041
"[0, 1, 1, 1, 0, 0, 1, 0, 1, 1, 0, 1, 1, 0, 1]",144,59,85,4,4,0.06779661016949153,0.047058823529411764
"[0, 0, 0, 1, 1, 0, 0, 0, 0, 1, 0, 1, 0, 0, 1]",357,258,99,26,10,0.10077519379844961,0.10101010101010101
"[0, 0, 1, 1, 1, 1, 0, 0, 0, 0, 0, 1, 1, 0, 0]",412,243,169,23,14,0.09465020576131687,0.08284023668639054
"[0, 0, 1, 0, 0, 1, 0, 0, 0, 1, 0, 0, 0, 0, 1]",499,354,145,36,19,0.1016949152542373,0.1310344827586207
"[1, 0, 0, 1, 0, 1, 0, 1, 0, 0, 0, 1, 1, 0, 1]",103,52,51,6,9,0.11538461538461539,0.17647058823529413
"[0, 0, 1, 0, 0, 0, 0, 0, 0, 1, 0, 0, 1, 0, 1]",495,341,154,29,18,0.08504398826979472,0.11688311688311688
"[0, 1, 1, 1, 1, 1, 0, 0, 0, 1, 1, 1, 0, 1, 0]",155,74,81,12,10,0.16216216216216217,0.12345679012345678
"[1, 1, 0, 0, 1, 1, 0, 1, 1, 1, 1, 1, 0, 0, 0]",232,91,141,10,16,0.10989010989010989,0.11347517730496454
"[0, 0, 0, 1, 0, 0, 1, 0, 1, 1, 1, 0, 0, 1, 1]",158,102,56,17,2,0.16666666666666666,0.03571428571428571
"[0, 1, 1, 1, 1, 0, 1, 1, 1, 0, 1, 1, 0, 1, 1]",515,162,353,14,32,0.08641975308641975,0.0906515580736544
"[0, 1, 1, 0, 0, 0, 0, 0, 1, 1, 0, 0, 1, 1, 1]",401,266,135,24,13,0.09022556390977443,0.0962962962962963
"[1, 1, 1, 0, 1, 0, 0, 1, 0, 0, 1, 0, 1, 1, 1]",160,57,103,3,5,0.05263157894736842,0.04854368932038835
"[0, 1, 0, 0, 0, 0, 0, 0, 0, 0, 0, 0, 1, 0, 1]",1686,1296,390,119,35,0.09182098765432099,0.08974358974358974
"[0, 1, 1, 0, 0, 0, 0, 1, 1, 1, 1, 0, 1, 1, 1]",452,310,142,24,14,0.07741935483870968,0.09859154929577464
"[1, 0, 0, 0, 1, 1, 0, 1, 1, 1, 1, 1, 1, 1, 0]",311,119,192,12,22,0.10084033613445378,0.11458333333333333
"[1, 1, 1, 1, 0, 1, 1, 0, 0, 0, 1, 1, 0, 1, 1]",243,99,144,6,18,0.06060606060606061,0.125
"[1, 1, 0, 1, 1, 0, 1, 0, 1, 1, 1, 0, 1, 1, 1]",539,165,374,12,40,0.07272727272727272,0.10695187165775401
"[0, 0, 1, 1, 0, 0, 1, 1, 1, 0, 0, 1, 0, 0, 0]",220,129,91,12,7,0.09302325581395349,0.07692307692307693
"[1, 1, 1, 0, 0, 0, 0, 0, 1, 0, 0, 1, 1, 0, 0]",247,145,102,15,12,0.10344827586206896,0.11764705882352941
"[1, 1, 1, 1, 1, 0, 0, 1, 0, 0, 0, 0, 1, 1, 1]",353,105,248,16,27,0.1523809523809524,0.10887096774193548
"[1, 1, 0, 0, 0, 0, 1, 0, 1, 0, 1, 0, 0, 1, 0]",150,96,54,6,4,0.0625,0.07407407407407407
"[1, 1, 0, 1, 0, 1, 0, 1, 1, 1, 1, 0, 0, 0, 1]",174,76,98,5,12,0.06578947368421052,0.12244897959183673
"[1, 0, 1, 0, 1, 0, 0, 0, 1, 0, 1, 1, 0, 1, 0]",112,61,51,8,3,0.13114754098360656,0.058823529411764705
"[0, 0, 0, 1, 1, 0, 1, 0, 0, 1, 1, 1, 0, 0, 0]",169,96,73,10,9,0.10416666666666667,0.1232876712328767
"[0, 0, 1, 1, 1, 1, 0, 0, 1, 0, 0, 0, 0, 1, 1]",274,158,116,12,10,0.0759493670886076,0.08620689655172414
"[0, 0, 1, 0, 1, 0, 0, 0, 1, 0, 1, 1, 0, 1, 0]",133,78,55,8,4,0.10256410256410256,0.07272727272727272
"[0, 1, 1, 0, 1, 0, 0, 0, 1, 0, 1, 0, 0, 0, 1]",140,80,60,6,3,0.075,0.05
"[1, 1, 0, 1, 1, 0, 0, 0, 0, 0, 0, 0, 1, 0, 0]",265,175,90,18,7,0.10285714285714286,0.07777777777777778
"[1, 1, 1, 0, 0, 0, 1, 0, 1, 0, 0, 0, 0, 1, 0]",132,69,63,8,9,0.11594202898550725,0.14285714285714285
"[0, 0, 0, 0, 1, 1, 0, 0, 0, 1, 1, 1, 0, 0, 0]",400,260,140,28,16,0.1076923076923077,0.11428571428571428
"[0, 1, 1, 1, 0, 0, 0, 1, 0, 0, 1, 1, 0, 0, 1]",142,69,73,5,3,0.07246376811594203,0.0410958904109589
"[1, 0, 1, 1, 0, 0, 1, 1, 1, 1, 0, 0, 0, 1, 1]",247,96,151,6,16,0.0625,0.10596026490066225
"[1, 0, 0, 0, 0, 0, 0, 1, 1, 1, 0, 1, 1, 1, 1]",351,95,256,9,21,0.09473684210526316,0.08203125
"[1, 0, 0, 0, 0, 0, 0, 1, 1, 1, 0, 0, 1, 0, 0]",317,179,138,23,18,0.12849162011173185,0.13043478260869565
"[1, 0, 0, 1, 0, 1, 1, 1, 1, 0, 1, 1, 1, 0, 1]",209,78,131,7,17,0.08974358974358974,0.1297709923664122
"[1, 0, 0, 0, 1, 0, 0, 0, 1, 1, 1, 0, 0, 0, 0]",302,199,103,15,9,0.07537688442211055,0.08737864077669903
"[1, 1, 0, 0, 1, 1, 0, 0, 0, 0, 1, 0, 1, 0, 0]",269,167,102,13,10,0.07784431137724551,0.09803921568627451
"[1, 1, 1, 0, 1, 1, 1, 1, 0, 0, 0, 1, 1, 1, 0]",255,100,155,12,15,0.12,0.0967741935483871
"[0, 1, 1, 1, 0, 1, 1, 1, 1, 0, 0, 0, 1, 1, 1]",322,129,193,8,23,0.06201550387596899,0.11917098445595854
"[0, 1, 0, 0, 1, 1, 1, 0, 1, 1, 1, 1, 0, 0, 0]",159,82,77,6,7,0.07317073170731707,0.09090909090909091
"[0, 0, 1, 0, 0, 1, 1, 0, 1, 1, 0, 1, 1, 1, 1]",201,84,117,9,8,0.10714285714285714,0.06837606837606838
"[0, 1, 1, 1, 0, 0, 0, 1, 0, 0, 1, 1, 0, 1, 0]",112,64,48,4,1,0.0625,0.020833333333333332
"[1, 0, 1, 0, 0, 0, 1, 1, 0, 0, 1, 1, 1, 1, 1]",369,159,210,13,21,0.08176100628930817,0.1
"[0, 0, 1, 1, 0, 0, 1, 1, 1, 0, 1, 0, 1, 0, 1]",136,70,66,4,11,0.05714285714285714,0.16666666666666666
"[0, 1, 0, 1, 0, 1, 1, 1, 1, 1, 1, 0, 0, 1, 0]",155,80,75,7,4,0.0875,0.05333333333333334
"[0, 1, 1, 1, 1, 0, 1, 0, 0, 0, 1, 1, 0, 0, 0]",157,84,73,11,8,0.13095238095238096,0.1095890410958904
"[0, 0, 1, 1, 1, 1, 1, 0, 1, 0, 1, 1, 1, 0, 1]",256,78,178,7,18,0.08974358974358974,0.10112359550561797
"[0, 1, 1, 0, 1, 1, 1, 0, 1, 0, 1, 1, 1, 0, 0]",163,60,103,7,9,0.11666666666666667,0.08737864077669903
"[1, 0, 1, 1, 0, 1, 1, 0, 1, 1, 1, 0, 1, 0, 1]",203,72,131,11,15,0.1527777777777778,0.11450381679389313
"[0, 1, 1, 0, 1, 0, 1, 0, 1, 0, 1, 1, 1, 1, 1]",302,131,171,12,16,0.0916030534351145,0.0935672514619883
"[1, 1, 0, 1, 0, 0, 1, 1, 0, 1, 0, 1, 0, 1, 0]",93,49,44,4,5,0.08163265306122448,0.11363636363636363
"[0, 1, 1, 0, 1, 0, 0, 1, 1, 0, 1, 0, 1, 0, 1]",102,49,53,5,6,0.10204081632653061,0.11320754716981132
"[0, 1, 0, 1, 0, 1, 1, 1, 1, 0, 0, 0, 0, 1, 1]",277,129,148,10,17,0.07751937984496124,0.11486486486486487
"[0, 0, 0, 0, 0, 1, 1, 0, 1, 1, 1, 1, 1, 0, 0]",170,107,63,10,8,0.09345794392523364,0.12698412698412698
"[0, 1, 0, 1, 0, 0, 1, 0, 1, 1, 1, 1, 1, 1, 1]",391,155,236,17,23,0.10967741935483871,0.09745762711864407
"[0, 0, 0, 1, 0, 1, 1, 1, 1, 1, 0, 1, 0, 1, 0]",107,59,48,5,4,0.0847457627118644,0.08333333333333333
"[1, 1, 1, 0, 0, 1, 1, 0, 0, 1, 0, 0, 0, 1, 0]",145,53,92,2,8,0.03773584905660377,0.08695652173913043
"[0, 1, 0, 1, 0, 1, 1, 1, 1, 0, 0, 1, 1, 0, 0]",259,132,127,13,12,0.09848484848484848,0.09448818897637795
"[0, 1, 1, 1, 1, 1, 1, 1, 1, 0, 0, 1, 0, 1, 1]",807,382,425,44,33,0.11518324607329843,0.07764705882352942
"[0, 0, 0, 0, 1, 0, 0, 1, 0, 1, 1, 0, 0, 0, 0]",650,491,159,37,17,0.07535641547861507,0.1069182389937107
"[0, 0, 0, 0, 0, 1, 0, 0, 1, 0, 1, 1, 0, 0, 0]",658,471,187,38,15,0.08067940552016985,0.08021390374331551
"[1, 0, 0, 1, 1, 0, 0, 0, 0, 1, 1, 1, 0, 1, 1]",312,73,239,9,23,0.1232876712328767,0.09623430962343096
"[1, 0, 0, 0, 1, 1, 1, 0, 1, 1, 1, 1, 0, 0, 1]",183,67,116,11,10,0.16417910447761194,0.08620689655172414
"[0, 0, 1, 0, 1, 1, 1, 0, 0, 0, 0, 0, 0, 1, 0]",265,172,93,19,7,0.11046511627906977,0.07526881720430108
"[0, 0, 0, 0, 0, 1, 0, 1, 1, 1, 0, 0, 0, 0, 0]",777,560,217,46,22,0.08214285714285714,0.10138248847926268
"[1, 1, 1, 0, 1, 1, 0, 0, 1, 0, 1, 1, 0, 0, 1]",176,54,122,2,10,0.037037037037037035,0.08196721311475409
"[1, 0, 1, 0, 1, 0, 1, 1, 0, 1, 0, 0, 1, 0, 0]",113,62,51,6,3,0.0967741935483871,0.058823529411764705
"[0, 1, 1, 0, 1, 0, 1, 0, 1, 0, 1, 1, 0, 1, 0]",96,42,54,7,9,0.16666666666666666,0.16666666666666666
"[1, 0, 0, 0, 0, 1, 0, 0, 1, 1, 1, 0, 0, 0, 1]",149,88,61,8,7,0.09090909090909091,0.11475409836065574
"[0, 1, 0, 1, 0, 1, 0, 0, 0, 0, 1, 0, 0, 1, 1]",183,106,77,9,5,0.08490566037735849,0.06493506493506493
"[0, 1, 1, 1, 0, 0, 1, 1, 1, 0, 0, 1, 0, 1, 0]",133,71,62,6,3,0.08450704225352113,0.04838709677419355
"[0, 1, 0, 0, 0, 0, 0, 0, 1, 1, 1, 0, 1, 1, 0]",143,79,64,8,5,0.10126582278481013,0.078125
"[1, 1, 1, 0, 0, 1, 0, 0, 0, 0, 0, 1, 1, 1, 1]",277,129,148,12,10,0.09302325581395349,0.06756756756756757
"[1, 1, 1, 0, 1, 0, 1, 0, 0, 1, 1, 1, 0, 0, 0]",122,51,71,4,8,0.0784313725490196,0.11267605633802817
"[0, 0, 1, 0, 1, 1, 0, 1, 0, 1, 0, 0, 0, 0, 0]",272,175,97,21,11,0.12,0.1134020618556701
"[1, 0, 1, 0, 1, 0, 0, 0, 1, 0, 1, 1, 1, 1, 1]",168,71,97,6,6,0.08450704225352113,0.061855670103092786
"[1, 1, 0, 0, 1, 1, 1, 0, 0, 0, 1, 0, 0, 0, 1]",119,54,65,2,4,0.037037037037037035,0.06153846153846154
"[1, 0, 0, 1, 1, 0, 0, 1, 1, 1, 0, 0, 0, 1, 0]",152,68,84,5,4,0.07352941176470588,0.047619047619047616
"[1, 0, 1, 1, 1, 0, 0, 1, 0, 1, 0, 0, 1, 1, 0]",126,57,69,7,11,0.12280701754385964,0.15942028985507245
"[0, 0, 1, 0, 1, 1, 0, 1, 0, 1, 0, 1, 1, 1, 1]",158,59,99,4,10,0.06779661016949153,0.10101010101010101
"[1, 1, 1, 0, 1, 1, 0, 1, 0, 1, 0, 1, 0, 1, 1]",239,80,159,6,16,0.075,0.10062893081761007
"[1, 0, 1, 1, 0, 1, 0, 1, 1, 1, 1, 1, 1, 0, 1]",472,119,353,12,25,0.10084033613445378,0.0708215297450425
"[0, 0, 1, 1, 1, 0, 0, 0, 0, 1, 0, 0, 0, 1, 0]",247,157,90,12,7,0.07643312101910828,0.07777777777777778
"[1, 0, 1, 1, 1, 1, 1, 1, 1, 1, 0, 1, 0, 0, 1]",611,171,440,8,40,0.04678362573099415,0.09090909090909091
"[1, 1, 1, 1, 0, 1, 0, 0, 1, 1, 1, 0, 1, 1, 1]",612,177,435,17,42,0.096045197740113,0.09655172413793103
"[0, 1, 1, 1, 0, 0, 1, 0, 0, 1, 1, 1, 1, 1, 0]",154,58,96,6,10,0.10344827586206896,0.10416666666666667
"[0, 0, 1, 1, 0, 1, 1, 0, 0, 1, 1, 0, 1, 0, 0]",123,63,60,10,9,0.15873015873015872,0.15
"[0, 1, 1, 1, 1, 1, 1, 1, 0, 0, 0, 0, 1, 1, 1]",1081,436,645,38,59,0.0871559633027523,0.09147286821705426
"[1, 0, 0, 0, 1, 0, 1, 1, 0, 1, 0, 1, 0, 0, 1]",121,70,51,7,10,0.1,0.19607843137254902
"[0, 1, 1, 1, 0, 0, 1, 1, 1, 1, 0, 0, 0, 0, 0]",444,242,202,24,20,0.09917355371900827,0.09900990099009901
"[0, 1, 0, 0, 0, 1, 0, 1, 1, 1, 0, 1, 0, 0, 1]",87,43,44,5,6,0.11627906976744186,0.13636363636363635
"[0, 1, 0, 1, 0, 1, 0, 1, 0, 0, 0, 1, 1, 1, 1]",156,59,97,8,11,0.13559322033898305,0.1134020618556701
"[0, 0, 0, 0, 1, 0, 1, 0, 1, 0, 1, 0, 0, 0, 1]",240,152,88,16,11,0.10526315789473684,0.125
"[0, 1, 0, 0, 1, 1, 1, 1, 1, 1, 1, 0, 1, 1, 1]",657,226,431,30,48,0.13274336283185842,0.11136890951276102
"[1, 1, 1, 1, 0, 1, 1, 1, 1, 0, 1, 0, 0, 1, 1]",649,185,464,16,45,0.08648648648648649,0.09698275862068965
"[1, 0, 0, 0, 0, 0, 1, 1, 0, 0, 0, 1, 0, 1, 0]",285,171,114,14,5,0.08187134502923976,0.043859649122807015
"[0, 0, 0, 1, 1, 0, 1, 1, 0, 0, 0, 0, 0, 1, 1]",265,168,97,13,8,0.07738095238095238,0.08247422680412371
"[1, 0, 1, 1, 1, 1, 1, 0, 0, 1, 0, 0, 1, 1, 1]",289,94,195,6,20,0.06382978723404255,0.10256410256410256
"[1, 0, 0, 1, 0, 0, 1, 0, 1, 1, 1, 1, 1, 0, 0]",142,63,79,7,10,0.1111111111111111,0.12658227848101267
"[1, 1, 1, 1, 1, 0, 0, 1, 1, 1, 0, 0, 1, 1, 0]",400,123,277,21,27,0.17073170731707318,0.09747292418772563
"[1, 0, 0, 1, 1, 1, 1, 1, 1, 0, 0, 1, 1, 1, 0]",649,118,531,17,44,0.1440677966101695,0.08286252354048965
"[0, 1, 0, 1, 1, 1, 1, 1, 0, 1, 1, 0, 1, 0, 1]",209,80,129,10,10,0.125,0.07751937984496124
"[1, 1, 1, 1, 1, 0, 0, 0, 0, 1, 0, 0, 0, 1, 0]",157,68,89,6,6,0.08823529411764706,0.06741573033707865
"[0, 1, 1, 1, 0, 0, 1, 0, 0, 0, 1, 0, 1, 0, 0]",147,91,56,5,5,0.054945054945054944,0.08928571428571429
"[0, 0, 1, 0, 1, 1, 1, 1, 0, 0, 1, 0, 0, 1, 1]",137,66,71,5,6,0.07575757575757576,0.08450704225352113
"[1, 0, 0, 1, 0, 1, 1, 1, 1, 0, 0, 1, 0, 0, 1]",122,56,66,1,4,0.017857142857142856,0.06060606060606061
"[1, 1, 0, 1, 1, 1, 0, 0, 1, 0, 1, 1, 1, 1, 0]",229,81,148,5,19,0.06172839506172839,0.12837837837837837
"[1, 1, 1, 0, 1, 1, 1, 0, 0, 1, 0, 1, 1, 1, 1]",653,180,473,19,33,0.10555555555555556,0.06976744186046512
"[0, 1, 0, 0, 0, 1, 1, 1, 1, 1, 1, 1, 0, 0, 1]",246,108,138,10,11,0.09259259259259259,0.07971014492753623
"[0, 1, 0, 0, 0, 0, 1, 1, 1, 1, 1, 1, 1, 1, 0]",482,234,248,25,26,0.10683760683760683,0.10483870967741936
"[1, 1, 0, 0, 0, 0, 1, 1, 1, 0, 0, 0, 0, 0, 1]",270,153,117,12,13,0.0784313725490196,0.1111111111111111
"[1, 1, 0, 0, 0, 0, 0, 1, 1, 0, 0, 0, 0, 1, 1]",612,355,257,34,20,0.09577464788732394,0.07782101167315175
"[0, 1, 1, 0, 0, 0, 0, 0, 1, 1, 0, 0, 0, 0, 1]",546,366,180,28,16,0.07650273224043716,0.08888888888888889
"[1, 1, 0, 0, 1, 0, 1, 1, 1, 1, 0, 0, 1, 1, 0]",267,107,160,11,16,0.102803738317757,0.1
"[1, 0, 1, 0, 0, 0, 0, 1, 0, 0, 0, 1, 0, 1, 0]",246,160,86,17,7,0.10625,0.08139534883720931
"[1, 1, 0, 1, 1, 1, 0, 1, 0, 1, 0, 0, 0, 0, 1]",138,65,73,8,7,0.12307692307692308,0.0958904109589041
"[0, 1, 1, 0, 0, 0, 0, 0, 0, 1, 0, 0, 1, 0, 0]",697,536,161,56,10,0.1044776119402985,0.062111801242236024
"[0, 0, 1, 0, 1, 1, 0, 0, 0, 0, 0, 0, 1, 0, 0]",580,411,169,33,13,0.08029197080291971,0.07692307692307693
"[1, 0, 0, 0, 1, 0, 1, 1, 0, 1, 0, 1, 1, 1, 0]",104,50,54,6,5,0.12,0.09259259259259259
"[1, 1, 1, 0, 0, 0, 0, 1, 0, 1, 0, 1, 1, 1, 1]",269,68,201,7,15,0.10294117647058823,0.07462686567164178
"[0, 1, 1, 0, 1, 0, 1, 1, 0, 1, 0, 1, 1, 0, 1]",131,61,70,2,7,0.03278688524590164,0.1
"[1, 0, 0, 1, 1, 0, 1, 0, 1, 1, 0, 1, 0, 1, 1]",154,61,93,5,4,0.08196721311475409,0.043010752688172046
"[1, 0, 0, 0, 0, 0, 1, 0, 1, 0, 0, 1, 0, 1, 0]",244,148,96,19,8,0.12837837837837837,0.08333333333333333
"[0, 0, 1, 1, 0, 0, 1, 1, 0, 1, 0, 1, 1, 0, 1]",155,82,73,9,5,0.10975609756097561,0.0684931506849315
"[0, 0, 0, 1, 0, 0, 1, 1, 0, 1, 1, 1, 1, 0, 1]",111,52,59,4,5,0.07692307692307693,0.0847457627118644
"[0, 1, 1, 1, 1, 0, 0, 1, 1, 1, 0, 1, 0, 1, 1]",352,176,176,12,20,0.06818181818181818,0.11363636363636363
"[1, 1, 0, 1, 1, 1, 1, 0, 0, 1, 1, 1, 0, 1, 0]",224,83,141,6,14,0.07228915662650602,0.09929078014184398
"[0, 0, 0, 0, 0, 0, 1, 0, 1, 0, 0, 1, 1, 0, 1]",267,166,101,13,12,0.0783132530120482,0.1188118811881188
"[0, 0, 1, 0, 0, 0, 1, 1, 0, 0, 0, 0, 1, 0, 0]",551,387,164,36,12,0.09302325581395349,0.07317073170731707
"[0, 1, 1, 0, 1, 1, 1, 0, 0, 1, 0, 0, 0, 1, 1]",126,66,60,8,4,0.12121212121212122,0.06666666666666667
"[1, 1, 0, 1, 0, 1, 1, 0, 0, 0, 0, 1, 0, 1, 0]",121,58,63,4,6,0.06896551724137931,0.09523809523809523
"[1, 0, 1, 0, 0, 0, 0, 0, 1, 1, 1, 0, 1, 0, 1]",110,61,49,7,5,0.11475409836065574,0.10204081632653061
"[0, 0, 0, 0, 0, 1, 0, 1, 0, 0, 0, 0, 0, 1, 1]",949,718,231,62,21,0.08635097493036212,0.09090909090909091
"[0, 1, 0, 0, 0, 1, 0, 0, 0, 0, 0, 1, 0, 1, 0]",486,336,150,32,15,0.09523809523809523,0.1
"[0, 1, 0, 1, 0, 0, 0, 0, 0, 1, 1, 0, 1, 0, 0]",259,158,101,17,7,0.10759493670886076,0.06930693069306931
"[1, 1, 1, 0, 0, 0, 0, 1, 1, 1, 0, 0, 0, 0, 1]",211,82,129,4,13,0.04878048780487805,0.10077519379844961
"[0, 1, 0, 1, 1, 1, 0, 1, 1, 1, 1, 1, 0, 0, 0]",190,94,96,8,9,0.0851063829787234,0.09375
"[0, 1, 0, 1, 1, 1, 1, 0, 0, 1, 1, 1, 1, 0, 0]",444,174,270,11,24,0.06321839080459771,0.08888888888888889
"[0, 1, 0, 0, 0, 1, 0, 1, 0, 1, 1, 1, 1, 0, 0]",139,85,54,8,5,0.09411764705882353,0.09259259259259259
"[1, 0, 0, 1, 1, 1, 0, 0, 0, 1, 0, 1, 1, 1, 0]",135,50,85,6,4,0.12,0.047058823529411764
"[0, 0, 0, 1, 0, 1, 1, 1, 0, 1, 1, 1, 0, 0, 1]",132,65,67,5,6,0.07692307692307693,0.08955223880597014
"[0, 1, 1, 1, 1, 0, 0, 0, 0, 0, 0, 1, 0, 1, 1]",298,216,82,25,9,0.11574074074074074,0.10975609756097561
"[1, 0, 0, 1, 1, 1, 1, 0, 0, 0, 0, 0, 0, 1, 0]",377,129,248,10,27,0.07751937984496124,0.10887096774193548
"[1, 1, 1, 1, 0, 1, 1, 0, 1, 0, 0, 1, 1, 1, 0]",249,89,160,11,15,0.12359550561797752,0.09375
"[1, 1, 0, 0, 1, 0, 1, 1, 1, 0, 0, 1, 0, 1, 1]",166,62,104,4,8,0.06451612903225806,0.07692307692307693
"[0, 0, 1, 1, 0, 0, 1, 1, 1, 0, 1, 1, 0, 0, 0]",172,89,83,6,7,0.06741573033707865,0.08433734939759036
"[1, 1, 0, 1, 1, 0, 0, 0, 1, 0, 0, 0, 0, 0, 1]",158,102,56,6,3,0.058823529411764705,0.05357142857142857
"[0, 1, 0, 1, 1, 0, 1, 0, 0, 1, 1, 0, 0, 0, 0]",202,124,78,11,6,0.08870967741935484,0.07692307692307693
"[0, 1, 1, 1, 0, 1, 0, 1, 0, 1, 1, 0, 0, 1, 1]",191,83,108,8,19,0.0963855421686747,0.17592592592592593
"[0, 0, 0, 0, 0, 0, 1, 0, 0, 1, 0, 0, 1, 0, 1]",539,393,146,39,18,0.09923664122137404,0.1232876712328767
"[0, 0, 0, 1, 1, 0, 1, 1, 1, 1, 0, 1, 1, 1, 0]",172,70,102,9,8,0.12857142857142856,0.0784313725490196
"[1, 1, 0, 0, 1, 0, 0, 0, 1, 1, 0, 1, 1, 0, 0]",126,69,57,8,5,0.11594202898550725,0.08771929824561403
"[1, 0, 0, 0, 0, 0, 0, 0, 0, 1, 0, 1, 1, 0, 1]",292,160,132,11,11,0.06875,0.08333333333333333
"[0, 1, 1, 1, 1, 1, 0, 1, 1, 1, 1, 0, 0, 1, 1]",897,276,621,32,60,0.11594202898550725,0.0966183574879227
"[1, 0, 1, 1, 1, 1, 1, 1, 1, 0, 0, 0, 0, 1, 1]",939,326,613,28,62,0.08588957055214724,0.10114192495921696
"[0, 1, 0, 1, 1, 1, 0, 1, 0, 1, 1, 1, 0, 1, 1]",268,103,165,6,14,0.05825242718446602,0.08484848484848485
"[1, 0, 0, 1, 0, 0, 0, 1, 0, 1, 1, 1, 0, 0, 0]",162,91,71,6,9,0.06593406593406594,0.1267605633802817
"[1, 1, 1, 0, 0, 0, 0, 0, 0, 0, 1, 0, 1, 1, 0]",188,100,88,10,6,0.1,0.06818181818181818
"[1, 1, 1, 0, 1, 1, 0, 1, 1, 0, 0, 1, 1, 1, 0]",260,91,169,7,13,0.07692307692307693,0.07692307692307693
"[0, 0, 1, 0, 0, 0, 0, 0, 1, 0, 0, 0, 1, 1, 0]",586,414,172,40,25,0.0966183574879227,0.14534883720930233
"[0, 1, 0, 0, 1, 0, 0, 0, 0, 0, 1, 0, 0, 0, 1]",519,354,165,35,15,0.09887005649717515,0.09090909090909091
"[0, 0, 1, 0, 0, 0, 1, 0, 1, 1, 0, 0, 0, 1, 0]",233,143,90,17,12,0.11888111888111888,0.13333333333333333
"[1, 1, 1, 1, 1, 0, 1, 0, 0, 1, 1, 0, 1, 0, 1]",201,64,137,4,8,0.0625,0.058394160583941604
"[1, 0, 0, 1, 1, 1, 1, 1, 1, 0, 1, 0, 0, 1, 1]",416,103,313,9,36,0.08737864077669903,0.11501597444089456
"[0, 0, 1, 0, 0, 1, 0, 1, 0, 0, 0, 1, 1, 0, 1]",147,85,62,7,7,0.08235294117647059,0.11290322580645161
"[0, 0, 1, 1, 1, 0, 0, 0, 1, 1, 0, 0, 0, 0, 1]",243,149,94,16,5,0.10738255033557047,0.05319148936170213
"[0, 1, 0, 1, 0, 1, 0, 1, 1, 0, 1, 1, 0, 1, 1]",133,57,76,6,14,0.10526315789473684,0.18421052631578946
"[1, 0, 1, 1, 0, 1, 1, 1, 1, 0, 1, 1, 1, 0, 1]",513,143,370,13,38,0.09090909090909091,0.10270270270270271
"[1, 0, 1, 0, 1, 1, 0, 0, 0, 1, 1, 0, 1, 0, 1]",118,50,68,7,9,0.14,0.1323529411764706
"[1, 0, 1, 0, 1, 0, 1, 0, 1, 1, 0, 0, 0, 1, 1]",130,60,70,8,5,0.13333333333333333,0.07142857142857142
"[1, 0, 0, 1, 1, 0, 1, 1, 0, 1, 0, 1, 0, 1, 0]",112,51,61,5,6,0.09803921568627451,0.09836065573770492
"[0, 0, 0, 0, 1, 0, 1, 1, 0, 0, 1, 1, 0, 1, 1]",146,88,58,13,5,0.14772727272727273,0.08620689655172414
"[0, 0, 1, 1, 1, 1, 0, 1, 0, 1, 0, 0, 0, 0, 1]",174,82,92,11,7,0.13414634146341464,0.07608695652173914
"[1, 0, 0, 0, 1, 1, 0, 1, 1, 1, 0, 1, 1, 0, 0]",130,59,71,3,8,0.05084745762711865,0.11267605633802817
"[1, 1, 1, 0, 0, 1, 1, 0, 0, 0, 1, 1, 0, 1, 1]",264,69,195,6,16,0.08695652173913043,0.08205128205128205
"[1, 0, 0, 1, 1, 0, 1, 1, 0, 0, 1, 1, 0, 0, 0]",189,95,94,8,8,0.08421052631578947,0.0851063829787234
"[0, 1, 1, 0, 0, 1, 1, 0, 1, 1, 0, 0, 1, 1, 0]",180,110,70,16,6,0.14545454545454545,0.08571428571428572
"[1, 0, 0, 0, 0, 1, 1, 0, 0, 1, 1, 0, 1, 1, 0]",232,81,151,6,14,0.07407407407407407,0.09271523178807947
"[1, 0, 0, 1, 1, 0, 1, 1, 1, 0, 0, 1, 1, 1, 1]",423,140,283,13,21,0.09285714285714286,0.07420494699646643
"[0, 1, 0, 0, 1, 1, 0, 1, 1, 1, 0, 0, 1, 1, 1]",197,83,114,11,11,0.13253012048192772,0.09649122807017543
"[0, 1, 1, 0, 0, 0, 1, 0, 1, 0, 0, 1, 1, 0, 1]",118,58,60,5,6,0.08620689655172414,0.1
"[1, 1, 1, 0, 0, 0, 0, 1, 1, 0, 0, 0, 1, 0, 0]",287,107,180,15,12,0.14018691588785046,0.06666666666666667
"[1, 1, 0, 0, 1, 0, 1, 1, 1, 0, 1, 1, 0, 1, 0]",138,61,77,5,2,0.08196721311475409,0.025974025974025976
"[1, 0, 0, 0, 0, 1, 1, 0, 0, 1, 0, 1, 1, 0, 1]",159,68,91,5,10,0.07352941176470588,0.10989010989010989
"[1, 0, 0, 1, 0, 0, 0, 0, 1, 0, 0, 0, 1, 1, 0]",236,155,81,13,7,0.08387096774193549,0.08641975308641975
"[0, 0, 1, 1, 1, 0, 1, 1, 0, 1, 0, 1, 1, 0, 1]",130,48,82,8,4,0.16666666666666666,0.04878048780487805
"[0, 1, 1, 0, 0, 0, 0, 0, 0, 0, 0, 1, 1, 1, 0]",602,482,120,41,11,0.08506224066390042,0.09166666666666666
"[1, 0, 1, 0, 1, 1, 0, 1, 0, 0, 0, 0, 1, 1, 0]",135,77,58,5,4,0.06493506493506493,0.06896551724137931
"[1, 0, 0, 1, 0, 0, 1, 1, 0, 0, 1, 0, 0, 0, 0]",274,170,104,12,11,0.07058823529411765,0.10576923076923077
"[1, 1, 1, 0, 1, 0, 0, 1, 0, 1, 1, 1, 1, 0, 1]",245,73,172,6,19,0.0821917808219178,0.11046511627906977
"[0, 0, 1, 1, 1, 0, 1, 0, 0, 1, 0, 1, 1, 1, 1]",193,77,116,10,11,0.12987012987012986,0.09482758620689655
"[0, 1, 0, 0, 1, 1, 1, 0, 1, 0, 0, 1, 0, 1, 1]",108,53,55,5,5,0.09433962264150944,0.09090909090909091
"[1, 0, 1, 0, 0, 1, 1, 1, 0, 1, 0, 0, 1, 0, 1]",102,55,47,3,8,0.05454545454545454,0.1702127659574468
"[0, 1, 1, 0, 1, 0, 0, 1, 1, 1, 0, 1, 0, 0, 1]",107,45,62,6,11,0.13333333333333333,0.1774193548387097
"[0, 1, 1, 1, 0, 0, 1, 0, 1, 1, 0, 0, 0, 1, 1]",144,76,68,8,8,0.10526315789473684,0.11764705882352941
"[1, 0, 0, 1, 0, 0, 0, 0, 0, 1, 1, 1, 0, 0, 1]",154,89,65,5,8,0.056179775280898875,0.12307692307692308
"[0, 0, 1, 0, 0, 1, 0, 0, 1, 0, 0, 0, 1, 0, 0]",515,365,150,33,16,0.09041095890410959,0.10666666666666667
"[1, 0, 0, 0, 0, 0, 1, 0, 1, 0, 0, 0, 0, 0, 0]",1961,1417,544,135,52,0.09527170077628794,0.09558823529411764
"[1, 1, 1, 1, 0, 0, 1, 0, 0, 0, 0, 0, 1, 0, 1]",122,69,53,8,6,0.11594202898550725,0.11320754716981132
"[0, 0, 1, 1, 1, 1, 0, 0, 1, 0, 0, 0, 0, 0, 1]",220,136,84,13,5,0.09558823529411764,0.05952380952380952
"[0, 1, 0, 0, 1, 1, 1, 1, 0, 0, 1, 0, 0, 0, 0]",179,107,72,9,9,0.08411214953271028,0.125
"[1, 0, 1, 1, 1, 0, 1, 1, 1, 1, 1, 0, 1, 0, 0]",234,80,154,12,13,0.15,0.08441558441558442
"[1, 1, 0, 0, 1, 1, 0, 1, 1, 1, 0, 1, 1, 1, 1]",708,213,495,21,40,0.09859154929577464,0.08080808080808081
"[1, 0, 1, 0, 0, 1, 0, 0, 1, 1, 1, 1, 1, 1, 1]",431,168,263,18,26,0.10714285714285714,0.09885931558935361
"[1, 0, 1, 0, 0, 1, 1, 1, 0, 0, 0, 1, 1, 1, 1]",172,66,106,7,14,0.10606060606060606,0.1320754716981132
"[0, 0, 0, 1, 0, 0, 0, 1, 1, 1, 0, 0, 1, 0, 0]",249,157,92,16,12,0.10191082802547771,0.13043478260869565
"[1, 1, 0, 0, 0, 0, 1, 0, 0, 0, 1, 1, 1, 0, 0]",179,99,80,8,10,0.08080808080808081,0.125
"[0, 1, 0, 1, 0, 1, 1, 0, 0, 0, 1, 1, 1, 1, 1]",218,97,121,11,6,0.1134020618556701,0.049586776859504134
"[0, 1, 1, 1, 0, 0, 1, 0, 1, 0, 1, 1, 0, 0, 0]",145,76,69,11,10,0.14473684210526316,0.14492753623188406
"[0, 0, 0, 1, 0, 1, 1, 1, 1, 1, 1, 1, 1, 0, 0]",361,183,178,18,13,0.09836065573770492,0.07303370786516854
"[0, 0, 1, 0, 1, 0, 0, 0, 0, 1, 0, 0, 0, 1, 0]",512,379,133,38,18,0.10026385224274406,0.13533834586466165
"[1, 1, 0, 1, 1, 1, 1, 0, 1, 1, 0, 0, 1, 0, 0]",151,59,92,4,8,0.06779661016949153,0.08695652173913043
"[1, 0, 1, 0, 1, 0, 0, 1, 0, 0, 1, 1, 0, 1, 1]",90,33,57,4,9,0.12121212121212122,0.15789473684210525
"[0, 1, 1, 0, 1, 1, 1, 0, 1, 1, 0, 1, 1, 1, 1]",541,170,371,16,31,0.09411764705882353,0.08355795148247978
"[1, 1, 0, 0, 0, 0, 0, 0, 1, 0, 1, 0, 1, 1, 0]",201,129,72,12,9,0.09302325581395349,0.125
"[1, 1, 0, 0, 1, 1, 1, 1, 0, 0, 0, 0, 0, 1, 1]",542,276,266,27,27,0.09782608695652174,0.10150375939849623
"[0, 1, 1, 0, 1, 1, 0, 0, 0, 1, 1, 0, 0, 0, 0]",226,134,92,13,7,0.09701492537313433,0.07608695652173914
"[1, 0, 0, 0, 0, 0, 1, 1, 0, 0, 1, 1, 0, 1, 0]",172,92,80,9,7,0.09782608695652174,0.0875
"[0, 1, 0, 0, 1, 1, 0, 0, 1, 1, 1, 1, 1, 1, 1]",795,297,498,22,41,0.07407407407407407,0.0823293172690763
"[1, 1, 0, 0, 1, 0, 0, 1, 1, 1, 0, 0, 1, 1, 1]",232,94,138,11,13,0.11702127659574468,0.09420289855072464
"[0, 0, 0, 0, 1, 0, 1, 1, 0, 0, 0, 0, 0, 1, 1]",420,292,128,30,7,0.10273972602739725,0.0546875
"[0, 1, 1, 0, 0, 1, 0, 0, 0, 1, 1, 1, 0, 0, 1]",139,81,58,4,10,0.04938271604938271,0.1724137931034483
"[0, 1, 1, 1, 0, 1, 1, 1, 1, 1, 0, 1, 0, 1, 1]",459,137,322,16,33,0.11678832116788321,0.10248447204968944
"[0, 0, 0, 0, 1, 0, 0, 0, 0, 1, 0, 1, 1, 0, 1]",228,148,80,12,7,0.08108108108108109,0.0875
"[0, 0, 0, 0, 0, 1, 1, 0, 1, 0, 0, 0, 1, 1, 1]",385,276,109,29,11,0.10507246376811594,0.10091743119266056
"[1, 0, 0, 1, 0, 0, 1, 1, 0, 1, 1, 1, 1, 1, 1]",296,96,200,12,17,0.125,0.085
"[0, 1, 0, 1, 0, 1, 1, 0, 0, 1, 0, 0, 1, 1, 0]",123,62,61,7,3,0.11290322580645161,0.04918032786885246
"[1, 0, 0, 1, 1, 1, 1, 1, 1, 0, 0, 1, 0, 1, 1]",481,107,374,18,25,0.16822429906542055,0.06684491978609626
"[1, 1, 1, 0, 0, 1, 1, 1, 1, 1, 1, 0, 0, 1, 0]",524,100,424,13,44,0.13,0.10377358490566038
"[1, 1, 1, 0, 0, 0, 1, 0, 0, 0, 1, 0, 1, 0, 0]",165,92,73,13,4,0.14130434782608695,0.0547945205479452
"[1, 0, 0, 1, 0, 0, 0, 1, 1, 0, 1, 1, 0, 1, 1]",116,47,69,6,8,0.1276595744680851,0.11594202898550725
"[0, 0, 1, 0, 0, 1, 0, 0, 1, 0, 0, 0, 1, 1, 0]",277,171,106,18,9,0.10526315789473684,0.08490566037735849
"[0, 1, 0, 0, 0, 1, 1, 1, 1, 0, 0, 0, 0, 0, 0]",780,516,264,50,24,0.09689922480620156,0.09090909090909091
"[0, 1, 0, 0, 1, 0, 0, 1, 0, 1, 1, 1, 1, 0, 1]",95,43,52,4,6,0.09302325581395349,0.11538461538461539
"[1, 1, 0, 0, 1, 1, 0, 1, 1, 1, 0, 1, 1, 1, 0]",242,79,163,9,17,0.11392405063291139,0.10429447852760736
"[0, 0, 0, 0, 1, 1, 1, 0, 0, 1, 1, 1, 1, 0, 0]",372,201,171,13,15,0.06467661691542288,0.08771929824561403
"[0, 1, 1, 0, 1, 1, 0, 0, 0, 0, 1, 1, 1, 0, 0]",145,89,56,10,5,0.11235955056179775,0.08928571428571429
"[0, 0, 0, 0, 0, 1, 1, 1, 0, 1, 1, 1, 1, 1, 0]",177,107,70,11,4,0.102803738317757,0.05714285714285714
"[1, 1, 0, 1, 0, 1, 0, 0, 0, 0, 0, 1, 0, 0, 0]",240,158,82,11,9,0.06962025316455696,0.10975609756097561
"[1, 0, 0, 0, 1, 0, 1, 1, 0, 1, 0, 1, 0, 0, 0]",157,91,66,8,9,0.08791208791208792,0.13636363636363635
"[0, 1, 0, 0, 0, 0, 1, 0, 0, 0, 1, 1, 0, 1, 1]",141,89,52,12,4,0.1348314606741573,0.07692307692307693
"[0, 1, 1, 1, 1, 0, 1, 0, 1, 1, 1, 0, 1, 1, 0]",248,87,161,9,13,0.10344827586206896,0.08074534161490683
"[0, 0, 1, 1, 1, 1, 0, 1, 0, 1, 1, 1, 0, 1, 1]",278,86,192,11,14,0.12790697674418605,0.07291666666666667
"[1, 0, 0, 0, 1, 1, 1, 1, 0, 1, 0, 1, 1, 1, 0]",140,57,83,8,5,0.14035087719298245,0.060240963855421686
"[0, 0, 1, 1, 0, 0, 0, 1, 1, 1, 1, 0, 1, 0, 1]",121,60,61,3,7,0.05,0.11475409836065574
"[1, 1, 1, 0, 1, 1, 1, 1, 1, 0, 1, 1, 0, 1, 0]",473,129,344,12,31,0.09302325581395349,0.09011627906976744
"[1, 1, 1, 0, 1, 0, 0, 0, 0, 0, 0, 0, 1, 1, 0]",251,138,113,13,14,0.09420289855072464,0.12389380530973451
"[0, 1, 0, 1, 0, 1, 0, 0, 0, 1, 0, 1, 0, 0, 0]",224,161,63,3,8,0.018633540372670808,0.12698412698412698
"[0, 0, 1, 0, 1, 0, 1, 0, 0, 0, 1, 0, 1, 0, 0]",243,169,74,16,6,0.09467455621301775,0.08108108108108109
"[0, 1, 0, 1, 0, 0, 0, 1, 0, 1, 0, 1, 0, 0, 0]",259,170,89,15,9,0.08823529411764706,0.10112359550561797
"[1, 0, 0, 0, 1, 0, 0, 0, 1, 0, 1, 0, 1, 1, 1]",168,90,78,11,4,0.12222222222222222,0.05128205128205128
"[1, 0, 1, 0, 0, 0, 1, 0, 0, 0, 1, 0, 1, 0, 1]",148,76,72,7,9,0.09210526315789473,0.125
"[0, 0, 0, 1, 0, 0, 1, 0, 1, 0, 1, 0, 0, 1, 0]",219,148,71,11,5,0.07432432432432433,0.07042253521126761
"[1, 1, 0, 1, 0, 0, 0, 1, 1, 1, 1, 1, 0, 0, 0]",161,82,79,8,11,0.0975609756097561,0.13924050632911392
"[0, 1, 1, 1, 1, 0, 0, 1, 1, 0, 1, 0, 0, 1, 1]",227,140,87,9,4,0.06428571428571428,0.04597701149425287
"[0, 0, 1, 1, 1, 1, 0, 0, 1, 1, 0, 1, 0, 0, 1]",225,111,114,12,10,0.10810810810810811,0.08771929824561403
"[0, 0, 1, 1, 0, 0, 0, 1, 0, 1, 0, 1, 0, 1, 0]",146,85,61,5,5,0.058823529411764705,0.08196721311475409
"[0, 1, 1, 1, 0, 0, 0, 0, 1, 0, 0, 1, 1, 0, 1]",123,60,63,5,6,0.08333333333333333,0.09523809523809523
"[0, 0, 1, 0, 1, 0, 0, 1, 1, 0, 0, 1, 1, 0, 1]",112,65,47,3,3,0.046153846153846156,0.06382978723404255
"[0, 0, 1, 0, 1, 1, 0, 0, 0, 0, 1, 0, 1, 0, 0]",262,183,79,15,9,0.08196721311475409,0.11392405063291139
"[1, 0, 0, 1, 1, 1, 1, 0, 0, 1, 0, 0, 1, 0, 0]",160,59,101,6,10,0.1016949152542373,0.09900990099009901
"[0, 0, 0, 0, 0, 0, 0, 1, 1, 0, 1, 0, 0, 0, 0]",2111,1655,456,162,35,0.09788519637462235,0.07675438596491228
"[0, 1, 1, 1, 0, 1, 0, 0, 1, 0, 0, 0, 0, 0, 0]",306,198,108,20,13,0.10101010101010101,0.12037037037037036
"[0, 0, 0, 0, 0, 1, 1, 0, 0, 1, 0, 0, 1, 1, 1]",527,415,112,45,12,0.10843373493975904,0.10714285714285714
"[1, 0, 0, 0, 0, 1, 0, 0, 0, 0, 0, 0, 1, 0, 0]",1583,1191,392,101,41,0.08480268681780016,0.10459183673469388
"[0, 1, 0, 1, 1, 0, 1, 1, 0, 0, 0, 1, 1, 1, 1]",226,100,126,10,11,0.1,0.0873015873015873
"[1, 1, 0, 0, 1, 0, 1, 1, 1, 1, 1, 0, 0, 1, 0]",129,54,75,4,6,0.07407407407407407,0.08
"[0, 1, 1, 1, 0, 1, 1, 1, 1, 0, 1, 0, 0, 1, 0]",129,51,78,3,6,0.058823529411764705,0.07692307692307693
"[0, 1, 1, 1, 0, 1, 0, 1, 1, 0, 1, 1, 1, 0, 1]",227,80,147,6,12,0.075,0.08163265306122448
"[1, 0, 1, 1, 1, 1, 1, 1, 0, 0, 0, 1, 1, 0, 1]",278,94,184,9,18,0.09574468085106383,0.09782608695652174
"[1, 1, 0, 1, 1, 1, 1, 1, 1, 0, 0, 0, 1, 1, 0]",323,128,195,12,15,0.09375,0.07692307692307693
"[0, 1, 1, 0, 1, 1, 1, 1, 1, 1, 0, 0, 0, 1, 1]",344,118,226,9,27,0.07627118644067797,0.11946902654867257
"[1, 1, 0, 0, 0, 0, 1, 0, 0, 0, 0, 0, 0, 1, 0]",577,411,166,43,20,0.10462287104622871,0.12048192771084337
"[0, 1, 1, 0, 1, 0, 1, 1, 1, 0, 0, 0, 0, 1, 0]",117,61,56,7,6,0.11475409836065574,0.10714285714285714
"[0, 1, 1, 1, 0, 0, 1, 1, 0, 1, 0, 1, 1, 1, 0]",142,62,80,5,10,0.08064516129032258,0.125
"[1, 0, 0, 0, 0, 1, 0, 1, 1, 0, 1, 1, 0, 1, 0]",91,45,46,4,1,0.08888888888888889,0.021739130434782608
"[1, 0, 1, 1, 0, 1, 1, 1, 1, 0, 0, 0, 1, 1, 1]",324,131,193,11,23,0.08396946564885496,0.11917098445595854
"[1, 1, 1, 1, 1, 0, 1, 0, 0, 0, 0, 0, 1, 1, 0]",189,81,108,6,7,0.07407407407407407,0.06481481481481481
"[0, 0, 1, 1, 1, 1, 1, 1, 1, 0, 1, 0, 0, 0, 0]",234,112,122,10,14,0.08928571428571429,0.11475409836065574
"[0, 0, 0, 1, 1, 1, 1, 1, 1, 1, 0, 1, 0, 0, 0]",201,123,78,8,5,0.06504065040650407,0.0641025641025641
"[1, 0, 0, 1, 0, 0, 0, 1, 1, 0, 0, 1, 0, 1, 1]",123,66,57,6,6,0.09090909090909091,0.10526315789473684
"[1, 0, 0, 0, 0, 1, 0, 0, 0, 1, 0, 0, 0, 1, 0]",492,351,141,35,12,0.09971509971509972,0.0851063829787234
"[0, 1, 1, 1, 0, 0, 1, 1, 0, 1, 1, 0, 0, 1, 1]",178,74,104,1,9,0.013513513513513514,0.08653846153846154
"[0, 1, 0, 1, 1, 1, 0, 0, 1, 1, 0, 1, 1, 0, 0]",133,64,69,4,5,0.0625,0.07246376811594203
"[0, 0, 1, 1, 0, 1, 1, 1, 1, 0, 0, 0, 0, 1, 1]",302,140,162,13,11,0.09285714285714286,0.06790123456790123
"[0, 0, 1, 1, 1, 1, 1, 1, 0, 0, 0, 1, 1, 1, 1]",782,328,454,38,54,0.11585365853658537,0.11894273127753303
"[0, 0, 1, 0, 1, 1, 1, 1, 1, 0, 1, 0, 0, 1, 1]",186,81,105,7,7,0.08641975308641975,0.06666666666666667
"[0, 0, 0, 1, 1, 1, 1, 0, 0, 1, 0, 1, 1, 1, 1]",361,217,144,13,11,0.059907834101382486,0.0763888888888889
"[0, 1, 0, 0, 0, 0, 1, 1, 0, 0, 0, 1, 0, 0, 0]",565,378,187,31,18,0.082010582010582,0.0962566844919786
"[1, 0, 0, 0, 0, 0, 0, 1, 1, 0, 0, 1, 0, 0, 0]",781,420,361,48,29,0.11428571428571428,0.08033240997229917
"[1, 1, 0, 1, 0, 0, 0, 1, 0, 1, 1, 1, 1, 1, 0]",148,59,89,6,10,0.1016949152542373,0.11235955056179775
"[1, 1, 0, 1, 1, 0, 1, 0, 1, 0, 1, 1, 0, 1, 0]",142,51,91,3,4,0.058823529411764705,0.04395604395604396
"[1, 0, 1, 0, 1, 0, 0, 1, 1, 1, 1, 1, 0, 1, 1]",262,96,166,10,20,0.10416666666666667,0.12048192771084337
"[1, 0, 0, 0, 1, 1, 1, 1, 1, 0, 1, 0, 1, 0, 0]",120,52,68,5,9,0.09615384615384616,0.1323529411764706
"[0, 1, 0, 1, 1, 1, 0, 1, 1, 1, 1, 1, 0, 0, 1]",312,120,192,6,18,0.05,0.09375
"[0, 0, 0, 0, 1, 1, 1, 1, 1, 1, 0, 1, 0, 1, 1]",381,183,198,13,25,0.07103825136612021,0.12626262626262627
"[0, 1, 0, 1, 1, 1, 0, 1, 1, 0, 0, 1, 0, 0, 1]",108,47,61,5,5,0.10638297872340426,0.08196721311475409
"[0, 0, 1, 0, 0, 0, 0, 1, 0, 1, 0, 1, 0, 0, 0]",514,360,154,32,13,0.08888888888888889,0.08441558441558442
"[0, 1, 0, 0, 0, 1, 0, 0, 0, 0, 1, 0, 1, 0, 1]",242,165,77,12,10,0.07272727272727272,0.12987012987012986
"[0, 0, 0, 0, 0, 0, 1, 1, 0, 1, 0, 0, 1, 0, 0]",689,514,175,50,18,0.09727626459143969,0.10285714285714286
"[0, 0, 0, 1, 1, 0, 1, 0, 0, 1, 0, 1, 0, 1, 0]",129,77,52,6,6,0.07792207792207792,0.11538461538461539
"[1, 0, 0, 0, 0, 1, 0, 1, 0, 0, 0, 1, 1, 1, 1]",199,102,97,10,7,0.09803921568627451,0.07216494845360824
"[0, 1, 1, 0, 0, 1, 1, 1, 0, 1, 0, 1, 0, 0, 1]",134,70,64,7,5,0.1,0.078125
"[1, 0, 1, 0, 0, 1, 1, 1, 0, 0, 1, 0, 0, 1, 0]",106,61,45,5,4,0.08196721311475409,0.08888888888888889
"[1, 1, 0, 0, 0, 0, 1, 1, 1, 1, 1, 1, 0, 1, 0]",360,149,211,19,22,0.12751677852348994,0.10426540284360189
"[0, 1, 1, 0, 1, 0, 1, 0, 0, 0, 0, 0, 0, 1, 1]",249,162,87,16,10,0.09876543209876543,0.11494252873563218
"[1, 0, 0, 1, 0, 1, 1, 0, 1, 0, 0, 1, 0, 0, 0]",174,103,71,9,5,0.08737864077669903,0.07042253521126761
"[0, 1, 0, 0, 1, 0, 1, 1, 0, 1, 0, 0, 1, 0, 0]",159,92,67,6,2,0.06521739130434782,0.029850746268656716
"[1, 1, 0, 1, 1, 0, 0, 0, 0, 0, 1, 0, 0, 0, 0]",267,164,103,14,9,0.08536585365853659,0.08737864077669903
"[1, 1, 0, 1, 1, 0, 0, 0, 1, 0, 0, 1, 0, 0, 1]",119,68,51,5,3,0.07352941176470588,0.058823529411764705
"[1, 0, 0, 0, 1, 1, 0, 1, 1, 0, 0, 0, 1, 0, 0]",137,71,66,7,10,0.09859154929577464,0.15151515151515152
"[0, 0, 1, 1, 1, 0, 1, 1, 0, 0, 0, 1, 1, 0, 1]",106,52,54,6,4,0.11538461538461539,0.07407407407407407
"[0, 1, 0, 0, 0, 1, 0, 0, 0, 1, 1, 0, 1, 1, 1]",140,70,70,6,7,0.08571428571428572,0.1
"[1, 1, 0, 1, 0, 0, 0, 1, 0, 0, 0, 0, 1, 0, 1]",130,80,50,5,6,0.0625,0.12
"[1, 0, 1, 0, 0, 0, 1, 1, 0, 0, 0, 0, 1, 0, 0]",257,162,95,15,5,0.09259259259259259,0.05263157894736842
"[1, 1, 1, 1, 0, 1, 0, 1, 0, 0, 1, 1, 0, 0, 0]",184,73,111,5,18,0.0684931506849315,0.16216216216216217
"[0, 1, 1, 1, 0, 1, 1, 0, 0, 0, 1, 0, 0, 0, 0]",150,93,57,10,6,0.10752688172043011,0.10526315789473684
"[0, 0, 0, 1, 0, 0, 0, 1, 1, 0, 0, 1, 0, 1, 1]",169,107,62,13,10,0.12149532710280374,0.16129032258064516
"[0, 0, 1, 0, 1, 1, 1, 0, 1, 0, 1, 1, 0, 1, 0]",92,42,50,4,4,0.09523809523809523,0.08
"[0, 0, 1, 0, 0, 1, 0, 1, 1, 1, 0, 1, 0, 1, 1]",105,48,57,8,3,0.16666666666666666,0.05263157894736842
"[1, 0, 0, 1, 0, 0, 1, 0, 1, 1, 1, 0, 1, 0, 1]",93,44,49,4,5,0.09090909090909091,0.10204081632653061
"[0, 0, 1, 0, 0, 1, 0, 0, 1, 0, 0, 1, 0, 1, 1]",161,96,65,8,6,0.08333333333333333,0.09230769230769231
"[0, 0, 1, 1, 0, 1, 0, 0, 0, 0, 1, 0, 0, 1, 1]",193,110,83,7,9,0.06363636363636363,0.10843373493975904
"[1, 0, 1, 1, 0, 1, 0, 0, 0, 1, 1, 1, 1, 1, 0]",162,59,103,3,6,0.05084745762711865,0.05825242718446602
"[1, 0, 1, 0, 1, 0, 0, 1, 1, 0, 1, 1, 0, 0, 1]",138,69,69,5,2,0.07246376811594203,0.028985507246376812
"[1, 1, 1, 1, 0, 0, 0, 1, 1, 1, 0, 0, 0, 0, 0]",256,113,143,14,18,0.12389380530973451,0.1258741258741259
"[1, 0, 1, 1, 0, 0, 0, 1, 0, 1, 1, 0, 1, 1, 0]",105,43,62,7,5,0.16279069767441862,0.08064516129032258
"[1, 1, 0, 1, 1, 0, 0, 0, 1, 0, 1, 1, 0, 1, 1]",134,57,77,4,9,0.07017543859649122,0.11688311688311688
"[1, 1, 1, 1, 0, 1, 1, 0, 0, 0, 1, 1, 0, 1, 0]",143,51,92,5,8,0.09803921568627451,0.08695652173913043
"[0, 1, 1, 0, 0, 0, 1, 1, 1, 0, 1, 1, 0, 0, 0]",143,80,63,13,4,0.1625,0.06349206349206349
"[0, 0, 0, 0, 0, 1, 1, 0, 0, 0, 1, 1, 1, 0, 1]",210,147,63,12,6,0.08163265306122448,0.09523809523809523
"[1, 1, 0, 0, 1, 0, 0, 0, 1, 1, 1, 0, 1, 0, 1]",100,55,45,3,9,0.05454545454545454,0.2
"[1, 0, 0, 1, 1, 0, 1, 1, 0, 1, 0, 1, 1, 0, 1]",127,56,71,7,9,0.125,0.1267605633802817
"[1, 0, 0, 0, 0, 0, 1, 0, 0, 0, 1, 1, 0, 1, 1]",185,103,82,16,6,0.1553398058252427,0.07317073170731707
"[1, 1, 0, 0, 1, 0, 1, 1, 1, 0, 0, 0, 1, 1, 0]",132,70,62,9,6,0.12857142857142856,0.0967741935483871
"[0, 0, 0, 1, 0, 1, 1, 1, 0, 1, 1, 0, 0, 1, 0]",124,72,52,5,3,0.06944444444444445,0.057692307692307696
"[0, 1, 1, 0, 1, 0, 0, 0, 1, 0, 1, 0, 0, 1, 0]",123,78,45,6,4,0.07692307692307693,0.08888888888888889
"[1, 0, 1, 0, 1, 1, 1, 0, 1, 0, 1, 0, 0, 1, 1]",139,54,85,8,4,0.14814814814814814,0.047058823529411764
"[0, 1, 1, 1, 1, 0, 1, 0, 1, 1, 1, 0, 1, 0, 1]",227,96,131,7,11,0.07291666666666667,0.08396946564885496
"[0, 0, 1, 0, 0, 1, 1, 0, 0, 0, 0, 0, 1, 0, 1]",261,171,90,18,7,0.10526315789473684,0.07777777777777778
"[0, 0, 0, 1, 0, 0, 1, 1, 0, 0, 0, 0, 0, 1, 0]",572,413,159,34,15,0.08232445520581114,0.09433962264150944
"[0, 0, 1, 1, 1, 0, 1, 0, 0, 1, 1, 1, 0, 0, 0]",122,62,60,7,5,0.11290322580645161,0.08333333333333333
"[0, 1, 0, 0, 0, 1, 1, 1, 0, 1, 0, 0, 1, 1, 1]",132,60,72,5,8,0.08333333333333333,0.1111111111111111
"[1, 0, 0, 0, 1, 1, 0, 0, 0, 0, 1, 0, 0, 1, 1]",209,122,87,11,9,0.09016393442622951,0.10344827586206896
"[0, 1, 0, 0, 1, 0, 1, 0, 1, 1, 0, 1, 0, 1, 1]",99,45,54,2,5,0.044444444444444446,0.09259259259259259
"[0, 1, 1, 0, 1, 0, 0, 1, 0, 1, 0, 1, 1, 0, 1]",98,57,41,7,3,0.12280701754385964,0.07317073170731707
"[0, 0, 0, 1, 0, 1, 0, 0, 1, 1, 1, 0, 0, 1, 1]",158,81,77,5,4,0.06172839506172839,0.05194805194805195
"[0, 1, 1, 1, 0, 0, 1, 1, 0, 1, 1, 1, 1, 0, 1]",228,87,141,11,12,0.12643678160919541,0.0851063829787234
"[0, 0, 0, 0, 1, 0, 0, 0, 1, 0, 1, 0, 1, 0, 0]",537,380,157,43,14,0.11315789473684211,0.08917197452229299
"[0, 0, 1, 1, 1, 1, 1, 1, 0, 1, 0, 0, 1, 1, 1]",470,164,306,17,33,0.10365853658536585,0.10784313725490197
"[0, 1, 1, 1, 0, 0, 1, 0, 0, 1, 1, 0, 1, 1, 1]",155,66,89,2,6,0.030303030303030304,0.06741573033707865
"[0, 0, 1, 1, 0, 0, 0, 1, 1, 1, 0, 0, 1, 0, 0]",172,102,70,13,4,0.12745098039215685,0.05714285714285714
"[0, 0, 0, 1, 1, 0, 1, 0, 1, 0, 0, 0, 0, 0, 0]",683,488,195,58,29,0.11885245901639344,0.14871794871794872
"[0, 0, 0, 0, 0, 1, 0, 1, 0, 0, 0, 0, 1, 0, 1]",539,374,165,35,18,0.09358288770053476,0.10909090909090909
"[0, 1, 0, 0, 1, 0, 1, 1, 0, 0, 1, 1, 1, 0, 0]",143,64,79,9,4,0.140625,0.05063291139240506
"[1, 0, 0, 1, 0, 1, 1, 1, 1, 0, 0, 1, 1, 0, 0]",279,117,162,17,17,0.1452991452991453,0.10493827160493827
"[1, 0, 0, 0, 0, 1, 0, 1, 0, 0, 0, 0, 0, 1, 1]",394,239,155,27,17,0.11297071129707113,0.10967741935483871
"[0, 1, 1, 0, 0, 0, 1, 0, 0, 0, 1, 0, 0, 0, 1]",268,183,85,14,9,0.07650273224043716,0.10588235294117647
"[1, 0, 1, 1, 0, 0, 0, 1, 0, 0, 0, 1, 0, 0, 0]",255,150,105,13,10,0.08666666666666667,0.09523809523809523
"[0, 1, 0, 0, 0, 1, 1, 0, 1, 1, 0, 0, 0, 1, 0]",126,83,43,8,7,0.0963855421686747,0.16279069767441862
"[1, 0, 0, 0, 0, 0, 0, 1, 1, 1, 1, 1, 0, 0, 0]",365,159,206,11,20,0.06918238993710692,0.0970873786407767
"[1, 1, 0, 1, 0, 0, 0, 0, 1, 0, 0, 1, 1, 0, 0]",176,102,74,7,9,0.06862745098039216,0.12162162162162163
"[0, 1, 0, 0, 0, 1, 0, 1, 1, 1, 1, 1, 1, 0, 1]",116,50,66,3,5,0.06,0.07575757575757576
"[1, 0, 1, 0, 1, 1, 0, 0, 1, 1, 1, 1, 1, 0, 0]",209,82,127,7,11,0.08536585365853659,0.08661417322834646
"[1, 0, 0, 1, 0, 0, 0, 1, 0, 1, 0, 1, 1, 0, 1]",102,51,51,6,3,0.11764705882352941,0.058823529411764705
"[0, 1, 1, 1, 1, 0, 0, 1, 0, 0, 1, 0, 0, 0, 1]",141,87,54,6,2,0.06896551724137931,0.037037037037037035
"[0, 0, 1, 1, 1, 1, 0, 0, 1, 0, 0, 1, 0, 0, 0]",216,135,81,9,9,0.06666666666666667,0.1111111111111111
"[1, 1, 1, 0, 0, 1, 0, 1, 1, 0, 1, 0, 1, 0, 0]",107,43,64,4,6,0.09302325581395349,0.09375
"[0, 1, 1, 0, 0, 1, 1, 1, 0, 0, 1, 0, 1, 1, 0]",126,80,46,6,4,0.075,0.08695652173913043
"[0, 1, 1, 0, 0, 1, 0, 0, 0, 0, 1, 0, 1, 0, 0]",245,169,76,10,10,0.05917159763313609,0.13157894736842105
"[0, 0, 0, 1, 0, 1, 0, 0, 0, 0, 1, 0, 1, 1, 1]",232,158,74,15,7,0.0949367088607595,0.0945945945945946
"[1, 0, 0, 0, 0, 1, 0, 1, 0, 0, 0, 0, 1, 0, 1]",243,154,89,13,10,0.08441558441558442,0.11235955056179775
"[1, 1, 0, 0, 0, 1, 1, 1, 0, 0, 1, 0, 1, 0, 1]",103,44,59,2,4,0.045454545454545456,0.06779661016949153
"[0, 1, 0, 1, 0, 1, 0, 0, 1, 1, 0, 1, 0, 0, 0]",147,90,57,8,3,0.08888888888888889,0.05263157894736842
"[1, 1, 1, 0, 0, 0, 0, 0, 1, 1, 1, 1, 1, 1, 1]",881,285,596,26,53,0.0912280701754386,0.08892617449664429
"[1, 0, 0, 0, 1, 1, 1, 1, 0, 0, 0, 1, 0, 0, 0]",178,106,72,12,4,0.11320754716981132,0.05555555555555555
"[1, 1, 0, 0, 0, 0, 1, 0, 1, 1, 1, 0, 0, 1, 0]",124,74,50,8,5,0.10810810810810811,0.1
"[1, 1, 1, 0, 0, 0, 0, 1, 0, 1, 1, 1, 0, 0, 1]",142,61,81,6,1,0.09836065573770492,0.012345679012345678
"[0, 0, 1, 1, 1, 1, 1, 0, 0, 0, 0, 1, 0, 1, 1]",158,81,77,2,4,0.024691358024691357,0.05194805194805195
"[1, 0, 1, 1, 1, 0, 0, 1, 1, 1, 1, 1, 0, 0, 0]",212,73,139,6,11,0.0821917808219178,0.07913669064748201
"[1, 0, 0, 0, 1, 0, 0, 0, 0, 1, 0, 1, 0, 0, 0]",553,389,164,36,17,0.09254498714652956,0.10365853658536585
"[0, 1, 1, 0, 1, 0, 1, 0, 1, 1, 0, 1, 0, 1, 1]",141,49,92,2,8,0.04081632653061224,0.08695652173913043
"[1, 0, 1, 1, 1, 0, 1, 1, 0, 1, 0, 1, 0, 1, 1]",194,65,129,7,16,0.1076923076923077,0.12403100775193798
"[0, 0, 1, 1, 1, 1, 0, 0, 1, 0, 0, 1, 0, 1, 1]",174,105,69,7,8,0.06666666666666667,0.11594202898550725
"[0, 1, 0, 0, 1, 0, 1, 0, 1, 0, 1, 0, 1, 0, 0]",143,95,48,8,5,0.08421052631578947,0.10416666666666667
"[1, 1, 1, 1, 0, 1, 1, 0, 0, 1, 1, 0, 0, 1, 1]",667,205,462,14,42,0.06829268292682927,0.09090909090909091
"[0, 1, 0, 1, 0, 0, 0, 1, 0, 0, 1, 1, 1, 1, 0]",137,74,63,5,7,0.06756756756756757,0.1111111111111111
"[1, 0, 1, 1, 1, 0, 0, 1, 1, 1, 1, 1, 0, 1, 1]",570,166,404,20,41,0.12048192771084337,0.10148514851485149
"[0, 1, 1, 0, 1, 1, 0, 1, 1, 1, 1, 0, 0, 1, 0]",144,64,80,7,4,0.109375,0.05
"[1, 1, 1, 1, 0, 1, 0, 0, 0, 0, 1, 0, 1, 1, 0]",102,46,56,6,2,0.13043478260869565,0.03571428571428571
"[1, 0, 1, 0, 1, 1, 1, 1, 1, 1, 1, 0, 1, 0, 0]",277,113,164,13,22,0.11504424778761062,0.13414634146341464
"[1, 0, 0, 1, 1, 1, 1, 1, 1, 0, 0, 0, 1, 0, 0]",205,74,131,7,14,0.0945945945945946,0.10687022900763359
"[0, 0, 1, 1, 1, 0, 0, 1, 1, 1, 1, 1, 1, 0, 0]",492,212,280,19,21,0.08962264150943396,0.075
"[1, 0, 0, 0, 0, 0, 1, 1, 0, 1, 1, 0, 1, 0, 0]",142,87,55,6,2,0.06896551724137931,0.03636363636363636
"[0, 1, 1, 1, 1, 0, 1, 1, 0, 0, 1, 0, 1, 1, 1]",290,118,172,12,16,0.1016949152542373,0.09302325581395349
"[0, 0, 0, 0, 1, 0, 0, 0, 0, 0, 0, 1, 0, 1, 1]",763,558,205,43,19,0.07706093189964158,0.09268292682926829
"[0, 0, 0, 0, 0, 1, 0, 0, 0, 0, 1, 1, 1, 1, 1]",482,311,171,26,21,0.08360128617363344,0.12280701754385964
"[1, 1, 1, 0, 0, 0, 0, 0, 1, 0, 0, 0, 0, 0, 0]",760,456,304,39,27,0.08552631578947369,0.08881578947368421
"[1, 0, 0, 1, 0, 0, 1, 0, 0, 1, 1, 1, 1, 0, 0]",205,97,108,9,8,0.09278350515463918,0.07407407407407407
"[1, 1, 1, 0, 0, 0, 0, 0, 0, 1, 0, 0, 1, 1, 0]",240,113,127,11,11,0.09734513274336283,0.08661417322834646
"[0, 0, 1, 1, 0, 0, 1, 1, 1, 1, 1, 0, 0, 0, 0]",360,204,156,11,24,0.05392156862745098,0.15384615384615385
"[0, 1, 1, 1, 1, 1, 1, 0, 1, 0, 0, 0, 0, 0, 1]",181,88,93,7,5,0.07954545454545454,0.053763440860215055
"[1, 1, 0, 1, 1, 0, 1, 0, 1, 0, 1, 0, 1, 0, 0]",128,51,77,3,6,0.058823529411764705,0.07792207792207792
"[0, 1, 1, 1, 0, 1, 1, 0, 1, 0, 1, 0, 1, 0, 1]",138,59,79,2,9,0.03389830508474576,0.11392405063291139
"[0, 0, 1, 0, 0, 0, 1, 1, 1, 0, 1, 1, 0, 1, 0]",91,53,38,6,6,0.11320754716981132,0.15789473684210525
"[0, 1, 1, 0, 1, 0, 0, 0, 0, 0, 0, 1, 1, 1, 0]",172,108,64,14,5,0.12962962962962962,0.078125
"[1, 1, 1, 0, 0, 0, 0, 0, 0, 0, 1, 0, 1, 0, 1]",210,97,113,7,6,0.07216494845360824,0.05309734513274336
"[1, 0, 1, 1, 0, 1, 1, 0, 1, 1, 1, 1, 0, 1, 0]",215,79,136,12,17,0.1518987341772152,0.125
"[1, 0, 0, 0, 1, 0, 1, 0, 1, 0, 0, 1, 1, 1, 1]",179,81,98,7,12,0.08641975308641975,0.12244897959183673
"[0, 1, 0, 1, 1, 1, 1, 0, 0, 1, 0, 0, 1, 0, 0]",115,58,57,2,5,0.034482758620689655,0.08771929824561403
"[1, 0, 0, 1, 0, 0, 1, 0, 0, 0, 0, 0, 1, 0, 1]",236,140,96,16,10,0.11428571428571428,0.10416666666666667
"[1, 0, 0, 0, 0, 1, 0, 1, 0, 0, 1, 0, 0, 1, 0]",234,147,87,13,7,0.08843537414965986,0.08045977011494253
"[1, 0, 1, 0, 1, 1, 1, 0, 1, 0, 0, 1, 1, 0, 0]",149,58,91,4,11,0.06896551724137931,0.12087912087912088
"[1, 1, 1, 0, 1, 0, 0, 0, 1, 1, 0, 0, 1, 0, 1]",105,56,49,8,5,0.14285714285714285,0.10204081632653061
"[1, 0, 1, 1, 0, 0, 1, 1, 1, 0, 1, 0, 0, 0, 1]",118,47,71,6,5,0.1276595744680851,0.07042253521126761
"[1, 1, 1, 0, 1, 0, 0, 0, 1, 0, 1, 0, 0, 1, 1]",123,46,77,0,9,0.0,0.11688311688311688
"[1, 0, 1, 1, 1, 0, 1, 0, 0, 0, 1, 0, 1, 0, 0]",99,52,47,5,5,0.09615384615384616,0.10638297872340426
"[0, 0, 0, 1, 1, 0, 0, 0, 1, 1, 1, 1, 1, 0, 1]",120,65,55,8,4,0.12307692307692308,0.07272727272727272
"[0, 1, 1, 1, 1, 1, 1, 1, 0, 0, 0, 1, 1, 0, 0]",258,129,129,10,6,0.07751937984496124,0.046511627906976744
"[1, 1, 1, 1, 0, 0, 0, 1, 1, 1, 1, 1, 0, 0, 1]",393,141,252,20,18,0.14184397163120568,0.07142857142857142
"[1, 1, 0, 0, 1, 1, 1, 0, 1, 1, 1, 1, 0, 1, 1]",587,181,406,20,38,0.11049723756906077,0.09359605911330049
"[1, 1, 0, 0, 1, 0, 0, 1, 1, 1, 0, 0, 1, 0, 0]",129,77,52,6,5,0.07792207792207792,0.09615384615384616
"[0, 0, 1, 1, 0, 0, 1, 1, 1, 1, 1, 0, 0, 1, 1]",461,189,272,20,29,0.10582010582010581,0.10661764705882353
"[1, 1, 1, 1, 0, 1, 1, 0, 0, 0, 0, 1, 1, 0, 1]",147,68,79,4,1,0.058823529411764705,0.012658227848101266
"[0, 1, 1, 1, 1, 1, 1, 1, 1, 0, 0, 0, 1, 0, 1]",426,241,185,23,18,0.0954356846473029,0.0972972972972973
"[1, 0, 0, 1, 0, 1, 0, 1, 0, 0, 1, 0, 1, 1, 1]",133,58,75,2,9,0.034482758620689655,0.12
"[0, 1, 1, 0, 0, 1, 0, 1, 0, 1, 0, 0, 1, 0, 1]",121,62,59,3,5,0.04838709677419355,0.0847457627118644
"[0, 0, 0, 0, 1, 0, 1, 0, 1, 1, 1, 0, 0, 1, 0]",155,92,63,13,7,0.14130434782608695,0.1111111111111111
"[0, 0, 1, 0, 1, 1, 1, 1, 1, 0, 1, 1, 0, 0, 1]",157,64,93,3,13,0.046875,0.13978494623655913
"[1, 0, 1, 1, 0, 0, 0, 0, 0, 0, 1, 0, 1, 0, 0]",221,131,90,10,7,0.07633587786259542,0.07777777777777778
"[0, 1, 1, 0, 0, 0, 0, 0, 1, 0, 1, 0, 1, 1, 0]",151,102,49,7,3,0.06862745098039216,0.061224489795918366
"[0, 1, 0, 1, 0, 0, 0, 1, 0, 1, 1, 0, 0, 1, 0]",140,85,55,7,5,0.08235294117647059,0.09090909090909091
"[0, 1, 1, 0, 0, 1, 1, 1, 0, 1, 0, 1, 1, 1, 0]",146,68,78,10,12,0.14705882352941177,0.15384615384615385
"[1, 1, 0, 1, 0, 1, 0, 1, 0, 0, 0, 1, 1, 0, 0]",124,60,64,3,6,0.05,0.09375
"[1, 1, 0, 0, 0, 0, 0, 1, 0, 0, 0, 1, 0, 0, 0]",627,434,193,47,23,0.10829493087557604,0.11917098445595854
"[0, 1, 1, 0, 1, 1, 1, 1, 0, 1, 1, 0, 0, 0, 1]",154,66,88,6,11,0.09090909090909091,0.125
"[0, 0, 1, 1, 0, 1, 1, 1, 1, 0, 1, 1, 0, 0, 0]",132,59,73,8,8,0.13559322033898305,0.1095890410958904
"[1, 1, 0, 1, 0, 0, 1, 1, 0, 0, 0, 1, 1, 0, 1]",114,52,62,9,6,0.17307692307692307,0.0967741935483871
"[1, 1, 1, 0, 1, 0, 0, 1, 1, 0, 0, 0, 1, 1, 0]",116,52,64,5,6,0.09615384615384616,0.09375
"[1, 0, 1, 1, 1, 0, 1, 0, 0, 1, 1, 0, 0, 0, 1]",122,56,66,12,2,0.21428571428571427,0.030303030303030304
"[0, 0, 0, 0, 0, 0, 1, 1, 1, 1, 0, 0, 1, 0, 1]",431,270,161,33,17,0.12222222222222222,0.10559006211180125
"[1, 1, 0, 1, 0, 0, 1, 0, 0, 0, 1, 1, 0, 0, 1]",134,79,55,14,6,0.17721518987341772,0.10909090909090909
"[1, 0, 1, 0, 1, 1, 1, 1, 0, 1, 0, 0, 1, 0, 0]",111,49,62,3,8,0.061224489795918366,0.12903225806451613
"[0, 1, 0, 0, 1, 0, 1, 1, 0, 0, 0, 1, 1, 1, 1]",174,83,91,8,20,0.0963855421686747,0.21978021978021978
"[0, 1, 1, 1, 0, 0, 0, 0, 1, 0, 1, 0, 0, 0, 0]",263,166,97,15,10,0.09036144578313253,0.10309278350515463
"[1, 0, 0, 1, 1, 0, 0, 0, 1, 0, 0, 0, 1, 1, 0]",188,86,102,5,14,0.05813953488372093,0.13725490196078433
"[1, 1, 0, 0, 1, 1, 1, 0, 0, 1, 1, 0, 0, 0, 1]",168,77,91,8,5,0.1038961038961039,0.054945054945054944
"[0, 0, 0, 0, 0, 1, 0, 0, 0, 1, 0, 0, 1, 1, 0]",625,465,160,39,19,0.08387096774193549,0.11875
"[1, 1, 0, 0, 0, 1, 1, 0, 1, 1, 0, 0, 1, 0, 0]",118,58,60,5,4,0.08620689655172414,0.06666666666666667
"[1, 0, 0, 0, 1, 0, 0, 1, 0, 1, 0, 0, 0, 0, 0]",614,421,193,43,19,0.1021377672209026,0.09844559585492228
"[1, 1, 1, 1, 0, 1, 1, 1, 0, 0, 1, 0, 0, 1, 0]",137,56,81,5,12,0.08928571428571429,0.14814814814814814
"[1, 1, 0, 0, 0, 0, 1, 0, 1, 1, 0, 0, 1, 0, 0]",159,89,70,11,9,0.12359550561797752,0.12857142857142856
"[1, 0, 0, 0, 1, 1, 0, 1, 1, 0, 0, 0, 0, 1, 0]",153,89,64,3,11,0.033707865168539325,0.171875
"[0, 0, 1, 1, 1, 0, 1, 1, 1, 0, 0, 0, 1, 0, 0]",121,64,57,6,5,0.09375,0.08771929824561403
"[0, 0, 0, 0, 1, 0, 1, 1, 0, 1, 0, 0, 0, 1, 1]",196,113,83,10,8,0.08849557522123894,0.0963855421686747
"[1, 1, 0, 1, 0, 0, 1, 1, 1, 1, 1, 1, 0, 0, 0]",349,143,206,10,22,0.06993006993006994,0.10679611650485436
"[1, 0, 1, 0, 1, 1, 0, 0, 0, 1, 0, 0, 0, 1, 1]",147,87,60,8,6,0.09195402298850575,0.1
"[0, 0, 1, 0, 1, 0, 1, 1, 0, 0, 0, 1, 0, 0, 0]",240,163,77,12,9,0.0736196319018405,0.11688311688311688
"[1, 1, 0, 0, 1, 0, 1, 0, 1, 1, 0, 0, 0, 1, 0]",96,48,48,5,0,0.10416666666666667,0.0
"[0, 0, 1, 1, 1, 0, 0, 1, 1, 0, 0, 1, 0, 1, 0]",129,63,66,4,5,0.06349206349206349,0.07575757575757576
"[0, 1, 1, 0, 1, 1, 0, 1, 1, 0, 0, 1, 1, 0, 1]",159,64,95,4,9,0.0625,0.09473684210526316
"[1, 0, 1, 1, 1, 1, 0, 0, 1, 0, 1, 0, 1, 0, 1]",134,59,75,10,7,0.1694915254237288,0.09333333333333334
"[0, 0, 0, 1, 1, 0, 1, 1, 1, 1, 1, 0, 0, 0, 0]",227,137,90,11,7,0.08029197080291971,0.07777777777777778
"[0, 1, 1, 1, 0, 1, 1, 0, 1, 0, 0, 0, 0, 0, 0]",190,109,81,12,5,0.11009174311926606,0.06172839506172839
"[0, 1, 1, 1, 1, 1, 1, 0, 1, 0, 0, 1, 1, 1, 1]",814,321,493,25,46,0.0778816199376947,0.09330628803245436
"[1, 1, 0, 1, 1, 0, 1, 0, 0, 1, 1, 1, 1, 0, 0]",237,101,136,10,15,0.09900990099009901,0.11029411764705882
"[1, 1, 0, 0, 0, 1, 1, 1, 0, 1, 0, 1, 1, 0, 1]",145,63,82,2,8,0.031746031746031744,0.0975609756097561
"[1, 0, 1, 0, 0, 1, 0, 0, 1, 1, 1, 1, 1, 1, 0]",224,93,131,5,11,0.053763440860215055,0.08396946564885496
"[1, 1, 1, 1, 0, 1, 0, 0, 0, 0, 1, 0, 0, 0, 1]",132,61,71,5,5,0.08196721311475409,0.07042253521126761
"[1, 0, 0, 0, 1, 1, 1, 1, 0, 1, 0, 0, 0, 0, 1]",140,72,68,6,6,0.08333333333333333,0.08823529411764706
"[0, 0, 1, 0, 0, 0, 0, 0, 1, 0, 1, 1, 0, 0, 1]",269,173,96,13,9,0.07514450867052024,0.09375
"[0, 1, 0, 1, 0, 0, 0, 0, 0, 0, 0, 1, 1, 0, 1]",282,192,90,28,9,0.14583333333333334,0.1
"[0, 0, 1, 0, 0, 0, 0, 1, 1, 0, 1, 0, 1, 0, 0]",235,135,100,15,8,0.1111111111111111,0.08
"[0, 1, 0, 0, 1, 0, 0, 0, 0, 0, 1, 1, 0, 0, 1]",330,214,116,18,8,0.08411214953271028,0.06896551724137931
"[1, 0, 0, 0, 0, 1, 0, 1, 1, 0, 0, 1, 0, 0, 1]",131,75,56,7,8,0.09333333333333334,0.14285714285714285
"[1, 0, 1, 0, 0, 1, 1, 1, 0, 1, 1, 0, 0, 0, 0]",163,79,84,5,10,0.06329113924050633,0.11904761904761904
"[1, 0, 0, 1, 0, 1, 0, 0, 1, 1, 1, 0, 1, 1, 0]",101,47,54,3,3,0.06382978723404255,0.05555555555555555
"[0, 1, 0, 0, 0, 0, 1, 0, 0, 1, 0, 1, 0, 0, 1]",270,180,90,13,8,0.07222222222222222,0.08888888888888889
"[0, 0, 1, 1, 0, 1, 0, 0, 0, 1, 1, 0, 0, 0, 1]",157,97,60,11,10,0.1134020618556701,0.16666666666666666
"[1, 0, 1, 1, 1, 0, 1, 0, 1, 0, 1, 1, 0, 1, 1]",221,77,144,8,13,0.1038961038961039,0.09027777777777778
"[1, 1, 0, 1, 0, 1, 0, 1, 0, 1, 0, 1, 0, 0, 0]",114,56,58,4,7,0.07142857142857142,0.1206896551724138
"[1, 1, 0, 1, 1, 1, 1, 1, 0, 1, 0, 1, 0, 1, 0]",225,90,135,14,12,0.15555555555555556,0.08888888888888889
"[0, 1, 1, 0, 1, 1, 1, 1, 1, 0, 1, 0, 1, 0, 1]",220,86,134,7,20,0.08139534883720931,0.14925373134328357
"[0, 1, 0, 0, 0, 1, 1, 1, 1, 0, 1, 1, 0, 0, 0]",129,68,61,8,4,0.11764705882352941,0.06557377049180328
"[1, 1, 0, 0, 0, 1, 0, 1, 1, 1, 0, 1, 1, 1, 1]",299,112,187,12,16,0.10714285714285714,0.0855614973262032
"[1, 0, 1, 0, 0, 1, 1, 1, 0, 0, 1, 0, 1, 1, 0]",95,44,51,7,7,0.1590909090909091,0.13725490196078433
"[0, 0, 0, 0, 0, 0, 0, 1, 0, 1, 1, 1, 0, 1, 0]",260,174,86,14,6,0.08045977011494253,0.06976744186046512
"[0, 1, 0, 0, 1, 1, 1, 1, 1, 1, 0, 1, 1, 0, 1]",242,94,148,8,14,0.0851063829787234,0.0945945945945946
"[0, 1, 0, 0, 1, 0, 1, 0, 0, 1, 1, 1, 1, 1, 1]",246,109,137,11,14,0.10091743119266056,0.10218978102189781
"[1, 1, 0, 1, 1, 0, 1, 0, 0, 0, 0, 0, 1, 1, 1]",174,89,85,6,6,0.06741573033707865,0.07058823529411765
"[1, 1, 1, 0, 0, 0, 1, 0, 0, 0, 1, 0, 0, 0, 1]",145,79,66,5,6,0.06329113924050633,0.09090909090909091
"[1, 0, 1, 0, 0, 1, 0, 1, 1, 1, 0, 1, 1, 1, 0]",119,48,71,4,7,0.08333333333333333,0.09859154929577464
"[0, 1, 1, 1, 0, 0, 0, 1, 1, 0, 0, 1, 1, 1, 0]",123,55,68,3,4,0.05454545454545454,0.058823529411764705
"[0, 1, 1, 1, 1, 0, 1, 0, 1, 0, 0, 1, 1, 1, 0]",140,64,76,6,5,0.09375,0.06578947368421052
"[1, 1, 1, 0, 0, 0, 1, 1, 0, 1, 1, 0, 1, 1, 1]",291,84,207,10,17,0.11904761904761904,0.0821256038647343
"[0, 0, 0, 1, 1, 0, 0, 0, 1, 0, 0, 0, 1, 0, 1]",274,188,86,18,4,0.09574468085106383,0.046511627906976744
"[1, 1, 0, 0, 0, 1, 0, 1, 0, 0, 0, 1, 1, 0, 0]",195,110,85,13,6,0.11818181818181818,0.07058823529411765
"[0, 1, 1, 0, 0, 0, 1, 0, 1, 0, 0, 0, 1, 1, 0]",163,100,63,10,6,0.1,0.09523809523809523
"[0, 0, 1, 1, 1, 1, 0, 0, 1, 0, 1, 1, 0, 0, 1]",180,88,92,11,11,0.125,0.11956521739130435
"[0, 0, 0, 1, 1, 1, 1, 0, 0, 1, 0, 1, 1, 0, 0]",183,118,65,12,2,0.1016949152542373,0.03076923076923077
"[0, 0, 0, 1, 1, 0, 1, 0, 0, 1, 0, 1, 0, 1, 1]",138,86,52,13,3,0.1511627906976744,0.057692307692307696
"[0, 1, 0, 0, 1, 0, 1, 1, 0, 1, 0, 1, 0, 0, 0]",134,81,53,7,5,0.08641975308641975,0.09433962264150944
"[0, 0, 1, 0, 0, 1, 0, 1, 1, 0, 1, 0, 1, 0, 0]",128,68,60,7,6,0.10294117647058823,0.1
"[1, 0, 0, 1, 1, 1, 0, 1, 0, 0, 0, 0, 1, 0, 0]",155,96,59,8,2,0.08333333333333333,0.03389830508474576
"[1, 0, 1, 0, 1, 0, 0, 0, 0, 0, 0, 1, 0, 0, 1]",262,153,109,17,9,0.1111111111111111,0.08256880733944955
"[0, 1, 1, 1, 1, 0, 1, 0, 1, 1, 0, 0, 0, 0, 1]",174,96,78,8,7,0.08333333333333333,0.08974358974358974
"[1, 1, 0, 0, 0, 1, 1, 1, 1, 0, 1, 0, 1, 1, 0]",147,66,81,3,4,0.045454545454545456,0.04938271604938271
"[1, 0, 1, 1, 1, 0, 1, 0, 0, 0, 0, 1, 1, 1, 0]",135,72,63,11,8,0.1527777777777778,0.12698412698412698
"[0, 1, 1, 0, 1, 1, 1, 0, 1, 0, 0, 0, 0, 1, 1]",174,87,87,6,7,0.06896551724137931,0.08045977011494253
"[1, 0, 1, 1, 1, 1, 1, 0, 1, 0, 1, 0, 1, 0, 0]",149,66,83,4,10,0.06060606060606061,0.12048192771084337
"[1, 0, 0, 1, 1, 1, 1, 1, 0, 1, 0, 1, 0, 0, 0]",129,52,77,6,14,0.11538461538461539,0.18181818181818182
"[1, 1, 1, 1, 1, 0, 0, 0, 1, 1, 1, 0, 1, 1, 0]",311,102,209,7,17,0.06862745098039216,0.08133971291866028
"[0, 1, 0, 0, 0, 0, 0, 1, 1, 1, 0, 1, 1, 1, 0]",112,54,58,7,4,0.12962962962962962,0.06896551724137931
"[0, 0, 0, 1, 0, 1, 0, 1, 0, 1, 1, 1, 1, 0, 1]",118,58,60,7,5,0.1206896551724138,0.08333333333333333
"[0, 1, 0, 0, 1, 0, 0, 1, 0, 0, 0, 0, 1, 1, 1]",250,141,109,14,10,0.09929078014184398,0.09174311926605505
"[0, 0, 1, 0, 0, 1, 1, 0, 1, 1, 0, 1, 0, 1, 0]",90,47,43,4,2,0.0851063829787234,0.046511627906976744
"[0, 1, 0, 0, 0, 1, 1, 0, 1, 1, 0, 0, 1, 0, 1]",115,73,42,5,3,0.0684931506849315,0.07142857142857142
"[0, 0, 0, 1, 1, 0, 0, 1, 0, 1, 0, 1, 0, 0, 1]",160,102,58,8,5,0.0784313725490196,0.08620689655172414
"[0, 1, 0, 1, 0, 0, 1, 0, 1, 1, 1, 1, 1, 0, 0]",153,74,79,11,5,0.14864864864864866,0.06329113924050633
"[1, 1, 0, 1, 1, 0, 0, 1, 1, 1, 0, 1, 1, 0, 1]",217,82,135,7,15,0.08536585365853659,0.1111111111111111
"[0, 0, 1, 1, 1, 1, 1, 1, 0, 0, 1, 1, 0, 1, 0]",349,147,202,15,16,0.10204081632653061,0.07920792079207921
"[1, 1, 0, 0, 1, 1, 0, 1, 1, 1, 1, 0, 0, 0, 0]",240,112,128,6,11,0.05357142857142857,0.0859375
"[0, 1, 1, 0, 1, 0, 0, 1, 0, 0, 0, 0, 1, 0, 0]",249,165,84,14,3,0.08484848484848485,0.03571428571428571
"[0, 1, 0, 0, 1, 0, 0, 0, 1, 1, 0, 1, 0, 0, 0]",233,142,91,15,16,0.1056338028169014,0.17582417582417584
"[0, 1, 0, 1, 0, 0, 0, 0, 0, 1, 0, 0, 0, 0, 1]",558,395,163,29,14,0.07341772151898734,0.08588957055214724
"[0, 1, 0, 1, 1, 0, 0, 0, 0, 1, 0, 0, 0, 0, 1]",270,180,90,16,7,0.08888888888888889,0.07777777777777778
"[1, 0, 0, 0, 1, 1, 1, 0, 0, 0, 0, 0, 1, 0, 1]",158,91,67,9,4,0.0989010989010989,0.05970149253731343
"[0, 1, 1, 1, 0, 0, 1, 0, 0, 1, 1, 0, 1, 1, 0]",123,63,60,2,5,0.031746031746031744,0.08333333333333333
"[1, 1, 1, 0, 1, 1, 1, 0, 0, 1, 0, 0, 1, 1, 0]",187,76,111,10,15,0.13157894736842105,0.13513513513513514
"[1, 1, 0, 0, 0, 1, 1, 0, 0, 1, 0, 1, 1, 0, 0]",134,73,61,10,8,0.136986301369863,0.13114754098360656
"[1, 0, 1, 1, 1, 1, 0, 0, 1, 0, 1, 1, 0, 1, 0]",126,55,71,5,5,0.09090909090909091,0.07042253521126761
"[1, 1, 1, 1, 0, 1, 0, 0, 1, 1, 0, 1, 0, 0, 1]",167,68,99,7,13,0.10294117647058823,0.13131313131313133
"[0, 1, 1, 1, 1, 0, 1, 0, 0, 1, 1, 0, 1, 0, 0]",113,53,60,7,9,0.1320754716981132,0.15
"[1, 0, 0, 0, 1, 0, 1, 0, 0, 1, 0, 0, 1, 1, 1]",159,96,63,5,10,0.052083333333333336,0.15873015873015872
"[1, 0, 0, 0, 0, 1, 1, 0, 0, 0, 1, 0, 0, 1, 0]",284,158,126,25,12,0.15822784810126583,0.09523809523809523
"[0, 0, 1, 0, 0, 0, 0, 1, 0, 0, 1, 0, 1, 1, 0]",213,140,73,19,10,0.1357142857142857,0.136986301369863
"[1, 0, 1, 1, 1, 1, 1, 1, 1, 0, 0, 0, 0, 1, 0]",213,77,136,7,11,0.09090909090909091,0.08088235294117647
"[0, 1, 1, 1, 1, 1, 0, 0, 0, 0, 0, 1, 1, 1, 1]",371,177,194,17,18,0.096045197740113,0.09278350515463918
"[0, 0, 0, 0, 1, 0, 1, 0, 0, 0, 1, 1, 0, 0, 1]",346,233,113,16,7,0.06866952789699571,0.061946902654867256
"[0, 1, 1, 1, 1, 1, 0, 0, 0, 0, 1, 0, 1, 0, 0]",135,78,57,5,7,0.0641025641025641,0.12280701754385964
"[0, 0, 0, 0, 0, 0, 0, 1, 1, 1, 1, 1, 0, 0, 0]",649,487,162,42,13,0.08624229979466119,0.08024691358024691
"[1, 1, 1, 0, 0, 0, 1, 1, 1, 1, 1, 1, 1, 1, 0]",926,290,636,33,65,0.11379310344827587,0.10220125786163523
"[0, 1, 0, 0, 1, 0, 1, 1, 1, 0, 1, 0, 1, 0, 0]",112,68,44,5,9,0.07352941176470588,0.20454545454545456
"[1, 0, 0, 0, 1, 1, 1, 1, 1, 0, 0, 1, 0, 0, 1]",151,76,75,8,4,0.10526315789473684,0.05333333333333334
"[1, 0, 0, 0, 1, 1, 1, 0, 0, 0, 0, 0, 1, 0, 0]",275,177,98,14,9,0.07909604519774012,0.09183673469387756
"[0, 0, 1, 0, 1, 0, 0, 1, 0, 1, 1, 0, 0, 0, 1]",151,94,57,11,9,0.11702127659574468,0.15789473684210525
"[0, 0, 1, 1, 1, 1, 0, 0, 0, 1, 0, 0, 1, 0, 1]",151,77,74,9,10,0.11688311688311688,0.13513513513513514
"[1, 0, 0, 1, 1, 1, 1, 0, 0, 0, 1, 0, 0, 1, 0]",124,53,71,8,8,0.1509433962264151,0.11267605633802817
"[0, 1, 1, 1, 0, 0, 1, 1, 1, 1, 0, 0, 0, 1, 0]",144,82,62,3,7,0.036585365853658534,0.11290322580645161
"[0, 0, 1, 0, 0, 0, 1, 0, 1, 0, 0, 0, 1, 1, 1]",199,115,84,8,9,0.06956521739130435,0.10714285714285714
"[1, 0, 1, 1, 1, 0, 1, 0, 1, 1, 1, 0, 1, 0, 1]",204,64,140,2,16,0.03125,0.11428571428571428
"[1, 0, 1, 1, 1, 1, 1, 1, 1, 0, 0, 0, 1, 0, 1]",277,86,191,4,15,0.046511627906976744,0.07853403141361257
"[1, 1, 1, 0, 0, 0, 0, 0, 1, 1, 1, 1, 1, 1, 0]",387,139,248,16,26,0.11510791366906475,0.10483870967741936
"[0, 1, 1, 1, 0, 0, 0, 0, 0, 1, 1, 1, 1, 1, 1]",441,186,255,20,19,0.10752688172043011,0.07450980392156863
"[0, 1, 1, 1, 1, 0, 0, 0, 0, 0, 0, 1, 0, 1, 0]",232,174,58,22,6,0.12643678160919541,0.10344827586206896
"[0, 1, 1, 0, 0, 1, 0, 1, 0, 0, 0, 0, 1, 0, 1]",141,96,45,12,5,0.125,0.1111111111111111
"[0, 1, 0, 1, 1, 0, 0, 0, 0, 0, 1, 1, 0, 0, 1]",232,144,88,13,5,0.09027777777777778,0.056818181818181816
"[0, 1, 1, 0, 0, 0, 0, 0, 0, 1, 0, 0, 0, 1, 0]",670,494,176,44,13,0.08906882591093117,0.07386363636363637
"[1, 1, 0, 1, 0, 1, 0, 1, 0, 1, 1, 1, 0, 0, 0]",153,73,80,6,7,0.0821917808219178,0.0875
"[1, 0, 1, 1, 0, 0, 0, 0, 1, 1, 0, 0, 1, 1, 0]",352,188,164,23,16,0.12234042553191489,0.0975609756097561
"[1, 0, 1, 1, 0, 1, 1, 1, 1, 0, 1, 0, 1, 1, 1]",568,174,394,17,45,0.09770114942528736,0.11421319796954314
"[1, 0, 0, 1, 1, 0, 1, 1, 1, 0, 0, 1, 1, 0, 1]",141,47,94,2,6,0.0425531914893617,0.06382978723404255
"[1, 1, 0, 0, 1, 1, 1, 1, 1, 0, 0, 1, 0, 0, 1]",223,95,128,10,10,0.10526315789473684,0.078125
"[0, 1, 1, 1, 1, 1, 1, 1, 1, 0, 0, 0, 1, 1, 0]",429,213,216,18,21,0.08450704225352113,0.09722222222222222
"[1, 0, 1, 1, 1, 1, 1, 1, 1, 1, 0, 0, 0, 1, 1]",801,229,572,28,61,0.1222707423580786,0.10664335664335664
"[1, 1, 0, 0, 0, 0, 0, 1, 1, 0, 1, 1, 1, 0, 0]",153,71,82,7,4,0.09859154929577464,0.04878048780487805
"[0, 0, 0, 0, 1, 1, 0, 1, 0, 1, 0, 0, 1, 0, 1]",176,111,65,10,6,0.09009009009009009,0.09230769230769231
"[1, 1, 0, 0, 1, 0, 0, 0, 0, 1, 1, 0, 1, 0, 1]",102,54,48,2,3,0.037037037037037035,0.0625
"[1, 1, 0, 1, 1, 0, 0, 0, 1, 1, 1, 0, 0, 1, 0]",85,42,43,2,5,0.047619047619047616,0.11627906976744186
"[0, 0, 1, 0, 1, 1, 1, 0, 1, 0, 1, 1, 0, 0, 0]",147,83,64,8,5,0.0963855421686747,0.078125
"[0, 1, 1, 1, 1, 0, 1, 0, 0, 1, 0, 0, 0, 0, 1]",143,84,59,7,2,0.08333333333333333,0.03389830508474576
"[0, 1, 0, 1, 0, 1, 1, 1, 1, 0, 1, 0, 0, 1, 0]",101,56,45,6,7,0.10714285714285714,0.15555555555555556
"[1, 0, 1, 0, 1, 0, 1, 1, 1, 1, 0, 1, 0, 1, 0]",137,57,80,8,11,0.14035087719298245,0.1375
"[1, 0, 1, 0, 0, 1, 0, 1, 1, 0, 1, 1, 1, 0, 0]",115,57,58,4,6,0.07017543859649122,0.10344827586206896
"[0, 1, 1, 1, 0, 1, 0, 1, 0, 0, 0, 1, 1, 0, 0]",132,60,72,4,3,0.06666666666666667,0.041666666666666664
"[1, 0, 1, 0, 1, 0, 0, 1, 0, 1, 1, 1, 0, 1, 0]",93,49,44,3,9,0.061224489795918366,0.20454545454545456
"[0, 1, 1, 0, 0, 1, 0, 1, 0, 1, 0, 0, 0, 0, 0]",320,213,107,22,14,0.10328638497652583,0.1308411214953271
"[1, 1, 0, 0, 0, 0, 1, 0, 0, 1, 1, 1, 1, 0, 1]",139,48,91,4,14,0.08333333333333333,0.15384615384615385
"[1, 1, 1, 0, 0, 0, 0, 1, 0, 1, 1, 1, 1, 0, 1]",159,53,106,2,6,0.03773584905660377,0.05660377358490566
"[0, 0, 0, 0, 0, 1, 1, 1, 0, 0, 0, 0, 1, 0, 1]",303,208,95,25,10,0.1201923076923077,0.10526315789473684
"[0, 1, 0, 0, 1, 1, 1, 1, 1, 1, 0, 1, 1, 0, 0]",169,73,96,6,11,0.0821917808219178,0.11458333333333333
"[1, 1, 0, 0, 0, 0, 1, 0, 1, 1, 0, 0, 0, 1, 0]",149,88,61,10,3,0.11363636363636363,0.04918032786885246
"[0, 0, 0, 0, 0, 0, 0, 1, 1, 1, 0, 1, 0, 1, 0]",321,228,93,27,4,0.11842105263157894,0.043010752688172046
"[1, 1, 0, 0, 0, 1, 0, 1, 0, 1, 1, 1, 0, 0, 1]",153,73,80,4,10,0.0547945205479452,0.125
"[1, 1, 1, 0, 0, 0, 1, 0, 1, 0, 1, 1, 1, 0, 0]",143,55,88,9,11,0.16363636363636364,0.125
"[0, 0, 0, 1, 1, 1, 0, 0, 0, 1, 0, 1, 0, 1, 1]",129,79,50,6,4,0.0759493670886076,0.08
"[1, 1, 0, 1, 1, 1, 0, 1, 1, 0, 0, 0, 0, 0, 1]",140,60,80,10,6,0.16666666666666666,0.075
"[0, 1, 0, 0, 1, 0, 1, 1, 0, 1, 1, 1, 0, 1, 1]",123,46,77,7,11,0.15217391304347827,0.14285714285714285
"[0, 1, 1, 0, 1, 1, 1, 1, 0, 1, 0, 0, 0, 0, 0]",143,77,66,7,3,0.09090909090909091,0.045454545454545456
"[0, 0, 1, 0, 0, 1, 0, 0, 1, 0, 0, 1, 0, 0, 1]",251,165,86,15,9,0.09090909090909091,0.10465116279069768
"[0, 0, 1, 0, 0, 1, 0, 1, 0, 1, 0, 0, 1, 0, 1]",140,73,67,5,5,0.0684931506849315,0.07462686567164178
"[1, 0, 1, 1, 0, 1, 1, 1, 0, 1, 1, 1, 0, 0, 1]",267,88,179,7,20,0.07954545454545454,0.11173184357541899
"[0, 1, 1, 0, 0, 1, 1, 0, 1, 0, 1, 0, 0, 1, 0]",108,57,51,4,4,0.07017543859649122,0.0784313725490196
"[0, 1, 0, 0, 0, 0, 0, 1, 1, 0, 1, 0, 0, 1, 1]",187,98,89,11,4,0.11224489795918367,0.0449438202247191
"[0, 1, 1, 1, 0, 0, 1, 1, 0, 1, 0, 0, 0, 1, 1]",122,51,71,7,5,0.13725490196078433,0.07042253521126761
"[0, 0, 1, 0, 0, 1, 1, 1, 0, 0, 0, 1, 0, 0, 0]",250,175,75,19,7,0.10857142857142857,0.09333333333333334
"[0, 0, 1, 1, 0, 0, 1, 1, 0, 0, 1, 0, 1, 1, 1]",411,218,193,18,20,0.08256880733944955,0.10362694300518134
"[0, 1, 0, 1, 0, 1, 0, 1, 1, 1, 1, 0, 0, 1, 0]",98,49,49,7,3,0.14285714285714285,0.061224489795918366
"[0, 1, 0, 0, 0, 1, 1, 0, 0, 1, 0, 1, 0, 1, 0]",143,82,61,8,12,0.0975609756097561,0.19672131147540983
"[0, 0, 1, 0, 1, 1, 0, 0, 1, 1, 0, 0, 1, 1, 0]",306,175,131,13,15,0.07428571428571429,0.11450381679389313
"[0, 0, 0, 1, 0, 1, 1, 0, 0, 1, 1, 0, 0, 1, 1]",334,200,134,22,13,0.11,0.09701492537313433
"[1, 1, 1, 0, 1, 0, 1, 0, 0, 1, 0, 1, 1, 0, 0]",127,59,68,11,5,0.1864406779661017,0.07352941176470588
"[0, 0, 0, 0, 0, 0, 1, 1, 0, 0, 1, 0, 1, 1, 0]",361,234,127,30,10,0.1282051282051282,0.07874015748031496
"[1, 0, 0, 0, 0, 0, 0, 1, 1, 0, 0, 1, 0, 1, 1]",364,121,243,14,20,0.11570247933884298,0.0823045267489712
"[0, 1, 1, 1, 1, 1, 0, 0, 0, 0, 0, 1, 0, 0, 1]",156,90,66,5,5,0.05555555555555555,0.07575757575757576
"[0, 0, 0, 1, 0, 0, 1, 0, 0, 1, 1, 1, 0, 1, 1]",121,71,50,10,7,0.14084507042253522,0.14
"[1, 0, 1, 1, 1, 0, 1, 1, 1, 1, 0, 0, 0, 1, 0]",126,52,74,4,5,0.07692307692307693,0.06756756756756757
"[1, 1, 1, 0, 0, 0, 1, 1, 1, 0, 1, 1, 1, 1, 0]",268,98,170,9,20,0.09183673469387756,0.11764705882352941
"[0, 0, 1, 1, 0, 1, 0, 1, 1, 0, 0, 1, 0, 1, 1]",131,63,68,10,4,0.15873015873015872,0.058823529411764705
"[0, 0, 0, 1, 0, 1, 0, 1, 1, 0, 0, 0, 1, 1, 0]",146,84,62,6,6,0.07142857142857142,0.0967741935483871
"[1, 1, 1, 1, 1, 0, 0, 1, 0, 1, 0, 0, 1, 0, 0]",127,55,72,4,9,0.07272727272727272,0.125
"[0, 0, 0, 1, 1, 1, 0, 0, 0, 1, 1, 0, 1, 1, 1]",194,99,95,10,8,0.10101010101010101,0.08421052631578947
"[0, 0, 0, 1, 1, 0, 0, 0, 1, 1, 1, 1, 1, 0, 0]",187,122,65,13,8,0.10655737704918032,0.12307692307692308
"[0, 0, 1, 1, 1, 1, 1, 1, 1, 0, 0, 0, 1, 0, 0]",188,97,91,7,10,0.07216494845360824,0.10989010989010989
"[1, 1, 1, 0, 0, 0, 0, 0, 0, 1, 0, 1, 0, 1, 0]",166,91,75,7,8,0.07692307692307693,0.10666666666666667
"[1, 1, 1, 1, 0, 1, 1, 1, 0, 1, 0, 0, 0, 1, 1]",294,86,208,3,18,0.03488372093023256,0.08653846153846154
"[0, 1, 0, 1, 0, 1, 0, 1, 0, 1, 0, 1, 1, 0, 0]",120,71,49,2,5,0.028169014084507043,0.10204081632653061
"[0, 1, 0, 1, 0, 0, 1, 1, 0, 0, 0, 0, 1, 1, 1]",348,168,180,13,17,0.07738095238095238,0.09444444444444444
"[1, 0, 1, 0, 0, 0, 1, 1, 0, 1, 0, 1, 0, 0, 1]",115,52,63,4,6,0.07692307692307693,0.09523809523809523
"[0, 0, 0, 0, 1, 0, 0, 1, 0, 0, 1, 0, 0, 0, 1]",558,406,152,44,17,0.10837438423645321,0.1118421052631579
"[1, 0, 0, 1, 1, 1, 1, 1, 0, 0, 0, 1, 1, 1, 1]",424,109,315,9,26,0.08256880733944955,0.08253968253968254
"[0, 1, 1, 1, 0, 0, 0, 1, 1, 1, 0, 1, 1, 1, 1]",298,101,197,5,21,0.04950495049504951,0.1065989847715736
"[1, 1, 1, 1, 0, 1, 1, 0, 0, 1, 0, 1, 0, 1, 1]",280,100,180,8,22,0.08,0.12222222222222222
"[0, 1, 0, 1, 1, 0, 0, 1, 0, 1, 0, 1, 0, 1, 0]",86,36,50,1,6,0.027777777777777776,0.12
"[1, 1, 0, 1, 1, 1, 1, 0, 0, 1, 0, 1, 1, 1, 1]",604,183,421,13,33,0.07103825136612021,0.07838479809976247
"[1, 0, 0, 1, 1, 1, 1, 1, 1, 1, 0, 0, 1, 0, 1]",344,106,238,6,20,0.05660377358490566,0.08403361344537816
"[0, 1, 1, 0, 0, 0, 0, 1, 0, 0, 1, 0, 0, 0, 0]",665,504,161,63,20,0.125,0.12422360248447205
"[0, 0, 1, 1, 0, 0, 0, 0, 1, 0, 0, 1, 0, 0, 0]",694,478,216,48,18,0.100418410041841,0.08333333333333333
"[1, 1, 0, 1, 1, 0, 0, 1, 0, 0, 1, 1, 0, 1, 1]",135,51,84,5,7,0.09803921568627451,0.08333333333333333
"[1, 1, 1, 0, 0, 1, 1, 0, 1, 1, 1, 0, 0, 1, 0]",173,71,102,12,7,0.16901408450704225,0.06862745098039216
"[1, 0, 1, 0, 0, 0, 1, 0, 1, 0, 0, 0, 0, 0, 1]",253,166,87,12,8,0.07228915662650602,0.09195402298850575
"[0, 1, 0, 0, 1, 0, 0, 0, 1, 0, 0, 0, 1, 1, 0]",249,165,84,18,6,0.10909090909090909,0.07142857142857142
"[0, 0, 1, 0, 1, 1, 0, 0, 1, 1, 1, 1, 1, 0, 1]",151,73,78,8,3,0.1095890410958904,0.038461538461538464
"[0, 1, 0, 0, 1, 0, 1, 1, 0, 0, 1, 1, 1, 1, 1]",256,113,143,9,5,0.07964601769911504,0.03496503496503497
"[1, 1, 1, 1, 1, 1, 0, 1, 0, 1, 1, 1, 1, 0, 0]",817,222,595,21,61,0.0945945945945946,0.10252100840336134
"[1, 0, 0, 0, 0, 0, 0, 0, 1, 0, 0, 1, 0, 0, 1]",557,363,194,34,10,0.09366391184573003,0.05154639175257732
"[1, 1, 0, 0, 1, 0, 1, 0, 0, 0, 0, 0, 1, 0, 1]",163,99,64,7,9,0.0707070707070707,0.140625
"[1, 1, 0, 1, 0, 1, 0, 1, 1, 1, 0, 1, 0, 0, 0]",91,43,48,5,5,0.11627906976744186,0.10416666666666667
"[0, 0, 1, 0, 1, 1, 1, 1, 0, 1, 0, 1, 0, 0, 0]",103,58,45,7,8,0.1206896551724138,0.17777777777777778
"[1, 0, 1, 1, 0, 0, 0, 0, 0, 0, 1, 1, 1, 1, 0]",435,235,200,29,25,0.12340425531914893,0.125
"[0, 0, 1, 0, 1, 1, 0, 0, 0, 1, 1, 1, 0, 1, 1]",120,54,66,4,4,0.07407407407407407,0.06060606060606061
"[1, 1, 0, 0, 1, 0, 0, 1, 1, 1, 1, 1, 1, 1, 0]",364,140,224,9,30,0.06428571428571428,0.13392857142857142
"[1, 0, 0, 1, 0, 1, 1, 0, 0, 1, 1, 0, 0, 1, 1]",296,148,148,16,16,0.10810810810810811,0.10810810810810811
"[1, 1, 0, 1, 1, 1, 0, 1, 0, 0, 1, 0, 0, 1, 0]",102,47,55,5,4,0.10638297872340426,0.07272727272727272
"[0, 1, 1, 0, 1, 1, 0, 0, 0, 0, 0, 1, 1, 1, 0]",121,62,59,4,4,0.06451612903225806,0.06779661016949153
"[0, 0, 0, 0, 1, 0, 1, 0, 0, 1, 1, 0, 1, 1, 1]",177,109,68,11,6,0.10091743119266056,0.08823529411764706
"[1, 1, 0, 1, 1, 0, 0, 0, 1, 0, 0, 1, 1, 1, 1]",204,78,126,7,11,0.08974358974358974,0.0873015873015873
"[0, 0, 0, 1, 0, 1, 1, 1, 0, 0, 1, 1, 0, 1, 0]",104,52,52,8,5,0.15384615384615385,0.09615384615384616
"[0, 1, 1, 0, 0, 1, 1, 1, 0, 1, 1, 1, 1, 0, 0]",229,107,122,14,14,0.1308411214953271,0.11475409836065574
"[1, 1, 1, 0, 1, 1, 0, 1, 1, 1, 0, 1, 0, 1, 1]",526,137,389,12,38,0.08759124087591241,0.09768637532133675
"[1, 1, 0, 0, 1, 0, 1, 1, 1, 1, 1, 0, 0, 0, 1]",176,66,110,10,13,0.15151515151515152,0.11818181818181818
"[1, 0, 0, 0, 0, 1, 1, 1, 1, 1, 0, 0, 0, 1, 1]",233,74,159,12,14,0.16216216216216217,0.0880503144654088
"[1, 1, 0, 1, 0, 0, 0, 0, 1, 1, 1, 1, 1, 0, 0]",153,72,81,11,8,0.1527777777777778,0.09876543209876543
"[1, 1, 0, 0, 0, 1, 0, 1, 0, 1, 0, 0, 0, 1, 1]",156,82,74,9,7,0.10975609756097561,0.0945945945945946
"[1, 0, 0, 0, 0, 0, 1, 1, 1, 1, 0, 1, 0, 0, 0]",180,97,83,7,12,0.07216494845360824,0.14457831325301204
"[1, 1, 0, 0, 1, 0, 1, 1, 0, 0, 0, 0, 1, 0, 1]",122,63,59,5,6,0.07936507936507936,0.1016949152542373
"[1, 0, 1, 1, 0, 0, 1, 1, 0, 0, 1, 0, 0, 0, 0]",148,88,60,6,5,0.06818181818181818,0.08333333333333333
"[1, 1, 0, 1, 1, 0, 0, 1, 1, 1, 0, 0, 1, 0, 1]",137,54,83,7,5,0.12962962962962962,0.060240963855421686
"[0, 0, 1, 1, 1, 0, 0, 0, 1, 0, 1, 1, 0, 1, 1]",123,64,59,7,1,0.109375,0.01694915254237288
"[1, 0, 0, 1, 1, 0, 0, 0, 1, 1, 1, 0, 0, 0, 1]",156,71,85,8,8,0.11267605633802817,0.09411764705882353
"[0, 0, 1, 1, 1, 0, 1, 1, 0, 1, 0, 0, 1, 0, 1]",118,52,66,8,6,0.15384615384615385,0.09090909090909091
"[1, 0, 1, 0, 0, 0, 0, 1, 1, 1, 0, 0, 0, 0, 1]",203,107,96,10,9,0.09345794392523364,0.09375
"[0, 0, 1, 1, 0, 1, 1, 0, 1, 0, 0, 0, 0, 1, 1]",175,101,74,9,10,0.0891089108910891,0.13513513513513514
"[1, 1, 0, 1, 0, 0, 0, 0, 0, 1, 1, 0, 1, 1, 0]",99,53,46,4,3,0.07547169811320754,0.06521739130434782
"[1, 1, 1, 1, 1, 1, 0, 0, 0, 0, 0, 1, 0, 0, 1]",242,110,132,13,7,0.11818181818181818,0.05303030303030303
"[1, 0, 0, 0, 0, 0, 1, 0, 0, 1, 0, 1, 0, 0, 0]",518,355,163,26,17,0.07323943661971831,0.10429447852760736
"[1, 1, 0, 0, 1, 0, 0, 1, 0, 0, 0, 0, 0, 1, 0]",241,148,93,17,4,0.11486486486486487,0.043010752688172046
"[0, 0, 0, 0, 1, 0, 1, 0, 0, 1, 1, 1, 0, 0, 1]",155,90,65,4,11,0.044444444444444446,0.16923076923076924
"[0, 0, 0, 0, 0, 1, 0, 1, 1, 1, 1, 0, 1, 1, 1]",155,87,68,10,9,0.11494252873563218,0.1323529411764706
"[1, 0, 0, 1, 1, 1, 1, 0, 0, 0, 0, 1, 0, 1, 0]",201,71,130,8,11,0.11267605633802817,0.08461538461538462
"[1, 1, 1, 0, 0, 1, 1, 1, 0, 0, 1, 1, 1, 0, 0]",212,76,136,8,7,0.10526315789473684,0.051470588235294115
"[1, 0, 0, 1, 0, 1, 1, 0, 0, 0, 0, 1, 1, 0, 0]",308,182,126,15,13,0.08241758241758242,0.10317460317460317
"[1, 1, 0, 1, 1, 0, 1, 1, 0, 1, 0, 1, 0, 0, 1]",136,51,85,9,6,0.17647058823529413,0.07058823529411765
"[0, 0, 1, 0, 1, 0, 1, 1, 0, 1, 1, 1, 1, 1, 0]",160,71,89,4,6,0.056338028169014086,0.06741573033707865
"[1, 1, 1, 1, 1, 0, 0, 1, 0, 1, 1, 1, 1, 0, 0]",380,114,266,16,22,0.14035087719298245,0.08270676691729323
"[0, 1, 0, 1, 1, 1, 1, 1, 0, 0, 1, 1, 0, 0, 1]",379,167,212,20,12,0.11976047904191617,0.05660377358490566
"[0, 1, 1, 0, 1, 1, 1, 0, 0, 1, 0, 1, 0, 0, 0]",126,62,64,2,6,0.03225806451612903,0.09375
"[1, 0, 0, 0, 0, 0, 0, 1, 0, 1, 1, 1, 0, 1, 1]",158,57,101,4,8,0.07017543859649122,0.07920792079207921
"[1, 1, 1, 0, 0, 0, 1, 1, 1, 1, 0, 1, 1, 1, 0]",256,97,159,10,20,0.10309278350515463,0.12578616352201258
"[1, 1, 1, 1, 1, 0, 0, 1, 1, 1, 0, 1, 0, 1, 1]",763,172,591,15,58,0.0872093023255814,0.09813874788494077
"[1, 0, 1, 1, 1, 1, 1, 0, 0, 1, 1, 1, 0, 1, 0]",229,77,152,2,16,0.025974025974025976,0.10526315789473684
"[1, 1, 1, 0, 1, 0, 1, 0, 0, 1, 0, 0, 0, 1, 0]",116,52,64,8,6,0.15384615384615385,0.09375
"[0, 0, 1, 0, 1, 0, 0, 1, 1, 0, 1, 0, 0, 0, 1]",144,85,59,7,8,0.08235294117647059,0.13559322033898305
"[0, 1, 1, 0, 0, 0, 1, 1, 1, 0, 0, 0, 0, 0, 0]",418,268,150,23,13,0.08582089552238806,0.08666666666666667
"[0, 0, 0, 0, 1, 1, 1, 1, 1, 1, 0, 1, 0, 1, 0]",208,104,104,10,12,0.09615384615384616,0.11538461538461539
"[0, 0, 0, 0, 1, 1, 0, 1, 0, 0, 1, 0, 0, 1, 1]",228,152,76,10,9,0.06578947368421052,0.11842105263157894
"[1, 1, 0, 0, 0, 1, 0, 0, 1, 0, 0, 1, 0, 1, 1]",119,63,56,8,7,0.12698412698412698,0.125
"[1, 1, 0, 1, 1, 0, 0, 1, 0, 0, 1, 0, 0, 1, 0]",116,63,53,6,3,0.09523809523809523,0.05660377358490566
"[0, 0, 0, 1, 0, 1, 1, 0, 0, 0, 1, 0, 0, 1, 1]",175,111,64,12,8,0.10810810810810811,0.125
"[0, 1, 0, 0, 1, 0, 1, 1, 1, 0, 1, 1, 0, 0, 0]",107,55,52,10,3,0.18181818181818182,0.057692307692307696
"[0, 1, 1, 1, 0, 0, 1, 0, 0, 1, 1, 1, 1, 1, 1]",412,149,263,10,18,0.06711409395973154,0.06844106463878327
"[1, 1, 0, 1, 0, 0, 0, 1, 0, 1, 1, 1, 0, 0, 1]",144,66,78,4,9,0.06060606060606061,0.11538461538461539
"[0, 1, 0, 0, 0, 1, 0, 1, 0, 1, 1, 1, 1, 1, 1]",204,92,112,5,8,0.05434782608695652,0.07142857142857142
"[1, 1, 0, 1, 0, 0, 0, 1, 0, 0, 1, 0, 1, 0, 0]",137,75,62,6,5,0.08,0.08064516129032258
"[0, 0, 0, 1, 1, 1, 1, 1, 1, 0, 0, 0, 0, 1, 0]",397,292,105,28,9,0.0958904109589041,0.08571428571428572
"[0, 0, 0, 1, 0, 1, 0, 1, 1, 0, 0, 1, 0, 0, 0]",244,165,79,15,8,0.09090909090909091,0.10126582278481013
"[1, 1, 0, 1, 1, 0, 0, 0, 1, 1, 1, 1, 0, 1, 1]",271,110,161,8,25,0.07272727272727272,0.15527950310559005
"[0, 1, 1, 1, 1, 0, 1, 0, 1, 0, 1, 1, 0, 0, 1]",175,80,95,12,12,0.15,0.12631578947368421
"[0, 0, 1, 0, 1, 1, 1, 1, 0, 1, 0, 1, 0, 1, 1]",143,53,90,3,9,0.05660377358490566,0.1
"[1, 1, 1, 1, 0, 0, 1, 0, 0, 0, 0, 0, 0, 0, 1]",246,144,102,14,6,0.09722222222222222,0.058823529411764705
"[1, 0, 1, 1, 1, 1, 1, 0, 1, 0, 0, 1, 0, 0, 0]",108,57,51,5,2,0.08771929824561403,0.0392156862745098
"[0, 1, 0, 1, 1, 0, 0, 1, 0, 0, 0, 0, 0, 1, 1]",197,108,89,12,11,0.1111111111111111,0.12359550561797752
"[1, 0, 0, 1, 1, 1, 0, 1, 0, 1, 1, 0, 0, 1, 0]",109,39,70,5,7,0.1282051282051282,0.1
"[1, 0, 0, 0, 1, 0, 1, 0, 0, 1, 1, 1, 0, 1, 0]",108,52,56,5,4,0.09615384615384616,0.07142857142857142
"[0, 1, 1, 1, 0, 1, 1, 0, 1, 0, 0, 0, 0, 1, 0]",109,60,49,7,4,0.11666666666666667,0.08163265306122448
"[0, 0, 1, 1, 1, 0, 0, 1, 0, 1, 0, 0, 0, 1, 0]",166,87,79,7,11,0.08045977011494253,0.13924050632911392
"[1, 1, 0, 0, 1, 1, 1, 0, 0, 1, 0, 1, 0, 0, 0]",135,65,70,9,7,0.13846153846153847,0.1
"[1, 1, 0, 1, 1, 1, 0, 1, 0, 0, 1, 1, 0, 0, 0]",157,76,81,6,7,0.07894736842105263,0.08641975308641975
"[0, 0, 1, 1, 0, 1, 1, 1, 0, 1, 0, 1, 1, 1, 1]",306,129,177,4,18,0.031007751937984496,0.1016949152542373
"[0, 0, 1, 1, 0, 1, 0, 1, 1, 0, 1, 1, 0, 1, 1]",127,59,68,8,7,0.13559322033898305,0.10294117647058823
"[0, 0, 0, 0, 1, 0, 1, 0, 1, 0, 1, 1, 0, 1, 1]",136,77,59,5,5,0.06493506493506493,0.0847457627118644
"[0, 1, 0, 0, 1, 1, 1, 0, 0, 1, 1, 1, 0, 1, 0]",99,46,53,4,4,0.08695652173913043,0.07547169811320754
"[1, 0, 1, 0, 1, 0, 0, 0, 0, 0, 1, 1, 1, 1, 1]",235,111,124,10,14,0.09009009009009009,0.11290322580645161
"[0, 1, 0, 1, 0, 1, 0, 1, 1, 0, 1, 0, 1, 0, 0]",111,59,52,2,3,0.03389830508474576,0.057692307692307696
"[1, 1, 0, 0, 0, 0, 1, 1, 1, 1, 1, 0, 1, 0, 1]",282,125,157,15,20,0.12,0.12738853503184713
"[1, 0, 1, 1, 0, 0, 0, 0, 0, 1, 0, 0, 0, 0, 1]",271,179,92,15,11,0.08379888268156424,0.11956521739130435
"[0, 1, 0, 0, 1, 0, 1, 0, 1, 0, 1, 1, 1, 0, 1]",102,51,51,5,2,0.09803921568627451,0.0392156862745098
"[1, 0, 1, 0, 0, 1, 0, 1, 0, 1, 0, 1, 1, 1, 0]",95,41,54,3,6,0.07317073170731707,0.1111111111111111
"[0, 0, 1, 0, 0, 0, 0, 1, 0, 0, 0, 1, 1, 1, 0]",262,178,84,17,7,0.09550561797752809,0.08333333333333333
"[0, 0, 0, 1, 0, 1, 0, 0, 1, 0, 1, 1, 0, 0, 0]",290,194,96,20,5,0.10309278350515463,0.052083333333333336
"[0, 0, 1, 1, 1, 0, 1, 1, 0, 1, 1, 1, 0, 1, 1]",236,79,157,8,10,0.10126582278481013,0.06369426751592357
"[1, 0, 0, 1, 1, 1, 0, 1, 1, 0, 1, 1, 1, 0, 1]",213,53,160,4,14,0.07547169811320754,0.0875
"[1, 0, 0, 1, 0, 1, 1, 0, 0, 1, 0, 0, 0, 1, 1]",138,59,79,7,5,0.11864406779661017,0.06329113924050633
"[0, 0, 0, 0, 1, 1, 0, 0, 1, 0, 1, 0, 0, 0, 1]",326,204,122,14,10,0.06862745098039216,0.08196721311475409
"[1, 1, 1, 0, 0, 0, 1, 0, 0, 1, 1, 1, 1, 0, 0]",221,102,119,11,11,0.10784313725490197,0.09243697478991597
"[0, 1, 1, 1, 0, 0, 0, 1, 0, 0, 1, 1, 1, 1, 0]",160,84,76,7,7,0.08333333333333333,0.09210526315789473
"[1, 0, 0, 1, 1, 1, 0, 0, 0, 1, 0, 0, 1, 1, 1]",173,74,99,9,11,0.12162162162162163,0.1111111111111111
"[1, 1, 1, 1, 0, 1, 1, 0, 1, 1, 1, 0, 0, 0, 0]",254,85,169,8,14,0.09411764705882353,0.08284023668639054
"[1, 0, 1, 1, 1, 1, 0, 0, 1, 0, 0, 1, 1, 0, 0]",140,77,63,5,4,0.06493506493506493,0.06349206349206349
"[0, 0, 1, 0, 0, 0, 1, 0, 0, 0, 0, 1, 0, 1, 1]",249,172,77,18,10,0.10465116279069768,0.12987012987012986
"[0, 1, 0, 1, 1, 1, 0, 0, 0, 0, 0, 0, 0, 0, 1]",459,278,181,25,21,0.08992805755395683,0.11602209944751381
"[1, 0, 0, 0, 1, 0, 1, 1, 1, 0, 1, 0, 0, 0, 1]",101,48,53,3,7,0.0625,0.1320754716981132
"[0, 1, 0, 1, 0, 1, 0, 0, 0, 1, 0, 1, 1, 1, 0]",110,59,51,5,5,0.0847457627118644,0.09803921568627451
"[0, 0, 1, 0, 1, 0, 0, 0, 1, 1, 0, 0, 1, 1, 0]",278,167,111,12,5,0.0718562874251497,0.04504504504504504
"[0, 1, 0, 0, 1, 0, 0, 1, 0, 1, 1, 0, 0, 0, 1]",145,92,53,6,5,0.06521739130434782,0.09433962264150944
"[1, 0, 0, 0, 1, 1, 0, 1, 1, 0, 0, 0, 0, 0, 0]",358,203,155,14,13,0.06896551724137931,0.08387096774193549
"[1, 0, 0, 1, 0, 1, 1, 1, 0, 0, 1, 1, 1, 0, 0]",128,62,66,4,8,0.06451612903225806,0.12121212121212122
"[0, 0, 0, 1, 0, 1, 1, 1, 0, 0, 0, 1, 1, 1, 1]",186,90,96,8,9,0.08888888888888889,0.09375
"[1, 0, 1, 0, 0, 0, 0, 1, 0, 1, 1, 1, 0, 0, 0]",155,100,55,15,3,0.15,0.05454545454545454
"[0, 1, 1, 0, 0, 0, 1, 0, 1, 0, 0, 0, 0, 0, 1]",275,192,83,22,4,0.11458333333333333,0.04819277108433735
"[0, 0, 0, 1, 1, 0, 0, 0, 1, 0, 1, 0, 0, 0, 0]",678,518,160,46,10,0.0888030888030888,0.0625
"[1, 1, 0, 0, 1, 0, 1, 0, 0, 0, 1, 0, 1, 0, 0]",120,72,48,7,6,0.09722222222222222,0.125
"[1, 0, 1, 0, 0, 0, 0, 1, 0, 1, 1, 0, 0, 1, 0]",126,66,60,10,6,0.15151515151515152,0.1
"[0, 0, 1, 1, 0, 1, 1, 1, 1, 1, 0, 0, 0, 0, 0]",257,130,127,12,8,0.09230769230769231,0.06299212598425197
"[0, 0, 0, 1, 1, 1, 1, 0, 1, 0, 1, 1, 0, 0, 1]",154,87,67,7,6,0.08045977011494253,0.08955223880597014
"[0, 1, 1, 0, 1, 1, 0, 0, 0, 1, 0, 0, 1, 0, 1]",120,59,61,7,10,0.11864406779661017,0.16393442622950818
"[1, 1, 0, 0, 1, 0, 0, 1, 0, 1, 1, 1, 1, 1, 1]",362,136,226,16,17,0.11764705882352941,0.0752212389380531
"[1, 1, 0, 1, 0, 0, 0, 1, 1, 0, 1, 1, 0, 1, 0]",97,44,53,5,8,0.11363636363636363,0.1509433962264151
"[0, 1, 0, 1, 1, 1, 1, 1, 0, 0, 1, 1, 1, 1, 0]",453,178,275,10,26,0.056179775280898875,0.09454545454545454
"[0, 0, 1, 1, 0, 1, 0, 1, 1, 0, 1, 0, 1, 1, 1]",172,75,97,7,10,0.09333333333333334,0.10309278350515463
"[0, 0, 1, 1, 1, 1, 1, 1, 0, 0, 1, 0, 0, 1, 0]",205,105,100,10,8,0.09523809523809523,0.08
"[1, 1, 0, 1, 1, 0, 0, 1, 0, 0, 0, 1, 1, 0, 1]",115,52,63,3,8,0.057692307692307696,0.12698412698412698
"[1, 0, 0, 0, 0, 1, 1, 1, 1, 0, 0, 0, 1, 0, 0]",287,126,161,8,14,0.06349206349206349,0.08695652173913043
"[1, 0, 1, 0, 1, 1, 1, 0, 0, 1, 0, 1, 1, 0, 1]",148,57,91,3,6,0.05263157894736842,0.06593406593406594
"[0, 0, 0, 0, 0, 1, 0, 0, 1, 1, 1, 0, 1, 0, 1]",140,85,55,11,7,0.12941176470588237,0.12727272727272726
"[1, 0, 1, 0, 1, 0, 0, 0, 0, 0, 1, 0, 0, 1, 1]",168,93,75,8,10,0.08602150537634409,0.13333333333333333
"[0, 0, 1, 0, 1, 0, 0, 1, 0, 1, 0, 1, 0, 0, 0]",249,157,92,10,7,0.06369426751592357,0.07608695652173914
"[1, 1, 0, 0, 1, 0, 1, 0, 0, 1, 0, 1, 0, 1, 0]",95,48,47,3,6,0.0625,0.1276595744680851
"[1, 0, 0, 0, 0, 1, 1, 1, 1, 1, 0, 0, 0, 0, 1]",259,108,151,11,9,0.10185185185185185,0.059602649006622516
"[1, 1, 0, 0, 0, 1, 0, 1, 1, 0, 0, 0, 0, 1, 1]",194,107,87,13,5,0.12149532710280374,0.05747126436781609
"[1, 0, 0, 0, 0, 0, 1, 0, 1, 1, 1, 0, 0, 0, 0]",339,208,131,17,12,0.08173076923076923,0.0916030534351145
"[1, 0, 1, 1, 1, 1, 0, 0, 0, 1, 1, 1, 0, 1, 0]",164,66,98,8,10,0.12121212121212122,0.10204081632653061
"[1, 0, 1, 0, 1, 0, 1, 1, 1, 0, 0, 1, 0, 0, 1]",115,66,49,11,3,0.16666666666666666,0.061224489795918366
"[1, 0, 1, 0, 1, 0, 1, 0, 1, 1, 1, 0, 0, 1, 0]",119,70,49,8,6,0.11428571428571428,0.12244897959183673
"[1, 1, 0, 1, 0, 0, 0, 1, 1, 1, 1, 1, 1, 0, 1]",258,88,170,8,14,0.09090909090909091,0.08235294117647059
"[1, 1, 1, 0, 1, 0, 1, 1, 0, 1, 1, 0, 0, 1, 0]",138,47,91,1,8,0.02127659574468085,0.08791208791208792
"[1, 0, 0, 0, 1, 1, 1, 1, 1, 0, 0, 0, 0, 1, 1]",329,163,166,15,11,0.09202453987730061,0.06626506024096386
"[1, 0, 0, 0, 0, 1, 1, 0, 1, 1, 1, 1, 1, 0, 1]",167,48,119,9,16,0.1875,0.13445378151260504
"[1, 0, 0, 1, 1, 0, 0, 1, 0, 1, 0, 1, 0, 1, 0]",115,64,51,10,5,0.15625,0.09803921568627451
"[1, 0, 1, 0, 0, 0, 1, 1, 0, 1, 1, 1, 0, 0, 1]",111,58,53,8,6,0.13793103448275862,0.11320754716981132
"[1, 0, 0, 0, 0, 0, 1, 1, 1, 0, 1, 0, 0, 0, 0]",293,195,98,16,12,0.08205128205128205,0.12244897959183673
"[1, 1, 0, 0, 0, 0, 0, 1, 1, 1, 0, 1, 0, 0, 0]",165,93,72,9,9,0.0967741935483871,0.125
"[0, 1, 1, 0, 0, 0, 0, 0, 1, 0, 1, 1, 1, 0, 0]",204,125,79,10,8,0.08,0.10126582278481013
"[0, 0, 0, 1, 1, 0, 1, 1, 1, 1, 0, 0, 0, 0, 0]",292,176,116,22,11,0.125,0.09482758620689655
"[1, 1, 0, 1, 1, 0, 0, 1, 0, 1, 0, 1, 1, 1, 0]",138,50,88,3,5,0.06,0.056818181818181816
"[1, 1, 1, 0, 1, 1, 1, 0, 1, 1, 0, 0, 1, 0, 1]",234,65,169,7,11,0.1076923076923077,0.0650887573964497
"[1, 1, 0, 0, 0, 0, 1, 0, 0, 0, 0, 1, 0, 1, 0]",217,147,70,11,3,0.07482993197278912,0.04285714285714286
"[0, 1, 1, 0, 0, 1, 0, 1, 0, 0, 1, 0, 1, 1, 0]",103,64,39,2,4,0.03125,0.10256410256410256
"[0, 1, 1, 0, 1, 0, 1, 0, 1, 0, 0, 0, 1, 1, 1]",149,84,65,14,7,0.16666666666666666,0.1076923076923077
"[1, 0, 0, 0, 1, 0, 0, 1, 1, 0, 1, 0, 1, 0, 0]",127,67,60,8,6,0.11940298507462686,0.1
"[0, 0, 0, 0, 1, 0, 0, 1, 0, 1, 1, 1, 1, 0, 0]",187,119,68,12,3,0.10084033613445378,0.04411764705882353
"[0, 0, 1, 1, 0, 1, 1, 1, 0, 0, 0, 1, 0, 0, 0]",147,86,61,8,10,0.09302325581395349,0.16393442622950818
"[0, 1, 1, 0, 1, 0, 0, 1, 1, 0, 1, 1, 1, 0, 0]",119,50,69,6,7,0.12,0.10144927536231885
"[1, 0, 1, 0, 0, 1, 1, 0, 1, 1, 1, 0, 1, 0, 0]",126,68,58,8,4,0.11764705882352941,0.06896551724137931
"[1, 1, 0, 1, 0, 0, 0, 0, 1, 1, 0, 1, 1, 1, 0]",115,52,63,7,5,0.1346153846153846,0.07936507936507936
"[0, 0, 0, 1, 1, 1, 0, 1, 1, 0, 1, 0, 0, 1, 1]",129,66,63,5,4,0.07575757575757576,0.06349206349206349
"[1, 1, 0, 1, 1, 0, 1, 0, 0, 1, 1, 1, 1, 1, 0]",242,87,155,8,14,0.09195402298850575,0.09032258064516129
"[1, 0, 1, 1, 0, 1, 1, 1, 0, 0, 1, 0, 0, 1, 1]",167,75,92,6,3,0.08,0.03260869565217391
"[0, 1, 1, 0, 1, 1, 0, 0, 1, 1, 0, 0, 1, 0, 0]",125,70,55,8,4,0.11428571428571428,0.07272727272727272
"[0, 0, 1, 1, 0, 1, 1, 0, 0, 1, 1, 0, 0, 1, 0]",124,64,60,6,8,0.09375,0.13333333333333333
"[0, 1, 0, 1, 0, 1, 0, 1, 0, 1, 1, 1, 0, 1, 1]",136,63,73,9,6,0.14285714285714285,0.0821917808219178
"[1, 1, 1, 1, 0, 0, 0, 1, 0, 1, 0, 0, 0, 1, 1]",184,81,103,8,8,0.09876543209876543,0.07766990291262135
"[1, 1, 1, 1, 0, 0, 1, 1, 1, 1, 0, 0, 0, 1, 0]",362,159,203,10,18,0.06289308176100629,0.08866995073891626
"[0, 0, 1, 0, 1, 0, 1, 0, 1, 1, 1, 1, 1, 0, 0]",151,82,69,11,10,0.13414634146341464,0.14492753623188406
"[1, 1, 1, 1, 1, 0, 0, 1, 0, 0, 1, 1, 0, 0, 0]",196,87,109,6,10,0.06896551724137931,0.09174311926605505
"[0, 0, 1, 0, 0, 1, 1, 0, 0, 0, 1, 1, 1, 1, 0]",162,85,77,6,7,0.07058823529411765,0.09090909090909091
"[1, 0, 1, 0, 1, 0, 0, 1, 0, 0, 0, 1, 1, 1, 1]",138,68,70,3,7,0.04411764705882353,0.1
"[0, 0, 0, 1, 0, 0, 1, 1, 0, 1, 1, 1, 1, 0, 0]",148,86,62,10,10,0.11627906976744186,0.16129032258064516
"[0, 1, 1, 1, 0, 0, 0, 0, 0, 1, 0, 1, 1, 0, 0]",153,99,54,8,8,0.08080808080808081,0.14814814814814814
"[0, 1, 1, 1, 0, 1, 0, 1, 0, 1, 0, 0, 1, 0, 1]",110,50,60,2,4,0.04,0.06666666666666667
"[1, 0, 0, 1, 1, 0, 1, 1, 0, 0, 0, 1, 0, 1, 0]",114,61,53,3,7,0.04918032786885246,0.1320754716981132
"[0, 0, 1, 0, 1, 0, 0, 0, 1, 0, 0, 1, 1, 1, 1]",159,92,67,7,6,0.07608695652173914,0.08955223880597014
"[1, 0, 1, 1, 1, 0, 0, 1, 1, 0, 1, 0, 1, 1, 0]",150,71,79,10,9,0.14084507042253522,0.11392405063291139
"[0, 1, 1, 1, 1, 1, 1, 1, 0, 1, 0, 1, 0, 1, 0]",248,95,153,10,18,0.10526315789473684,0.11764705882352941
"[0, 1, 0, 1, 0, 1, 1, 0, 0, 0, 0, 1, 0, 1, 0]",157,85,72,12,6,0.1411764705882353,0.08333333333333333
"[0, 1, 0, 0, 0, 1, 1, 1, 1, 0, 1, 1, 1, 1, 0]",139,59,80,4,6,0.06779661016949153,0.075
"[1, 1, 1, 1, 1, 1, 1, 0, 0, 0, 1, 1, 0, 1, 0]",295,94,201,11,19,0.11702127659574468,0.0945273631840796
"[1, 0, 0, 1, 1, 0, 1, 1, 1, 1, 1, 0, 0, 1, 0]",142,52,90,4,10,0.07692307692307693,0.1111111111111111
"[0, 1, 1, 1, 1, 0, 0, 1, 0, 0, 1, 0, 1, 0, 1]",120,68,52,4,4,0.058823529411764705,0.07692307692307693
"[1, 1, 0, 1, 0, 1, 1, 0, 1, 0, 1, 1, 0, 1, 1]",236,81,155,9,17,0.1111111111111111,0.10967741935483871
"[1, 0, 1, 1, 0, 1, 1, 0, 1, 0, 1, 1, 0, 1, 0]",136,57,79,5,6,0.08771929824561403,0.0759493670886076
"[1, 1, 0, 0, 0, 0, 1, 1, 0, 1, 1, 0, 1, 1, 0]",160,74,86,8,6,0.10810810810810811,0.06976744186046512
"[1, 0, 0, 1, 1, 1, 0, 0, 1, 0, 1, 1, 1, 0, 1]",135,52,83,7,8,0.1346153846153846,0.0963855421686747
"[0, 1, 0, 0, 0, 0, 1, 1, 1, 0, 1, 1, 1, 1, 0]",143,65,78,5,6,0.07692307692307693,0.07692307692307693
"[1, 1, 1, 0, 1, 0, 0, 1, 1, 0, 0, 0, 1, 0, 0]",139,71,68,7,7,0.09859154929577464,0.10294117647058823
"[0, 0, 0, 0, 1, 1, 1, 1, 1, 0, 1, 0, 0, 1, 1]",232,103,129,6,11,0.05825242718446602,0.08527131782945736
"[0, 0, 0, 1, 1, 0, 0, 1, 1, 1, 0, 1, 0, 0, 0]",214,148,66,11,6,0.07432432432432433,0.09090909090909091
"[1, 0, 0, 0, 1, 1, 0, 0, 1, 1, 1, 0, 1, 0, 0]",119,68,51,4,5,0.058823529411764705,0.09803921568627451
"[0, 1, 0, 0, 0, 0, 1, 1, 1, 1, 0, 0, 1, 0, 0]",164,89,75,11,9,0.12359550561797752,0.12
"[1, 0, 0, 0, 0, 1, 1, 1, 1, 0, 1, 0, 0, 0, 1]",163,63,100,8,9,0.12698412698412698,0.09
"[0, 1, 1, 0, 1, 1, 1, 0, 0, 0, 0, 0, 0, 0, 0]",445,266,179,27,18,0.10150375939849623,0.1005586592178771
"[0, 1, 1, 0, 1, 1, 0, 1, 0, 0, 0, 1, 1, 0, 0]",148,76,72,7,7,0.09210526315789473,0.09722222222222222
"[1, 1, 1, 0, 1, 0, 1, 1, 0, 0, 1, 1, 1, 0, 1]",248,89,159,12,19,0.1348314606741573,0.11949685534591195
"[0, 1, 1, 1, 0, 0, 0, 0, 1, 1, 1, 1, 1, 0, 0]",200,99,101,8,7,0.08080808080808081,0.06930693069306931
"[1, 0, 0, 1, 1, 1, 1, 0, 0, 1, 0, 0, 0, 1, 1]",195,81,114,9,14,0.1111111111111111,0.12280701754385964
"[1, 0, 1, 0, 1, 1, 0, 0, 1, 0, 0, 0, 0, 0, 0]",290,182,108,15,12,0.08241758241758242,0.1111111111111111
"[0, 0, 1, 1, 1, 0, 1, 1, 0, 0, 0, 0, 1, 1, 0]",197,108,89,10,7,0.09259259259259259,0.07865168539325842
"[1, 1, 0, 0, 1, 1, 0, 1, 1, 0, 0, 0, 1, 1, 1]",244,110,134,7,14,0.06363636363636363,0.1044776119402985
"[1, 0, 1, 1, 1, 0, 0, 1, 0, 1, 1, 1, 1, 0, 1]",218,81,137,9,11,0.1111111111111111,0.08029197080291971
"[1, 1, 0, 1, 1, 0, 0, 0, 1, 1, 0, 0, 1, 0, 0]",128,61,67,7,3,0.11475409836065574,0.04477611940298507
"[1, 0, 0, 0, 0, 0, 1, 1, 1, 1, 0, 1, 0, 0, 1]",138,68,70,4,4,0.058823529411764705,0.05714285714285714
"[1, 1, 1, 0, 0, 1, 1, 1, 0, 0, 1, 1, 0, 1, 1]",293,104,189,9,14,0.08653846153846154,0.07407407407407407
"[0, 0, 1, 0, 0, 0, 1, 0, 1, 0, 0, 1, 1, 1, 1]",179,101,78,14,5,0.13861386138613863,0.0641025641025641
"[0, 1, 0, 1, 1, 0, 1, 0, 1, 0, 1, 0, 0, 0, 0]",146,84,62,11,5,0.13095238095238096,0.08064516129032258
"[0, 0, 1, 0, 1, 1, 0, 1, 0, 1, 0, 1, 0, 0, 0]",126,76,50,5,2,0.06578947368421052,0.04
"[0, 0, 1, 0, 1, 0, 1, 0, 0, 1, 1, 0, 0, 0, 0]",403,262,141,24,17,0.0916030534351145,0.12056737588652482
"[1, 1, 1, 0, 1, 0, 0, 1, 0, 0, 0, 0, 1, 1, 0]",143,74,69,4,3,0.05405405405405406,0.043478260869565216
"[1, 1, 1, 0, 1, 0, 0, 0, 1, 0, 0, 1, 1, 1, 0]",106,49,57,3,4,0.061224489795918366,0.07017543859649122
"[0, 1, 0, 0, 0, 1, 0, 0, 1, 0, 1, 0, 1, 1, 1]",135,74,61,13,8,0.17567567567567569,0.13114754098360656
"[0, 0, 1, 1, 0, 0, 0, 1, 1, 1, 0, 0, 1, 1, 1]",219,103,116,9,9,0.08737864077669903,0.07758620689655173
"[1, 0, 1, 1, 0, 0, 0, 1, 0, 0, 1, 0, 1, 0, 1]",86,42,44,6,1,0.14285714285714285,0.022727272727272728
"[1, 1, 0, 1, 1, 1, 1, 0, 0, 1, 0, 1, 1, 0, 0]",177,74,103,13,8,0.17567567567567569,0.07766990291262135
"[1, 0, 1, 1, 1, 1, 0, 1, 0, 1, 1, 0, 1, 0, 1]",214,73,141,12,18,0.1643835616438356,0.1276595744680851
"[1, 0, 0, 0, 0, 1, 1, 1, 0, 0, 0, 0, 1, 1, 0]",290,150,140,14,17,0.09333333333333334,0.12142857142857143
"[1, 1, 1, 0, 0, 1, 1, 1, 0, 1, 0, 0, 1, 0, 1]",144,53,91,4,6,0.07547169811320754,0.06593406593406594
"[0, 0, 1, 1, 0, 0, 1, 0, 1, 0, 1, 1, 1, 1, 1]",264,119,145,13,16,0.1092436974789916,0.1103448275862069
"[1, 1, 0, 1, 1, 0, 1, 1, 0, 1, 0, 0, 1, 0, 0]",118,54,64,4,4,0.07407407407407407,0.0625
"[0, 1, 1, 1, 0, 1, 0, 1, 1, 0, 1, 1, 0, 0, 1]",135,64,71,8,6,0.125,0.08450704225352113
"[1, 1, 0, 1, 0, 1, 1, 1, 0, 1, 0, 1, 1, 0, 1]",215,85,130,6,8,0.07058823529411765,0.06153846153846154
"[0, 1, 0, 0, 0, 0, 0, 0, 1, 0, 0, 0, 1, 0, 1]",527,380,147,43,11,0.11315789473684211,0.07482993197278912
"[1, 1, 1, 1, 1, 0, 1, 0, 0, 1, 1, 1, 0, 0, 0]",188,61,127,6,7,0.09836065573770492,0.05511811023622047
"[0, 1, 0, 0, 0, 0, 0, 1, 0, 1, 1, 1, 1, 1, 1]",171,80,91,11,5,0.1375,0.054945054945054944
"[0, 0, 0, 1, 0, 0, 1, 1, 1, 0, 1, 0, 1, 0, 0]",132,82,50,10,6,0.12195121951219512,0.12
"[0, 1, 1, 0, 1, 0, 0, 0, 1, 0, 0, 1, 1, 1, 1]",174,98,76,8,7,0.08163265306122448,0.09210526315789473
"[1, 1, 1, 0, 1, 1, 0, 0, 1, 1, 1, 0, 1, 0, 0]",168,67,101,8,8,0.11940298507462686,0.07920792079207921
"[1, 1, 0, 1, 0, 0, 1, 1, 1, 1, 0, 1, 0, 1, 1]",278,113,165,8,18,0.07079646017699115,0.10909090909090909
"[0, 1, 1, 1, 1, 0, 1, 1, 1, 0, 1, 0, 0, 0, 1]",143,60,83,4,7,0.06666666666666667,0.08433734939759036
"[1, 0, 0, 0, 1, 0, 1, 0, 1, 0, 1, 0, 0, 1, 1]",127,67,60,4,7,0.05970149253731343,0.11666666666666667
"[1, 0, 0, 0, 1, 1, 1, 1, 1, 1, 0, 0, 0, 1, 1]",268,107,161,8,21,0.07476635514018691,0.13043478260869565
"[1, 1, 1, 0, 0, 0, 1, 1, 0, 1, 1, 1, 0, 1, 1]",264,94,170,10,15,0.10638297872340426,0.08823529411764706
"[1, 1, 1, 0, 1, 1, 0, 0, 0, 1, 0, 0, 1, 1, 1]",184,79,105,5,11,0.06329113924050633,0.10476190476190476
"[0, 1, 1, 0, 0, 1, 0, 1, 1, 1, 1, 1, 0, 1, 0]",152,64,88,4,6,0.0625,0.06818181818181818
"[0, 1, 1, 1, 1, 0, 1, 1, 0, 1, 0, 1, 0, 0, 1]",152,75,77,12,11,0.16,0.14285714285714285
"[1, 1, 1, 1, 0, 1, 0, 1, 0, 1, 0, 0, 1, 1, 0]",164,67,97,7,11,0.1044776119402985,0.1134020618556701
"[1, 0, 1, 0, 1, 0, 1, 0, 1, 1, 1, 0, 1, 0, 1]",119,49,70,8,6,0.16326530612244897,0.08571428571428572
"[0, 1, 0, 1, 0, 1, 0, 1, 0, 1, 1, 1, 0, 1, 0]",102,50,52,4,5,0.08,0.09615384615384616
"[0, 1, 0, 0, 1, 1, 1, 0, 0, 1, 0, 1, 0, 1, 0]",75,39,36,2,9,0.05128205128205128,0.25
"[0, 0, 1, 1, 1, 0, 1, 0, 1, 0, 0, 0, 0, 1, 0]",143,78,65,11,7,0.14102564102564102,0.1076923076923077
"[0, 0, 1, 1, 0, 0, 0, 1, 0, 0, 1, 1, 0, 0, 1]",196,115,81,10,3,0.08695652173913043,0.037037037037037035
"[0, 0, 0, 0, 0, 1, 1, 0, 0, 0, 1, 0, 0, 1, 1]",521,400,121,50,13,0.125,0.10743801652892562
"[1, 1, 0, 1, 0, 1, 0, 0, 1, 0, 1, 1, 0, 1, 1]",134,57,77,3,12,0.05263157894736842,0.15584415584415584
"[0, 0, 1, 1, 1, 0, 0, 0, 1, 1, 1, 0, 0, 0, 1]",166,94,72,8,8,0.0851063829787234,0.1111111111111111
"[0, 0, 1, 1, 0, 0, 0, 1, 0, 0, 1, 0, 1, 1, 0]",183,121,62,9,4,0.0743801652892562,0.06451612903225806
"[0, 0, 0, 0, 1, 1, 0, 0, 0, 1, 0, 0, 1, 0, 1]",331,221,110,15,16,0.06787330316742081,0.14545454545454545
"[1, 0, 1, 0, 0, 1, 0, 1, 1, 0, 0, 0, 0, 1, 0]",151,83,68,8,7,0.0963855421686747,0.10294117647058823
"[1, 0, 0, 0, 0, 1, 0, 1, 0, 0, 0, 1, 0, 1, 1]",166,89,77,7,7,0.07865168539325842,0.09090909090909091
"[0, 0, 1, 0, 0, 0, 1, 0, 1, 0, 0, 1, 1, 0, 1]",121,72,49,8,7,0.1111111111111111,0.14285714285714285
"[0, 1, 1, 0, 1, 0, 0, 0, 1, 0, 1, 1, 1, 0, 1]",94,50,44,7,2,0.14,0.045454545454545456
"[1, 0, 1, 0, 0, 0, 1, 1, 1, 0, 1, 1, 0, 0, 1]",120,64,56,6,4,0.09375,0.07142857142857142
"[1, 1, 1, 0, 0, 0, 0, 0, 0, 1, 0, 1, 1, 0, 0]",221,109,112,8,9,0.07339449541284404,0.08035714285714286
"[0, 0, 1, 1, 1, 0, 0, 0, 0, 0, 0, 1, 0, 1, 1]",214,137,77,14,5,0.10218978102189781,0.06493506493506493
"[1, 1, 0, 0, 0, 0, 0, 1, 0, 1, 0, 0, 0, 1, 1]",225,126,99,9,11,0.07142857142857142,0.1111111111111111
"[1, 1, 0, 0, 1, 0, 0, 0, 1, 1, 1, 0, 0, 0, 0]",192,118,74,8,6,0.06779661016949153,0.08108108108108109
"[1, 0, 1, 0, 1, 0, 1, 0, 0, 1, 1, 1, 0, 1, 0]",98,48,50,4,3,0.08333333333333333,0.06
"[1, 1, 0, 1, 1, 1, 1, 0, 1, 0, 1, 0, 1, 0, 0]",155,67,88,8,4,0.11940298507462686,0.045454545454545456
"[0, 1, 0, 0, 1, 1, 1, 0, 1, 0, 1, 1, 1, 1, 1]",300,105,195,8,13,0.0761904761904762,0.06666666666666667
"[0, 1, 0, 0, 1, 1, 0, 1, 0, 0, 1, 1, 1, 0, 1]",106,56,50,3,7,0.05357142857142857,0.14
"[1, 1, 1, 1, 1, 1, 0, 0, 1, 0, 1, 0, 0, 0, 0]",209,90,119,10,13,0.1111111111111111,0.1092436974789916
"[1, 1, 0, 0, 1, 0, 1, 0, 0, 0, 0, 1, 1, 1, 1]",233,114,119,8,15,0.07017543859649122,0.12605042016806722
"[1, 0, 0, 1, 1, 0, 0, 1, 0, 1, 0, 0, 0, 0, 1]",181,86,95,6,7,0.06976744186046512,0.07368421052631578
"[0, 1, 1, 1, 1, 0, 1, 1, 0, 0, 0, 0, 1, 0, 1]",134,75,59,6,8,0.08,0.13559322033898305
"[1, 1, 0, 0, 0, 0, 0, 0, 0, 1, 1, 1, 0, 1, 0]",200,113,87,10,8,0.08849557522123894,0.09195402298850575
"[1, 1, 0, 0, 0, 0, 0, 1, 1, 0, 1, 0, 0, 1, 0]",150,98,52,3,2,0.030612244897959183,0.038461538461538464
"[1, 1, 1, 0, 1, 0, 0, 1, 1, 0, 0, 0, 0, 0, 1]",140,59,81,2,13,0.03389830508474576,0.16049382716049382
"[0, 1, 0, 0, 0, 1, 0, 1, 1, 1, 0, 0, 1, 0, 1]",114,62,52,4,6,0.06451612903225806,0.11538461538461539
"[1, 0, 1, 1, 1, 1, 1, 0, 1, 1, 0, 0, 0, 0, 0]",201,89,112,9,11,0.10112359550561797,0.09821428571428571
"[0, 0, 1, 0, 1, 1, 1, 0, 0, 0, 1, 1, 1, 0, 1]",127,57,70,4,10,0.07017543859649122,0.14285714285714285
"[0, 1, 0, 0, 1, 1, 1, 1, 0, 1, 1, 0, 0, 0, 1]",119,62,57,3,4,0.04838709677419355,0.07017543859649122
"[1, 1, 1, 1, 0, 0, 0, 0, 0, 0, 1, 0, 1, 1, 0]",203,100,103,7,14,0.07,0.13592233009708737
"[1, 0, 0, 0, 1, 0, 1, 0, 0, 1, 0, 1, 1, 0, 0]",153,93,60,16,8,0.17204301075268819,0.13333333333333333
"[1, 0, 1, 1, 1, 1, 0, 1, 1, 0, 1, 1, 0, 1, 0]",198,69,129,7,12,0.10144927536231885,0.09302325581395349
"[0, 1, 1, 1, 1, 1, 0, 1, 1, 0, 0, 1, 1, 0, 0]",287,116,171,10,11,0.08620689655172414,0.06432748538011696
"[0, 1, 0, 1, 1, 0, 1, 1, 1, 0, 0, 0, 1, 1, 1]",170,75,95,5,10,0.06666666666666667,0.10526315789473684
"[1, 0, 1, 0, 0, 1, 0, 0, 1, 1, 1, 0, 0, 0, 1]",115,63,52,9,8,0.14285714285714285,0.15384615384615385
"[1, 0, 0, 0, 0, 0, 0, 1, 1, 1, 0, 0, 0, 1, 0]",332,190,142,17,15,0.08947368421052632,0.1056338028169014
"[0, 0, 1, 0, 0, 1, 1, 1, 0, 0, 0, 0, 1, 0, 1]",136,77,59,4,3,0.05194805194805195,0.05084745762711865
"[0, 1, 1, 0, 1, 0, 0, 0, 0, 0, 1, 1, 1, 0, 1]",107,62,45,7,4,0.11290322580645161,0.08888888888888889
"[1, 0, 1, 0, 0, 1, 1, 0, 1, 0, 1, 0, 1, 1, 0]",99,46,53,3,5,0.06521739130434782,0.09433962264150944
"[1, 0, 1, 0, 0, 1, 0, 1, 1, 0, 1, 0, 0, 1, 1]",143,58,85,5,6,0.08620689655172414,0.07058823529411765
"[0, 0, 1, 1, 1, 0, 1, 0, 0, 0, 1, 1, 1, 0, 1]",108,51,57,3,6,0.058823529411764705,0.10526315789473684
"[0, 0, 0, 0, 1, 1, 0, 0, 0, 1, 1, 1, 1, 1, 0]",186,98,88,7,11,0.07142857142857142,0.125
"[1, 1, 0, 1, 1, 1, 1, 1, 0, 0, 0, 1, 0, 1, 1]",252,94,158,11,16,0.11702127659574468,0.10126582278481013
"[1, 1, 1, 1, 0, 0, 0, 0, 1, 0, 1, 1, 1, 1, 0]",215,89,126,7,14,0.07865168539325842,0.1111111111111111
"[1, 0, 1, 1, 0, 0, 1, 0, 1, 1, 0, 0, 0, 0, 1]",149,66,83,5,5,0.07575757575757576,0.060240963855421686
"[1, 0, 1, 1, 0, 0, 1, 0, 1, 0, 0, 1, 0, 0, 0]",146,85,61,10,5,0.11764705882352941,0.08196721311475409
"[0, 1, 1, 1, 0, 1, 1, 0, 0, 1, 1, 1, 1, 0, 1]",216,91,125,11,22,0.12087912087912088,0.176
"[1, 1, 0, 0, 1, 1, 1, 0, 1, 1, 0, 0, 1, 1, 1]",410,144,266,16,26,0.1111111111111111,0.09774436090225563
"[1, 0, 1, 1, 1, 1, 1, 0, 0, 0, 1, 0, 1, 1, 1]",277,97,180,7,20,0.07216494845360824,0.1111111111111111
"[0, 1, 1, 0, 0, 0, 1, 1, 1, 0, 1, 0, 0, 0, 0]",160,101,59,11,4,0.10891089108910891,0.06779661016949153
"[1, 1, 1, 1, 1, 0, 0, 1, 1, 1, 0, 0, 1, 0, 0]",229,68,161,5,14,0.07352941176470588,0.08695652173913043
"[1, 0, 0, 0, 1, 1, 1, 1, 1, 1, 0, 1, 1, 0, 1]",236,78,158,7,17,0.08974358974358974,0.10759493670886076
"[1, 0, 0, 1, 1, 1, 0, 0, 1, 0, 1, 1, 1, 1, 0]",161,71,90,10,11,0.14084507042253522,0.12222222222222222
"[0, 1, 1, 1, 1, 1, 0, 0, 1, 1, 1, 0, 0, 1, 0]",152,74,78,10,4,0.13513513513513514,0.05128205128205128
"[1, 0, 1, 1, 0, 1, 0, 1, 1, 0, 1, 0, 0, 0, 0]",119,65,54,7,5,0.1076923076923077,0.09259259259259259
"[0, 0, 0, 1, 0, 1, 1, 0, 1, 0, 1, 1, 0, 1, 0]",100,57,43,1,1,0.017543859649122806,0.023255813953488372
"[1, 0, 0, 1, 1, 0, 0, 1, 1, 0, 1, 1, 0, 0, 0]",171,63,108,4,7,0.06349206349206349,0.06481481481481481
"[0, 0, 1, 0, 1, 1, 0, 0, 1, 1, 0, 1, 0, 0, 1]",124,63,61,6,7,0.09523809523809523,0.11475409836065574
"[1, 1, 1, 0, 0, 0, 1, 1, 0, 1, 0, 0, 0, 0, 1]",111,48,63,2,6,0.041666666666666664,0.09523809523809523
"[0, 0, 1, 0, 0, 1, 1, 0, 0, 1, 0, 1, 1, 1, 1]",136,75,61,8,4,0.10666666666666667,0.06557377049180328
"[0, 1, 1, 1, 1, 0, 0, 0, 0, 0, 1, 1, 1, 0, 0]",197,130,67,15,8,0.11538461538461539,0.11940298507462686
"[1, 1, 1, 1, 0, 1, 1, 1, 1, 0, 0, 0, 0, 0, 1]",228,81,147,10,6,0.12345679012345678,0.04081632653061224
"[0, 1, 1, 1, 1, 0, 0, 0, 0, 0, 0, 1, 1, 0, 1]",382,295,87,20,13,0.06779661016949153,0.14942528735632185
"[0, 0, 0, 1, 0, 1, 0, 1, 1, 1, 1, 0, 1, 0, 1]",98,51,47,4,5,0.0784313725490196,0.10638297872340426
"[0, 1, 0, 0, 0, 1, 0, 1, 0, 1, 1, 1, 1, 0, 1]",116,51,65,5,7,0.09803921568627451,0.1076923076923077
"[0, 1, 0, 0, 1, 1, 1, 1, 1, 0, 0, 0, 0, 0, 1]",157,79,78,6,4,0.0759493670886076,0.05128205128205128
"[0, 0, 0, 0, 0, 1, 0, 1, 0, 0, 1, 1, 1, 1, 1]",277,170,107,15,12,0.08823529411764706,0.11214953271028037
"[1, 0, 0, 1, 1, 1, 0, 1, 1, 1, 0, 1, 1, 1, 0]",239,81,158,8,15,0.09876543209876543,0.0949367088607595
"[0, 1, 1, 1, 1, 0, 0, 0, 1, 1, 1, 0, 1, 0, 1]",169,70,99,4,15,0.05714285714285714,0.15151515151515152
"[1, 1, 0, 1, 0, 0, 1, 1, 1, 0, 1, 0, 0, 0, 0]",137,73,64,6,5,0.0821917808219178,0.078125
"[1, 1, 0, 0, 0, 0, 0, 1, 0, 0, 1, 1, 0, 1, 0]",154,92,62,8,3,0.08695652173913043,0.04838709677419355
"[1, 0, 0, 0, 0, 1, 1, 1, 0, 1, 1, 0, 1, 1, 1]",241,69,172,8,16,0.11594202898550725,0.09302325581395349
"[1, 1, 1, 1, 0, 0, 0, 1, 1, 0, 0, 0, 0, 0, 1]",193,98,95,15,12,0.15306122448979592,0.12631578947368421
"[0, 0, 1, 1, 1, 1, 0, 0, 0, 1, 0, 0, 0, 1, 1]",233,125,108,12,10,0.096,0.09259259259259259
"[1, 1, 0, 1, 0, 1, 0, 1, 1, 0, 1, 0, 1, 0, 0]",100,48,52,2,3,0.041666666666666664,0.057692307692307696
"[1, 1, 0, 0, 0, 1, 1, 0, 1, 0, 1, 0, 1, 1, 1]",166,65,101,5,10,0.07692307692307693,0.09900990099009901
"[0, 0, 1, 1, 1, 0, 0, 1, 0, 1, 1, 0, 1, 1, 1]",169,67,102,7,6,0.1044776119402985,0.058823529411764705
"[1, 0, 0, 1, 0, 1, 0, 0, 1, 0, 0, 1, 0, 0, 1]",128,75,53,12,7,0.16,0.1320754716981132
"[0, 0, 1, 0, 1, 1, 0, 1, 0, 0, 1, 0, 1, 0, 0]",145,86,59,10,5,0.11627906976744186,0.0847457627118644
"[1, 0, 1, 0, 0, 1, 0, 0, 1, 1, 0, 0, 0, 1, 1]",161,80,81,7,11,0.0875,0.13580246913580246
"[0, 0, 0, 0, 1, 1, 0, 0, 1, 1, 1, 1, 1, 0, 1]",376,171,205,15,21,0.08771929824561403,0.1024390243902439
"[1, 1, 0, 0, 0, 0, 1, 1, 1, 0, 1, 0, 0, 1, 1]",218,102,116,9,10,0.08823529411764706,0.08620689655172414
"[0, 1, 0, 1, 1, 0, 0, 1, 0, 0, 0, 0, 0, 1, 0]",234,165,69,14,4,0.08484848484848485,0.057971014492753624
"[0, 1, 0, 0, 1, 1, 0, 0, 1, 1, 1, 1, 0, 1, 1]",204,88,116,6,7,0.06818181818181818,0.0603448275862069
"[1, 0, 1, 0, 0, 1, 1, 0, 0, 1, 1, 1, 1, 0, 1]",200,80,120,5,13,0.0625,0.10833333333333334
"[0, 0, 1, 1, 1, 1, 0, 1, 1, 0, 0, 1, 1, 0, 0]",222,108,114,12,4,0.1111111111111111,0.03508771929824561
"[1, 0, 1, 1, 0, 0, 0, 0, 1, 1, 1, 0, 0, 1, 0]",117,62,55,6,7,0.0967741935483871,0.12727272727272726
"[1, 1, 1, 0, 1, 0, 0, 0, 1, 0, 1, 0, 0, 0, 0]",148,84,64,9,3,0.10714285714285714,0.046875
"[0, 1, 0, 1, 0, 1, 0, 1, 1, 0, 0, 0, 0, 0, 1]",168,103,65,18,6,0.17475728155339806,0.09230769230769231
"[0, 0, 0, 1, 1, 0, 1, 1, 1, 1, 0, 1, 1, 0, 1]",155,73,82,12,8,0.1643835616438356,0.0975609756097561
"[0, 1, 1, 0, 1, 0, 1, 0, 0, 0, 1, 1, 1, 1, 1]",216,100,116,12,11,0.12,0.09482758620689655
"[0, 0, 0, 0, 0, 1, 0, 0, 1, 1, 1, 0, 1, 1, 0]",155,93,62,5,6,0.053763440860215055,0.0967741935483871
"[1, 0, 0, 0, 0, 0, 1, 0, 0, 1, 1, 1, 0, 1, 1]",118,55,63,4,4,0.07272727272727272,0.06349206349206349
"[0, 1, 0, 0, 1, 0, 0, 1, 0, 1, 0, 0, 0, 0, 0]",568,390,178,51,19,0.13076923076923078,0.10674157303370786
"[0, 1, 1, 1, 1, 1, 1, 0, 0, 0, 1, 0, 0, 1, 1]",257,150,107,14,11,0.09333333333333334,0.102803738317757
"[1, 1, 0, 0, 1, 1, 0, 1, 0, 1, 0, 0, 0, 1, 1]",139,67,72,6,14,0.08955223880597014,0.19444444444444445
"[1, 1, 1, 0, 0, 1, 1, 0, 1, 0, 1, 0, 0, 0, 1]",120,48,72,7,8,0.14583333333333334,0.1111111111111111
"[1, 0, 1, 0, 0, 1, 0, 0, 1, 0, 0, 0, 0, 1, 1]",200,119,81,9,10,0.07563025210084033,0.12345679012345678
"[0, 1, 1, 0, 1, 0, 0, 1, 1, 1, 1, 1, 0, 0, 1]",191,73,118,7,13,0.0958904109589041,0.11016949152542373
"[0, 1, 0, 1, 0, 0, 1, 0, 0, 1, 0, 0, 1, 0, 0]",239,161,78,24,7,0.14906832298136646,0.08974358974358974
"[1, 1, 1, 0, 0, 1, 1, 1, 0, 0, 0, 0, 1, 1, 0]",239,102,137,14,9,0.13725490196078433,0.06569343065693431
"[1, 0, 0, 0, 1, 1, 1, 0, 0, 1, 0, 1, 0, 1, 0]",110,66,44,2,1,0.030303030303030304,0.022727272727272728
"[1, 0, 1, 1, 0, 0, 0, 1, 1, 0, 0, 0, 0, 1, 0]",157,84,73,8,8,0.09523809523809523,0.1095890410958904
"[0, 0, 0, 1, 0, 0, 1, 1, 1, 0, 0, 1, 1, 1, 1]",253,136,117,12,13,0.08823529411764706,0.1111111111111111
"[0, 0, 0, 1, 0, 0, 0, 1, 1, 1, 0, 0, 0, 1, 1]",177,117,60,10,2,0.08547008547008547,0.03333333333333333
"[0, 1, 1, 0, 0, 0, 1, 0, 0, 0, 1, 1, 1, 0, 0]",170,105,65,11,10,0.10476190476190476,0.15384615384615385
"[0, 1, 1, 0, 1, 0, 0, 1, 0, 1, 0, 1, 0, 1, 0]",84,44,40,4,5,0.09090909090909091,0.125
"[0, 1, 0, 1, 0, 0, 1, 0, 1, 1, 0, 0, 0, 0, 0]",334,200,134,24,17,0.12,0.12686567164179105
"[0, 0, 1, 1, 0, 1, 1, 0, 0, 0, 1, 1, 1, 1, 0]",177,87,90,6,9,0.06896551724137931,0.1
"[1, 1, 1, 1, 0, 0, 1, 1, 0, 1, 1, 0, 0, 0, 1]",205,77,128,8,19,0.1038961038961039,0.1484375
"[0, 1, 0, 1, 0, 0, 1, 1, 0, 0, 1, 1, 0, 0, 1]",290,156,134,23,17,0.14743589743589744,0.12686567164179105
"[1, 0, 0, 1, 1, 1, 0, 0, 1, 0, 0, 0, 0, 0, 0]",364,210,154,14,12,0.06666666666666667,0.07792207792207792
"[0, 0, 0, 1, 0, 0, 1, 1, 1, 0, 0, 1, 0, 0, 0]",252,168,84,16,9,0.09523809523809523,0.10714285714285714
"[0, 0, 0, 1, 1, 0, 1, 1, 1, 1, 0, 1, 0, 1, 1]",146,86,60,9,5,0.10465116279069768,0.08333333333333333
"[0, 0, 0, 0, 0, 1, 1, 0, 1, 1, 1, 1, 0, 1, 0]",135,82,53,7,2,0.08536585365853659,0.03773584905660377
"[0, 1, 0, 1, 0, 0, 0, 1, 1, 1, 0, 1, 0, 0, 0]",138,80,58,8,4,0.1,0.06896551724137931
"[1, 0, 0, 0, 1, 1, 0, 0, 0, 0, 0, 1, 1, 0, 1]",175,103,72,12,5,0.11650485436893204,0.06944444444444445
"[0, 1, 1, 0, 1, 0, 0, 1, 0, 0, 1, 1, 0, 1, 0]",94,44,50,4,8,0.09090909090909091,0.16
"[0, 1, 0, 1, 1, 0, 1, 1, 0, 1, 1, 0, 1, 0, 0]",101,56,45,7,5,0.125,0.1111111111111111
"[0, 1, 0, 1, 0, 1, 1, 1, 0, 0, 1, 0, 1, 1, 0]",117,57,60,8,7,0.14035087719298245,0.11666666666666667
"[1, 0, 0, 1, 0, 0, 1, 1, 0, 1, 1, 1, 0, 0, 1]",110,55,55,4,3,0.07272727272727272,0.05454545454545454
"[0, 1, 0, 1, 0, 0, 0, 1, 0, 1, 0, 0, 0, 1, 1]",140,86,54,11,3,0.12790697674418605,0.05555555555555555
"[1, 1, 0, 0, 0, 1, 0, 1, 1, 1, 0, 1, 1, 1, 0]",134,46,88,5,8,0.10869565217391304,0.09090909090909091
"[0, 1, 1, 1, 1, 1, 0, 1, 1, 0, 0, 0, 1, 0, 1]",141,74,67,5,6,0.06756756756756757,0.08955223880597014
"[1, 0, 1, 1, 0, 0, 1, 0, 0, 1, 0, 0, 1, 0, 1]",104,45,59,4,7,0.08888888888888889,0.11864406779661017
"[1, 0, 1, 0, 1, 0, 1, 1, 1, 0, 1, 1, 1, 1, 0]",258,105,153,11,10,0.10476190476190476,0.06535947712418301
"[1, 0, 0, 1, 1, 0, 0, 0, 1, 1, 0, 1, 1, 0, 1]",139,52,87,8,6,0.15384615384615385,0.06896551724137931
"[1, 1, 1, 1, 0, 0, 0, 0, 0, 1, 0, 0, 1, 0, 0]",201,114,87,8,5,0.07017543859649122,0.05747126436781609
"[1, 1, 1, 1, 0, 0, 1, 1, 1, 0, 0, 0, 1, 0, 0]",161,71,90,6,6,0.08450704225352113,0.06666666666666667
"[0, 1, 1, 0, 0, 1, 0, 0, 1, 1, 0, 0, 0, 1, 0]",140,80,60,8,6,0.1,0.1
"[0, 1, 1, 1, 1, 1, 0, 1, 0, 1, 0, 1, 0, 1, 1]",251,114,137,12,12,0.10526315789473684,0.08759124087591241
"[1, 0, 0, 1, 1, 1, 1, 1, 0, 1, 0, 1, 0, 1, 0]",146,55,91,8,8,0.14545454545454545,0.08791208791208792
"[1, 1, 1, 0, 0, 0, 0, 0, 1, 1, 1, 0, 1, 1, 1]",269,98,171,15,14,0.15306122448979592,0.08187134502923976
"[1, 0, 1, 1, 1, 1, 1, 1, 0, 1, 1, 1, 0, 0, 0]",333,108,225,4,25,0.037037037037037035,0.1111111111111111
"[0, 1, 1, 0, 1, 1, 0, 0, 1, 0, 0, 1, 1, 1, 0]",117,60,57,5,8,0.08333333333333333,0.14035087719298245
"[0, 1, 0, 0, 1, 1, 0, 1, 1, 1, 0, 1, 0, 0, 1]",116,46,70,3,7,0.06521739130434782,0.1
"[0, 1, 1, 0, 1, 0, 1, 1, 0, 1, 1, 0, 0, 1, 1]",207,83,124,6,17,0.07228915662650602,0.13709677419354838
"[1, 1, 0, 1, 0, 1, 0, 1, 0, 1, 0, 0, 0, 0, 1]",128,71,57,8,9,0.11267605633802817,0.15789473684210525
"[0, 1, 1, 0, 0, 1, 1, 0, 1, 0, 1, 0, 1, 1, 0]",162,87,75,11,7,0.12643678160919541,0.09333333333333334
"[0, 1, 1, 1, 0, 0, 0, 1, 0, 1, 1, 0, 0, 1, 1]",156,72,84,8,6,0.1111111111111111,0.07142857142857142
"[0, 1, 1, 0, 1, 0, 0, 1, 0, 0, 1, 1, 1, 0, 1]",104,48,56,3,2,0.0625,0.03571428571428571
"[0, 1, 0, 0, 1, 1, 1, 1, 0, 0, 1, 1, 1, 0, 0]",149,75,74,11,8,0.14666666666666667,0.10810810810810811
"[1, 1, 0, 0, 1, 1, 0, 0, 0, 1, 0, 1, 1, 1, 0]",165,87,78,5,11,0.05747126436781609,0.14102564102564102
"[1, 1, 0, 0, 0, 0, 0, 1, 0, 0, 0, 1, 0, 1, 0]",267,168,99,13,8,0.07738095238095238,0.08080808080808081
"[1, 1, 1, 0, 0, 0, 0, 0, 1, 0, 0, 0, 1, 0, 1]",191,84,107,8,6,0.09523809523809523,0.056074766355140186
"[1, 1, 0, 1, 0, 1, 0, 0, 1, 0, 0, 1, 0, 0, 0]",138,88,50,5,6,0.056818181818181816,0.12
"[0, 1, 1, 1, 1, 0, 0, 1, 0, 1, 0, 0, 1, 1, 1]",241,136,105,9,9,0.0661764705882353,0.08571428571428572
"[0, 0, 0, 1, 1, 0, 1, 1, 0, 1, 1, 0, 0, 1, 1]",180,94,86,5,7,0.05319148936170213,0.08139534883720931
"[0, 0, 0, 0, 1, 1, 0, 1, 1, 0, 1, 1, 0, 0, 1]",149,77,72,9,3,0.11688311688311688,0.041666666666666664
"[1, 1, 1, 0, 1, 1, 1, 0, 0, 0, 0, 1, 1, 0, 1]",177,65,112,10,8,0.15384615384615385,0.07142857142857142
"[0, 0, 1, 0, 1, 0, 0, 0, 1, 1, 0, 1, 1, 1, 1]",135,70,65,5,8,0.07142857142857142,0.12307692307692308
"[1, 0, 0, 1, 1, 0, 0, 1, 1, 0, 1, 1, 0, 1, 0]",128,57,71,5,11,0.08771929824561403,0.15492957746478872
"[1, 0, 1, 0, 0, 1, 1, 0, 0, 1, 1, 0, 1, 1, 0]",116,50,66,3,4,0.06,0.06060606060606061
"[1, 1, 0, 1, 0, 1, 1, 1, 1, 0, 0, 0, 0, 1, 1]",396,162,234,14,17,0.08641975308641975,0.07264957264957266
"[0, 1, 1, 1, 0, 0, 1, 0, 0, 0, 0, 1, 0, 1, 0]",139,81,58,7,5,0.08641975308641975,0.08620689655172414
"[1, 1, 0, 0, 1, 1, 0, 1, 0, 0, 0, 0, 1, 1, 0]",183,96,87,7,5,0.07291666666666667,0.05747126436781609
"[0, 1, 1, 0, 0, 1, 1, 0, 0, 1, 1, 0, 1, 0, 0]",238,165,73,17,5,0.10303030303030303,0.0684931506849315
"[1, 1, 1, 0, 0, 1, 1, 0, 1, 0, 0, 0, 1, 0, 1]",114,35,79,6,4,0.17142857142857143,0.05063291139240506
"[1, 0, 0, 0, 1, 0, 1, 1, 0, 1, 1, 1, 1, 0, 0]",159,70,89,5,6,0.07142857142857142,0.06741573033707865
"[0, 0, 1, 1, 0, 1, 0, 1, 1, 0, 1, 1, 0, 0, 0]",152,86,66,6,7,0.06976744186046512,0.10606060606060606
"[0, 0, 0, 1, 1, 0, 1, 0, 1, 1, 1, 1, 1, 0, 1]",168,78,90,9,8,0.11538461538461539,0.08888888888888889
"[1, 0, 0, 0, 0, 0, 0, 1, 1, 0, 1, 0, 1, 0, 0]",308,179,129,17,16,0.09497206703910614,0.12403100775193798
"[0, 0, 0, 1, 1, 1, 1, 0, 1, 1, 0, 0, 0, 1, 0]",122,70,52,7,9,0.1,0.17307692307692307
"[0, 1, 0, 1, 0, 0, 1, 0, 0, 0, 0, 0, 1, 0, 0]",531,375,156,33,19,0.088,0.12179487179487179
"[1, 0, 0, 1, 0, 1, 0, 0, 0, 1, 0, 0, 0, 1, 0]",183,111,72,13,4,0.11711711711711711,0.05555555555555555
"[0, 0, 1, 1, 0, 1, 1, 0, 1, 1, 0, 1, 1, 1, 0]",152,65,87,7,7,0.1076923076923077,0.08045977011494253
"[1, 1, 0, 1, 0, 1, 1, 1, 0, 0, 1, 1, 0, 0, 0]",222,93,129,5,13,0.053763440860215055,0.10077519379844961
"[1, 0, 1, 0, 0, 0, 1, 1, 1, 0, 1, 1, 0, 0, 0]",122,65,57,6,7,0.09230769230769231,0.12280701754385964
"[1, 0, 0, 1, 1, 0, 0, 1, 0, 0, 0, 1, 1, 0, 0]",210,117,93,12,10,0.10256410256410256,0.10752688172043011
"[1, 1, 0, 0, 1, 0, 1, 0, 1, 1, 0, 0, 1, 1, 0]",159,68,91,3,5,0.04411764705882353,0.054945054945054944
"[0, 1, 1, 0, 1, 0, 1, 0, 1, 1, 0, 1, 1, 1, 1]",249,104,145,10,14,0.09615384615384616,0.09655172413793103
"[1, 1, 0, 1, 1, 1, 1, 0, 0, 1, 1, 0, 1, 0, 1]",232,72,160,10,13,0.1388888888888889,0.08125
"[1, 0, 0, 1, 1, 1, 1, 0, 1, 0, 1, 1, 0, 1, 0]",157,48,109,5,5,0.10416666666666667,0.045871559633027525
"[1, 0, 1, 1, 1, 0, 0, 0, 1, 1, 1, 0, 0, 1, 1]",210,82,128,7,12,0.08536585365853659,0.09375
"[1, 0, 1, 0, 1, 1, 1, 0, 0, 0, 1, 1, 1, 0, 0]",130,53,77,2,5,0.03773584905660377,0.06493506493506493
"[0, 1, 1, 0, 1, 0, 0, 1, 0, 0, 0, 1, 1, 0, 1]",124,63,61,8,5,0.12698412698412698,0.08196721311475409
"[1, 1, 1, 0, 0, 0, 1, 1, 0, 0, 0, 0, 0, 0, 1]",331,140,191,13,21,0.09285714285714286,0.1099476439790576
"[1, 0, 0, 0, 0, 1, 1, 0, 1, 1, 1, 1, 0, 1, 0]",130,48,82,3,6,0.0625,0.07317073170731707
"[1, 1, 1, 1, 1, 0, 1, 1, 0, 0, 0, 0, 0, 0, 0]",307,140,167,14,14,0.1,0.08383233532934131
"[1, 0, 1, 1, 0, 0, 1, 0, 1, 0, 1, 1, 0, 0, 0]",100,45,55,5,5,0.1111111111111111,0.09090909090909091
"[0, 1, 0, 1, 0, 0, 0, 0, 1, 1, 0, 1, 0, 0, 0]",224,129,95,9,13,0.06976744186046512,0.1368421052631579
"[0, 1, 1, 1, 1, 0, 1, 1, 1, 0, 0, 0, 1, 1, 1]",346,151,195,15,23,0.09933774834437085,0.11794871794871795
"[1, 1, 1, 0, 0, 1, 1, 1, 1, 0, 1, 1, 1, 0, 0]",372,100,272,9,22,0.09,0.08088235294117647
"[0, 1, 1, 0, 1, 0, 0, 1, 1, 1, 1, 1, 1, 0, 0]",327,153,174,19,9,0.12418300653594772,0.05172413793103448
"[1, 0, 1, 0, 1, 0, 0, 0, 1, 0, 1, 1, 1, 0, 0]",120,66,54,5,9,0.07575757575757576,0.16666666666666666
"[1, 1, 1, 0, 1, 0, 1, 0, 0, 1, 1, 1, 0, 1, 1]",246,85,161,7,6,0.08235294117647059,0.037267080745341616
"[0, 1, 1, 0, 1, 1, 1, 0, 1, 0, 1, 0, 0, 1, 1]",162,65,97,7,11,0.1076923076923077,0.1134020618556701
"[0, 0, 0, 0, 0, 1, 1, 0, 1, 0, 0, 0, 1, 1, 0]",334,243,91,25,10,0.102880658436214,0.10989010989010989
"[0, 1, 0, 1, 0, 1, 0, 1, 0, 0, 1, 0, 1, 1, 1]",134,53,81,6,10,0.11320754716981132,0.12345679012345678
"[1, 0, 0, 0, 1, 1, 0, 0, 0, 1, 0, 0, 1, 0, 1]",187,116,71,8,4,0.06896551724137931,0.056338028169014086
"[0, 0, 0, 1, 0, 1, 0, 1, 0, 1, 0, 0, 1, 1, 0]",150,85,65,6,7,0.07058823529411765,0.1076923076923077
"[0, 0, 0, 0, 1, 0, 1, 0, 1, 1, 1, 1, 1, 1, 0]",174,90,84,7,10,0.07777777777777778,0.11904761904761904
"[1, 0, 0, 1, 0, 1, 1, 1, 0, 1, 1, 1, 0, 1, 0]",129,44,85,7,7,0.1590909090909091,0.08235294117647059
"[1, 1, 0, 1, 1, 1, 1, 0, 0, 0, 0, 1, 1, 0, 1]",176,76,100,9,6,0.11842105263157894,0.06
"[0, 1, 1, 0, 1, 1, 1, 1, 0, 0, 0, 0, 1, 1, 0]",273,131,142,13,18,0.09923664122137404,0.1267605633802817
"[1, 1, 0, 0, 1, 0, 0, 1, 1, 1, 0, 0, 0, 0, 1]",176,84,92,2,11,0.023809523809523808,0.11956521739130435
"[0, 1, 0, 0, 0, 0, 1, 0, 1, 0, 1, 1, 1, 1, 0]",126,69,57,6,5,0.08695652173913043,0.08771929824561403
"[0, 1, 0, 0, 0, 1, 0, 1, 0, 0, 1, 0, 0, 0, 1]",231,148,83,15,10,0.10135135135135136,0.12048192771084337
"[0, 1, 0, 0, 1, 1, 1, 0, 1, 1, 0, 0, 1, 1, 1]",204,92,112,7,14,0.07608695652173914,0.125
"[1, 1, 0, 0, 1, 1, 1, 1, 0, 1, 0, 0, 0, 0, 0]",209,103,106,15,6,0.14563106796116504,0.05660377358490566
"[1, 1, 0, 1, 1, 0, 0, 1, 0, 0, 0, 0, 1, 1, 1]",195,88,107,8,13,0.09090909090909091,0.12149532710280374
"[1, 1, 1, 1, 0, 1, 1, 0, 0, 1, 0, 0, 0, 0, 1]",127,59,68,11,7,0.1864406779661017,0.10294117647058823
"[0, 1, 0, 1, 1, 0, 0, 1, 0, 0, 0, 1, 0, 0, 0]",237,153,84,26,9,0.16993464052287582,0.10714285714285714
"[1, 0, 0, 1, 1, 0, 1, 1, 0, 0, 0, 1, 1, 0, 1]",114,43,71,4,8,0.09302325581395349,0.11267605633802817
"[1, 0, 1, 1, 0, 1, 0, 1, 1, 1, 0, 0, 1, 0, 0]",104,46,58,2,9,0.043478260869565216,0.15517241379310345
"[1, 1, 1, 1, 1, 0, 0, 1, 0, 0, 1, 0, 0, 0, 1]",138,57,81,4,8,0.07017543859649122,0.09876543209876543
"[0, 1, 1, 0, 1, 1, 1, 0, 0, 1, 1, 0, 0, 0, 0]",247,125,122,13,7,0.104,0.05737704918032787
"[1, 1, 0, 0, 0, 1, 0, 0, 1, 1, 0, 1, 1, 0, 0]",128,73,55,7,10,0.0958904109589041,0.18181818181818182
"[0, 1, 0, 0, 0, 1, 1, 0, 0, 0, 1, 0, 1, 0, 0]",218,146,72,13,5,0.08904109589041095,0.06944444444444445
"[0, 1, 1, 0, 0, 0, 1, 1, 1, 1, 1, 0, 1, 1, 0]",157,60,97,7,7,0.11666666666666667,0.07216494845360824
"[1, 0, 1, 0, 1, 1, 0, 0, 0, 1, 1, 1, 1, 1, 0]",169,70,99,3,11,0.04285714285714286,0.1111111111111111
"[0, 0, 0, 0, 0, 1, 1, 1, 1, 0, 1, 0, 1, 1, 1]",323,216,107,18,11,0.08333333333333333,0.102803738317757
"[0, 1, 0, 1, 1, 1, 0, 0, 0, 1, 1, 0, 1, 0, 0]",94,52,42,3,3,0.057692307692307696,0.07142857142857142
"[1, 0, 1, 1, 1, 1, 1, 1, 0, 0, 1, 0, 1, 0, 0]",165,64,101,5,15,0.078125,0.1485148514851485
"[1, 1, 0, 1, 1, 0, 0, 1, 1, 1, 1, 1, 0, 1, 0]",245,94,151,4,12,0.0425531914893617,0.07947019867549669
"[0, 0, 0, 1, 0, 1, 1, 1, 1, 1, 1, 0, 0, 0, 0]",308,172,136,16,13,0.09302325581395349,0.09558823529411764
"[1, 0, 1, 0, 1, 0, 1, 1, 0, 0, 0, 0, 1, 0, 0]",147,82,65,10,7,0.12195121951219512,0.1076923076923077
"[1, 0, 0, 1, 0, 1, 0, 0, 1, 1, 0, 1, 1, 0, 1]",108,55,53,4,3,0.07272727272727272,0.05660377358490566
"[1, 0, 0, 1, 1, 1, 1, 1, 1, 0, 0, 0, 1, 0, 1]",284,77,207,11,19,0.14285714285714285,0.09178743961352658
"[1, 1, 1, 1, 0, 1, 1, 0, 1, 0, 0, 0, 0, 1, 1]",247,95,152,8,11,0.08421052631578947,0.07236842105263158
"[1, 1, 0, 1, 1, 0, 0, 0, 1, 1, 1, 1, 1, 0, 0]",196,80,116,12,12,0.15,0.10344827586206896
"[0, 1, 1, 1, 1, 0, 1, 0, 1, 1, 1, 0, 1, 0, 0]",148,62,86,4,9,0.06451612903225806,0.10465116279069768
"[0, 1, 1, 0, 1, 1, 1, 0, 1, 1, 0, 0, 0, 0, 1]",171,74,97,6,10,0.08108108108108109,0.10309278350515463
"[1, 0, 0, 1, 1, 0, 0, 0, 1, 0, 1, 0, 0, 0, 0]",324,182,142,15,19,0.08241758241758242,0.13380281690140844
"[0, 1, 0, 0, 1, 1, 1, 1, 1, 0, 0, 0, 1, 0, 1]",112,49,63,4,5,0.08163265306122448,0.07936507936507936
"[1, 0, 1, 1, 1, 0, 0, 1, 0, 0, 1, 0, 0, 1, 0]",95,43,52,3,5,0.06976744186046512,0.09615384615384616
"[0, 1, 0, 1, 1, 1, 0, 1, 1, 1, 1, 0, 0, 0, 1]",147,53,94,7,10,0.1320754716981132,0.10638297872340426
"[0, 0, 0, 1, 1, 0, 1, 1, 0, 1, 0, 0, 1, 0, 1]",108,61,47,4,5,0.06557377049180328,0.10638297872340426
"[0, 1, 0, 0, 0, 1, 0, 0, 1, 1, 1, 1, 0, 1, 0]",115,64,51,6,3,0.09375,0.058823529411764705
"[1, 0, 1, 1, 1, 1, 1, 0, 0, 1, 0, 0, 1, 1, 0]",152,55,97,5,13,0.09090909090909091,0.13402061855670103
"[1, 1, 1, 0, 0, 0, 0, 0, 0, 1, 1, 1, 1, 0, 1]",445,98,347,6,38,0.061224489795918366,0.10951008645533142
"[1, 1, 0, 0, 1, 1, 0, 1, 0, 0, 1, 1, 1, 0, 1]",135,64,71,6,9,0.09375,0.1267605633802817
"[0, 0, 0, 1, 0, 1, 1, 1, 0, 1, 0, 1, 1, 1, 1]",162,67,95,12,8,0.1791044776119403,0.08421052631578947
"[1, 1, 0, 0, 1, 1, 0, 0, 0, 1, 0, 0, 1, 0, 0]",187,111,76,14,6,0.12612612612612611,0.07894736842105263
"[1, 0, 0, 0, 0, 0, 0, 0, 1, 0, 1, 1, 1, 1, 0]",220,127,93,8,8,0.06299212598425197,0.08602150537634409
"[0, 1, 1, 0, 1, 0, 0, 0, 0, 0, 1, 1, 0, 1, 0]",160,101,59,9,3,0.0891089108910891,0.05084745762711865
"[0, 1, 0, 1, 0, 0, 0, 0, 1, 1, 0, 1, 0, 1, 1]",127,56,71,5,8,0.08928571428571429,0.11267605633802817
"[0, 0, 1, 0, 1, 1, 0, 0, 0, 0, 0, 1, 0, 1, 1]",178,108,70,10,4,0.09259259259259259,0.05714285714285714
"[0, 1, 0, 1, 0, 1, 1, 1, 0, 1, 0, 0, 0, 0, 0]",167,96,71,13,7,0.13541666666666666,0.09859154929577464
"[1, 0, 0, 1, 0, 0, 0, 0, 0, 0, 1, 0, 0, 1, 0]",512,342,170,23,18,0.06725146198830409,0.10588235294117647
"[1, 0, 0, 1, 1, 1, 0, 0, 0, 0, 1, 0, 0, 1, 0]",134,66,68,7,3,0.10606060606060606,0.04411764705882353
"[1, 0, 1, 0, 0, 0, 0, 1, 1, 0, 1, 1, 1, 0, 0]",123,63,60,5,5,0.07936507936507936,0.08333333333333333
"[1, 1, 1, 1, 0, 0, 0, 0, 0, 1, 0, 1, 0, 0, 0]",251,144,107,17,13,0.11805555555555555,0.12149532710280374
"[0, 1, 0, 0, 1, 1, 0, 1, 0, 0, 1, 0, 0, 0, 0]",248,157,91,12,8,0.07643312101910828,0.08791208791208792
"[0, 1, 1, 0, 0, 0, 1, 0, 0, 1, 1, 1, 0, 1, 1]",139,80,59,11,4,0.1375,0.06779661016949153
"[0, 1, 1, 0, 0, 1, 1, 1, 0, 0, 0, 1, 0, 1, 0]",126,71,55,4,7,0.056338028169014086,0.12727272727272726
"[1, 0, 0, 1, 1, 1, 0, 0, 0, 1, 1, 0, 0, 1, 0]",113,58,55,9,8,0.15517241379310345,0.14545454545454545
"[1, 0, 0, 0, 0, 1, 1, 0, 0, 1, 0, 1, 0, 1, 0]",181,85,96,7,7,0.08235294117647059,0.07291666666666667
"[0, 1, 1, 1, 1, 0, 0, 0, 1, 1, 0, 1, 1, 0, 1]",147,70,77,3,8,0.04285714285714286,0.1038961038961039
"[0, 0, 1, 0, 1, 0, 1, 1, 0, 1, 1, 1, 1, 1, 1]",298,118,180,10,20,0.0847457627118644,0.1111111111111111
"[0, 1, 1, 0, 1, 0, 0, 0, 0, 1, 0, 0, 1, 0, 0]",219,144,75,19,7,0.13194444444444445,0.09333333333333334
"[1, 0, 0, 1, 1, 0, 1, 1, 0, 1, 0, 0, 0, 0, 1]",121,70,51,14,7,0.2,0.13725490196078433
"[1, 0, 1, 1, 0, 1, 1, 1, 1, 0, 0, 1, 0, 1, 0]",147,78,69,9,8,0.11538461538461539,0.11594202898550725
"[1, 1, 0, 0, 0, 1, 0, 0, 1, 1, 0, 0, 1, 1, 1]",238,115,123,8,8,0.06956521739130435,0.06504065040650407
"[1, 1, 1, 1, 0, 0, 0, 1, 1, 0, 0, 1, 1, 1, 0]",204,82,122,4,13,0.04878048780487805,0.10655737704918032
"[0, 0, 0, 1, 0, 0, 0, 1, 1, 1, 0, 0, 1, 0, 1]",140,78,62,13,4,0.16666666666666666,0.06451612903225806
"[1, 0, 0, 1, 1, 0, 1, 1, 0, 1, 0, 0, 1, 1, 0]",146,69,77,5,11,0.07246376811594203,0.14285714285714285
"[1, 0, 1, 1, 0, 0, 0, 1, 0, 0, 0, 0, 1, 1, 0]",191,132,59,17,4,0.12878787878787878,0.06779661016949153
"[0, 1, 0, 1, 0, 1, 1, 0, 0, 1, 0, 1, 1, 0, 0]",124,83,41,11,7,0.13253012048192772,0.17073170731707318
"[0, 1, 1, 1, 0, 0, 1, 0, 0, 0, 1, 1, 1, 0, 0]",117,68,49,10,6,0.14705882352941177,0.12244897959183673
"[1, 1, 1, 1, 0, 0, 0, 1, 1, 1, 0, 1, 0, 1, 0]",145,57,88,8,8,0.14035087719298245,0.09090909090909091
"[0, 1, 0, 1, 1, 1, 0, 0, 0, 1, 1, 1, 1, 1, 1]",397,150,247,19,24,0.12666666666666668,0.09716599190283401
"[1, 0, 1, 1, 0, 1, 0, 0, 1, 1, 0, 1, 1, 0, 1]",137,41,96,4,14,0.0975609756097561,0.14583333333333334
"[0, 1, 1, 1, 0, 1, 1, 0, 1, 0, 0, 1, 0, 0, 1]",136,60,76,7,6,0.11666666666666667,0.07894736842105263
"[1, 0, 1, 1, 0, 1, 0, 0, 0, 1, 0, 1, 0, 0, 0]",153,88,65,6,8,0.06818181818181818,0.12307692307692308
"[1, 0, 0, 0, 0, 1, 1, 1, 0, 0, 1, 0, 1, 0, 0]",120,68,52,7,3,0.10294117647058823,0.057692307692307696
"[0, 1, 0, 1, 0, 1, 0, 0, 0, 1, 1, 1, 1, 0, 0]",180,88,92,7,6,0.07954545454545454,0.06521739130434782
"[0, 1, 1, 0, 1, 0, 0, 0, 0, 0, 1, 0, 1, 1, 0]",153,98,55,9,2,0.09183673469387756,0.03636363636363636
"[0, 0, 0, 0, 0, 1, 0, 1, 1, 0, 1, 1, 0, 1, 0]",131,79,52,7,4,0.08860759493670886,0.07692307692307693
"[1, 1, 1, 0, 0, 0, 1, 1, 0, 0, 1, 0, 1, 1, 0]",126,50,76,7,5,0.14,0.06578947368421052
"[1, 0, 0, 1, 1, 1, 1, 0, 0, 0, 1, 1, 1, 1, 0]",250,76,174,7,22,0.09210526315789473,0.12643678160919541
"[1, 1, 0, 1, 0, 1, 0, 0, 1, 0, 1, 1, 1, 0, 1]",133,45,88,6,8,0.13333333333333333,0.09090909090909091
"[0, 1, 0, 0, 1, 0, 0, 1, 1, 1, 0, 0, 1, 1, 1]",145,68,77,10,6,0.14705882352941177,0.07792207792207792
"[0, 1, 1, 1, 0, 1, 0, 1, 0, 1, 0, 1, 0, 0, 1]",124,54,70,5,10,0.09259259259259259,0.14285714285714285
"[1, 1, 1, 1, 1, 0, 0, 0, 1, 1, 1, 0, 0, 1, 0]",166,67,99,4,8,0.05970149253731343,0.08080808080808081
"[0, 1, 1, 0, 1, 0, 0, 0, 0, 0, 1, 0, 1, 1, 1]",161,105,56,15,3,0.14285714285714285,0.05357142857142857
"[1, 1, 0, 1, 1, 1, 0, 0, 1, 1, 0, 1, 1, 0, 0]",156,66,90,11,11,0.16666666666666666,0.12222222222222222
"[1, 0, 0, 1, 0, 0, 0, 1, 1, 1, 0, 1, 0, 1, 0]",108,55,53,6,5,0.10909090909090909,0.09433962264150944
"[1, 1, 0, 0, 1, 0, 1, 0, 0, 0, 1, 1, 0, 0, 1]",148,79,69,3,8,0.0379746835443038,0.11594202898550725
"[0, 1, 1, 1, 0, 0, 0, 1, 1, 1, 0, 1, 1, 0, 1]",127,50,77,3,11,0.06,0.14285714285714285
"[1, 0, 0, 0, 1, 0, 1, 0, 1, 0, 0, 1, 1, 0, 0]",179,86,93,10,13,0.11627906976744186,0.13978494623655913
"[1, 1, 1, 1, 1, 0, 0, 0, 1, 0, 1, 0, 1, 0, 0]",133,53,80,2,9,0.03773584905660377,0.1125
"[0, 1, 1, 0, 1, 0, 1, 0, 1, 0, 0, 1, 0, 1, 1]",112,51,61,5,6,0.09803921568627451,0.09836065573770492
"[0, 1, 0, 1, 0, 1, 1, 0, 1, 1, 1, 1, 0, 0, 0]",161,82,79,4,6,0.04878048780487805,0.0759493670886076
"[1, 0, 0, 1, 0, 0, 1, 1, 0, 0, 1, 1, 1, 0, 0]",137,71,66,3,4,0.04225352112676056,0.06060606060606061
"[0, 0, 0, 1, 1, 0, 1, 0, 0, 1, 0, 1, 0, 0, 0]",258,174,84,22,7,0.12643678160919541,0.08333333333333333
"[0, 1, 0, 1, 1, 1, 0, 0, 1, 0, 0, 1, 0, 0, 1]",96,41,55,5,7,0.12195121951219512,0.12727272727272726
"[0, 0, 0, 1, 0, 0, 1, 0, 0, 1, 1, 0, 1, 1, 0]",158,98,60,8,4,0.08163265306122448,0.06666666666666667
"[1, 1, 0, 1, 1, 0, 0, 0, 0, 1, 0, 0, 1, 0, 1]",98,53,45,8,6,0.1509433962264151,0.13333333333333333
"[0, 0, 0, 1, 0, 1, 1, 0, 1, 1, 0, 0, 0, 0, 1]",191,110,81,11,2,0.1,0.024691358024691357
"[1, 0, 0, 1, 1, 1, 0, 0, 0, 0, 1, 1, 1, 0, 1]",135,61,74,8,8,0.13114754098360656,0.10810810810810811
"[1, 1, 1, 1, 1, 0, 0, 1, 1, 1, 0, 0, 0, 0, 1]",279,89,190,11,14,0.12359550561797752,0.07368421052631578
"[0, 1, 1, 1, 0, 0, 1, 0, 1, 1, 0, 0, 1, 1, 1]",210,99,111,14,5,0.1414141414141414,0.04504504504504504
"[0, 1, 0, 1, 0, 1, 1, 1, 1, 0, 0, 1, 0, 0, 0]",121,68,53,8,6,0.11764705882352941,0.11320754716981132
"[0, 0, 1, 0, 1, 0, 1, 1, 0, 1, 0, 1, 1, 0, 1]",90,51,39,5,2,0.09803921568627451,0.05128205128205128
"[0, 0, 1, 1, 0, 0, 1, 1, 1, 0, 1, 0, 0, 0, 0]",215,123,92,11,8,0.08943089430894309,0.08695652173913043
"[0, 1, 0, 1, 1, 1, 1, 0, 0, 1, 1, 0, 1, 0, 1]",145,70,75,6,6,0.08571428571428572,0.08
"[0, 1, 0, 1, 0, 0, 1, 0, 1, 0, 1, 1, 1, 1, 1]",148,66,82,8,5,0.12121212121212122,0.06097560975609756
"[0, 0, 1, 0, 0, 0, 1, 0, 0, 1, 0, 1, 1, 1, 0]",116,65,51,9,4,0.13846153846153847,0.0784313725490196
"[1, 1, 1, 1, 1, 0, 1, 1, 0, 0, 1, 0, 0, 0, 1]",153,60,93,5,8,0.08333333333333333,0.08602150537634409
"[1, 1, 0, 0, 0, 1, 1, 0, 0, 1, 0, 1, 1, 0, 1]",114,47,67,3,7,0.06382978723404255,0.1044776119402985
"[1, 1, 0, 1, 0, 0, 0, 1, 1, 0, 1, 0, 0, 0, 1]",99,50,49,6,7,0.12,0.14285714285714285
"[0, 1, 0, 0, 0, 1, 1, 0, 0, 0, 1, 1, 0, 1, 1]",127,67,60,7,2,0.1044776119402985,0.03333333333333333
"[1, 0, 1, 1, 1, 1, 0, 0, 0, 0, 1, 1, 0, 0, 0]",402,195,207,15,18,0.07692307692307693,0.08695652173913043
"[1, 1, 1, 0, 1, 0, 0, 1, 0, 0, 0, 0, 1, 1, 1]",184,86,98,10,8,0.11627906976744186,0.08163265306122448
"[1, 1, 0, 0, 0, 0, 1, 0, 1, 1, 1, 1, 0, 1, 0]",105,56,49,9,3,0.16071428571428573,0.061224489795918366
"[0, 1, 0, 1, 0, 1, 0, 0, 0, 1, 0, 1, 1, 0, 0]",176,100,76,12,6,0.12,0.07894736842105263
"[1, 0, 1, 0, 0, 0, 0, 1, 1, 0, 0, 0, 1, 0, 0]",280,173,107,16,7,0.09248554913294797,0.06542056074766354
"[1, 1, 1, 0, 1, 0, 0, 0, 1, 0, 0, 0, 1, 1, 0]",114,54,60,3,9,0.05555555555555555,0.15
"[0, 0, 1, 0, 1, 0, 1, 1, 0, 0, 0, 1, 1, 1, 0]",112,55,57,2,3,0.03636363636363636,0.05263157894736842
"[1, 1, 1, 1, 0, 0, 1, 1, 0, 1, 0, 1, 1, 0, 0]",212,93,119,10,10,0.10752688172043011,0.08403361344537816
"[1, 0, 0, 0, 1, 1, 1, 0, 1, 0, 0, 0, 1, 1, 0]",123,58,65,7,8,0.1206896551724138,0.12307692307692308
"[0, 0, 0, 1, 1, 1, 0, 1, 0, 1, 0, 0, 1, 1, 0]",130,66,64,8,4,0.12121212121212122,0.0625
"[0, 1, 0, 0, 0, 1, 1, 1, 0, 1, 0, 1, 0, 0, 1]",104,53,51,7,4,0.1320754716981132,0.0784313725490196
"[1, 0, 1, 0, 0, 1, 1, 1, 0, 0, 1, 1, 0, 0, 1]",185,84,101,6,11,0.07142857142857142,0.10891089108910891
"[0, 1, 1, 1, 1, 0, 1, 0, 0, 1, 1, 1, 0, 0, 1]",145,65,80,4,8,0.06153846153846154,0.1
"[1, 0, 0, 0, 1, 0, 0, 0, 0, 0, 0, 1, 0, 1, 1]",284,180,104,17,15,0.09444444444444444,0.14423076923076922
"[1, 1, 1, 1, 0, 1, 1, 0, 0, 0, 1, 1, 0, 0, 0]",195,91,104,11,6,0.12087912087912088,0.057692307692307696
"[0, 1, 0, 1, 1, 0, 1, 1, 0, 0, 1, 0, 1, 1, 1]",150,69,81,8,7,0.11594202898550725,0.08641975308641975
"[1, 1, 1, 0, 1, 1, 1, 1, 1, 1, 0, 0, 0, 1, 0]",250,84,166,7,19,0.08333333333333333,0.1144578313253012
"[1, 1, 1, 1, 1, 0, 1, 1, 0, 1, 0, 1, 0, 0, 0]",167,45,122,6,10,0.13333333333333333,0.08196721311475409
"[0, 1, 1, 1, 0, 0, 0, 1, 1, 1, 1, 0, 0, 1, 0]",112,54,58,3,4,0.05555555555555555,0.06896551724137931
"[0, 0, 1, 1, 0, 0, 1, 1, 0, 1, 1, 1, 1, 0, 0]",207,88,119,13,13,0.14772727272727273,0.1092436974789916
"[0, 1, 0, 1, 1, 1, 1, 0, 1, 0, 0, 0, 1, 0, 1]",105,45,60,6,4,0.13333333333333333,0.06666666666666667
"[1, 0, 1, 1, 0, 1, 1, 1, 0, 1, 1, 0, 1, 1, 0]",191,73,118,9,12,0.1232876712328767,0.1016949152542373
"[1, 0, 0, 1, 0, 0, 1, 1, 0, 1, 1, 1, 0, 0, 0]",108,55,53,2,7,0.03636363636363636,0.1320754716981132
"[0, 1, 0, 0, 0, 1, 1, 1, 0, 1, 0, 0, 0, 1, 1]",128,78,50,5,5,0.0641025641025641,0.1
"[1, 1, 0, 0, 0, 1, 1, 0, 0, 0, 1, 0, 0, 1, 0]",152,86,66,10,5,0.11627906976744186,0.07575757575757576
"[0, 0, 1, 0, 0, 0, 1, 0, 1, 0, 0, 1, 0, 1, 1]",193,114,79,9,9,0.07894736842105263,0.11392405063291139
"[0, 1, 1, 0, 1, 0, 0, 0, 0, 0, 1, 0, 1, 0, 0]",237,157,80,12,10,0.07643312101910828,0.125
"[0, 1, 0, 1, 0, 1, 1, 0, 1, 0, 0, 0, 0, 0, 1]",149,95,54,8,8,0.08421052631578947,0.14814814814814814
"[0, 1, 0, 0, 1, 1, 0, 0, 1, 0, 1, 1, 1, 1, 1]",182,78,104,8,7,0.10256410256410256,0.0673076923076923
"[1, 0, 1, 0, 0, 1, 1, 0, 0, 1, 0, 1, 1, 1, 1]",184,74,110,6,11,0.08108108108108109,0.1
"[0, 1, 0, 1, 1, 0, 0, 1, 0, 1, 1, 1, 1, 1, 0]",155,78,77,14,6,0.1794871794871795,0.07792207792207792
"[0, 1, 1, 0, 1, 0, 1, 1, 0, 1, 1, 1, 0, 1, 1]",246,101,145,7,19,0.06930693069306931,0.1310344827586207
"[1, 0, 0, 0, 1, 1, 1, 0, 1, 1, 1, 0, 0, 1, 0]",82,31,51,3,5,0.0967741935483871,0.09803921568627451
"[1, 0, 1, 0, 0, 0, 0, 0, 0, 1, 0, 1, 1, 0, 1]",124,72,52,12,6,0.16666666666666666,0.11538461538461539
"[1, 0, 0, 1, 1, 0, 1, 0, 1, 1, 1, 0, 1, 1, 1]",284,91,193,11,15,0.12087912087912088,0.07772020725388601
"[1, 0, 1, 0, 1, 1, 0, 0, 0, 1, 1, 1, 1, 0, 1]",158,79,79,6,4,0.0759493670886076,0.05063291139240506
"[1, 0, 1, 1, 1, 0, 1, 1, 1, 1, 0, 1, 1, 0, 0]",270,89,181,9,18,0.10112359550561797,0.09944751381215469
"[1, 0, 1, 1, 0, 1, 0, 1, 1, 1, 0, 0, 1, 1, 0]",184,76,108,8,7,0.10526315789473684,0.06481481481481481
"[0, 1, 0, 1, 1, 0, 0, 1, 0, 0, 1, 0, 1, 1, 0]",125,73,52,6,5,0.0821917808219178,0.09615384615384616
"[1, 0, 0, 1, 1, 0, 1, 1, 1, 0, 1, 1, 1, 1, 0]",277,92,185,10,11,0.10869565217391304,0.05945945945945946
"[0, 0, 1, 0, 0, 1, 0, 1, 0, 0, 0, 0, 1, 1, 1]",261,157,104,15,10,0.09554140127388536,0.09615384615384616
"[0, 1, 0, 0, 0, 1, 0, 1, 0, 0, 1, 1, 1, 0, 1]",102,51,51,4,6,0.0784313725490196,0.11764705882352941
"[1, 0, 1, 1, 1, 1, 0, 0, 0, 0, 0, 1, 0, 1, 0]",110,52,58,3,7,0.057692307692307696,0.1206896551724138
"[0, 1, 0, 1, 1, 1, 1, 1, 0, 0, 0, 1, 0, 1, 1]",135,59,76,6,4,0.1016949152542373,0.05263157894736842
"[1, 1, 1, 1, 0, 1, 1, 0, 0, 0, 1, 0, 0, 0, 1]",122,47,75,7,4,0.14893617021276595,0.05333333333333334
"[0, 1, 1, 0, 1, 0, 1, 0, 0, 0, 1, 0, 0, 1, 1]",125,72,53,6,9,0.08333333333333333,0.16981132075471697
"[1, 0, 0, 0, 1, 1, 0, 1, 1, 1, 1, 0, 1, 0, 0]",114,44,70,5,6,0.11363636363636363,0.08571428571428572
"[1, 0, 0, 1, 1, 0, 0, 0, 0, 1, 0, 1, 1, 1, 1]",322,101,221,8,18,0.07920792079207921,0.08144796380090498
"[0, 1, 1, 0, 1, 0, 1, 0, 0, 1, 1, 1, 0, 0, 1]",134,43,91,3,6,0.06976744186046512,0.06593406593406594
"[1, 0, 1, 1, 0, 0, 0, 1, 0, 0, 1, 0, 1, 1, 0]",116,60,56,6,7,0.1,0.125
"[0, 0, 1, 1, 0, 1, 0, 1, 1, 1, 1, 0, 1, 0, 0]",114,67,47,7,4,0.1044776119402985,0.0851063829787234
"[1, 0, 0, 0, 1, 1, 1, 0, 1, 1, 0, 0, 0, 1, 0]",94,53,41,4,3,0.07547169811320754,0.07317073170731707
"[1, 1, 0, 0, 1, 1, 1, 0, 1, 0, 0, 0, 0, 0, 0]",228,128,100,13,11,0.1015625,0.11
"[1, 1, 1, 0, 0, 0, 0, 1, 0, 1, 1, 0, 0, 1, 0]",130,59,71,6,5,0.1016949152542373,0.07042253521126761
"[0, 1, 0, 0, 1, 0, 0, 0, 1, 0, 0, 1, 1, 0, 1]",148,89,59,8,6,0.0898876404494382,0.1016949152542373
"[1, 0, 1, 0, 1, 0, 1, 0, 1, 0, 1, 0, 0, 1, 1]",137,67,70,7,6,0.1044776119402985,0.08571428571428572
"[0, 1, 1, 1, 0, 0, 0, 1, 0, 1, 0, 0, 1, 1, 1]",169,82,87,4,5,0.04878048780487805,0.05747126436781609
"[1, 0, 1, 1, 1, 0, 1, 1, 1, 1, 1, 1, 0, 1, 0]",498,137,361,15,25,0.10948905109489052,0.06925207756232687
"[1, 1, 0, 0, 1, 0, 0, 0, 0, 1, 0, 1, 1, 0, 0]",167,87,80,7,5,0.08045977011494253,0.0625
"[1, 1, 0, 0, 0, 1, 1, 1, 1, 0, 0, 1, 0, 0, 0]",143,68,75,6,7,0.08823529411764706,0.09333333333333334
"[1, 0, 0, 1, 1, 0, 0, 0, 1, 0, 0, 1, 0, 1, 0]",148,89,59,6,7,0.06741573033707865,0.11864406779661017
"[1, 1, 0, 0, 0, 0, 0, 1, 1, 1, 0, 1, 1, 0, 1]",129,61,68,5,3,0.08196721311475409,0.04411764705882353
"[1, 0, 1, 0, 0, 1, 0, 0, 0, 1, 1, 1, 0, 0, 1]",128,63,65,4,7,0.06349206349206349,0.1076923076923077
"[0, 0, 1, 1, 1, 0, 0, 0, 1, 0, 0, 1, 1, 0, 1]",120,67,53,7,3,0.1044776119402985,0.05660377358490566
"[0, 0, 0, 0, 1, 1, 0, 0, 1, 1, 0, 1, 1, 1, 1]",427,224,203,27,16,0.12053571428571429,0.07881773399014778
"[1, 0, 0, 1, 0, 0, 1, 1, 1, 0, 0, 0, 1, 1, 0]",126,66,60,7,8,0.10606060606060606,0.13333333333333333
"[1, 1, 1, 1, 0, 0, 1, 0, 1, 1, 0, 1, 1, 0, 0]",176,70,106,7,9,0.1,0.08490566037735849
"[1, 1, 0, 1, 1, 1, 1, 0, 1, 0, 0, 1, 0, 1, 1]",226,92,134,6,16,0.06521739130434782,0.11940298507462686
"[1, 1, 1, 0, 1, 1, 0, 1, 0, 0, 0, 1, 0, 0, 0]",109,59,50,5,3,0.0847457627118644,0.06
"[1, 1, 0, 1, 1, 1, 0, 0, 1, 1, 0, 0, 1, 0, 0]",112,43,69,4,10,0.09302325581395349,0.14492753623188406
"[0, 0, 1, 1, 0, 0, 1, 1, 1, 0, 0, 0, 0, 1, 1]",323,190,133,12,13,0.06315789473684211,0.09774436090225563
"[0, 1, 1, 1, 1, 0, 0, 1, 0, 0, 0, 1, 1, 0, 1]",135,67,68,9,5,0.13432835820895522,0.07352941176470588
"[1, 1, 0, 1, 0, 0, 1, 0, 0, 0, 1, 1, 0, 1, 0]",109,69,40,10,7,0.14492753623188406,0.175
"[1, 0, 1, 1, 0, 1, 1, 0, 1, 0, 0, 1, 0, 0, 0]",121,65,56,6,3,0.09230769230769231,0.05357142857142857
"[1, 0, 1, 1, 1, 0, 1, 1, 0, 1, 1, 0, 1, 0, 0]",132,48,84,1,4,0.020833333333333332,0.047619047619047616
"[0, 0, 0, 1, 1, 1, 0, 0, 0, 1, 0, 0, 1, 0, 0]",255,176,79,16,9,0.09090909090909091,0.11392405063291139
"[0, 1, 1, 0, 0, 1, 0, 0, 0, 1, 0, 0, 1, 0, 1]",147,93,54,8,6,0.08602150537634409,0.1111111111111111
"[1, 0, 1, 1, 0, 1, 0, 1, 0, 1, 1, 0, 0, 0, 1]",99,46,53,5,5,0.10869565217391304,0.09433962264150944
"[1, 0, 1, 1, 1, 1, 0, 0, 1, 1, 1, 0, 0, 0, 1]",182,65,117,7,13,0.1076923076923077,0.1111111111111111
"[1, 0, 1, 1, 0, 1, 0, 0, 1, 0, 0, 0, 0, 1, 1]",167,94,73,6,8,0.06382978723404255,0.1095890410958904
"[1, 0, 1, 1, 1, 0, 0, 0, 0, 1, 0, 1, 0, 0, 1]",112,67,45,8,5,0.11940298507462686,0.1111111111111111
"[0, 1, 1, 1, 1, 0, 0, 1, 0, 1, 0, 1, 0, 1, 0]",118,56,62,2,8,0.03571428571428571,0.12903225806451613
"[0, 0, 0, 0, 1, 1, 0, 1, 0, 1, 0, 0, 1, 1, 0]",212,129,83,7,7,0.05426356589147287,0.08433734939759036
"[0, 0, 1, 0, 1, 1, 1, 1, 0, 1, 0, 0, 0, 0, 0]",172,92,80,10,7,0.10869565217391304,0.0875
"[1, 0, 1, 1, 0, 1, 1, 0, 1, 1, 1, 0, 1, 0, 0]",144,60,84,8,10,0.13333333333333333,0.11904761904761904
"[0, 1, 1, 0, 1, 1, 1, 1, 0, 1, 0, 1, 0, 0, 0]",105,54,51,7,2,0.12962962962962962,0.0392156862745098
"[0, 0, 1, 0, 0, 1, 1, 0, 1, 0, 1, 1, 0, 0, 1]",131,64,67,8,13,0.125,0.19402985074626866
"[1, 0, 0, 0, 1, 0, 0, 1, 1, 1, 0, 1, 0, 1, 1]",94,47,47,4,6,0.0851063829787234,0.1276595744680851
"[0, 0, 1, 0, 0, 1, 1, 0, 1, 1, 0, 0, 0, 0, 1]",194,109,85,14,5,0.12844036697247707,0.058823529411764705
"[1, 0, 0, 1, 0, 0, 1, 1, 0, 0, 0, 1, 1, 1, 1]",193,92,101,7,6,0.07608695652173914,0.0594059405940594
"[1, 0, 1, 1, 0, 1, 0, 1, 1, 0, 0, 0, 1, 1, 1]",166,75,91,5,9,0.06666666666666667,0.0989010989010989
"[1, 0, 1, 0, 0, 1, 1, 0, 1, 0, 0, 0, 1, 1, 0]",141,73,68,7,10,0.0958904109589041,0.14705882352941177
"[1, 0, 1, 1, 1, 0, 1, 0, 0, 0, 0, 0, 1, 1, 1]",176,82,94,11,10,0.13414634146341464,0.10638297872340426
"[1, 0, 0, 1, 0, 0, 1, 0, 1, 1, 0, 0, 1, 0, 1]",113,54,59,11,7,0.2037037037037037,0.11864406779661017
"[0, 0, 1, 0, 1, 1, 0, 0, 1, 0, 1, 1, 0, 0, 0]",165,98,67,11,6,0.11224489795918367,0.08955223880597014
"[0, 0, 1, 0, 0, 1, 0, 1, 1, 0, 1, 0, 1, 1, 1]",121,64,57,7,5,0.109375,0.08771929824561403
"[1, 0, 1, 0, 0, 1, 0, 1, 1, 0, 0, 0, 1, 0, 1]",95,41,54,9,6,0.21951219512195122,0.1111111111111111
"[1, 1, 0, 0, 0, 1, 0, 1, 1, 1, 0, 0, 1, 0, 0]",140,75,65,6,7,0.08,0.1076923076923077
"[0, 1, 0, 0, 1, 1, 1, 1, 0, 0, 0, 1, 1, 1, 1]",250,114,136,7,14,0.06140350877192982,0.10294117647058823
"[1, 0, 1, 1, 1, 0, 1, 1, 0, 1, 0, 0, 0, 0, 1]",129,56,73,3,7,0.05357142857142857,0.0958904109589041
"[0, 1, 0, 1, 1, 0, 1, 0, 0, 0, 0, 0, 1, 1, 0]",181,113,68,7,7,0.061946902654867256,0.10294117647058823
"[1, 0, 0, 0, 1, 1, 0, 1, 1, 0, 0, 1, 0, 0, 1]",124,59,65,3,6,0.05084745762711865,0.09230769230769231
"[0, 0, 0, 1, 1, 0, 0, 1, 0, 0, 0, 1, 1, 1, 1]",262,192,70,16,4,0.08333333333333333,0.05714285714285714
"[0, 1, 1, 0, 0, 1, 1, 1, 1, 1, 0, 1, 1, 0, 1]",296,148,148,19,9,0.12837837837837837,0.060810810810810814
"[0, 0, 0, 1, 1, 1, 0, 1, 0, 1, 1, 0, 0, 1, 1]",191,99,92,5,6,0.050505050505050504,0.06521739130434782
"[1, 0, 0, 0, 1, 1, 0, 1, 0, 0, 0, 0, 0, 1, 1]",192,108,84,10,9,0.09259259259259259,0.10714285714285714
"[1, 0, 0, 0, 1, 0, 0, 1, 0, 1, 1, 0, 1, 1, 0]",112,51,61,5,6,0.09803921568627451,0.09836065573770492
"[0, 1, 1, 0, 1, 1, 0, 0, 1, 0, 0, 1, 0, 1, 0]",106,58,48,6,2,0.10344827586206896,0.041666666666666664
"[0, 0, 1, 1, 0, 1, 0, 0, 1, 1, 0, 0, 1, 1, 1]",243,133,110,12,12,0.09022556390977443,0.10909090909090909
"[0, 1, 1, 0, 1, 0, 0, 1, 1, 0, 1, 0, 0, 1, 1]",126,62,64,5,4,0.08064516129032258,0.0625
"[0, 0, 1, 1, 0, 1, 0, 0, 1, 1, 0, 1, 0, 0, 1]",116,66,50,9,3,0.13636363636363635,0.06
"[1, 0, 1, 1, 1, 0, 1, 1, 0, 1, 0, 0, 0, 1, 0]",77,39,38,3,1,0.07692307692307693,0.02631578947368421
"[0, 1, 0, 1, 1, 1, 1, 0, 0, 0, 0, 0, 1, 1, 0]",165,84,81,13,12,0.15476190476190477,0.14814814814814814
"[1, 1, 0, 1, 1, 0, 0, 0, 1, 0, 1, 1, 1, 0, 0]",131,59,72,4,8,0.06779661016949153,0.1111111111111111
"[1, 0, 0, 1, 1, 0, 0, 0, 1, 0, 0, 1, 0, 0, 0]",275,161,114,19,9,0.11801242236024845,0.07894736842105263
"[0, 0, 1, 0, 1, 1, 0, 1, 0, 1, 1, 1, 1, 1, 0]",149,61,88,4,4,0.06557377049180328,0.045454545454545456
"[0, 1, 0, 1, 0, 0, 1, 0, 0, 1, 0, 1, 1, 1, 1]",120,63,57,4,5,0.06349206349206349,0.08771929824561403
"[0, 0, 1, 1, 0, 0, 0, 1, 1, 1, 1, 1, 1, 0, 1]",181,75,106,4,10,0.05333333333333334,0.09433962264150944
"[1, 1, 0, 1, 1, 1, 1, 0, 1, 0, 1, 1, 0, 0, 0]",178,71,107,8,17,0.11267605633802817,0.1588785046728972
"[0, 0, 0, 1, 0, 0, 1, 1, 0, 1, 0, 0, 0, 1, 0]",196,119,77,10,12,0.08403361344537816,0.15584415584415584
"[0, 0, 1, 1, 1, 0, 0, 0, 0, 1, 1, 1, 1, 1, 0]",184,81,103,14,14,0.1728395061728395,0.13592233009708737
"[1, 1, 0, 1, 0, 1, 0, 0, 1, 0, 1, 0, 0, 1, 1]",135,60,75,3,7,0.05,0.09333333333333334
"[1, 0, 1, 1, 1, 1, 1, 0, 0, 0, 0, 0, 0, 1, 0]",156,84,72,11,7,0.13095238095238096,0.09722222222222222
"[1, 0, 0, 1, 0, 1, 1, 1, 0, 0, 1, 1, 1, 1, 0]",227,100,127,11,13,0.11,0.10236220472440945
"[0, 1, 1, 0, 1, 1, 0, 0, 0, 1, 1, 1, 0, 0, 1]",126,69,57,8,3,0.11594202898550725,0.05263157894736842
"[1, 1, 0, 1, 1, 1, 0, 1, 1, 0, 0, 1, 1, 0, 1]",224,79,145,8,14,0.10126582278481013,0.09655172413793103
"[1, 0, 1, 0, 0, 0, 1, 0, 0, 0, 1, 0, 0, 1, 0]",215,140,75,13,7,0.09285714285714286,0.09333333333333334
"[0, 0, 0, 1, 0, 1, 1, 1, 1, 0, 0, 0, 0, 0, 1]",205,118,87,17,14,0.1440677966101695,0.16091954022988506
"[0, 1, 1, 0, 0, 1, 0, 1, 1, 1, 0, 1, 0, 0, 1]",118,60,58,6,8,0.1,0.13793103448275862
"[0, 0, 1, 1, 0, 0, 1, 1, 1, 1, 1, 0, 0, 0, 1]",256,137,119,11,15,0.08029197080291971,0.12605042016806722
"[0, 0, 1, 0, 1, 0, 0, 1, 0, 0, 1, 0, 1, 0, 1]",141,78,63,10,4,0.1282051282051282,0.06349206349206349
"[1, 0, 1, 0, 0, 0, 0, 1, 0, 1, 1, 1, 1, 0, 0]",154,79,75,8,6,0.10126582278481013,0.08
"[1, 1, 1, 0, 1, 1, 1, 1, 0, 0, 1, 0, 0, 1, 1]",273,99,174,17,14,0.1717171717171717,0.08045977011494253
"[1, 0, 1, 0, 0, 1, 1, 0, 1, 0, 0, 1, 1, 0, 1]",78,37,41,5,5,0.13513513513513514,0.12195121951219512
"[0, 1, 1, 0, 0, 1, 1, 1, 0, 0, 1, 1, 1, 0, 1]",173,82,91,1,11,0.012195121951219513,0.12087912087912088
"[0, 0, 1, 1, 0, 0, 1, 1, 1, 0, 0, 1, 1, 1, 0]",165,84,81,7,8,0.08333333333333333,0.09876543209876543
"[1, 1, 1, 1, 0, 0, 1, 0, 0, 1, 0, 1, 0, 0, 1]",129,55,74,3,7,0.05454545454545454,0.0945945945945946
"[1, 1, 0, 1, 0, 1, 0, 1, 0, 1, 0, 1, 1, 1, 0]",130,48,82,6,3,0.125,0.036585365853658534
"[1, 0, 0, 1, 0, 0, 0, 1, 1, 0, 1, 1, 0, 1, 0]",107,57,50,2,5,0.03508771929824561,0.1
"[0, 0, 1, 1, 1, 0, 1, 0, 1, 0, 1, 0, 1, 0, 1]",106,54,52,2,2,0.037037037037037035,0.038461538461538464
"[1, 0, 1, 1, 0, 0, 0, 1, 0, 1, 0, 0, 0, 1, 1]",123,72,51,9,7,0.125,0.13725490196078433
"[0, 1, 1, 0, 1, 0, 0, 0, 1, 0, 0, 1, 1, 0, 0]",165,90,75,12,11,0.13333333333333333,0.14666666666666667
"[0, 1, 0, 1, 1, 0, 0, 0, 1, 1, 1, 1, 0, 1, 0]",112,55,57,3,5,0.05454545454545454,0.08771929824561403
"[1, 1, 0, 0, 1, 0, 1, 1, 0, 1, 1, 1, 0, 1, 0]",126,53,73,10,6,0.18867924528301888,0.0821917808219178
"[1, 0, 0, 0, 1, 1, 1, 0, 1, 1, 1, 0, 1, 1, 0]",151,61,90,5,7,0.08196721311475409,0.07777777777777778
"[0, 1, 0, 1, 0, 1, 0, 1, 1, 0, 0, 0, 0, 1, 0]",138,83,55,10,4,0.12048192771084337,0.07272727272727272
"[1, 0, 0, 1, 0, 0, 1, 1, 1, 0, 1, 0, 1, 0, 0]",99,47,52,2,4,0.0425531914893617,0.07692307692307693
"[1, 1, 1, 0, 1, 0, 0, 1, 0, 0, 1, 1, 0, 1, 0]",125,51,74,3,7,0.058823529411764705,0.0945945945945946
"[1, 0, 1, 1, 1, 0, 1, 1, 0, 0, 1, 0, 0, 0, 0]",135,67,68,7,6,0.1044776119402985,0.08823529411764706
"[1, 1, 0, 1, 0, 1, 0, 0, 0, 0, 0, 1, 1, 1, 0]",123,67,56,9,6,0.13432835820895522,0.10714285714285714
"[0, 0, 1, 1, 1, 0, 1, 0, 1, 1, 0, 0, 1, 1, 0]",160,84,76,8,10,0.09523809523809523,0.13157894736842105
"[1, 0, 0, 1, 1, 1, 1, 0, 1, 0, 0, 0, 0, 0, 0]",238,119,119,6,15,0.05042016806722689,0.12605042016806722
"[0, 1, 1, 0, 0, 1, 0, 1, 1, 0, 1, 1, 1, 0, 0]",119,63,56,6,4,0.09523809523809523,0.07142857142857142
"[0, 1, 0, 0, 0, 0, 1, 1, 1, 1, 1, 0, 0, 1, 0]",114,59,55,1,6,0.01694915254237288,0.10909090909090909
"[1, 0, 1, 0, 1, 1, 0, 0, 1, 1, 0, 1, 1, 0, 1]",145,57,88,2,9,0.03508771929824561,0.10227272727272728
"[0, 1, 0, 0, 0, 1, 1, 0, 1, 0, 1, 0, 1, 1, 0]",127,60,67,3,6,0.05,0.08955223880597014
"[1, 0, 1, 1, 1, 1, 0, 0, 0, 0, 0, 0, 0, 1, 1]",265,136,129,17,21,0.125,0.16279069767441862
"[1, 1, 0, 0, 1, 1, 1, 0, 0, 0, 0, 1, 1, 0, 1]",146,68,78,7,7,0.10294117647058823,0.08974358974358974
"[1, 0, 1, 0, 0, 0, 1, 1, 1, 0, 1, 0, 1, 0, 1]",98,42,56,4,2,0.09523809523809523,0.03571428571428571
"[0, 1, 1, 0, 1, 0, 0, 1, 0, 1, 1, 1, 1, 0, 0]",143,62,81,5,7,0.08064516129032258,0.08641975308641975
"[0, 0, 1, 0, 1, 1, 0, 0, 1, 1, 0, 0, 0, 1, 1]",178,104,74,11,8,0.10576923076923077,0.10810810810810811
"[0, 1, 0, 1, 1, 1, 0, 0, 1, 1, 1, 0, 1, 0, 1]",127,47,80,4,7,0.0851063829787234,0.0875
"[1, 0, 0, 1, 1, 0, 0, 0, 1, 1, 0, 1, 0, 0, 1]",129,54,75,3,4,0.05555555555555555,0.05333333333333334
"[1, 1, 1, 0, 1, 0, 1, 1, 1, 0, 1, 1, 1, 0, 0]",274,105,169,8,23,0.0761904761904762,0.13609467455621302
"[1, 0, 1, 0, 0, 0, 1, 0, 0, 0, 1, 0, 1, 1, 1]",119,62,57,10,6,0.16129032258064516,0.10526315789473684
"[1, 0, 0, 1, 0, 0, 1, 0, 0, 1, 1, 0, 0, 0, 1]",157,91,66,7,3,0.07692307692307693,0.045454545454545456
"[0, 1, 0, 0, 1, 0, 1, 1, 1, 1, 1, 1, 0, 0, 0]",189,109,80,11,3,0.10091743119266056,0.0375
"[0, 1, 0, 1, 1, 0, 1, 1, 1, 0, 0, 1, 1, 0, 0]",180,84,96,8,11,0.09523809523809523,0.11458333333333333
"[0, 1, 0, 1, 0, 0, 1, 1, 0, 0, 1, 1, 1, 0, 1]",107,51,56,7,7,0.13725490196078433,0.125
"[0, 1, 1, 0, 1, 1, 1, 0, 1, 0, 1, 1, 0, 1, 0]",111,45,66,5,7,0.1111111111111111,0.10606060606060606
"[1, 1, 0, 1, 1, 0, 0, 1, 0, 0, 1, 1, 1, 1, 0]",187,64,123,6,14,0.09375,0.11382113821138211
"[1, 0, 1, 1, 0, 1, 0, 0, 1, 1, 0, 0, 1, 1, 0]",176,82,94,5,8,0.06097560975609756,0.0851063829787234
"[0, 1, 0, 1, 0, 1, 1, 0, 0, 1, 0, 1, 0, 0, 0]",155,94,61,7,7,0.07446808510638298,0.11475409836065574
"[0, 0, 1, 1, 1, 0, 1, 0, 1, 0, 0, 1, 1, 0, 1]",108,50,58,3,6,0.06,0.10344827586206896
"[1, 0, 0, 1, 1, 0, 0, 1, 0, 0, 1, 1, 1, 0, 1]",129,60,69,3,1,0.05,0.014492753623188406
"[0, 0, 1, 0, 0, 0, 1, 1, 0, 0, 0, 1, 0, 1, 1]",189,116,73,16,9,0.13793103448275862,0.1232876712328767
"[1, 1, 1, 1, 0, 1, 0, 1, 0, 1, 1, 0, 0, 0, 0]",161,68,93,5,7,0.07352941176470588,0.07526881720430108
"[0, 1, 0, 1, 0, 1, 0, 0, 0, 0, 0, 1, 1, 1, 0]",161,105,56,9,1,0.08571428571428572,0.017857142857142856
"[0, 1, 0, 1, 1, 1, 1, 0, 1, 0, 1, 0, 1, 0, 0]",116,53,63,6,4,0.11320754716981132,0.06349206349206349
"[1, 1, 0, 0, 1, 0, 0, 0, 0, 1, 1, 0, 1, 1, 0]",119,61,58,2,5,0.03278688524590164,0.08620689655172414
"[1, 0, 1, 1, 0, 1, 0, 1, 1, 1, 0, 1, 0, 1, 0]",123,42,81,3,4,0.07142857142857142,0.04938271604938271
"[1, 0, 1, 1, 1, 0, 0, 0, 1, 0, 1, 0, 1, 0, 1]",101,54,47,5,6,0.09259259259259259,0.1276595744680851
"[0, 1, 1, 0, 1, 1, 0, 1, 0, 0, 0, 1, 1, 1, 1]",182,70,112,12,14,0.17142857142857143,0.125
"[0, 1, 1, 0, 1, 1, 0, 1, 1, 0, 1, 0, 0, 0, 1]",95,46,49,3,5,0.06521739130434782,0.10204081632653061
"[0, 0, 1, 1, 1, 1, 0, 0, 0, 1, 0, 1, 0, 0, 1]",152,74,78,11,10,0.14864864864864866,0.1282051282051282
"[0, 1, 0, 1, 0, 0, 1, 1, 1, 0, 0, 1, 0, 0, 0]",157,86,71,9,5,0.10465116279069768,0.07042253521126761
"[1, 0, 1, 1, 0, 1, 1, 1, 1, 0, 0, 0, 1, 1, 0]",163,74,89,6,7,0.08108108108108109,0.07865168539325842
"[1, 1, 0, 0, 0, 0, 0, 0, 1, 0, 1, 0, 1, 0, 1]",171,97,74,8,2,0.08247422680412371,0.02702702702702703
"[0, 0, 1, 0, 0, 1, 1, 1, 0, 0, 0, 1, 1, 0, 1]",107,67,40,6,3,0.08955223880597014,0.075
"[0, 0, 1, 1, 0, 0, 0, 1, 0, 1, 1, 0, 0, 1, 0]",133,82,51,7,3,0.08536585365853659,0.058823529411764705
"[0, 1, 0, 1, 0, 0, 0, 0, 1, 0, 1, 0, 1, 0, 0]",210,130,80,21,9,0.16153846153846155,0.1125
"[1, 0, 1, 0, 0, 1, 1, 0, 0, 0, 0, 1, 1, 1, 0]",134,75,59,4,9,0.05333333333333334,0.15254237288135594
"[1, 1, 1, 0, 0, 0, 1, 0, 0, 1, 0, 0, 0, 1, 0]",151,82,69,12,10,0.14634146341463414,0.14492753623188406
"[0, 1, 0, 0, 1, 0, 1, 1, 1, 0, 0, 1, 1, 1, 0]",112,54,58,7,2,0.12962962962962962,0.034482758620689655
"[0, 1, 1, 1, 1, 1, 0, 1, 1, 0, 1, 0, 0, 0, 0]",160,81,79,8,5,0.09876543209876543,0.06329113924050633
"[1, 1, 0, 0, 0, 0, 0, 1, 0, 1, 0, 1, 0, 0, 1]",153,93,60,6,3,0.06451612903225806,0.05
"[1, 1, 0, 1, 0, 0, 0, 1, 0, 1, 0, 1, 0, 1, 1]",115,55,60,4,4,0.07272727272727272,0.06666666666666667
"[0, 0, 1, 0, 1, 1, 0, 1, 0, 0, 0, 1, 0, 1, 0]",135,81,54,9,3,0.1111111111111111,0.05555555555555555
"[0, 1, 0, 0, 1, 0, 0, 0, 1, 0, 1, 1, 0, 1, 1]",123,71,52,8,8,0.11267605633802817,0.15384615384615385
"[0, 1, 1, 0, 1, 0, 0, 1, 1, 1, 1, 0, 1, 1, 0]",141,64,77,11,7,0.171875,0.09090909090909091
"[1, 0, 0, 1, 1, 1, 0, 0, 1, 1, 0, 1, 1, 0, 0]",147,67,80,6,4,0.08955223880597014,0.05
"[1, 1, 1, 0, 1, 0, 1, 0, 1, 1, 0, 1, 0, 1, 0]",120,43,77,4,4,0.09302325581395349,0.05194805194805195
"[0, 1, 0, 1, 0, 1, 1, 0, 0, 1, 1, 1, 0, 1, 1]",159,72,87,7,6,0.09722222222222222,0.06896551724137931
"[0, 0, 1, 1, 1, 1, 1, 0, 1, 1, 0, 1, 0, 0, 0]",137,65,72,5,7,0.07692307692307693,0.09722222222222222
"[0, 1, 0, 0, 0, 0, 1, 1, 1, 0, 1, 1, 1, 0, 0]",116,68,48,3,5,0.04411764705882353,0.10416666666666667
"[1, 0, 0, 0, 1, 0, 1, 0, 0, 0, 1, 1, 0, 0, 1]",198,121,77,13,4,0.10743801652892562,0.05194805194805195
"[0, 1, 1, 1, 1, 0, 1, 0, 1, 0, 0, 1, 1, 0, 1]",159,81,78,10,5,0.12345679012345678,0.0641025641025641
"[1, 1, 0, 1, 1, 0, 0, 1, 0, 0, 0, 0, 1, 1, 0]",155,84,71,8,5,0.09523809523809523,0.07042253521126761
"[0, 1, 1, 1, 1, 1, 0, 1, 0, 0, 1, 1, 0, 0, 1]",210,88,122,4,12,0.045454545454545456,0.09836065573770492
"[1, 1, 1, 1, 0, 1, 0, 0, 1, 1, 1, 0, 0, 0, 1]",148,64,84,7,12,0.109375,0.14285714285714285
"[0, 1, 1, 0, 0, 1, 0, 0, 0, 0, 1, 1, 0, 1, 0]",148,91,57,7,2,0.07692307692307693,0.03508771929824561
"[0, 1, 0, 0, 0, 1, 0, 0, 1, 1, 0, 1, 1, 1, 0]",98,56,42,5,1,0.08928571428571429,0.023809523809523808
"[0, 1, 1, 0, 0, 0, 0, 1, 0, 0, 1, 1, 0, 1, 1]",150,92,58,14,7,0.15217391304347827,0.1206896551724138
"[0, 1, 0, 1, 1, 1, 1, 0, 0, 0, 1, 1, 0, 1, 1]",145,59,86,6,6,0.1016949152542373,0.06976744186046512
"[0, 0, 1, 1, 1, 0, 1, 0, 0, 0, 0, 0, 1, 0, 1]",147,84,63,6,4,0.07142857142857142,0.06349206349206349
"[0, 0, 1, 0, 1, 0, 1, 1, 1, 0, 1, 0, 0, 1, 0]",97,61,36,6,5,0.09836065573770492,0.1388888888888889
"[1, 0, 0, 1, 0, 0, 0, 1, 1, 0, 1, 0, 0, 1, 1]",134,79,55,8,5,0.10126582278481013,0.09090909090909091
"[0, 1, 1, 1, 1, 1, 0, 1, 0, 1, 1, 0, 1, 0, 1]",208,80,128,5,13,0.0625,0.1015625
"[0, 0, 1, 1, 0, 0, 1, 1, 1, 0, 0, 0, 1, 1, 0]",171,92,79,8,7,0.08695652173913043,0.08860759493670886
"[1, 1, 1, 1, 0, 1, 0, 0, 1, 0, 1, 1, 0, 0, 0]",123,60,63,3,4,0.05,0.06349206349206349
"[1, 0, 1, 1, 0, 0, 0, 1, 1, 0, 1, 0, 1, 1, 0]",123,49,74,3,10,0.061224489795918366,0.13513513513513514
"[0, 0, 0, 1, 1, 0, 1, 1, 1, 0, 0, 1, 0, 1, 0]",118,65,53,6,4,0.09230769230769231,0.07547169811320754
"[1, 0, 1, 0, 0, 0, 0, 1, 1, 0, 1, 1, 0, 1, 0]",109,58,51,7,10,0.1206896551724138,0.19607843137254902
"[0, 0, 1, 0, 1, 0, 0, 1, 0, 1, 1, 1, 1, 0, 1]",116,61,55,6,5,0.09836065573770492,0.09090909090909091
"[1, 1, 0, 0, 0, 1, 0, 0, 1, 1, 1, 1, 0, 1, 0]",114,50,64,4,9,0.08,0.140625
"[1, 0, 1, 0, 1, 0, 1, 1, 1, 0, 0, 0, 1, 1, 1]",182,64,118,11,11,0.171875,0.09322033898305085
"[1, 0, 0, 0, 0, 1, 1, 1, 1, 0, 1, 1, 0, 1, 0]",139,54,85,6,8,0.1111111111111111,0.09411764705882353
"[1, 0, 1, 0, 1, 1, 0, 1, 0, 1, 1, 1, 1, 0, 0]",226,98,128,6,9,0.061224489795918366,0.0703125
"[0, 1, 1, 0, 1, 1, 0, 1, 0, 1, 1, 1, 0, 0, 0]",122,64,58,8,6,0.125,0.10344827586206896
"[1, 1, 0, 1, 0, 0, 1, 0, 1, 1, 1, 0, 0, 0, 1]",95,35,60,2,10,0.05714285714285714,0.16666666666666666
"[1, 1, 0, 1, 0, 0, 0, 0, 1, 1, 0, 1, 0, 1, 1]",119,59,60,4,3,0.06779661016949153,0.05
"[1, 1, 0, 1, 0, 1, 1, 1, 1, 0, 0, 0, 1, 0, 0]",125,64,61,11,5,0.171875,0.08196721311475409
"[1, 1, 1, 0, 0, 1, 1, 1, 0, 1, 1, 0, 0, 1, 0]",147,58,89,5,8,0.08620689655172414,0.0898876404494382
"[1, 1, 0, 0, 1, 1, 0, 0, 0, 1, 1, 0, 0, 1, 0]",170,85,85,7,6,0.08235294117647059,0.07058823529411765
"[0, 1, 1, 0, 1, 1, 1, 1, 1, 0, 1, 0, 1, 1, 0]",254,93,161,5,16,0.053763440860215055,0.09937888198757763
"[1, 0, 0, 0, 1, 1, 1, 0, 1, 0, 1, 1, 1, 0, 0]",146,65,81,11,10,0.16923076923076924,0.12345679012345678
"[1, 0, 1, 1, 1, 1, 0, 0, 0, 0, 1, 0, 1, 0, 0]",123,64,59,8,4,0.125,0.06779661016949153
"[1, 1, 0, 1, 1, 1, 1, 0, 0, 0, 0, 1, 0, 1, 0]",109,50,59,9,11,0.18,0.1864406779661017
"[0, 1, 0, 0, 0, 1, 1, 0, 0, 1, 1, 1, 0, 0, 1]",128,69,59,9,4,0.13043478260869565,0.06779661016949153
"[0, 1, 0, 1, 0, 0, 1, 0, 0, 0, 1, 1, 1, 0, 0]",146,88,58,9,4,0.10227272727272728,0.06896551724137931
"[1, 1, 1, 1, 0, 0, 0, 1, 0, 1, 0, 1, 0, 0, 0]",132,72,60,9,8,0.125,0.13333333333333333
"[0, 1, 0, 1, 1, 1, 1, 1, 0, 0, 1, 0, 1, 1, 0]",137,61,76,8,7,0.13114754098360656,0.09210526315789473
"[0, 0, 1, 0, 0, 1, 0, 1, 0, 0, 1, 1, 1, 1, 1]",182,95,87,11,8,0.11578947368421053,0.09195402298850575
"[0, 1, 1, 0, 0, 1, 0, 0, 1, 0, 0, 1, 0, 0, 0]",228,152,76,13,5,0.08552631578947369,0.06578947368421052
"[1, 0, 0, 0, 0, 1, 0, 1, 1, 1, 0, 0, 1, 0, 0]",149,79,70,10,10,0.12658227848101267,0.14285714285714285
"[1, 1, 0, 1, 1, 1, 1, 0, 0, 0, 1, 0, 0, 0, 0]",144,70,74,7,11,0.1,0.14864864864864866
"[1, 1, 0, 0, 1, 0, 1, 0, 0, 0, 0, 1, 0, 1, 1]",120,56,64,5,11,0.08928571428571429,0.171875
"[0, 0, 0, 0, 1, 1, 0, 1, 0, 0, 0, 1, 1, 1, 1]",260,149,111,14,14,0.09395973154362416,0.12612612612612611
"[1, 1, 0, 0, 1, 0, 1, 0, 0, 0, 1, 1, 0, 1, 1]",133,59,74,4,9,0.06779661016949153,0.12162162162162163
"[1, 0, 0, 0, 0, 1, 0, 1, 1, 0, 1, 1, 0, 1, 1]",112,42,70,4,3,0.09523809523809523,0.04285714285714286
"[0, 0, 1, 1, 1, 1, 0, 1, 0, 0, 1, 0, 1, 0, 1]",139,62,77,4,8,0.06451612903225806,0.1038961038961039
"[1, 1, 0, 0, 1, 1, 0, 0, 1, 0, 1, 0, 0, 0, 0]",245,141,104,17,9,0.12056737588652482,0.08653846153846154
"[0, 0, 0, 0, 1, 1, 1, 1, 1, 0, 1, 1, 0, 0, 1]",186,89,97,9,13,0.10112359550561797,0.13402061855670103
"[0, 0, 0, 0, 1, 1, 0, 1, 0, 1, 1, 1, 0, 0, 1]",160,82,78,11,7,0.13414634146341464,0.08974358974358974
"[0, 0, 1, 1, 0, 1, 0, 1, 1, 1, 0, 0, 1, 0, 0]",131,77,54,14,6,0.18181818181818182,0.1111111111111111
"[0, 1, 0, 0, 1, 0, 1, 0, 1, 1, 0, 1, 1, 0, 0]",111,52,59,3,5,0.057692307692307696,0.0847457627118644
"[1, 0, 0, 0, 1, 1, 0, 1, 1, 1, 1, 0, 0, 1, 0]",112,50,62,6,7,0.12,0.11290322580645161
"[0, 0, 1, 0, 1, 0, 1, 0, 1, 1, 1, 0, 1, 1, 1]",173,82,91,7,9,0.08536585365853659,0.0989010989010989
"[1, 0, 0, 1, 0, 0, 1, 1, 1, 0, 0, 1, 0, 0, 0]",146,75,71,10,5,0.13333333333333333,0.07042253521126761
"[1, 1, 0, 1, 0, 0, 1, 0, 1, 0, 1, 1, 1, 1, 1]",279,100,179,11,15,0.11,0.08379888268156424
"[1, 1, 0, 1, 0, 0, 0, 0, 1, 1, 0, 1, 0, 0, 0]",163,86,77,10,8,0.11627906976744186,0.1038961038961039
"[0, 0, 1, 1, 1, 0, 1, 1, 1, 0, 1, 0, 0, 1, 0]",88,35,53,5,2,0.14285714285714285,0.03773584905660377
"[0, 1, 1, 1, 0, 1, 0, 1, 0, 0, 0, 0, 0, 1, 1]",156,93,63,10,5,0.10752688172043011,0.07936507936507936
"[0, 1, 0, 0, 1, 1, 1, 0, 0, 0, 0, 1, 1, 1, 0]",142,73,69,8,4,0.1095890410958904,0.057971014492753624
"[1, 1, 0, 1, 0, 0, 0, 0, 0, 1, 1, 1, 0, 1, 1]",115,54,61,3,7,0.05555555555555555,0.11475409836065574
"[1, 0, 1, 1, 1, 1, 0, 1, 0, 1, 1, 0, 0, 0, 1]",158,65,93,5,18,0.07692307692307693,0.1935483870967742
"[1, 0, 0, 1, 1, 1, 1, 1, 0, 1, 0, 0, 1, 0, 1]",148,63,85,6,13,0.09523809523809523,0.15294117647058825
"[0, 1, 0, 1, 1, 0, 0, 1, 1, 0, 1, 0, 1, 0, 0]",114,63,51,8,6,0.12698412698412698,0.11764705882352941
"[0, 1, 1, 0, 1, 1, 0, 1, 1, 1, 0, 1, 0, 0, 1]",146,58,88,6,8,0.10344827586206896,0.09090909090909091
"[0, 1, 1, 1, 0, 0, 1, 1, 0, 0, 1, 1, 0, 1, 0]",126,63,63,3,2,0.047619047619047616,0.031746031746031744
"[1, 0, 0, 1, 1, 1, 0, 1, 0, 0, 0, 1, 1, 0, 1]",100,41,59,3,8,0.07317073170731707,0.13559322033898305
"[1, 1, 0, 1, 0, 0, 1, 1, 1, 0, 1, 0, 0, 0, 1]",113,51,62,7,6,0.13725490196078433,0.0967741935483871
"[0, 1, 1, 0, 1, 0, 0, 0, 1, 1, 1, 0, 0, 0, 1]",115,61,54,6,11,0.09836065573770492,0.2037037037037037
"[0, 1, 1, 0, 1, 0, 1, 1, 0, 1, 1, 0, 0, 1, 0]",104,47,57,4,4,0.0851063829787234,0.07017543859649122
"[1, 0, 0, 1, 0, 1, 0, 0, 0, 0, 1, 1, 0, 1, 0]",114,67,47,6,3,0.08955223880597014,0.06382978723404255
"[0, 1, 0, 0, 1, 1, 0, 1, 0, 0, 1, 0, 1, 1, 0]",116,58,58,9,13,0.15517241379310345,0.22413793103448276
"[1, 1, 0, 0, 1, 0, 1, 0, 1, 1, 0, 0, 1, 0, 0]",95,54,41,10,3,0.18518518518518517,0.07317073170731707
"[1, 0, 1, 1, 1, 1, 0, 0, 1, 0, 1, 0, 1, 1, 0]",161,58,103,1,7,0.017241379310344827,0.06796116504854369
"[0, 0, 1, 0, 1, 0, 0, 1, 1, 1, 0, 1, 0, 0, 1]",106,53,53,2,7,0.03773584905660377,0.1320754716981132
"[1, 1, 1, 0, 0, 1, 0, 0, 1, 1, 0, 1, 0, 1, 0]",110,52,58,7,5,0.1346153846153846,0.08620689655172414
"[0, 1, 1, 1, 1, 0, 0, 1, 0, 0, 1, 1, 0, 1, 0]",120,62,58,3,7,0.04838709677419355,0.1206896551724138
"[1, 0, 1, 1, 0, 1, 1, 0, 0, 0, 1, 0, 1, 0, 0]",100,57,43,7,4,0.12280701754385964,0.09302325581395349
"[0, 1, 1, 0, 1, 0, 1, 1, 0, 1, 1, 1, 0, 1, 0]",125,47,78,2,7,0.0425531914893617,0.08974358974358974
"[1, 0, 1, 1, 0, 0, 0, 0, 1, 0, 0, 1, 1, 0, 1]",114,67,47,6,3,0.08955223880597014,0.06382978723404255
"[0, 0, 0, 1, 1, 1, 0, 1, 0, 1, 0, 0, 0, 0, 1]",177,105,72,6,6,0.05714285714285714,0.08333333333333333
"[1, 1, 0, 1, 1, 1, 0, 1, 0, 1, 0, 0, 0, 1, 1]",146,63,83,4,8,0.06349206349206349,0.0963855421686747
"[0, 1, 0, 0, 0, 1, 0, 0, 0, 1, 0, 1, 1, 1, 1]",137,82,55,11,6,0.13414634146341464,0.10909090909090909
"[1, 1, 0, 0, 1, 0, 0, 0, 0, 1, 0, 0, 0, 1, 1]",175,103,72,8,10,0.07766990291262135,0.1388888888888889
"[1, 0, 1, 1, 0, 0, 0, 1, 1, 1, 0, 1, 0, 1, 0]",88,33,55,2,9,0.06060606060606061,0.16363636363636364
"[0, 0, 0, 1, 0, 1, 0, 0, 1, 0, 1, 1, 1, 0, 1]",115,58,57,8,9,0.13793103448275862,0.15789473684210525
"[0, 0, 0, 1, 1, 1, 1, 1, 0, 0, 0, 1, 0, 1, 1]",152,86,66,8,12,0.09302325581395349,0.18181818181818182
"[1, 0, 1, 1, 0, 1, 0, 1, 0, 0, 1, 0, 0, 1, 1]",136,62,74,5,5,0.08064516129032258,0.06756756756756757
"[1, 1, 0, 1, 0, 1, 1, 0, 0, 0, 1, 0, 1, 0, 1]",101,52,49,5,3,0.09615384615384616,0.061224489795918366
"[0, 1, 1, 0, 1, 0, 1, 1, 0, 0, 0, 1, 0, 1, 0]",95,50,45,4,4,0.08,0.08888888888888889
"[1, 0, 1, 0, 0, 1, 0, 1, 1, 1, 0, 0, 0, 0, 1]",144,73,71,9,7,0.1232876712328767,0.09859154929577464
"[1, 1, 0, 0, 1, 0, 0, 0, 1, 1, 1, 1, 1, 1, 0]",246,100,146,10,7,0.1,0.04794520547945205
"[0, 1, 1, 0, 0, 1, 1, 0, 0, 0, 1, 1, 0, 1, 0]",143,85,58,5,11,0.058823529411764705,0.1896551724137931
"[1, 0, 1, 0, 1, 1, 0, 0, 0, 1, 0, 1, 0, 1, 1]",116,52,64,4,5,0.07692307692307693,0.078125
"[1, 1, 0, 0, 0, 1, 0, 1, 1, 1, 1, 0, 0, 1, 1]",240,92,148,8,11,0.08695652173913043,0.07432432432432433
"[0, 0, 0, 0, 0, 0, 1, 0, 1, 1, 1, 1, 1, 1, 0]",208,126,82,15,11,0.11904761904761904,0.13414634146341464
"[1, 1, 0, 1, 0, 1, 1, 1, 0, 0, 0, 0, 0, 1, 1]",158,64,94,10,6,0.15625,0.06382978723404255
"[1, 0, 0, 0, 1, 1, 0, 0, 1, 1, 0, 0, 1, 0, 1]",125,64,61,6,5,0.09375,0.08196721311475409
"[0, 1, 1, 0, 1, 0, 1, 0, 0, 1, 0, 0, 1, 0, 1]",103,48,55,3,4,0.0625,0.07272727272727272
"[1, 0, 1, 1, 1, 1, 0, 0, 0, 1, 0, 0, 0, 0, 0]",183,108,75,8,9,0.07407407407407407,0.12
"[0, 0, 1, 1, 0, 1, 0, 1, 0, 1, 0, 1, 0, 0, 0]",146,89,57,8,3,0.0898876404494382,0.05263157894736842
"[1, 1, 0, 1, 0, 1, 0, 0, 1, 0, 0, 0, 1, 1, 1]",131,54,77,5,9,0.09259259259259259,0.11688311688311688
"[1, 0, 0, 1, 0, 1, 1, 0, 1, 0, 1, 0, 0, 1, 0]",97,52,45,6,3,0.11538461538461539,0.06666666666666667
"[0, 0, 1, 1, 0, 0, 1, 0, 0, 1, 1, 0, 0, 1, 0]",144,74,70,10,9,0.13513513513513514,0.12857142857142856
"[1, 0, 1, 1, 0, 0, 1, 0, 1, 1, 0, 0, 1, 1, 0]",132,60,72,4,5,0.06666666666666667,0.06944444444444445
"[1, 1, 0, 0, 0, 1, 0, 0, 0, 0, 1, 0, 1, 1, 0]",161,95,66,6,4,0.06315789473684211,0.06060606060606061
"[0, 1, 0, 0, 1, 1, 1, 1, 1, 0, 1, 0, 0, 1, 0]",110,54,56,9,3,0.16666666666666666,0.05357142857142857
"[1, 1, 0, 1, 1, 0, 1, 0, 1, 0, 0, 0, 1, 0, 0]",102,52,50,4,8,0.07692307692307693,0.16
"[0, 1, 0, 1, 0, 0, 1, 1, 0, 0, 1, 0, 0, 1, 1]",142,75,67,7,5,0.09333333333333334,0.07462686567164178
"[1, 0, 1, 0, 1, 0, 1, 1, 0, 0, 0, 1, 0, 1, 0]",126,66,60,7,2,0.10606060606060606,0.03333333333333333
"[0, 1, 0, 1, 1, 0, 0, 0, 0, 1, 1, 1, 0, 1, 1]",119,55,64,6,6,0.10909090909090909,0.09375
"[1, 1, 1, 0, 1, 0, 1, 1, 0, 1, 0, 0, 1, 0, 0]",112,53,59,9,6,0.16981132075471697,0.1016949152542373
"[0, 0, 0, 0, 0, 1, 1, 1, 0, 1, 0, 0, 1, 1, 0]",179,116,63,7,7,0.0603448275862069,0.1111111111111111
"[0, 0, 1, 1, 0, 1, 1, 0, 1, 0, 1, 0, 1, 1, 1]",190,80,110,13,9,0.1625,0.08181818181818182
"[1, 0, 0, 1, 1, 1, 0, 0, 0, 1, 0, 1, 1, 0, 1]",103,51,52,3,3,0.058823529411764705,0.057692307692307696
"[0, 0, 1, 0, 1, 1, 0, 1, 0, 1, 1, 0, 1, 1, 0]",110,50,60,1,5,0.02,0.08333333333333333
"[1, 1, 0, 0, 1, 0, 0, 1, 1, 0, 1, 0, 1, 1, 0]",118,60,58,6,5,0.1,0.08620689655172414
"[1, 0, 0, 0, 1, 1, 0, 1, 1, 1, 0, 1, 1, 0, 1]",127,59,68,9,8,0.15254237288135594,0.11764705882352941
"[1, 0, 1, 1, 1, 0, 1, 0, 1, 0, 1, 0, 1, 1, 0]",136,65,71,6,10,0.09230769230769231,0.14084507042253522
"[1, 1, 0, 1, 0, 1, 0, 0, 1, 0, 0, 1, 0, 1, 0]",95,49,46,5,4,0.10204081632653061,0.08695652173913043
"[0, 0, 1, 0, 1, 0, 0, 1, 1, 1, 0, 0, 0, 1, 0]",131,74,57,9,10,0.12162162162162163,0.17543859649122806
"[1, 1, 1, 1, 0, 1, 0, 1, 0, 0, 0, 0, 1, 0, 1]",130,61,69,11,6,0.18032786885245902,0.08695652173913043
"[1, 0, 1, 0, 1, 0, 0, 0, 0, 1, 0, 1, 1, 0, 1]",107,57,50,8,2,0.14035087719298245,0.04
"[1, 1, 0, 1, 0, 1, 1, 0, 0, 1, 0, 1, 0, 0, 1]",120,66,54,4,3,0.06060606060606061,0.05555555555555555
"[1, 0, 0, 1, 0, 0, 1, 0, 1, 0, 1, 1, 0, 1, 1]",106,51,55,3,5,0.058823529411764705,0.09090909090909091
"[1, 1, 0, 0, 0, 1, 0, 0, 1, 1, 0, 1, 0, 0, 1]",126,68,58,3,4,0.04411764705882353,0.06896551724137931
"[0, 0, 1, 1, 1, 1, 1, 0, 0, 0, 1, 0, 1, 0, 0]",122,67,55,10,5,0.14925373134328357,0.09090909090909091
"[1, 0, 1, 0, 1, 1, 0, 1, 1, 0, 0, 0, 1, 0, 1]",100,37,63,2,7,0.05405405405405406,0.1111111111111111
"[1, 0, 0, 1, 1, 1, 1, 1, 0, 0, 1, 0, 0, 1, 0]",116,39,77,2,5,0.05128205128205128,0.06493506493506493
"[0, 1, 0, 1, 0, 0, 1, 1, 1, 1, 0, 0, 0, 1, 0]",114,63,51,6,5,0.09523809523809523,0.09803921568627451
"[0, 0, 0, 1, 0, 0, 1, 1, 1, 0, 1, 1, 1, 0, 1]",101,38,63,2,7,0.05263157894736842,0.1111111111111111
"[0, 0, 1, 1, 1, 0, 1, 1, 0, 0, 1, 1, 1, 0, 0]",132,59,73,2,3,0.03389830508474576,0.0410958904109589
"[0, 0, 1, 0, 0, 1, 1, 0, 0, 1, 1, 0, 1, 0, 1]",119,67,52,1,2,0.014925373134328358,0.038461538461538464
"[0, 1, 0, 1, 1, 1, 0, 1, 1, 0, 0, 0, 1, 1, 0]",143,74,69,6,7,0.08108108108108109,0.10144927536231885
"[0, 1, 1, 1, 0, 0, 1, 0, 0, 0, 1, 0, 1, 1, 0]",124,70,54,6,3,0.08571428571428572,0.05555555555555555
"[0, 1, 0, 0, 0, 1, 0, 0, 0, 1, 1, 0, 1, 1, 0]",143,87,56,6,5,0.06896551724137931,0.08928571428571429
"[0, 1, 1, 0, 1, 1, 0, 1, 1, 0, 0, 0, 1, 0, 1]",111,60,51,6,7,0.1,0.13725490196078433
"[0, 1, 0, 1, 0, 0, 1, 0, 1, 1, 1, 0, 0, 1, 0]",103,57,46,7,3,0.12280701754385964,0.06521739130434782
"[1, 1, 1, 1, 0, 0, 1, 0, 0, 1, 1, 0, 1, 0, 0]",120,56,64,1,0,0.017857142857142856,0.0
"[1, 1, 1, 0, 0, 1, 0, 0, 0, 0, 1, 0, 1, 0, 1]",104,59,45,3,3,0.05084745762711865,0.06666666666666667
"[0, 0, 1, 0, 1, 1, 0, 0, 0, 1, 0, 1, 1, 0, 1]",115,56,59,7,5,0.125,0.0847457627118644
"[0, 1, 1, 0, 0, 0, 1, 1, 1, 1, 0, 1, 1, 0, 0]",122,58,64,4,4,0.06896551724137931,0.0625
