state,n,nA,nB,rewardA,rewardB,mn_rewardA,mn_rewardB
"[1, 1, 0, 0, 1, 1, 0, 0, 0, 1]",8290,4166,4124,401,392,0.09625540086413827,0.0950533462657614
"[0, 0, 1, 1, 0, 0, 1, 1, 0, 0]",27974,16350,11624,1595,1073,0.09755351681957186,0.09230901582931865
"[0, 0, 0, 0, 0, 1, 1, 0, 1, 1]",10101,6953,3148,710,300,0.10211419531137639,0.09529860228716645
"[0, 0, 0, 0, 0, 0, 1, 1, 0, 1]",15515,10507,5008,1028,493,0.09783953554773009,0.09844249201277955
"[1, 0, 0, 1, 0, 1, 0, 0, 0, 0]",11149,7078,4071,676,384,0.09550720542526138,0.09432571849668386
"[0, 0, 1, 0, 0, 0, 0, 0, 0, 1]",31639,23604,8035,2235,796,0.09468734112862227,0.09906658369632856
"[1, 0, 0, 0, 0, 1, 0, 0, 0, 0]",29583,20869,8714,2007,802,0.09617135464085486,0.09203580445260501
"[1, 1, 1, 1, 1, 1, 1, 1, 0, 0]",85100,21101,63999,1945,6172,0.09217572626889721,0.09643900685948217
"[0, 0, 1, 1, 0, 0, 0, 0, 0, 1]",16808,11192,5616,1047,531,0.09354896354538957,0.09455128205128205
"[0, 0, 0, 1, 1, 0, 0, 0, 1, 0]",12400,8944,3456,880,335,0.09838998211091235,0.09693287037037036
"[1, 1, 1, 0, 0, 0, 0, 1, 1, 1]",25197,5274,19923,493,1901,0.09347743648084945,0.09541735682377152
"[0, 1, 0, 1, 1, 0, 1, 0, 0, 0]",5769,3376,2393,299,236,0.08856635071090048,0.09862097785206854
"[0, 1, 0, 0, 1, 0, 1, 0, 1, 1]",5034,2591,2443,258,240,0.0995754534928599,0.09823986901350798
"[1, 0, 1, 1, 0, 0, 1, 1, 0, 1]",5853,2446,3407,216,362,0.08830744071954211,0.10625183445846786
"[0, 1, 0, 1, 1, 0, 0, 1, 1, 0]",6271,3244,3027,313,268,0.09648581997533909,0.08853650479022133
"[1, 0, 1, 1, 1, 1, 1, 0, 1, 0]",9434,3151,6283,304,542,0.09647730879086004,0.08626452331688683
"[1, 0, 0, 0, 1, 1, 1, 1, 0, 1]",6191,2453,3738,231,364,0.09417040358744394,0.09737827715355805
"[1, 1, 1, 0, 1, 1, 0, 0, 0, 1]",6386,2485,3901,224,359,0.09014084507042254,0.0920276852089208
"[1, 1, 0, 1, 1, 1, 1, 0, 1, 1]",27887,7058,20829,710,2011,0.10059506942476622,0.09654808200105622
"[1, 1, 1, 1, 0, 0, 0, 1, 1, 0]",8085,3304,4781,336,474,0.1016949152542373,0.09914243882033047
"[1, 0, 0, 0, 1, 1, 0, 1, 0, 1]",4783,2273,2510,211,230,0.09282886053673559,0.09163346613545817
"[1, 0, 1, 0, 0, 1, 1, 0, 0, 1]",6310,3052,3258,299,286,0.09796854521625163,0.08778391651319828
"[1, 0, 0, 1, 1, 1, 1, 0, 0, 1]",20450,4132,16318,418,1552,0.10116166505324298,0.09510969481554112
"[1, 0, 1, 0, 0, 1, 0, 0, 0, 1]",5702,3239,2463,336,245,0.10373572090151281,0.09947218838814453
"[0, 1, 0, 0, 0, 0, 0, 1, 0, 0]",25967,19481,6486,1880,615,0.09650428622760639,0.09481961147086032
"[1, 1, 1, 0, 1, 1, 1, 0, 1, 0]",9809,3173,6636,342,670,0.10778443113772455,0.10096443640747438
"[0, 0, 0, 1, 0, 1, 1, 0, 1, 0]",5573,3278,2295,304,220,0.09273947528981086,0.09586056644880174
"[1, 0, 0, 0, 1, 0, 1, 1, 0, 1]",4876,2300,2576,198,241,0.08608695652173913,0.09355590062111802
"[1, 0, 0, 1, 0, 0, 0, 0, 0, 1]",11227,7167,4060,689,400,0.09613506348541928,0.09852216748768473
"[0, 0, 1, 0, 0, 0, 0, 0, 1, 1]",16721,11706,5015,1079,461,0.09217495301554758,0.09192422731804586
"[1, 1, 0, 1, 1, 1, 1, 0, 0, 1]",13813,4497,9316,439,923,0.09762063597954192,0.09907685702018033
"[1, 1, 1, 0, 0, 1, 0, 1, 1, 0]",6266,2399,3867,240,355,0.1000416840350146,0.09180243082492888
"[1, 1, 0, 0, 1, 0, 1, 1, 1, 0]",6183,2541,3642,225,336,0.0885478158205431,0.09225700164744646
"[1, 0, 1, 0, 0, 0, 0, 0, 1, 1]",8486,4869,3617,493,317,0.10125282398849866,0.087641692009953
"[0, 0, 1, 0, 0, 1, 1, 0, 0, 1]",7727,4533,3194,448,312,0.09883079638208692,0.09768315591734503
"[1, 0, 1, 1, 0, 1, 0, 0, 1, 1]",6518,2661,3857,243,330,0.09131905298759865,0.0855587243971999
"[1, 0, 0, 0, 0, 1, 0, 1, 1, 1]",7877,3415,4462,328,441,0.09604685212298682,0.09883460331689825
"[1, 0, 1, 0, 1, 1, 1, 0, 0, 1]",6655,2675,3980,231,378,0.08635514018691588,0.0949748743718593
"[0, 0, 1, 1, 1, 1, 1, 1, 1, 0]",16989,6078,10911,585,1040,0.096248766041461,0.0953166529190725
"[1, 0, 0, 1, 0, 0, 1, 1, 1, 1]",9310,3671,5639,342,531,0.09316262598746936,0.09416563220429154
"[1, 0, 0, 1, 0, 1, 1, 0, 0, 0]",6686,3821,2865,383,287,0.10023554043444124,0.10017452006980802
"[0, 1, 0, 0, 1, 0, 1, 1, 0, 0]",6277,3651,2626,346,260,0.09476855655984662,0.09900990099009901
"[1, 1, 1, 1, 0, 0, 0, 1, 0, 0]",6385,3123,3262,318,305,0.10182516810758886,0.09350091968117719
"[1, 0, 0, 1, 0, 1, 1, 1, 0, 0]",5440,2570,2870,243,261,0.09455252918287937,0.09094076655052265
"[0, 1, 0, 0, 1, 0, 1, 1, 1, 0]",4673,2422,2251,252,213,0.10404624277456648,0.09462461128387384
"[0, 0, 0, 0, 1, 1, 0, 1, 0, 1]",7413,4419,2994,435,313,0.09843856076035302,0.10454241816967268
"[0, 0, 0, 1, 0, 1, 1, 1, 1, 1]",9270,4556,4714,464,448,0.10184372256365233,0.09503606279168435
"[0, 1, 0, 1, 1, 0, 1, 1, 0, 0]",5210,2610,2600,253,231,0.09693486590038314,0.08884615384615385
"[1, 0, 0, 1, 1, 0, 0, 1, 0, 0]",7079,3444,3635,328,329,0.09523809523809523,0.09050894085281981
"[0, 0, 0, 0, 1, 1, 1, 1, 1, 0]",8790,4631,4159,430,382,0.09285251565536601,0.09184900216398173
"[0, 0, 0, 1, 0, 0, 0, 0, 0, 1]",30440,23324,7116,2279,707,0.0977105127765392,0.09935356942102305
"[1, 0, 1, 0, 0, 1, 0, 1, 1, 0]",4764,2411,2353,223,235,0.09249274160099544,0.09987250318742032
"[1, 1, 1, 0, 1, 0, 0, 1, 0, 1]",5795,2357,3438,231,351,0.09800593975392448,0.10209424083769633
"[1, 1, 0, 0, 1, 0, 0, 1, 1, 1]",9349,4047,5302,405,528,0.10007412898443291,0.0995850622406639
"[1, 1, 0, 1, 1, 0, 1, 1, 0, 0]",6679,2713,3966,238,352,0.08772576483597494,0.08875441250630359
"[1, 1, 1, 0, 0, 0, 0, 1, 0, 0]",7453,3561,3892,329,344,0.09238977815220444,0.08838643371017471
"[1, 0, 1, 0, 1, 0, 0, 0, 1, 1]",5472,2760,2712,269,252,0.09746376811594203,0.09292035398230089
"[0, 1, 1, 0, 1, 0, 0, 1, 1, 1]",7817,3724,4093,352,378,0.09452201933404941,0.09235279745907647
"[0, 0, 1, 1, 0, 1, 0, 0, 1, 1]",6345,3316,3029,346,247,0.10434258142340169,0.0815450643776824
"[0, 0, 0, 1, 0, 0, 1, 1, 0, 1]",5850,3544,2306,315,249,0.08888261851015801,0.10797918473547267
"[1, 1, 1, 1, 0, 0, 1, 0, 1, 0]",6806,2782,4024,269,397,0.09669302659956866,0.09865805168986083
"[1, 0, 1, 0, 0, 1, 1, 1, 0, 1]",5550,2277,3273,197,335,0.08651734738691261,0.10235258172930034
"[1, 0, 0, 0, 1, 1, 0, 0, 1, 0]",5611,3080,2531,276,264,0.08961038961038961,0.10430659818253654
"[1, 1, 1, 1, 0, 1, 1, 0, 1, 0]",10077,3337,6740,353,609,0.10578363799820198,0.09035608308605342
"[1, 0, 0, 0, 0, 1, 1, 1, 0, 0]",7842,3853,3989,344,355,0.08928107967817285,0.08899473552268738
"[1, 0, 1, 1, 0, 0, 0, 0, 1, 1]",8608,4175,4433,393,419,0.0941317365269461,0.09451838484096549
"[0, 0, 0, 0, 0, 0, 0, 1, 1, 1]",78746,67545,11201,6493,1076,0.09612850692131172,0.0960628515311133
"[0, 0, 0, 0, 1, 0, 0, 0, 1, 0]",26706,20170,6536,1933,611,0.09583539910758553,0.09348225214198286
"[0, 0, 0, 1, 0, 0, 1, 0, 1, 1]",7085,4370,2715,424,243,0.09702517162471395,0.08950276243093923
"[0, 0, 0, 0, 0, 1, 0, 0, 1, 0]",27959,21390,6569,2138,635,0.09995324918186069,0.09666615923275994
"[1, 0, 0, 0, 0, 0, 0, 0, 1, 0]",28534,19448,9086,1879,803,0.0966166186754422,0.08837772397094432
"[0, 1, 1, 0, 0, 1, 1, 1, 0, 0]",6847,4044,2803,380,242,0.09396636993076163,0.08633606849803782
"[0, 0, 0, 0, 0, 0, 1, 0, 0, 0]",133598,111719,21879,10571,2048,0.09462132672150664,0.09360574066456419
"[1, 1, 1, 0, 1, 1, 1, 1, 1, 1]",147100,24658,122442,2363,11472,0.09583096763727796,0.09369334052040966
"[1, 0, 1, 0, 1, 1, 0, 1, 1, 1]",11048,3698,7350,333,687,0.09004867495943754,0.09346938775510204
"[1, 0, 1, 1, 1, 1, 0, 1, 1, 1]",29118,7276,21842,701,2092,0.09634414513468939,0.09577877483746909
"[0, 0, 1, 0, 1, 0, 1, 0, 0, 1]",5936,3497,2439,326,249,0.09322276236774378,0.10209102091020911
"[0, 1, 1, 0, 0, 0, 0, 0, 1, 0]",12226,8820,3406,841,317,0.0953514739229025,0.09307105108631826
"[0, 0, 0, 0, 1, 1, 0, 0, 0, 1]",16287,11050,5237,1068,480,0.09665158371040725,0.09165552797403094
"[1, 0, 0, 0, 0, 0, 0, 0, 1, 1]",22275,12773,9502,1229,901,0.09621858608001253,0.09482214270679856
"[1, 1, 0, 0, 0, 0, 1, 1, 1, 1]",33070,13885,19185,1329,1792,0.09571480014404034,0.09340630701068543
"[0, 1, 1, 0, 1, 0, 0, 0, 0, 1]",6475,3856,2619,369,238,0.09569502074688796,0.09087437953417335
"[0, 0, 1, 0, 1, 0, 1, 1, 0, 1]",4683,2436,2247,233,196,0.09564860426929392,0.08722741433021806
"[1, 0, 0, 1, 1, 0, 0, 0, 1, 0]",6881,3350,3531,312,341,0.09313432835820895,0.09657320872274143
"[0, 1, 1, 1, 1, 1, 0, 1, 0, 0]",6447,2975,3472,285,314,0.0957983193277311,0.09043778801843318
"[0, 0, 1, 1, 1, 1, 0, 1, 0, 0]",6142,3130,3012,282,264,0.0900958466453674,0.08764940239043825
"[0, 1, 1, 1, 1, 0, 0, 1, 1, 1]",29611,18450,11161,1770,1048,0.0959349593495935,0.09389839620105725
"[1, 0, 1, 0, 1, 1, 1, 1, 0, 0]",7685,3148,4537,303,451,0.09625158831003812,0.09940489310116818
"[0, 1, 0, 1, 0, 1, 1, 1, 1, 0]",6287,2713,3574,271,370,0.0998894213048286,0.10352546166759932
"[1, 1, 1, 0, 0, 1, 1, 0, 1, 1]",14015,3705,10310,326,967,0.08798920377867746,0.09379243452958293
"[1, 1, 1, 1, 1, 1, 0, 0, 0, 0]",31430,12600,18830,1196,1783,0.09492063492063492,0.09468932554434413
"[1, 0, 1, 1, 1, 0, 1, 0, 1, 1]",10131,3358,6773,284,646,0.08457415128052412,0.09537870958216448
"[1, 0, 0, 0, 1, 1, 1, 0, 1, 0]",4681,2216,2465,203,225,0.09160649819494585,0.09127789046653144
"[0, 0, 1, 1, 1, 0, 0, 0, 1, 0]",6201,3655,2546,296,225,0.08098495212038304,0.08837391987431265
"[0, 0, 1, 0, 1, 1, 1, 0, 0, 1]",5571,2792,2779,259,252,0.09276504297994269,0.0906801007556675
"[1, 0, 1, 0, 0, 0, 1, 0, 1, 0]",5251,3032,2219,285,196,0.09399736147757255,0.08832807570977919
"[1, 1, 0, 1, 0, 0, 0, 1, 1, 1]",8149,3369,4780,315,456,0.09349955476402494,0.09539748953974896
"[0, 0, 1, 0, 0, 0, 0, 1, 1, 1]",12823,8303,4520,837,448,0.10080693725159581,0.09911504424778761
"[0, 1, 0, 1, 1, 0, 0, 0, 0, 1]",7382,4244,3138,409,311,0.09637134778510839,0.09910771191841937
"[1, 1, 1, 0, 1, 0, 1, 0, 1, 1]",10749,3442,7307,323,707,0.09384079023823358,0.09675653482961544
"[1, 0, 1, 1, 1, 1, 0, 0, 0, 1]",6518,2678,3840,272,397,0.10156833457804332,0.10338541666666666
"[1, 0, 1, 1, 1, 1, 1, 0, 0, 1]",13389,4309,9080,409,841,0.09491761429566024,0.09262114537444933
"[1, 1, 0, 1, 1, 1, 1, 1, 0, 0]",13537,4343,9194,392,929,0.09026018880957863,0.10104415923428323
"[1, 1, 1, 1, 0, 0, 1, 0, 0, 1]",7714,3121,4593,273,465,0.087471964114066,0.10124101894186806
"[1, 1, 0, 1, 0, 0, 0, 1, 0, 1]",4605,2253,2352,220,226,0.09764758100310697,0.09608843537414966
"[0, 1, 1, 1, 0, 0, 0, 0, 0, 1]",7181,4386,2795,396,249,0.09028727770177838,0.089087656529517
"[0, 1, 1, 0, 1, 0, 0, 1, 0, 1]",4691,2484,2207,236,232,0.09500805152979067,0.10512007249660173
"[1, 1, 0, 1, 1, 0, 0, 0, 0, 0]",8509,4791,3718,430,373,0.08975161761636402,0.10032275416890801
"[0, 1, 1, 0, 1, 0, 1, 0, 1, 0]",4535,2338,2197,213,224,0.09110350727117195,0.10195721438324988
"[1, 0, 0, 1, 1, 0, 1, 1, 1, 0]",6174,2294,3880,223,349,0.0972101133391456,0.08994845360824742
"[0, 1, 0, 0, 1, 1, 0, 1, 1, 1]",6852,3043,3809,269,357,0.08839960565231679,0.0937253872407456
"[1, 0, 1, 1, 0, 1, 1, 0, 1, 0]",5272,2203,3069,197,299,0.08942351339083068,0.09742587161942001
"[0, 1, 1, 1, 0, 0, 0, 1, 0, 0]",6064,3666,2398,349,243,0.09519912711402073,0.10133444537114263
"[0, 1, 1, 0, 0, 1, 0, 0, 1, 1]",6623,3876,2747,394,259,0.10165118679050568,0.09428467419002548
"[0, 1, 1, 0, 0, 1, 0, 1, 1, 0]",5128,2807,2321,273,221,0.09725685785536159,0.0952175786299009
"[0, 0, 0, 0, 0, 0, 0, 0, 1, 1]",127817,102481,25336,9874,2372,0.09634956723685366,0.09362172402904957
"[1, 0, 1, 0, 0, 0, 0, 0, 0, 1]",12315,7932,4383,802,389,0.1011094301563288,0.08875199634953228
"[1, 1, 1, 0, 0, 1, 1, 1, 1, 0]",25804,5112,20692,479,1948,0.09370109546165885,0.09414266383143244
"[1, 1, 0, 0, 0, 0, 1, 1, 1, 0]",7814,3780,4034,381,378,0.1007936507936508,0.09370352007932573
"[1, 1, 0, 1, 1, 0, 0, 0, 0, 1]",6682,3235,3447,312,326,0.0964451313755796,0.09457499274731651
"[1, 0, 0, 0, 1, 0, 1, 1, 1, 0]",4937,2311,2626,210,230,0.09086975335352661,0.08758568164508758
"[0, 0, 0, 1, 0, 0, 0, 1, 0, 0]",26764,20285,6479,1868,596,0.09208774956864678,0.09198950455317179
"[0, 0, 1, 0, 0, 1, 0, 1, 0, 0]",9929,6743,3186,671,310,0.09951060358890701,0.0973006905210295
"[0, 1, 0, 0, 0, 1, 0, 0, 1, 0]",9219,6194,3025,607,295,0.09799806264126575,0.09752066115702479
"[1, 0, 0, 1, 1, 0, 0, 0, 0, 0]",26982,10404,16578,1013,1556,0.09736639753940791,0.09385933164434793
"[0, 0, 1, 0, 1, 1, 1, 0, 0, 0]",6828,4043,2785,403,285,0.09967845659163987,0.10233393177737882
"[1, 0, 1, 1, 1, 1, 1, 1, 1, 1]",153959,27256,126703,2646,11816,0.09707954211916642,0.09325746036005461
"[1, 1, 0, 0, 1, 0, 1, 1, 1, 1]",13695,4691,9004,455,862,0.09699424429759113,0.09573522878720568
"[1, 0, 1, 1, 0, 1, 1, 1, 1, 1]",31297,7830,23467,744,2147,0.0950191570881226,0.09149017769633955
"[1, 1, 0, 1, 0, 1, 1, 0, 1, 1]",10372,3458,6914,329,665,0.0951417004048583,0.09618166039919004
"[1, 1, 0, 0, 0, 0, 0, 1, 0, 1]",7454,4287,3167,389,290,0.0907394448332167,0.09156930849384275
"[1, 0, 0, 0, 0, 1, 1, 0, 0, 0]",26131,10293,15838,1010,1472,0.09812493927912173,0.09294102790756409
"[0, 1, 0, 0, 0, 0, 1, 1, 0, 1]",5945,3484,2461,328,236,0.09414466130884042,0.09589597724502234
"[1, 0, 0, 1, 0, 1, 0, 1, 1, 0]",4873,2303,2570,212,228,0.09205384281372124,0.088715953307393
"[0, 0, 1, 0, 1, 1, 0, 0, 1, 1]",7038,3689,3349,343,300,0.09297912713472485,0.08957897879964169
"[0, 1, 0, 0, 1, 1, 0, 0, 0, 1]",6254,3712,2542,385,251,0.10371767241379311,0.0987411487018096
"[1, 1, 0, 0, 0, 1, 1, 1, 1, 0]",8024,3406,4618,336,451,0.09864944216089254,0.09766132524902556
"[0, 1, 1, 1, 1, 0, 0, 0, 1, 1]",9184,4994,4190,486,420,0.09731678013616339,0.10023866348448687
"[1, 1, 1, 0, 1, 0, 1, 1, 0, 0]",6865,2776,4089,298,409,0.10734870317002881,0.1000244558571778
"[0, 1, 1, 0, 0, 1, 0, 1, 1, 1]",8226,4385,3841,402,350,0.09167616875712657,0.09112210361884926
"[1, 1, 1, 1, 0, 1, 1, 0, 1, 1]",29475,7411,22064,712,2035,0.09607340439886655,0.09223168963016679
"[1, 1, 1, 0, 1, 1, 1, 0, 0, 1]",12342,3939,8403,423,852,0.10738766184310738,0.10139235987147448
"[1, 1, 1, 1, 1, 1, 0, 1, 0, 1]",30380,7235,23145,673,2260,0.0930200414651002,0.0976452797580471
"[0, 0, 0, 0, 0, 0, 1, 0, 1, 0]",29456,22365,7091,2197,655,0.09823384752962218,0.09237061063319701
"[0, 0, 0, 0, 1, 0, 1, 0, 0, 0]",29025,21919,7106,2079,669,0.09484921757379443,0.09414579228820714
"[1, 0, 1, 1, 1, 0, 1, 1, 0, 1]",9483,3190,6293,280,608,0.0877742946708464,0.09661528682663277
"[1, 0, 1, 0, 1, 1, 1, 0, 1, 1]",10235,3363,6872,321,646,0.09545049063336307,0.0940046565774156
"[1, 0, 1, 0, 0, 0, 1, 0, 0, 1]",5663,3303,2360,344,240,0.10414774447471996,0.1016949152542373
"[0, 0, 0, 1, 1, 1, 0, 0, 0, 1]",7319,4519,2800,414,265,0.09161318875857491,0.09464285714285714
"[0, 0, 1, 0, 0, 0, 1, 1, 1, 0]",5932,3526,2406,345,246,0.09784458309699376,0.10224438902743142
"[1, 0, 1, 1, 1, 1, 1, 1, 0, 0]",15791,5222,10569,470,996,0.09000382995021065,0.09423786545557764
"[0, 1, 0, 1, 1, 1, 1, 1, 1, 0]",11487,4134,7353,393,699,0.09506531204644413,0.09506323949408405
"[1, 0, 1, 1, 0, 1, 1, 1, 0, 1]",9326,3024,6302,282,591,0.09325396825396826,0.09377975245953665
"[0, 0, 1, 1, 0, 0, 1, 1, 1, 0]",7747,3983,3764,367,344,0.09214160180768265,0.09139213602550478
"[1, 0, 0, 1, 0, 0, 1, 1, 0, 0]",7482,4326,3156,373,263,0.08622283865002311,0.08333333333333333
"[1, 1, 0, 0, 1, 0, 0, 0, 1, 0]",5779,3336,2443,330,278,0.09892086330935251,0.11379451494064674
"[0, 0, 1, 1, 1, 1, 0, 1, 1, 1]",15814,5691,10123,566,962,0.09945528026708839,0.09503111725772992
"[0, 0, 1, 1, 0, 1, 0, 0, 0, 1]",6406,3850,2556,380,272,0.0987012987012987,0.10641627543035993
"[1, 1, 1, 1, 1, 0, 0, 0, 1, 0]",7493,2551,4942,235,460,0.09212073696589573,0.09307972480777013
"[0, 1, 1, 0, 0, 1, 1, 1, 1, 0]",16741,11677,5064,1065,473,0.09120493277382889,0.0934044233807267
"[0, 1, 1, 1, 1, 0, 0, 0, 1, 0]",6056,3595,2461,344,255,0.0956884561891516,0.10361641609101992
"[1, 1, 0, 1, 0, 1, 0, 1, 1, 0]",5666,2323,3343,203,289,0.08738699956952217,0.0864492970385881
"[0, 1, 0, 0, 0, 0, 0, 1, 0, 1]",10128,6794,3334,626,275,0.09214012363850456,0.08248350329934014
"[0, 0, 1, 0, 1, 0, 0, 1, 1, 1]",7326,4064,3262,413,332,0.1016240157480315,0.10177805027590435
"[1, 0, 0, 0, 0, 1, 0, 0, 1, 1]",8243,4234,4009,411,375,0.09707132735002362,0.09353953604390122
"[1, 0, 1, 1, 0, 0, 1, 1, 1, 1]",16567,5654,10913,551,1040,0.09745313052706049,0.09529918445890223
"[1, 0, 1, 0, 1, 1, 0, 0, 1, 1]",7806,3295,4511,318,433,0.09650986342943854,0.09598758590113057
"[1, 0, 0, 1, 0, 0, 1, 1, 0, 1]",4844,2315,2529,230,241,0.09935205183585313,0.09529458283906682
"[0, 1, 1, 1, 0, 0, 1, 0, 0, 1]",5247,2785,2462,249,215,0.08940754039497308,0.08732737611697806
"[0, 1, 0, 0, 0, 1, 1, 0, 1, 1]",5212,2686,2526,265,226,0.09865971705137751,0.0894695170229612
"[1, 1, 0, 1, 1, 0, 0, 1, 1, 0]",7400,3112,4288,285,391,0.09158097686375322,0.09118470149253731
"[0, 0, 1, 0, 0, 1, 0, 0, 0, 1]",10395,6977,3418,678,318,0.09717643686398166,0.0930368636629608
"[0, 1, 0, 0, 1, 1, 1, 1, 0, 0]",8179,4213,3966,440,399,0.10443864229765012,0.10060514372163389
"[1, 0, 1, 0, 0, 1, 1, 1, 1, 0]",7189,3060,4129,306,419,0.1,0.10147735529183821
"[0, 1, 1, 1, 0, 0, 0, 0, 1, 0]",5954,3588,2366,335,222,0.09336677814938685,0.09382924767540152
"[0, 0, 1, 1, 0, 1, 0, 1, 0, 0]",6281,3737,2544,379,264,0.10141824993310142,0.10377358490566038
"[1, 1, 0, 0, 1, 0, 1, 0, 0, 1]",5300,2560,2740,251,269,0.098046875,0.09817518248175182
"[1, 1, 0, 1, 0, 0, 1, 0, 1, 0]",4552,2213,2339,199,228,0.08992318120198825,0.09747755451047456
"[1, 0, 0, 0, 0, 1, 0, 1, 0, 1]",6244,3226,3018,317,293,0.09826410415375078,0.09708416169648774
"[0, 1, 1, 1, 0, 1, 0, 0, 0, 0]",6827,4141,2686,410,246,0.09900990099009901,0.09158600148920328
"[1, 1, 0, 0, 0, 1, 0, 0, 0, 1]",6653,3830,2823,359,276,0.09373368146214099,0.09776833156216791
"[0, 1, 0, 1, 0, 0, 1, 0, 1, 1]",5156,2694,2462,272,256,0.10096510764662213,0.10398050365556458
"[1, 0, 1, 0, 1, 1, 1, 1, 1, 0]",10455,3454,7001,323,624,0.09351476548928778,0.08913012426796171
"[0, 1, 1, 1, 1, 1, 0, 0, 1, 0]",6149,2931,3218,285,315,0.09723643807574207,0.09788688626476072
"[1, 1, 1, 1, 0, 1, 1, 1, 1, 1]",145973,24421,121552,2298,11406,0.09409934073133779,0.09383638278267738
"[1, 1, 0, 0, 0, 1, 1, 0, 0, 0]",8603,4942,3661,496,359,0.10036422501011737,0.09806063916962579
"[0, 1, 0, 0, 0, 0, 0, 0, 1, 1]",18895,12832,6063,1196,611,0.09320448877805486,0.10077519379844961
"[0, 1, 0, 1, 1, 1, 0, 1, 1, 0]",5598,2374,3224,226,303,0.09519797809604044,0.09398263027295285
"[0, 0, 1, 0, 0, 0, 1, 0, 0, 0]",27260,20540,6720,2014,624,0.09805258033106135,0.09285714285714286
"[1, 1, 0, 0, 1, 1, 0, 0, 0, 0]",28738,16359,12379,1448,1135,0.08851396784644538,0.09168753534211165
"[0, 0, 1, 1, 1, 0, 0, 0, 0, 0]",15367,10303,5064,966,472,0.0937590992914685,0.09320695102685624
"[0, 0, 0, 1, 1, 0, 1, 1, 0, 0]",7386,4641,2745,423,290,0.09114414996767937,0.10564663023679417
"[1, 1, 1, 1, 1, 1, 0, 1, 1, 1]",147352,24225,123127,2278,11759,0.09403508771929825,0.09550301720987274
"[0, 0, 1, 1, 1, 1, 1, 1, 1, 1]",90833,25679,65154,2435,6138,0.09482456481950231,0.09420756975780459
"[1, 0, 0, 1, 1, 1, 1, 1, 1, 1]",78710,11437,67273,1110,6332,0.09705342310046342,0.09412394274077267
"[1, 1, 1, 0, 0, 1, 1, 1, 1, 1]",78816,11381,67435,1072,6359,0.0941920745101485,0.0942982130940906
"[1, 1, 1, 1, 1, 0, 0, 1, 1, 1]",78972,12038,66934,1138,6415,0.09453397574347898,0.09584067887770042
"[1, 1, 0, 1, 1, 0, 1, 0, 1, 1]",10420,3396,7024,329,678,0.09687868080094228,0.09652619589977221
"[1, 1, 1, 1, 1, 0, 1, 1, 0, 1]",28213,6610,21603,641,1994,0.09697428139183056,0.09230199509327408
"[1, 0, 0, 1, 0, 0, 1, 0, 0, 0]",10290,6590,3700,616,363,0.09347496206373293,0.0981081081081081
"[0, 0, 0, 1, 1, 1, 1, 1, 1, 1]",33682,21181,12501,2035,1221,0.09607667248949531,0.09767218622510199
"[0, 1, 0, 1, 1, 0, 1, 1, 1, 0]",5489,2312,3177,234,275,0.10121107266435986,0.08655964746616304
"[1, 0, 0, 1, 1, 0, 1, 1, 1, 1]",14251,4036,10215,382,975,0.09464816650148662,0.09544787077826726
"[1, 1, 0, 0, 0, 1, 0, 1, 1, 0]",5227,2583,2644,246,263,0.09523809523809523,0.09947049924357035
"[1, 1, 0, 1, 0, 0, 1, 1, 0, 0]",6355,3115,3240,284,309,0.09117174959871589,0.09537037037037037
"[0, 1, 1, 0, 1, 1, 0, 1, 1, 1]",11601,4600,7001,440,686,0.09565217391304348,0.09798600199971433
"[1, 1, 0, 0, 0, 1, 1, 0, 1, 0]",4943,2457,2486,262,242,0.10663410663410663,0.09734513274336283
"[1, 1, 1, 0, 1, 0, 1, 1, 1, 1]",32226,7863,24363,771,2274,0.09805417779473484,0.09333825883511883
"[0, 0, 0, 1, 1, 0, 0, 0, 1, 1]",10860,7560,3300,716,343,0.09470899470899471,0.10393939393939394
"[1, 0, 0, 0, 1, 0, 0, 0, 0, 1]",11228,7113,4115,694,414,0.09756783354421482,0.10060753341433779
"[0, 0, 0, 0, 1, 0, 1, 0, 0, 1]",11259,7684,3575,761,354,0.09903695991671005,0.09902097902097902
"[0, 1, 1, 1, 0, 1, 1, 0, 1, 1]",10539,3848,6691,340,646,0.08835758835758836,0.09654760125541773
"[1, 1, 0, 0, 1, 0, 0, 0, 0, 0]",13082,8363,4719,760,448,0.09087647973215353,0.0949353676626404
"[1, 0, 1, 0, 0, 1, 0, 0, 1, 0]",5267,3008,2259,301,203,0.10006648936170212,0.08986277113767153
"[1, 1, 1, 0, 1, 1, 1, 1, 0, 0]",13862,4387,9475,415,884,0.0945976749487121,0.0932981530343008
"[0, 1, 1, 1, 1, 1, 1, 0, 0, 1]",26582,16070,10512,1529,951,0.09514623522090852,0.09046803652968037
"[0, 0, 0, 1, 1, 1, 0, 1, 0, 1]",5449,3067,2382,304,204,0.09911966090642321,0.08564231738035265
"[0, 0, 1, 1, 0, 0, 0, 0, 1, 1]",31582,18679,12903,1793,1233,0.09599014936559773,0.095559172285515
"[1, 1, 0, 0, 1, 0, 1, 1, 0, 1]",5951,2416,3535,253,318,0.10471854304635761,0.08995756718528995
"[1, 1, 0, 1, 1, 1, 0, 1, 1, 0]",9741,3141,6600,306,631,0.09742120343839542,0.09560606060606061
"[1, 0, 0, 1, 1, 1, 1, 1, 1, 0]",25155,5027,20128,469,1990,0.09329620051720708,0.09886724960254371
"[1, 0, 0, 0, 0, 1, 1, 0, 1, 1]",7470,2796,4674,244,473,0.08726752503576538,0.10119811724433034
"[1, 0, 0, 0, 0, 0, 1, 1, 0, 0]",16182,10060,6122,958,554,0.0952286282306163,0.09049330284220843
"[1, 1, 0, 0, 1, 0, 0, 1, 0, 0]",6224,3549,2675,347,231,0.09777402085094393,0.08635514018691588
"[1, 1, 1, 1, 1, 1, 0, 0, 0, 1]",16881,5432,11449,530,1079,0.0975699558173785,0.09424403878067954
"[1, 1, 0, 1, 0, 1, 1, 1, 0, 0]",6728,2708,4020,274,363,0.10118168389955687,0.09029850746268657
"[0, 0, 1, 0, 1, 0, 1, 0, 0, 0]",10310,6916,3394,680,316,0.09832272990167727,0.09310548025928109
"[0, 1, 0, 0, 0, 0, 1, 0, 0, 1]",10148,6780,3368,666,308,0.09823008849557523,0.09144893111638955
"[0, 1, 1, 1, 1, 1, 0, 0, 1, 1]",17179,6800,10379,634,988,0.09323529411764706,0.09519221504961943
"[0, 0, 1, 1, 1, 0, 1, 1, 0, 1]",6170,2643,3527,259,350,0.09799470298902763,0.09923447689254324
"[0, 0, 0, 1, 1, 1, 1, 1, 0, 0]",8272,4862,3410,458,353,0.0941999177293295,0.10351906158357771
"[1, 0, 0, 1, 1, 0, 1, 1, 0, 1]",6266,2324,3942,249,386,0.10714285714285714,0.09791983764586504
"[1, 1, 0, 0, 1, 1, 1, 0, 0, 1]",8407,3436,4971,341,458,0.09924330616996507,0.09213437940052303
"[0, 1, 1, 1, 0, 1, 0, 0, 1, 0]",4560,2412,2148,239,207,0.09908789386401327,0.09636871508379888
"[0, 1, 1, 0, 1, 1, 0, 0, 1, 0]",4731,2494,2237,217,196,0.08700882117080995,0.08761734465802413
"[1, 1, 1, 1, 1, 1, 0, 1, 0, 0]",12587,3986,8601,371,845,0.09307576517812344,0.09824439018718753
"[0, 1, 1, 0, 0, 0, 1, 1, 1, 0]",5439,3008,2431,295,241,0.09807180851063829,0.09913615795968737
"[1, 0, 1, 0, 1, 0, 1, 0, 0, 1]",4773,2368,2405,243,228,0.10261824324324324,0.09480249480249481
"[1, 0, 1, 0, 1, 0, 1, 0, 1, 0]",4447,2236,2211,205,204,0.09168157423971378,0.09226594301221167
"[0, 0, 1, 1, 0, 1, 0, 1, 0, 1]",4990,2543,2447,227,235,0.08926464805348014,0.09603596240294238
"[1, 0, 1, 0, 1, 0, 1, 0, 0, 0]",5787,3285,2502,318,219,0.09680365296803653,0.08752997601918465
"[0, 0, 1, 0, 1, 0, 1, 1, 1, 1]",7837,3527,4310,363,420,0.10292032889140913,0.09744779582366589
"[1, 0, 0, 0, 1, 1, 1, 1, 1, 0]",6911,2795,4116,277,387,0.09910554561717352,0.09402332361516035
"[0, 0, 1, 0, 0, 1, 1, 1, 1, 1]",10032,4576,5456,458,540,0.10008741258741259,0.09897360703812316
"[1, 1, 1, 1, 0, 0, 0, 0, 1, 0]",7718,3801,3917,331,360,0.08708234675085504,0.09190707173857544
"[1, 1, 1, 1, 1, 0, 0, 1, 0, 1]",12543,3568,8975,336,851,0.09417040358744394,0.09481894150417827
"[0, 1, 1, 0, 1, 0, 0, 1, 0, 0]",5997,3606,2391,336,216,0.09317803660565724,0.0903387703889586
"[1, 0, 0, 1, 1, 1, 1, 1, 0, 0]",9386,3233,6153,303,556,0.09372100216517167,0.0903624248334146
"[1, 0, 1, 1, 1, 0, 1, 0, 0, 0]",4929,2384,2545,248,238,0.1040268456375839,0.09351669941060904
"[0, 1, 0, 1, 1, 1, 0, 1, 0, 0]",4548,2368,2180,225,238,0.09501689189189189,0.10917431192660551
"[0, 1, 1, 1, 1, 1, 0, 1, 1, 1]",31655,10168,21487,947,2085,0.09313532651455547,0.09703541676362452
"[0, 0, 0, 0, 0, 1, 1, 0, 0, 1]",28224,22631,5593,2183,542,0.09646060713181034,0.09690684784552119
"[1, 1, 0, 0, 0, 0, 0, 0, 0, 0]",82746,59595,23151,5700,2159,0.0956456078530078,0.09325731069932185
"[0, 1, 1, 0, 0, 0, 0, 0, 0, 0]",70943,60554,10389,5750,1009,0.09495656769164712,0.09712195591491
"[0, 1, 1, 0, 0, 1, 1, 0, 0, 0]",20388,16273,4115,1502,385,0.0923001290481165,0.09356014580801944
"[1, 0, 0, 0, 1, 1, 0, 0, 1, 1]",8848,4276,4572,432,442,0.10102899906454631,0.09667541557305337
"[1, 1, 1, 0, 1, 1, 0, 1, 0, 0]",6006,2403,3603,238,356,0.09904286308780691,0.09880655009714127
"[0, 1, 0, 0, 0, 1, 0, 1, 1, 1]",6235,3414,2821,321,255,0.09402460456942004,0.09039347749025169
"[0, 0, 0, 1, 0, 0, 0, 1, 0, 1]",10381,7036,3345,655,326,0.09309266628766344,0.09745889387144993
"[1, 0, 0, 0, 1, 0, 1, 0, 0, 0]",10502,6705,3797,626,400,0.09336316181953766,0.10534632604687912
"[1, 0, 1, 0, 0, 0, 1, 0, 0, 0]",9898,6499,3399,618,297,0.09509155254654562,0.08737864077669903
"[0, 0, 0, 1, 1, 1, 0, 1, 0, 0]",6552,4137,2415,403,237,0.09741358472322939,0.09813664596273292
"[1, 0, 0, 0, 1, 0, 0, 1, 0, 0]",9866,6232,3634,624,376,0.10012836970474968,0.10346725371491469
"[0, 0, 1, 0, 0, 1, 0, 1, 1, 1]",6846,3810,3036,383,301,0.1005249343832021,0.09914361001317523
"[0, 0, 0, 0, 1, 0, 0, 0, 0, 0]",135447,112739,22708,10772,2123,0.09554812442899085,0.09349128060595385
"[1, 0, 1, 1, 0, 0, 0, 0, 0, 0]",15368,9771,5597,940,534,0.09620304984136731,0.0954082544220118
"[0, 0, 1, 0, 1, 1, 0, 0, 0, 0]",12892,8596,4296,792,411,0.0921358771521638,0.09567039106145252
"[1, 0, 1, 1, 0, 0, 0, 0, 1, 0]",5703,3349,2354,322,226,0.0961481039116154,0.09600679694137638
"[0, 0, 1, 0, 0, 0, 0, 0, 0, 0]",141958,117153,24805,11161,2412,0.0952685804034041,0.09723845998790566
"[0, 1, 1, 1, 1, 1, 1, 0, 1, 1]",30877,10614,20263,1054,1904,0.09930280761258715,0.0939643685535212
"[1, 0, 0, 1, 0, 1, 1, 1, 1, 1]",13319,4316,9003,396,877,0.0917516218721038,0.0974119737865156
"[1, 1, 1, 1, 1, 1, 0, 0, 1, 1]",87269,22293,64976,2085,6144,0.09352711613510968,0.09455799064269885
"[1, 0, 1, 1, 0, 1, 0, 1, 1, 0]",5579,2311,3268,214,325,0.09260060579835569,0.09944920440636475
"[0, 1, 0, 0, 1, 0, 0, 0, 0, 1]",10760,7120,3640,707,356,0.09929775280898877,0.0978021978021978
"[1, 1, 1, 1, 0, 0, 0, 0, 1, 1]",31725,12952,18773,1182,1872,0.09126003705991352,0.09971767964630054
"[0, 0, 0, 1, 1, 0, 1, 0, 0, 0]",11525,8067,3458,769,346,0.09532663939506632,0.10005783689994216
"[0, 0, 1, 0, 0, 1, 0, 1, 0, 1]",5551,3259,2292,337,209,0.10340595274624118,0.0911867364746946
"[0, 1, 1, 1, 0, 0, 1, 1, 0, 1]",5929,2585,3344,252,325,0.09748549323017408,0.097188995215311
"[1, 0, 1, 1, 0, 0, 0, 1, 1, 1]",8000,3299,4701,327,496,0.09912094574113367,0.10550946607104872
"[1, 0, 0, 1, 1, 1, 1, 0, 0, 0]",16007,4173,11834,428,1133,0.10256410256410256,0.09574108500929525
"[1, 1, 0, 1, 0, 1, 1, 0, 0, 0]",5781,2785,2996,275,304,0.09874326750448834,0.10146862483311081
"[0, 0, 0, 0, 0, 1, 0, 0, 1, 1]",17948,13140,4808,1230,472,0.09360730593607305,0.09816971713810316
"[1, 0, 0, 1, 0, 0, 0, 0, 0, 0]",32202,22949,9253,2201,912,0.09590831844524816,0.09856262833675565
"[1, 0, 0, 0, 0, 0, 0, 1, 0, 0]",29275,19702,9573,1796,857,0.09115825804486855,0.08952261568996135
"[1, 0, 1, 1, 1, 0, 0, 1, 1, 1]",14456,4790,9666,426,943,0.08893528183716075,0.09755845230705566
"[1, 0, 1, 0, 1, 1, 1, 1, 1, 1]",33188,8446,24742,790,2327,0.0935354013734312,0.09405060221485732
"[0, 1, 0, 0, 0, 0, 1, 0, 1, 0]",9445,6286,3159,629,324,0.10006363347120585,0.10256410256410256
"[0, 1, 1, 1, 0, 1, 0, 1, 1, 1]",11652,4484,7168,428,748,0.09545049063336307,0.10435267857142858
"[1, 1, 1, 1, 0, 1, 1, 1, 0, 1]",27342,6663,20679,626,2023,0.09395167342038122,0.09782871512162097
"[1, 0, 0, 0, 0, 0, 1, 0, 0, 0]",28132,19780,8352,1844,796,0.09322548028311425,0.09530651340996169
"[0, 0, 0, 1, 1, 1, 1, 0, 0, 1]",16656,12442,4214,1161,392,0.09331297219096608,0.09302325581395349
"[1, 1, 1, 0, 0, 0, 0, 1, 1, 0]",16191,4257,11934,408,1146,0.09584214235377025,0.09602815485168427
"[1, 1, 1, 0, 0, 0, 1, 0, 1, 1]",7466,2767,4699,238,441,0.08601373328514637,0.0938497552670781
"[0, 1, 0, 0, 1, 0, 0, 1, 1, 0]",6494,3820,2674,321,262,0.08403141361256544,0.09798055347793568
"[1, 0, 1, 0, 0, 0, 1, 0, 1, 1]",5088,2611,2477,254,235,0.09728073535044045,0.09487283003633427
"[0, 1, 1, 0, 0, 0, 0, 0, 1, 1]",11900,8205,3695,755,387,0.09201706276660573,0.1047361299052774
"[0, 1, 0, 0, 1, 0, 0, 1, 1, 1]",7074,3876,3198,369,317,0.09520123839009288,0.09912445278298937
"[0, 0, 1, 0, 0, 1, 0, 1, 1, 0]",5793,3387,2406,317,235,0.0935931502804842,0.09767248545303409
"[1, 0, 0, 0, 1, 1, 1, 1, 0, 0]",8402,4010,4392,366,419,0.0912718204488778,0.09540072859744991
"[0, 1, 1, 0, 1, 1, 0, 0, 0, 1]",5279,2782,2497,273,262,0.09813084112149532,0.10492591109331198
"[0, 1, 1, 0, 1, 0, 1, 1, 0, 0]",5372,2777,2595,275,251,0.09902772776377386,0.09672447013487476
"[0, 0, 1, 1, 1, 0, 1, 0, 1, 0]",4803,2431,2372,235,207,0.09666803784450843,0.0872681281618887
"[1, 1, 1, 1, 0, 1, 1, 0, 0, 1]",12871,4133,8738,404,868,0.09774981853375272,0.0993362325474937
"[1, 1, 1, 0, 0, 1, 0, 0, 1, 0]",5121,2346,2775,214,262,0.09121909633418585,0.09441441441441441
"[1, 0, 1, 1, 0, 0, 1, 0, 0, 0]",5985,3414,2571,310,220,0.09080257762155829,0.08556981719175417
"[0, 0, 1, 1, 0, 1, 0, 0, 1, 0]",5972,3552,2420,331,219,0.09318693693693694,0.09049586776859504
"[0, 0, 0, 1, 1, 0, 1, 1, 1, 0]",5289,2896,2393,286,252,0.09875690607734806,0.10530714584203928
"[0, 1, 0, 1, 0, 1, 1, 1, 1, 1]",12312,4513,7799,466,713,0.10325725681364946,0.0914219771765611
"[1, 1, 0, 0, 0, 1, 0, 0, 1, 1]",6676,3321,3355,326,336,0.09816320385426076,0.10014903129657228
"[1, 0, 0, 1, 1, 1, 0, 1, 1, 0]",6258,2351,3907,205,386,0.08719693747341557,0.09879703097005375
"[0, 1, 1, 1, 0, 0, 1, 1, 1, 0]",6375,2775,3600,289,342,0.10414414414414415,0.095
"[0, 1, 0, 1, 1, 0, 0, 0, 1, 0]",5561,3259,2302,303,217,0.09297330469469162,0.09426585577758471
"[1, 1, 0, 1, 0, 0, 1, 0, 0, 0]",6152,3603,2549,374,255,0.10380238689980571,0.10003923107100823
"[0, 0, 1, 1, 0, 0, 1, 0, 0, 1]",7366,4316,3050,443,286,0.10264133456904541,0.09377049180327869
"[0, 1, 0, 1, 0, 1, 0, 1, 1, 1]",6756,3044,3712,276,340,0.09067017082785808,0.09159482758620689
"[0, 1, 0, 0, 1, 0, 1, 0, 1, 0]",5308,3082,2226,285,193,0.09247242050616483,0.0867026055705301
"[1, 1, 0, 1, 1, 0, 0, 1, 0, 1]",5673,2356,3317,193,309,0.08191850594227504,0.09315646668676515
"[0, 1, 1, 0, 1, 1, 0, 1, 1, 0]",5753,2572,3181,250,291,0.09720062208398134,0.09148066645708897
"[0, 0, 1, 1, 1, 0, 1, 0, 0, 1]",5388,2712,2676,253,237,0.09328908554572271,0.08856502242152467
"[0, 1, 0, 1, 0, 1, 1, 1, 0, 1]",5389,2288,3101,229,299,0.10008741258741259,0.0964205095130603
"[1, 1, 1, 0, 1, 1, 0, 0, 1, 0]",5756,2335,3421,226,316,0.09678800856531049,0.0923706518561824
"[1, 0, 0, 1, 1, 1, 0, 1, 0, 1]",6154,2197,3957,199,371,0.09057806099226218,0.09375789739701794
"[0, 1, 0, 1, 0, 0, 1, 1, 1, 0]",4718,2368,2350,223,209,0.0941722972972973,0.08893617021276595
"[1, 0, 1, 1, 1, 0, 1, 0, 1, 0]",5360,2217,3143,193,322,0.08705457825890843,0.10244988864142539
"[1, 1, 0, 0, 1, 1, 1, 1, 1, 0]",15237,5050,10187,494,948,0.09782178217821783,0.09305978207519387
"[1, 0, 0, 0, 0, 0, 0, 0, 0, 1]",47347,25074,22273,2367,2108,0.09440057430007179,0.09464373905625645
"[0, 0, 0, 1, 1, 0, 1, 1, 0, 1]",5372,2962,2410,271,229,0.09149223497636733,0.0950207468879668
"[1, 1, 0, 1, 0, 0, 0, 0, 0, 0]",13310,8484,4826,786,463,0.09264497878359264,0.09593866556154165
"[0, 1, 1, 0, 1, 0, 0, 0, 0, 0]",12043,8196,3847,780,342,0.0951683748169839,0.08890044190278139
"[1, 0, 1, 1, 1, 0, 1, 1, 0, 0]",6194,2532,3662,240,357,0.0947867298578199,0.09748771163298744
"[0, 0, 1, 0, 1, 0, 0, 0, 0, 0]",30555,22705,7850,2119,752,0.09332746091169346,0.09579617834394905
"[1, 1, 0, 0, 0, 0, 1, 0, 0, 0]",12713,8418,4295,789,434,0.09372772630078403,0.1010477299185099
"[0, 1, 1, 0, 0, 0, 0, 1, 0, 0]",12604,9236,3368,880,344,0.09527934170636639,0.1021377672209026
"[0, 1, 0, 0, 1, 0, 1, 1, 1, 1]",7357,3295,4062,353,422,0.1071320182094082,0.10388970950270802
"[0, 0, 0, 0, 0, 0, 0, 1, 0, 0]",135020,113696,21324,10831,2045,0.09526280607936954,0.0959013318326768
"[0, 1, 1, 0, 1, 1, 0, 0, 1, 1]",8077,3648,4429,343,402,0.09402412280701754,0.0907654097990517
"[0, 0, 0, 1, 0, 1, 1, 0, 0, 0]",11989,8187,3802,805,362,0.09832661536582386,0.09521304576538664
"[1, 1, 0, 0, 0, 0, 1, 0, 1, 1]",7174,3546,3628,341,331,0.09616469261139311,0.0912348401323043
"[0, 1, 1, 0, 1, 1, 0, 0, 0, 0]",7905,4697,3208,468,291,0.09963806685118161,0.09071072319201995
"[1, 1, 1, 0, 0, 0, 1, 1, 0, 1]",6589,2409,4180,252,434,0.10460772104607721,0.10382775119617225
"[1, 0, 1, 1, 1, 0, 1, 1, 1, 1]",29910,7633,22277,744,2009,0.09747150530590855,0.09018269964537415
"[0, 1, 1, 0, 1, 1, 1, 1, 1, 1]",34295,10121,24174,976,2277,0.0964331587787768,0.09419210722263589
"[1, 0, 1, 0, 1, 0, 0, 1, 1, 1]",7553,3145,4408,289,488,0.0918918918918919,0.11070780399274047
"[0, 0, 0, 0, 1, 0, 1, 0, 1, 0]",10136,6745,3391,624,321,0.09251297257227575,0.09466234149218519
"[1, 1, 0, 0, 1, 0, 1, 0, 0, 0]",6565,3783,2782,338,296,0.08934707903780069,0.10639827462257369
"[0, 1, 0, 0, 0, 1, 1, 0, 0, 0]",13293,8944,4349,832,403,0.09302325581395349,0.09266498045527707
"[0, 0, 0, 1, 0, 1, 0, 0, 0, 1]",10644,7238,3406,684,317,0.09450124343741365,0.09307105108631826
"[1, 1, 0, 1, 1, 1, 0, 0, 0, 0]",6869,3270,3599,294,310,0.08990825688073395,0.08613503751041957
"[1, 0, 1, 1, 0, 1, 1, 1, 0, 0]",6444,2579,3865,242,360,0.09383481969755719,0.09314359637774904
"[0, 1, 1, 0, 1, 1, 1, 1, 0, 1]",10011,3569,6442,365,627,0.10226954328943681,0.09733002173238124
"[1, 1, 0, 1, 1, 0, 0, 0, 1, 1]",7288,3055,4233,305,424,0.09983633387888707,0.10016536735175999
"[1, 0, 1, 1, 0, 0, 0, 1, 1, 0]",5321,2617,2704,233,265,0.08903324417271685,0.09800295857988166
"[0, 0, 1, 1, 0, 0, 1, 0, 1, 1]",7077,3614,3463,369,345,0.10210293303818484,0.09962460294542304
"[0, 0, 0, 1, 0, 0, 1, 0, 0, 0]",27971,21239,6732,2086,692,0.09821554687132163,0.10279263220439691
"[0, 0, 0, 0, 1, 0, 0, 1, 0, 0]",27986,21254,6732,2040,665,0.09598193281264703,0.09878193701723113
"[1, 1, 1, 1, 0, 1, 0, 1, 1, 1]",32610,8136,24474,742,2352,0.09119960668633235,0.09610198578082864
"[0, 1, 0, 0, 1, 0, 0, 0, 1, 0]",9452,6334,3118,575,301,0.0907799179033786,0.09653624118024375
"[0, 0, 1, 0, 0, 0, 0, 1, 0, 1]",10039,6719,3320,676,314,0.10061020985265665,0.09457831325301205
"[0, 1, 1, 0, 0, 0, 0, 0, 0, 1]",27638,22419,5219,2058,489,0.09179713635755386,0.09369611036597049
"[1, 1, 0, 1, 0, 1, 1, 1, 0, 1]",9633,3125,6508,279,637,0.08928,0.09787953288260602
"[0, 1, 1, 0, 1, 0, 1, 0, 0, 0]",6107,3737,2370,389,245,0.10409419320310409,0.10337552742616034
"[1, 0, 0, 0, 0, 0, 1, 1, 1, 0]",6768,3650,3118,334,271,0.09150684931506849,0.08691468890314304
"[1, 0, 0, 0, 0, 1, 1, 1, 1, 0]",15817,4195,11622,392,1130,0.0934445768772348,0.09722939253140596
"[1, 0, 0, 1, 0, 0, 0, 1, 1, 1]",7405,3524,3881,324,351,0.09194097616345062,0.09044060809069827
"[1, 1, 1, 0, 0, 1, 0, 0, 0, 1]",5578,2534,3044,247,295,0.09747434885556433,0.0969119579500657
"[1, 0, 0, 0, 0, 0, 0, 1, 0, 1]",11788,6766,5022,655,460,0.09680756724800473,0.09159697331740342
"[1, 1, 1, 1, 0, 1, 0, 1, 0, 0]",6365,2548,3817,263,375,0.1032182103610675,0.09824469478648153
"[0, 1, 1, 1, 1, 0, 1, 0, 1, 0]",5945,2839,3106,283,313,0.09968298696724198,0.10077269800386349
"[0, 0, 0, 1, 1, 0, 0, 0, 0, 1]",27652,22293,5359,2093,515,0.09388597317543623,0.0961000186601978
"[0, 1, 1, 0, 0, 1, 0, 0, 1, 0]",5877,3612,2265,367,217,0.10160575858250277,0.09580573951434879
"[0, 0, 1, 0, 1, 1, 0, 0, 1, 0]",5521,3226,2295,313,214,0.09702417854928705,0.09324618736383443
"[0, 1, 0, 0, 0, 1, 0, 1, 1, 0]",5877,3511,2366,305,232,0.08686983765309028,0.09805579036348266
"[0, 1, 0, 0, 1, 1, 0, 1, 0, 0]",5582,3309,2273,291,222,0.08794197642792384,0.09766827980642323
"[0, 0, 0, 0, 1, 1, 1, 1, 0, 1]",8327,4333,3994,410,395,0.0946226632817909,0.09889834752128192
"[1, 0, 0, 0, 1, 0, 1, 0, 1, 0]",5489,3055,2434,309,246,0.1011456628477905,0.10106820049301561
"[1, 1, 1, 0, 0, 0, 1, 0, 0, 1]",5820,2568,3252,249,335,0.0969626168224299,0.10301353013530136
"[1, 0, 1, 0, 0, 0, 0, 1, 0, 0]",9861,6561,3300,581,314,0.08855357415028196,0.09515151515151515
"[1, 0, 0, 0, 1, 1, 1, 0, 1, 1]",6498,2461,4037,250,394,0.10158472165786266,0.09759722566262076
"[1, 1, 0, 0, 0, 1, 1, 1, 0, 1]",6387,2604,3783,244,381,0.09370199692780339,0.1007137192704203
"[0, 0, 1, 1, 1, 1, 1, 0, 0, 0]",8297,4224,4073,386,375,0.09138257575757576,0.09206972747360667
"[0, 1, 1, 0, 0, 0, 1, 0, 1, 0]",6111,3870,2241,414,218,0.10697674418604651,0.09727800089245872
"[0, 1, 0, 0, 0, 1, 1, 1, 1, 1]",9212,4185,5027,408,514,0.0974910394265233,0.10224786154764273
"[0, 1, 1, 0, 0, 1, 0, 0, 0, 1]",6535,4128,2407,382,246,0.09253875968992248,0.10220191109264645
"[0, 0, 0, 1, 0, 0, 1, 1, 1, 1]",9404,5507,3897,541,377,0.09823860541129471,0.09674108288426995
"[1, 1, 1, 1, 0, 1, 0, 0, 0, 1]",6703,2699,4004,285,377,0.10559466469062616,0.09415584415584416
"[1, 0, 1, 0, 0, 0, 1, 1, 0, 1]",4693,2290,2403,223,239,0.09737991266375545,0.09945900957136912
"[0, 1, 0, 1, 1, 1, 0, 0, 1, 1]",7698,3281,4417,313,410,0.095397744590064,0.09282318315598823
"[0, 0, 0, 1, 0, 1, 1, 1, 1, 0]",5698,3023,2675,265,238,0.08766126364538537,0.08897196261682243
"[0, 1, 1, 1, 1, 1, 0, 0, 0, 1]",6997,3327,3670,342,341,0.10279531109107304,0.09291553133514986
"[0, 0, 0, 1, 0, 1, 0, 1, 1, 1]",7362,4264,3098,442,296,0.10365853658536585,0.09554551323434474
"[0, 0, 1, 0, 1, 0, 0, 1, 1, 0]",6557,3962,2595,362,241,0.09136799596163554,0.0928709055876686
"[0, 1, 0, 1, 0, 0, 1, 0, 1, 0]",5210,3052,2158,296,201,0.09698558322411534,0.09314179796107507
"[0, 1, 1, 0, 1, 0, 1, 0, 0, 1]",5050,2668,2382,270,251,0.10119940029985007,0.10537363560033586
"[0, 1, 0, 0, 1, 1, 0, 1, 0, 1]",4598,2342,2256,225,221,0.09607173356105893,0.09796099290780141
"[1, 0, 0, 1, 0, 1, 0, 1, 0, 0]",5710,3185,2525,306,249,0.09607535321821035,0.09861386138613862
"[0, 0, 0, 0, 1, 0, 1, 0, 1, 1]",7917,4921,2996,464,288,0.09428977850030482,0.09612817089452604
"[1, 0, 1, 1, 1, 0, 1, 0, 0, 1]",5729,2288,3441,214,312,0.09353146853146853,0.09067131647776809
"[1, 0, 1, 1, 1, 1, 1, 0, 1, 1]",27338,6826,20512,622,1925,0.09112217990038089,0.093847503900156
"[1, 0, 0, 1, 1, 1, 1, 0, 1, 1]",14039,3703,10336,343,995,0.09262759924385633,0.09626547987616099
"[1, 1, 0, 0, 1, 1, 1, 1, 0, 1]",14868,5041,9827,440,939,0.08728426899424717,0.09555306807774498
"[0, 1, 1, 1, 0, 1, 1, 0, 0, 0]",5656,2928,2728,272,272,0.09289617486338798,0.09970674486803519
"[0, 0, 1, 0, 0, 0, 1, 0, 1, 1]",6794,4103,2691,363,271,0.08847184986595175,0.10070605722779635
"[1, 0, 0, 0, 0, 0, 0, 0, 0, 0]",186006,124930,61076,11952,5862,0.09566957496197871,0.09597878053572598
"[1, 1, 1, 0, 0, 0, 0, 0, 0, 0]",29410,11323,18087,1059,1693,0.09352645058730019,0.09360314037706641
"[0, 1, 1, 1, 1, 0, 0, 0, 0, 0]",21669,17204,4465,1632,437,0.09486166007905138,0.09787234042553192
"[0, 0, 1, 1, 1, 1, 0, 0, 0, 0]",29403,17473,11930,1635,1110,0.09357294110913981,0.09304274937133278
"[0, 0, 0, 0, 0, 1, 1, 1, 1, 0]",21923,17317,4606,1576,434,0.09100883524859964,0.09422492401215805
"[1, 0, 1, 0, 0, 0, 0, 0, 0, 0]",33658,24502,9156,2329,848,0.09505346502326341,0.0926168632590651
"[0, 0, 0, 0, 0, 0, 0, 0, 1, 0]",137944,115351,22593,10957,2171,0.09498833993636813,0.09609170982162617
"[1, 0, 0, 0, 0, 1, 0, 1, 1, 0]",6092,3266,2826,309,271,0.09461114513165952,0.09589525831564048
"[1, 0, 1, 1, 1, 0, 0, 0, 1, 1]",6781,2720,4061,261,379,0.09595588235294118,0.09332676680620537
"[1, 1, 1, 1, 1, 1, 0, 1, 1, 0]",30111,7272,22839,697,2177,0.09584708470847085,0.09531940978151408
"[0, 1, 0, 0, 0, 0, 1, 1, 0, 0]",15215,10102,5113,983,487,0.09730746386854089,0.09524740856639938
"[0, 1, 0, 1, 0, 0, 0, 1, 1, 1]",6966,3818,3148,356,264,0.09324253535882661,0.08386277001270648
"[1, 0, 0, 0, 0, 0, 1, 0, 0, 1]",11162,6828,4334,674,401,0.0987111892208553,0.09252422704199353
"[0, 0, 0, 1, 0, 1, 1, 0, 0, 1]",6787,3978,2809,401,248,0.1008044243338361,0.08828764684941261
"[0, 1, 0, 0, 1, 1, 1, 0, 0, 1]",5412,2820,2592,279,254,0.09893617021276596,0.09799382716049383
"[1, 0, 1, 0, 1, 1, 0, 1, 0, 1]",5375,2198,3177,197,282,0.08962693357597816,0.08876298394711993
"[0, 0, 0, 1, 0, 0, 0, 0, 1, 1]",17098,12063,5035,1140,519,0.0945038547624969,0.10307845084409135
"[1, 0, 0, 1, 0, 0, 0, 1, 0, 0]",9900,6450,3450,640,331,0.09922480620155039,0.09594202898550724
"[0, 0, 1, 0, 1, 0, 0, 1, 0, 0]",9822,6612,3210,630,305,0.09528130671506352,0.09501557632398754
"[0, 0, 0, 1, 0, 1, 0, 0, 1, 0]",9755,6592,3163,614,285,0.09314320388349515,0.09010433133101486
"[0, 1, 0, 0, 0, 1, 0, 0, 1, 1]",7041,4272,2769,411,279,0.09620786516853932,0.10075839653304441
"[0, 0, 0, 0, 0, 1, 1, 1, 0, 0]",15003,10810,4193,1022,423,0.09454209065679926,0.10088242308609588
"[0, 1, 1, 1, 1, 1, 1, 1, 0, 1]",29524,9938,19586,895,1802,0.09005836184342926,0.0920044930052078
"[1, 0, 1, 1, 1, 1, 1, 1, 1, 0]",29661,7655,22006,756,2100,0.09875898105813194,0.09542851949468327
"[1, 1, 1, 1, 0, 1, 0, 0, 0, 0]",6579,3103,3476,328,318,0.10570415726716081,0.09148446490218642
"[0, 1, 1, 1, 0, 0, 0, 1, 1, 1]",8607,4230,4377,397,383,0.09385342789598108,0.0875028558373315
"[0, 1, 1, 1, 0, 1, 1, 1, 1, 0]",10625,3828,6797,371,619,0.09691745036572623,0.09106958952479034
"[1, 1, 1, 0, 1, 1, 1, 0, 1, 1]",28025,6711,21314,640,1978,0.0953658173148562,0.09280285258515529
"[0, 1, 1, 1, 1, 1, 1, 0, 0, 0]",17911,12384,5527,1192,519,0.0962532299741602,0.09390265967070743
"[0, 1, 1, 1, 0, 0, 1, 0, 1, 0]",4713,2381,2332,249,212,0.10457790844183117,0.09090909090909091
"[0, 1, 0, 0, 0, 0, 1, 0, 1, 1]",6568,3976,2592,377,259,0.09481891348088531,0.09992283950617284
"[1, 1, 1, 1, 0, 0, 0, 1, 0, 1]",7379,3025,4354,295,407,0.09752066115702479,0.09347726228755168
"[1, 0, 0, 0, 0, 0, 1, 1, 0, 1]",6593,3458,3135,323,307,0.09340659340659341,0.09792663476874003
"[0, 0, 1, 0, 1, 1, 0, 0, 0, 1]",6104,3589,2515,359,251,0.10002786291446085,0.09980119284294235
"[1, 0, 1, 0, 1, 0, 1, 1, 0, 1]",5344,2223,3121,226,283,0.10166441745389114,0.09067606536366549
"[0, 1, 1, 1, 1, 1, 0, 1, 0, 1]",10233,4035,6198,385,612,0.09541511771995044,0.09874152952565343
"[1, 1, 0, 0, 0, 1, 1, 1, 1, 1]",17616,5833,11783,545,1076,0.09343391050917195,0.09131800050920819
"[0, 0, 0, 1, 0, 1, 0, 0, 1, 1]",7904,4885,3019,432,299,0.08843398157625385,0.09903941702550513
"[1, 0, 0, 1, 0, 0, 0, 0, 1, 0]",9584,6143,3441,574,310,0.09343968744912909,0.09009009009009009
"[0, 1, 0, 0, 1, 1, 0, 1, 1, 0]",4809,2486,2323,229,229,0.0921158487530169,0.09857942315970727
"[1, 1, 0, 0, 1, 1, 0, 0, 1, 1]",29895,12472,17423,1197,1615,0.09597498396407954,0.09269356597600872
"[0, 0, 1, 1, 0, 0, 1, 1, 0, 1]",7772,3895,3877,386,337,0.09910141206675224,0.0869228785143152
"[0, 0, 1, 0, 1, 1, 0, 1, 1, 0]",4810,2429,2381,218,202,0.08974886784685056,0.08483830323393532
"[1, 0, 1, 1, 0, 0, 0, 1, 0, 1]",4684,2350,2334,225,217,0.09574468085106383,0.09297343616109682
"[0, 1, 1, 0, 1, 1, 1, 0, 1, 0]",5437,2370,3067,203,293,0.08565400843881857,0.09553309422888817
"[1, 1, 1, 0, 0, 1, 1, 0, 0, 1]",21015,4223,16792,386,1550,0.09140421501302391,0.09230585993330158
"[1, 1, 1, 0, 1, 0, 0, 0, 1, 1]",7379,2937,4442,293,432,0.09976166155941436,0.09725348941918055
"[0, 0, 1, 1, 0, 1, 1, 1, 0, 0]",5659,2848,2811,291,277,0.10217696629213484,0.09854144432586268
"[0, 1, 0, 0, 1, 0, 1, 0, 0, 1]",5604,3325,2279,321,221,0.09654135338345865,0.09697235629662132
"[1, 1, 0, 1, 0, 1, 0, 1, 0, 0]",4790,2336,2454,196,251,0.0839041095890411,0.10228198859005705
"[1, 1, 0, 0, 1, 0, 0, 1, 0, 1]",5008,2460,2548,218,217,0.0886178861788618,0.08516483516483517
"[1, 1, 0, 0, 1, 0, 1, 1, 0, 0]",5667,2828,2839,279,286,0.09865629420084866,0.10073969707643536
"[1, 1, 1, 1, 0, 1, 0, 0, 1, 0]",5973,2497,3476,239,330,0.09571485782939528,0.0949367088607595
"[0, 0, 0, 1, 0, 1, 0, 1, 0, 1]",5817,3567,2250,324,213,0.09083263246425567,0.09466666666666666
"[1, 1, 0, 1, 0, 1, 0, 0, 1, 0]",4450,2235,2215,210,192,0.09395973154362416,0.08668171557562077
"[1, 1, 0, 0, 1, 1, 0, 1, 1, 0]",6988,2821,4167,268,387,0.09500177242112726,0.09287257019438445
"[0, 0, 0, 1, 0, 1, 0, 1, 1, 0]",6157,3770,2387,346,229,0.09177718832891246,0.09593632174277336
"[1, 1, 1, 0, 0, 0, 0, 1, 0, 1]",6444,2522,3922,259,346,0.10269627279936558,0.08822029576746558
"[1, 1, 0, 1, 0, 0, 1, 0, 0, 1]",5056,2519,2537,243,218,0.0964668519253672,0.08592826172644856
"[0, 1, 0, 0, 1, 1, 1, 0, 1, 0]",4456,2244,2212,209,197,0.09313725490196079,0.08905967450271247
"[1, 0, 1, 1, 1, 0, 0, 0, 1, 0]",4678,2305,2373,224,217,0.09718004338394794,0.09144542772861357
"[0, 0, 1, 1, 0, 0, 1, 1, 1, 1]",31947,14057,17890,1343,1736,0.09553958881695952,0.09703745108999441
"[1, 0, 0, 0, 1, 1, 0, 0, 0, 0]",15616,9835,5781,921,566,0.09364514489069649,0.09790693651617367
"[0, 1, 1, 0, 1, 0, 0, 0, 1, 1]",6002,3256,2746,317,247,0.09735872235872235,0.08994901675163874
"[1, 1, 0, 1, 1, 0, 1, 0, 0, 0]",5098,2490,2608,232,216,0.09317269076305221,0.08282208588957055
"[0, 1, 1, 1, 0, 0, 1, 1, 1, 1]",17081,6644,10437,642,1042,0.09662853702588801,0.09983711794576985
"[1, 1, 1, 1, 0, 0, 0, 0, 0, 0]",30944,17181,13763,1600,1305,0.0931261276992026,0.09481944343529754
"[0, 1, 0, 1, 0, 0, 0, 0, 0, 0]",31817,23754,8063,2257,752,0.09501557632398754,0.09326553392037704
"[0, 1, 0, 0, 0, 1, 0, 0, 0, 1]",9957,6709,3248,627,307,0.09345655090177374,0.09451970443349754
"[1, 1, 1, 0, 1, 0, 0, 0, 1, 0]",4639,2251,2388,214,238,0.09506885828520657,0.09966499162479062
"[0, 0, 1, 0, 1, 0, 0, 0, 0, 1]",11116,7571,3545,731,329,0.09655263505481443,0.0928067700987306
"[1, 1, 0, 0, 1, 1, 1, 0, 0, 0]",6989,3506,3483,309,310,0.0881346263548203,0.08900373241458513
"[0, 0, 0, 1, 0, 1, 1, 1, 0, 0]",6699,4019,2680,379,231,0.09430206519034585,0.08619402985074627
"[0, 0, 1, 0, 1, 1, 1, 1, 1, 1]",14729,5568,9161,487,878,0.08746408045977011,0.0958410653858749
"[1, 1, 0, 0, 1, 1, 1, 1, 1, 1]",89461,23350,66111,2291,6244,0.09811563169164882,0.09444721755834884
"[0, 1, 1, 0, 1, 0, 1, 1, 0, 1]",5585,2472,3113,211,281,0.08535598705501618,0.09026662383552843
"[0, 0, 0, 1, 0, 1, 0, 1, 0, 0]",10165,6788,3377,631,331,0.09295816146140247,0.09801599052413384
"[1, 0, 0, 0, 0, 0, 1, 0, 1, 0]",10236,6376,3860,586,366,0.09190715181932246,0.09481865284974093
"[1, 0, 0, 1, 0, 0, 0, 0, 1, 1]",8743,4831,3912,458,373,0.09480438832539846,0.09534764826175869
"[1, 1, 1, 1, 0, 1, 0, 1, 1, 0]",10476,3442,7034,342,646,0.09936083672283556,0.09183963605345465
"[1, 1, 1, 1, 1, 0, 1, 0, 0, 1]",12022,3767,8255,352,776,0.0934430581364481,0.09400363416111447
"[1, 1, 0, 1, 1, 0, 1, 1, 1, 1]",31031,7883,23148,749,2190,0.0950145883546873,0.09460860549507517
"[0, 1, 0, 1, 1, 1, 1, 0, 0, 1]",7603,3192,4411,257,449,0.08051378446115288,0.1017909771026978
"[0, 1, 1, 0, 0, 0, 1, 1, 0, 1]",5359,3016,2343,276,237,0.09151193633952255,0.10115236875800256
"[0, 1, 0, 0, 1, 0, 0, 0, 0, 0]",29527,22144,7383,2180,649,0.09844653179190752,0.08790464580793715
"[1, 1, 1, 1, 1, 1, 1, 0, 1, 0]",31151,7311,23840,708,2291,0.09684037751333607,0.0960989932885906
"[0, 1, 0, 0, 1, 1, 0, 0, 0, 0]",15436,10156,5280,924,518,0.09098070106341079,0.0981060606060606
"[0, 1, 1, 1, 1, 1, 1, 0, 1, 0]",10999,4595,6404,440,611,0.0957562568008705,0.09540911930043723
"[1, 1, 0, 1, 0, 1, 0, 0, 0, 1]",4883,2360,2523,225,224,0.09533898305084745,0.08878319460959176
"[0, 1, 1, 1, 0, 0, 1, 0, 0, 0]",6462,3882,2580,414,266,0.10664605873261206,0.10310077519379846
"[0, 1, 0, 1, 0, 0, 1, 0, 0, 1]",5738,3364,2374,334,256,0.09928656361474435,0.10783487784330244
"[0, 0, 0, 0, 0, 1, 1, 1, 1, 1]",23971,17848,6123,1734,576,0.09715374271627072,0.09407153356197942
"[0, 1, 1, 1, 1, 0, 0, 1, 0, 1]",7104,3750,3354,345,302,0.092,0.0900417412045319
"[0, 0, 0, 1, 0, 0, 0, 1, 1, 1]",12327,8534,3793,825,352,0.09667213498945394,0.09280253097811758
"[1, 0, 0, 1, 0, 0, 1, 0, 0, 1]",5953,3298,2655,307,252,0.09308671922377199,0.09491525423728814
"[0, 1, 1, 1, 1, 0, 0, 1, 0, 0]",6231,3703,2528,350,242,0.0945179584120983,0.09572784810126582
"[1, 0, 1, 1, 1, 0, 0, 0, 0, 0]",8134,4632,3502,453,310,0.0977979274611399,0.0885208452312964
"[0, 1, 1, 0, 1, 0, 1, 1, 1, 0]",5713,2596,3117,253,280,0.09745762711864407,0.08982996470965672
"[1, 1, 1, 0, 0, 1, 1, 1, 0, 0]",8344,2966,5378,283,494,0.09541469993256911,0.09185570844179992
"[1, 0, 0, 1, 0, 0, 0, 1, 1, 0]",6363,3580,2783,369,252,0.10307262569832402,0.0905497664390945
"[0, 1, 0, 0, 1, 0, 0, 0, 1, 1]",6986,4288,2698,401,290,0.09351679104477612,0.10748702742772424
"[1, 1, 0, 1, 0, 1, 0, 0, 0, 0]",6797,3858,2939,398,281,0.10316226023846553,0.09561075195644778
"[1, 1, 1, 0, 1, 0, 1, 0, 0, 0]",5365,2584,2781,241,248,0.09326625386996903,0.08917655519597267
"[0, 1, 1, 1, 0, 1, 0, 1, 0, 0]",4863,2476,2387,230,245,0.09289176090468497,0.10263929618768329
"[1, 0, 0, 0, 1, 0, 0, 0, 1, 1]",7387,4049,3338,364,310,0.08989874042973574,0.09286998202516476
"[0, 1, 0, 0, 0, 1, 1, 0, 1, 0]",5375,3103,2272,284,222,0.09152433129229777,0.0977112676056338
"[0, 0, 0, 0, 1, 1, 1, 0, 1, 1]",7694,4076,3618,354,340,0.08684985279685967,0.09397457158651189
"[0, 0, 1, 0, 0, 0, 1, 1, 1, 1]",8625,4795,3830,431,348,0.08988529718456725,0.09086161879895562
"[1, 0, 0, 1, 1, 0, 0, 1, 1, 1]",23280,4603,18677,420,1813,0.09124484032152944,0.09707126412164695
"[1, 0, 1, 0, 0, 1, 0, 1, 1, 1]",6799,2851,3948,312,386,0.1094352858646089,0.0977710233029382
"[1, 1, 1, 1, 1, 0, 1, 0, 0, 0]",7358,2815,4543,272,429,0.09662522202486679,0.09443099273607748
"[1, 0, 0, 1, 1, 1, 0, 1, 0, 0]",5368,2372,2996,212,260,0.0893760539629005,0.08678237650200267
"[0, 0, 0, 0, 0, 1, 0, 1, 1, 0]",11588,7936,3652,772,338,0.09727822580645161,0.09255202628696604
"[1, 0, 1, 0, 0, 1, 0, 0, 1, 1]",5774,2873,2901,265,272,0.09223807866341803,0.09376077214753534
"[1, 1, 0, 1, 0, 1, 0, 1, 0, 1]",5563,2317,3246,222,326,0.09581355200690549,0.1004313000616143
"[0, 0, 1, 0, 1, 1, 1, 1, 0, 0]",6496,3334,3162,295,295,0.08848230353929214,0.09329538266919671
"[1, 1, 1, 0, 0, 1, 0, 1, 0, 0]",5426,2489,2937,258,294,0.1036560867818401,0.10010214504596528
"[1, 1, 0, 1, 1, 1, 0, 0, 0, 1]",6301,2571,3730,273,361,0.10618436406067679,0.0967828418230563
"[0, 1, 0, 0, 1, 1, 1, 1, 1, 0]",6556,2922,3634,284,349,0.0971937029431896,0.09603742432581178
"[1, 0, 1, 1, 0, 1, 0, 0, 1, 0]",4494,2209,2285,205,232,0.09280217292892712,0.10153172866520788
"[1, 0, 1, 1, 1, 1, 0, 0, 0, 0]",8665,4225,4440,409,465,0.09680473372781065,0.10472972972972973
"[0, 0, 1, 0, 1, 0, 1, 0, 1, 0]",5371,3172,2199,300,220,0.09457755359394704,0.10004547521600728
"[0, 1, 0, 1, 0, 1, 1, 0, 1, 1]",5865,2566,3299,229,316,0.08924395946999221,0.09578660200060625
"[0, 1, 0, 1, 1, 0, 1, 1, 0, 1]",5356,2307,3049,216,306,0.09362808842652796,0.10036077402427025
"[0, 1, 1, 1, 0, 1, 0, 0, 1, 1]",6769,3060,3709,285,361,0.09313725490196079,0.09733081693178755
"[0, 0, 1, 1, 1, 1, 1, 0, 1, 1]",13895,4906,8989,498,874,0.10150835711373828,0.09722994771387251
"[0, 0, 0, 1, 1, 0, 0, 1, 1, 1]",21034,16122,4912,1602,509,0.09936732415333085,0.10362377850162867
"[0, 0, 0, 0, 0, 0, 0, 1, 1, 0]",72188,60895,11293,5777,1077,0.09486821578126282,0.09536881253874081
"[0, 0, 1, 1, 0, 0, 0, 1, 1, 0]",8070,4797,3273,460,311,0.09589326662497394,0.09501985945615643
"[0, 1, 1, 1, 1, 0, 1, 1, 0, 1]",10538,4122,6416,385,655,0.09340126152353227,0.10208852867830424
"[0, 0, 0, 1, 1, 1, 0, 0, 1, 1]",8068,4669,3399,428,345,0.09166845148854144,0.10150044130626655
"[0, 0, 1, 0, 1, 1, 1, 0, 1, 1]",6248,2773,3475,263,304,0.09484313018391634,0.08748201438848921
"[1, 1, 1, 1, 1, 1, 1, 1, 1, 1]",2008923,168542,1840381,16051,176555,0.09523442228049982,0.09593393976573329
"[0, 0, 0, 0, 0, 0, 1, 1, 1, 1]",41173,26079,15094,2510,1360,0.09624602170328617,0.09010202729561415
"[0, 1, 0, 1, 0, 0, 0, 0, 1, 1]",8335,4946,3389,453,328,0.09158916295996765,0.09678371200944232
"[1, 0, 0, 1, 0, 0, 1, 0, 1, 0]",5333,3029,2304,279,214,0.09210960713106636,0.09288194444444445
"[0, 0, 0, 1, 0, 0, 1, 0, 0, 1]",10707,7348,3359,632,339,0.08600979858464888,0.10092289371836856
"[1, 0, 0, 1, 1, 1, 0, 0, 0, 0]",8334,4389,3945,434,350,0.09888357256778309,0.08871989860583017
"[0, 1, 1, 0, 0, 0, 0, 1, 0, 1]",7425,4978,2447,477,244,0.09582161510646846,0.09971393543114017
"[0, 1, 1, 1, 1, 1, 1, 1, 1, 1]",198257,68451,129806,6494,12476,0.09487078348015368,0.09611266043172119
"[0, 1, 0, 1, 1, 0, 1, 1, 1, 1]",11746,4269,7477,388,713,0.0908877957367065,0.09535910124381436
"[0, 1, 0, 1, 0, 0, 1, 1, 1, 1]",8559,3845,4714,385,435,0.10013003901170352,0.09227831989817564
"[0, 0, 0, 0, 0, 1, 1, 0, 0, 0]",71989,61146,10843,5678,1007,0.09285971281849999,0.09287097666697408
"[0, 1, 1, 0, 0, 1, 0, 1, 0, 0]",6237,3914,2323,375,221,0.09580991313234542,0.0951356005165734
"[0, 0, 1, 0, 0, 1, 0, 0, 0, 0]",28698,21600,7098,2152,664,0.09962962962962962,0.09354747816286278
"[0, 0, 1, 0, 0, 0, 1, 1, 0, 0]",12944,8740,4204,835,432,0.09553775743707094,0.1027592768791627
"[0, 0, 0, 1, 0, 0, 0, 1, 1, 0]",11896,8139,3757,801,369,0.09841503870254331,0.09821666223050306
"[0, 0, 0, 0, 0, 1, 0, 0, 0, 1]",31313,24209,7104,2375,681,0.09810401090503532,0.09586148648648649
"[0, 0, 0, 1, 1, 1, 0, 0, 0, 0]",15103,10459,4644,1006,440,0.09618510373840711,0.09474590869939707
"[1, 0, 0, 0, 1, 1, 1, 0, 0, 0]",7309,3937,3372,378,313,0.09601219202438405,0.09282325029655991
"[1, 0, 0, 0, 0, 1, 1, 1, 1, 1]",25020,5089,19931,484,1902,0.09510709373157791,0.09542923084642015
"[0, 0, 0, 1, 0, 0, 1, 0, 1, 0]",9772,6574,3198,634,317,0.09644052327350168,0.09912445278298937
"[0, 0, 1, 1, 1, 0, 0, 1, 1, 0]",6748,3442,3306,329,318,0.09558396281231842,0.09618874773139746
"[0, 1, 1, 0, 0, 1, 1, 0, 1, 1]",8017,4427,3590,450,335,0.1016489722159476,0.09331476323119778
"[0, 1, 1, 1, 1, 0, 1, 0, 0, 1]",6548,3077,3471,259,347,0.08417289567760806,0.09997118985883031
"[1, 1, 0, 0, 1, 1, 1, 1, 0, 0]",28028,11822,16206,1111,1525,0.09397733040094738,0.09410095026533383
"[1, 0, 1, 1, 0, 1, 0, 1, 0, 1]",5329,2210,3119,198,263,0.08959276018099548,0.08432189804424495
"[0, 0, 1, 0, 1, 1, 1, 1, 0, 1]",5737,2468,3269,211,331,0.08549432739059967,0.10125420617925972
"[0, 1, 1, 0, 1, 0, 0, 1, 1, 0]",5254,2715,2539,229,242,0.0843462246777164,0.09531311539976368
"[0, 0, 0, 0, 1, 0, 0, 1, 1, 1]",13906,9564,4342,922,437,0.09640317858636553,0.10064486411791801
"[0, 1, 0, 1, 0, 0, 1, 0, 0, 0]",10006,6690,3316,666,354,0.09955156950672646,0.10675512665862485
"[0, 0, 0, 0, 0, 1, 0, 1, 0, 0]",29052,22080,6972,2129,656,0.09642210144927536,0.09409064830751578
"[0, 0, 0, 1, 0, 0, 1, 1, 1, 0]",6217,3700,2517,325,228,0.08783783783783784,0.09058402860548272
"[1, 0, 0, 0, 1, 0, 0, 1, 1, 1]",7539,3587,3952,369,385,0.10287148034569278,0.09741902834008097
"[0, 0, 1, 0, 0, 0, 0, 0, 1, 0]",25694,19274,6420,1866,601,0.09681436131576217,0.09361370716510903
"[1, 1, 1, 1, 1, 0, 0, 1, 0, 0]",7849,2702,5147,279,512,0.10325684678016284,0.09947542257625802
"[1, 1, 1, 1, 0, 0, 1, 1, 0, 0]",28877,11978,16899,1118,1583,0.09333778594089163,0.0936741819042547
"[1, 0, 0, 1, 1, 1, 0, 0, 0, 1]",5636,2480,3156,273,284,0.11008064516129032,0.08998732572877059
"[0, 1, 1, 1, 1, 0, 1, 1, 1, 0]",10451,3890,6561,377,670,0.09691516709511568,0.10211857948483463
"[0, 0, 1, 1, 1, 1, 1, 1, 0, 0]",28296,12652,15644,1247,1469,0.09856149225418906,0.09390181539248274
"[1, 1, 0, 0, 0, 0, 1, 1, 0, 1]",8125,3943,4182,359,420,0.09104742581790515,0.10043041606886657
"[0, 1, 1, 0, 0, 0, 0, 1, 1, 0]",19565,15696,3869,1434,362,0.09136085626911315,0.0935642284828121
"[0, 1, 0, 1, 1, 0, 0, 1, 0, 0]",5679,3344,2335,337,222,0.1007775119617225,0.09507494646680942
"[1, 0, 0, 1, 0, 0, 0, 1, 0, 1]",5693,3226,2467,272,269,0.08431494110353378,0.10903931901094446
"[0, 1, 0, 1, 0, 1, 1, 1, 0, 0]",5253,2674,2579,253,230,0.09461480927449514,0.08918185343156262
"[0, 1, 0, 1, 0, 0, 0, 1, 0, 1]",5535,3270,2265,336,205,0.10275229357798166,0.09050772626931568
"[0, 1, 0, 1, 0, 0, 0, 0, 1, 0]",9596,6387,3209,615,293,0.09628933771723815,0.09130570271112497
"[0, 1, 0, 1, 0, 1, 0, 0, 0, 0]",10690,7144,3546,710,347,0.09938409854423293,0.09785673998871969
"[1, 1, 0, 0, 0, 1, 0, 1, 0, 1]",5195,2604,2591,271,257,0.10407066052227343,0.09918950212273253
"[1, 0, 0, 0, 0, 0, 1, 0, 1, 1]",7725,4006,3719,353,368,0.08811782326510234,0.09895133100295779
"[1, 1, 0, 1, 0, 0, 0, 0, 0, 1]",6780,3787,2993,345,276,0.09110113546342752,0.09221516872702974
"[0, 1, 0, 1, 1, 1, 1, 0, 0, 0]",6804,3410,3394,334,327,0.09794721407624633,0.09634649381261048
"[0, 0, 0, 1, 1, 1, 0, 1, 1, 0]",5477,2986,2491,270,245,0.09042196918955124,0.0983540746688077
"[0, 0, 1, 0, 0, 0, 1, 1, 0, 1]",5660,3366,2294,313,231,0.09298871063576945,0.1006974716652136
"[1, 1, 0, 1, 0, 0, 1, 0, 1, 1]",6162,2571,3591,263,365,0.10229482691559705,0.10164299637983848
"[0, 1, 1, 0, 1, 0, 0, 0, 1, 0]",5386,3266,2120,320,197,0.09797917942437231,0.09292452830188679
"[1, 1, 0, 0, 1, 1, 1, 0, 1, 0]",6826,2877,3949,263,419,0.09141466805700382,0.10610281083818689
"[0, 1, 0, 0, 1, 1, 0, 0, 1, 1]",8555,4479,4076,393,381,0.08774279973208306,0.09347399411187439
"[1, 0, 1, 0, 1, 0, 0, 1, 0, 0]",5554,3217,2337,305,224,0.09480882810071495,0.09584937954642704
"[0, 1, 0, 1, 0, 1, 0, 1, 0, 1]",4530,2299,2231,207,216,0.0900391474554154,0.09681757059614522
"[0, 1, 1, 1, 0, 0, 1, 1, 0, 0]",8265,4259,4006,403,370,0.09462315097440714,0.09236145781328008
"[1, 1, 0, 0, 0, 0, 0, 1, 1, 1]",12686,6775,5911,634,521,0.09357933579335793,0.08814075452546101
"[1, 1, 0, 0, 0, 1, 0, 0, 0, 0]",12189,8042,4147,791,376,0.09835861725938821,0.09066795273691826
"[1, 0, 0, 0, 1, 0, 0, 1, 1, 0]",6411,3589,2822,364,283,0.10142100863750349,0.1002834868887314
"[0, 1, 1, 1, 0, 1, 1, 0, 0, 1]",6559,2978,3581,286,356,0.09603760913364674,0.09941357162803686
"[1, 0, 1, 0, 0, 1, 0, 1, 0, 1]",4551,2257,2294,202,221,0.08949933540097474,0.0963382737576286
"[1, 0, 1, 0, 0, 1, 0, 1, 0, 0]",5462,3105,2357,274,211,0.08824476650563608,0.08952057700466695
"[1, 0, 1, 1, 0, 0, 1, 0, 1, 1]",6029,2555,3474,240,301,0.09393346379647749,0.08664363845710996
"[1, 0, 1, 1, 0, 0, 1, 0, 1, 0]",4521,2184,2337,226,220,0.10347985347985347,0.094137783483098
"[0, 1, 1, 0, 0, 1, 1, 1, 1, 1]",29941,18869,11072,1799,1083,0.09534156553076474,0.09781430635838151
"[0, 0, 0, 0, 1, 1, 0, 0, 1, 1]",32074,19229,12845,1881,1208,0.09782099953195694,0.09404437524328532
"[1, 0, 0, 1, 1, 0, 0, 0, 1, 1]",7903,3038,4865,277,426,0.0911784068466096,0.08756423432682425
"[0, 0, 1, 1, 1, 1, 0, 1, 1, 0]",7227,3102,4125,312,427,0.10058027079303675,0.10351515151515152
"[0, 1, 1, 0, 0, 0, 0, 1, 1, 1]",20866,16003,4863,1540,452,0.09623195650815472,0.09294674069504422
"[0, 0, 0, 1, 0, 1, 1, 1, 0, 1]",4991,2619,2372,260,219,0.09927453226422299,0.09232715008431704
"[0, 1, 0, 0, 0, 1, 0, 1, 0, 0]",9822,6684,3138,596,316,0.08916816277678037,0.10070108349267048
"[0, 0, 1, 0, 0, 0, 1, 0, 1, 0]",9655,6529,3126,606,319,0.09281666411395313,0.10204734484964811
"[0, 0, 1, 1, 0, 1, 1, 0, 0, 1]",6041,3127,2914,321,246,0.10265430124720179,0.08442004118050789
"[0, 0, 0, 1, 0, 0, 0, 0, 0, 0]",138089,114760,23329,10709,2253,0.09331648658069014,0.09657507822881392
"[0, 0, 0, 0, 1, 0, 1, 1, 1, 0]",6494,3942,2552,390,230,0.0989345509893455,0.09012539184952978
"[0, 0, 0, 0, 0, 1, 0, 1, 1, 1]",14493,10298,4195,914,368,0.08875509807729656,0.08772348033373063
"[0, 0, 0, 0, 0, 0, 1, 0, 1, 1]",17992,13068,4924,1248,471,0.09550045913682277,0.09565393988627133
"[0, 0, 0, 0, 0, 0, 0, 0, 0, 0]",1898476,1738995,159481,166741,15343,0.09588354193082786,0.09620581762090782
"[1, 1, 1, 1, 1, 1, 1, 0, 1, 1]",143259,22816,120443,2141,11318,0.09383765778401122,0.09396976162998265
"[1, 1, 1, 1, 1, 1, 1, 1, 0, 1]",141654,23092,118562,2212,11373,0.09579075004330503,0.0959244952008232
"[1, 1, 1, 1, 0, 0, 1, 1, 1, 1]",90042,23277,66765,2234,6367,0.09597456716930876,0.095364337602037
"[0, 0, 0, 0, 0, 1, 0, 1, 0, 1]",11431,7969,3462,752,333,0.09436566695946794,0.09618717504332755
"[0, 0, 1, 1, 0, 0, 1, 0, 1, 0]",6703,3950,2753,373,245,0.09443037974683545,0.08899382491827097
"[0, 0, 0, 1, 1, 0, 0, 1, 0, 1]",7448,5077,2371,484,237,0.09533188891077408,0.09995782370307887
"[1, 0, 0, 0, 0, 1, 1, 0, 0, 1]",17300,5131,12169,513,1128,0.09998051062171116,0.09269455172980524
"[0, 0, 1, 1, 0, 0, 0, 1, 0, 0]",12316,8253,4063,793,399,0.09608627165879075,0.09820329805562392
"[0, 1, 1, 1, 1, 0, 0, 0, 0, 1]",16644,12322,4322,1131,405,0.09178704755721474,0.09370661730680241
"[1, 1, 0, 0, 1, 1, 0, 1, 0, 1]",6965,2936,4029,291,399,0.09911444141689374,0.09903201787043932
"[0, 1, 1, 1, 0, 0, 0, 0, 1, 1]",9427,4976,4451,456,425,0.09163987138263666,0.09548416086272747
"[0, 1, 1, 0, 1, 1, 1, 0, 0, 0]",5749,2935,2814,284,251,0.09676320272572402,0.08919687277896234
"[1, 1, 1, 0, 1, 0, 0, 1, 1, 0]",6492,2605,3887,228,386,0.08752399232245682,0.09930537689735014
"[1, 1, 1, 1, 0, 0, 0, 1, 1, 1]",18195,6023,12172,617,1201,0.1024406441972439,0.09866907656917516
"[0, 1, 0, 0, 1, 1, 0, 0, 1, 0]",5705,3380,2325,321,219,0.09497041420118343,0.09419354838709677
"[0, 1, 0, 0, 0, 0, 0, 0, 1, 0]",25891,19408,6483,1812,627,0.09336356141797197,0.0967144840351689
"[0, 0, 1, 1, 1, 1, 0, 0, 1, 1]",29996,12970,17026,1250,1596,0.09637625289128758,0.0937389874309879
"[0, 1, 0, 0, 0, 1, 0, 0, 0, 0]",28065,21188,6877,1957,671,0.09236360203888994,0.09757161553002763
"[0, 1, 0, 1, 0, 0, 0, 1, 0, 0]",9580,6319,3261,606,328,0.0959012501978161,0.10058264336093223
"[1, 0, 1, 1, 0, 1, 0, 1, 0, 0]",4653,2237,2416,223,261,0.09968708091193562,0.10802980132450331
"[0, 0, 1, 1, 1, 0, 1, 1, 1, 1]",14319,5171,9148,500,845,0.09669309611293754,0.09236991692173152
"[0, 0, 1, 0, 1, 1, 0, 1, 1, 1]",7234,3300,3934,304,372,0.09212121212121212,0.0945602440264362
"[0, 1, 0, 0, 1, 1, 1, 1, 1, 1]",16887,6374,10513,630,972,0.09883903357389394,0.0924569580519357
"[1, 1, 0, 1, 0, 1, 0, 0, 1, 1]",6932,2925,4007,283,421,0.09675213675213676,0.10506613426503619
"[0, 0, 0, 1, 1, 0, 1, 1, 1, 1]",9461,4953,4508,473,454,0.09549767817484353,0.10070984915705412
"[0, 1, 0, 1, 1, 1, 0, 0, 1, 0]",4766,2390,2376,228,227,0.09539748953974896,0.09553872053872053
"[0, 0, 1, 0, 1, 0, 0, 0, 1, 0]",9378,6340,3038,618,304,0.0974763406940063,0.10006583278472679
"[1, 0, 0, 1, 1, 0, 1, 0, 0, 0]",6370,3342,3028,316,273,0.0945541591861161,0.09015852047556143
"[0, 0, 1, 1, 1, 1, 1, 1, 0, 1]",14989,5268,9721,503,964,0.0954821564160972,0.09916675239172924
"[0, 1, 1, 1, 1, 1, 0, 1, 1, 0]",10374,3947,6427,365,577,0.09247529769445148,0.08977750116695192
"[0, 1, 1, 0, 1, 0, 1, 1, 1, 1]",12365,4806,7559,477,714,0.09925093632958802,0.0944569387485117
"[1, 1, 1, 1, 1, 0, 1, 0, 1, 0]",10523,3242,7281,333,693,0.1027143738433066,0.09517923362175525
"[0, 0, 0, 0, 1, 0, 1, 1, 1, 1]",9245,5292,3953,543,352,0.10260770975056689,0.08904629395395902
"[0, 1, 1, 1, 0, 1, 0, 1, 1, 0]",5861,2682,3179,250,322,0.09321401938851603,0.10128971374646115
"[0, 1, 0, 1, 1, 0, 1, 0, 1, 1]",5863,2504,3359,238,311,0.0950479233226837,0.09258707948794284
"[0, 1, 0, 0, 0, 1, 0, 1, 0, 1]",5418,3183,2235,284,222,0.08922400251335218,0.09932885906040269
"[1, 1, 1, 0, 0, 0, 1, 1, 1, 0]",6961,2641,4320,251,451,0.09503975766755017,0.10439814814814814
"[1, 0, 0, 0, 1, 1, 0, 1, 1, 1]",7618,2930,4688,279,438,0.09522184300341296,0.09343003412969283
"[0, 1, 0, 1, 1, 0, 0, 1, 1, 1]",8800,3897,4903,393,448,0.100846805234796,0.09137262900265143
"[0, 1, 1, 0, 1, 1, 0, 1, 0, 1]",5501,2438,3063,249,278,0.10213289581624282,0.09076069213189683
"[1, 1, 0, 1, 1, 1, 0, 0, 1, 0]",5664,2313,3351,219,318,0.0946822308690013,0.09489704565801253
"[1, 1, 1, 0, 0, 0, 1, 1, 0, 0]",7083,3074,4009,312,389,0.1014964216005205,0.09703167872287354
"[0, 0, 1, 0, 0, 1, 1, 1, 0, 1]",4756,2319,2437,220,222,0.0948684777921518,0.09109560935576529
"[1, 0, 0, 1, 0, 0, 1, 1, 1, 0]",5120,2443,2677,225,281,0.09209987720016373,0.10496824803884945
"[1, 0, 1, 1, 1, 1, 1, 0, 0, 0]",8029,3360,4669,317,431,0.0943452380952381,0.09231098736346113
"[1, 1, 1, 0, 1, 1, 0, 1, 1, 0]",10133,3281,6852,317,637,0.09661688509600731,0.09296555750145943
"[0, 1, 0, 1, 0, 1, 0, 1, 0, 0]",5531,3215,2316,316,222,0.09828926905132193,0.09585492227979274
"[0, 0, 1, 1, 1, 1, 0, 1, 0, 1]",7284,3049,4235,300,416,0.09839291571006888,0.09822904368358913
"[1, 1, 0, 1, 0, 0, 1, 1, 1, 1]",14277,4777,9500,437,916,0.09148000837345614,0.09642105263157895
"[0, 1, 1, 0, 0, 0, 1, 0, 0, 0]",11646,8209,3437,780,330,0.09501766354001706,0.09601396566773349
"[1, 0, 1, 1, 0, 0, 0, 1, 0, 0]",5716,3343,2373,337,220,0.10080765779240203,0.09270965023177413
"[1, 1, 1, 0, 0, 0, 1, 0, 0, 0]",6864,3628,3236,334,281,0.09206174200661521,0.08683559950556242
"[1, 0, 0, 1, 0, 1, 0, 0, 1, 0]",5389,3037,2352,282,231,0.09285479091208429,0.09821428571428571
"[1, 0, 0, 1, 0, 1, 0, 1, 0, 1]",4681,2234,2447,189,251,0.0846016114592659,0.10257458111973845
"[1, 1, 0, 0, 1, 0, 1, 0, 1, 0]",4862,2433,2429,248,243,0.1019317714755446,0.10004116920543434
"[1, 1, 0, 1, 1, 0, 1, 1, 0, 1]",9511,3165,6346,317,578,0.10015797788309637,0.09108099590293098
"[0, 0, 1, 1, 1, 1, 1, 0, 0, 1]",9599,4164,5435,419,489,0.10062439961575408,0.08997240110395584
"[0, 1, 0, 1, 1, 1, 1, 1, 0, 0]",7544,3266,4278,283,411,0.08665033680342928,0.09607293127629733
"[0, 1, 0, 1, 0, 0, 1, 1, 0, 0]",7432,4388,3044,398,335,0.09070191431175935,0.11005256241787122
"[0, 1, 0, 1, 0, 0, 1, 1, 0, 1]",4595,2322,2273,196,219,0.08440999138673558,0.0963484381874175
"[0, 0, 1, 0, 1, 1, 1, 0, 1, 0]",4589,2320,2269,213,221,0.09181034482758621,0.09739973556632878
"[0, 0, 1, 0, 1, 0, 1, 1, 0, 0]",6571,3848,2723,352,258,0.09147609147609148,0.09474843922144693
"[1, 0, 0, 1, 1, 0, 1, 0, 0, 1]",5344,2379,2965,209,252,0.0878520386717108,0.08499156829679595
"[0, 0, 1, 1, 0, 1, 1, 0, 1, 0]",4839,2471,2368,233,255,0.094293808174828,0.10768581081081081
"[1, 0, 0, 0, 0, 0, 0, 1, 1, 0]",25713,10413,15300,1037,1373,0.09958705464323442,0.08973856209150327
"[1, 0, 1, 1, 0, 1, 0, 0, 0, 0]",6339,3502,2837,310,253,0.0885208452312964,0.08917870990482904
"[1, 1, 1, 0, 1, 1, 0, 0, 0, 0]",7056,3273,3783,304,377,0.09288114879315612,0.09965635738831616
"[0, 0, 0, 1, 1, 1, 1, 0, 0, 0]",21643,17338,4305,1600,443,0.09228284692582767,0.10290360046457607
"[0, 0, 0, 1, 0, 1, 0, 0, 0, 0]",29717,22375,7342,2110,712,0.09430167597765363,0.09697630073549442
"[0, 0, 1, 1, 1, 0, 1, 0, 0, 0]",6771,3971,2800,404,262,0.10173759758247293,0.09357142857142857
"[0, 0, 1, 1, 0, 0, 0, 0, 1, 0]",13964,9203,4761,856,400,0.09301314788655873,0.08401596303297626
"[1, 0, 0, 1, 1, 0, 0, 0, 0, 1]",17561,5252,12309,459,1141,0.0873952779893374,0.09269640100739296
"[0, 0, 0, 0, 1, 0, 0, 1, 0, 1]",10746,7323,3423,684,308,0.09340434248258911,0.08997955010224949
"[1, 1, 0, 0, 0, 0, 0, 0, 0, 1]",18392,11958,6434,1099,582,0.09190500083626024,0.09045694746658377
"[0, 1, 1, 1, 0, 0, 0, 0, 0, 0]",16671,11208,5463,1054,510,0.09403997144896503,0.09335529928610653
"[1, 1, 0, 1, 1, 0, 0, 1, 1, 1]",15070,5091,9979,458,982,0.08996267923787075,0.09840665397334403
"[0, 0, 0, 0, 0, 1, 0, 0, 0, 0]",133747,112110,21637,10796,2077,0.0962982784764963,0.09599297499653371
"[0, 0, 0, 0, 1, 0, 1, 1, 0, 0]",11936,8147,3789,741,375,0.09095372529765558,0.09897070467141726
"[0, 0, 1, 1, 0, 1, 1, 0, 0, 0]",7355,4393,2962,405,301,0.09219212383337128,0.10162052667116812
"[1, 1, 1, 0, 0, 1, 0, 1, 1, 1]",13678,4116,9562,395,861,0.09596695821185618,0.09004392386530015
"[1, 1, 1, 1, 1, 1, 1, 0, 0, 1]",73808,11703,62105,1099,5914,0.09390754507391268,0.09522582722808147
"[0, 1, 1, 1, 1, 0, 1, 1, 1, 1]",32594,10562,22032,1027,2125,0.09723537208861958,0.09645061728395062
"[0, 1, 0, 0, 1, 0, 0, 1, 0, 0]",9667,6473,3194,600,278,0.09269272362119574,0.08703819661865998
"[0, 0, 0, 0, 1, 1, 1, 1, 1, 1]",35314,16149,19165,1571,1951,0.09728156542200755,0.1018001565353509
"[1, 0, 1, 0, 1, 1, 0, 1, 0, 0]",4608,2268,2340,208,206,0.09171075837742504,0.08803418803418804
"[1, 0, 0, 0, 1, 0, 1, 1, 0, 0]",6483,3717,2766,363,275,0.09765940274414851,0.09942154736080984
"[0, 1, 1, 0, 0, 0, 1, 0, 1, 1]",6116,3580,2536,344,250,0.09608938547486033,0.09858044164037855
"[0, 0, 1, 0, 1, 1, 1, 1, 1, 0]",6482,2891,3591,263,353,0.09097198201314424,0.09830130882762461
"[1, 1, 1, 1, 0, 1, 1, 0, 0, 0]",7558,3023,4535,319,437,0.10552431359576579,0.09636163175303197
"[0, 1, 1, 1, 1, 0, 1, 1, 0, 0]",7034,3227,3807,327,318,0.1013325069724202,0.08353033884948778
"[0, 0, 1, 1, 0, 1, 1, 0, 1, 1]",7047,3005,4042,302,395,0.10049916805324459,0.09772389905987135
"[1, 0, 1, 1, 1, 1, 0, 0, 1, 1]",16039,5345,10694,522,1062,0.09766136576239476,0.09930802319057415
"[0, 1, 0, 1, 1, 0, 1, 0, 1, 0]",4336,2206,2130,204,198,0.09247506799637353,0.09295774647887324
"[1, 0, 0, 1, 0, 1, 1, 1, 1, 0]",6308,2548,3760,251,367,0.09850863422291994,0.0976063829787234
"[0, 0, 1, 1, 0, 1, 1, 1, 1, 1]",14873,5388,9485,541,867,0.1004083147735709,0.09140748550342646
"[1, 1, 1, 1, 0, 0, 1, 1, 0, 1]",14525,4919,9606,489,898,0.0994104492783086,0.09348323964189048
"[1, 0, 1, 0, 0, 0, 0, 0, 1, 0]",9586,6295,3291,594,304,0.0943606036536934,0.09237313886356731
"[0, 1, 0, 0, 1, 1, 1, 0, 0, 0]",6739,4105,2634,411,247,0.10012180267965895,0.09377372817008352
"[1, 1, 1, 0, 0, 1, 1, 1, 0, 1]",12727,3534,9193,342,846,0.0967741935483871,0.09202654193408027
"[0, 1, 0, 0, 0, 0, 1, 1, 1, 1]",10250,5603,4647,528,457,0.0942352311261824,0.0983430170002152
"[1, 1, 1, 0, 1, 0, 0, 0, 0, 1]",5923,2782,3141,254,302,0.09130122214234364,0.09614772365488698
"[1, 1, 1, 1, 0, 0, 1, 0, 0, 0]",6605,3204,3401,314,316,0.09800249687890138,0.09291384886798
"[0, 1, 1, 1, 1, 0, 0, 1, 1, 0]",16783,11664,5119,1068,489,0.09156378600823045,0.09552647001367455
"[1, 1, 0, 1, 1, 1, 0, 1, 1, 1]",29341,7316,22025,682,2027,0.09322033898305085,0.09203178206583428
"[1, 0, 0, 1, 0, 1, 1, 0, 1, 1]",6194,2427,3767,227,352,0.09353110836423568,0.0934430581364481
"[0, 1, 1, 1, 0, 0, 0, 1, 0, 1]",5047,2673,2374,239,212,0.08941264496820052,0.08930075821398484
"[1, 0, 1, 0, 1, 1, 1, 0, 0, 0]",5571,2680,2891,244,283,0.09104477611940298,0.09789000345901072
"[0, 0, 1, 0, 1, 0, 1, 1, 1, 0]",4859,2505,2354,250,248,0.0998003992015968,0.10535259133389975
"[1, 1, 1, 0, 0, 1, 0, 1, 0, 1]",6300,2325,3975,206,386,0.08860215053763441,0.09710691823899371
"[0, 1, 1, 1, 1, 1, 1, 1, 0, 0]",17948,7276,10672,713,1014,0.0979934029686641,0.09501499250374812
"[1, 0, 1, 0, 1, 1, 1, 1, 0, 1]",9806,3275,6531,323,654,0.09862595419847328,0.10013780431786863
"[0, 0, 1, 1, 0, 1, 0, 1, 1, 1]",8319,3784,4535,368,430,0.09725158562367865,0.09481808158765159
"[0, 1, 0, 1, 1, 1, 0, 1, 0, 1]",5440,2338,3102,197,303,0.08426005132591959,0.097678916827853
"[1, 0, 1, 0, 1, 1, 1, 0, 1, 0]",5152,2149,3003,230,272,0.10702652396463472,0.09057609057609058
"[1, 0, 1, 0, 1, 1, 0, 1, 1, 0]",5527,2284,3243,227,303,0.09938704028021016,0.09343200740055504
"[1, 0, 1, 1, 1, 1, 0, 1, 0, 0]",5902,2441,3461,239,329,0.09791069233920524,0.09505923143600116
"[1, 1, 0, 1, 0, 1, 1, 0, 0, 1]",6693,2700,3993,259,350,0.09592592592592593,0.0876533934385174
"[0, 0, 1, 0, 0, 1, 1, 0, 1, 1]",5399,2757,2642,256,242,0.09285455204932898,0.09159727479182438
"[1, 1, 1, 0, 0, 1, 0, 0, 1, 1]",8062,3015,5047,291,465,0.09651741293532339,0.09213394095502278
"[1, 1, 0, 0, 0, 1, 1, 0, 0, 1]",6997,3461,3536,346,373,0.0999711066165848,0.10548642533936652
"[0, 1, 0, 0, 1, 0, 1, 1, 0, 1]",4526,2263,2263,223,200,0.09854175872735307,0.08837825894829872
"[1, 1, 0, 1, 1, 0, 0, 1, 0, 0]",5026,2489,2537,237,246,0.09521896343913218,0.09696491919590067
"[0, 0, 0, 1, 0, 1, 1, 0, 1, 1]",5625,2928,2697,277,246,0.09460382513661202,0.09121245828698554
"[1, 1, 1, 0, 0, 0, 0, 0, 1, 0]",7327,3506,3821,331,331,0.09440958357102111,0.08662653755561371
"[0, 0, 0, 1, 1, 0, 1, 0, 0, 1]",6735,4296,2439,423,228,0.09846368715083799,0.09348093480934809
"[0, 0, 1, 1, 0, 1, 1, 1, 0, 1]",6009,2524,3485,225,329,0.08914421553090333,0.09440459110473458
"[0, 0, 1, 1, 1, 0, 1, 1, 1, 0]",6206,2653,3553,262,317,0.09875612514134942,0.08922037714607374
"[1, 0, 0, 1, 1, 1, 0, 0, 1, 1]",8918,3289,5629,306,557,0.09303739738522347,0.09895185645763013
"[0, 1, 0, 1, 0, 1, 1, 0, 0, 1]",5439,2796,2643,287,228,0.10264663805436337,0.08626560726447219
"[1, 1, 1, 0, 1, 1, 1, 0, 0, 0]",7202,2755,4447,252,427,0.09147005444646097,0.09601978862154262
"[0, 0, 1, 1, 1, 1, 1, 0, 1, 0]",6870,2888,3982,304,361,0.10526315789473684,0.09065796082370668
"[0, 0, 0, 0, 0, 1, 1, 1, 0, 1]",8101,5399,2702,507,245,0.09390627894054454,0.09067357512953368
"[0, 1, 1, 0, 1, 1, 1, 0, 0, 1]",6590,2829,3761,259,356,0.09155178508306822,0.09465567668173358
"[0, 0, 1, 0, 0, 1, 1, 0, 1, 0]",5534,3220,2314,299,229,0.09285714285714286,0.0989628349178911
"[1, 0, 0, 1, 1, 1, 1, 0, 1, 0]",7091,2357,4734,242,429,0.10267288926601613,0.09062103929024082
"[1, 1, 1, 0, 0, 0, 1, 0, 1, 0]",5231,2397,2834,232,295,0.09678765123070505,0.10409315455187015
"[1, 0, 1, 0, 1, 0, 0, 1, 1, 0]",5207,2554,2653,246,273,0.09631949882537197,0.10290237467018469
"[1, 0, 0, 0, 0, 0, 1, 1, 1, 1]",12169,5557,6612,532,641,0.09573510887169336,0.0969449485783424
"[0, 1, 0, 1, 1, 0, 0, 1, 0, 1]",4637,2309,2328,233,224,0.10090948462537895,0.09621993127147767
"[1, 1, 1, 0, 1, 1, 1, 1, 1, 0]",28405,6930,21475,656,2056,0.09466089466089467,0.09573923166472642
"[0, 1, 0, 0, 0, 1, 1, 0, 0, 1]",7227,4177,3050,388,294,0.09288963370840315,0.09639344262295083
"[1, 0, 1, 1, 0, 1, 0, 0, 0, 1]",4771,2394,2377,221,235,0.0923141186299081,0.09886411442995373
"[0, 0, 1, 1, 1, 0, 0, 1, 1, 1]",10473,4730,5743,432,539,0.09133192389006342,0.09385338673167334
"[0, 0, 0, 0, 0, 0, 0, 0, 0, 1]",215153,185957,29196,17694,2742,0.095151029539087,0.09391697492807234
"[0, 1, 0, 0, 0, 0, 0, 0, 0, 0]",147275,121051,26224,11493,2471,0.09494345358567877,0.09422666259914582
"[1, 0, 0, 0, 1, 0, 0, 0, 1, 0]",9593,6160,3433,576,328,0.09350649350649351,0.09554325662685698
"[0, 1, 1, 1, 0, 1, 0, 0, 0, 1]",5084,2753,2331,252,232,0.09153650563022157,0.09952809952809953
"[1, 0, 1, 0, 0, 0, 0, 1, 1, 1]",8198,4131,4067,415,360,0.10045993706124424,0.08851733464470125
"[0, 0, 0, 0, 0, 0, 1, 0, 0, 1]",33932,25962,7970,2482,749,0.09560126338494723,0.09397741530740276
"[0, 0, 0, 1, 0, 0, 0, 0, 1, 0]",26160,19744,6416,1908,627,0.09663695299837925,0.09772443890274314
"[0, 1, 0, 1, 1, 1, 0, 0, 0, 1]",4909,2531,2378,246,217,0.09719478467009088,0.09125315391084945
"[0, 1, 0, 1, 0, 1, 0, 0, 1, 1]",5592,2926,2666,286,262,0.09774436090225563,0.09827456864216054
"[0, 0, 1, 0, 0, 0, 0, 1, 1, 0]",13358,8996,4362,823,419,0.09148510449088484,0.09605685465382852
"[0, 0, 0, 0, 1, 0, 0, 0, 1, 1]",16466,11764,4702,1129,439,0.09597075824549473,0.09336452573373033
"[0, 0, 1, 0, 1, 0, 0, 0, 1, 1]",7488,4517,2971,419,266,0.09276068186849679,0.08953214405923932
"[0, 0, 1, 1, 0, 1, 0, 1, 1, 0]",5134,2626,2508,245,233,0.0932977913175933,0.09290271132376396
"[1, 0, 1, 1, 1, 0, 0, 0, 0, 1]",6702,3223,3479,346,310,0.10735339745578654,0.08910606496119575
"[1, 1, 1, 0, 1, 0, 1, 1, 0, 1]",9837,3234,6603,300,618,0.09276437847866419,0.09359382099045888
"[1, 1, 0, 1, 1, 1, 1, 0, 1, 0]",9660,3198,6462,333,608,0.10412757973733583,0.09408851748684617
"[1, 1, 0, 1, 0, 0, 1, 1, 1, 0]",5738,2357,3381,228,312,0.09673313534153585,0.09228039041703638
"[1, 1, 1, 1, 0, 1, 1, 1, 1, 0]",29149,7188,21961,732,2029,0.1018363939899833,0.09239105687354857
"[0, 1, 1, 0, 1, 1, 1, 1, 1, 0]",10503,3796,6707,355,664,0.09351949420442571,0.0990010436857015
"[1, 1, 1, 0, 0, 0, 1, 1, 1, 1]",17427,5208,12219,479,1153,0.09197388632872504,0.09436124069072756
"[1, 0, 1, 0, 1, 0, 1, 1, 1, 1]",11745,4043,7702,378,777,0.09349492950779124,0.1008828875616723
"[1, 1, 0, 1, 0, 1, 0, 1, 1, 1]",11490,3854,7636,395,719,0.10249091852620654,0.09415924567836563
"[1, 1, 0, 1, 0, 1, 1, 0, 1, 0]",5387,2257,3130,195,304,0.08639787328311918,0.09712460063897764
"[1, 1, 1, 1, 0, 1, 1, 1, 0, 0]",12609,4007,8602,404,845,0.10082355877214874,0.09823296907695885
"[0, 0, 1, 0, 0, 1, 1, 0, 0, 0]",13640,9212,4428,900,415,0.09769865392965697,0.09372177055103885
"[1, 0, 0, 0, 0, 1, 0, 1, 0, 0]",10476,6444,4032,613,377,0.09512725015518311,0.09350198412698413
"[1, 1, 1, 0, 1, 0, 1, 1, 1, 0]",10306,3294,7012,332,650,0.100789313904068,0.09269823160296635
"[0, 0, 1, 0, 1, 1, 0, 1, 0, 1]",4602,2342,2260,208,207,0.0888129803586678,0.0915929203539823
"[1, 0, 0, 1, 1, 1, 0, 1, 1, 1]",13589,3832,9757,358,890,0.09342379958246347,0.09121656246797172
"[1, 1, 1, 1, 0, 0, 1, 1, 1, 0]",14334,4759,9575,460,937,0.09665896196679975,0.09785900783289818
"[0, 1, 1, 1, 1, 0, 1, 0, 0, 0]",5711,3159,2552,307,249,0.0971826527382083,0.0975705329153605
"[1, 1, 1, 1, 1, 1, 0, 0, 1, 0]",13912,4495,9417,431,922,0.09588431590656285,0.097908038653499
"[1, 1, 0, 0, 0, 0, 1, 1, 0, 0]",27877,15753,12124,1463,1165,0.09287119913667238,0.09609039920818212
"[0, 0, 1, 1, 1, 1, 0, 0, 1, 0]",7354,3793,3561,342,355,0.09016609543896652,0.09969109800617804
"[1, 0, 0, 0, 1, 0, 1, 1, 1, 1]",8005,3060,4945,296,468,0.09673202614379085,0.09464105156723963
"[0, 1, 1, 0, 0, 1, 0, 0, 0, 0]",12211,8495,3716,783,363,0.09217186580341377,0.09768568353067815
"[1, 1, 1, 0, 1, 0, 1, 0, 0, 1]",6087,2385,3702,244,380,0.10230607966457023,0.10264721772015127
"[1, 0, 1, 1, 0, 1, 1, 1, 1, 0]",10543,3529,7014,346,685,0.09804477189005384,0.09766181921870544
"[0, 0, 0, 0, 0, 0, 1, 1, 1, 0]",15997,10759,5238,1024,467,0.0951761316107445,0.0891561664757541
"[0, 0, 0, 0, 1, 1, 0, 1, 1, 1]",10306,5787,4519,587,460,0.10143424917919475,0.10179243195397211
"[0, 1, 0, 0, 0, 0, 0, 1, 1, 0]",13272,8940,4332,851,393,0.09519015659955257,0.0907202216066482
"[0, 0, 1, 0, 0, 1, 0, 0, 1, 1]",7564,4572,2992,412,286,0.09011373578302712,0.09558823529411764
"[0, 1, 0, 1, 1, 1, 0, 0, 0, 0]",7743,4434,3309,444,326,0.10013531799729364,0.09851919008763978
"[0, 1, 0, 1, 1, 1, 1, 0, 1, 1]",10349,3539,6810,331,686,0.09352924554959027,0.10073421439060205
"[0, 0, 0, 0, 0, 1, 1, 0, 1, 0]",12369,8800,3569,825,325,0.09375,0.09106192210703279
"[1, 0, 1, 0, 0, 0, 0, 1, 0, 1]",5634,3256,2378,323,216,0.0992014742014742,0.09083263246425567
"[1, 0, 1, 0, 1, 0, 0, 0, 0, 1]",6477,3612,2865,349,275,0.09662236987818383,0.09598603839441536
"[1, 0, 1, 0, 1, 1, 0, 0, 0, 0]",7661,4300,3361,440,337,0.10232558139534884,0.10026777744718833
"[0, 1, 0, 1, 0, 1, 1, 0, 0, 0]",6644,3905,2739,397,273,0.10166453265044814,0.09967141292442497
"[1, 1, 1, 0, 1, 0, 0, 0, 0, 0]",7690,4159,3531,414,327,0.09954315941332051,0.09260832625318606
"[1, 0, 0, 1, 1, 0, 0, 1, 1, 0]",15384,4049,11335,391,1041,0.09656705359347988,0.09183943537715042
"[1, 1, 1, 0, 1, 1, 0, 0, 1, 1]",14036,4340,9696,437,924,0.10069124423963134,0.0952970297029703
"[1, 1, 0, 0, 0, 1, 0, 1, 0, 0]",6374,3629,2745,341,265,0.09396527969137504,0.0965391621129326
"[1, 0, 0, 0, 1, 0, 0, 0, 0, 0]",29871,21579,8292,2052,821,0.09509245099402197,0.09901109503135552
"[0, 0, 0, 1, 1, 0, 1, 0, 1, 0]",6154,3871,2283,365,212,0.09429088090932576,0.09286027157249234
"[0, 1, 0, 1, 0, 1, 0, 0, 0, 1]",5742,3392,2350,312,196,0.09198113207547169,0.08340425531914894
"[0, 1, 1, 1, 0, 1, 1, 1, 0, 0]",6569,2889,3680,279,345,0.09657320872274143,0.09375
"[0, 1, 1, 0, 0, 1, 0, 1, 0, 1]",5198,2900,2298,288,214,0.0993103448275862,0.09312445604873804
"[1, 1, 0, 1, 0, 1, 1, 1, 1, 0]",10858,3629,7229,367,695,0.10112978782033619,0.09614054502697468
"[1, 1, 1, 1, 1, 0, 1, 1, 0, 0]",13078,3974,9104,342,900,0.08605938600905888,0.09885764499121265
"[1, 0, 1, 1, 0, 1, 1, 0, 1, 1]",9955,3305,6650,340,628,0.10287443267776097,0.09443609022556392
"[1, 1, 0, 0, 0, 1, 1, 1, 0, 0]",6250,2953,3297,299,303,0.10125296308838469,0.09190172884440401
"[1, 0, 0, 0, 1, 0, 1, 0, 1, 1]",5352,2492,2860,223,262,0.08948635634028893,0.09160839160839161
"[0, 1, 1, 1, 0, 1, 1, 1, 0, 1]",9679,3442,6237,325,625,0.09442184776292853,0.10020843354176688
"[1, 0, 1, 0, 1, 0, 0, 1, 0, 1]",4494,2283,2211,202,216,0.08848007008322382,0.09769335142469471
"[1, 0, 0, 1, 0, 1, 0, 0, 1, 1]",5744,2710,3034,233,278,0.08597785977859779,0.09162821357943308
"[1, 0, 0, 0, 1, 1, 0, 0, 0, 1]",6640,3697,2943,369,293,0.09981065728969435,0.09955827387020047
"[1, 1, 1, 0, 1, 0, 0, 1, 0, 0]",4978,2334,2644,223,222,0.09554413024850043,0.08396369137670197
"[0, 0, 1, 0, 1, 0, 0, 1, 0, 1]",5627,3342,2285,329,238,0.09844404548174746,0.10415754923413567
"[1, 0, 1, 0, 1, 0, 1, 1, 1, 0]",5569,2284,3285,215,297,0.09413309982486866,0.09041095890410959
"[1, 1, 0, 1, 1, 1, 0, 1, 0, 0]",5878,2377,3501,219,306,0.09213294068153134,0.08740359897172237
"[1, 1, 0, 1, 1, 1, 1, 1, 0, 1]",26193,6379,19814,585,1902,0.09170716413230914,0.09599273241142627
"[0, 0, 0, 0, 0, 0, 1, 1, 0, 0]",83181,62274,20907,5821,1887,0.09347400199120018,0.09025685177213373
"[0, 0, 1, 1, 0, 0, 0, 0, 0, 0]",82380,60781,21599,5744,2044,0.09450321646567184,0.0946340108338349
"[0, 1, 1, 0, 0, 0, 1, 1, 0, 0]",8268,5179,3089,470,304,0.09075111025294458,0.09841372612495954
"[0, 0, 0, 1, 1, 0, 0, 1, 1, 0]",20124,16080,4044,1506,364,0.09365671641791044,0.09000989119683482
"[0, 1, 1, 0, 1, 1, 0, 1, 0, 0]",4859,2520,2339,241,199,0.09563492063492063,0.08507909362975631
"[0, 1, 0, 0, 1, 0, 0, 1, 0, 1]",5419,3218,2201,317,221,0.09850839030453698,0.1004089050431622
"[0, 0, 1, 0, 0, 1, 0, 0, 1, 0]",9462,6361,3101,583,303,0.09165225593460148,0.09771041599484037
"[1, 1, 1, 0, 0, 1, 1, 0, 0, 0]",16395,4151,12244,376,1138,0.0905805829920501,0.09294348252205162
"[1, 1, 0, 0, 0, 0, 0, 0, 1, 1]",32190,18410,13780,1743,1312,0.09467680608365019,0.09521044992743107
"[0, 1, 0, 1, 1, 0, 0, 0, 0, 0]",13495,8855,4640,827,446,0.09339356295878035,0.09612068965517241
"[1, 0, 0, 0, 1, 1, 0, 1, 1, 0]",5055,2383,2672,229,276,0.0960973562736047,0.10329341317365269
"[1, 1, 0, 0, 0, 1, 1, 0, 1, 1]",7246,3014,4232,295,374,0.09787657597876576,0.0883742911153119
"[0, 1, 1, 1, 0, 0, 0, 1, 1, 0]",5387,2867,2520,293,231,0.10219741890477851,0.09166666666666666
"[0, 0, 0, 0, 0, 0, 0, 1, 0, 1]",34832,27004,7828,2555,726,0.09461561250185158,0.09274399591211037
"[1, 1, 1, 1, 1, 1, 1, 1, 1, 0]",179881,26885,152996,2545,14599,0.09466245118095593,0.0954207953149102
"[1, 0, 1, 1, 1, 1, 1, 1, 0, 1]",26052,6505,19547,635,1853,0.09761721752498079,0.09479715557374534
"[0, 1, 0, 1, 1, 1, 1, 1, 1, 1]",35381,9988,25393,979,2506,0.09801762114537445,0.09868861497263025
"[1, 0, 1, 0, 0, 1, 1, 1, 1, 1]",14680,5038,9642,491,909,0.09745930924970227,0.09427504667081518
"[0, 0, 0, 0, 1, 1, 0, 0, 0, 0]",82618,61504,21114,5714,2010,0.09290452653485952,0.0951974992895709
"[1, 1, 0, 1, 0, 0, 0, 0, 1, 1]",7048,3404,3644,335,336,0.09841363102232667,0.09220636663007684
"[0, 1, 0, 1, 0, 1, 1, 0, 1, 0]",4377,2207,2170,199,168,0.09016764839148166,0.07741935483870968
"[1, 1, 0, 0, 0, 0, 0, 1, 0, 0]",12438,8138,4300,814,415,0.10002457606291472,0.09651162790697675
"[0, 1, 0, 1, 1, 1, 1, 1, 0, 1]",9750,3349,6401,333,607,0.09943266646760227,0.094828932979222
"[0, 1, 1, 1, 0, 0, 1, 0, 1, 1]",6380,2875,3505,290,334,0.10086956521739131,0.09529243937232525
"[1, 0, 1, 0, 0, 1, 1, 1, 0, 0]",5131,2545,2586,247,245,0.09705304518664047,0.09474091260634183
"[0, 1, 1, 0, 1, 0, 1, 0, 1, 1]",6023,2758,3265,252,316,0.09137055837563451,0.09678407350689128
"[0, 0, 0, 1, 1, 0, 1, 0, 1, 1]",6294,3681,2613,340,251,0.0923662048356425,0.09605817068503636
"[1, 0, 0, 1, 1, 0, 0, 1, 0, 1]",6112,2386,3726,217,366,0.09094719195305952,0.09822866344605476
"[1, 1, 1, 1, 1, 0, 0, 1, 1, 0]",26273,5366,20907,505,2004,0.09411106969809914,0.09585306356722628
"[1, 1, 1, 1, 1, 1, 1, 0, 0, 0]",30062,6475,23587,665,2331,0.10270270270270271,0.09882562428456353
"[0, 0, 1, 1, 0, 0, 0, 1, 1, 1]",10920,6182,4738,628,455,0.1015852474927208,0.09603208104685522
"[0, 0, 0, 1, 0, 0, 1, 1, 0, 0]",13531,9311,4220,886,428,0.0951562667812265,0.1014218009478673
"[0, 1, 0, 1, 0, 0, 0, 0, 0, 1]",10935,7400,3535,680,323,0.0918918918918919,0.09137199434229137
"[1, 1, 0, 1, 1, 1, 0, 1, 0, 1]",9715,3184,6531,311,642,0.09767587939698492,0.0983004134129536
"[0, 0, 1, 1, 1, 0, 0, 1, 0, 0]",6544,3864,2680,401,235,0.10377846790890269,0.08768656716417911
"[0, 0, 0, 1, 1, 1, 0, 0, 1, 0]",6322,3907,2415,399,241,0.10212439211671359,0.09979296066252588
"[0, 0, 1, 1, 1, 0, 0, 0, 1, 1]",6992,3801,3191,370,319,0.09734280452512496,0.09996866186148542
"[1, 0, 0, 1, 0, 1, 0, 1, 1, 1]",7279,2841,4438,265,420,0.09327701513551566,0.0946372239747634
"[1, 1, 0, 0, 1, 0, 1, 0, 1, 1]",6876,2867,4009,269,390,0.09382629926752703,0.09728111748565726
"[0, 1, 0, 0, 0, 1, 1, 1, 1, 0]",6366,3310,3056,301,295,0.09093655589123867,0.09653141361256544
"[1, 0, 0, 0, 1, 0, 0, 1, 0, 1]",5792,3209,2583,344,261,0.10719850420691804,0.10104529616724739
"[0, 1, 0, 1, 1, 0, 1, 0, 0, 1]",4770,2454,2316,219,206,0.08924205378973105,0.08894645941278066
"[0, 1, 0, 1, 0, 1, 0, 1, 1, 0]",4712,2431,2281,252,220,0.10366104483751543,0.09644892590968873
"[1, 0, 0, 0, 1, 1, 1, 1, 1, 1]",18410,5877,12533,553,1186,0.09409562702058874,0.09463017633447698
"[1, 1, 1, 1, 1, 0, 0, 0, 1, 1]",16733,4572,12161,451,1155,0.09864391951006124,0.09497574212646986
"[1, 1, 0, 0, 1, 0, 0, 1, 1, 0]",5591,2704,2887,254,216,0.09393491124260354,0.0748181503290613
"[0, 1, 1, 0, 0, 1, 1, 0, 0, 1]",15889,11833,4056,1108,378,0.09363644046311163,0.09319526627218935
"[1, 0, 1, 1, 0, 0, 0, 0, 0, 1]",6983,3930,3053,409,315,0.10407124681933842,0.10317720275139207
"[1, 0, 1, 1, 1, 0, 0, 1, 0, 0]",4942,2473,2469,235,205,0.0950262838657501,0.08302956662616444
"[1, 1, 0, 1, 1, 0, 0, 0, 1, 0]",4614,2331,2283,219,195,0.09395109395109395,0.08541392904073587
"[1, 0, 1, 0, 0, 1, 0, 0, 0, 0]",10809,7007,3802,619,373,0.08834023119737405,0.09810625986322988
"[1, 1, 0, 1, 1, 0, 1, 0, 1, 0]",5414,2230,3184,202,308,0.09058295964125561,0.09673366834170855
"[1, 0, 0, 1, 1, 0, 1, 0, 1, 0]",4899,2181,2718,206,261,0.09445208619899129,0.09602649006622517
"[0, 0, 1, 1, 1, 0, 1, 1, 0, 0]",5795,2940,2855,279,274,0.09489795918367347,0.09597197898423818
"[0, 1, 0, 0, 1, 1, 1, 1, 0, 1]",5940,2583,3357,252,357,0.0975609756097561,0.1063449508489723
"[0, 1, 1, 1, 0, 1, 0, 1, 0, 1]",5535,2415,3120,217,309,0.08985507246376812,0.09903846153846153
"[1, 1, 0, 1, 1, 1, 1, 0, 0, 0]",8156,3381,4775,309,482,0.09139307897071872,0.10094240837696335
"[1, 0, 1, 0, 1, 1, 0, 0, 1, 0]",4564,2246,2318,215,252,0.09572573463935886,0.10871440897325281
"[1, 0, 1, 0, 0, 0, 1, 1, 0, 0]",7276,4066,3210,406,299,0.09985243482538121,0.09314641744548287
"[0, 0, 0, 0, 1, 1, 0, 1, 1, 0]",7476,4430,3046,448,260,0.10112866817155756,0.08535784635587657
"[0, 0, 1, 0, 0, 0, 1, 0, 0, 1]",10251,6847,3404,662,342,0.09668467942164452,0.10047003525264395
"[1, 1, 1, 0, 0, 0, 0, 0, 0, 1]",18568,5564,13004,494,1267,0.08878504672897196,0.09743155952014765
"[1, 0, 1, 1, 0, 0, 1, 1, 1, 0]",6067,2574,3493,235,327,0.0912975912975913,0.0936158030346407
"[0, 1, 0, 0, 0, 0, 1, 0, 0, 0]",27074,20370,6704,1950,630,0.09572901325478646,0.09397374701670644
"[0, 0, 0, 0, 1, 0, 0, 0, 0, 1]",31209,23714,7495,2222,676,0.09369992409547102,0.09019346230820548
"[1, 1, 0, 1, 1, 1, 1, 1, 1, 1]",149780,26040,123740,2519,11641,0.0967357910906298,0.09407628899304994
"[1, 1, 1, 0, 1, 1, 0, 1, 0, 1]",9954,3246,6708,313,626,0.09642637091805299,0.09332140727489564
"[0, 0, 0, 0, 1, 1, 0, 0, 1, 0]",13832,9251,4581,891,435,0.09631391200951249,0.09495743287491815
"[0, 1, 1, 0, 0, 0, 1, 0, 0, 1]",6722,4326,2396,394,214,0.09107720758206195,0.08931552587646077
"[1, 0, 0, 1, 1, 0, 1, 0, 1, 1]",6919,2520,4399,239,412,0.09484126984126984,0.09365764946578768
"[1, 1, 1, 0, 0, 1, 1, 0, 1, 0]",6792,2341,4451,236,406,0.10081161896625374,0.09121545720062907
"[0, 0, 1, 1, 0, 0, 0, 1, 0, 1]",7324,4387,2937,456,280,0.10394346934123547,0.09533537623425264
"[1, 1, 1, 0, 1, 0, 0, 1, 1, 1]",13567,4284,9283,430,858,0.10037348272642391,0.0924270171280836
"[1, 1, 1, 0, 1, 1, 1, 1, 0, 1]",26678,6441,20237,620,2004,0.09625834497748796,0.09902653555368879
"[0, 0, 1, 1, 1, 1, 0, 0, 0, 1]",8482,4299,4183,421,397,0.09792975110490812,0.09490796079368874
"[0, 1, 0, 1, 1, 0, 0, 0, 1, 1]",5809,2985,2824,302,257,0.10117252931323283,0.0910056657223796
"[1, 0, 1, 0, 1, 1, 0, 0, 0, 1]",5022,2485,2537,241,241,0.09698189134808853,0.09499408750492708
"[0, 1, 0, 1, 1, 1, 1, 0, 1, 0]",5553,2335,3218,258,342,0.11049250535331906,0.10627719080174021
"[1, 1, 1, 0, 1, 1, 0, 1, 1, 1]",30713,7495,23218,733,2186,0.09779853235490327,0.09415108967180635
"[1, 1, 1, 1, 1, 0, 0, 0, 0, 1]",22564,4650,17914,458,1735,0.09849462365591398,0.09685162442782182
"[1, 1, 1, 1, 1, 0, 1, 1, 1, 0]",28687,6937,21750,665,2094,0.0958627648839556,0.09627586206896552
"[1, 1, 1, 1, 1, 0, 1, 0, 1, 1]",30891,7208,23683,668,2240,0.09267480577136515,0.0945826120001689
"[0, 0, 0, 0, 1, 0, 0, 1, 1, 0]",12620,8594,4026,802,383,0.0933209215731906,0.09513164431197219
"[1, 0, 0, 0, 0, 0, 0, 1, 1, 1]",25739,8714,17025,889,1565,0.10201973835207712,0.09192364170337738
"[0, 0, 1, 0, 0, 1, 1, 1, 0, 0]",6806,4017,2789,420,279,0.10455563853622106,0.10003585514521333
"[1, 1, 1, 1, 0, 0, 1, 0, 1, 1]",13207,4452,8755,422,827,0.09478885893980234,0.09446030839520274
"[0, 0, 0, 1, 1, 0, 0, 1, 0, 0]",12328,8969,3359,825,334,0.09198349871780577,0.0994343554629354
"[1, 1, 0, 1, 1, 0, 1, 1, 1, 0]",9952,3203,6749,307,626,0.09584764283484233,0.09275448214550304
"[0, 1, 1, 0, 1, 1, 1, 1, 0, 0]",7742,3391,4351,321,430,0.09466234149218519,0.09882785566536428
"[1, 0, 1, 0, 0, 1, 1, 0, 1, 0]",4424,2207,2217,192,218,0.08699592206615316,0.09833107803337844
"[0, 0, 0, 1, 1, 1, 1, 0, 1, 1]",8670,4798,3872,448,369,0.09337223843268028,0.0952995867768595
"[1, 0, 1, 0, 0, 0, 1, 1, 1, 1]",8551,3603,4948,340,492,0.09436580627255066,0.09943411479385611
"[1, 0, 0, 0, 0, 1, 0, 0, 1, 0]",9940,6134,3806,576,379,0.09390283664819041,0.09957961114030478
"[0, 1, 0, 0, 0, 0, 0, 0, 0, 1]",31623,23607,8016,2297,797,0.09730164781632566,0.09942614770459082
"[0, 0, 0, 1, 1, 1, 1, 1, 1, 0]",17812,12531,5281,1230,562,0.09815657170217859,0.10641923878053398
"[1, 1, 1, 1, 0, 1, 0, 1, 0, 1]",10452,3516,6936,352,680,0.10011376564277588,0.09803921568627451
"[0, 1, 1, 1, 1, 1, 0, 0, 0, 0]",9551,5068,4483,454,452,0.08958168902920284,0.10082534017399063
"[1, 1, 0, 0, 1, 1, 0, 1, 0, 0]",5900,3000,2900,264,281,0.088,0.09689655172413793
"[0, 1, 1, 0, 0, 1, 1, 0, 1, 0]",5830,3445,2385,339,214,0.09840348330914368,0.08972746331236897
"[0, 1, 1, 1, 0, 1, 1, 0, 1, 0]",5508,2455,3053,243,273,0.0989816700610998,0.0894202423845398
"[1, 0, 1, 1, 0, 1, 1, 0, 0, 1]",6523,2583,3940,237,353,0.09175377468060394,0.08959390862944162
"[0, 0, 0, 1, 1, 1, 0, 1, 1, 1]",8963,4819,4144,421,422,0.08736252334509234,0.10183397683397684
"[1, 0, 1, 0, 1, 0, 0, 0, 0, 0]",11361,7298,4063,711,369,0.09742395176760757,0.09081959143490032
"[1, 0, 1, 1, 1, 0, 0, 1, 1, 0]",7232,3050,4182,256,382,0.0839344262295082,0.09134385461501673
"[1, 1, 1, 0, 0, 0, 0, 0, 1, 1]",9674,3798,5876,364,539,0.09583991574512901,0.0917290673927842
"[1, 1, 1, 0, 1, 0, 1, 0, 1, 0]",5579,2213,3366,199,309,0.08992318120198825,0.09180035650623886
"[1, 0, 1, 1, 1, 0, 1, 1, 1, 0]",9683,3240,6443,347,589,0.10709876543209877,0.09141704175073724
"[0, 0, 0, 1, 1, 1, 1, 1, 0, 1]",7656,4022,3634,355,350,0.08826454500248633,0.09631260319207485
"[1, 0, 0, 0, 1, 1, 1, 0, 0, 1]",5707,2709,2998,235,291,0.08674787744555186,0.0970647098065377
"[1, 1, 0, 1, 1, 0, 1, 0, 0, 1]",6006,2482,3524,236,349,0.09508460918614021,0.09903518728717367
"[1, 0, 0, 1, 0, 0, 1, 0, 1, 1]",5326,2519,2807,276,270,0.10956728860658992,0.09618810117563235
"[1, 1, 1, 1, 0, 0, 0, 0, 0, 1]",9588,4611,4977,463,480,0.10041205812188246,0.09644364074743822
"[1, 1, 0, 1, 0, 0, 0, 0, 1, 0]",5559,3184,2375,307,246,0.09641959798994974,0.10357894736842105
"[1, 1, 0, 0, 1, 1, 0, 0, 1, 0]",7267,3537,3730,303,379,0.08566581849024597,0.10160857908847185
"[1, 0, 0, 1, 1, 0, 1, 1, 0, 0]",5770,2593,3177,228,307,0.08792903972232935,0.0966320428076802
"[1, 1, 1, 1, 1, 0, 1, 1, 1, 1]",145991,23823,122168,2337,11349,0.09809847626243547,0.09289666688494533
"[1, 0, 0, 1, 1, 1, 1, 1, 0, 1]",12736,3455,9281,325,882,0.09406657018813314,0.09503286283805625
"[0, 0, 0, 1, 1, 0, 0, 0, 0, 0]",71363,60895,10468,5662,960,0.09297971918876755,0.09170806266717615
"[1, 1, 0, 1, 0, 0, 0, 1, 1, 0]",5496,2741,2755,267,284,0.09740970448741336,0.10308529945553539
"[0, 0, 0, 0, 1, 1, 1, 0, 0, 1]",8430,5045,3385,500,306,0.09910802775024777,0.09039881831610044
"[0, 0, 0, 0, 1, 1, 1, 1, 0, 0]",29644,17723,11921,1632,1170,0.09208373300231337,0.09814612868047982
"[1, 1, 0, 1, 0, 0, 0, 1, 0, 0]",5636,3258,2378,302,221,0.09269490484960098,0.09293523969722456
"[0, 0, 0, 0, 1, 1, 1, 0, 1, 0]",7072,4169,2903,407,279,0.09762532981530343,0.09610747502583535
"[1, 0, 0, 0, 0, 1, 1, 1, 0, 1]",6423,2480,3943,248,384,0.1,0.09738777580522445
"[0, 1, 0, 0, 0, 0, 1, 1, 1, 0]",6198,3626,2572,364,258,0.10038610038610038,0.10031104199066875
"[0, 1, 0, 0, 1, 0, 1, 0, 0, 0]",10146,6824,3322,693,312,0.10155334114888628,0.09391932570740517
"[1, 0, 0, 0, 0, 1, 0, 0, 0, 1]",11008,6777,4231,645,404,0.09517485613103142,0.09548570077995745
"[0, 0, 1, 0, 0, 0, 0, 1, 0, 0]",26527,20054,6473,1948,577,0.09713772813403809,0.0891395025490499
"[1, 1, 0, 1, 1, 1, 1, 1, 1, 0]",29515,7633,21882,713,2069,0.09341019258482904,0.0945526003107577
"[0, 1, 1, 1, 0, 1, 1, 1, 1, 1]",32292,9631,22661,939,2145,0.09749766379399855,0.09465601694541283
"[1, 1, 0, 0, 0, 1, 0, 0, 1, 0]",6098,3526,2572,308,242,0.08735110606920023,0.09409020217729394
"[0, 1, 0, 0, 0, 1, 1, 1, 0, 0]",6503,3747,2756,394,229,0.10515078729650387,0.08309143686502177
"[1, 0, 1, 0, 0, 0, 1, 1, 1, 0]",4896,2435,2461,210,236,0.08624229979466119,0.09589597724502234
"[0, 0, 1, 1, 0, 1, 0, 0, 0, 0]",11826,7899,3927,752,367,0.09520192429421445,0.09345556404379934
"[0, 0, 0, 0, 1, 1, 0, 1, 0, 0]",12131,8179,3952,789,340,0.09646656070424257,0.0860323886639676
"[1, 0, 0, 0, 0, 1, 1, 0, 1, 0]",6829,3275,3554,303,336,0.09251908396946565,0.09454136184580754
"[1, 0, 1, 0, 0, 0, 0, 1, 1, 0]",7432,4335,3097,432,331,0.09965397923875433,0.10687762350661931
"[0, 1, 1, 1, 1, 0, 1, 0, 1, 1]",11342,4574,6768,428,667,0.09357236554438128,0.09855200945626477
"[1, 0, 1, 1, 1, 1, 0, 1, 0, 1]",9652,3226,6426,333,608,0.10322380657160571,0.09461562402738874
"[0, 0, 1, 1, 0, 1, 1, 1, 1, 0]",6850,2974,3876,274,340,0.09213180901143242,0.08771929824561403
"[1, 1, 0, 0, 1, 1, 0, 1, 1, 1]",15407,5324,10083,519,941,0.09748309541697972,0.09332539918674998
"[1, 0, 1, 0, 0, 1, 1, 0, 0, 0]",7715,4506,3209,438,328,0.09720372836218376,0.10221252726706138
"[1, 1, 1, 1, 0, 1, 0, 0, 1, 1]",12959,4190,8769,378,874,0.09021479713603818,0.09966928954270726
"[0, 0, 1, 1, 1, 0, 0, 1, 0, 1]",5145,2590,2555,248,283,0.09575289575289575,0.11076320939334638
"[1, 0, 0, 1, 1, 1, 0, 0, 1, 0]",5135,2229,2906,239,295,0.10722296994167788,0.10151410874053682
"[0, 0, 0, 1, 1, 1, 1, 0, 1, 0]",6063,3625,2438,308,237,0.08496551724137931,0.09721082854799015
"[0, 1, 1, 0, 0, 0, 1, 1, 1, 1]",10282,5304,4978,541,496,0.10199849170437406,0.09963840899959824
"[1, 0, 1, 1, 1, 1, 0, 1, 1, 0]",9976,3307,6669,332,613,0.10039310553371636,0.09191782875993403
"[0, 1, 1, 1, 1, 1, 1, 1, 1, 0]",43623,20021,23602,1890,2237,0.09440087907696919,0.0947801033810694
"[1, 1, 0, 1, 1, 1, 0, 0, 1, 1]",13629,4396,9233,438,895,0.09963603275705187,0.09693490739737896
"[1, 1, 0, 1, 0, 1, 1, 1, 1, 1]",32401,8229,24172,792,2287,0.09624498724024791,0.09461360251530697
"[1, 0, 1, 0, 1, 0, 0, 0, 1, 0]",5382,3104,2278,276,227,0.08891752577319588,0.0996488147497805
"[1, 1, 1, 0, 0, 1, 0, 0, 0, 0]",7733,4063,3670,403,334,0.0991877922717204,0.09100817438692098
"[0, 1, 0, 0, 0, 0, 0, 1, 1, 1]",12280,7994,4286,752,401,0.09407055291468601,0.09356042930471302
"[1, 1, 0, 0, 1, 1, 1, 0, 1, 1]",13449,4466,8983,407,816,0.09113300492610837,0.09083825002783034
"[1, 1, 0, 0, 1, 0, 0, 0, 1, 1]",6560,3322,3238,323,302,0.09723058398555087,0.0932674490426189
"[0, 0, 1, 1, 1, 0, 1, 0, 1, 1]",7040,3125,3915,313,385,0.10016,0.0983397190293742
"[0, 1, 0, 0, 0, 1, 1, 1, 0, 1]",4573,2318,2255,217,237,0.09361518550474547,0.10509977827050998
"[0, 1, 1, 0, 1, 1, 1, 0, 1, 1]",10258,3794,6464,352,670,0.09277807063784924,0.1036509900990099
"[1, 1, 0, 0, 0, 0, 0, 0, 1, 0]",14373,9460,4913,868,477,0.09175475687103594,0.09708935477305108
"[1, 1, 0, 0, 0, 1, 0, 1, 1, 1]",8601,3648,4953,353,478,0.09676535087719298,0.09650716737330911
"[1, 1, 0, 0, 1, 0, 0, 0, 0, 1]",7220,4084,3136,365,305,0.08937316356513222,0.09725765306122448
"[0, 0, 1, 1, 0, 0, 1, 0, 0, 0]",12405,8224,4181,754,389,0.0916828793774319,0.09303994259746472
"[0, 1, 0, 1, 1, 1, 0, 1, 1, 1]",11243,4002,7241,370,685,0.09245377311344327,0.09460019334346084
"[1, 0, 0, 1, 0, 1, 1, 1, 0, 1]",5634,2205,3429,233,332,0.1056689342403628,0.0968212306794984
"[0, 0, 0, 0, 1, 1, 1, 0, 0, 0]",14751,10181,4570,916,420,0.0899715155682153,0.09190371991247265
"[1, 1, 1, 1, 1, 0, 0, 0, 0, 0]",18640,5004,13636,419,1254,0.0837330135891287,0.09196245233206218
"[1, 0, 1, 1, 0, 0, 1, 0, 0, 1]",4917,2370,2547,219,228,0.09240506329113925,0.0895170789163722
"[1, 0, 1, 1, 1, 1, 0, 0, 1, 0]",5746,2388,3358,218,298,0.09128978224455611,0.08874329958308518
"[1, 0, 1, 1, 1, 0, 0, 1, 0, 1]",5719,2413,3306,260,322,0.10774968918358889,0.09739866908650938
"[1, 1, 0, 1, 0, 0, 1, 1, 0, 1]",5628,2258,3370,188,320,0.08325952170062002,0.09495548961424333
"[1, 1, 0, 0, 0, 0, 0, 1, 1, 0]",9128,5256,3872,473,367,0.0899923896499239,0.09478305785123967
"[1, 0, 1, 0, 1, 0, 1, 1, 0, 0]",5264,2590,2674,237,238,0.09150579150579151,0.08900523560209424
"[1, 0, 1, 1, 0, 1, 1, 0, 0, 0]",5599,2727,2872,246,299,0.09020902090209021,0.10410863509749303
"[1, 0, 1, 1, 0, 1, 0, 1, 1, 1]",11037,3665,7372,331,747,0.0903137789904502,0.1013293543136191
"[1, 0, 1, 1, 0, 0, 1, 1, 0, 0]",8063,3939,4124,364,361,0.0924092409240924,0.08753637245392823
"[1, 0, 0, 1, 0, 1, 1, 0, 0, 1]",5524,2608,2916,238,288,0.09125766871165644,0.09876543209876543
"[0, 1, 0, 0, 1, 1, 1, 0, 1, 1]",6066,2608,3458,249,336,0.09547546012269939,0.09716599190283401
"[1, 0, 0, 0, 1, 0, 1, 0, 0, 1]",6061,3361,2700,342,271,0.10175542993156798,0.10037037037037037
"[0, 1, 0, 1, 0, 0, 0, 1, 1, 0]",6228,3784,2444,376,224,0.09936575052854123,0.09165302782324058
"[0, 1, 1, 0, 0, 1, 1, 1, 0, 1]",7211,3801,3410,319,342,0.08392528282031045,0.10029325513196481
"[0, 0, 0, 0, 1, 0, 1, 1, 0, 1]",6078,3662,2416,316,229,0.08629164391043145,0.09478476821192053
"[0, 0, 1, 1, 1, 0, 0, 0, 0, 1]",8428,5025,3403,494,309,0.09830845771144278,0.09080223332353805
"[0, 1, 0, 1, 0, 1, 0, 0, 1, 0]",5351,3138,2213,306,205,0.09751434034416825,0.09263443289652055
"[1, 1, 0, 0, 0, 0, 1, 0, 0, 1]",7709,4424,3285,396,316,0.08951175406871609,0.09619482496194826
"[0, 0, 1, 0, 1, 0, 1, 0, 1, 1]",5362,2781,2581,286,253,0.10284070478245236,0.09802402169701666
"[0, 0, 1, 0, 0, 1, 1, 1, 1, 0]",6704,3525,3179,330,299,0.09361702127659574,0.0940547341931425
"[0, 0, 1, 0, 1, 1, 0, 1, 0, 0]",5710,3349,2361,314,207,0.09375933114362496,0.08767471410419314
"[1, 0, 0, 0, 1, 1, 0, 1, 0, 0]",5759,3215,2544,315,224,0.09797822706065319,0.0880503144654088
"[1, 0, 0, 1, 0, 1, 0, 0, 0, 1]",5881,3275,2606,333,235,0.1016793893129771,0.09017651573292403
"[1, 1, 0, 0, 0, 0, 1, 0, 1, 0]",6923,4009,2914,369,284,0.0920429034671988,0.09746053534660261
"[1, 0, 0, 1, 0, 1, 1, 0, 1, 0]",4515,2211,2304,208,228,0.09407507914970602,0.09895833333333333
"[1, 0, 1, 0, 1, 0, 1, 0, 1, 1]",5871,2399,3472,236,333,0.09837432263443101,0.09591013824884792
"[1, 0, 1, 0, 0, 1, 1, 0, 1, 1]",6011,2488,3523,221,326,0.08882636655948553,0.09253477150156117
