state,n,nA,nB,rewardA,rewardB,mn_rewardA,mn_rewardB
"[1, 0, 0, 0, 0, 1, 0, 1, 1, 1]",184,79,105,5,11,0.06329113924050633,0.10476190476190476
"[1, 1, 1, 0, 0, 0, 0, 1, 0, 0]",191,78,113,5,7,0.0641025641025641,0.061946902654867256
"[1, 1, 1, 1, 1, 0, 0, 0, 0, 1]",468,137,331,8,22,0.058394160583941604,0.06646525679758308
"[1, 1, 1, 1, 1, 1, 0, 0, 0, 0]",700,354,346,38,28,0.10734463276836158,0.08092485549132948
"[1, 1, 1, 1, 1, 1, 1, 1, 0, 0]",565,278,287,29,26,0.10431654676258993,0.09059233449477352
"[1, 0, 0, 0, 1, 1, 0, 0, 1, 0]",135,69,66,4,4,0.057971014492753624,0.06060606060606061
"[1, 1, 1, 1, 0, 0, 0, 1, 1, 0]",220,107,113,9,12,0.08411214953271028,0.10619469026548672
"[0, 0, 1, 1, 1, 1, 0, 0, 0, 1]",219,111,108,15,6,0.13513513513513514,0.05555555555555555
"[1, 0, 1, 1, 1, 0, 1, 0, 1, 1]",138,72,66,4,8,0.05555555555555555,0.12121212121212122
"[0, 0, 0, 0, 0, 1, 1, 0, 1, 1]",193,108,85,10,6,0.09259259259259259,0.07058823529411765
"[0, 0, 0, 0, 0, 0, 1, 1, 0, 1]",213,116,97,10,10,0.08620689655172414,0.10309278350515463
"[1, 0, 1, 0, 1, 0, 0, 0, 0, 0]",157,75,82,5,11,0.06666666666666667,0.13414634146341464
"[0, 0, 1, 1, 0, 0, 1, 1, 0, 0]",658,319,339,29,26,0.09090909090909091,0.07669616519174041
"[1, 0, 1, 0, 0, 1, 1, 0, 0, 1]",218,104,114,10,10,0.09615384615384616,0.08771929824561403
"[0, 0, 1, 1, 0, 1, 0, 0, 1, 1]",196,111,85,11,6,0.0990990990990991,0.07058823529411765
"[0, 0, 1, 0, 0, 0, 0, 0, 0, 1]",166,75,91,11,9,0.14666666666666667,0.0989010989010989
"[0, 1, 0, 0, 1, 0, 1, 1, 0, 0]",188,92,96,5,11,0.05434782608695652,0.11458333333333333
"[1, 0, 1, 0, 0, 1, 0, 1, 1, 0]",159,77,82,4,8,0.05194805194805195,0.0975609756097561
"[1, 0, 0, 0, 0, 0, 0, 1, 1, 1]",479,143,336,11,29,0.07692307692307693,0.08630952380952381
"[1, 1, 1, 0, 0, 0, 0, 0, 0, 1]",450,131,319,15,33,0.11450381679389313,0.10344827586206896
"[0, 0, 0, 0, 0, 0, 0, 1, 1, 1]",474,325,149,22,9,0.06769230769230769,0.06040268456375839
"[0, 0, 0, 1, 1, 1, 1, 1, 1, 0]",505,381,124,34,16,0.08923884514435695,0.12903225806451613
"[1, 1, 0, 0, 0, 0, 1, 1, 1, 1]",661,351,310,30,23,0.08547008547008547,0.07419354838709677
"[1, 1, 1, 0, 0, 0, 0, 1, 1, 1]",454,143,311,17,29,0.11888111888111888,0.0932475884244373
"[1, 0, 0, 0, 0, 1, 0, 0, 1, 0]",155,76,79,4,6,0.05263157894736842,0.0759493670886076
"[1, 1, 0, 1, 1, 0, 1, 0, 0, 1]",163,81,82,5,11,0.06172839506172839,0.13414634146341464
"[0, 0, 1, 0, 1, 0, 1, 0, 0, 1]",159,80,79,7,5,0.0875,0.06329113924050633
"[1, 0, 1, 0, 0, 0, 1, 0, 1, 0]",148,68,80,4,4,0.058823529411764705,0.05
"[1, 1, 0, 1, 0, 0, 0, 1, 0, 1]",141,65,76,6,6,0.09230769230769231,0.07894736842105263
"[1, 0, 0, 0, 1, 1, 1, 0, 1, 0]",150,73,77,6,6,0.0821917808219178,0.07792207792207792
"[1, 1, 1, 0, 1, 1, 0, 0, 0, 1]",177,94,83,7,2,0.07446808510638298,0.024096385542168676
"[1, 0, 1, 0, 1, 1, 0, 1, 1, 1]",170,85,85,10,7,0.11764705882352941,0.08235294117647059
"[1, 0, 1, 0, 0, 1, 1, 1, 0, 1]",135,63,72,4,9,0.06349206349206349,0.125
"[1, 1, 1, 0, 1, 0, 0, 1, 1, 1]",161,81,80,7,3,0.08641975308641975,0.0375
"[1, 0, 1, 1, 0, 0, 1, 1, 1, 0]",158,78,80,4,10,0.05128205128205128,0.125
"[1, 0, 0, 1, 1, 0, 1, 1, 0, 0]",185,81,104,6,14,0.07407407407407407,0.1346153846153846
"[1, 1, 0, 0, 1, 1, 0, 0, 0, 1]",218,99,119,5,18,0.050505050505050504,0.15126050420168066
"[1, 0, 1, 1, 0, 1, 1, 0, 0, 1]",167,79,88,9,5,0.11392405063291139,0.056818181818181816
"[0, 1, 0, 1, 1, 0, 1, 1, 0, 0]",155,76,79,8,6,0.10526315789473684,0.0759493670886076
"[1, 1, 1, 0, 1, 0, 1, 0, 1, 1]",151,68,83,5,6,0.07352941176470588,0.07228915662650602
"[1, 0, 0, 1, 0, 1, 1, 0, 0, 0]",176,84,92,12,7,0.14285714285714285,0.07608695652173914
"[1, 1, 0, 1, 1, 1, 1, 1, 1, 1]",195,98,97,7,7,0.07142857142857142,0.07216494845360824
"[1, 1, 1, 0, 1, 1, 1, 1, 1, 1]",182,95,87,13,6,0.1368421052631579,0.06896551724137931
"[1, 1, 1, 1, 1, 0, 1, 1, 1, 0]",181,83,98,7,11,0.08433734939759036,0.11224489795918367
"[0, 0, 0, 0, 1, 0, 0, 0, 1, 0]",161,75,86,6,8,0.08,0.09302325581395349
"[0, 0, 0, 0, 0, 0, 1, 0, 0, 0]",165,86,79,5,5,0.05813953488372093,0.06329113924050633
"[1, 1, 0, 1, 1, 0, 0, 0, 0, 0]",225,102,123,6,9,0.058823529411764705,0.07317073170731707
"[0, 0, 0, 0, 1, 1, 0, 1, 1, 0]",190,100,90,13,3,0.13,0.03333333333333333
"[0, 0, 1, 1, 1, 1, 1, 1, 1, 0]",284,145,139,20,16,0.13793103448275862,0.11510791366906475
"[1, 0, 0, 1, 0, 0, 1, 0, 1, 1]",165,70,95,7,8,0.1,0.08421052631578947
"[0, 0, 0, 0, 0, 1, 0, 0, 1, 0]",159,93,66,8,5,0.08602150537634409,0.07575757575757576
"[1, 0, 1, 1, 0, 1, 1, 0, 1, 0]",130,68,62,5,5,0.07352941176470588,0.08064516129032258
"[1, 0, 1, 0, 1, 1, 1, 0, 0, 1]",173,92,81,8,10,0.08695652173913043,0.12345679012345678
"[1, 0, 0, 1, 0, 1, 0, 0, 0, 0]",161,78,83,7,4,0.08974358974358974,0.04819277108433735
"[1, 1, 1, 1, 0, 0, 1, 0, 1, 0]",207,94,113,8,14,0.0851063829787234,0.12389380530973451
"[1, 1, 0, 1, 1, 1, 1, 0, 0, 1]",193,102,91,12,8,0.11764705882352941,0.08791208791208792
"[0, 1, 1, 0, 1, 1, 1, 1, 0, 0]",209,117,92,9,10,0.07692307692307693,0.10869565217391304
"[0, 1, 0, 0, 1, 0, 1, 0, 1, 1]",162,79,83,4,8,0.05063291139240506,0.0963855421686747
"[1, 1, 1, 0, 1, 0, 0, 1, 0, 1]",151,81,70,7,6,0.08641975308641975,0.08571428571428572
"[1, 0, 1, 1, 1, 1, 1, 0, 0, 1]",195,102,93,10,10,0.09803921568627451,0.10752688172043011
"[1, 1, 0, 1, 1, 1, 1, 1, 0, 0]",199,94,105,13,7,0.13829787234042554,0.06666666666666667
"[0, 1, 0, 0, 1, 1, 0, 1, 1, 1]",171,89,82,6,11,0.06741573033707865,0.13414634146341464
"[1, 1, 0, 0, 1, 1, 0, 1, 0, 0]",202,113,89,9,10,0.07964601769911504,0.11235955056179775
"[1, 1, 1, 0, 0, 1, 1, 0, 1, 0]",178,74,104,1,11,0.013513513513513514,0.10576923076923077
"[1, 0, 1, 1, 1, 0, 0, 1, 1, 0]",193,99,94,7,9,0.0707070707070707,0.09574468085106383
"[1, 0, 1, 1, 1, 1, 0, 1, 1, 1]",145,73,72,5,6,0.0684931506849315,0.08333333333333333
"[0, 1, 0, 1, 0, 1, 1, 1, 1, 0]",175,86,89,6,8,0.06976744186046512,0.0898876404494382
"[0, 1, 0, 1, 1, 0, 1, 0, 0, 0]",151,67,84,7,10,0.1044776119402985,0.11904761904761904
"[1, 1, 1, 1, 0, 1, 0, 1, 0, 1]",153,70,83,5,6,0.07142857142857142,0.07228915662650602
"[1, 1, 0, 1, 1, 0, 1, 1, 1, 0]",152,64,88,4,10,0.0625,0.11363636363636363
"[1, 1, 1, 0, 1, 1, 0, 1, 1, 1]",170,96,74,5,3,0.052083333333333336,0.04054054054054054
"[1, 1, 1, 1, 0, 0, 1, 0, 0, 1]",216,104,112,8,9,0.07692307692307693,0.08035714285714286
"[0, 0, 0, 1, 1, 1, 0, 1, 1, 1]",183,100,83,13,8,0.13,0.0963855421686747
"[1, 0, 0, 1, 1, 0, 0, 1, 0, 0]",201,84,117,3,13,0.03571428571428571,0.1111111111111111
"[1, 1, 0, 0, 1, 1, 0, 0, 1, 0]",218,92,126,8,16,0.08695652173913043,0.12698412698412698
"[0, 1, 1, 1, 1, 1, 0, 1, 0, 0]",160,92,68,8,11,0.08695652173913043,0.16176470588235295
"[0, 0, 0, 1, 1, 1, 1, 1, 0, 1]",166,95,71,7,12,0.07368421052631578,0.16901408450704225
"[0, 0, 0, 0, 1, 1, 1, 1, 1, 0]",225,134,91,9,10,0.06716417910447761,0.10989010989010989
"[0, 0, 1, 1, 0, 0, 0, 0, 0, 1]",235,109,126,13,12,0.11926605504587157,0.09523809523809523
"[1, 1, 0, 1, 0, 0, 0, 0, 1, 0]",152,70,82,3,8,0.04285714285714286,0.0975609756097561
"[0, 1, 1, 0, 1, 0, 0, 0, 0, 1]",194,110,84,5,3,0.045454545454545456,0.03571428571428571
"[0, 1, 1, 0, 0, 0, 0, 0, 1, 0]",166,92,74,9,2,0.09782608695652174,0.02702702702702703
"[0, 0, 0, 1, 1, 1, 1, 0, 1, 1]",212,129,83,13,10,0.10077519379844961,0.12048192771084337
"[1, 1, 1, 1, 0, 0, 0, 1, 0, 0]",204,86,118,8,14,0.09302325581395349,0.11864406779661017
"[0, 1, 1, 0, 1, 0, 0, 1, 0, 1]",159,85,74,9,4,0.10588235294117647,0.05405405405405406
"[1, 0, 1, 0, 0, 0, 1, 1, 0, 0]",176,78,98,2,7,0.02564102564102564,0.07142857142857142
"[1, 1, 1, 0, 1, 1, 1, 1, 0, 1]",114,60,54,5,7,0.08333333333333333,0.12962962962962962
"[0, 0, 1, 0, 1, 1, 1, 0, 0, 1]",174,90,84,10,11,0.1111111111111111,0.13095238095238096
"[1, 0, 1, 0, 0, 1, 0, 0, 0, 1]",149,65,84,9,6,0.13846153846153847,0.07142857142857142
"[0, 0, 0, 1, 0, 1, 1, 1, 1, 1]",197,111,86,9,7,0.08108108108108109,0.08139534883720931
"[1, 0, 0, 1, 1, 0, 1, 1, 1, 0]",179,85,94,6,6,0.07058823529411765,0.06382978723404255
"[1, 1, 1, 0, 0, 1, 1, 0, 1, 1]",206,88,118,14,9,0.1590909090909091,0.07627118644067797
"[0, 0, 0, 1, 1, 0, 0, 1, 0, 0]",189,119,70,7,8,0.058823529411764705,0.11428571428571428
"[0, 0, 0, 0, 1, 1, 0, 0, 1, 0]",238,127,111,10,12,0.07874015748031496,0.10810810810810811
"[1, 0, 0, 1, 1, 1, 1, 0, 0, 1]",447,134,313,17,22,0.12686567164179105,0.07028753993610223
"[1, 0, 0, 1, 0, 0, 1, 1, 1, 1]",204,97,107,13,9,0.13402061855670103,0.08411214953271028
"[0, 1, 1, 1, 1, 0, 0, 1, 1, 1]",413,308,105,35,17,0.11363636363636363,0.1619047619047619
"[0, 0, 1, 0, 0, 0, 0, 1, 1, 1]",221,106,115,15,9,0.14150943396226415,0.0782608695652174
"[0, 0, 0, 0, 1, 0, 0, 0, 0, 1]",132,63,69,11,7,0.1746031746031746,0.10144927536231885
"[0, 1, 0, 0, 0, 0, 0, 1, 0, 0]",135,69,66,6,4,0.08695652173913043,0.06060606060606061
"[1, 0, 1, 0, 0, 1, 1, 0, 1, 0]",158,75,83,2,8,0.02666666666666667,0.0963855421686747
"[1, 0, 1, 1, 1, 1, 1, 0, 1, 0]",150,75,75,8,9,0.10666666666666667,0.12
"[0, 0, 0, 1, 0, 0, 1, 0, 1, 1]",183,97,86,5,2,0.05154639175257732,0.023255813953488372
"[1, 0, 0, 0, 1, 1, 1, 1, 0, 1]",163,83,80,11,5,0.13253012048192772,0.0625
"[1, 0, 1, 0, 0, 0, 1, 1, 1, 1]",180,90,90,12,11,0.13333333333333333,0.12222222222222222
"[1, 1, 0, 1, 0, 0, 0, 1, 1, 1]",175,96,79,6,6,0.0625,0.0759493670886076
"[1, 0, 0, 0, 1, 1, 1, 0, 0, 1]",193,89,104,7,7,0.07865168539325842,0.0673076923076923
"[1, 0, 1, 1, 0, 0, 0, 0, 1, 1]",238,110,128,9,11,0.08181818181818182,0.0859375
"[0, 1, 0, 1, 1, 0, 0, 0, 0, 1]",187,92,95,5,3,0.05434782608695652,0.031578947368421054
"[0, 1, 1, 0, 0, 1, 0, 1, 1, 0]",157,80,77,8,6,0.1,0.07792207792207792
"[0, 1, 0, 1, 1, 0, 0, 1, 1, 0]",221,118,103,12,8,0.1016949152542373,0.07766990291262135
"[1, 1, 1, 1, 0, 1, 1, 0, 1, 0]",153,81,72,14,6,0.1728395061728395,0.08333333333333333
"[1, 0, 0, 0, 0, 1, 1, 1, 0, 0]",226,84,142,5,19,0.05952380952380952,0.13380281690140844
"[0, 0, 1, 1, 1, 1, 0, 1, 0, 0]",185,97,88,9,7,0.09278350515463918,0.07954545454545454
"[1, 1, 1, 0, 1, 1, 0, 1, 0, 1]",136,68,68,6,5,0.08823529411764706,0.07352941176470588
"[0, 0, 0, 0, 1, 1, 0, 1, 0, 1]",186,87,99,17,12,0.19540229885057472,0.12121212121212122
"[0, 1, 1, 1, 1, 1, 0, 0, 0, 0]",271,138,133,7,14,0.050724637681159424,0.10526315789473684
"[1, 0, 0, 0, 0, 1, 0, 0, 0, 0]",147,70,77,8,8,0.11428571428571428,0.1038961038961039
"[0, 1, 0, 0, 0, 0, 1, 0, 0, 0]",144,68,76,7,10,0.10294117647058823,0.13157894736842105
"[1, 1, 1, 1, 0, 0, 0, 0, 0, 1]",271,127,144,15,13,0.11811023622047244,0.09027777777777778
"[0, 1, 0, 1, 1, 0, 0, 0, 1, 1]",157,81,76,6,5,0.07407407407407407,0.06578947368421052
"[1, 0, 1, 0, 1, 1, 0, 0, 0, 1]",142,78,64,4,3,0.05128205128205128,0.046875
"[0, 0, 1, 1, 0, 0, 0, 1, 0, 1]",164,78,86,5,10,0.0641025641025641,0.11627906976744186
"[1, 0, 0, 1, 1, 0, 0, 0, 1, 0]",176,91,85,5,7,0.054945054945054944,0.08235294117647059
"[0, 0, 1, 0, 0, 1, 1, 0, 0, 1]",218,99,119,9,13,0.09090909090909091,0.1092436974789916
"[1, 0, 0, 1, 0, 1, 1, 1, 0, 0]",179,94,85,6,5,0.06382978723404255,0.058823529411764705
"[0, 1, 0, 0, 1, 0, 1, 1, 1, 0]",154,81,73,5,8,0.06172839506172839,0.1095890410958904
"[1, 1, 1, 0, 1, 0, 1, 0, 1, 0]",142,73,69,6,7,0.0821917808219178,0.10144927536231885
"[1, 0, 1, 0, 0, 0, 0, 0, 1, 1]",207,96,111,9,9,0.09375,0.08108108108108109
"[1, 0, 0, 0, 0, 0, 0, 0, 1, 1]",285,126,159,6,12,0.047619047619047616,0.07547169811320754
"[0, 1, 0, 0, 0, 0, 0, 0, 0, 1]",189,104,85,10,7,0.09615384615384616,0.08235294117647059
"[0, 1, 0, 1, 1, 1, 1, 0, 1, 0]",172,78,94,7,9,0.08974358974358974,0.09574468085106383
"[0, 1, 1, 0, 0, 1, 1, 1, 0, 0]",233,150,83,16,9,0.10666666666666667,0.10843373493975904
"[1, 0, 0, 0, 0, 0, 0, 0, 1, 0]",167,66,101,12,7,0.18181818181818182,0.06930693069306931
"[1, 0, 1, 1, 1, 0, 1, 1, 1, 0]",135,65,70,8,9,0.12307692307692308,0.12857142857142856
"[1, 1, 0, 0, 1, 0, 0, 1, 1, 1]",202,108,94,13,7,0.12037037037037036,0.07446808510638298
"[0, 1, 1, 0, 0, 1, 0, 0, 1, 1]",210,110,100,10,10,0.09090909090909091,0.1
"[1, 1, 0, 1, 1, 1, 1, 0, 1, 1]",136,79,57,9,9,0.11392405063291139,0.15789473684210525
"[1, 1, 0, 1, 1, 0, 1, 1, 0, 0]",179,88,91,8,11,0.09090909090909091,0.12087912087912088
"[1, 0, 1, 1, 0, 0, 1, 1, 0, 1]",169,87,82,6,11,0.06896551724137931,0.13414634146341464
"[1, 0, 1, 1, 1, 1, 0, 0, 0, 1]",160,81,79,5,6,0.06172839506172839,0.0759493670886076
"[1, 0, 1, 0, 1, 1, 1, 1, 0, 0]",201,93,108,6,9,0.06451612903225806,0.08333333333333333
"[1, 1, 1, 0, 0, 0, 0, 0, 1, 1]",275,115,160,17,14,0.14782608695652175,0.0875
"[0, 0, 0, 1, 0, 0, 1, 1, 0, 1]",152,75,77,4,8,0.05333333333333334,0.1038961038961039
"[0, 0, 0, 0, 1, 0, 0, 1, 1, 0]",165,81,84,8,5,0.09876543209876543,0.05952380952380952
"[0, 1, 1, 0, 0, 0, 1, 0, 0, 1]",159,89,70,9,9,0.10112359550561797,0.12857142857142856
"[0, 1, 1, 1, 0, 0, 0, 1, 0, 0]",170,90,80,10,4,0.1111111111111111,0.05
"[0, 0, 1, 1, 1, 0, 0, 0, 1, 0]",166,82,84,5,9,0.06097560975609756,0.10714285714285714
"[1, 0, 1, 0, 1, 0, 0, 0, 1, 1]",144,72,72,7,5,0.09722222222222222,0.06944444444444445
"[0, 1, 1, 1, 0, 0, 0, 0, 0, 1]",212,97,115,6,10,0.061855670103092786,0.08695652173913043
"[0, 0, 0, 0, 1, 1, 0, 0, 0, 1]",245,120,125,5,6,0.041666666666666664,0.048
"[1, 1, 1, 0, 1, 1, 1, 0, 1, 0]",156,80,76,8,8,0.1,0.10526315789473684
"[1, 1, 1, 0, 0, 1, 0, 1, 1, 0]",166,78,88,12,6,0.15384615384615385,0.06818181818181818
"[1, 0, 1, 1, 0, 1, 0, 0, 1, 1]",174,100,74,4,5,0.04,0.06756756756756757
"[0, 0, 1, 0, 0, 0, 1, 0, 0, 1]",151,64,87,7,8,0.109375,0.09195402298850575
"[0, 1, 1, 0, 0, 1, 1, 0, 1, 0]",219,116,103,11,10,0.09482758620689655,0.0970873786407767
"[0, 0, 1, 0, 0, 0, 0, 0, 1, 1]",186,91,95,7,9,0.07692307692307693,0.09473684210526316
"[0, 0, 0, 1, 0, 0, 0, 0, 0, 1]",155,82,73,5,8,0.06097560975609756,0.1095890410958904
"[0, 0, 0, 1, 0, 1, 1, 0, 1, 0]",151,79,72,9,8,0.11392405063291139,0.1111111111111111
"[1, 0, 0, 1, 1, 0, 1, 0, 1, 1]",162,73,89,5,3,0.0684931506849315,0.033707865168539325
"[1, 0, 0, 0, 1, 0, 1, 1, 0, 1]",142,69,73,6,7,0.08695652173913043,0.0958904109589041
"[0, 1, 1, 0, 1, 0, 0, 1, 1, 1]",170,88,82,5,6,0.056818181818181816,0.07317073170731707
"[1, 0, 0, 1, 0, 0, 0, 0, 0, 1]",169,86,83,7,11,0.08139534883720931,0.13253012048192772
"[0, 1, 1, 1, 0, 1, 1, 0, 1, 0]",135,76,59,7,2,0.09210526315789473,0.03389830508474576
"[0, 0, 0, 1, 1, 0, 0, 0, 1, 0]",162,100,62,7,6,0.07,0.0967741935483871
"[1, 0, 0, 0, 1, 1, 0, 1, 0, 1]",154,74,80,7,8,0.0945945945945946,0.1
"[1, 1, 1, 1, 1, 0, 1, 0, 1, 1]",162,84,78,6,10,0.07142857142857142,0.1282051282051282
"[0, 0, 1, 0, 1, 0, 1, 1, 0, 1]",141,76,65,7,5,0.09210526315789473,0.07692307692307693
"[1, 1, 1, 1, 0, 0, 1, 0, 1, 1]",166,84,82,4,6,0.047619047619047616,0.07317073170731707
"[0, 1, 1, 0, 1, 0, 1, 0, 1, 0]",138,66,72,4,8,0.06060606060606061,0.1111111111111111
"[1, 1, 0, 0, 1, 0, 1, 1, 1, 0]",164,86,78,8,8,0.09302325581395349,0.10256410256410256
"[0, 0, 1, 0, 0, 1, 1, 1, 0, 0]",170,78,92,8,8,0.10256410256410256,0.08695652173913043
"[0, 0, 0, 0, 1, 0, 1, 1, 1, 1]",205,104,101,7,6,0.0673076923076923,0.0594059405940594
"[0, 1, 1, 1, 1, 0, 0, 0, 0, 1]",440,326,114,28,6,0.08588957055214724,0.05263157894736842
"[0, 1, 0, 0, 1, 1, 1, 1, 0, 0]",252,138,114,13,14,0.09420289855072464,0.12280701754385964
"[1, 0, 0, 0, 0, 1, 0, 0, 1, 1]",175,66,109,8,4,0.12121212121212122,0.03669724770642202
"[1, 0, 1, 1, 1, 1, 1, 1, 1, 1]",190,98,92,10,6,0.10204081632653061,0.06521739130434782
"[1, 1, 0, 0, 1, 0, 1, 1, 1, 1]",177,95,82,13,4,0.1368421052631579,0.04878048780487805
"[0, 1, 1, 0, 0, 1, 0, 1, 1, 1]",178,104,74,8,7,0.07692307692307693,0.0945945945945946
"[0, 0, 0, 1, 1, 0, 0, 1, 0, 1]",182,114,68,9,6,0.07894736842105263,0.08823529411764706
"[1, 1, 1, 0, 0, 0, 1, 1, 0, 0]",237,99,138,10,16,0.10101010101010101,0.11594202898550725
"[0, 1, 1, 1, 1, 0, 0, 0, 1, 1]",207,119,88,12,7,0.10084033613445378,0.07954545454545454
"[1, 0, 1, 0, 0, 1, 1, 1, 1, 0]",188,91,97,9,9,0.0989010989010989,0.09278350515463918
"[0, 1, 0, 1, 0, 1, 0, 0, 1, 1]",165,90,75,17,7,0.18888888888888888,0.09333333333333334
"[0, 1, 0, 1, 0, 1, 0, 1, 0, 0]",133,66,67,5,7,0.07575757575757576,0.1044776119402985
"[1, 0, 0, 1, 0, 1, 0, 1, 0, 1]",128,57,71,4,9,0.07017543859649122,0.1267605633802817
"[1, 1, 0, 0, 1, 0, 1, 0, 1, 0]",161,89,72,8,7,0.0898876404494382,0.09722222222222222
"[0, 1, 1, 0, 0, 1, 0, 1, 0, 1]",172,85,87,4,9,0.047058823529411764,0.10344827586206896
"[1, 1, 1, 0, 1, 0, 1, 1, 0, 0]",196,93,103,4,8,0.043010752688172046,0.07766990291262135
"[0, 1, 1, 1, 0, 1, 0, 1, 1, 0]",173,104,69,12,7,0.11538461538461539,0.10144927536231885
"[0, 0, 0, 0, 1, 1, 0, 1, 1, 1]",193,89,104,11,11,0.12359550561797752,0.10576923076923077
"[1, 0, 1, 0, 0, 0, 0, 0, 0, 1]",186,96,90,10,5,0.10416666666666667,0.05555555555555555
"[1, 0, 0, 0, 0, 1, 0, 1, 0, 1]",170,84,86,7,14,0.08333333333333333,0.16279069767441862
"[1, 0, 0, 1, 1, 0, 0, 1, 1, 0]",451,112,339,10,27,0.08928571428571429,0.07964601769911504
"[0, 0, 0, 0, 0, 1, 1, 0, 1, 0]",195,102,93,8,16,0.0784313725490196,0.17204301075268819
"[0, 1, 1, 0, 0, 1, 0, 0, 0, 0]",194,100,94,3,8,0.03,0.0851063829787234
"[0, 1, 0, 1, 0, 0, 1, 0, 1, 1]",152,80,72,7,3,0.0875,0.041666666666666664
"[1, 0, 1, 0, 1, 0, 0, 1, 0, 1]",138,74,64,9,7,0.12162162162162163,0.109375
"[1, 1, 1, 0, 1, 0, 1, 0, 0, 1]",138,76,62,12,6,0.15789473684210525,0.0967741935483871
"[0, 0, 1, 1, 1, 1, 0, 1, 0, 1]",185,94,91,10,6,0.10638297872340426,0.06593406593406594
"[0, 1, 1, 0, 0, 1, 1, 1, 1, 0]",448,306,142,29,18,0.09477124183006536,0.1267605633802817
"[1, 0, 1, 1, 0, 0, 1, 1, 1, 1]",238,108,130,15,12,0.1388888888888889,0.09230769230769231
"[0, 1, 0, 1, 1, 0, 0, 1, 1, 1]",184,95,89,9,10,0.09473684210526316,0.11235955056179775
"[1, 0, 1, 0, 1, 1, 0, 0, 1, 1]",192,94,98,12,8,0.1276595744680851,0.08163265306122448
"[0, 0, 0, 0, 0, 0, 0, 0, 1, 1]",601,312,289,29,26,0.09294871794871795,0.08996539792387544
"[1, 0, 0, 1, 1, 0, 0, 0, 0, 0]",466,118,348,16,32,0.13559322033898305,0.09195402298850575
"[0, 0, 0, 1, 0, 1, 1, 1, 0, 1]",155,80,75,8,8,0.1,0.10666666666666667
"[0, 0, 0, 0, 1, 0, 1, 1, 1, 0]",167,84,83,9,9,0.10714285714285714,0.10843373493975904
"[0, 1, 0, 0, 0, 1, 0, 1, 0, 1]",144,77,67,11,3,0.14285714285714285,0.04477611940298507
"[0, 1, 1, 1, 0, 1, 0, 0, 0, 1]",142,75,67,5,6,0.06666666666666667,0.08955223880597014
"[1, 1, 0, 1, 0, 1, 1, 0, 1, 1]",164,89,75,10,3,0.11235955056179775,0.04
"[1, 1, 1, 0, 1, 0, 1, 1, 0, 1]",153,79,74,10,6,0.12658227848101267,0.08108108108108109
"[0, 0, 0, 0, 0, 0, 1, 0, 0, 1]",206,116,90,9,5,0.07758620689655173,0.05555555555555555
"[1, 0, 0, 1, 1, 1, 0, 1, 1, 1]",160,68,92,9,10,0.1323529411764706,0.10869565217391304
"[1, 1, 0, 1, 0, 0, 1, 1, 1, 0]",149,72,77,5,6,0.06944444444444445,0.07792207792207792
"[1, 1, 1, 0, 1, 1, 1, 0, 0, 1]",166,71,95,7,4,0.09859154929577464,0.042105263157894736
"[0, 1, 1, 1, 0, 1, 1, 1, 0, 0]",154,79,75,13,5,0.16455696202531644,0.06666666666666667
"[0, 0, 1, 1, 0, 1, 1, 0, 0, 1]",178,85,93,3,6,0.03529411764705882,0.06451612903225806
"[1, 0, 0, 1, 1, 0, 0, 0, 1, 1]",232,103,129,9,10,0.08737864077669903,0.07751937984496124
"[1, 1, 0, 1, 1, 0, 0, 1, 1, 0]",210,109,101,12,6,0.11009174311926606,0.0594059405940594
"[1, 1, 0, 1, 0, 1, 0, 1, 1, 0]",169,85,84,10,5,0.11764705882352941,0.05952380952380952
"[0, 0, 1, 0, 1, 0, 0, 1, 1, 1]",178,83,95,5,1,0.060240963855421686,0.010526315789473684
"[1, 0, 0, 0, 0, 1, 0, 1, 0, 0]",155,75,80,7,7,0.09333333333333334,0.0875
"[0, 0, 1, 1, 1, 1, 1, 1, 0, 1]",218,106,112,7,11,0.0660377358490566,0.09821428571428571
"[0, 0, 0, 1, 0, 0, 0, 1, 0, 0]",138,68,70,6,10,0.08823529411764706,0.14285714285714285
"[0, 0, 0, 0, 0, 0, 0, 0, 0, 1]",421,280,141,24,14,0.08571428571428572,0.09929078014184398
"[0, 1, 1, 0, 0, 1, 1, 1, 1, 1]",410,310,100,44,6,0.14193548387096774,0.06
"[0, 0, 1, 0, 1, 1, 0, 0, 1, 1]",211,88,123,8,8,0.09090909090909091,0.06504065040650407
"[0, 1, 0, 0, 0, 0, 0, 0, 1, 0]",119,60,59,5,4,0.08333333333333333,0.06779661016949153
"[1, 1, 0, 1, 1, 0, 1, 1, 0, 1]",114,61,53,3,9,0.04918032786885246,0.16981132075471697
"[0, 1, 0, 1, 1, 1, 0, 0, 1, 0]",154,77,77,6,11,0.07792207792207792,0.14285714285714285
"[1, 0, 1, 0, 1, 0, 1, 1, 1, 0]",143,62,81,3,10,0.04838709677419355,0.12345679012345678
"[1, 0, 1, 1, 0, 1, 1, 1, 1, 0]",152,78,74,5,6,0.0641025641025641,0.08108108108108109
"[1, 1, 0, 1, 0, 0, 1, 0, 1, 0]",145,74,71,8,6,0.10810810810810811,0.08450704225352113
"[0, 1, 1, 0, 1, 1, 1, 1, 1, 0]",168,101,67,12,4,0.1188118811881188,0.05970149253731343
"[1, 0, 0, 1, 1, 0, 1, 0, 0, 1]",174,80,94,6,8,0.075,0.0851063829787234
"[1, 1, 1, 1, 0, 1, 1, 1, 0, 0]",190,86,104,12,8,0.13953488372093023,0.07692307692307693
"[0, 1, 0, 1, 1, 1, 1, 0, 1, 1]",154,69,85,5,4,0.07246376811594203,0.047058823529411764
"[0, 0, 1, 0, 1, 0, 0, 1, 0, 1]",154,62,92,7,6,0.11290322580645161,0.06521739130434782
"[1, 0, 0, 1, 0, 1, 0, 0, 1, 0]",180,75,105,9,11,0.12,0.10476190476190476
"[1, 1, 0, 0, 1, 0, 1, 0, 0, 1]",211,98,113,8,9,0.08163265306122448,0.07964601769911504
"[0, 0, 0, 0, 1, 0, 1, 0, 0, 0]",157,73,84,9,4,0.1232876712328767,0.047619047619047616
"[1, 1, 1, 1, 0, 1, 1, 1, 1, 0]",148,77,71,6,5,0.07792207792207792,0.07042253521126761
"[1, 1, 1, 1, 0, 0, 1, 1, 1, 1]",567,296,271,29,21,0.09797297297297297,0.07749077490774908
"[0, 0, 1, 1, 1, 1, 1, 0, 0, 1]",238,129,109,14,6,0.10852713178294573,0.05504587155963303
"[1, 1, 1, 1, 1, 1, 0, 0, 1, 0]",233,126,107,14,10,0.1111111111111111,0.09345794392523364
"[1, 0, 1, 0, 1, 0, 1, 1, 1, 1]",177,90,87,10,9,0.1111111111111111,0.10344827586206896
"[0, 1, 1, 1, 0, 0, 1, 0, 0, 1]",170,83,87,7,8,0.08433734939759036,0.09195402298850575
"[1, 1, 0, 0, 0, 1, 1, 1, 0, 0]",211,92,119,12,13,0.13043478260869565,0.1092436974789916
"[1, 1, 1, 0, 0, 0, 1, 1, 1, 0]",206,101,105,11,6,0.10891089108910891,0.05714285714285714
"[1, 1, 1, 1, 0, 0, 0, 1, 1, 1]",213,100,113,5,6,0.05,0.05309734513274336
"[1, 1, 1, 1, 1, 1, 1, 0, 1, 1]",182,89,93,8,4,0.0898876404494382,0.043010752688172046
"[0, 0, 0, 0, 0, 0, 1, 0, 1, 1]",192,89,103,14,9,0.15730337078651685,0.08737864077669903
"[0, 1, 0, 0, 0, 0, 0, 0, 0, 0]",217,103,114,6,15,0.05825242718446602,0.13157894736842105
"[1, 1, 1, 1, 1, 0, 1, 0, 1, 0]",161,83,78,7,9,0.08433734939759036,0.11538461538461539
"[0, 1, 1, 0, 1, 1, 1, 0, 0, 0]",190,96,94,12,6,0.125,0.06382978723404255
"[1, 1, 1, 1, 0, 1, 1, 0, 1, 1]",145,74,71,9,4,0.12162162162162163,0.056338028169014086
"[0, 1, 0, 1, 1, 1, 1, 1, 1, 0]",198,98,100,2,9,0.02040816326530612,0.09
"[1, 0, 0, 1, 0, 0, 1, 1, 0, 1]",163,73,90,6,9,0.0821917808219178,0.1
"[0, 0, 1, 1, 1, 0, 1, 1, 1, 1]",178,100,78,17,6,0.17,0.07692307692307693
"[0, 0, 1, 0, 0, 0, 1, 1, 1, 0]",151,71,80,5,5,0.07042253521126761,0.0625
"[1, 1, 0, 0, 0, 1, 0, 0, 0, 1]",174,81,93,11,9,0.13580246913580246,0.0967741935483871
"[0, 1, 1, 0, 0, 0, 1, 0, 0, 0]",162,84,78,12,7,0.14285714285714285,0.08974358974358974
"[0, 0, 1, 1, 0, 0, 0, 1, 0, 0]",172,80,92,9,5,0.1125,0.05434782608695652
"[0, 1, 0, 0, 1, 1, 1, 1, 1, 1]",263,131,132,9,13,0.06870229007633588,0.09848484848484848
"[1, 1, 0, 1, 0, 0, 1, 1, 1, 1]",185,98,87,9,5,0.09183673469387756,0.05747126436781609
"[0, 0, 1, 0, 0, 1, 0, 0, 0, 1]",152,74,78,7,13,0.0945945945945946,0.16666666666666666
"[1, 0, 1, 1, 1, 1, 1, 1, 0, 0]",239,123,116,6,13,0.04878048780487805,0.11206896551724138
"[1, 1, 0, 1, 1, 1, 0, 0, 1, 0]",150,72,78,11,5,0.1527777777777778,0.0641025641025641
"[0, 0, 1, 1, 1, 1, 0, 1, 1, 1]",188,105,83,9,4,0.08571428571428572,0.04819277108433735
"[1, 1, 1, 0, 0, 0, 1, 0, 0, 0]",186,83,103,6,8,0.07228915662650602,0.07766990291262135
"[0, 1, 1, 1, 1, 0, 0, 0, 1, 0]",168,92,76,10,9,0.10869565217391304,0.11842105263157894
"[1, 0, 1, 0, 0, 0, 0, 1, 1, 1]",206,94,112,13,10,0.13829787234042554,0.08928571428571429
"[1, 1, 1, 0, 1, 0, 1, 1, 1, 0]",150,73,77,5,2,0.0684931506849315,0.025974025974025976
"[1, 1, 0, 0, 0, 0, 1, 1, 1, 0]",265,125,140,13,11,0.104,0.07857142857142857
"[0, 1, 1, 0, 0, 0, 0, 1, 1, 1]",479,356,123,28,8,0.07865168539325842,0.06504065040650407
"[0, 1, 0, 0, 0, 1, 1, 0, 0, 1]",169,77,92,9,5,0.11688311688311688,0.05434782608695652
"[0, 0, 1, 1, 0, 0, 1, 1, 1, 0]",269,121,148,12,12,0.09917355371900827,0.08108108108108109
"[0, 0, 0, 0, 1, 1, 0, 0, 1, 1]",652,321,331,36,40,0.11214953271028037,0.12084592145015106
"[0, 0, 0, 0, 0, 0, 0, 0, 0, 0]",635,348,287,22,26,0.06321839080459771,0.09059233449477352
"[1, 0, 0, 0, 0, 1, 1, 0, 0, 0]",452,114,338,7,28,0.06140350877192982,0.08284023668639054
"[1, 1, 0, 0, 0, 0, 1, 1, 0, 0]",680,337,343,31,30,0.09198813056379822,0.08746355685131195
"[1, 1, 1, 0, 0, 1, 1, 1, 1, 0]",412,137,275,8,31,0.058394160583941604,0.11272727272727273
"[1, 0, 0, 0, 1, 0, 1, 1, 1, 0]",174,91,83,7,7,0.07692307692307693,0.08433734939759036
"[1, 0, 0, 0, 1, 0, 0, 0, 1, 0]",126,53,73,3,9,0.05660377358490566,0.1232876712328767
"[1, 0, 1, 1, 1, 1, 1, 0, 0, 0]",207,100,107,11,8,0.11,0.07476635514018691
"[0, 1, 0, 1, 1, 1, 1, 1, 0, 0]",207,108,99,6,8,0.05555555555555555,0.08080808080808081
"[1, 0, 0, 0, 1, 0, 1, 1, 1, 1]",164,70,94,4,10,0.05714285714285714,0.10638297872340426
"[1, 1, 0, 0, 1, 0, 0, 0, 1, 0]",164,76,88,8,11,0.10526315789473684,0.125
"[0, 0, 1, 1, 1, 1, 0, 0, 1, 1]",646,323,323,23,17,0.07120743034055728,0.05263157894736842
"[1, 1, 0, 0, 0, 1, 1, 1, 1, 0]",217,125,92,11,9,0.088,0.09782608695652174
"[1, 1, 1, 0, 1, 1, 0, 0, 1, 1]",211,96,115,6,15,0.0625,0.13043478260869565
"[1, 1, 0, 1, 1, 1, 0, 1, 0, 0]",158,71,87,7,8,0.09859154929577464,0.09195402298850575
"[1, 0, 1, 1, 0, 1, 1, 1, 0, 1]",145,80,65,4,5,0.05,0.07692307692307693
"[0, 1, 1, 1, 1, 1, 0, 1, 1, 0]",153,90,63,7,5,0.07777777777777778,0.07936507936507936
"[1, 0, 0, 0, 0, 1, 1, 0, 0, 1]",457,123,334,5,41,0.04065040650406504,0.12275449101796407
"[0, 1, 0, 1, 0, 0, 1, 1, 0, 0]",216,126,90,8,8,0.06349206349206349,0.08888888888888889
"[0, 0, 1, 1, 0, 0, 1, 0, 1, 0]",182,91,91,8,3,0.08791208791208792,0.03296703296703297
"[1, 0, 0, 1, 1, 0, 1, 0, 0, 0]",188,84,104,8,8,0.09523809523809523,0.07692307692307693
"[1, 1, 1, 0, 1, 0, 0, 1, 1, 0]",192,99,93,8,13,0.08080808080808081,0.13978494623655913
"[1, 1, 1, 0, 1, 1, 0, 1, 1, 0]",148,79,69,7,5,0.08860759493670886,0.07246376811594203
"[1, 1, 1, 1, 1, 1, 1, 1, 0, 1]",202,92,110,7,6,0.07608695652173914,0.05454545454545454
"[1, 1, 0, 1, 1, 1, 1, 0, 1, 0]",113,54,59,8,8,0.14814814814814814,0.13559322033898305
"[0, 0, 1, 0, 0, 1, 1, 1, 0, 1]",158,76,82,6,8,0.07894736842105263,0.0975609756097561
"[1, 0, 0, 1, 0, 0, 1, 1, 1, 0]",173,76,97,10,8,0.13157894736842105,0.08247422680412371
"[0, 0, 1, 0, 0, 1, 0, 0, 1, 1]",173,82,91,7,9,0.08536585365853659,0.0989010989010989
"[1, 1, 1, 0, 1, 0, 0, 0, 0, 0]",211,98,113,17,7,0.17346938775510204,0.061946902654867256
"[0, 1, 1, 1, 0, 1, 0, 0, 0, 0]",189,94,95,12,6,0.1276595744680851,0.06315789473684211
"[0, 1, 0, 1, 0, 1, 0, 0, 0, 1]",129,61,68,6,4,0.09836065573770492,0.058823529411764705
"[0, 0, 0, 0, 0, 1, 0, 1, 0, 1]",152,73,79,9,2,0.1232876712328767,0.02531645569620253
"[0, 0, 0, 0, 0, 0, 1, 0, 1, 0]",151,74,77,5,7,0.06756756756756757,0.09090909090909091
"[0, 0, 1, 0, 0, 0, 0, 1, 1, 0]",190,80,110,12,10,0.15,0.09090909090909091
"[0, 1, 1, 1, 1, 1, 0, 0, 1, 0]",184,92,92,13,7,0.14130434782608695,0.07608695652173914
"[1, 0, 1, 0, 1, 1, 1, 1, 1, 0]",164,90,74,5,7,0.05555555555555555,0.0945945945945946
"[1, 1, 0, 1, 0, 1, 0, 1, 1, 1]",168,97,71,5,6,0.05154639175257732,0.08450704225352113
"[1, 1, 1, 1, 1, 1, 0, 1, 0, 1]",159,73,86,6,9,0.0821917808219178,0.10465116279069768
"[1, 0, 1, 0, 1, 0, 0, 0, 0, 1]",175,71,104,2,7,0.028169014084507043,0.0673076923076923
"[0, 1, 0, 0, 0, 1, 0, 0, 1, 0]",133,63,70,4,6,0.06349206349206349,0.08571428571428572
"[1, 0, 1, 0, 0, 0, 1, 0, 0, 1]",137,64,73,5,9,0.078125,0.1232876712328767
"[0, 0, 1, 0, 1, 0, 0, 0, 1, 1]",170,82,88,5,9,0.06097560975609756,0.10227272727272728
"[0, 0, 1, 1, 0, 1, 0, 0, 0, 1]",177,80,97,9,11,0.1125,0.1134020618556701
"[1, 0, 1, 1, 0, 1, 1, 1, 1, 1]",161,81,80,6,9,0.07407407407407407,0.1125
"[0, 0, 1, 1, 1, 1, 0, 1, 1, 0]",217,104,113,10,7,0.09615384615384616,0.061946902654867256
"[0, 0, 1, 0, 1, 1, 0, 1, 1, 1]",150,76,74,5,8,0.06578947368421052,0.10810810810810811
"[1, 1, 1, 1, 1, 0, 0, 0, 1, 0]",209,86,123,4,13,0.046511627906976744,0.10569105691056911
"[0, 1, 0, 0, 0, 0, 0, 1, 0, 1]",145,70,75,3,6,0.04285714285714286,0.08
"[1, 1, 0, 1, 0, 1, 0, 0, 1, 1]",176,102,74,12,9,0.11764705882352941,0.12162162162162163
"[1, 1, 0, 1, 0, 1, 1, 1, 1, 0]",200,102,98,12,4,0.11764705882352941,0.04081632653061224
"[0, 1, 1, 0, 1, 0, 1, 1, 1, 1]",185,102,83,11,10,0.10784313725490197,0.12048192771084337
"[0, 0, 0, 1, 0, 0, 0, 0, 1, 0]",126,61,65,5,6,0.08196721311475409,0.09230769230769231
"[1, 1, 0, 0, 0, 0, 0, 1, 0, 1]",195,91,104,9,11,0.0989010989010989,0.10576923076923077
"[1, 0, 0, 0, 1, 1, 0, 1, 1, 1]",183,78,105,4,11,0.05128205128205128,0.10476190476190476
"[0, 0, 1, 1, 1, 0, 0, 1, 1, 1]",241,137,104,10,11,0.072992700729927,0.10576923076923077
"[0, 0, 1, 0, 0, 1, 0, 1, 0, 0]",156,75,81,7,9,0.09333333333333334,0.1111111111111111
"[0, 0, 1, 1, 1, 1, 0, 0, 1, 0]",244,123,121,11,14,0.08943089430894309,0.11570247933884298
"[1, 1, 1, 0, 1, 1, 1, 1, 1, 0]",173,91,82,8,8,0.08791208791208792,0.0975609756097561
"[0, 0, 1, 1, 0, 1, 0, 1, 0, 0]",184,89,95,10,10,0.11235955056179775,0.10526315789473684
"[1, 0, 0, 1, 0, 0, 1, 1, 0, 0]",241,113,128,12,7,0.10619469026548672,0.0546875
"[0, 1, 1, 1, 0, 0, 0, 0, 1, 1]",254,134,120,15,15,0.11194029850746269,0.125
"[1, 0, 1, 1, 1, 0, 0, 0, 0, 1]",189,100,89,11,6,0.11,0.06741573033707865
"[0, 1, 0, 1, 1, 1, 0, 0, 0, 0]",211,110,101,7,11,0.06363636363636363,0.10891089108910891
"[0, 0, 1, 0, 1, 1, 1, 0, 0, 0]",188,91,97,9,11,0.0989010989010989,0.1134020618556701
"[0, 0, 1, 0, 1, 1, 1, 0, 1, 0]",139,70,69,6,5,0.08571428571428572,0.07246376811594203
"[0, 0, 0, 1, 1, 1, 0, 0, 0, 1]",175,87,88,5,6,0.05747126436781609,0.06818181818181818
"[0, 0, 0, 0, 0, 0, 1, 1, 1, 0]",253,111,142,9,11,0.08108108108108109,0.07746478873239436
"[1, 1, 0, 0, 0, 1, 0, 1, 0, 0]",151,78,73,5,4,0.0641025641025641,0.0547945205479452
"[1, 1, 0, 1, 0, 1, 1, 0, 1, 0]",170,91,79,5,17,0.054945054945054944,0.21518987341772153
"[0, 1, 1, 1, 1, 0, 1, 0, 0, 0]",180,99,81,8,9,0.08080808080808081,0.1111111111111111
"[1, 1, 1, 1, 0, 0, 1, 1, 1, 0]",230,116,114,12,13,0.10344827586206896,0.11403508771929824
"[0, 1, 0, 0, 0, 1, 1, 0, 1, 1]",140,76,64,6,5,0.07894736842105263,0.078125
"[0, 0, 0, 0, 1, 0, 0, 0, 1, 1]",185,90,95,3,13,0.03333333333333333,0.1368421052631579
"[0, 1, 1, 1, 0, 1, 1, 1, 0, 1]",147,87,60,11,5,0.12643678160919541,0.08333333333333333
"[1, 1, 1, 1, 1, 0, 1, 1, 0, 0]",206,86,120,6,11,0.06976744186046512,0.09166666666666666
"[0, 0, 0, 1, 1, 0, 1, 1, 1, 1]",203,100,103,8,16,0.08,0.1553398058252427
"[0, 0, 1, 0, 1, 0, 1, 1, 0, 0]",181,87,94,8,7,0.09195402298850575,0.07446808510638298
"[0, 1, 1, 1, 0, 0, 0, 0, 1, 0]",163,90,73,7,7,0.07777777777777778,0.0958904109589041
"[0, 0, 0, 1, 0, 0, 0, 0, 0, 0]",170,72,98,12,15,0.16666666666666666,0.15306122448979592
"[1, 0, 0, 0, 1, 0, 0, 0, 0, 0]",167,75,92,8,7,0.10666666666666667,0.07608695652173914
"[0, 1, 0, 0, 1, 1, 0, 0, 0, 1]",195,89,106,14,8,0.15730337078651685,0.07547169811320754
"[0, 1, 1, 0, 1, 1, 0, 1, 0, 1]",147,71,76,7,8,0.09859154929577464,0.10526315789473684
"[1, 1, 0, 1, 1, 0, 0, 0, 0, 1]",209,103,106,13,6,0.1262135922330097,0.05660377358490566
"[1, 0, 1, 0, 1, 1, 0, 0, 0, 0]",218,102,116,9,11,0.08823529411764706,0.09482758620689655
"[0, 1, 0, 1, 0, 1, 1, 0, 0, 0]",179,90,89,7,3,0.07777777777777778,0.033707865168539325
"[1, 0, 0, 1, 0, 1, 0, 1, 1, 0]",158,84,74,10,11,0.11904761904761904,0.14864864864864866
"[0, 0, 1, 0, 0, 1, 1, 0, 0, 0]",206,79,127,5,6,0.06329113924050633,0.047244094488188976
"[1, 0, 1, 1, 0, 0, 0, 1, 0, 0]",145,66,79,7,3,0.10606060606060606,0.0379746835443038
"[0, 1, 0, 0, 1, 1, 0, 0, 1, 0]",164,79,85,6,8,0.0759493670886076,0.09411764705882353
"[0, 1, 0, 0, 0, 1, 0, 1, 0, 0]",157,76,81,2,6,0.02631578947368421,0.07407407407407407
"[0, 0, 1, 0, 0, 0, 1, 0, 1, 0]",152,70,82,11,11,0.15714285714285714,0.13414634146341464
"[1, 0, 0, 1, 0, 1, 0, 0, 1, 1]",198,92,106,8,12,0.08695652173913043,0.11320754716981132
"[1, 1, 0, 0, 1, 1, 0, 1, 0, 1]",191,105,86,12,6,0.11428571428571428,0.06976744186046512
"[0, 0, 0, 0, 0, 1, 0, 1, 1, 1]",188,102,86,6,10,0.058823529411764705,0.11627906976744186
"[1, 0, 1, 1, 0, 1, 0, 1, 0, 0]",151,69,82,13,9,0.18840579710144928,0.10975609756097561
"[1, 1, 1, 0, 1, 0, 0, 1, 0, 0]",179,83,96,5,5,0.060240963855421686,0.052083333333333336
"[1, 0, 0, 0, 1, 0, 1, 0, 1, 1]",158,73,85,7,5,0.0958904109589041,0.058823529411764705
"[0, 1, 0, 1, 0, 0, 0, 1, 0, 0]",125,57,68,3,3,0.05263157894736842,0.04411764705882353
"[0, 0, 1, 0, 1, 0, 0, 0, 1, 0]",128,64,64,5,9,0.078125,0.140625
"[1, 0, 1, 1, 1, 0, 1, 1, 0, 1]",140,64,76,4,8,0.0625,0.10526315789473684
"[0, 1, 0, 0, 0, 1, 0, 0, 0, 0]",156,81,75,8,5,0.09876543209876543,0.06666666666666667
"[0, 1, 0, 1, 1, 0, 1, 0, 1, 1]",157,80,77,7,9,0.0875,0.11688311688311688
"[0, 0, 1, 1, 0, 1, 0, 1, 1, 0]",181,90,91,5,7,0.05555555555555555,0.07692307692307693
"[0, 1, 0, 0, 0, 0, 1, 1, 0, 1]",170,81,89,8,11,0.09876543209876543,0.12359550561797752
"[1, 1, 1, 0, 0, 0, 1, 1, 1, 1]",189,81,108,7,8,0.08641975308641975,0.07407407407407407
"[0, 1, 0, 1, 1, 1, 0, 0, 0, 1]",147,79,68,11,5,0.13924050632911392,0.07352941176470588
"[1, 0, 1, 0, 0, 0, 0, 1, 0, 1]",152,74,78,5,6,0.06756756756756757,0.07692307692307693
"[1, 0, 0, 0, 1, 1, 0, 0, 0, 1]",167,81,86,6,9,0.07407407407407407,0.10465116279069768
"[1, 0, 1, 1, 0, 1, 0, 0, 0, 1]",128,67,61,1,7,0.014925373134328358,0.11475409836065574
"[0, 1, 0, 1, 0, 0, 1, 1, 0, 1]",141,62,79,6,9,0.0967741935483871,0.11392405063291139
"[0, 0, 0, 1, 1, 0, 1, 0, 1, 0]",158,82,76,7,7,0.08536585365853659,0.09210526315789473
"[0, 0, 1, 0, 1, 1, 0, 1, 0, 1]",152,80,72,6,8,0.075,0.1111111111111111
"[1, 0, 1, 0, 1, 1, 1, 0, 1, 1]",147,81,66,8,4,0.09876543209876543,0.06060606060606061
"[1, 0, 1, 1, 0, 1, 1, 0, 1, 1]",119,67,52,6,5,0.08955223880597014,0.09615384615384616
"[0, 1, 0, 0, 0, 0, 0, 1, 1, 0]",193,85,108,5,7,0.058823529411764705,0.06481481481481481
"[0, 0, 0, 1, 0, 1, 1, 1, 1, 0]",175,98,77,5,8,0.05102040816326531,0.1038961038961039
"[1, 1, 0, 0, 0, 0, 1, 0, 1, 1]",191,89,102,8,5,0.0898876404494382,0.049019607843137254
"[1, 1, 1, 0, 0, 0, 0, 1, 0, 1]",181,85,96,6,9,0.07058823529411765,0.09375
"[0, 0, 1, 1, 1, 1, 0, 0, 0, 0]",654,322,332,23,27,0.07142857142857142,0.08132530120481928
"[1, 0, 0, 1, 1, 1, 1, 0, 0, 0]",449,119,330,15,28,0.12605042016806722,0.08484848484848485
"[0, 0, 0, 1, 0, 0, 1, 1, 1, 1]",243,132,111,6,15,0.045454545454545456,0.13513513513513514
"[1, 0, 0, 1, 0, 1, 1, 1, 1, 1]",226,117,109,8,7,0.06837606837606838,0.06422018348623854
"[0, 0, 1, 1, 0, 0, 1, 0, 1, 1]",186,92,94,5,7,0.05434782608695652,0.07446808510638298
"[1, 0, 1, 0, 1, 0, 0, 1, 1, 1]",175,82,93,10,11,0.12195121951219512,0.11827956989247312
"[0, 1, 1, 0, 1, 1, 1, 0, 1, 0]",144,77,67,6,7,0.07792207792207792,0.1044776119402985
"[0, 0, 0, 1, 1, 0, 1, 1, 1, 0]",169,91,78,7,8,0.07692307692307693,0.10256410256410256
"[0, 0, 0, 0, 1, 0, 1, 0, 1, 0]",160,82,78,11,7,0.13414634146341464,0.08974358974358974
"[0, 1, 0, 0, 0, 0, 1, 0, 1, 0]",158,75,83,5,9,0.06666666666666667,0.10843373493975904
"[0, 0, 1, 0, 0, 0, 0, 1, 0, 1]",147,62,85,7,12,0.11290322580645161,0.1411764705882353
"[1, 1, 0, 0, 1, 1, 0, 0, 1, 1]",675,367,308,35,25,0.09536784741144415,0.08116883116883117
"[1, 0, 0, 1, 0, 0, 0, 0, 0, 0]",198,93,105,4,10,0.043010752688172046,0.09523809523809523
"[1, 0, 1, 1, 0, 0, 1, 0, 0, 0]",162,86,76,7,7,0.08139534883720931,0.09210526315789473
"[0, 0, 1, 0, 1, 1, 0, 0, 1, 0]",161,80,81,6,9,0.075,0.1111111111111111
"[1, 1, 0, 1, 0, 1, 0, 0, 1, 0]",138,72,66,2,4,0.027777777777777776,0.06060606060606061
"[1, 1, 1, 1, 0, 1, 0, 1, 0, 0]",142,63,79,5,7,0.07936507936507936,0.08860759493670886
"[0, 1, 1, 1, 1, 0, 1, 0, 1, 0]",131,77,54,9,10,0.11688311688311688,0.18518518518518517
"[1, 1, 0, 0, 1, 1, 1, 1, 0, 1]",213,120,93,10,13,0.08333333333333333,0.13978494623655913
"[0, 0, 0, 0, 0, 1, 1, 1, 1, 0]",437,305,132,20,15,0.06557377049180328,0.11363636363636363
"[0, 1, 1, 1, 1, 0, 0, 0, 0, 0]",455,314,141,37,14,0.1178343949044586,0.09929078014184398
"[1, 0, 0, 0, 0, 0, 0, 0, 0, 1]",390,102,288,10,29,0.09803921568627451,0.10069444444444445
"[1, 1, 0, 0, 0, 0, 0, 0, 0, 0]",618,288,330,39,26,0.13541666666666666,0.07878787878787878
"[0, 1, 1, 0, 0, 0, 0, 0, 0, 0]",411,282,129,30,15,0.10638297872340426,0.11627906976744186
"[1, 1, 1, 1, 1, 1, 0, 0, 1, 1]",572,324,248,26,21,0.08024691358024691,0.0846774193548387
"[1, 1, 1, 1, 0, 0, 0, 0, 1, 1]",681,332,349,29,34,0.08734939759036145,0.09742120343839542
"[0, 1, 1, 1, 0, 1, 1, 1, 1, 0]",158,76,82,7,7,0.09210526315789473,0.08536585365853659
"[1, 0, 1, 1, 1, 0, 1, 1, 1, 1]",162,85,77,10,3,0.11764705882352941,0.03896103896103896
"[0, 1, 0, 0, 0, 0, 1, 0, 1, 1]",151,75,76,10,6,0.13333333333333333,0.07894736842105263
"[1, 0, 0, 1, 0, 0, 0, 0, 1, 0]",152,67,85,6,8,0.08955223880597014,0.09411764705882353
"[0, 1, 0, 0, 1, 0, 0, 0, 0, 1]",158,73,85,6,6,0.0821917808219178,0.07058823529411765
"[0, 0, 0, 1, 0, 0, 1, 0, 0, 0]",148,74,74,5,8,0.06756756756756757,0.10810810810810811
"[0, 0, 0, 0, 1, 0, 0, 1, 0, 0]",152,85,67,10,4,0.11764705882352941,0.05970149253731343
"[1, 1, 0, 1, 0, 0, 1, 0, 0, 0]",182,96,86,9,7,0.09375,0.08139534883720931
"[1, 1, 1, 0, 1, 1, 0, 1, 0, 0]",156,71,85,8,13,0.11267605633802817,0.15294117647058825
"[1, 0, 0, 0, 1, 0, 1, 0, 1, 0]",139,71,68,9,4,0.1267605633802817,0.058823529411764705
"[0, 0, 0, 1, 1, 1, 0, 1, 0, 0]",180,99,81,14,4,0.1414141414141414,0.04938271604938271
"[1, 1, 0, 0, 0, 1, 1, 1, 0, 1]",174,87,87,6,4,0.06896551724137931,0.04597701149425287
"[1, 0, 1, 1, 0, 0, 0, 1, 1, 1]",179,83,96,6,11,0.07228915662650602,0.11458333333333333
"[1, 1, 0, 1, 1, 0, 0, 0, 1, 1]",172,81,91,12,8,0.14814814814814814,0.08791208791208792
"[0, 1, 1, 1, 0, 1, 1, 0, 0, 0]",202,104,98,6,9,0.057692307692307696,0.09183673469387756
"[1, 0, 0, 1, 1, 1, 0, 1, 1, 0]",162,67,95,8,7,0.11940298507462686,0.07368421052631578
"[0, 1, 1, 1, 0, 0, 1, 1, 1, 0]",172,94,78,10,6,0.10638297872340426,0.07692307692307693
"[1, 0, 1, 1, 1, 0, 0, 1, 1, 1]",192,95,97,9,10,0.09473684210526316,0.10309278350515463
"[1, 0, 1, 1, 0, 1, 1, 1, 0, 0]",174,86,88,8,4,0.09302325581395349,0.045454545454545456
"[0, 0, 0, 0, 0, 1, 0, 0, 1, 1]",210,118,92,12,13,0.1016949152542373,0.14130434782608695
"[0, 0, 1, 1, 1, 0, 1, 0, 0, 1]",185,101,84,7,3,0.06930693069306931,0.03571428571428571
"[0, 1, 1, 0, 1, 1, 0, 0, 1, 1]",201,95,106,6,12,0.06315789473684211,0.11320754716981132
"[1, 1, 0, 0, 1, 1, 0, 1, 1, 0]",188,85,103,5,8,0.058823529411764705,0.07766990291262135
"[0, 0, 1, 1, 0, 0, 1, 1, 0, 1]",231,119,112,13,11,0.1092436974789916,0.09821428571428571
"[1, 0, 0, 0, 1, 1, 0, 0, 1, 1]",232,103,129,8,6,0.07766990291262135,0.046511627906976744
"[0, 1, 1, 0, 0, 1, 1, 0, 0, 0]",437,315,122,31,14,0.09841269841269841,0.11475409836065574
"[1, 0, 1, 0, 1, 0, 1, 1, 0, 1]",148,61,87,6,10,0.09836065573770492,0.11494252873563218
"[0, 0, 1, 1, 1, 0, 1, 0, 1, 0]",156,75,81,8,2,0.10666666666666667,0.024691358024691357
"[1, 0, 0, 0, 0, 0, 1, 1, 1, 0]",176,71,105,4,12,0.056338028169014086,0.11428571428571428
"[0, 1, 1, 0, 0, 0, 0, 0, 1, 1]",270,142,128,13,12,0.09154929577464789,0.09375
"[0, 0, 1, 0, 1, 1, 0, 0, 0, 0]",207,104,103,6,9,0.057692307692307696,0.08737864077669903
"[0, 1, 0, 0, 1, 1, 1, 0, 0, 1]",175,88,87,5,14,0.056818181818181816,0.16091954022988506
"[0, 1, 0, 1, 0, 0, 1, 1, 1, 0]",145,68,77,5,4,0.07352941176470588,0.05194805194805195
"[0, 0, 0, 1, 0, 1, 0, 0, 1, 1]",169,83,86,11,10,0.13253012048192772,0.11627906976744186
"[1, 1, 1, 0, 1, 1, 1, 0, 1, 1]",150,68,82,4,5,0.058823529411764705,0.06097560975609756
"[1, 1, 1, 1, 0, 1, 1, 1, 0, 1]",159,79,80,7,3,0.08860759493670886,0.0375
"[0, 1, 1, 1, 1, 1, 1, 0, 1, 1]",182,120,62,9,5,0.075,0.08064516129032258
"[0, 1, 0, 0, 0, 1, 1, 1, 1, 1]",210,112,98,7,5,0.0625,0.05102040816326531
"[0, 0, 0, 0, 0, 0, 0, 1, 0, 0]",205,115,90,4,5,0.034782608695652174,0.05555555555555555
"[0, 0, 0, 0, 0, 0, 0, 0, 1, 0]",208,105,103,15,11,0.14285714285714285,0.10679611650485436
"[1, 0, 0, 0, 0, 0, 0, 0, 0, 0]",432,114,318,10,28,0.08771929824561403,0.0880503144654088
"[1, 0, 1, 1, 0, 0, 0, 0, 0, 0]",262,132,130,11,18,0.08333333333333333,0.13846153846153847
"[0, 1, 1, 0, 1, 1, 0, 0, 0, 0]",205,102,103,5,16,0.049019607843137254,0.1553398058252427
"[0, 0, 1, 0, 0, 1, 0, 1, 1, 0]",168,88,80,10,5,0.11363636363636363,0.0625
"[1, 0, 0, 0, 0, 0, 0, 1, 0, 0]",168,60,108,3,12,0.05,0.1111111111111111
"[0, 1, 1, 0, 1, 1, 0, 1, 1, 0]",149,78,71,5,7,0.0641025641025641,0.09859154929577464
"[0, 0, 0, 1, 1, 0, 1, 1, 0, 1]",151,88,63,8,6,0.09090909090909091,0.09523809523809523
"[1, 0, 0, 0, 0, 0, 1, 1, 0, 1]",176,81,95,12,9,0.14814814814814814,0.09473684210526316
"[0, 1, 0, 1, 0, 1, 0, 1, 1, 1]",151,78,73,7,5,0.08974358974358974,0.0684931506849315
"[0, 1, 0, 0, 1, 0, 1, 0, 1, 0]",113,61,52,10,3,0.16393442622950818,0.057692307692307696
"[0, 0, 1, 0, 0, 1, 0, 1, 0, 1]",137,75,62,6,5,0.08,0.08064516129032258
"[1, 0, 1, 0, 0, 0, 0, 1, 0, 0]",146,67,79,7,6,0.1044776119402985,0.0759493670886076
"[1, 1, 0, 0, 1, 0, 1, 0, 0, 0]",163,71,92,3,5,0.04225352112676056,0.05434782608695652
"[0, 1, 0, 1, 0, 1, 1, 1, 0, 1]",134,65,69,5,8,0.07692307692307693,0.11594202898550725
"[1, 0, 1, 1, 1, 0, 1, 0, 0, 1]",149,72,77,6,7,0.08333333333333333,0.09090909090909091
"[0, 1, 1, 1, 0, 0, 1, 1, 0, 1]",163,81,82,8,8,0.09876543209876543,0.0975609756097561
"[0, 1, 0, 1, 0, 0, 1, 0, 1, 0]",143,73,70,4,10,0.0547945205479452,0.14285714285714285
"[0, 1, 0, 0, 1, 0, 1, 0, 0, 1]",167,86,81,6,5,0.06976744186046512,0.06172839506172839
"[0, 0, 1, 0, 1, 0, 0, 0, 0, 0]",184,94,90,12,7,0.1276595744680851,0.07777777777777778
"[0, 1, 1, 1, 1, 1, 0, 1, 1, 1]",158,68,90,3,5,0.04411764705882353,0.05555555555555555
"[1, 1, 0, 0, 1, 1, 1, 1, 1, 0]",229,106,123,15,12,0.14150943396226415,0.0975609756097561
"[1, 0, 0, 1, 0, 0, 0, 1, 1, 1]",171,84,87,6,7,0.07142857142857142,0.08045977011494253
"[1, 1, 1, 0, 0, 1, 0, 0, 0, 1]",173,68,105,7,10,0.10294117647058823,0.09523809523809523
"[1, 0, 1, 0, 1, 1, 1, 1, 1, 1]",192,93,99,12,6,0.12903225806451613,0.06060606060606061
"[0, 1, 0, 1, 0, 1, 1, 1, 1, 1]",179,89,90,8,4,0.0898876404494382,0.044444444444444446
"[1, 1, 1, 0, 0, 1, 0, 0, 1, 0]",171,79,92,10,8,0.12658227848101267,0.08695652173913043
"[0, 1, 1, 1, 1, 1, 0, 0, 0, 1]",186,111,75,12,9,0.10810810810810811,0.12
"[0, 0, 1, 1, 1, 1, 1, 0, 0, 0]",250,116,134,11,13,0.09482758620689655,0.09701492537313433
"[1, 1, 1, 0, 0, 1, 1, 0, 0, 1]",436,131,305,17,24,0.1297709923664122,0.07868852459016394
"[0, 1, 1, 1, 1, 1, 1, 1, 0, 1]",179,108,71,12,6,0.1111111111111111,0.08450704225352113
"[0, 0, 0, 1, 0, 1, 1, 0, 0, 0]",182,93,89,4,14,0.043010752688172046,0.15730337078651685
"[1, 0, 1, 0, 0, 0, 0, 0, 0, 0]",199,87,112,5,15,0.05747126436781609,0.13392857142857142
"[1, 1, 0, 1, 0, 0, 0, 0, 0, 0]",201,92,109,11,8,0.11956521739130435,0.07339449541284404
"[0, 1, 1, 0, 1, 0, 0, 0, 0, 0]",171,91,80,7,11,0.07692307692307693,0.1375
"[0, 1, 1, 1, 1, 1, 0, 1, 0, 1]",170,87,83,6,4,0.06896551724137931,0.04819277108433735
"[1, 1, 0, 1, 1, 1, 0, 0, 0, 0]",208,103,105,8,11,0.07766990291262135,0.10476190476190476
"[1, 1, 1, 1, 1, 1, 0, 1, 1, 0]",189,93,96,4,9,0.043010752688172046,0.09375
"[0, 0, 0, 1, 0, 1, 0, 1, 1, 1]",169,95,74,11,8,0.11578947368421053,0.10810810810810811
"[0, 0, 0, 0, 1, 0, 1, 0, 1, 1]",167,70,97,7,7,0.1,0.07216494845360824
"[0, 0, 1, 1, 0, 1, 0, 0, 1, 0]",176,90,86,12,8,0.13333333333333333,0.09302325581395349
"[0, 1, 0, 0, 1, 1, 0, 1, 0, 0]",162,79,83,3,8,0.0379746835443038,0.0963855421686747
"[1, 0, 0, 0, 1, 1, 1, 0, 1, 1]",168,71,97,8,7,0.11267605633802817,0.07216494845360824
"[0, 1, 1, 0, 0, 1, 0, 0, 0, 1]",158,86,72,3,5,0.03488372093023256,0.06944444444444445
"[0, 1, 0, 0, 0, 1, 1, 0, 0, 0]",183,100,83,9,9,0.09,0.10843373493975904
"[0, 0, 0, 1, 1, 0, 1, 0, 0, 0]",182,102,80,6,7,0.058823529411764705,0.0875
"[1, 0, 0, 0, 0, 0, 1, 0, 0, 1]",161,73,88,9,4,0.1232876712328767,0.045454545454545456
"[1, 0, 1, 1, 1, 0, 0, 0, 1, 1]",177,85,92,8,7,0.09411764705882353,0.07608695652173914
"[0, 0, 1, 1, 0, 1, 1, 1, 0, 0]",183,83,100,11,18,0.13253012048192772,0.18
"[0, 1, 0, 0, 1, 0, 1, 1, 1, 1]",202,111,91,8,13,0.07207207207207207,0.14285714285714285
"[0, 0, 0, 0, 1, 1, 1, 1, 0, 1]",248,124,124,6,16,0.04838709677419355,0.12903225806451613
"[0, 1, 1, 1, 1, 1, 1, 0, 0, 0]",479,358,121,39,10,0.10893854748603352,0.08264462809917356
"[1, 0, 0, 0, 0, 1, 1, 1, 1, 0]",474,122,352,17,39,0.13934426229508196,0.11079545454545454
"[1, 1, 0, 1, 0, 1, 1, 1, 0, 1]",129,64,65,8,4,0.125,0.06153846153846154
"[0, 1, 1, 1, 0, 1, 0, 1, 1, 1]",166,96,70,9,10,0.09375,0.14285714285714285
"[0, 0, 0, 0, 0, 1, 1, 0, 0, 1]",449,300,149,30,18,0.1,0.12080536912751678
"[1, 1, 1, 0, 0, 0, 0, 1, 1, 0]",474,115,359,12,34,0.10434782608695652,0.0947075208913649
"[0, 1, 0, 1, 1, 1, 0, 0, 1, 1]",191,98,93,15,11,0.15306122448979592,0.11827956989247312
"[0, 1, 0, 0, 0, 1, 0, 1, 1, 1]",156,79,77,8,5,0.10126582278481013,0.06493506493506493
"[0, 0, 1, 0, 0, 0, 1, 0, 1, 1]",161,81,80,5,10,0.06172839506172839,0.125
"[0, 0, 0, 1, 0, 0, 0, 1, 0, 1]",151,91,60,6,7,0.06593406593406594,0.11666666666666667
"[1, 0, 0, 1, 0, 0, 0, 1, 0, 0]",159,83,76,15,9,0.18072289156626506,0.11842105263157894
"[0, 1, 0, 0, 1, 0, 0, 0, 1, 0]",155,74,81,4,6,0.05405405405405406,0.07407407407407407
"[1, 1, 1, 0, 0, 0, 1, 1, 0, 1]",171,91,80,7,6,0.07692307692307693,0.075
"[0, 0, 0, 1, 1, 1, 1, 0, 0, 1]",453,328,125,25,15,0.07621951219512195,0.12
"[1, 0, 0, 0, 1, 1, 1, 1, 0, 0]",233,98,135,8,14,0.08163265306122448,0.1037037037037037
"[0, 1, 1, 0, 1, 1, 0, 0, 0, 1]",156,83,73,8,9,0.0963855421686747,0.1232876712328767
"[1, 0, 1, 0, 0, 0, 1, 1, 0, 1]",135,66,69,5,7,0.07575757575757576,0.10144927536231885
"[1, 1, 1, 0, 1, 0, 0, 0, 1, 1]",166,77,89,6,12,0.07792207792207792,0.1348314606741573
"[1, 0, 1, 1, 1, 1, 1, 0, 1, 1]",153,84,69,5,7,0.05952380952380952,0.10144927536231885
"[0, 0, 0, 1, 1, 0, 0, 0, 0, 1]",458,327,131,26,15,0.07951070336391437,0.11450381679389313
"[1, 0, 1, 1, 1, 1, 1, 1, 1, 0]",214,111,103,11,7,0.0990990990990991,0.06796116504854369
"[0, 1, 1, 0, 1, 1, 1, 1, 1, 1]",207,110,97,14,11,0.12727272727272726,0.1134020618556701
"[1, 0, 0, 1, 0, 1, 0, 1, 0, 0]",147,58,89,5,8,0.08620689655172414,0.0898876404494382
"[0, 1, 0, 0, 1, 0, 0, 1, 1, 1]",172,84,88,4,7,0.047619047619047616,0.07954545454545454
"[0, 0, 0, 1, 0, 0, 0, 0, 1, 1]",183,75,108,12,10,0.16,0.09259259259259259
"[1, 0, 0, 0, 0, 0, 1, 0, 0, 0]",148,61,87,6,8,0.09836065573770492,0.09195402298850575
"[0, 0, 1, 0, 0, 1, 0, 1, 1, 1]",187,97,90,1,7,0.010309278350515464,0.07777777777777778
"[1, 1, 1, 1, 0, 1, 0, 0, 0, 1]",162,83,79,13,6,0.1566265060240964,0.0759493670886076
"[0, 1, 1, 0, 1, 1, 1, 1, 0, 1]",132,71,61,10,7,0.14084507042253522,0.11475409836065574
"[1, 0, 0, 1, 1, 1, 0, 1, 0, 1]",171,89,82,9,10,0.10112359550561797,0.12195121951219512
"[0, 1, 0, 0, 1, 1, 1, 0, 1, 0]",156,82,74,11,7,0.13414634146341464,0.0945945945945946
"[1, 0, 1, 0, 0, 0, 1, 0, 1, 1]",139,73,66,9,2,0.1232876712328767,0.030303030303030304
"[0, 1, 0, 0, 0, 0, 1, 1, 0, 0]",235,111,124,7,13,0.06306306306306306,0.10483870967741936
"[0, 1, 0, 1, 0, 0, 0, 1, 1, 1]",176,96,80,4,7,0.041666666666666664,0.0875
"[0, 0, 0, 1, 0, 1, 0, 0, 0, 1]",150,75,75,5,10,0.06666666666666667,0.13333333333333333
"[1, 1, 0, 0, 1, 0, 1, 1, 0, 0]",190,98,92,6,8,0.061224489795918366,0.08695652173913043
"[1, 0, 0, 1, 1, 1, 1, 0, 1, 1]",198,87,111,4,10,0.04597701149425287,0.09009009009009009
"[1, 1, 1, 0, 0, 0, 0, 0, 0, 0]",478,137,341,12,34,0.08759124087591241,0.09970674486803519
"[1, 1, 0, 0, 0, 1, 1, 1, 1, 1]",229,129,100,15,10,0.11627906976744186,0.1
"[1, 0, 1, 1, 1, 0, 1, 1, 0, 0]",178,98,80,8,7,0.08163265306122448,0.0875
"[1, 0, 0, 0, 0, 0, 0, 1, 0, 1]",195,62,133,6,18,0.0967741935483871,0.13533834586466165
"[1, 1, 1, 0, 0, 0, 1, 0, 1, 1]",171,77,94,10,11,0.12987012987012986,0.11702127659574468
"[1, 1, 1, 1, 0, 0, 0, 1, 0, 1]",175,81,94,9,9,0.1111111111111111,0.09574468085106383
"[1, 1, 0, 0, 1, 0, 0, 1, 0, 1]",161,77,84,4,8,0.05194805194805195,0.09523809523809523
"[1, 0, 1, 1, 0, 0, 0, 1, 1, 0]",160,80,80,4,9,0.05,0.1125
"[1, 1, 0, 1, 0, 1, 1, 0, 0, 0]",180,83,97,6,8,0.07228915662650602,0.08247422680412371
"[1, 1, 1, 0, 0, 0, 1, 0, 0, 1]",195,88,107,5,11,0.056818181818181816,0.102803738317757
"[0, 1, 1, 0, 0, 0, 0, 0, 0, 1]",440,308,132,32,6,0.1038961038961039,0.045454545454545456
"[0, 1, 1, 0, 1, 0, 1, 0, 0, 1]",171,99,72,8,7,0.08080808080808081,0.09722222222222222
"[0, 1, 0, 0, 1, 0, 0, 1, 1, 0]",185,86,99,6,13,0.06976744186046512,0.13131313131313133
"[1, 1, 0, 1, 0, 0, 1, 0, 0, 1]",165,70,95,10,7,0.14285714285714285,0.07368421052631578
"[0, 0, 0, 1, 0, 1, 0, 1, 0, 1]",149,82,67,10,6,0.12195121951219512,0.08955223880597014
"[1, 1, 0, 1, 0, 1, 0, 1, 0, 0]",144,70,74,2,3,0.02857142857142857,0.04054054054054054
"[0, 1, 1, 1, 0, 0, 0, 1, 1, 1]",179,93,86,9,9,0.0967741935483871,0.10465116279069768
"[0, 0, 0, 0, 0, 1, 1, 1, 0, 0]",219,136,83,11,10,0.08088235294117647,0.12048192771084337
"[1, 1, 1, 1, 0, 1, 0, 0, 0, 0]",213,101,112,9,9,0.0891089108910891,0.08035714285714286
"[1, 0, 1, 1, 1, 0, 0, 0, 1, 0]",144,63,81,6,6,0.09523809523809523,0.07407407407407407
"[1, 0, 0, 0, 0, 1, 0, 1, 1, 0]",163,72,91,6,9,0.08333333333333333,0.0989010989010989
"[0, 0, 1, 0, 1, 1, 0, 0, 0, 1]",154,80,74,7,3,0.0875,0.04054054054054054
"[1, 1, 1, 0, 1, 1, 0, 0, 1, 0]",174,82,92,12,9,0.14634146341463414,0.09782608695652174
"[1, 1, 1, 1, 0, 1, 1, 0, 0, 1]",207,115,92,14,4,0.12173913043478261,0.043478260869565216
"[0, 0, 0, 1, 0, 1, 0, 1, 1, 0]",163,77,86,11,10,0.14285714285714285,0.11627906976744186
"[0, 0, 0, 0, 1, 0, 0, 0, 0, 0]",153,77,76,14,9,0.18181818181818182,0.11842105263157894
"[1, 0, 0, 0, 1, 0, 1, 0, 0, 0]",164,79,85,9,12,0.11392405063291139,0.1411764705882353
"[0, 1, 0, 0, 1, 1, 0, 1, 1, 0]",154,77,77,4,8,0.05194805194805195,0.1038961038961039
"[0, 1, 0, 0, 0, 1, 0, 0, 1, 1]",159,89,70,8,4,0.0898876404494382,0.05714285714285714
"[0, 1, 1, 0, 0, 0, 0, 1, 0, 0]",176,93,83,10,6,0.10752688172043011,0.07228915662650602
"[1, 1, 0, 0, 0, 1, 0, 0, 1, 1]",177,88,89,14,8,0.1590909090909091,0.0898876404494382
"[0, 0, 1, 1, 0, 0, 1, 0, 0, 1]",195,93,102,4,9,0.043010752688172046,0.08823529411764706
"[0, 0, 1, 0, 1, 0, 0, 1, 1, 0]",186,82,104,9,16,0.10975609756097561,0.15384615384615385
"[0, 1, 1, 0, 1, 0, 1, 1, 0, 0]",157,88,69,7,7,0.07954545454545454,0.10144927536231885
"[1, 0, 1, 1, 0, 1, 0, 1, 1, 0]",148,85,63,4,2,0.047058823529411764,0.031746031746031744
"[0, 1, 1, 0, 1, 0, 1, 0, 0, 0]",165,83,82,10,4,0.12048192771084337,0.04878048780487805
"[0, 1, 1, 0, 0, 0, 1, 0, 1, 0]",158,80,78,9,9,0.1125,0.11538461538461539
"[1, 0, 1, 1, 0, 0, 0, 1, 0, 1]",156,75,81,4,5,0.05333333333333334,0.06172839506172839
"[0, 0, 0, 1, 0, 1, 1, 0, 0, 1]",168,91,77,11,9,0.12087912087912088,0.11688311688311688
"[0, 1, 1, 0, 0, 1, 0, 0, 1, 0]",174,85,89,10,8,0.11764705882352941,0.0898876404494382
"[1, 0, 1, 0, 0, 0, 1, 0, 0, 0]",131,65,66,5,5,0.07692307692307693,0.07575757575757576
"[1, 0, 1, 1, 1, 0, 1, 0, 1, 0]",135,56,79,3,6,0.05357142857142857,0.0759493670886076
"[1, 1, 0, 1, 1, 0, 0, 1, 0, 1]",161,76,85,8,4,0.10526315789473684,0.047058823529411764
"[1, 1, 1, 1, 0, 1, 0, 1, 1, 1]",173,98,75,7,5,0.07142857142857142,0.06666666666666667
"[1, 0, 1, 0, 1, 1, 0, 1, 0, 1]",152,73,79,7,3,0.0958904109589041,0.0379746835443038
"[0, 1, 0, 0, 1, 1, 0, 1, 0, 1]",151,75,76,8,9,0.10666666666666667,0.11842105263157894
"[1, 1, 1, 1, 0, 1, 0, 0, 1, 0]",167,83,84,7,11,0.08433734939759036,0.13095238095238096
"[0, 1, 0, 1, 1, 0, 0, 0, 1, 0]",139,73,66,4,7,0.0547945205479452,0.10606060606060606
"[0, 0, 0, 1, 0, 1, 0, 0, 1, 0]",130,67,63,10,7,0.14925373134328357,0.1111111111111111
"[0, 1, 0, 0, 0, 1, 0, 1, 1, 0]",147,84,63,5,5,0.05952380952380952,0.07936507936507936
"[1, 0, 1, 1, 0, 0, 0, 0, 1, 0]",162,79,83,9,5,0.11392405063291139,0.060240963855421686
"[0, 1, 1, 1, 0, 0, 1, 0, 1, 0]",150,78,72,7,4,0.08974358974358974,0.05555555555555555
"[0, 0, 1, 0, 0, 0, 0, 0, 0, 0]",204,95,109,10,11,0.10526315789473684,0.10091743119266056
"[1, 0, 0, 0, 1, 0, 0, 1, 0, 0]",147,56,91,2,16,0.03571428571428571,0.17582417582417584
"[0, 0, 1, 0, 1, 1, 0, 1, 1, 0]",143,72,71,5,6,0.06944444444444445,0.08450704225352113
"[1, 1, 0, 0, 0, 0, 1, 0, 0, 0]",181,91,90,7,17,0.07692307692307693,0.18888888888888888
"[0, 0, 1, 0, 1, 0, 0, 1, 0, 0]",156,69,87,4,6,0.057971014492753624,0.06896551724137931
"[1, 1, 1, 1, 0, 0, 0, 0, 1, 0]",215,106,109,8,5,0.07547169811320754,0.045871559633027525
"[0, 0, 0, 0, 1, 0, 0, 1, 1, 1]",217,126,91,11,5,0.0873015873015873,0.054945054945054944
"[1, 1, 0, 0, 0, 1, 1, 0, 0, 1]",195,84,111,8,7,0.09523809523809523,0.06306306306306306
"[0, 1, 0, 1, 0, 0, 1, 1, 1, 1]",216,112,104,5,8,0.044642857142857144,0.07692307692307693
"[1, 0, 1, 0, 1, 0, 1, 0, 0, 1]",141,70,71,4,0,0.05714285714285714,0.0
"[1, 0, 1, 1, 0, 0, 1, 0, 1, 0]",157,68,89,11,10,0.16176470588235295,0.11235955056179775
"[0, 1, 0, 1, 1, 0, 0, 1, 0, 1]",136,69,67,5,6,0.07246376811594203,0.08955223880597014
"[1, 1, 0, 1, 0, 1, 1, 0, 0, 1]",172,79,93,11,7,0.13924050632911392,0.07526881720430108
"[0, 0, 1, 1, 0, 1, 1, 1, 0, 1]",158,85,73,9,5,0.10588235294117647,0.0684931506849315
"[1, 0, 0, 0, 0, 0, 0, 1, 1, 0]",385,94,291,12,31,0.1276595744680851,0.10652920962199312
"[0, 1, 0, 0, 0, 0, 0, 0, 1, 1]",236,108,128,11,9,0.10185185185185185,0.0703125
"[0, 1, 0, 1, 0, 1, 0, 0, 0, 0]",150,80,70,14,2,0.175,0.02857142857142857
"[0, 0, 1, 0, 1, 0, 1, 0, 0, 0]",140,70,70,7,12,0.1,0.17142857142857143
"[0, 1, 0, 0, 1, 1, 0, 0, 1, 1]",272,141,131,17,16,0.12056737588652482,0.12213740458015267
"[1, 1, 0, 1, 0, 0, 1, 1, 0, 0]",237,121,116,11,10,0.09090909090909091,0.08620689655172414
"[0, 1, 1, 0, 1, 0, 0, 1, 1, 0]",205,111,94,6,8,0.05405405405405406,0.0851063829787234
"[0, 0, 0, 1, 1, 0, 1, 0, 0, 1]",204,111,93,20,7,0.18018018018018017,0.07526881720430108
"[1, 1, 0, 0, 1, 0, 0, 0, 0, 0]",192,84,108,8,14,0.09523809523809523,0.12962962962962962
"[0, 1, 0, 1, 1, 0, 0, 1, 0, 0]",184,94,90,8,7,0.0851063829787234,0.07777777777777778
"[1, 0, 0, 1, 1, 1, 1, 0, 1, 0]",178,79,99,12,10,0.1518987341772152,0.10101010101010101
"[0, 0, 0, 0, 0, 0, 1, 1, 1, 1]",694,363,331,28,29,0.07713498622589532,0.08761329305135952
"[0, 0, 0, 1, 1, 1, 1, 0, 0, 0]",438,327,111,30,15,0.09174311926605505,0.13513513513513514
"[1, 1, 0, 0, 1, 1, 0, 0, 0, 0]",685,334,351,29,26,0.08682634730538923,0.07407407407407407
"[1, 1, 1, 1, 0, 0, 1, 1, 0, 0]",662,334,328,34,30,0.10179640718562874,0.09146341463414634
"[0, 1, 1, 1, 1, 1, 1, 0, 0, 1]",453,334,119,30,11,0.08982035928143713,0.09243697478991597
"[0, 0, 1, 1, 1, 1, 1, 1, 0, 0]",695,394,301,39,29,0.09898477157360407,0.09634551495016612
"[0, 0, 0, 0, 1, 1, 1, 1, 1, 1]",742,399,343,26,24,0.06516290726817042,0.06997084548104957
"[1, 0, 0, 0, 0, 1, 1, 1, 1, 1]",442,141,301,11,19,0.07801418439716312,0.06312292358803986
"[1, 1, 1, 0, 1, 1, 1, 1, 0, 0]",195,101,94,14,11,0.13861386138613863,0.11702127659574468
"[0, 0, 1, 0, 1, 1, 1, 0, 1, 1]",160,85,75,14,7,0.16470588235294117,0.09333333333333334
"[0, 0, 1, 0, 0, 1, 0, 0, 0, 0]",156,73,83,6,8,0.0821917808219178,0.0963855421686747
"[0, 1, 0, 0, 0, 0, 1, 0, 0, 1]",141,70,71,3,5,0.04285714285714286,0.07042253521126761
"[0, 1, 1, 0, 1, 0, 0, 1, 0, 0]",163,87,76,10,4,0.11494252873563218,0.05263157894736842
"[1, 0, 1, 0, 1, 0, 0, 1, 0, 0]",143,69,74,7,7,0.10144927536231885,0.0945945945945946
"[0, 0, 1, 1, 1, 0, 1, 0, 0, 0]",168,80,88,9,6,0.1125,0.06818181818181818
"[0, 1, 1, 0, 0, 0, 1, 1, 1, 0]",177,106,71,11,7,0.10377358490566038,0.09859154929577464
"[1, 1, 1, 0, 0, 1, 1, 1, 0, 1]",182,79,103,11,17,0.13924050632911392,0.1650485436893204
"[0, 1, 1, 0, 1, 1, 1, 0, 0, 1]",173,84,89,8,6,0.09523809523809523,0.06741573033707865
"[0, 1, 0, 1, 1, 0, 1, 1, 1, 0]",166,72,94,9,7,0.125,0.07446808510638298
"[1, 1, 0, 0, 1, 1, 1, 0, 1, 0]",186,103,83,4,6,0.038834951456310676,0.07228915662650602
"[0, 0, 1, 1, 1, 0, 1, 1, 1, 0]",166,85,81,10,8,0.11764705882352941,0.09876543209876543
"[1, 1, 0, 1, 1, 0, 0, 1, 1, 1]",208,97,111,6,6,0.061855670103092786,0.05405405405405406
"[0, 1, 1, 0, 0, 1, 1, 0, 1, 1]",186,116,70,14,4,0.1206896551724138,0.05714285714285714
"[0, 0, 1, 1, 0, 0, 0, 1, 1, 0]",214,102,112,10,13,0.09803921568627451,0.11607142857142858
"[1, 0, 1, 0, 1, 1, 0, 1, 1, 0]",141,62,79,6,7,0.0967741935483871,0.08860759493670886
"[0, 0, 0, 1, 1, 1, 0, 1, 0, 1]",179,105,74,10,8,0.09523809523809523,0.10810810810810811
"[0, 0, 0, 0, 0, 1, 1, 1, 0, 1]",207,113,94,12,5,0.10619469026548672,0.05319148936170213
"[1, 1, 0, 0, 0, 0, 0, 1, 1, 1]",280,140,140,13,11,0.09285714285714286,0.07857142857142857
"[1, 0, 0, 1, 1, 1, 0, 0, 1, 1]",219,103,116,12,10,0.11650485436893204,0.08620689655172414
"[0, 0, 0, 0, 1, 0, 1, 0, 0, 1]",150,79,71,7,11,0.08860759493670886,0.15492957746478872
"[1, 1, 0, 1, 1, 1, 0, 1, 1, 1]",151,82,69,8,14,0.0975609756097561,0.2028985507246377
"[1, 1, 1, 1, 1, 1, 0, 1, 1, 1]",170,90,80,5,13,0.05555555555555555,0.1625
"[0, 0, 1, 0, 0, 0, 1, 0, 0, 0]",152,76,76,6,8,0.07894736842105263,0.10526315789473684
"[0, 0, 0, 0, 0, 1, 0, 0, 0, 1]",166,85,81,2,4,0.023529411764705882,0.04938271604938271
"[0, 0, 1, 1, 0, 1, 1, 0, 0, 0]",182,90,92,6,6,0.06666666666666667,0.06521739130434782
"[0, 0, 0, 1, 1, 0, 1, 1, 0, 0]",174,101,73,10,4,0.09900990099009901,0.0547945205479452
"[1, 0, 0, 0, 0, 1, 1, 0, 1, 1]",190,78,112,5,9,0.0641025641025641,0.08035714285714286
"[0, 1, 1, 1, 1, 1, 1, 1, 0, 0]",310,167,143,17,12,0.10179640718562874,0.08391608391608392
"[1, 0, 0, 1, 1, 1, 1, 1, 1, 1]",419,148,271,10,35,0.06756756756756757,0.12915129151291513
"[0, 0, 0, 1, 0, 0, 1, 0, 0, 1]",152,79,73,8,7,0.10126582278481013,0.0958904109589041
"[0, 0, 1, 1, 0, 1, 1, 0, 1, 1]",156,78,78,10,5,0.1282051282051282,0.0641025641025641
"[0, 1, 0, 1, 0, 1, 1, 1, 0, 0]",177,98,79,9,2,0.09183673469387756,0.02531645569620253
"[0, 0, 0, 1, 0, 0, 1, 0, 1, 0]",150,70,80,7,6,0.1,0.075
"[0, 0, 0, 0, 1, 0, 0, 1, 0, 1]",166,75,91,5,11,0.06666666666666667,0.12087912087912088
"[0, 1, 0, 1, 0, 0, 0, 0, 1, 0]",136,63,73,7,5,0.1111111111111111,0.0684931506849315
"[0, 1, 0, 1, 1, 0, 1, 1, 1, 1]",158,78,80,3,4,0.038461538461538464,0.05
"[0, 1, 0, 1, 1, 1, 0, 1, 0, 1]",124,64,60,4,2,0.0625,0.03333333333333333
"[1, 0, 1, 0, 1, 1, 1, 0, 1, 0]",122,57,65,3,2,0.05263157894736842,0.03076923076923077
"[0, 0, 1, 0, 1, 0, 1, 1, 1, 0]",161,88,73,5,7,0.056818181818181816,0.0958904109589041
"[1, 0, 1, 0, 0, 1, 0, 1, 0, 1]",132,66,66,6,7,0.09090909090909091,0.10606060606060606
"[0, 1, 1, 1, 0, 1, 0, 0, 1, 0]",157,92,65,5,4,0.05434782608695652,0.06153846153846154
"[0, 1, 0, 1, 1, 1, 0, 1, 0, 0]",145,79,66,9,7,0.11392405063291139,0.10606060606060606
"[1, 1, 0, 0, 0, 0, 1, 1, 0, 1]",240,119,121,11,8,0.09243697478991597,0.06611570247933884
"[0, 1, 1, 0, 0, 0, 0, 1, 1, 0]",457,342,115,31,11,0.09064327485380116,0.09565217391304348
"[0, 0, 1, 1, 0, 0, 0, 0, 1, 1]",714,368,346,36,30,0.09782608695652174,0.08670520231213873
"[1, 0, 0, 1, 1, 0, 0, 0, 0, 1]",464,137,327,9,32,0.06569343065693431,0.09785932721712538
"[0, 1, 1, 1, 1, 1, 0, 0, 1, 1]",250,146,104,17,12,0.11643835616438356,0.11538461538461539
"[0, 0, 1, 1, 0, 1, 1, 1, 1, 1]",210,119,91,7,13,0.058823529411764705,0.14285714285714285
"[1, 0, 0, 1, 1, 0, 1, 1, 1, 1]",190,87,103,9,9,0.10344827586206896,0.08737864077669903
"[0, 1, 1, 1, 1, 0, 1, 1, 1, 0]",166,93,73,6,9,0.06451612903225806,0.1232876712328767
"[1, 0, 1, 0, 1, 1, 1, 1, 0, 1]",177,85,92,6,6,0.07058823529411765,0.06521739130434782
"[0, 0, 1, 0, 1, 0, 1, 1, 1, 1]",172,84,88,5,6,0.05952380952380952,0.06818181818181818
"[1, 0, 1, 0, 0, 1, 0, 1, 0, 0]",159,80,79,5,9,0.0625,0.11392405063291139
"[0, 0, 0, 1, 0, 1, 0, 0, 0, 0]",169,82,87,9,10,0.10975609756097561,0.11494252873563218
"[0, 0, 1, 1, 1, 1, 1, 0, 1, 1]",156,75,81,5,9,0.06666666666666667,0.1111111111111111
"[1, 1, 1, 0, 0, 1, 1, 1, 1, 1]",410,127,283,12,18,0.09448818897637795,0.0636042402826855
"[1, 1, 1, 1, 1, 0, 0, 1, 1, 1]",383,131,252,13,24,0.09923664122137404,0.09523809523809523
"[0, 0, 0, 1, 1, 1, 1, 1, 0, 0]",245,122,123,9,7,0.07377049180327869,0.056910569105691054
"[1, 0, 0, 0, 1, 1, 1, 1, 1, 0]",194,91,103,9,9,0.0989010989010989,0.08737864077669903
"[1, 1, 1, 1, 0, 0, 1, 0, 0, 0]",209,102,107,13,8,0.12745098039215685,0.07476635514018691
"[1, 1, 1, 1, 1, 0, 0, 1, 0, 0]",219,98,121,6,10,0.061224489795918366,0.08264462809917356
"[1, 1, 1, 1, 1, 1, 1, 0, 0, 1]",366,124,242,11,21,0.08870967741935484,0.08677685950413223
"[1, 0, 0, 1, 0, 0, 1, 0, 1, 0]",142,76,66,5,7,0.06578947368421052,0.10606060606060606
"[1, 1, 0, 0, 1, 0, 0, 1, 0, 0]",182,95,87,12,4,0.12631578947368421,0.04597701149425287
"[1, 1, 0, 0, 1, 1, 1, 0, 0, 1]",207,106,101,9,9,0.08490566037735849,0.0891089108910891
"[1, 0, 0, 1, 1, 1, 1, 1, 0, 0]",246,101,145,9,14,0.0891089108910891,0.09655172413793103
"[0, 1, 1, 1, 0, 0, 1, 1, 0, 0]",249,136,113,13,14,0.09558823529411764,0.12389380530973451
"[0, 0, 0, 1, 1, 1, 1, 1, 1, 1]",487,366,121,33,9,0.09016393442622951,0.0743801652892562
"[0, 0, 0, 0, 1, 0, 1, 1, 0, 0]",186,100,86,2,9,0.02,0.10465116279069768
"[1, 0, 1, 1, 0, 1, 0, 0, 0, 0]",163,83,80,3,8,0.03614457831325301,0.1
"[1, 0, 1, 0, 1, 1, 0, 1, 0, 0]",168,76,92,14,8,0.18421052631578946,0.08695652173913043
"[0, 0, 1, 1, 1, 1, 1, 0, 1, 0]",180,88,92,9,7,0.10227272727272728,0.07608695652173914
"[0, 1, 1, 1, 0, 0, 0, 0, 0, 0]",267,147,120,18,11,0.12244897959183673,0.09166666666666666
"[1, 1, 1, 1, 1, 0, 1, 1, 0, 1]",139,67,72,4,8,0.05970149253731343,0.1111111111111111
"[0, 0, 1, 0, 0, 1, 1, 0, 1, 0]",154,78,76,8,7,0.10256410256410256,0.09210526315789473
"[1, 1, 1, 0, 0, 1, 0, 0, 1, 1]",208,88,120,7,8,0.07954545454545454,0.06666666666666667
"[1, 1, 1, 1, 1, 1, 1, 1, 1, 1]",641,284,357,25,33,0.0880281690140845,0.09243697478991597
"[0, 1, 1, 1, 1, 1, 1, 1, 1, 1]",414,313,101,34,6,0.10862619808306709,0.0594059405940594
"[0, 0, 1, 1, 1, 1, 1, 1, 1, 1]",610,338,272,31,33,0.09171597633136094,0.1213235294117647
"[1, 0, 0, 0, 0, 0, 1, 1, 1, 1]",301,130,171,10,10,0.07692307692307693,0.05847953216374269
"[0, 0, 1, 0, 0, 0, 1, 1, 0, 0]",177,102,75,8,6,0.0784313725490196,0.08
"[0, 0, 1, 0, 0, 0, 1, 1, 0, 1]",150,82,68,7,6,0.08536585365853659,0.08823529411764706
"[1, 0, 0, 1, 1, 1, 1, 1, 1, 0]",415,114,301,14,30,0.12280701754385964,0.09966777408637874
"[0, 0, 1, 0, 0, 1, 1, 1, 1, 1]",226,128,98,10,11,0.078125,0.11224489795918367
"[1, 1, 0, 0, 0, 1, 1, 0, 0, 0]",234,108,126,11,13,0.10185185185185185,0.10317460317460317
"[1, 1, 0, 1, 0, 0, 1, 0, 1, 1]",165,85,80,8,10,0.09411764705882353,0.125
"[1, 1, 1, 1, 1, 1, 0, 0, 0, 1]",260,125,135,16,8,0.128,0.05925925925925926
"[0, 1, 0, 0, 0, 0, 1, 1, 1, 1]",265,131,134,15,10,0.11450381679389313,0.07462686567164178
"[0, 1, 0, 1, 0, 0, 0, 0, 1, 1]",185,83,102,11,12,0.13253012048192772,0.11764705882352941
"[0, 0, 0, 1, 1, 0, 0, 1, 1, 1]",419,310,109,33,9,0.1064516129032258,0.08256880733944955
"[0, 0, 0, 0, 0, 0, 0, 1, 1, 0]",407,273,134,27,11,0.0989010989010989,0.08208955223880597
"[1, 1, 0, 0, 1, 1, 1, 1, 0, 0]",645,326,319,26,37,0.07975460122699386,0.11598746081504702
"[1, 1, 0, 0, 0, 1, 1, 0, 1, 0]",178,92,86,17,10,0.18478260869565216,0.11627906976744186
"[0, 0, 1, 0, 1, 1, 1, 1, 1, 0]",206,88,118,9,8,0.10227272727272728,0.06779661016949153
"[1, 0, 0, 1, 0, 0, 0, 1, 0, 1]",158,71,87,2,6,0.028169014084507043,0.06896551724137931
"[1, 1, 1, 1, 0, 0, 1, 1, 0, 1]",222,126,96,12,7,0.09523809523809523,0.07291666666666667
"[0, 1, 1, 1, 1, 0, 0, 1, 1, 0]",464,323,141,22,15,0.06811145510835913,0.10638297872340426
"[1, 0, 0, 0, 0, 0, 1, 1, 0, 0]",281,118,163,6,19,0.05084745762711865,0.1165644171779141
"[0, 1, 1, 1, 0, 1, 1, 0, 0, 1]",176,94,82,9,6,0.09574468085106383,0.07317073170731707
"[0, 0, 0, 1, 1, 1, 0, 1, 1, 0]",195,108,87,11,8,0.10185185185185185,0.09195402298850575
"[1, 0, 1, 1, 1, 0, 1, 0, 0, 0]",159,76,83,10,5,0.13157894736842105,0.060240963855421686
"[1, 0, 1, 0, 1, 0, 0, 1, 1, 0]",169,87,82,7,9,0.08045977011494253,0.10975609756097561
"[0, 0, 0, 0, 0, 1, 0, 0, 0, 0]",144,77,67,9,7,0.11688311688311688,0.1044776119402985
"[1, 0, 1, 0, 0, 0, 0, 0, 1, 0]",142,66,76,3,4,0.045454545454545456,0.05263157894736842
"[1, 1, 0, 1, 0, 0, 0, 0, 0, 1]",185,82,103,6,12,0.07317073170731707,0.11650485436893204
"[1, 1, 1, 1, 1, 1, 0, 1, 0, 0]",216,111,105,16,9,0.14414414414414414,0.08571428571428572
"[0, 0, 0, 0, 0, 1, 1, 0, 0, 0]",396,263,133,21,12,0.07984790874524715,0.09022556390977443
"[0, 1, 0, 1, 0, 0, 0, 1, 0, 1]",136,70,66,5,2,0.07142857142857142,0.030303030303030304
"[0, 1, 1, 0, 0, 1, 0, 1, 0, 0]",169,96,73,3,6,0.03125,0.0821917808219178
"[0, 0, 1, 1, 1, 0, 0, 1, 1, 0]",214,102,112,8,16,0.0784313725490196,0.14285714285714285
"[0, 0, 0, 1, 1, 1, 0, 0, 1, 1]",238,128,110,11,8,0.0859375,0.07272727272727272
"[0, 1, 1, 1, 1, 0, 1, 1, 0, 1]",155,89,66,11,12,0.12359550561797752,0.18181818181818182
"[1, 1, 0, 1, 1, 1, 0, 1, 1, 0]",155,75,80,7,7,0.09333333333333334,0.0875
"[0, 0, 0, 1, 0, 1, 1, 0, 1, 1]",146,76,70,8,5,0.10526315789473684,0.07142857142857142
"[0, 1, 0, 1, 1, 1, 1, 0, 0, 0]",200,94,106,14,6,0.14893617021276595,0.05660377358490566
"[1, 0, 0, 1, 0, 1, 1, 1, 1, 0]",156,85,71,11,6,0.12941176470588237,0.08450704225352113
"[1, 1, 1, 0, 0, 1, 0, 1, 1, 1]",161,82,79,5,7,0.06097560975609756,0.08860759493670886
"[0, 1, 1, 1, 1, 0, 1, 0, 0, 1]",162,89,73,11,10,0.12359550561797752,0.136986301369863
"[1, 0, 0, 0, 0, 0, 1, 0, 1, 1]",182,69,113,6,12,0.08695652173913043,0.10619469026548672
"[1, 1, 0, 1, 1, 0, 1, 0, 1, 1]",135,73,62,8,6,0.1095890410958904,0.0967741935483871
"[0, 0, 1, 1, 0, 1, 0, 1, 1, 1]",170,97,73,9,8,0.09278350515463918,0.1095890410958904
"[0, 0, 0, 0, 0, 1, 0, 1, 0, 0]",158,80,78,14,11,0.175,0.14102564102564102
"[1, 1, 1, 0, 0, 0, 0, 0, 1, 0]",203,95,108,10,8,0.10526315789473684,0.07407407407407407
"[1, 1, 1, 1, 0, 1, 1, 1, 1, 1]",165,87,78,9,5,0.10344827586206896,0.0641025641025641
"[0, 1, 1, 0, 0, 0, 1, 0, 1, 1]",166,89,77,8,11,0.0898876404494382,0.14285714285714285
"[0, 1, 1, 1, 0, 1, 1, 0, 1, 1]",173,89,84,6,6,0.06741573033707865,0.07142857142857142
"[0, 0, 1, 1, 1, 0, 1, 1, 0, 1]",159,85,74,10,7,0.11764705882352941,0.0945945945945946
"[1, 0, 1, 0, 1, 0, 1, 0, 1, 0]",119,59,60,5,3,0.0847457627118644,0.05
"[0, 1, 0, 1, 0, 1, 0, 1, 0, 1]",127,75,52,5,9,0.06666666666666667,0.17307692307692307
"[1, 1, 1, 0, 1, 0, 0, 0, 0, 1]",191,92,99,8,8,0.08695652173913043,0.08080808080808081
"[1, 1, 0, 1, 0, 1, 1, 1, 0, 0]",156,71,85,7,3,0.09859154929577464,0.03529411764705882
"[1, 0, 1, 0, 1, 0, 1, 0, 0, 0]",138,65,73,6,9,0.09230769230769231,0.1232876712328767
"[1, 1, 1, 0, 0, 0, 1, 0, 1, 0]",145,66,79,5,6,0.07575757575757576,0.0759493670886076
"[0, 1, 1, 1, 0, 0, 0, 1, 0, 1]",144,79,65,10,3,0.12658227848101267,0.046153846153846156
"[1, 0, 1, 1, 1, 1, 0, 1, 0, 0]",154,89,65,9,7,0.10112359550561797,0.1076923076923077
"[0, 0, 1, 0, 1, 1, 1, 1, 0, 1]",148,80,68,10,3,0.125,0.04411764705882353
"[1, 0, 1, 1, 1, 1, 0, 0, 1, 1]",242,127,115,13,12,0.10236220472440945,0.10434782608695652
"[0, 1, 1, 0, 0, 0, 0, 1, 0, 1]",182,102,80,10,7,0.09803921568627451,0.0875
"[0, 0, 1, 1, 0, 0, 0, 0, 1, 0]",199,86,113,7,11,0.08139534883720931,0.09734513274336283
"[0, 0, 0, 1, 0, 0, 0, 1, 1, 0]",187,98,89,7,9,0.07142857142857142,0.10112359550561797
"[0, 0, 0, 1, 1, 1, 0, 0, 0, 0]",242,134,108,20,6,0.14925373134328357,0.05555555555555555
"[1, 1, 1, 0, 1, 1, 0, 0, 0, 0]",229,109,120,10,14,0.09174311926605505,0.11666666666666667
"[1, 1, 1, 1, 0, 1, 1, 0, 0, 0]",208,94,114,2,9,0.02127659574468085,0.07894736842105263
"[1, 1, 0, 1, 1, 0, 0, 1, 0, 0]",161,75,86,7,4,0.09333333333333334,0.046511627906976744
"[0, 1, 1, 1, 1, 0, 1, 1, 0, 0]",207,125,82,6,5,0.048,0.06097560975609756
"[1, 0, 0, 1, 1, 0, 1, 1, 0, 1]",160,76,84,8,7,0.10526315789473684,0.08333333333333333
"[0, 1, 0, 1, 0, 1, 1, 0, 0, 1]",170,92,78,5,7,0.05434782608695652,0.08974358974358974
"[1, 1, 0, 0, 0, 1, 0, 0, 0, 0]",177,81,96,6,3,0.07407407407407407,0.03125
"[1, 1, 1, 0, 1, 0, 1, 1, 1, 1]",187,92,95,6,11,0.06521739130434782,0.11578947368421053
"[1, 1, 1, 0, 0, 1, 0, 1, 0, 1]",144,59,85,5,6,0.0847457627118644,0.07058823529411765
"[1, 1, 1, 1, 1, 0, 0, 1, 0, 1]",199,90,109,6,14,0.06666666666666667,0.12844036697247707
"[1, 0, 1, 1, 0, 1, 0, 1, 0, 1]",158,87,71,2,2,0.022988505747126436,0.028169014084507043
"[0, 0, 1, 1, 0, 1, 1, 0, 1, 0]",157,73,84,5,3,0.0684931506849315,0.03571428571428571
"[0, 0, 1, 0, 0, 1, 1, 0, 1, 1]",161,72,89,9,8,0.125,0.0898876404494382
"[1, 0, 0, 0, 1, 0, 0, 1, 1, 0]",166,60,106,2,13,0.03333333333333333,0.12264150943396226
"[1, 0, 0, 1, 1, 1, 0, 0, 0, 1]",177,68,109,7,8,0.10294117647058823,0.07339449541284404
"[0, 1, 0, 0, 1, 1, 1, 0, 0, 0]",165,87,78,11,8,0.12643678160919541,0.10256410256410256
"[1, 0, 0, 1, 1, 1, 0, 0, 0, 0]",230,99,131,8,10,0.08080808080808081,0.07633587786259542
"[1, 0, 1, 0, 1, 1, 1, 0, 0, 0]",167,89,78,9,5,0.10112359550561797,0.0641025641025641
"[0, 0, 0, 1, 1, 0, 0, 0, 1, 1]",236,135,101,14,10,0.1037037037037037,0.09900990099009901
"[1, 0, 0, 1, 0, 0, 1, 0, 0, 0]",160,70,90,8,9,0.11428571428571428,0.1
"[0, 1, 0, 0, 1, 0, 0, 1, 0, 0]",138,67,71,8,4,0.11940298507462686,0.056338028169014086
"[1, 0, 1, 0, 0, 1, 0, 0, 1, 0]",137,61,76,10,4,0.16393442622950818,0.05263157894736842
"[0, 1, 1, 1, 1, 0, 1, 1, 1, 1]",164,92,72,11,5,0.11956521739130435,0.06944444444444445
"[1, 1, 0, 0, 0, 0, 0, 0, 0, 1]",264,118,146,11,10,0.09322033898305085,0.0684931506849315
"[1, 0, 0, 0, 1, 0, 0, 1, 1, 1]",173,100,73,6,7,0.06,0.0958904109589041
"[0, 1, 1, 0, 1, 1, 0, 0, 1, 0]",148,85,63,6,4,0.07058823529411765,0.06349206349206349
"[0, 0, 1, 1, 0, 1, 0, 1, 0, 1]",162,72,90,5,9,0.06944444444444445,0.1
"[1, 1, 1, 0, 1, 1, 1, 0, 0, 0]",185,88,97,9,11,0.10227272727272728,0.1134020618556701
"[0, 0, 1, 0, 0, 0, 0, 0, 1, 0]",139,64,75,6,10,0.09375,0.13333333333333333
"[1, 0, 0, 0, 1, 0, 1, 1, 0, 0]",167,80,87,10,11,0.125,0.12643678160919541
"[1, 0, 0, 0, 1, 0, 0, 0, 0, 1]",168,81,87,6,5,0.07407407407407407,0.05747126436781609
"[0, 1, 0, 0, 1, 0, 1, 1, 0, 1]",142,78,64,3,3,0.038461538461538464,0.046875
"[1, 1, 0, 0, 0, 1, 0, 1, 0, 1]",151,82,69,9,2,0.10975609756097561,0.028985507246376812
"[0, 1, 0, 1, 0, 0, 1, 0, 0, 0]",144,75,69,9,7,0.12,0.10144927536231885
"[1, 1, 0, 0, 0, 1, 0, 1, 1, 0]",160,86,74,7,5,0.08139534883720931,0.06756756756756757
"[0, 1, 1, 0, 1, 0, 0, 0, 1, 0]",138,76,62,9,7,0.11842105263157894,0.11290322580645161
"[0, 0, 1, 1, 1, 0, 0, 0, 0, 0]",246,128,118,16,9,0.125,0.07627118644067797
"[1, 0, 0, 0, 1, 1, 1, 0, 0, 0]",194,92,102,5,10,0.05434782608695652,0.09803921568627451
"[0, 1, 0, 1, 1, 0, 1, 0, 1, 0]",151,73,78,4,8,0.0547945205479452,0.10256410256410256
"[0, 1, 0, 1, 1, 1, 0, 1, 1, 0]",162,91,71,10,4,0.10989010989010989,0.056338028169014086
"[1, 0, 1, 1, 0, 0, 1, 0, 1, 1]",147,71,76,4,7,0.056338028169014086,0.09210526315789473
"[0, 0, 0, 1, 0, 0, 1, 1, 1, 0]",151,88,63,3,5,0.03409090909090909,0.07936507936507936
"[0, 1, 1, 0, 1, 1, 0, 1, 1, 1]",129,78,51,5,4,0.0641025641025641,0.0784313725490196
"[1, 1, 0, 0, 1, 0, 1, 1, 0, 1]",134,59,75,5,5,0.0847457627118644,0.06666666666666667
"[1, 0, 0, 1, 0, 1, 1, 0, 1, 1]",143,70,73,7,7,0.1,0.0958904109589041
"[0, 0, 1, 0, 0, 1, 1, 1, 1, 0]",222,115,107,11,9,0.09565217391304348,0.08411214953271028
"[1, 1, 0, 0, 0, 0, 1, 0, 0, 1]",185,86,99,3,6,0.03488372093023256,0.06060606060606061
"[1, 1, 1, 1, 1, 1, 1, 0, 0, 0]",492,177,315,18,33,0.1016949152542373,0.10476190476190476
"[0, 1, 1, 1, 1, 1, 1, 1, 1, 0]",372,284,88,22,2,0.07746478873239436,0.022727272727272728
"[0, 1, 0, 1, 1, 1, 1, 1, 1, 1]",209,120,89,15,7,0.125,0.07865168539325842
"[0, 0, 1, 0, 1, 1, 1, 1, 1, 1]",214,109,105,10,6,0.09174311926605505,0.05714285714285714
"[0, 0, 1, 0, 1, 0, 1, 0, 1, 0]",136,70,66,6,7,0.08571428571428572,0.10606060606060606
"[1, 0, 1, 0, 1, 1, 0, 0, 1, 0]",156,81,75,10,5,0.12345679012345678,0.06666666666666667
"[1, 1, 0, 1, 1, 1, 0, 1, 0, 1]",144,74,70,5,11,0.06756756756756757,0.15714285714285714
"[0, 1, 0, 1, 0, 0, 0, 0, 0, 0]",183,90,93,8,8,0.08888888888888889,0.08602150537634409
"[0, 0, 0, 1, 0, 1, 0, 1, 0, 0]",149,75,74,7,12,0.09333333333333334,0.16216216216216217
"[0, 1, 1, 0, 0, 1, 1, 0, 0, 1]",468,329,139,24,14,0.0729483282674772,0.10071942446043165
"[0, 0, 0, 0, 1, 1, 0, 1, 0, 0]",211,101,110,9,7,0.0891089108910891,0.06363636363636363
"[1, 0, 0, 1, 0, 1, 1, 0, 0, 1]",201,105,96,2,6,0.01904761904761905,0.0625
"[0, 0, 0, 0, 1, 1, 1, 1, 0, 0]",662,313,349,21,39,0.0670926517571885,0.11174785100286533
"[1, 1, 0, 0, 0, 0, 0, 0, 1, 1]",631,322,309,28,33,0.08695652173913043,0.10679611650485436
"[1, 1, 1, 1, 0, 0, 0, 0, 0, 0]",667,318,349,39,37,0.12264150943396226,0.10601719197707736
"[0, 0, 1, 1, 0, 0, 0, 0, 0, 0]",601,268,333,31,35,0.11567164179104478,0.10510510510510511
"[1, 1, 1, 0, 0, 1, 1, 0, 0, 0]",473,118,355,7,37,0.059322033898305086,0.10422535211267606
"[1, 1, 1, 1, 1, 0, 0, 1, 1, 0]",426,117,309,14,42,0.11965811965811966,0.13592233009708737
"[1, 0, 1, 1, 1, 1, 0, 0, 0, 0]",256,120,136,12,20,0.1,0.14705882352941177
"[1, 1, 0, 1, 1, 1, 1, 0, 0, 0]",213,109,104,7,12,0.06422018348623854,0.11538461538461539
"[0, 1, 0, 1, 1, 1, 0, 1, 1, 1]",146,70,76,6,8,0.08571428571428572,0.10526315789473684
"[0, 0, 1, 0, 0, 0, 0, 1, 0, 0]",136,63,73,5,3,0.07936507936507936,0.0410958904109589
"[1, 0, 1, 0, 0, 1, 0, 0, 0, 0]",177,78,99,10,8,0.1282051282051282,0.08080808080808081
"[1, 0, 1, 1, 0, 1, 0, 0, 1, 0]",149,58,91,8,5,0.13793103448275862,0.054945054945054944
"[0, 1, 0, 1, 0, 0, 1, 0, 0, 1]",157,79,78,5,18,0.06329113924050633,0.23076923076923078
"[0, 1, 0, 1, 0, 1, 0, 0, 1, 0]",139,72,67,9,6,0.125,0.08955223880597014
"[1, 1, 1, 0, 1, 0, 0, 0, 1, 0]",140,66,74,8,6,0.12121212121212122,0.08108108108108109
"[0, 0, 1, 1, 1, 0, 1, 1, 0, 0]",193,107,86,7,11,0.06542056074766354,0.12790697674418605
"[1, 1, 0, 0, 1, 1, 1, 0, 1, 1]",187,91,96,9,12,0.0989010989010989,0.125
"[1, 1, 0, 1, 1, 1, 0, 0, 1, 1]",190,99,91,12,10,0.12121212121212122,0.10989010989010989
"[1, 1, 1, 1, 0, 1, 0, 1, 1, 0]",175,87,88,9,4,0.10344827586206896,0.045454545454545456
"[0, 1, 1, 1, 1, 0, 1, 0, 1, 1]",186,102,84,16,4,0.1568627450980392,0.047619047619047616
"[0, 1, 0, 0, 1, 1, 1, 1, 0, 1]",163,85,78,7,7,0.08235294117647059,0.08974358974358974
"[0, 1, 0, 0, 1, 1, 1, 0, 1, 1]",135,75,60,6,7,0.08,0.11666666666666667
"[0, 1, 1, 1, 0, 1, 0, 0, 1, 1]",178,94,84,6,9,0.06382978723404255,0.10714285714285714
"[1, 0, 0, 1, 1, 1, 0, 1, 0, 0]",170,71,99,7,7,0.09859154929577464,0.0707070707070707
"[0, 1, 1, 0, 0, 1, 1, 1, 0, 1]",197,118,79,12,8,0.1016949152542373,0.10126582278481013
"[0, 0, 0, 1, 1, 0, 0, 1, 1, 0]",442,324,118,30,10,0.09259259259259259,0.0847457627118644
"[0, 1, 1, 0, 0, 0, 1, 1, 0, 0]",190,106,84,11,9,0.10377358490566038,0.10714285714285714
"[1, 0, 1, 1, 0, 0, 1, 1, 0, 0]",261,133,128,16,17,0.12030075187969924,0.1328125
"[0, 1, 0, 1, 0, 1, 1, 0, 1, 1]",147,75,72,7,7,0.09333333333333334,0.09722222222222222
"[0, 1, 1, 1, 0, 1, 0, 1, 0, 1]",139,77,62,9,5,0.11688311688311688,0.08064516129032258
"[0, 0, 0, 0, 1, 1, 1, 0, 1, 0]",206,98,108,10,8,0.10204081632653061,0.07407407407407407
"[1, 0, 1, 1, 0, 0, 0, 0, 0, 1]",202,109,93,8,5,0.07339449541284404,0.053763440860215055
"[0, 1, 0, 1, 1, 0, 0, 0, 0, 0]",240,118,122,6,10,0.05084745762711865,0.08196721311475409
"[1, 0, 1, 0, 0, 1, 1, 1, 0, 0]",163,84,79,12,8,0.14285714285714285,0.10126582278481013
"[1, 1, 0, 0, 0, 0, 1, 0, 1, 0]",169,90,79,11,5,0.12222222222222222,0.06329113924050633
"[0, 1, 1, 1, 0, 1, 1, 1, 1, 1]",185,101,84,11,6,0.10891089108910891,0.07142857142857142
"[1, 0, 0, 0, 1, 1, 1, 1, 1, 1]",247,122,125,11,10,0.09016393442622951,0.08
"[0, 0, 1, 0, 0, 0, 1, 1, 1, 1]",209,115,94,9,6,0.0782608695652174,0.06382978723404255
"[0, 0, 0, 1, 0, 0, 0, 1, 1, 1]",185,90,95,10,13,0.1111111111111111,0.1368421052631579
"[1, 0, 0, 0, 1, 0, 0, 0, 1, 1]",181,78,103,4,9,0.05128205128205128,0.08737864077669903
"[0, 1, 0, 0, 0, 1, 0, 0, 0, 1]",131,72,59,6,6,0.08333333333333333,0.1016949152542373
"[1, 1, 0, 0, 1, 1, 1, 1, 1, 1]",591,304,287,31,23,0.10197368421052631,0.08013937282229965
"[0, 1, 0, 0, 1, 0, 0, 1, 0, 1]",144,75,69,5,4,0.06666666666666667,0.057971014492753624
"[0, 0, 1, 0, 0, 1, 0, 0, 1, 0]",140,68,72,5,8,0.07352941176470588,0.1111111111111111
"[0, 1, 0, 0, 1, 0, 0, 0, 0, 0]",178,85,93,10,6,0.11764705882352941,0.06451612903225806
"[0, 1, 1, 0, 1, 1, 0, 1, 0, 0]",144,84,60,2,3,0.023809523809523808,0.05
"[1, 1, 0, 0, 0, 0, 0, 1, 1, 0]",262,126,136,21,11,0.16666666666666666,0.08088235294117647
"[0, 1, 1, 1, 0, 0, 1, 0, 1, 1]",156,83,73,8,5,0.0963855421686747,0.0684931506849315
"[1, 0, 1, 1, 1, 0, 0, 1, 0, 1]",146,80,66,4,6,0.05,0.09090909090909091
"[0, 0, 1, 0, 1, 0, 1, 0, 1, 1]",142,78,64,7,6,0.08974358974358974,0.09375
"[0, 0, 1, 0, 1, 0, 0, 0, 0, 1]",148,74,74,6,11,0.08108108108108109,0.14864864864864866
"[1, 1, 1, 0, 0, 1, 0, 1, 0, 0]",206,91,115,6,14,0.06593406593406594,0.12173913043478261
"[0, 1, 1, 1, 1, 0, 0, 1, 0, 1]",176,117,59,8,5,0.06837606837606838,0.0847457627118644
"[1, 0, 1, 1, 1, 1, 0, 0, 1, 0]",139,61,78,6,4,0.09836065573770492,0.05128205128205128
"[1, 0, 0, 1, 0, 1, 0, 1, 1, 1]",158,77,81,6,5,0.07792207792207792,0.06172839506172839
"[1, 0, 0, 0, 0, 1, 1, 0, 1, 0]",215,93,122,12,16,0.12903225806451613,0.13114754098360656
"[1, 0, 1, 0, 0, 1, 1, 0, 1, 1]",155,71,84,2,4,0.028169014084507043,0.047619047619047616
"[1, 1, 0, 1, 0, 0, 1, 1, 0, 1]",165,90,75,8,8,0.08888888888888889,0.10666666666666667
"[1, 1, 1, 1, 1, 0, 1, 1, 1, 1]",148,79,69,8,8,0.10126582278481013,0.11594202898550725
"[1, 0, 0, 1, 1, 1, 1, 1, 0, 1]",170,84,86,6,7,0.07142857142857142,0.08139534883720931
"[1, 1, 0, 0, 1, 0, 0, 0, 1, 1]",164,79,85,4,13,0.05063291139240506,0.15294117647058825
"[1, 0, 0, 1, 0, 0, 1, 0, 0, 1]",163,69,94,9,6,0.13043478260869565,0.06382978723404255
"[0, 0, 1, 1, 1, 0, 0, 1, 0, 0]",181,80,101,4,7,0.05,0.06930693069306931
"[1, 0, 0, 1, 1, 1, 0, 0, 1, 0]",167,75,92,7,11,0.09333333333333334,0.11956521739130435
"[1, 1, 1, 1, 1, 0, 0, 0, 1, 1]",231,99,132,11,6,0.1111111111111111,0.045454545454545456
"[0, 0, 1, 1, 0, 0, 1, 1, 1, 1]",629,293,336,35,29,0.11945392491467577,0.08630952380952381
"[1, 0, 0, 1, 1, 0, 0, 1, 1, 1]",485,160,325,15,28,0.09375,0.08615384615384615
"[0, 0, 0, 0, 0, 1, 1, 1, 1, 1]",541,378,163,27,18,0.07142857142857142,0.11042944785276074
"[0, 0, 0, 0, 0, 1, 0, 1, 1, 0]",179,85,94,12,16,0.1411764705882353,0.1702127659574468
"[0, 0, 0, 0, 0, 0, 0, 1, 0, 1]",166,88,78,12,9,0.13636363636363635,0.11538461538461539
"[0, 1, 0, 1, 0, 1, 1, 0, 1, 0]",147,66,81,9,8,0.13636363636363635,0.09876543209876543
"[1, 0, 1, 1, 1, 0, 0, 0, 0, 0]",230,107,123,9,8,0.08411214953271028,0.06504065040650407
"[1, 0, 1, 1, 1, 1, 1, 1, 0, 1]",152,72,80,7,9,0.09722222222222222,0.1125
"[1, 1, 0, 0, 1, 0, 0, 1, 1, 0]",219,104,115,6,7,0.057692307692307696,0.06086956521739131
"[0, 1, 1, 1, 1, 0, 0, 1, 0, 0]",207,123,84,13,12,0.10569105691056911,0.14285714285714285
"[0, 1, 0, 0, 0, 1, 1, 1, 0, 1]",139,58,81,4,6,0.06896551724137931,0.07407407407407407
"[0, 0, 1, 1, 0, 0, 1, 0, 0, 0]",193,93,100,6,7,0.06451612903225806,0.07
"[1, 1, 1, 1, 1, 1, 1, 1, 1, 0]",403,127,276,14,31,0.11023622047244094,0.11231884057971014
"[1, 0, 1, 0, 0, 1, 1, 1, 1, 1]",213,125,88,8,6,0.064,0.06818181818181818
"[1, 1, 1, 1, 0, 1, 0, 0, 1, 1]",174,82,92,7,11,0.08536585365853659,0.11956521739130435
"[1, 1, 1, 1, 1, 0, 1, 0, 0, 1]",177,72,105,4,10,0.05555555555555555,0.09523809523809523
"[0, 0, 0, 1, 1, 0, 0, 0, 0, 0]",382,263,119,27,10,0.10266159695817491,0.08403361344537816
"[1, 0, 0, 0, 1, 1, 0, 0, 0, 0]",248,103,145,7,15,0.06796116504854369,0.10344827586206896
"[1, 0, 0, 1, 0, 0, 0, 1, 1, 0]",141,65,76,4,5,0.06153846153846154,0.06578947368421052
"[0, 1, 0, 0, 1, 0, 0, 0, 1, 1]",149,79,70,6,13,0.0759493670886076,0.18571428571428572
"[0, 0, 1, 1, 0, 1, 0, 0, 0, 0]",195,100,95,6,9,0.06,0.09473684210526316
"[1, 0, 0, 0, 1, 1, 0, 1, 0, 0]",171,74,97,9,7,0.12162162162162163,0.07216494845360824
"[0, 1, 0, 0, 0, 1, 1, 0, 1, 0]",146,70,76,5,9,0.07142857142857142,0.11842105263157894
"[1, 1, 0, 0, 0, 0, 0, 1, 0, 0]",176,76,100,10,9,0.13157894736842105,0.09
"[0, 1, 1, 1, 0, 0, 0, 1, 1, 0]",190,97,93,13,6,0.13402061855670103,0.06451612903225806
"[1, 1, 0, 1, 1, 1, 0, 0, 0, 1]",172,86,86,12,11,0.13953488372093023,0.12790697674418605
"[1, 1, 1, 0, 0, 1, 0, 0, 0, 0]",203,104,99,9,7,0.08653846153846154,0.0707070707070707
"[1, 0, 1, 0, 0, 1, 0, 1, 1, 1]",160,76,84,6,10,0.07894736842105263,0.11904761904761904
"[1, 0, 1, 1, 1, 0, 0, 1, 0, 0]",161,75,86,8,10,0.10666666666666667,0.11627906976744186
"[0, 1, 0, 0, 1, 0, 1, 0, 0, 0]",150,71,79,8,6,0.11267605633802817,0.0759493670886076
"[0, 1, 0, 1, 1, 0, 1, 1, 0, 1]",131,70,61,6,5,0.08571428571428572,0.08196721311475409
"[0, 0, 1, 1, 1, 0, 1, 0, 1, 1]",197,105,92,5,6,0.047619047619047616,0.06521739130434782
"[1, 0, 0, 0, 0, 1, 1, 1, 0, 1]",210,88,122,10,14,0.11363636363636363,0.11475409836065574
"[0, 0, 0, 0, 0, 0, 1, 1, 0, 0]",568,283,285,26,24,0.09187279151943463,0.08421052631578947
"[0, 0, 0, 0, 1, 1, 0, 0, 0, 0]",598,276,322,22,27,0.07971014492753623,0.08385093167701864
"[0, 1, 1, 1, 0, 0, 1, 1, 1, 1]",263,149,114,12,8,0.08053691275167785,0.07017543859649122
"[0, 0, 0, 1, 0, 1, 1, 1, 0, 0]",184,83,101,8,5,0.0963855421686747,0.04950495049504951
"[0, 1, 1, 1, 0, 0, 1, 0, 0, 0]",170,98,72,12,10,0.12244897959183673,0.1388888888888889
"[1, 1, 0, 0, 1, 1, 0, 1, 1, 1]",199,98,101,12,11,0.12244897959183673,0.10891089108910891
"[0, 1, 1, 0, 0, 0, 1, 1, 1, 1]",257,148,109,17,14,0.11486486486486487,0.12844036697247707
"[1, 0, 1, 1, 0, 1, 1, 0, 0, 0]",173,77,96,2,19,0.025974025974025976,0.19791666666666666
"[0, 0, 0, 0, 1, 1, 1, 0, 1, 1]",210,108,102,12,11,0.1111111111111111,0.10784313725490197
"[0, 1, 0, 0, 1, 1, 0, 0, 0, 0]",251,118,133,9,10,0.07627118644067797,0.07518796992481203
"[1, 0, 1, 0, 0, 1, 1, 0, 0, 0]",237,114,123,6,12,0.05263157894736842,0.0975609756097561
"[1, 1, 0, 1, 0, 0, 0, 1, 1, 0]",165,80,85,10,9,0.125,0.10588235294117647
"[1, 0, 0, 1, 1, 0, 0, 1, 0, 1]",182,80,102,8,8,0.1,0.0784313725490196
"[1, 0, 1, 0, 0, 1, 0, 0, 1, 1]",190,94,96,11,10,0.11702127659574468,0.10416666666666667
"[0, 1, 0, 1, 1, 1, 1, 1, 0, 1]",157,92,65,12,13,0.13043478260869565,0.2
"[1, 1, 0, 1, 1, 0, 1, 0, 0, 0]",137,64,73,5,8,0.078125,0.1095890410958904
"[1, 1, 1, 1, 1, 0, 1, 0, 0, 0]",192,89,103,8,8,0.0898876404494382,0.07766990291262135
"[1, 1, 1, 1, 1, 1, 1, 0, 1, 0]",192,88,104,6,7,0.06818181818181818,0.0673076923076923
"[1, 1, 0, 1, 0, 1, 0, 0, 0, 0]",187,95,92,8,3,0.08421052631578947,0.03260869565217391
"[1, 1, 1, 0, 1, 0, 1, 0, 0, 0]",161,80,81,8,7,0.1,0.08641975308641975
"[1, 0, 1, 1, 1, 1, 0, 1, 0, 1]",134,84,50,4,7,0.047619047619047616,0.14
"[0, 0, 1, 1, 0, 0, 0, 1, 1, 1]",255,137,118,16,13,0.11678832116788321,0.11016949152542373
"[1, 0, 1, 0, 1, 0, 0, 0, 1, 0]",131,59,72,2,9,0.03389830508474576,0.125
"[1, 0, 0, 1, 0, 0, 0, 0, 1, 1]",225,98,127,14,10,0.14285714285714285,0.07874015748031496
"[1, 1, 0, 0, 1, 0, 0, 0, 0, 1]",213,114,99,11,8,0.09649122807017543,0.08080808080808081
"[0, 1, 1, 1, 1, 1, 1, 0, 1, 0]",185,96,89,10,10,0.10416666666666667,0.11235955056179775
"[1, 0, 0, 0, 1, 0, 0, 1, 0, 1]",167,79,88,8,11,0.10126582278481013,0.125
"[1, 1, 0, 1, 0, 0, 0, 1, 0, 0]",139,74,65,4,6,0.05405405405405406,0.09230769230769231
"[0, 1, 0, 0, 0, 1, 1, 1, 1, 0]",177,97,80,9,9,0.09278350515463918,0.1125
"[1, 0, 0, 1, 0, 1, 0, 0, 0, 1]",152,72,80,9,10,0.125,0.125
"[0, 1, 0, 0, 0, 1, 1, 1, 0, 0]",182,91,91,6,7,0.06593406593406594,0.07692307692307693
"[1, 0, 1, 0, 0, 0, 1, 1, 1, 0]",171,85,86,6,9,0.07058823529411765,0.10465116279069768
"[0, 1, 1, 0, 1, 0, 0, 0, 1, 1]",174,105,69,6,10,0.05714285714285714,0.14492753623188406
"[0, 1, 0, 1, 0, 0, 0, 1, 1, 0]",142,75,67,12,7,0.16,0.1044776119402985
"[1, 1, 1, 1, 1, 0, 0, 0, 0, 0]",495,136,359,12,31,0.08823529411764706,0.08635097493036212
"[0, 1, 1, 0, 1, 1, 1, 0, 1, 1]",156,82,74,9,7,0.10975609756097561,0.0945945945945946
"[0, 0, 0, 0, 1, 0, 1, 1, 0, 1]",154,77,77,9,9,0.11688311688311688,0.11688311688311688
"[1, 1, 0, 0, 0, 0, 0, 0, 1, 0]",245,115,130,12,18,0.10434782608695652,0.13846153846153847
"[0, 0, 1, 0, 1, 1, 1, 1, 0, 0]",190,97,93,6,6,0.061855670103092786,0.06451612903225806
"[0, 0, 1, 1, 1, 0, 0, 1, 0, 1]",165,97,68,11,11,0.1134020618556701,0.16176470588235295
"[0, 0, 0, 1, 1, 1, 0, 0, 1, 0]",178,93,85,7,9,0.07526881720430108,0.10588235294117647
"[0, 0, 0, 0, 1, 1, 1, 0, 0, 1]",220,104,116,8,11,0.07692307692307693,0.09482758620689655
"[1, 1, 0, 0, 0, 1, 0, 1, 1, 1]",174,80,94,8,9,0.1,0.09574468085106383
"[0, 1, 1, 0, 1, 0, 1, 1, 1, 0]",136,70,66,6,4,0.08571428571428572,0.06060606060606061
"[1, 0, 1, 1, 0, 1, 0, 1, 1, 1]",148,75,73,6,10,0.08,0.136986301369863
"[1, 0, 1, 1, 1, 1, 0, 1, 1, 0]",148,82,66,8,7,0.0975609756097561,0.10606060606060606
"[0, 0, 0, 1, 1, 0, 1, 0, 1, 1]",185,102,83,7,13,0.06862745098039216,0.1566265060240964
"[0, 1, 0, 0, 1, 1, 1, 1, 1, 0]",182,96,86,8,8,0.08333333333333333,0.09302325581395349
"[1, 0, 0, 0, 0, 0, 1, 0, 1, 0]",158,79,79,5,10,0.06329113924050633,0.12658227848101267
"[1, 1, 0, 0, 0, 1, 1, 0, 1, 1]",175,89,86,6,8,0.06741573033707865,0.09302325581395349
"[0, 1, 1, 0, 0, 0, 1, 1, 0, 1]",180,104,76,8,5,0.07692307692307693,0.06578947368421052
"[0, 0, 0, 1, 1, 1, 1, 0, 1, 0]",196,115,81,8,7,0.06956521739130435,0.08641975308641975
"[1, 1, 0, 0, 0, 1, 0, 0, 1, 0]",174,70,104,8,9,0.11428571428571428,0.08653846153846154
"[1, 0, 0, 1, 1, 0, 1, 0, 1, 0]",185,79,106,8,13,0.10126582278481013,0.12264150943396226
"[1, 1, 0, 1, 0, 0, 0, 0, 1, 1]",226,119,107,17,6,0.14285714285714285,0.056074766355140186
"[1, 0, 0, 1, 0, 1, 1, 1, 0, 1]",144,66,78,6,8,0.09090909090909091,0.10256410256410256
"[0, 0, 1, 1, 1, 0, 0, 0, 1, 1]",188,96,92,5,11,0.052083333333333336,0.11956521739130435
"[0, 0, 0, 0, 1, 1, 1, 0, 0, 0]",220,110,110,12,12,0.10909090909090909,0.10909090909090909
"[0, 1, 0, 0, 0, 0, 0, 1, 1, 1]",199,98,101,5,14,0.05102040816326531,0.13861386138613863
"[1, 0, 0, 0, 1, 0, 1, 0, 0, 1]",146,80,66,8,7,0.1,0.10606060606060606
"[1, 0, 1, 0, 0, 0, 0, 1, 1, 0]",211,95,116,12,14,0.12631578947368421,0.1206896551724138
"[0, 1, 0, 1, 1, 1, 1, 0, 0, 1]",186,95,91,6,10,0.06315789473684211,0.10989010989010989
"[1, 1, 1, 0, 0, 1, 1, 1, 0, 0]",223,97,126,9,8,0.09278350515463918,0.06349206349206349
"[1, 0, 0, 0, 0, 1, 0, 0, 0, 1]",181,77,104,7,6,0.09090909090909091,0.057692307692307696
"[0, 0, 1, 1, 1, 0, 0, 0, 0, 1]",226,115,111,17,8,0.14782608695652175,0.07207207207207207
"[1, 0, 1, 1, 0, 0, 1, 0, 0, 1]",186,99,87,6,5,0.06060606060606061,0.05747126436781609
"[0, 0, 1, 1, 0, 1, 1, 1, 1, 0]",186,84,102,8,5,0.09523809523809523,0.049019607843137254
"[1, 0, 0, 0, 1, 1, 0, 1, 1, 0]",135,67,68,4,12,0.05970149253731343,0.17647058823529413
"[1, 1, 0, 0, 1, 0, 1, 0, 1, 1]",153,81,72,11,7,0.13580246913580246,0.09722222222222222
"[0, 1, 1, 0, 1, 0, 1, 0, 1, 1]",181,97,84,8,9,0.08247422680412371,0.10714285714285714
"[1, 1, 0, 1, 1, 0, 1, 0, 1, 0]",153,79,74,8,8,0.10126582278481013,0.10810810810810811
"[0, 1, 0, 1, 0, 0, 0, 0, 0, 1]",160,96,64,4,2,0.041666666666666664,0.03125
"[0, 0, 0, 1, 0, 0, 1, 1, 0, 0]",178,88,90,6,10,0.06818181818181818,0.1111111111111111
"[1, 1, 0, 1, 0, 1, 0, 0, 0, 1]",143,73,70,4,6,0.0547945205479452,0.08571428571428572
"[1, 1, 0, 1, 1, 1, 1, 1, 0, 1]",144,72,72,10,11,0.1388888888888889,0.1527777777777778
"[1, 1, 0, 1, 1, 0, 0, 0, 1, 0]",160,76,84,7,7,0.09210526315789473,0.08333333333333333
"[1, 1, 0, 0, 1, 1, 1, 0, 0, 0]",244,123,121,11,11,0.08943089430894309,0.09090909090909091
"[0, 1, 0, 1, 1, 0, 1, 0, 0, 1]",156,69,87,4,11,0.057971014492753624,0.12643678160919541
"[0, 1, 0, 1, 0, 1, 0, 1, 1, 0]",139,63,76,8,10,0.12698412698412698,0.13157894736842105
"[1, 0, 1, 0, 1, 0, 1, 0, 1, 1]",145,68,77,6,7,0.08823529411764706,0.09090909090909091
"[1, 1, 0, 1, 0, 1, 0, 1, 0, 1]",137,68,69,6,6,0.08823529411764706,0.08695652173913043
"[1, 1, 0, 1, 0, 1, 1, 1, 1, 1]",170,84,86,7,6,0.08333333333333333,0.06976744186046512
"[0, 0, 1, 0, 1, 1, 0, 1, 0, 0]",138,80,58,8,4,0.1,0.06896551724137931
"[0, 1, 0, 0, 0, 0, 1, 1, 1, 0]",168,91,77,8,8,0.08791208791208792,0.1038961038961039
"[1, 0, 1, 0, 1, 0, 1, 1, 0, 0]",163,79,84,8,5,0.10126582278481013,0.05952380952380952
"[0, 1, 1, 0, 1, 0, 1, 1, 0, 1]",178,94,84,4,4,0.0425531914893617,0.047619047619047616
"[0, 1, 1, 1, 0, 1, 0, 1, 0, 0]",159,79,80,6,8,0.0759493670886076,0.1
"[1, 0, 0, 1, 0, 1, 1, 0, 1, 0]",132,75,57,4,5,0.05333333333333334,0.08771929824561403
"[1, 1, 0, 1, 1, 1, 1, 1, 1, 0]",195,109,86,9,8,0.08256880733944955,0.09302325581395349
"[1, 1, 0, 1, 1, 0, 1, 1, 1, 1]",153,68,85,6,7,0.08823529411764706,0.08235294117647059
